src,sep,dst,inframes,inbytes,outframes,outbytes,totalframes,totalbytes,relstart,duration
109.97.67.71,<->,92.27.27.185,0,0,3880,5835520,3880,5835520,0.004506000,1.9954
144.93.121.86,<->,144.93.120.177,3414,696456,0,0,3414,696456,0.001075000,1.9987
144.93.121.48,<->,144.93.120.177,2928,597312,0,0,2928,597312,0.000797000,1.9992
144.93.121.10,<->,144.93.120.177,2820,575280,0,0,2820,575280,0.000132000,1.9988
252.98.181.203,<->,139.254.110.36,2080,2830768,0,0,2080,2830768,0.001749000,1.9975
144.93.121.50,<->,144.93.120.177,1468,299472,0,0,1468,299472,0.000327000,1.9983
144.93.125.49,<->,144.93.121.10,0,0,1046,213084,1046,213084,0.000556000,1.9940
144.93.125.49,<->,144.93.121.86,0,0,1010,205492,1010,205492,0.000513000,1.9981
144.93.121.86,<->,113.171.246.29,901,119656,0,0,901,119656,0.000263000,1.9988
148.214.83.199,<->,92.27.27.179,0,0,826,1203482,826,1203482,0.020736000,1.9750
131.148.66.172,<->,20.206.10.26,0,0,762,62484,762,62484,0.220441000,1.6019
230.102.130.22,<->,133.178.227.222,0,0,733,624403,733,624403,0.000236000,1.9995
105.113.53.185,<->,92.27.219.43,0,0,718,378164,718,378164,0.022238000,1.9750
192.64.194.99,<->,127.161.158.33,707,1027988,0,0,707,1027988,0.005265000,1.9927
144.93.125.48,<->,144.93.121.86,0,0,703,143112,703,143112,0.007305000,1.9899
144.93.121.86,<->,144.93.120.28,500,102000,0,0,500,102000,0.003369000,1.9961
144.93.121.48,<->,144.93.120.28,500,102000,0,0,500,102000,0.003336000,1.9935
144.253.55.140,<->,133.178.227.200,0,0,482,504454,482,504454,0.018361000,1.9751
247.136.132.126,<->,93.181.154.100,442,23640,0,0,442,23640,0.010717000,1.9287
152.12.153.239,<->,89.183.104.135,0,0,435,358975,435,358975,0.102488000,1.8477
220.211.201.206,<->,133.178.227.152,0,0,432,129034,432,129034,0.004044000,1.9924
124.59.106.210,<->,109.222.212.23,0,0,405,589680,405,589680,0.003362000,1.9962
133.178.227.207,<->,69.31.239.50,405,84372,0,0,405,84372,0.000599000,1.9952
232.111.67.19,<->,192.67.146.96,0,0,401,350228,401,350228,0.017747000,1.9592
215.158.2.80,<->,8.238.204.1,0,0,399,92238,399,92238,0.002284000,1.9911
144.93.121.10,<->,144.93.120.28,399,81396,0,0,399,81396,0.001919000,1.9910
198.230.143.36,<->,82.252.43.154,0,0,368,360343,368,360343,0.000165000,1.9998
133.178.227.145,<->,83.232.206.116,355,104074,0,0,355,104074,0.000051000,1.9917
110.63.236.92,<->,92.27.219.40,0,0,345,502896,345,502896,0.003593000,1.9846
144.93.125.48,<->,144.93.121.10,0,0,302,61408,302,61408,0.000280000,1.9890
144.93.121.50,<->,144.93.120.28,300,61200,0,0,300,61200,0.010245000,1.9865
144.93.125.38,<->,144.93.121.86,0,0,300,61200,300,61200,0.001312000,1.9960
195.88.168.52,<->,80.40.19.83,0,0,284,14786,284,14786,0.037265000,1.9559
193.45.87.23,<->,192.67.144.51,0,0,280,14560,280,14560,0.008529000,1.9801
192.67.183.27,<->,148.54.19.75,264,13728,0,0,264,13728,0.000340000,1.6919
92.27.219.165,<->,67.240.216.233,254,124054,0,0,254,124054,0.008929000,1.9788
133.178.227.223,<->,80.47.152.63,251,258007,0,0,251,258007,0.000119000,1.9993
108.134.108.77,<->,106.157.38.242,239,11950,0,0,239,11950,0.102749000,1.7773
249.101.194.110,<->,122.228.233.173,233,12116,0,0,233,12116,0.034969000,1.9233
215.158.2.83,<->,108.39.227.100,0,0,223,127613,223,127613,0.007995000,1.9805
89.220.215.61,<->,80.42.213.194,0,0,207,19216,207,19216,0.007531000,1.9911
246.253.253.207,<->,204.42.61.33,206,60326,0,0,206,60326,0.007781000,1.8655
108.32.18.191,<->,89.183.104.136,0,0,205,28513,205,28513,0.010844000,1.9848
111.147.141.67,<->,76.72.21.156,204,13868,0,0,204,13868,0.012287000,1.4502
144.93.121.10,<->,113.171.246.29,202,25008,0,0,202,25008,0.001568000,1.9900
144.93.125.37,<->,144.93.121.10,0,0,201,40904,201,40904,0.009032000,1.9800
220.14.74.198,<->,35.56.98.184,0,0,200,40800,200,40800,0.002321000,1.9879
119.255.203.35,<->,89.183.104.172,0,0,200,11143,200,11143,0.000684000,1.9114
117.18.226.85,<->,92.27.219.151,0,0,198,288684,198,288684,0.099355000,1.8940
230.102.130.12,<->,133.178.227.215,0,0,191,108620,191,108620,0.002217000,1.9738
111.147.65.245,<->,76.15.3.35,188,97500,0,0,188,97500,0.057234000,1.9394
89.183.104.231,<->,33.57.74.172,183,199661,0,0,183,199661,0.003270000,1.9929
133.178.227.145,<->,50.51.22.133,180,35192,0,0,180,35192,0.153834000,0.8538
198.43.254.51,<->,100.95.198.6,0,0,172,247964,172,247964,0.817795000,1.1670
114.74.11.114,<->,56.121.49.236,0,0,172,222592,172,222592,0.030899000,1.9665
114.193.59.188,<->,92.27.27.187,0,0,170,33042,170,33042,0.004065000,1.9924
243.156.114.200,<->,92.27.27.151,0,0,165,8580,165,8580,0.002802000,1.8734
249.101.104.134,<->,139.165.148.255,164,37716,0,0,164,37716,0.013507000,1.9798
144.75.218.242,<->,8.222.218.199,152,18484,0,0,152,18484,0.043182000,1.9548
98.129.85.115,<->,57.62.248.124,143,7972,0,0,143,7972,0.004746000,1.8248
159.108.77.35,<->,139.249.88.21,0,0,142,53094,142,53094,0.281171000,1.7030
104.81.132.140,<->,92.27.219.195,0,0,142,8161,142,8161,0.015562000,1.9696
215.158.66.194,<->,133.178.227.207,0,0,137,54590,137,54590,0.007284000,1.9913
111.151.139.139,<->,8.252.221.89,0,0,131,128147,131,128147,0.009239000,1.9664
109.222.219.127,<->,50.182.187.249,128,6704,0,0,128,6704,0.010013000,1.9703
141.37.44.96,<->,89.183.104.251,0,0,127,186690,127,186690,0.007375000,1.9632
192.64.200.221,<->,35.56.30.5,125,12558,0,0,125,12558,0.001173000,1.9918
117.20.112.178,<->,89.183.104.229,0,0,123,184992,123,184992,0.008152000,1.9833
206.248.77.125,<->,109.222.209.181,0,0,120,171520,120,171520,0.107554000,1.7583
148.141.174.148,<->,35.56.97.156,0,0,120,10560,120,10560,0.012461000,1.9820
112.151.85.120,<->,35.56.97.124,0,0,120,7110,120,7110,0.009325000,1.9808
89.183.110.45,<->,0.97.210.184,119,13916,0,0,119,13916,0.161798000,1.8315
121.215.68.28,<->,89.183.104.246,0,0,117,162064,117,162064,0.149739000,1.8262
118.215.113.160,<->,89.183.104.246,0,0,116,170520,116,170520,0.221087000,1.7345
230.102.130.25,<->,133.178.227.207,0,0,116,31102,116,31102,0.001072000,1.9597
226.68.196.217,<->,82.252.33.45,0,0,115,36396,115,36396,0.003846000,1.9796
89.183.104.141,<->,76.178.78.215,115,54959,0,0,115,54959,0.002944000,1.9715
105.104.5.199,<->,39.48.2.224,0,0,114,7036,114,7036,0.010138000,0.9405
144.75.218.241,<->,8.222.218.207,111,13689,0,0,111,13689,0.002320000,1.9861
246.253.253.210,<->,194.220.68.39,110,17142,0,0,110,17142,0.015170000,1.9712
100.188.51.6,<->,89.183.104.159,0,0,109,121099,109,121099,0.020284000,1.9651
144.75.218.246,<->,8.222.218.197,106,12919,0,0,106,12919,0.020424000,1.9572
149.110.19.113,<->,89.183.104.148,0,0,105,151580,105,151580,0.525680000,1.2333
246.253.253.210,<->,204.43.169.138,105,16565,0,0,105,16565,0.013499000,1.9775
149.193.32.35,<->,102.51.78.239,0,0,104,131456,104,131456,0.023613000,1.9108
200.174.209.33,<->,102.72.16.148,104,150432,0,0,104,150432,0.008944000,1.9721
246.253.253.208,<->,204.42.246.7,103,16315,0,0,103,16315,0.011226000,1.9804
192.64.235.125,<->,127.161.224.79,103,14960,0,0,103,14960,0.003200000,1.9962
139.69.162.189,<->,50.128.200.204,0,0,102,13908,102,13908,0.015260000,1.9801
220.14.74.249,<->,35.56.98.184,0,0,102,22234,102,22234,0.010615000,1.9800
144.93.125.38,<->,144.93.121.10,0,0,102,20608,102,20608,0.010250000,1.9800
144.93.121.83,<->,113.178.109.84,101,20516,0,0,101,20516,0.010880000,1.9800
246.253.253.210,<->,204.42.167.55,101,15857,0,0,101,15857,0.002039000,1.9954
132.227.248.61,<->,111.146.189.146,0,0,101,16017,101,16017,0.000883000,1.9856
159.46.201.24,<->,144.93.121.10,0,0,101,20604,101,20604,0.000312000,1.9979
159.46.201.109,<->,144.93.121.83,0,0,100,20400,100,20400,0.019046000,1.9800
144.93.121.83,<->,98.198.84.28,100,20400,0,0,100,20400,0.018886000,1.9800
144.93.125.32,<->,144.93.121.50,0,0,100,20400,100,20400,0.016079000,1.9800
159.46.201.28,<->,144.93.121.86,0,0,100,20400,100,20400,0.014532000,1.9799
145.2.46.169,<->,144.93.121.10,0,0,100,20400,100,20400,0.013898000,1.9800
144.93.121.83,<->,101.71.113.171,100,20400,0,0,100,20400,0.013602000,1.9800
137.83.230.7,<->,50.23.57.66,100,20400,0,0,100,20400,0.011853000,1.9821
210.213.21.66,<->,92.26.144.99,0,0,100,20400,100,20400,0.009868000,1.9799
198.11.192.232,<->,144.93.121.10,0,0,100,20400,100,20400,0.007386000,1.9799
236.90.17.75,<->,144.93.121.10,0,0,100,20400,100,20400,0.005421000,1.9800
144.93.121.10,<->,101.71.113.171,100,20400,0,0,100,20400,0.004641000,1.9800
145.2.46.74,<->,144.93.121.10,0,0,100,20400,100,20400,0.004305000,1.9800
144.93.125.32,<->,144.93.121.10,0,0,100,20400,100,20400,0.003085000,1.9800
145.2.46.75,<->,144.93.121.10,0,0,100,20400,100,20400,0.001381000,1.9800
144.93.121.83,<->,98.198.84.11,100,20400,0,0,100,20400,0.000715000,1.9800
144.93.125.32,<->,144.93.121.43,0,0,100,20400,100,20400,0.000031000,1.9800
226.36.250.224,<->,92.27.27.178,0,0,98,5120,98,5120,0.044841000,1.9455
121.212.70.115,<->,92.27.27.182,0,0,96,141120,96,141120,0.109522000,1.8810
215.158.2.89,<->,92.170.244.173,0,0,96,12321,96,12321,0.008123000,1.9006
108.128.237.16,<->,101.224.167.233,0,0,95,9610,95,9610,0.016295000,1.9481
144.75.218.246,<->,8.222.218.204,91,11305,0,0,91,11305,0.046830000,1.9434
144.75.218.242,<->,8.222.218.207,91,10983,0,0,91,10983,0.022196000,1.9668
204.114.166.12,<->,92.27.219.133,0,0,90,4746,90,4746,0.121285000,1.8013
133.178.227.143,<->,89.207.131.9,89,56889,0,0,89,56889,0.005498000,1.9627
92.27.219.165,<->,6.211.193.169,88,36560,0,0,88,36560,0.048729000,1.9480
141.37.255.242,<->,8.228.214.124,0,0,88,128304,88,128304,0.001026000,1.9978
210.221.110.77,<->,114.186.59.195,87,119382,0,0,87,119382,0.376816000,1.5877
120.221.207.133,<->,92.27.27.164,0,0,87,111304,87,111304,0.033640000,1.7968
103.164.140.56,<->,92.27.219.220,0,0,86,11310,86,11310,0.342100000,1.5562
113.108.161.158,<->,92.27.27.142,0,0,85,123845,85,123845,0.263029000,1.7168
111.161.94.38,<->,92.27.219.226,0,0,85,67077,85,67077,0.086605000,1.8823
230.102.130.52,<->,133.178.227.192,0,0,81,30635,81,30635,0.053179000,1.9424
230.102.130.22,<->,133.178.227.200,0,0,80,61882,80,61882,0.029645000,1.9503
204.131.179.159,<->,39.15.146.228,0,0,79,9596,79,9596,0.074676000,1.7273
223.143.15.189,<->,92.27.27.165,0,0,78,114660,78,114660,0.212845000,1.3017
223.138.87.163,<->,89.183.104.175,0,0,78,4170,78,4170,0.185415000,1.6680
89.183.104.243,<->,42.27.151.57,77,4799,0,0,77,4799,0.028416000,1.9570
144.75.218.246,<->,8.222.218.199,77,9701,0,0,77,9701,0.021688000,1.9199
201.67.203.4,<->,109.112.164.42,0,0,74,9400,74,9400,0.104665000,1.8627
144.93.121.10,<->,130.42.61.8,71,14484,0,0,71,14484,0.304881000,1.6782
109.1.45.197,<->,99.167.41.210,67,11936,0,0,67,11936,0.016779000,1.9793
230.102.130.14,<->,133.178.227.198,0,0,67,20592,67,20592,0.000400000,1.9991
146.188.124.240,<->,39.23.131.210,0,0,66,4030,66,4030,1.944340000,0.0517
92.27.27.185,<->,27.233.131.196,66,3943,0,0,66,3943,0.078802000,1.6807
224.250.33.165,<->,109.222.230.140,0,0,64,18634,64,18634,0.014003000,1.9515
217.48.45.61,<->,109.222.212.23,0,0,64,67028,64,67028,0.013661000,1.9801
89.183.104.233,<->,42.145.216.142,63,88981,0,0,63,88981,0.275654000,1.7000
121.209.129.56,<->,97.126.89.196,0,0,63,91192,63,91192,0.022373000,1.9384
144.70.194.19,<->,107.127.56.45,62,12632,0,0,62,12632,0.038739000,1.9464
144.75.218.237,<->,8.222.218.198,62,7585,0,0,62,7585,0.031651000,1.9457
92.28.243.121,<->,80.41.50.144,0,0,62,72447,62,72447,0.022882000,1.9101
207.178.235.42,<->,102.50.97.18,0,0,62,62341,62,62341,0.008476000,1.9907
218.113.73.124,<->,109.222.221.183,0,0,62,3100,62,3100,0.001178000,1.9714
98.128.99.20,<->,92.27.209.220,0,0,61,7967,61,7967,0.018947000,1.9524
144.75.218.237,<->,8.222.218.204,61,7497,0,0,61,7497,0.005727000,1.9794
158.10.218.189,<->,92.27.219.33,0,0,60,15230,60,15230,0.225141000,1.6779
192.64.227.200,<->,0.239.41.218,60,3414,0,0,60,3414,0.113670000,1.8328
92.27.27.165,<->,8.229.117.238,60,90240,0,0,60,90240,0.081566000,1.8529
247.136.136.4,<->,109.110.71.152,60,85040,0,0,60,85040,0.077890000,1.8656
144.79.8.124,<->,92.27.219.243,0,0,60,40355,60,40355,0.022155000,1.9696
116.92.246.189,<->,92.27.219.207,0,0,59,3068,59,3068,0.110482000,1.4687
92.27.219.139,<->,8.163.119.245,59,87320,0,0,59,87320,0.053491000,1.9379
144.75.218.233,<->,8.222.218.204,59,7342,0,0,59,7342,0.022204000,1.9678
117.73.204.10,<->,80.41.58.244,0,0,59,7112,59,7112,0.013080000,1.9523
215.158.238.153,<->,122.158.69.69,59,25826,0,0,59,25826,0.012355000,1.9834
127.101.167.95,<->,89.183.104.147,0,0,59,83472,59,83472,0.007190000,1.9813
122.140.135.247,<->,89.183.104.135,0,0,58,3058,58,3058,0.099621000,1.7454
246.253.253.211,<->,143.120.91.175,58,8738,0,0,58,8738,0.086423000,1.9019
103.248.168.73,<->,92.27.209.222,0,0,58,7532,58,7532,0.009390000,1.9875
220.18.60.199,<->,92.27.209.213,0,0,57,7061,57,7061,0.033653000,1.9470
210.221.109.12,<->,60.100.96.242,57,10392,0,0,57,10392,0.003766000,1.9676
144.75.218.237,<->,120.155.84.97,56,8591,0,0,56,8591,0.012610000,1.9771
92.42.46.202,<->,92.27.209.220,0,0,56,7436,56,7436,0.009826000,1.9837
97.120.1.114,<->,92.27.209.212,0,0,56,6633,56,6633,0.009033000,1.9863
92.27.209.173,<->,82.155.227.130,55,8112,0,0,55,8112,0.024845000,1.9703
222.12.110.202,<->,92.27.209.213,0,0,55,6246,55,6246,0.023981000,1.9509
230.102.130.22,<->,133.178.227.216,0,0,55,16191,55,16191,0.019502000,1.9601
144.75.218.237,<->,8.222.218.207,55,6981,0,0,55,6981,0.018862000,1.9730
230.102.130.20,<->,133.178.227.200,0,0,55,36324,55,36324,0.013446000,1.9480
103.6.186.36,<->,92.27.209.217,0,0,55,6404,55,6404,0.009975000,1.9500
247.136.187.136,<->,110.85.114.41,54,2808,0,0,54,2808,0.958450000,1.0177
116.74.122.224,<->,92.27.27.175,0,0,54,2958,54,2958,0.196163000,1.6581
92.27.209.115,<->,92.2.166.138,54,6048,0,0,54,6048,0.025765000,1.9520
110.88.88.65,<->,92.27.209.213,0,0,54,8701,54,8701,0.010973000,1.9580
89.183.104.234,<->,42.64.170.221,53,79712,0,0,53,79712,0.064467000,1.9151
108.38.132.20,<->,92.27.209.140,0,0,53,7088,53,7088,0.029269000,1.9654
226.61.137.133,<->,92.27.209.217,0,0,53,6861,53,6861,0.026502000,1.9480
80.40.59.129,<->,42.189.76.202,52,67942,0,0,52,67942,0.093338000,1.7391
144.75.218.235,<->,8.222.218.204,52,6314,0,0,52,6314,0.056269000,1.7796
121.14.135.231,<->,109.1.15.193,0,0,52,73604,52,73604,0.034397000,1.9550
110.50.143.159,<->,92.27.209.140,0,0,52,7584,52,7584,0.016999000,1.9505
247.157.15.209,<->,215.158.215.54,52,20270,0,0,52,20270,0.008978000,1.9899
144.75.218.237,<->,8.222.218.197,51,6488,0,0,51,6488,0.092605000,1.8364
192.67.152.25,<->,98.23.121.94,51,18639,0,0,51,18639,0.041236000,1.9466
220.55.175.209,<->,159.46.22.47,50,6688,0,0,50,6688,0.002166000,1.9744
144.75.218.233,<->,8.222.218.197,49,6149,0,0,49,6149,0.025189000,1.9699
113.172.47.6,<->,92.27.219.203,0,0,48,2730,48,2730,0.339407000,1.4879
152.12.3.191,<->,92.27.219.165,0,0,48,2496,48,2496,0.110922000,1.7280
109.1.15.193,<->,33.57.74.137,48,70560,0,0,48,70560,0.044918000,1.9455
220.55.171.232,<->,124.224.212.254,48,4728,0,0,48,4728,0.002313000,1.9650
144.75.218.242,<->,8.222.218.196,47,5734,0,0,47,5734,0.017012000,1.9162
215.158.238.86,<->,59.158.157.234,47,19521,0,0,47,19521,0.013114000,1.9467
247.136.131.28,<->,205.8.173.220,46,6375,0,0,46,6375,0.036277000,1.9380
144.75.218.235,<->,8.222.218.198,46,5971,0,0,46,5971,0.022601000,1.9656
144.75.218.233,<->,8.222.218.196,46,5772,0,0,46,5772,0.019775000,1.9375
144.75.218.241,<->,8.222.218.204,46,5624,0,0,46,5624,0.017776000,1.9726
247.136.133.229,<->,116.249.165.54,46,2470,0,0,46,2470,0.008993000,1.9454
192.67.159.55,<->,118.69.159.68,45,3630,0,0,45,3630,0.146766000,1.7931
247.136.250.58,<->,117.130.91.228,45,65520,0,0,45,65520,0.128981000,1.5018
144.75.218.242,<->,8.222.218.204,45,5779,0,0,45,5779,0.058270000,1.8966
144.75.218.237,<->,8.222.218.199,44,5534,0,0,44,5534,0.112456000,1.7620
247.136.147.198,<->,127.162.74.46,44,64680,0,0,44,64680,0.058562000,1.6511
220.87.124.222,<->,215.158.2.89,44,10752,0,0,44,10752,0.013697000,1.9198
159.224.11.110,<->,111.146.157.33,0,0,43,14508,43,14508,0.198541000,1.7775
108.39.7.100,<->,77.28.69.25,43,4767,0,0,43,4767,0.027568000,1.9432
100.110.50.212,<->,92.27.209.217,0,0,42,5202,42,5202,0.110862000,1.8383
119.250.57.185,<->,92.27.219.154,0,0,42,61740,42,61740,0.033998000,1.9197
144.75.218.241,<->,8.222.218.196,42,5328,0,0,42,5328,0.033101000,1.8938
144.75.218.241,<->,120.155.84.97,42,6595,0,0,42,6595,0.019852000,1.9697
230.102.130.54,<->,133.178.227.207,0,0,42,8722,42,8722,0.012647000,1.9398
198.249.136.154,<->,92.27.219.19,0,0,42,39632,42,39632,0.003629000,1.5169
57.203.86.245,<->,0.195.210.12,0,0,40,19943,40,19943,0.194542000,1.7379
136.25.188.27,<->,98.191.25.119,39,54159,0,0,39,54159,0.226153000,1.5620
115.85.99.120,<->,109.222.212.23,0,0,39,55752,39,55752,0.099191000,1.8207
204.19.149.79,<->,102.50.97.18,0,0,39,34109,39,34109,0.041394000,1.7306
144.75.218.235,<->,8.222.218.197,38,4611,0,0,38,4611,0.040374000,1.8502
252.98.149.196,<->,198.8.144.150,38,9222,0,0,38,9222,0.013297000,1.9799
230.102.130.22,<->,133.178.227.192,0,0,37,10951,37,10951,0.044820000,1.9288
114.48.32.71,<->,101.70.183.44,0,0,36,5488,36,5488,0.072078000,1.9273
107.19.40.128,<->,92.27.219.197,0,0,36,16324,36,16324,0.065685000,1.9203
117.156.242.240,<->,100.94.188.95,0,0,36,6415,36,6415,0.016437000,1.9776
102.28.84.233,<->,22.59.8.111,0,0,36,3835,36,3835,0.009681000,1.4859
206.69.16.143,<->,89.183.104.165,0,0,35,49590,35,49590,0.217881000,1.7736
92.27.219.225,<->,27.79.198.231,35,2347,0,0,35,2347,0.107910000,1.8518
197.108.9.58,<->,109.1.0.79,0,0,35,1820,35,1820,0.063395000,1.8930
106.209.215.4,<->,80.42.159.46,0,0,35,1922,35,1922,0.048031000,1.8955
69.93.67.175,<->,0.195.210.15,0,0,35,6762,35,6762,0.033132000,1.9299
146.188.27.11,<->,0.195.210.15,0,0,35,6140,35,6140,0.018878000,1.8646
204.47.12.101,<->,100.93.156.90,0,0,34,2078,34,2078,0.487461000,1.3344
89.183.104.136,<->,59.145.64.89,34,30282,0,0,34,30282,0.148757000,1.8385
110.3.31.65,<->,92.27.219.230,0,0,34,1768,34,1768,0.106923000,1.6766
197.199.10.134,<->,196.148.128.241,0,0,34,3426,34,3426,0.014096000,1.7155
249.129.136.212,<->,111.151.139.247,34,15166,0,0,34,15166,0.013941000,1.9505
158.85.62.215,<->,133.178.227.201,0,0,34,12606,34,12606,0.012222000,1.9828
137.170.13.105,<->,101.123.188.42,0,0,34,7898,34,7898,0.011923000,1.9836
247.136.146.184,<->,112.99.239.91,34,1802,0,0,34,1802,0.010335000,1.9365
198.196.107.83,<->,92.27.219.172,0,0,33,48510,33,48510,0.127089000,1.8713
89.183.104.148,<->,48.111.159.80,33,45674,0,0,33,45674,0.068648000,1.8009
158.85.62.216,<->,133.178.227.200,0,0,33,10423,33,10423,0.053552000,1.9200
89.183.104.232,<->,27.75.29.116,33,24899,0,0,33,24899,0.025874000,1.9720
108.39.75.243,<->,0.195.194.241,33,8660,0,0,33,8660,0.002603000,1.9824
215.158.66.187,<->,133.178.227.201,0,0,32,20023,32,20023,0.970227000,0.4228
192.64.227.64,<->,115.48.155.17,32,1712,0,0,32,1712,0.118303000,1.6632
122.202.156.172,<->,92.27.219.184,0,0,32,2079,32,2079,0.039954000,1.8593
111.151.139.254,<->,8.176.8.218,0,0,32,14642,32,14642,0.031381000,1.8292
117.9.179.125,<->,89.183.104.186,0,0,32,1820,32,1820,0.007750000,1.8656
195.109.248.194,<->,99.72.8.232,0,0,31,4506,31,4506,0.874077000,1.1082
114.51.67.67,<->,89.183.104.158,0,0,31,45167,31,45167,0.038503000,1.9315
112.176.7.240,<->,56.121.40.204,0,0,31,45570,31,45570,0.036012000,1.9404
145.89.157.16,<->,66.47.246.227,30,3932,0,0,30,3932,0.024428000,1.9705
102.51.166.249,<->,27.13.158.158,30,1645,0,0,30,1645,0.019718000,1.9021
113.97.200.242,<->,98.67.154.28,0,0,30,4006,30,4006,0.005186000,1.8519
92.27.219.148,<->,6.10.112.30,29,1670,0,0,29,1670,0.447779000,1.4434
121.64.198.129,<->,92.27.219.228,0,0,29,1508,29,1508,0.073173000,1.6707
125.194.228.63,<->,92.27.27.175,0,0,29,1508,29,1508,0.071841000,1.9016
204.92.39.211,<->,100.95.177.132,0,0,29,35540,29,35540,0.050302000,1.9307
114.68.69.205,<->,80.42.149.110,0,0,28,42112,28,42112,1.495617000,0.4942
104.136.21.135,<->,99.73.221.249,0,0,28,2895,28,2895,0.192580000,1.7810
137.170.13.110,<->,109.222.196.120,0,0,27,18479,27,18479,0.152987000,1.8096
149.110.222.182,<->,22.59.8.111,0,0,27,3011,27,3011,0.131743000,1.8676
136.25.188.42,<->,122.158.176.131,27,12663,0,0,27,12663,0.003186000,1.9887
101.106.122.69,<->,92.27.219.49,0,0,26,7230,26,7230,0.890714000,0.9753
115.170.189.64,<->,80.42.175.248,0,0,26,26885,26,26885,0.163557000,1.7903
65.26.114.146,<->,8.252.221.79,0,0,26,6298,26,6298,0.053302000,1.9377
215.158.140.214,<->,122.158.69.2,26,10931,0,0,26,10931,0.001027000,1.9560
205.150.176.250,<->,109.222.254.165,0,0,25,1334,25,1334,0.663611000,1.2344
229.69.240.213,<->,80.41.35.54,0,0,25,1776,25,1776,0.223692000,1.3647
98.67.144.152,<->,75.211.26.129,25,1250,0,0,25,1250,0.184524000,1.7902
247.136.177.71,<->,124.8.194.202,23,1282,0,0,23,1282,0.430728000,1.5315
92.27.219.36,<->,0.244.115.75,23,32982,0,0,23,32982,0.101382000,1.8957
111.151.139.139,<->,8.176.8.93,0,0,23,10836,23,10836,0.094901000,1.8853
125.9.106.97,<->,109.1.17.245,0,0,23,1334,23,1334,0.056086000,1.8929
136.25.188.105,<->,135.88.171.34,23,5276,0,0,23,5276,0.017994000,1.9527
192.64.219.151,<->,48.106.195.65,23,1208,0,0,23,1208,0.000079000,1.9818
200.226.80.179,<->,129.92.113.143,0,0,22,1100,22,1100,0.276439000,1.4226
195.120.129.171,<->,99.75.125.132,0,0,22,1144,22,1144,0.134814000,1.7746
119.238.208.112,<->,109.222.251.151,0,0,22,1289,22,1289,0.023816000,1.8070
92.27.219.241,<->,40.213.57.116,22,1276,0,0,22,1276,0.008020000,1.8363
125.181.234.162,<->,89.183.104.230,0,0,21,1104,21,1104,0.939663000,0.9710
140.136.9.105,<->,136.25.188.105,0,0,21,4640,21,4640,0.164620000,1.6491
125.3.248.172,<->,80.41.18.181,0,0,21,29452,21,29452,0.154441000,1.6603
92.27.27.183,<->,76.178.137.163,21,1092,0,0,21,1092,0.124174000,1.6102
80.42.164.116,<->,33.57.78.82,21,28034,0,0,21,28034,0.119700000,1.7643
121.139.59.102,<->,101.224.167.97,0,0,21,2274,21,2274,0.084958000,1.7490
105.155.60.93,<->,92.27.219.175,0,0,21,30492,21,30492,0.005625000,1.9932
215.158.140.216,<->,111.151.139.154,20,7864,0,0,20,7864,0.341674000,1.6145
226.68.196.218,<->,111.181.114.114,0,0,20,13556,20,13556,0.335775000,1.3800
114.216.173.200,<->,92.27.219.51,0,0,20,20380,20,20380,0.030272000,1.9330
132.249.70.233,<->,91.54.155.124,20,1566,0,0,20,1566,0.025713000,1.6966
136.25.188.105,<->,132.5.71.202,20,4415,0,0,20,4415,0.023821000,1.8538
104.70.118.211,<->,89.183.104.237,0,0,19,8716,19,8716,0.117226000,1.8519
126.88.32.178,<->,92.27.219.212,0,0,19,13242,19,13242,0.100154000,1.7433
138.112.247.164,<->,39.15.146.228,0,0,19,20412,19,20412,0.020455000,1.6541
192.67.129.30,<->,121.42.178.118,18,23624,0,0,18,23624,1.495758000,0.4895
123.129.231.146,<->,92.27.219.242,0,0,18,1010,18,1010,0.286823000,1.4219
101.70.127.226,<->,83.155.125.5,18,2208,0,0,18,2208,0.049054000,1.9044
92.27.27.150,<->,29.162.32.50,18,936,0,0,18,936,0.013959000,1.5665
232.111.67.19,<->,192.64.201.167,0,0,17,3508,17,3508,1.026628000,0.6710
247.136.231.91,<->,125.207.62.135,17,902,0,0,17,902,0.172823000,1.1582
159.36.241.98,<->,92.27.219.243,0,0,17,8185,17,8185,0.141603000,1.8430
103.154.12.2,<->,92.27.27.186,0,0,17,2309,17,2309,0.090916000,1.6342
111.151.139.139,<->,8.252.221.226,0,0,17,6310,17,6310,0.040258000,1.9564
214.245.140.57,<->,50.224.118.88,0,0,17,938,17,938,0.032028000,1.4720
111.151.139.138,<->,8.252.221.214,0,0,17,6310,17,6310,0.029612000,1.9564
92.27.219.147,<->,57.240.3.219,17,19123,0,0,17,19123,0.025848000,1.3837
206.17.241.68,<->,80.40.50.117,0,0,17,884,17,884,0.022751000,0.7182
120.114.211.51,<->,89.183.104.172,0,0,17,986,17,986,0.005636000,1.9105
92.27.219.54,<->,88.5.223.142,16,1583,0,0,16,1583,0.137071000,1.7143
111.20.172.70,<->,33.233.141.71,0,0,16,1827,16,1827,0.107015000,1.0074
126.223.18.230,<->,92.27.219.247,0,0,16,1073,16,1073,0.104769000,1.8095
207.117.160.72,<->,100.93.89.174,0,0,16,896,16,896,0.061927000,1.9055
130.217.163.17,<->,92.27.219.171,0,0,16,22891,16,22891,0.052071000,1.8801
120.193.155.221,<->,101.224.174.212,0,0,16,2055,16,2055,0.004688000,1.7525
106.149.129.48,<->,89.183.104.152,0,0,15,21855,15,21855,0.739426000,0.8782
99.251.31.170,<->,92.27.219.165,0,0,15,3594,15,3594,0.449175000,1.4126
92.27.219.143,<->,4.111.14.19,15,798,0,0,15,798,0.186142000,1.6501
200.175.234.79,<->,50.189.172.216,15,19302,0,0,15,19302,0.101063000,1.4480
197.45.74.148,<->,89.183.104.147,0,0,15,22050,15,22050,0.026869000,1.8635
118.221.45.56,<->,89.183.104.174,0,0,15,786,15,786,0.017909000,1.8553
192.64.223.86,<->,117.84.5.182,15,870,0,0,15,870,0.016930000,1.8764
192.67.176.153,<->,122.127.16.36,15,780,0,0,15,780,0.015260000,1.8021
215.158.140.136,<->,139.252.1.230,14,2282,0,0,14,2282,1.753935000,0.0033
223.141.212.240,<->,39.54.1.198,0,0,14,859,14,859,1.283440000,0.7107
101.70.118.35,<->,100.53.195.10,14,700,0,0,14,700,0.704514000,1.2425
105.65.117.137,<->,92.27.27.174,0,0,14,17744,14,17744,0.443902000,1.1441
119.126.161.254,<->,92.27.27.99,0,0,14,17125,14,17125,0.228385000,0.7626
136.25.188.105,<->,128.243.151.33,14,3072,0,0,14,3072,0.217492000,1.5153
121.210.96.252,<->,92.27.219.181,0,0,14,17528,14,17528,0.100861000,1.8224
111.20.172.70,<->,111.20.168.23,0,0,14,1681,14,1681,0.057990000,1.0616
117.166.148.72,<->,92.27.219.219,0,0,14,799,14,799,0.004270000,1.6243
107.8.60.69,<->,92.27.219.204,0,0,14,18551,14,18551,0.000765000,1.0508
192.67.167.86,<->,111.82.148.238,13,1349,0,0,13,1349,0.879175000,1.1164
218.4.168.98,<->,121.211.58.14,13,17692,0,0,13,17692,0.387532000,1.0199
92.27.219.217,<->,38.84.57.194,13,15440,0,0,13,15440,0.353117000,1.6318
89.183.104.252,<->,33.57.79.43,13,9328,0,0,13,9328,0.270361000,1.6904
220.55.175.209,<->,98.102.221.116,13,936,0,0,13,936,0.202574000,1.7520
125.24.121.131,<->,80.40.41.27,0,0,13,809,13,809,0.172836000,1.6697
152.11.225.23,<->,92.27.27.143,0,0,13,718,13,718,0.160645000,1.8170
104.139.44.208,<->,100.92.65.165,0,0,13,676,13,676,0.095045000,1.4171
111.20.172.70,<->,33.233.141.101,0,0,13,1890,13,1890,0.082950000,1.0135
205.254.139.169,<->,109.1.35.93,0,0,13,1240,13,1240,0.060612000,1.8872
92.27.27.145,<->,48.109.16.112,13,15724,0,0,13,15724,0.052430000,0.9103
132.249.70.233,<->,53.201.149.31,13,1131,0,0,13,1131,0.010478000,1.7934
104.149.211.148,<->,80.40.13.234,0,0,12,658,12,658,0.783984000,1.1439
207.198.85.65,<->,89.183.104.224,0,0,12,653,12,653,0.322046000,1.6035
136.25.188.43,<->,59.158.157.233,12,5093,0,0,12,5093,0.271454000,1.6812
112.158.194.201,<->,89.183.104.136,0,0,12,17021,12,17021,0.242411000,0.1978
136.25.188.105,<->,129.70.124.49,12,2495,0,0,12,2495,0.174587000,1.7274
246.253.253.207,<->,142.178.23.162,12,3644,0,0,12,3644,0.149740000,1.7915
194.214.160.24,<->,92.27.219.201,0,0,12,15110,12,15110,0.148515000,1.8287
230.95.240.156,<->,6.228.37.66,0,0,12,624,12,624,0.136359000,1.6988
111.20.172.70,<->,111.20.168.4,0,0,12,1784,12,1784,0.116496000,1.0029
109.1.39.166,<->,54.92.206.16,12,633,0,0,12,633,0.065768000,1.8659
111.20.172.70,<->,33.233.141.15,0,0,12,1485,12,1485,0.056932000,0.9998
104.39.26.5,<->,92.27.219.207,0,0,12,624,12,624,0.056169000,1.7689
113.79.203.253,<->,80.42.175.248,0,0,12,624,12,624,0.038983000,1.8655
100.94.114.216,<->,6.242.28.74,11,641,0,0,11,641,0.403473000,1.5778
92.27.27.163,<->,33.57.77.133,11,1566,0,0,11,1566,0.261281000,1.6139
246.253.253.207,<->,207.83.100.194,11,3119,0,0,11,3119,0.220921000,1.6425
215.158.238.200,<->,122.158.69.2,11,12232,0,0,11,12232,0.174375000,1.2393
204.44.84.191,<->,102.50.97.18,0,0,11,572,11,572,0.159183000,1.7759
215.158.239.102,<->,122.158.176.233,11,4553,0,0,11,4553,0.132974000,1.6493
125.59.16.30,<->,80.41.51.34,0,0,11,638,11,638,0.106040000,1.2930
111.20.172.70,<->,33.233.141.57,0,0,11,1361,11,1361,0.104782000,1.0059
111.20.172.70,<->,111.20.168.157,0,0,11,1480,11,1480,0.098826000,1.0029
111.20.172.70,<->,111.20.168.144,0,0,11,1473,11,1473,0.074827000,1.0152
247.136.177.71,<->,124.9.21.238,11,833,0,0,11,833,0.071456000,1.7884
143.194.53.201,<->,136.25.188.105,0,0,11,2568,11,2568,0.063677000,1.5885
192.67.159.55,<->,88.152.234.41,10,520,0,0,10,520,1.334886000,0.6220
207.46.243.242,<->,92.27.219.39,0,0,10,11088,10,11088,1.048080000,0.9449
92.27.27.174,<->,18.200.16.20,10,526,0,0,10,526,0.638330000,1.2800
109.1.51.20,<->,40.215.63.180,10,622,0,0,10,622,0.565370000,0.9533
92.27.27.173,<->,48.111.250.235,10,520,0,0,10,520,0.525636000,1.3517
143.88.15.116,<->,133.178.227.200,0,0,10,1344,10,1344,0.442866000,1.2617
246.253.253.208,<->,194.195.11.79,10,2210,0,0,10,2210,0.298494000,1.1089
89.183.109.183,<->,6.251.66.197,10,576,0,0,10,576,0.255095000,1.6442
205.186.190.236,<->,92.27.27.146,0,0,10,1714,10,1714,0.254926000,1.5306
247.136.240.193,<->,229.69.132.202,10,520,0,0,10,520,0.230000000,1.3909
111.20.172.70,<->,33.233.141.49,0,0,10,1268,10,1268,0.115871000,1.0082
111.20.172.70,<->,101.224.89.129,0,0,10,1422,10,1422,0.106184000,1.0021
111.20.172.70,<->,111.20.168.3,0,0,10,1293,10,1293,0.105196000,0.0157
111.20.172.70,<->,33.233.141.62,0,0,10,1259,10,1259,0.102877000,1.0117
127.13.41.126,<->,80.42.175.248,0,0,10,520,10,520,0.092987000,1.6524
134.53.24.179,<->,89.183.104.144,0,0,10,1554,10,1554,0.090550000,1.4070
247.136.205.189,<->,118.244.125.226,10,560,0,0,10,560,0.075578000,0.7905
111.20.172.70,<->,33.233.141.21,0,0,10,1263,10,1263,0.069996000,1.0047
192.67.128.252,<->,29.196.111.121,10,580,0,0,10,580,0.067606000,1.5625
111.20.172.70,<->,111.20.168.11,0,0,10,1631,10,1631,0.063087000,1.0151
111.20.172.70,<->,111.20.168.6,0,0,10,1380,10,1380,0.060557000,1.0161
113.224.216.39,<->,92.27.219.21,0,0,10,617,10,617,0.057150000,1.7630
122.158.69.68,<->,97.126.31.73,0,0,10,3703,10,3703,0.034010000,1.7922
247.136.177.100,<->,110.46.216.59,10,1400,0,0,10,1400,0.028931000,1.8312
195.106.14.119,<->,92.27.219.34,0,0,10,3330,10,3330,0.012610000,1.7662
138.127.224.166,<->,136.25.188.35,0,0,9,2532,9,2532,1.132240000,0.0059
122.212.152.132,<->,92.27.219.175,0,0,9,12888,9,12888,1.069877000,0.9157
8.252.221.97,<->,8.240.125.171,9,1364,0,0,9,1364,0.985460000,0.9964
225.3.225.27,<->,92.27.27.174,0,0,9,13122,9,13122,0.843434000,1.0925
215.158.195.26,<->,122.158.69.2,9,10008,0,0,9,10008,0.835458000,0.1893
89.158.50.248,<->,48.53.141.23,0,0,9,8981,9,8981,0.620636000,1.1253
89.183.104.247,<->,66.13.105.220,9,585,0,0,9,585,0.620326000,1.0263
144.76.43.245,<->,80.56.78.128,0,0,9,954,9,954,0.482413000,1.4667
192.67.167.86,<->,92.18.173.95,9,705,0,0,9,705,0.327427000,1.1326
122.143.169.253,<->,92.27.219.201,0,0,9,12485,9,12485,0.303954000,0.8233
138.98.157.180,<->,33.250.67.227,9,1044,0,0,9,1044,0.282285000,1.5657
80.42.175.248,<->,57.37.120.78,9,1201,0,0,9,1201,0.263080000,1.0566
133.178.227.215,<->,69.31.239.89,9,1200,0,0,9,1200,0.240585000,0.4134
247.136.136.53,<->,110.2.33.25,9,2847,0,0,9,2847,0.198831000,1.7713
143.159.235.195,<->,89.183.104.232,0,0,9,7498,9,7498,0.178429000,0.3526
235.67.254.158,<->,92.27.219.28,0,0,9,468,9,468,0.126578000,1.7587
111.20.172.70,<->,33.233.141.120,0,0,9,1337,9,1337,0.119657000,1.0048
111.20.172.70,<->,101.224.89.134,0,0,9,1147,9,1147,0.117913000,1.0060
111.20.172.70,<->,33.233.141.80,0,0,9,1116,9,1116,0.115960000,1.0033
111.20.172.70,<->,33.233.141.28,0,0,9,1204,9,1204,0.114617000,1.0074
111.20.172.70,<->,33.233.141.123,0,0,9,1267,9,1267,0.107616000,1.0018
111.20.172.70,<->,33.233.141.59,0,0,9,1279,9,1279,0.104369000,1.0115
111.20.172.70,<->,33.233.141.102,0,0,9,1266,9,1266,0.095885000,1.0013
115.51.254.30,<->,92.27.219.171,0,0,9,3290,9,3290,0.081420000,1.4692
232.31.73.213,<->,220.55.174.143,0,0,9,470,9,470,0.075010000,1.8901
136.25.188.105,<->,132.43.156.81,9,2207,0,0,9,2207,0.045652000,1.9332
192.67.174.99,<->,0.204.192.239,9,1104,0,0,9,1104,0.029522000,1.9274
210.221.109.17,<->,122.253.169.56,9,13230,0,0,9,13230,0.012630000,1.9863
111.20.172.70,<->,111.20.168.22,0,0,9,1110,9,1110,0.008912000,1.9910
215.158.238.200,<->,80.56.91.244,8,8896,0,0,8,8896,1.513717000,0.0001
136.41.13.4,<->,110.69.249.11,8,497,0,0,8,497,1.416436000,0.1166
138.127.224.225,<->,33.233.141.2,0,0,8,1936,8,1936,1.070473000,0.0056
111.20.172.70,<->,111.20.168.139,0,0,8,1016,8,1016,0.979436000,1.0123
134.21.115.23,<->,109.1.40.226,0,0,8,1093,8,1093,0.873528000,0.8604
92.27.219.22,<->,18.203.68.39,8,432,0,0,8,432,0.798312000,0.4649
159.133.254.197,<->,89.183.104.156,0,0,8,7836,8,7836,0.775465000,0.9993
92.27.27.145,<->,72.150.20.100,8,416,0,0,8,416,0.764186000,1.1100
246.253.253.211,<->,204.90.4.135,8,1016,0,0,8,1016,0.739532000,1.0465
114.196.95.169,<->,92.27.27.169,0,0,8,416,8,416,0.506954000,0.9205
92.27.219.169,<->,88.152.222.126,8,422,0,0,8,422,0.433901000,1.4975
247.136.217.189,<->,125.16.198.1,8,464,0,0,8,464,0.411759000,1.4831
133.178.227.214,<->,8.240.125.163,8,1192,0,0,8,1192,0.391031000,1.5850
207.12.103.185,<->,92.27.27.176,0,0,8,451,8,451,0.360372000,1.3911
119.71.114.135,<->,92.27.219.137,0,0,8,6256,8,6256,0.340111000,1.5634
192.64.202.30,<->,38.84.41.144,8,434,0,0,8,434,0.213320000,1.3750
113.191.253.140,<->,89.183.104.150,0,0,8,1294,8,1294,0.211114000,0.6676
121.52.54.249,<->,92.27.219.169,0,0,8,11760,8,11760,0.188894000,1.7060
133.252.163.90,<->,80.41.46.191,0,0,8,1034,8,1034,0.172619000,1.8271
118.202.255.160,<->,80.41.15.57,0,0,8,902,8,902,0.155734000,1.5684
104.158.138.181,<->,89.183.104.172,0,0,8,2320,8,2320,0.151781000,0.5711
89.183.104.170,<->,18.202.108.16,8,434,0,0,8,434,0.116772000,1.8168
111.20.172.70,<->,33.233.141.19,0,0,8,1112,8,1112,0.111631000,1.0003
111.20.172.70,<->,33.233.141.24,0,0,8,952,8,952,0.106753000,1.0041
111.20.172.70,<->,101.224.89.154,0,0,8,709,8,709,0.106704000,0.9927
109.81.202.72,<->,32.167.157.157,8,576,0,0,8,576,0.106486000,1.7255
195.70.106.235,<->,92.27.219.171,0,0,8,844,8,844,0.102563000,0.8865
111.20.172.70,<->,101.224.89.161,0,0,8,911,8,911,0.102257000,1.0131
111.20.172.70,<->,101.224.89.145,0,0,8,890,8,890,0.102097000,1.0091
111.20.172.70,<->,33.233.141.88,0,0,8,1281,8,1281,0.101943000,1.0033
92.27.219.217,<->,6.248.194.160,8,8220,0,0,8,8220,0.093467000,1.8423
111.20.172.70,<->,101.224.89.243,0,0,8,918,8,918,0.080919000,1.0100
111.20.172.70,<->,111.20.168.2,0,0,8,931,8,931,0.075077000,0.9956
111.20.172.70,<->,101.224.89.133,0,0,8,1056,8,1056,0.071131000,1.0033
123.228.59.190,<->,80.42.159.46,0,0,8,442,8,442,0.061483000,1.4096
92.27.219.142,<->,42.204.158.155,8,9820,0,0,8,9820,0.057683000,1.4833
230.72.92.160,<->,8.238.225.188,0,0,8,8000,8,8000,0.025560000,1.3849
247.136.217.189,<->,38.69.117.31,8,1293,0,0,8,1293,0.022554000,1.6044
89.183.104.130,<->,75.94.225.251,8,10344,0,0,8,10344,0.008654000,1.9745
111.20.172.70,<->,33.233.141.53,0,0,8,1036,8,1036,0.001231000,1.9980
139.241.115.221,<->,29.211.214.254,0,0,7,582,7,582,1.780564000,0.0321
192.64.246.197,<->,33.78.194.97,7,1261,0,0,7,1261,1.391083000,0.5201
87.9.72.93,<->,80.42.175.248,0,0,7,364,7,364,1.239198000,0.5001
129.224.112.252,<->,92.160.15.146,7,541,0,0,7,541,1.109436000,0.0050
144.122.240.217,<->,144.108.64.184,7,481,0,0,7,481,1.043337000,0.0138
144.122.240.192,<->,144.108.64.184,7,462,0,0,7,462,1.034341000,0.0132
111.20.172.70,<->,33.233.141.31,0,0,7,902,7,902,0.981099000,1.0094
118.208.11.148,<->,89.183.104.245,0,0,7,9856,7,9856,0.802822000,0.2424
198.100.2.208,<->,89.183.104.167,0,0,7,706,7,706,0.753297000,1.2116
89.183.104.189,<->,83.7.230.68,7,1731,0,0,7,1731,0.390351000,1.2315
125.196.62.17,<->,89.183.104.167,0,0,7,10199,7,10199,0.298389000,0.5393
248.232.242.136,<->,92.27.219.61,0,0,7,1771,7,1771,0.270964000,1.5584
102.81.45.53,<->,92.27.219.129,0,0,7,1059,7,1059,0.258793000,0.1443
215.158.49.10,<->,29.211.214.254,0,0,7,560,7,560,0.223269000,0.0110
192.67.144.149,<->,68.227.84.215,7,5980,0,0,7,5980,0.215681000,1.7445
229.61.242.186,<->,92.27.219.181,0,0,7,364,7,364,0.200962000,1.7017
119.70.121.138,<->,92.27.27.161,0,0,7,379,7,379,0.191419000,1.6643
194.169.242.51,<->,92.27.27.158,0,0,7,364,7,364,0.176923000,1.4980
137.170.13.106,<->,82.237.234.119,0,0,7,1403,7,1403,0.174879000,1.5909
144.75.218.246,<->,132.200.124.228,7,1352,0,0,7,1352,0.140683000,1.5070
247.136.136.13,<->,127.93.47.235,7,394,0,0,7,394,0.136755000,1.1362
111.20.172.70,<->,33.233.141.94,0,0,7,882,7,882,0.115257000,1.0016
111.20.172.70,<->,33.233.141.96,0,0,7,879,7,879,0.113889000,1.0029
111.20.172.70,<->,111.20.168.12,0,0,7,866,7,866,0.111186000,1.0071
111.20.172.70,<->,33.233.141.84,0,0,7,1012,7,1012,0.107831000,1.0042
111.20.172.70,<->,33.233.141.52,0,0,7,759,7,759,0.105886000,0.9993
111.20.172.70,<->,111.20.168.27,0,0,7,878,7,878,0.101806000,1.0042
111.20.172.70,<->,33.233.141.97,0,0,7,911,7,911,0.100757000,1.0060
156.164.19.175,<->,92.27.219.217,0,0,7,10290,7,10290,0.099651000,1.6660
92.181.56.219,<->,59.36.39.14,7,626,0,0,7,626,0.098990000,1.0025
125.50.212.165,<->,80.40.9.90,0,0,7,364,7,364,0.096842000,1.6101
111.20.172.70,<->,111.20.168.141,0,0,7,857,7,857,0.091194000,1.0123
111.20.172.70,<->,33.233.141.30,0,0,7,911,7,911,0.060314000,1.0220
103.250.23.108,<->,80.40.50.197,0,0,7,793,7,793,0.059447000,0.5408
129.236.111.48,<->,129.224.112.252,0,0,7,535,7,535,0.059411000,0.0134
117.35.5.6,<->,92.27.219.150,0,0,7,6309,7,6309,0.051068000,1.6493
111.20.172.70,<->,101.224.89.158,0,0,7,822,7,822,0.034050000,1.9614
220.82.24.60,<->,198.196.222.46,7,1214,0,0,7,1214,0.020597000,1.9193
127.86.88.161,<->,80.41.12.225,0,0,7,1241,7,1241,0.018838000,0.4874
111.20.172.70,<->,101.224.89.225,0,0,7,852,7,852,0.010975000,1.9865
98.236.206.251,<->,84.202.238.91,7,1757,0,0,7,1757,0.003551000,1.9400
111.20.172.70,<->,33.233.141.83,0,0,7,1004,7,1004,0.000282000,1.9978
145.23.212.61,<->,80.40.0.124,0,0,6,808,6,808,1.707783000,0.1454
111.20.172.70,<->,101.224.89.162,0,0,6,784,6,784,1.001236000,0.9917
111.20.172.70,<->,101.224.89.224,0,0,6,949,6,949,0.991406000,1.0036
111.20.172.70,<->,33.233.141.29,0,0,6,943,6,943,0.986838000,1.0024
144.76.43.246,<->,80.56.78.128,0,0,6,622,6,622,0.906443000,1.0000
101.117.57.49,<->,92.27.219.56,0,0,6,1310,6,1310,0.823245000,0.9827
42.197.80.101,<->,20.194.211.253,0,0,6,848,6,848,0.672956000,0.0712
137.132.207.124,<->,132.49.148.23,0,0,6,5120,6,5120,0.672113000,0.7609
110.85.216.27,<->,89.183.104.137,0,0,6,1230,6,1230,0.672089000,0.7339
144.75.218.235,<->,99.168.7.150,6,846,0,0,6,846,0.611779000,0.6927
149.91.110.39,<->,92.27.219.52,0,0,6,974,6,974,0.600815000,0.9301
135.204.166.170,<->,133.178.227.198,0,0,6,816,6,816,0.508972000,1.1240
143.252.64.234,<->,129.224.112.252,0,0,6,420,6,420,0.507997000,1.3755
118.234.243.5,<->,92.27.27.160,0,0,6,330,6,330,0.505506000,1.1784
108.39.122.228,<->,89.183.104.152,0,0,6,830,6,830,0.415202000,1.5390
123.215.22.204,<->,80.42.189.6,0,0,6,2430,6,2430,0.384704000,1.5623
206.23.120.250,<->,80.40.10.148,0,0,6,944,6,944,0.381866000,0.4606
215.158.140.149,<->,122.158.69.2,6,6672,0,0,6,6672,0.370604000,1.0881
89.183.104.255,<->,78.49.6.7,6,329,0,0,6,329,0.351341000,1.5686
143.252.64.224,<->,129.224.112.252,0,0,6,404,6,404,0.328182000,1.4281
127.107.255.141,<->,89.183.104.238,0,0,6,8538,6,8538,0.290255000,1.1034
255.29.52.48,<->,97.168.79.200,0,0,6,1032,6,1032,0.281333000,1.4849
192.64.222.13,<->,93.161.230.56,6,348,0,0,6,348,0.259752000,1.5003
136.129.20.230,<->,75.94.112.195,6,964,0,0,6,964,0.214878000,1.1429
229.96.187.56,<->,92.27.219.205,0,0,6,3232,6,3232,0.177495000,1.6759
247.136.136.112,<->,110.61.185.178,6,668,0,0,6,668,0.171202000,0.1939
50.224.118.88,<->,27.11.131.168,6,344,0,0,6,344,0.168345000,1.6331
89.139.247.130,<->,50.224.72.13,0,0,6,1171,6,1171,0.149997000,1.5391
207.13.138.222,<->,92.27.27.158,0,0,6,312,6,312,0.140128000,1.5675
111.20.172.70,<->,101.224.89.128,0,0,6,797,6,797,0.122025000,1.0148
104.14.70.23,<->,92.27.219.251,0,0,6,5928,6,5928,0.120841000,0.7686
111.20.172.70,<->,33.233.141.90,0,0,6,689,6,689,0.116839000,0.9987
111.20.172.70,<->,33.233.141.93,0,0,6,850,6,850,0.116113000,1.0071
111.20.172.70,<->,101.224.89.247,0,0,6,842,6,842,0.112813000,1.0042
111.20.172.70,<->,111.20.168.8,0,0,6,801,6,801,0.111169000,1.0042
111.20.172.70,<->,33.233.141.27,0,0,6,797,6,797,0.109156000,0.9982
111.20.172.70,<->,101.224.89.144,0,0,6,768,6,768,0.108675000,1.0047
111.20.172.70,<->,33.233.141.103,0,0,6,795,6,795,0.105906000,1.0082
111.20.172.70,<->,33.233.141.61,0,0,6,909,6,909,0.101170000,1.0048
111.20.172.70,<->,111.20.168.58,0,0,6,776,6,776,0.100594000,1.0036
205.188.191.243,<->,92.27.219.168,0,0,6,312,6,312,0.099703000,1.6822
111.20.172.70,<->,111.20.168.20,0,0,6,880,6,880,0.090531000,1.0002
111.20.172.70,<->,111.20.168.143,0,0,6,826,6,826,0.087604000,1.0004
111.20.172.70,<->,33.233.141.104,0,0,6,718,6,718,0.085303000,1.0103
111.20.172.70,<->,111.20.168.14,0,0,6,881,6,881,0.085263000,1.0049
202.163.117.156,<->,89.183.104.145,0,0,6,5928,6,5928,0.083990000,1.8356
111.20.172.70,<->,33.233.141.121,0,0,6,752,6,752,0.083176000,1.0063
111.20.172.70,<->,111.20.168.1,0,0,6,744,6,744,0.069045000,0.9948
89.183.104.185,<->,33.245.119.91,6,348,0,0,6,348,0.067468000,1.7681
111.20.172.70,<->,33.233.141.91,0,0,6,941,6,941,0.058438000,1.0653
111.20.172.70,<->,33.233.141.25,0,0,6,749,6,749,0.052817000,1.9416
141.204.123.255,<->,136.25.188.105,0,0,6,760,6,760,0.047390000,1.6834
111.20.172.70,<->,101.224.89.132,0,0,6,756,6,756,0.047128000,1.9519
92.27.219.36,<->,60.99.160.252,6,4566,0,0,6,4566,0.037116000,1.8688
145.129.249.172,<->,138.98.233.50,0,0,6,1483,6,1483,0.016385000,1.9518
117.4.7.176,<->,111.146.152.238,0,0,6,980,6,980,0.013532000,0.2636
246.253.253.210,<->,196.20.252.209,6,990,0,0,6,990,0.004442000,1.7291
93.141.161.227,<->,92.27.219.43,0,0,6,8688,6,8688,0.003427000,1.4970
117.128.153.245,<->,92.27.219.178,0,0,6,4692,6,4692,0.002881000,1.7458
108.8.186.194,<->,101.235.70.72,0,0,6,1717,6,1717,0.000844000,0.4848
145.255.180.193,<->,144.75.218.235,0,0,5,875,5,875,1.720958000,0.1493
215.158.140.235,<->,122.158.176.235,5,7496,0,0,5,7496,1.712289000,0.0135
133.178.226.212,<->,122.158.176.156,5,7496,0,0,5,7496,1.702169000,0.0135
109.1.54.101,<->,80.243.150.152,5,944,0,0,5,944,1.684804000,0.2015
133.178.226.173,<->,111.151.139.138,5,7496,0,0,5,7496,1.629522000,0.0139
112.28.115.238,<->,89.183.104.173,0,0,5,260,5,260,1.622756000,0.3769
109.1.54.101,<->,101.143.64.164,5,1046,0,0,5,1046,1.578396000,0.2726
93.66.55.106,<->,80.40.25.242,0,0,5,715,5,715,1.485566000,0.4768
194.210.255.197,<->,80.42.168.206,0,0,5,269,5,269,1.340762000,0.0396
115.59.77.95,<->,92.27.27.150,0,0,5,260,5,260,1.276471000,0.1579
198.253.49.109,<->,92.27.27.184,0,0,5,572,5,572,1.275038000,0.3821
92.27.27.182,<->,57.68.48.112,5,654,0,0,5,654,1.250788000,0.7066
109.1.54.101,<->,92.36.36.224,5,823,0,0,5,823,1.237740000,0.1849
192.171.13.189,<->,8.252.222.18,0,0,5,689,5,689,1.104538000,0.0070
247.136.139.37,<->,148.43.230.154,5,255,0,0,5,255,1.024940000,0.8985
111.20.172.70,<->,111.20.168.156,0,0,5,681,5,681,0.977964000,1.0028
100.92.103.47,<->,38.17.171.70,5,869,0,0,5,869,0.896077000,0.9995
80.40.12.180,<->,33.78.85.2,5,277,0,0,5,277,0.889104000,0.1256
111.89.77.172,<->,109.222.241.62,0,0,5,276,5,276,0.859338000,0.0714
125.42.173.70,<->,109.1.54.101,0,0,5,1208,5,1208,0.843715000,0.2996
132.168.196.9,<->,33.240.77.13,5,681,0,0,5,681,0.839124000,1.1391
125.5.234.225,<->,80.40.61.86,0,0,5,7280,5,7280,0.736508000,1.2615
92.27.27.162,<->,32.215.241.105,5,508,0,0,5,508,0.666286000,0.0120
143.184.207.146,<->,92.27.219.192,0,0,5,290,5,290,0.599440000,0.9188
148.158.222.19,<->,129.224.112.252,0,0,5,339,5,339,0.580088000,1.1773
129.78.114.107,<->,119.94.225.50,5,726,0,0,5,726,0.572544000,0.0182
89.183.104.145,<->,78.55.252.81,5,404,0,0,5,404,0.540357000,1.1479
144.76.43.242,<->,80.56.78.128,0,0,5,519,5,519,0.532063000,0.6605
194.195.244.244,<->,102.51.189.86,0,0,5,328,5,328,0.515267000,1.3054
144.75.218.241,<->,99.168.7.150,5,693,0,0,5,693,0.510215000,0.9665
205.81.149.14,<->,92.27.219.139,0,0,5,992,5,992,0.501474000,0.9944
234.127.80.157,<->,109.222.251.106,0,0,5,311,5,311,0.470397000,0.5273
79.20.59.166,<->,66.14.88.15,0,0,5,1524,5,1524,0.407189000,1.1885
121.205.145.177,<->,92.27.27.99,0,0,5,1148,5,1148,0.404061000,1.2729
136.25.188.105,<->,128.243.151.35,5,1055,0,0,5,1055,0.369315000,1.5177
92.27.219.165,<->,88.45.20.228,5,1668,0,0,5,1668,0.354749000,1.0274
215.158.140.216,<->,59.158.143.25,5,1750,0,0,5,1750,0.324729000,1.4627
230.75.129.225,<->,102.83.184.157,0,0,5,483,5,483,0.318152000,0.4537
247.136.154.209,<->,38.93.215.114,5,266,0,0,5,266,0.306989000,0.4220
134.150.68.36,<->,80.41.35.54,0,0,5,260,5,260,0.282625000,1.6939
112.109.177.35,<->,92.27.219.243,0,0,5,4584,5,4584,0.241158000,1.5808
92.27.219.149,<->,57.3.164.69,5,7170,0,0,5,7170,0.189244000,0.0520
206.17.243.41,<->,109.1.54.101,0,0,5,766,5,766,0.162415000,1.3270
149.230.23.62,<->,89.183.104.243,0,0,5,5634,5,5634,0.157956000,1.3013
144.75.218.237,<->,138.127.224.104,5,1595,0,0,5,1595,0.149357000,1.5499
247.136.227.198,<->,98.181.20.37,5,1378,0,0,5,1378,0.148459000,0.2708
106.145.155.77,<->,92.27.27.181,0,0,5,433,5,433,0.146727000,0.3695
192.64.211.88,<->,118.85.247.93,5,260,0,0,5,260,0.145952000,1.2755
113.192.25.253,<->,92.27.219.32,0,0,5,600,5,600,0.140448000,1.6832
247.136.177.71,<->,42.36.26.179,5,1164,0,0,5,1164,0.123536000,0.8800
89.183.104.174,<->,78.48.176.130,5,371,0,0,5,371,0.118573000,1.5801
111.20.172.70,<->,111.20.168.154,0,0,5,587,5,587,0.113913000,1.0066
111.20.172.70,<->,111.20.168.13,0,0,5,561,5,561,0.112079000,1.0031
111.20.172.70,<->,33.233.141.26,0,0,5,702,5,702,0.111477000,0.0099
140.145.218.36,<->,133.178.227.217,0,0,5,672,5,672,0.110957000,0.2170
111.20.172.70,<->,111.20.168.142,0,0,5,728,5,728,0.106959000,0.9976
111.20.172.70,<->,111.20.168.21,0,0,5,706,5,706,0.103646000,0.9996
111.20.172.70,<->,33.233.141.50,0,0,5,760,5,760,0.098940000,0.9945
129.236.64.94,<->,129.224.112.252,0,0,5,400,5,400,0.097103000,0.0247
111.20.172.70,<->,33.233.141.47,0,0,5,564,5,564,0.090463000,0.9990
111.20.172.70,<->,33.233.141.81,0,0,5,545,5,545,0.088920000,0.9956
92.27.219.39,<->,78.45.201.41,5,519,0,0,5,519,0.085005000,1.5710
129.236.100.161,<->,129.224.112.252,0,0,5,378,5,378,0.083453000,0.0206
111.20.172.70,<->,101.224.89.136,0,0,5,556,5,556,0.083157000,1.0098
192.64.204.68,<->,125.37.55.102,5,888,0,0,5,888,0.077160000,1.1679
122.192.58.162,<->,92.27.219.178,0,0,5,5884,5,5884,0.076650000,1.8552
144.75.218.242,<->,99.168.7.150,5,651,0,0,5,651,0.076605000,1.7410
111.20.172.70,<->,33.233.141.70,0,0,5,684,5,684,0.075567000,1.1132
142.174.222.235,<->,102.50.179.199,0,0,5,342,5,342,0.074199000,1.8782
80.40.50.197,<->,33.198.250.108,5,1250,0,0,5,1250,0.065819000,1.6180
141.95.30.9,<->,129.224.112.252,0,0,5,375,5,375,0.065295000,1.8118
111.20.172.70,<->,33.233.141.89,0,0,5,644,5,644,0.065259000,1.0264
138.127.224.225,<->,111.20.168.215,0,0,5,1200,5,1200,0.051636000,0.0116
129.236.64.99,<->,129.224.112.252,0,0,5,386,5,386,0.050127000,0.0395
104.142.182.228,<->,102.51.211.141,0,0,5,651,5,651,0.029915000,0.4117
138.127.224.225,<->,33.233.141.41,0,0,5,1199,5,1199,0.028981000,0.0064
93.251.237.157,<->,92.27.219.191,0,0,5,513,5,513,0.018371000,0.8637
97.68.226.205,<->,56.61.99.23,5,430,0,0,5,430,0.013396000,1.6978
247.136.231.91,<->,110.73.45.161,5,503,0,0,5,503,0.012680000,0.6985
66.217.128.239,<->,50.128.183.47,0,0,5,485,5,485,0.008961000,0.2418
195.1.112.76,<->,91.231.193.172,0,0,5,250,5,250,0.007343000,1.9827
98.217.2.71,<->,77.41.75.13,5,314,0,0,5,314,0.004788000,1.3341
210.220.219.152,<->,53.149.143.243,4,1968,0,0,4,1968,1.872277000,0.0849
215.158.66.184,<->,8.252.221.80,0,0,4,584,4,584,1.859238000,0.0608
119.69.154.213,<->,92.27.219.229,0,0,4,4244,4,4244,1.857164000,0.0288
198.107.230.163,<->,99.73.153.222,0,0,4,498,4,498,1.833386000,0.1595
80.56.91.244,<->,8.252.221.215,0,0,4,4448,4,4448,1.687858000,0.2428
144.76.46.38,<->,100.95.88.249,0,0,4,520,4,520,1.596944000,0.0209
215.158.66.185,<->,133.178.227.200,0,0,4,508,4,508,1.554251000,0.0022
220.6.163.23,<->,92.27.219.142,0,0,4,740,4,740,1.509367000,0.3400
218.4.180.210,<->,115.80.7.174,4,428,0,0,4,428,1.358539000,0.6279
192.64.255.44,<->,112.96.179.64,4,276,0,0,4,276,1.290140000,0.5703
144.75.218.242,<->,138.127.225.15,4,1050,0,0,4,1050,1.120352000,0.6390
111.20.172.70,<->,33.233.141.56,0,0,4,481,4,481,1.087217000,0.0078
111.20.172.70,<->,101.224.89.138,0,0,4,451,4,451,1.075461000,0.0053
138.127.224.225,<->,101.224.89.178,0,0,4,980,4,980,1.063352000,0.0052
111.20.172.70,<->,33.233.141.95,0,0,4,601,4,601,1.035138000,0.0293
138.127.224.225,<->,33.233.141.107,0,0,4,976,4,976,1.031343000,0.0121
200.174.217.111,<->,6.188.163.28,4,592,0,0,4,592,0.995578000,0.9333
114.251.126.39,<->,92.27.209.193,0,0,4,200,4,200,0.972973000,0.4664
139.248.201.139,<->,50.200.173.137,4,320,0,0,4,320,0.919139000,0.1138
89.183.104.172,<->,78.44.243.152,4,693,0,0,4,693,0.885326000,1.0065
220.187.80.11,<->,92.27.27.173,0,0,4,628,4,628,0.855550000,0.7116
159.146.67.44,<->,111.147.178.69,0,0,4,364,4,364,0.839808000,0.6987
126.102.186.4,<->,8.228.215.123,0,0,4,489,4,489,0.804751000,1.1265
144.75.218.246,<->,138.127.225.148,4,1464,0,0,4,1464,0.784830000,1.0474
109.222.208.215,<->,93.196.138.15,4,240,0,0,4,240,0.757548000,1.0821
207.125.234.7,<->,22.59.4.26,0,0,4,200,4,200,0.752427000,1.2002
149.178.48.72,<->,129.224.112.252,0,0,4,305,4,305,0.733130000,0.8158
113.246.46.33,<->,92.27.219.211,0,0,4,708,4,708,0.721380000,0.7848
80.40.50.197,<->,29.156.85.9,4,1372,0,0,4,1372,0.703444000,1.1615
247.136.181.127,<->,27.160.143.95,4,200,0,0,4,200,0.701450000,1.2080
215.158.66.193,<->,8.252.221.76,0,0,4,508,4,508,0.683165000,0.0018
195.111.188.39,<->,91.231.193.172,0,0,4,200,4,200,0.682276000,1.2581
92.27.27.153,<->,40.210.30.180,4,802,0,0,4,802,0.665055000,0.4361
132.43.156.54,<->,80.38.56.151,0,0,4,2698,4,2698,0.640883000,1.0748
252.72.196.66,<->,27.160.143.95,4,200,0,0,4,200,0.609187000,1.0967
97.183.216.230,<->,92.27.226.86,4,320,0,0,4,320,0.581311000,0.1644
195.56.26.110,<->,92.27.234.141,0,0,4,200,4,200,0.572221000,1.0176
215.158.103.206,<->,129.220.171.193,4,3021,0,0,4,3021,0.555711000,0.8886
92.180.56.187,<->,22.59.5.231,0,0,4,200,4,200,0.543349000,1.2357
99.75.122.192,<->,92.27.4.178,4,5880,0,0,4,5880,0.539949000,1.0402
207.1.199.234,<->,92.27.234.141,0,0,4,200,4,200,0.527775000,1.0944
82.135.81.66,<->,22.59.5.231,0,0,4,200,4,200,0.508028000,1.1998
246.253.238.229,<->,207.88.23.78,4,304,0,0,4,304,0.486972000,0.0003
92.27.219.176,<->,29.239.238.231,4,208,0,0,4,208,0.474879000,0.9757
199.102.232.92,<->,92.27.219.230,0,0,4,208,4,208,0.452884000,1.3635
192.80.230.86,<->,145.242.126.88,0,0,4,3189,4,3189,0.444416000,1.1369
121.215.124.71,<->,89.183.109.183,0,0,4,200,4,200,0.427778000,1.1402
89.183.110.5,<->,6.16.149.123,4,559,0,0,4,559,0.426670000,1.4367
92.27.219.169,<->,78.46.152.207,4,260,0,0,4,260,0.402961000,1.1739
92.181.136.240,<->,22.59.6.26,0,0,4,200,4,200,0.375560000,1.3600
192.64.224.151,<->,74.172.3.5,4,532,0,0,4,532,0.372015000,1.3282
196.148.128.9,<->,195.5.16.230,4,200,0,0,4,200,0.369153000,1.2281
207.79.207.171,<->,102.50.212.241,0,0,4,218,4,218,0.363501000,1.2630
237.33.122.147,<->,92.27.27.158,0,0,4,485,4,485,0.360669000,0.9830
119.253.25.166,<->,89.183.110.45,0,0,4,200,4,200,0.358157000,1.0611
111.151.139.235,<->,29.211.214.80,0,0,4,298,4,298,0.353042000,1.5031
194.194.3.109,<->,100.93.144.191,0,0,4,276,4,276,0.348739000,0.6922
142.104.79.22,<->,92.27.219.190,0,0,4,208,4,208,0.346826000,1.6411
207.235.120.66,<->,196.148.128.241,0,0,4,200,4,200,0.345324000,1.3240
119.52.114.180,<->,80.41.16.79,0,0,4,532,4,532,0.339498000,1.0511
200.175.231.151,<->,6.130.18.22,4,276,0,0,4,276,0.321010000,0.5980
98.23.118.150,<->,89.183.104.244,0,0,4,200,4,200,0.317638000,1.6008
144.75.218.233,<->,132.200.124.228,4,622,0,0,4,622,0.303775000,0.9796
210.221.111.77,<->,57.148.44.122,4,1626,0,0,4,1626,0.279456000,0.5004
111.146.248.83,<->,94.39.218.34,4,532,0,0,4,532,0.271166000,0.9038
92.27.234.6,<->,82.247.233.205,4,200,0,0,4,200,0.268649000,1.2621
192.67.168.13,<->,120.117.233.56,4,208,0,0,4,208,0.264115000,1.5795
92.27.27.175,<->,72.63.102.180,4,232,0,0,4,232,0.262341000,1.7028
192.64.200.73,<->,35.56.31.165,4,496,0,0,4,496,0.261816000,1.4403
119.70.246.26,<->,92.27.219.237,0,0,4,5880,4,5880,0.253093000,1.4670
132.168.196.9,<->,122.22.230.148,4,208,0,0,4,208,0.249148000,1.1128
110.247.87.162,<->,91.231.194.54,0,0,4,200,4,200,0.247656000,1.0637
207.196.145.247,<->,92.27.234.141,0,0,4,200,4,200,0.241946000,1.3134
114.60.0.6,<->,22.59.5.231,0,0,4,200,4,200,0.241221000,1.3875
92.27.209.212,<->,57.141.132.156,4,1560,0,0,4,1560,0.239280000,0.4295
207.197.78.90,<->,109.222.212.23,0,0,4,5736,4,5736,0.233934000,1.6851
92.27.27.177,<->,57.33.182.12,4,226,0,0,4,226,0.229670000,1.3630
157.208.232.75,<->,108.39.53.224,0,0,4,268,4,268,0.228090000,1.1264
88.61.181.164,<->,50.224.81.197,0,0,4,256,4,256,0.220446000,1.4995
119.230.159.211,<->,6.75.237.59,0,0,4,276,4,276,0.214845000,0.3527
215.158.238.155,<->,122.158.69.2,4,4448,0,0,4,4448,0.211951000,1.0054
215.158.239.67,<->,122.158.69.2,4,4448,0,0,4,4448,0.209107000,1.0072
205.109.5.113,<->,22.59.36.31,0,0,4,200,4,200,0.208925000,1.4464
238.155.239.157,<->,89.183.104.254,0,0,4,208,4,208,0.205749000,1.1725
195.3.157.138,<->,129.224.112.252,0,0,4,300,4,300,0.190164000,0.1530
132.20.222.234,<->,129.224.112.221,0,0,4,330,4,330,0.161544000,1.1624
144.75.218.241,<->,138.127.231.62,4,1151,0,0,4,1151,0.157811000,1.2003
247.136.180.232,<->,122.6.184.30,4,655,0,0,4,655,0.154912000,1.5941
247.136.250.194,<->,80.233.221.39,4,200,0,0,4,200,0.148998000,1.0874
111.20.172.70,<->,33.233.141.22,0,0,4,453,4,453,0.139033000,0.9794
144.75.218.233,<->,99.168.7.150,4,514,0,0,4,514,0.129456000,1.1318
111.20.172.70,<->,101.224.89.248,0,0,4,378,4,378,0.123191000,0.9931
138.73.126.183,<->,77.38.144.199,4,244,0,0,4,244,0.123107000,1.7345
192.171.13.33,<->,8.252.222.153,0,0,4,1318,4,1318,0.122333000,0.0040
136.25.188.105,<->,128.243.151.37,4,515,0,0,4,515,0.118671000,0.9002
111.20.172.70,<->,33.233.141.58,0,0,4,627,4,627,0.117829000,0.9931
111.151.107.247,<->,8.252.222.153,0,0,4,484,4,484,0.114185000,0.0044
210.156.94.131,<->,145.136.243.126,4,200,0,0,4,200,0.113143000,1.0143
111.20.172.70,<->,33.233.141.63,0,0,4,491,4,491,0.107297000,1.0090
97.198.121.42,<->,89.204.88.146,4,528,0,0,4,528,0.106889000,1.5003
111.20.172.70,<->,33.233.141.99,0,0,4,454,4,454,0.106537000,0.0097
129.236.100.135,<->,129.224.112.252,0,0,4,312,4,312,0.105386000,0.0194
111.20.172.70,<->,33.233.141.122,0,0,4,584,4,584,0.103107000,0.9977
111.20.172.70,<->,101.224.89.244,0,0,4,495,4,495,0.101191000,1.0056
243.49.232.125,<->,192.67.139.145,0,0,4,244,4,244,0.095152000,1.1851
139.114.208.34,<->,132.249.70.233,0,0,4,524,4,524,0.092258000,1.6750
111.20.172.70,<->,111.20.168.10,0,0,4,407,4,407,0.091042000,1.0094
205.25.24.107,<->,109.222.216.231,0,0,4,540,4,540,0.081656000,0.2676
111.20.172.70,<->,101.224.89.137,0,0,4,573,4,573,0.081489000,1.0081
226.36.140.164,<->,92.27.219.155,0,0,4,572,4,572,0.076814000,1.2759
112.13.158.155,<->,109.222.208.215,0,0,4,268,4,268,0.075687000,1.7752
222.5.185.61,<->,92.27.234.6,0,0,4,200,4,200,0.064496000,1.2361
125.161.178.229,<->,92.27.219.210,0,0,4,500,4,500,0.059136000,0.4679
196.148.131.53,<->,194.237.237.8,4,320,0,0,4,320,0.058804000,1.5369
129.224.112.252,<->,27.127.251.23,4,300,0,0,4,300,0.056570000,0.0039
111.20.172.70,<->,33.233.141.51,0,0,4,503,4,503,0.054004000,1.9455
92.27.219.17,<->,40.212.145.54,4,226,0,0,4,226,0.052527000,1.5125
129.224.112.252,<->,27.127.251.38,4,317,0,0,4,317,0.051388000,0.0055
236.137.155.115,<->,89.183.104.255,0,0,4,647,4,647,0.043367000,0.2952
92.27.219.171,<->,27.79.107.211,4,208,0,0,4,208,0.041658000,0.8643
196.20.139.86,<->,8.228.218.37,0,0,4,208,4,208,0.040999000,1.3351
103.135.210.152,<->,35.56.100.188,0,0,4,200,4,200,0.031394000,1.5937
138.127.224.225,<->,33.233.141.35,0,0,4,950,4,950,0.031367000,0.0069
99.162.71.215,<->,53.161.125.14,4,416,0,0,4,416,0.015738000,1.0255
207.199.23.163,<->,92.27.234.141,0,0,4,200,4,200,0.011764000,1.5296
80.41.32.57,<->,38.28.41.166,4,208,0,0,4,208,0.011443000,1.8742
92.27.209.103,<->,50.63.20.4,4,320,0,0,4,320,0.010861000,1.5149
144.75.218.246,<->,99.168.7.150,4,576,0,0,4,576,0.009720000,1.8031
104.125.215.35,<->,80.42.175.248,0,0,4,208,4,208,0.007313000,1.1163
249.113.218.249,<->,97.126.26.166,0,0,4,316,4,316,0.002056000,0.1994
158.27.166.9,<->,80.41.50.144,0,0,4,268,4,268,0.001807000,1.8007
138.127.224.225,<->,33.233.141.115,0,0,3,725,3,725,1.970842000,0.0065
133.178.227.222,<->,111.150.185.46,3,428,0,0,3,428,1.861924000,0.0000
133.178.227.207,<->,69.31.239.60,3,428,0,0,3,428,1.799003000,0.0000
136.25.188.37,<->,111.151.107.247,3,462,0,0,3,462,1.730031000,0.0215
136.25.189.52,<->,80.56.91.244,3,3336,0,0,3,3336,1.621547000,0.3110
122.34.74.206,<->,89.183.104.254,0,0,3,351,3,351,1.529692000,0.2779
144.75.218.246,<->,8.47.122.178,3,299,0,0,3,299,1.485713000,0.4336
98.23.111.141,<->,92.27.209.234,0,0,3,150,3,150,1.473897000,0.2812
113.13.87.152,<->,92.27.219.29,0,0,3,447,3,447,1.443051000,0.3990
110.108.83.73,<->,109.1.54.101,0,0,3,224,3,224,1.411150000,0.2081
133.178.226.212,<->,122.158.176.232,3,3336,0,0,3,3336,1.386140000,0.2407
139.36.49.54,<->,109.1.21.169,0,0,3,540,3,540,1.362786000,0.2402
144.75.218.235,<->,138.127.225.148,3,1098,0,0,3,1098,1.352877000,0.0713
119.213.189.67,<->,92.27.219.49,0,0,3,174,3,174,1.342489000,0.2820
144.75.218.242,<->,138.127.231.3,3,882,0,0,3,882,1.342456000,0.6203
80.40.1.230,<->,50.127.188.132,3,156,0,0,3,156,1.337776000,0.0620
92.27.219.42,<->,88.5.213.212,3,203,0,0,3,203,1.328412000,0.3965
125.20.85.151,<->,80.42.183.31,0,0,3,156,3,156,1.319791000,0.6133
92.170.252.152,<->,48.17.236.244,3,399,0,0,3,399,1.298990000,0.4691
133.178.226.66,<->,122.158.69.2,3,3336,0,0,3,3336,1.291794000,0.1608
121.205.33.55,<->,89.183.104.137,0,0,3,326,3,326,1.283132000,0.6219
115.179.195.96,<->,80.41.20.208,0,0,3,156,3,156,1.280126000,0.1744
215.158.2.83,<->,136.116.10.96,0,0,3,300,3,300,1.219191000,0.6574
138.127.224.192,<->,92.27.8.182,0,0,3,494,3,494,1.205340000,0.3322
92.27.219.148,<->,78.44.2.32,3,156,0,0,3,156,1.179551000,0.4170
59.32.3.196,<->,34.90.46.185,0,0,3,166,3,166,1.146773000,0.1292
144.75.218.237,<->,132.200.124.228,3,766,0,0,3,766,1.142493000,0.6044
89.183.104.251,<->,82.150.74.32,3,156,0,0,3,156,1.135395000,0.0880
144.75.218.237,<->,138.127.225.148,3,1087,0,0,3,1087,1.132978000,0.5619
125.211.116.201,<->,92.27.219.178,0,0,3,156,3,156,1.132180000,0.3817
235.38.54.55,<->,92.27.27.169,0,0,3,156,3,156,1.091307000,0.6078
148.180.169.155,<->,92.27.219.19,0,0,3,156,3,156,1.078302000,0.2427
192.171.13.35,<->,8.176.8.237,0,0,3,622,3,622,1.054663000,0.0037
138.127.224.225,<->,101.224.89.251,0,0,3,729,3,729,1.048089000,0.0010
129.224.112.252,<->,27.127.251.61,3,237,0,0,3,237,1.046781000,0.0057
129.224.112.252,<->,27.127.251.31,3,236,0,0,3,236,1.038191000,0.0075
97.223.146.236,<->,92.27.27.175,0,0,3,161,3,161,1.025077000,0.1414
138.127.224.225,<->,101.224.89.222,0,0,3,726,3,726,1.020792000,0.0040
247.136.154.209,<->,88.156.22.45,3,234,0,0,3,234,1.012043000,0.4902
193.23.0.8,<->,89.183.104.188,0,0,3,156,3,156,1.006680000,0.8609
89.183.104.188,<->,78.45.228.179,3,156,0,0,3,156,0.995465000,0.5989
111.20.172.70,<->,33.233.141.86,0,0,3,335,3,335,0.979061000,1.0016
116.146.253.37,<->,92.27.219.234,0,0,3,156,3,156,0.942837000,0.5610
204.34.19.221,<->,100.95.230.73,0,0,3,253,3,253,0.920228000,0.6262
92.27.219.190,<->,78.46.255.104,3,4290,0,0,3,4290,0.898022000,0.9008
102.244.221.223,<->,89.183.104.234,0,0,3,166,3,166,0.895138000,0.7007
80.42.183.31,<->,29.204.172.105,3,156,0,0,3,156,0.886357000,0.4216
194.208.223.87,<->,80.40.61.86,0,0,3,234,3,234,0.858951000,0.5938
144.75.218.235,<->,138.127.224.104,3,925,0,0,3,925,0.829832000,1.0844
246.253.253.207,<->,207.83.86.49,3,455,0,0,3,455,0.828564000,0.4127
146.188.154.183,<->,92.27.219.145,0,0,3,156,3,156,0.816519000,0.9594
206.216.71.6,<->,89.183.104.249,0,0,3,306,3,306,0.806255000,0.7619
144.75.218.242,<->,119.94.225.50,3,427,0,0,3,427,0.791022000,0.2801
192.171.13.35,<->,8.176.8.83,0,0,3,417,3,417,0.785293000,0.0039
144.75.218.246,<->,139.252.1.230,3,270,0,0,3,270,0.784360000,0.7503
192.64.212.179,<->,105.249.105.196,3,224,0,0,3,224,0.768615000,0.9036
139.81.45.38,<->,138.98.246.1,0,0,3,376,3,376,0.758964000,0.3724
144.75.218.242,<->,138.127.230.221,3,251,0,0,3,251,0.756403000,1.0568
122.140.81.210,<->,89.183.104.142,0,0,3,463,3,463,0.742669000,0.2534
152.1.121.89,<->,20.50.240.231,0,0,3,706,3,706,0.738709000,0.0996
129.224.112.252,<->,97.242.126.192,3,243,0,0,3,243,0.729628000,0.1725
192.64.211.88,<->,127.177.15.49,3,162,0,0,3,162,0.703835000,0.7095
203.135.215.71,<->,89.183.104.230,0,0,3,160,3,160,0.702933000,0.8029
195.3.157.139,<->,39.15.169.14,0,0,3,258,3,258,0.701423000,0.7696
204.140.159.18,<->,39.15.169.14,0,0,3,249,3,249,0.687785000,1.1550
126.88.138.182,<->,92.27.219.232,0,0,3,156,3,156,0.681467000,0.1961
92.27.219.214,<->,88.155.32.239,3,156,0,0,3,156,0.673871000,0.8394
246.253.253.210,<->,136.6.92.157,3,375,0,0,3,375,0.671792000,0.2173
130.37.102.18,<->,39.214.55.177,0,0,3,258,3,258,0.668142000,0.7502
200.174.129.238,<->,6.171.58.242,3,3177,0,0,3,3177,0.666628000,0.9080
92.27.219.131,<->,38.255.125.152,3,156,0,0,3,156,0.664774000,0.5149
192.67.143.198,<->,134.244.248.146,3,156,0,0,3,156,0.654945000,0.7010
104.54.63.97,<->,80.42.190.120,0,0,3,160,3,160,0.638642000,1.0038
220.55.75.167,<->,33.57.74.181,3,225,0,0,3,225,0.633817000,0.5861
192.171.13.80,<->,8.252.222.202,0,0,3,602,3,602,0.618141000,0.0345
92.27.219.229,<->,57.114.28.94,3,174,0,0,3,174,0.615530000,0.6955
136.25.189.5,<->,8.220.7.141,3,505,0,0,3,505,0.608602000,0.0089
101.235.76.65,<->,17.3.209.41,3,1527,0,0,3,1527,0.606724000,0.8295
120.248.160.71,<->,80.40.38.190,0,0,3,496,3,496,0.606687000,1.1620
144.75.218.246,<->,138.127.224.101,3,251,0,0,3,251,0.587240000,0.4347
109.222.246.106,<->,92.173.80.91,3,156,0,0,3,156,0.580618000,1.3570
57.209.136.82,<->,6.122.205.96,0,0,3,221,3,221,0.558846000,1.1543
144.75.218.246,<->,139.252.1.242,3,399,0,0,3,399,0.499818000,1.1754
48.53.210.97,<->,6.171.78.167,3,1689,0,0,3,1689,0.498104000,0.3361
158.15.212.118,<->,92.27.219.153,0,0,3,4221,3,4221,0.489300000,1.1580
119.117.27.67,<->,92.27.27.158,0,0,3,156,3,156,0.481450000,0.8788
206.57.21.191,<->,80.41.53.163,0,0,3,156,3,156,0.477288000,0.9360
98.242.57.201,<->,92.27.219.230,0,0,3,511,3,511,0.475164000,1.0140
136.25.188.105,<->,132.43.156.54,3,427,0,0,3,427,0.471595000,1.4672
133.24.118.119,<->,92.27.27.174,0,0,3,4512,3,4512,0.454327000,0.8795
98.236.122.10,<->,92.27.219.137,0,0,3,156,3,156,0.452768000,0.1352
109.1.9.150,<->,104.154.237.127,3,156,0,0,3,156,0.444840000,0.3040
109.1.54.101,<->,80.238.60.11,3,292,0,0,3,292,0.444809000,1.2787
92.27.219.178,<->,38.80.130.180,3,447,0,0,3,447,0.441906000,0.0063
93.142.250.183,<->,80.42.184.112,0,0,3,156,3,156,0.434955000,0.3999
80.40.2.168,<->,78.45.12.81,3,168,0,0,3,168,0.426336000,0.9784
142.218.110.190,<->,99.73.151.145,0,0,3,316,3,316,0.416756000,0.3774
144.75.218.233,<->,138.127.224.104,3,911,0,0,3,911,0.413898000,0.5374
206.102.5.199,<->,92.27.27.99,0,0,3,156,3,156,0.411097000,0.4139
215.158.103.219,<->,149.88.113.197,3,1632,0,0,3,1632,0.410845000,1.4995
192.64.248.242,<->,134.94.147.245,3,506,0,0,3,506,0.395465000,0.2796
207.178.152.255,<->,100.95.251.127,0,0,3,162,3,162,0.392007000,1.3508
222.20.200.135,<->,132.249.70.233,0,0,3,409,3,409,0.390009000,0.9599
206.195.145.185,<->,99.73.178.32,0,0,3,156,3,156,0.378603000,1.5521
210.156.216.109,<->,77.24.25.158,3,495,0,0,3,495,0.377028000,0.7406
98.67.155.63,<->,53.196.208.123,3,505,0,0,3,505,0.370642000,0.6932
215.158.239.105,<->,111.151.107.247,3,504,0,0,3,504,0.362580000,0.0197
247.136.136.112,<->,27.123.17.33,3,156,0,0,3,156,0.354707000,0.2854
39.22.29.188,<->,30.192.18.236,3,203,0,0,3,203,0.344247000,0.1269
126.196.222.83,<->,80.40.2.27,0,0,3,224,3,224,0.342741000,0.4057
110.57.3.72,<->,92.27.27.179,0,0,3,263,3,263,0.340488000,0.5034
100.208.13.217,<->,77.39.172.5,3,399,0,0,3,399,0.335106000,0.6727
123.163.186.237,<->,39.15.169.14,0,0,3,264,3,264,0.329713000,1.0138
159.115.14.88,<->,75.92.230.44,3,156,0,0,3,156,0.321472000,0.6422
158.28.223.211,<->,80.41.4.141,0,0,3,601,3,601,0.310050000,0.0998
121.204.206.54,<->,89.183.104.150,0,0,3,156,3,156,0.305907000,0.3319
149.178.48.81,<->,129.224.112.252,0,0,3,228,3,228,0.303296000,1.6768
215.158.103.206,<->,129.223.93.3,3,1917,0,0,3,1917,0.300709000,1.4799
92.27.219.222,<->,69.196.227.88,3,156,0,0,3,156,0.297768000,1.6858
215.158.103.219,<->,129.203.66.31,3,2100,0,0,3,2100,0.277150000,1.6209
144.75.218.235,<->,97.94.119.24,3,229,0,0,3,229,0.273519000,0.8246
120.241.71.24,<->,89.183.104.254,0,0,3,463,3,463,0.266385000,0.4188
117.242.104.229,<->,92.27.219.226,0,0,3,161,3,161,0.259620000,0.3761
200.174.211.210,<->,6.171.93.27,3,393,0,0,3,393,0.255042000,1.5809
89.183.104.245,<->,86.76.154.253,3,156,0,0,3,156,0.253971000,0.5031
92.27.219.240,<->,48.107.197.58,3,4410,0,0,3,4410,0.251884000,1.1488
117.6.108.183,<->,89.183.104.167,0,0,3,156,3,156,0.251737000,0.1228
145.19.9.66,<->,81.96.98.4,3,240,0,0,3,240,0.229797000,1.2411
92.27.219.180,<->,72.62.223.132,3,170,0,0,3,170,0.223184000,0.3787
92.27.219.238,<->,29.44.96.146,3,156,0,0,3,156,0.220858000,0.5448
207.79.157.237,<->,99.72.167.52,0,0,3,175,3,175,0.218059000,0.9135
33.124.235.126,<->,22.59.37.233,0,0,3,150,3,150,0.216193000,1.0013
144.75.218.235,<->,138.127.231.62,3,777,0,0,3,777,0.212886000,1.2414
92.181.148.15,<->,92.27.219.61,0,0,3,987,3,987,0.210369000,0.8640
118.100.76.40,<->,109.222.212.23,0,0,3,224,3,224,0.208381000,0.2157
121.10.132.194,<->,92.27.219.63,0,0,3,652,3,652,0.187079000,0.6152
194.193.197.231,<->,99.75.33.195,0,0,3,190,3,190,0.177300000,1.0216
192.67.139.145,<->,42.81.250.54,3,183,0,0,3,183,0.175744000,0.6573
139.128.242.158,<->,92.27.219.60,0,0,3,156,3,156,0.156105000,1.2967
92.27.27.174,<->,27.25.112.156,3,156,0,0,3,156,0.138397000,0.1764
205.188.162.40,<->,192.67.172.77,0,0,3,399,3,399,0.134751000,1.8345
111.20.172.70,<->,101.224.89.131,0,0,3,511,3,511,0.116477000,0.9996
111.20.172.70,<->,33.233.141.82,0,0,3,426,3,426,0.115919000,1.0033
111.20.172.70,<->,33.233.141.87,0,0,3,359,3,359,0.107429000,0.0089
115.86.156.192,<->,22.59.37.233,0,0,3,150,3,150,0.101065000,0.9984
215.158.140.111,<->,192.171.13.80,3,561,0,0,3,561,0.100052000,0.0095
104.40.239.30,<->,89.183.104.147,0,0,3,2531,3,2531,0.096431000,0.4440
144.122.240.201,<->,144.108.80.170,3,203,0,0,3,203,0.096151000,0.1238
111.20.172.70,<->,101.224.89.245,0,0,3,365,3,365,0.093516000,0.0065
135.79.232.55,<->,109.1.54.145,0,0,3,360,3,360,0.083059000,0.1006
145.216.238.18,<->,111.146.175.90,0,0,3,156,3,156,0.081616000,1.6182
192.171.13.80,<->,8.252.222.19,0,0,3,398,3,398,0.071127000,1.4250
111.20.172.70,<->,111.20.168.28,0,0,3,370,3,370,0.065236000,0.9985
118.209.199.81,<->,92.27.219.247,0,0,3,1011,3,1011,0.064541000,1.0466
193.1.1.67,<->,101.70.111.87,0,0,3,246,3,246,0.062990000,1.9284
148.155.129.25,<->,101.224.89.208,0,0,3,496,3,496,0.060302000,1.0016
138.127.224.225,<->,33.233.141.10,0,0,3,723,3,723,0.057477000,0.0045
230.60.74.150,<->,96.31.74.8,0,0,3,399,3,399,0.055423000,1.7190
102.244.195.51,<->,35.56.100.188,0,0,3,150,3,150,0.048812000,1.0001
192.64.200.112,<->,134.18.200.92,3,220,0,0,3,220,0.047836000,1.5874
148.198.183.187,<->,132.249.70.233,0,0,3,243,3,243,0.046223000,0.9694
138.127.224.225,<->,33.233.141.43,0,0,3,719,3,719,0.045797000,0.0047
210.221.111.77,<->,60.92.18.35,3,218,0,0,3,218,0.044636000,1.0334
109.1.54.101,<->,107.127.118.108,3,335,0,0,3,335,0.043610000,0.1121
138.127.224.225,<->,33.233.141.67,0,0,3,731,3,731,0.032296000,0.0056
129.224.112.252,<->,27.127.251.41,3,226,0,0,3,226,0.029777000,0.0073
220.55.79.118,<->,198.206.5.108,3,239,0,0,3,239,0.028942000,0.7540
194.194.227.156,<->,99.75.102.6,0,0,3,156,3,156,0.023264000,0.1900
138.127.224.225,<->,33.233.141.231,0,0,3,716,3,716,0.016276000,0.0044
192.138.215.26,<->,92.27.219.18,0,0,3,216,3,216,0.015708000,1.7450
206.62.58.105,<->,80.42.146.108,0,0,3,268,3,268,0.010322000,0.8226
144.122.240.212,<->,144.108.64.184,3,207,0,0,3,207,0.006316000,0.0112
159.194.94.44,<->,100.176.233.172,3,306,0,0,3,306,0.003799000,1.8859
247.136.139.100,<->,120.71.141.210,2,136,0,0,2,136,1.964191000,0.0338
113.199.186.37,<->,92.27.219.32,0,0,2,373,2,373,1.941625000,0.0167
92.27.219.224,<->,81.11.131.84,2,457,0,0,2,457,1.940251000,0.0201
215.158.140.84,<->,111.151.139.246,2,2224,0,0,2,2224,1.901690000,0.0804
111.151.139.246,<->,8.252.223.171,0,0,2,2224,2,2224,1.897446000,0.0771
97.126.26.71,<->,56.90.112.160,2,380,0,0,2,380,1.894396000,0.0044
192.227.190.250,<->,80.56.78.208,0,0,2,172,2,172,1.893608000,0.0108
246.252.97.167,<->,145.16.34.73,0,0,2,488,2,488,1.891321000,0.0690
111.151.139.246,<->,8.252.221.181,0,0,2,2224,2,2224,1.872122000,0.0658
111.151.139.246,<->,8.176.8.185,0,0,2,2224,2,2224,1.869929000,0.0638
247.136.165.38,<->,104.217.186.99,2,104,0,0,2,104,1.866732000,0.1105
111.151.139.246,<->,8.252.221.226,0,0,2,2224,2,2224,1.865133000,0.0602
111.147.103.177,<->,70.191.71.13,2,328,0,0,2,328,1.849525000,0.0922
144.111.184.84,<->,132.249.70.233,0,0,2,152,2,152,1.848624000,0.1276
93.221.37.138,<->,92.27.219.244,0,0,2,104,2,104,1.834387000,0.0895
158.13.202.176,<->,92.27.27.154,0,0,2,104,2,104,1.805091000,0.0336
159.69.187.46,<->,144.108.64.179,2,143,0,0,2,143,1.796074000,0.0619
101.106.122.69,<->,92.27.219.141,0,0,2,335,2,335,1.779677000,0.0898
192.67.183.227,<->,116.166.253.26,2,104,0,0,2,104,1.778409000,0.1037
247.136.169.35,<->,121.242.88.242,2,172,0,0,2,172,1.764348000,0.1344
192.64.217.166,<->,125.43.71.208,2,104,0,0,2,104,1.762949000,0.1540
109.222.246.106,<->,54.42.69.14,2,197,0,0,2,197,1.759436000,0.1450
145.99.95.239,<->,132.151.128.158,0,0,2,154,2,154,1.757541000,0.0033
144.75.218.246,<->,138.127.225.75,2,134,0,0,2,134,1.749200000,0.1034
205.80.53.82,<->,89.183.104.143,0,0,2,279,2,279,1.730323000,0.0650
192.67.146.69,<->,149.200.188.126,2,111,0,0,2,111,1.724981000,0.1115
48.53.19.217,<->,6.147.62.230,2,168,0,0,2,168,1.722406000,0.0060
141.204.123.242,<->,136.25.188.105,0,0,2,295,2,295,1.720492000,0.2710
207.3.85.49,<->,102.51.154.36,0,0,2,277,2,277,1.712290000,0.0000
132.60.99.180,<->,80.40.37.166,0,0,2,164,2,164,1.701106000,0.0832
210.158.44.36,<->,129.148.253.17,2,372,0,0,2,372,1.654401000,0.0080
254.242.186.155,<->,159.231.131.109,2,337,0,0,2,337,1.641164000,0.0627
134.245.141.254,<->,92.27.219.238,0,0,2,331,2,331,1.624335000,0.3126
100.93.247.0,<->,38.238.10.170,2,104,0,0,2,104,1.606926000,0.0000
144.75.218.241,<->,138.127.231.115,2,732,0,0,2,732,1.604013000,0.0179
113.38.212.89,<->,109.222.200.127,0,0,2,114,2,114,1.596830000,0.1625
192.171.13.189,<->,8.176.8.177,0,0,2,314,2,314,1.593707000,0.0020
192.64.235.214,<->,80.226.252.43,2,189,0,0,2,189,1.590977000,0.2104
80.41.58.237,<->,50.140.157.178,2,326,0,0,2,326,1.581614000,0.1402
144.75.218.233,<->,138.127.225.148,2,732,0,0,2,732,1.579600000,0.1434
98.23.111.141,<->,92.27.209.119,0,0,2,100,2,100,1.564636000,0.0000
98.23.111.141,<->,92.27.209.202,0,0,2,100,2,100,1.563251000,0.0000
143.46.12.204,<->,136.25.188.105,0,0,2,293,2,293,1.558270000,0.3668
129.224.112.252,<->,74.1.12.213,2,178,0,0,2,178,1.552751000,0.0112
192.64.245.156,<->,80.237.224.21,2,228,0,0,2,228,1.550408000,0.4039
249.101.84.15,<->,76.187.242.22,2,168,0,0,2,168,1.546525000,0.0000
246.253.253.208,<->,195.59.71.46,2,250,0,0,2,250,1.545489000,0.0000
144.69.82.139,<->,92.169.159.102,2,142,0,0,2,142,1.544996000,0.0338
132.249.70.213,<->,100.225.82.255,2,218,0,0,2,218,1.530531000,0.0081
136.41.13.4,<->,98.198.167.139,2,1466,0,0,2,1466,1.528992000,0.0004
144.64.139.146,<->,125.152.68.220,2,168,0,0,2,168,1.526143000,0.0697
134.198.171.8,<->,92.27.27.175,0,0,2,104,2,104,1.509140000,0.2526
198.146.30.172,<->,144.86.151.114,0,0,2,176,2,176,1.508228000,0.0031
102.224.165.182,<->,57.84.217.167,2,698,0,0,2,698,1.506948000,0.0160
156.143.11.242,<->,144.75.218.237,0,0,2,354,2,354,1.505740000,0.1518
247.136.181.26,<->,90.199.69.209,2,686,0,0,2,686,1.502756000,0.0202
98.23.111.141,<->,92.27.209.227,0,0,2,100,2,100,1.495960000,0.0000
119.94.225.50,<->,80.38.6.211,0,0,2,286,2,286,1.493146000,0.0200
115.170.240.204,<->,92.27.219.54,0,0,2,231,2,231,1.490828000,0.3283
234.182.169.148,<->,89.183.108.200,0,0,2,153,2,153,1.488569000,0.0225
98.23.111.141,<->,92.27.209.229,0,0,2,100,2,100,1.484833000,0.0000
210.156.34.185,<->,89.220.214.254,2,255,0,0,2,255,1.484334000,0.1256
131.233.164.64,<->,129.224.112.252,0,0,2,148,2,148,1.469069000,0.0073
200.174.199.176,<->,54.37.145.251,2,194,0,0,2,194,1.464965000,0.1034
220.55.96.152,<->,143.106.201.86,2,271,0,0,2,271,1.464918000,0.0106
92.27.219.244,<->,40.223.152.65,2,104,0,0,2,104,1.457341000,0.0992
80.125.16.180,<->,78.45.217.58,2,104,0,0,2,104,1.446919000,0.0337
215.158.239.231,<->,8.191.7.199,2,179,0,0,2,179,1.437110000,0.0002
248.225.25.172,<->,54.40.52.190,2,200,0,0,2,200,1.431706000,0.3226
196.148.133.194,<->,138.126.131.34,2,404,0,0,2,404,1.421496000,0.0005
159.69.187.1,<->,144.108.80.170,2,144,0,0,2,144,1.399843000,0.3822
53.187.78.215,<->,39.15.169.14,0,0,2,175,2,175,1.376946000,0.1996
159.69.187.49,<->,144.108.64.184,2,150,0,0,2,150,1.375024000,0.0133
139.252.1.217,<->,101.224.204.193,0,0,2,150,2,150,1.373404000,0.0991
136.41.13.4,<->,95.221.82.205,2,1480,0,0,2,1480,1.371261000,0.0000
144.76.42.211,<->,144.64.138.24,0,0,2,152,2,152,1.363963000,0.0409
207.212.200.80,<->,92.27.219.39,0,0,2,2210,2,2210,1.361721000,0.3370
144.75.218.237,<->,138.127.231.62,2,543,0,0,2,543,1.355770000,0.3295
129.224.112.252,<->,97.242.126.186,2,174,0,0,2,174,1.354836000,0.1236
120.83.73.157,<->,89.183.104.243,0,0,2,648,2,648,1.350146000,0.2006
145.213.37.27,<->,136.129.94.109,0,0,2,168,2,168,1.348700000,0.0374
80.15.90.172,<->,69.128.106.102,0,0,2,644,2,644,1.330992000,0.3200
144.69.82.139,<->,92.169.159.101,2,139,0,0,2,139,1.315791000,0.1394
144.75.218.237,<->,138.127.231.114,2,578,0,0,2,578,1.313639000,0.0893
222.79.118.35,<->,210.193.94.45,2,248,0,0,2,248,1.308363000,0.0204
148.187.166.178,<->,92.26.149.106,0,0,2,173,2,173,1.301337000,0.3046
148.155.129.25,<->,101.224.89.159,0,0,2,342,2,342,1.291120000,0.0055
149.224.49.236,<->,144.75.218.242,0,0,2,140,2,140,1.277672000,0.3424
144.122.240.237,<->,144.76.43.246,2,150,0,0,2,150,1.273889000,0.7132
215.158.103.219,<->,129.229.242.60,2,1584,0,0,2,1584,1.264612000,0.5418
144.75.218.237,<->,8.47.122.178,2,200,0,0,2,200,1.252654000,0.4671
247.136.201.118,<->,201.213.20.210,2,194,0,0,2,194,1.246736000,0.0678
144.75.218.246,<->,138.127.224.104,2,603,0,0,2,603,1.242806000,0.4517
192.171.13.189,<->,8.252.222.105,0,0,2,284,2,284,1.228442000,0.0016
192.178.173.46,<->,132.249.70.233,0,0,2,299,2,299,1.226714000,0.1030
143.252.64.230,<->,129.224.112.252,0,0,2,135,2,135,1.220833000,0.7253
129.224.112.252,<->,92.160.14.37,2,158,0,0,2,158,1.218894000,0.0036
246.253.253.208,<->,195.0.73.54,2,266,0,0,2,266,1.216497000,0.3425
145.213.37.26,<->,136.129.94.107,0,0,2,168,2,168,1.215928000,0.1094
222.65.26.49,<->,33.250.210.16,2,352,0,0,2,352,1.209339000,0.0010
144.232.221.31,<->,35.56.102.150,0,0,2,100,2,100,1.187687000,0.0000
144.75.218.237,<->,99.168.7.150,2,289,0,0,2,289,1.182808000,0.2979
125.18.130.104,<->,92.27.27.166,0,0,2,2916,2,2916,1.178012000,0.6379
144.75.218.235,<->,138.127.225.151,2,526,0,0,2,526,1.172213000,0.2985
144.75.218.237,<->,53.167.244.138,2,252,0,0,2,252,1.166783000,0.6271
121.211.213.138,<->,92.27.27.156,0,0,2,702,2,702,1.164427000,0.2681
140.9.184.155,<->,129.224.112.252,0,0,2,161,2,161,1.163075000,0.0029
129.224.112.252,<->,92.160.15.143,2,150,0,0,2,150,1.159460000,0.0022
144.75.218.237,<->,139.252.1.230,2,180,0,0,2,180,1.157632000,0.1606
98.33.78.19,<->,92.27.219.188,0,0,2,304,2,304,1.148128000,0.5097
129.224.112.252,<->,97.242.126.193,2,171,0,0,2,171,1.133096000,0.0047
144.76.46.38,<->,102.51.208.201,0,0,2,481,2,481,1.133063000,0.0360
92.27.234.195,<->,92.27.51.139,2,240,0,0,2,240,1.132421000,0.0000
111.20.172.70,<->,33.233.141.39,0,0,2,583,2,583,1.111414000,0.0052
129.236.100.84,<->,129.224.112.252,0,0,2,151,2,151,1.104334000,0.0110
129.175.139.190,<->,29.211.214.32,0,0,2,244,2,244,1.101365000,0.2395
148.155.129.25,<->,33.233.141.230,0,0,2,340,2,340,1.097825000,0.0032
192.171.13.33,<->,8.252.222.166,0,0,2,557,2,557,1.086358000,0.0252
129.236.100.120,<->,129.224.112.252,0,0,2,151,2,151,1.083780000,0.0023
215.158.103.206,<->,129.211.22.194,2,1598,0,0,2,1598,1.082759000,0.8561
144.75.218.246,<->,132.43.156.54,2,319,0,0,2,319,1.078380000,0.3555
129.236.100.136,<->,129.224.112.252,0,0,2,149,2,149,1.077369000,0.0129
111.20.172.70,<->,101.224.89.152,0,0,2,582,2,582,1.076654000,0.0013
138.127.224.225,<->,101.224.89.180,0,0,2,471,2,471,1.067675000,0.0078
159.69.187.48,<->,144.108.64.184,2,123,0,0,2,123,1.066507000,0.0939
209.60.50.164,<->,192.67.154.172,0,0,2,188,2,188,1.064733000,0.0000
138.127.224.225,<->,33.233.141.1,0,0,2,493,2,493,1.063365000,0.0029
129.236.111.66,<->,129.224.112.252,0,0,2,150,2,150,1.063141000,0.0004
138.127.224.225,<->,101.224.89.208,0,0,2,474,2,474,1.062247000,0.0040
144.75.218.241,<->,139.252.1.230,2,180,0,0,2,180,1.060885000,0.2513
144.75.218.241,<->,130.61.211.1,2,211,0,0,2,211,1.050782000,0.1198
129.236.111.79,<->,129.224.112.252,0,0,2,153,2,153,1.050040000,0.0055
129.236.111.82,<->,129.224.112.252,0,0,2,155,2,155,1.048193000,0.0048
192.64.223.86,<->,57.46.23.242,2,628,0,0,2,628,1.040863000,0.0106
138.127.224.225,<->,101.224.89.171,0,0,2,478,2,478,1.040594000,0.0010
111.20.172.70,<->,33.233.141.100,0,0,2,238,2,238,1.036646000,0.0446
138.127.224.225,<->,33.233.141.114,0,0,2,472,2,472,1.032942000,0.0003
148.155.129.25,<->,101.224.89.175,0,0,2,345,2,345,1.031042000,0.0054
215.158.103.206,<->,129.229.242.60,2,1432,0,0,2,1432,1.020979000,0.3741
143.147.2.220,<->,92.27.219.139,0,0,2,2940,2,2940,1.019209000,0.3979
144.122.240.204,<->,144.108.64.184,2,159,0,0,2,159,1.006715000,0.0105
195.114.88.237,<->,92.27.27.164,0,0,2,104,2,104,1.004544000,0.9776
252.98.141.99,<->,8.47.122.178,2,178,0,0,2,178,1.003184000,0.0060
210.228.29.0,<->,139.241.119.19,0,0,2,260,2,260,1.001390000,0.0014
109.1.14.71,<->,105.90.194.26,2,109,0,0,2,109,1.000076000,0.2154
111.146.250.198,<->,109.26.79.44,2,100,0,0,2,100,0.997472000,0.4005
133.178.227.30,<->,131.1.235.233,2,170,0,0,2,170,0.996455000,0.0004
201.222.32.9,<->,80.41.21.72,0,0,2,123,2,123,0.995273000,0.7217
111.20.172.70,<->,33.233.141.229,0,0,2,580,2,580,0.993274000,0.0017
111.20.172.70,<->,33.233.141.60,0,0,2,265,2,265,0.988121000,1.0049
131.144.248.187,<->,129.224.112.252,0,0,2,164,2,164,0.988067000,0.0433
139.241.115.2,<->,29.211.214.254,0,0,2,194,2,194,0.985761000,0.0007
138.127.224.104,<->,101.224.89.214,0,0,2,568,2,568,0.982576000,1.0113
131.153.183.226,<->,56.121.47.18,0,0,2,216,2,216,0.982503000,0.1522
192.67.162.92,<->,38.71.255.21,2,104,0,0,2,104,0.976520000,0.9555
144.75.218.246,<->,97.68.93.9,2,1414,0,0,2,1414,0.969085000,0.0586
229.102.219.67,<->,111.147.242.225,0,0,2,104,2,104,0.967297000,0.3058
144.75.218.246,<->,97.94.181.63,2,344,0,0,2,344,0.961143000,0.3591
112.158.254.7,<->,92.27.27.99,0,0,2,297,2,297,0.953582000,0.0000
111.151.107.247,<->,8.252.223.38,0,0,2,450,2,450,0.949625000,0.0031
129.224.112.252,<->,113.189.202.235,2,138,0,0,2,138,0.944679000,1.0125
58.164.104.206,<->,20.194.30.147,0,0,2,266,2,266,0.930723000,0.0315
145.213.37.27,<->,136.129.94.107,0,0,2,168,2,168,0.928633000,0.6271
80.246.53.102,<->,80.40.50.197,0,0,2,132,2,132,0.919420000,0.4062
159.69.187.25,<->,144.108.80.170,2,142,0,0,2,142,0.917062000,0.4798
89.183.104.230,<->,6.74.114.97,2,104,0,0,2,104,0.915228000,0.0000
207.20.140.168,<->,129.224.112.252,0,0,2,148,2,148,0.910057000,0.8865
92.27.52.56,<->,35.56.99.192,0,0,2,164,2,164,0.904921000,0.6232
92.27.219.235,<->,66.11.253.17,2,104,0,0,2,104,0.876143000,0.3549
247.136.141.15,<->,75.95.120.8,2,104,0,0,2,104,0.872734000,0.0010
143.192.84.146,<->,8.228.215.123,0,0,2,113,2,113,0.870049000,1.1127
144.75.218.235,<->,129.188.130.3,2,160,0,0,2,160,0.866505000,0.5283
220.55.75.166,<->,33.57.74.181,2,150,0,0,2,150,0.864669000,0.0995
197.196.47.226,<->,92.27.219.19,0,0,2,104,2,104,0.863142000,0.5189
133.178.227.206,<->,8.240.125.165,2,296,0,0,2,296,0.860868000,0.7007
247.157.0.168,<->,77.21.42.142,2,104,0,0,2,104,0.850916000,0.0080
140.136.9.105,<->,97.126.119.191,0,0,2,870,2,870,0.832198000,0.0232
101.106.122.69,<->,92.27.219.159,0,0,2,456,2,456,0.831445000,0.0919
215.158.30.32,<->,29.211.214.254,0,0,2,203,2,203,0.830324000,0.3098
110.9.120.22,<->,80.40.61.163,0,0,2,210,2,210,0.827678000,0.0501
104.252.174.36,<->,92.27.219.34,0,0,2,434,2,434,0.810801000,0.4412
100.230.7.112,<->,6.122.144.87,0,0,2,100,2,100,0.788339000,1.0000
92.27.219.129,<->,67.226.174.178,2,104,0,0,2,104,0.782421000,0.2665
92.27.52.56,<->,92.27.26.203,0,0,2,166,2,166,0.773048000,0.1843
205.127.142.147,<->,109.1.38.119,0,0,2,110,2,110,0.772932000,1.0336
121.67.9.245,<->,89.183.104.135,0,0,2,698,2,698,0.768859000,1.0257
144.75.218.237,<->,138.127.230.2,2,599,0,0,2,599,0.761331000,1.1958
89.183.104.137,<->,38.182.16.102,2,104,0,0,2,104,0.760533000,0.8000
112.73.216.90,<->,92.27.219.238,0,0,2,104,2,104,0.753463000,0.0005
132.168.196.174,<->,53.78.162.188,2,116,0,0,2,116,0.752769000,0.0398
144.75.218.237,<->,50.149.206.145,2,513,0,0,2,513,0.750103000,0.2551
144.75.218.237,<->,138.127.225.165,2,508,0,0,2,508,0.748658000,1.1784
119.43.150.48,<->,20.151.0.202,0,0,2,160,2,160,0.747761000,0.9997
247.136.255.52,<->,117.64.120.171,2,238,0,0,2,238,0.745528000,0.1614
159.31.237.1,<->,78.45.154.137,2,184,0,0,2,184,0.742900000,0.5138
152.12.131.83,<->,92.27.219.223,0,0,2,642,2,642,0.741021000,0.0034
132.249.70.213,<->,101.229.93.43,2,212,0,0,2,212,0.740042000,0.4661
192.64.208.147,<->,127.81.151.203,2,172,0,0,2,172,0.735625000,0.6990
144.75.218.246,<->,129.35.251.34,2,303,0,0,2,303,0.728774000,0.3170
126.211.107.156,<->,89.183.104.248,0,0,2,397,2,397,0.726693000,1.0130
144.75.218.241,<->,139.252.1.253,2,343,0,0,2,343,0.719560000,0.9380
89.204.223.30,<->,89.183.108.215,0,0,2,1110,2,1110,0.718623000,1.0002
145.19.9.13,<->,110.194.114.3,2,314,0,0,2,314,0.715694000,0.0367
144.75.218.241,<->,138.127.225.148,2,732,0,0,2,732,0.713430000,1.2548
204.42.100.81,<->,133.24.77.91,0,0,2,120,2,120,0.713000000,0.0031
195.123.175.8,<->,100.94.55.113,0,0,2,278,2,278,0.709545000,0.9772
247.136.192.204,<->,27.242.250.182,2,168,0,0,2,168,0.708877000,0.4130
159.80.143.31,<->,159.80.129.217,0,0,2,256,2,256,0.696881000,0.6025
230.83.120.210,<->,220.81.57.237,0,0,2,266,2,266,0.691242000,0.2200
137.137.124.206,<->,122.235.215.40,2,218,0,0,2,218,0.690957000,0.0204
249.101.104.130,<->,239.29.96.45,2,216,0,0,2,216,0.667511000,0.0000
201.222.12.47,<->,92.27.219.60,0,0,2,2940,2,2940,0.660534000,0.0321
144.75.218.246,<->,138.127.230.132,2,550,0,0,2,550,0.660121000,0.0027
64.148.91.176,<->,34.13.94.119,0,0,2,114,2,114,0.649207000,0.0178
120.150.106.190,<->,89.183.104.132,0,0,2,104,2,104,0.641991000,0.7669
144.75.218.246,<->,138.127.231.221,2,636,0,0,2,636,0.638926000,1.3468
192.67.130.105,<->,159.151.56.171,2,104,0,0,2,104,0.632218000,0.6987
144.75.218.235,<->,138.127.225.15,2,546,0,0,2,546,0.624718000,1.0570
192.171.13.33,<->,8.252.222.202,0,0,2,542,2,542,0.623135000,0.0004
254.70.113.234,<->,192.64.255.44,0,0,2,168,2,168,0.620388000,0.0259
101.224.183.152,<->,91.231.118.234,2,170,0,0,2,170,0.620307000,0.9498
106.169.196.77,<->,92.27.219.153,0,0,2,362,2,362,0.619369000,0.0032
144.75.218.233,<->,8.47.123.78,2,338,0,0,2,338,0.618865000,0.9338
246.253.253.212,<->,142.178.1.24,2,602,0,0,2,602,0.616618000,1.2548
144.75.218.241,<->,138.127.224.101,2,167,0,0,2,167,0.613930000,0.6289
200.174.214.48,<->,100.176.233.172,2,212,0,0,2,212,0.613566000,0.3347
144.75.218.237,<->,138.127.230.221,2,167,0,0,2,167,0.610477000,0.1702
129.224.112.252,<->,92.162.219.24,2,158,0,0,2,158,0.609766000,0.2917
129.224.112.252,<->,74.1.12.192,2,162,0,0,2,162,0.601739000,0.0716
50.224.121.247,<->,48.130.165.6,2,100,0,0,2,100,0.582005000,1.0400
109.222.200.111,<->,82.239.211.136,2,100,0,0,2,100,0.577764000,1.2243
192.171.13.33,<->,8.252.222.171,0,0,2,567,2,567,0.575163000,0.0238
129.224.112.252,<->,97.242.126.180,2,164,0,0,2,164,0.570958000,0.0649
192.64.229.17,<->,127.161.246.238,2,132,0,0,2,132,0.559467000,1.0219
215.158.239.120,<->,131.4.236.16,2,252,0,0,2,252,0.559152000,0.0008
192.67.139.111,<->,87.9.230.170,2,272,0,0,2,272,0.557625000,0.8421
132.249.70.213,<->,22.50.105.63,2,266,0,0,2,266,0.553933000,0.1690
144.75.218.233,<->,141.37.226.86,2,174,0,0,2,174,0.545007000,0.3021
215.158.239.8,<->,8.220.7.141,2,252,0,0,2,252,0.539914000,0.0021
92.27.219.39,<->,33.227.94.168,2,662,0,0,2,662,0.535430000,0.9887
197.45.243.206,<->,92.27.27.170,0,0,2,151,2,151,0.532399000,0.0000
220.0.242.22,<->,92.27.219.32,0,0,2,104,2,104,0.524003000,0.0106
110.86.201.155,<->,92.27.219.187,0,0,2,284,2,284,0.523174000,0.0000
92.27.219.252,<->,88.45.158.210,2,104,0,0,2,104,0.523071000,1.4463
80.41.59.232,<->,38.57.179.208,2,1917,0,0,2,1917,0.522782000,0.6580
92.27.219.31,<->,69.133.95.41,2,121,0,0,2,121,0.522642000,0.7057
144.75.218.241,<->,33.238.69.117,2,264,0,0,2,264,0.517392000,1.0938
215.158.102.78,<->,129.224.112.252,0,0,2,150,2,150,0.514767000,0.9577
206.199.183.63,<->,132.168.196.9,0,0,2,104,2,104,0.513941000,0.0107
112.11.21.26,<->,101.70.111.86,0,0,2,164,2,164,0.511446000,1.0161
141.245.151.199,<->,136.47.66.197,2,174,0,0,2,174,0.510796000,0.9693
239.66.101.100,<->,99.72.215.157,0,0,2,1342,2,1342,0.503567000,0.9989
97.94.179.20,<->,80.38.57.148,0,0,2,100,2,100,0.499665000,1.1159
129.224.112.252,<->,97.242.126.200,2,152,0,0,2,152,0.495801000,0.7794
117.130.224.137,<->,92.27.27.175,0,0,2,255,2,255,0.494274000,0.0078
192.67.145.193,<->,33.240.23.50,2,362,0,0,2,362,0.491590000,0.0651
144.75.218.237,<->,53.165.133.164,2,168,0,0,2,168,0.489578000,0.6141
109.0.228.28,<->,4.122.107.17,2,362,0,0,2,362,0.489446000,0.0897
138.126.224.187,<->,92.27.219.236,0,0,2,182,2,182,0.488140000,0.5883
115.121.192.145,<->,92.27.219.237,0,0,2,187,2,187,0.486848000,1.2936
139.47.239.231,<->,110.109.231.156,2,216,0,0,2,216,0.480777000,1.0182
132.200.108.136,<->,129.224.112.221,0,0,2,178,2,178,0.475024000,0.7309
92.27.27.167,<->,42.46.193.243,2,642,0,0,2,642,0.474630000,0.0000
215.158.239.120,<->,97.4.79.164,2,514,0,0,2,514,0.465139000,0.0198
121.195.174.188,<->,89.183.104.166,0,0,2,104,2,104,0.463979000,0.0002
222.59.244.202,<->,48.53.123.29,0,0,2,104,2,104,0.458056000,0.0000
133.178.227.168,<->,122.158.176.232,2,2224,0,0,2,2224,0.456209000,0.1092
102.50.242.234,<->,102.45.3.188,2,809,0,0,2,809,0.453401000,0.1798
246.253.253.210,<->,206.72.123.108,2,250,0,0,2,250,0.449575000,0.2485
247.136.192.204,<->,133.252.81.46,2,168,0,0,2,168,0.449165000,0.9681
132.180.212.246,<->,129.224.112.252,0,0,2,130,2,130,0.448272000,0.3294
243.117.125.15,<->,129.224.112.252,0,0,2,176,2,176,0.430715000,0.2175
121.74.22.120,<->,92.27.27.179,0,0,2,104,2,104,0.426471000,0.0000
132.249.70.213,<->,101.87.248.103,2,251,0,0,2,251,0.421066000,0.8449
139.241.73.46,<->,129.224.112.221,0,0,2,156,2,156,0.419032000,0.9364
113.226.157.159,<->,89.183.104.157,0,0,2,104,2,104,0.418848000,0.2370
192.67.175.66,<->,75.94.222.102,2,104,0,0,2,104,0.405687000,1.0444
144.75.218.246,<->,97.94.119.43,2,153,0,0,2,153,0.398060000,1.3466
205.225.212.78,<->,92.27.219.42,0,0,2,806,2,806,0.397621000,0.1579
126.101.55.158,<->,92.27.219.34,0,0,2,104,2,104,0.397195000,0.8476
110.40.13.209,<->,80.42.175.248,0,0,2,113,2,113,0.395958000,0.5507
92.180.179.45,<->,20.194.30.147,0,0,2,260,2,260,0.394255000,0.0203
159.57.86.226,<->,144.75.218.242,0,0,2,339,2,339,0.393932000,0.6837
136.99.122.178,<->,66.246.165.183,2,440,0,0,2,440,0.392547000,0.4760
113.173.255.26,<->,80.42.129.116,0,0,2,126,2,126,0.382100000,0.3282
144.75.218.235,<->,139.252.1.242,2,342,0,0,2,342,0.381655000,0.2937
78.128.203.22,<->,39.15.169.14,0,0,2,174,2,174,0.380452000,0.8468
152.105.92.208,<->,92.181.251.39,0,0,2,266,2,266,0.374682000,1.5311
215.158.103.219,<->,138.127.231.62,2,663,0,0,2,663,0.369286000,0.0655
207.189.68.218,<->,144.93.121.10,0,0,2,224,2,224,0.368168000,1.0011
146.253.87.247,<->,144.75.218.242,0,0,2,242,2,242,0.364297000,0.3843
136.129.83.88,<->,100.50.96.76,2,162,0,0,2,162,0.355694000,1.0004
120.233.143.121,<->,92.27.219.151,0,0,2,600,2,600,0.347031000,0.0079
144.75.218.233,<->,53.162.176.63,2,532,0,0,2,532,0.344741000,0.4568
92.27.27.161,<->,48.111.183.109,2,104,0,0,2,104,0.333276000,0.9076
144.75.218.246,<->,53.200.173.149,2,468,0,0,2,468,0.325410000,0.0069
111.147.97.95,<->,53.213.141.53,2,1146,0,0,2,1146,0.325342000,0.0859
131.144.36.214,<->,80.38.25.116,0,0,2,412,2,412,0.323441000,0.9220
192.67.139.145,<->,107.23.207.19,2,122,0,0,2,122,0.315899000,1.5519
217.9.139.9,<->,132.249.70.213,0,0,2,202,2,202,0.314459000,0.0621
137.132.207.124,<->,99.175.107.53,0,0,2,640,2,640,0.310294000,0.0308
145.208.138.125,<->,92.27.219.204,0,0,2,2848,2,2848,0.310291000,0.2640
138.127.224.101,<->,97.126.26.71,0,0,2,168,2,168,0.307020000,0.4769
230.113.228.44,<->,220.83.21.43,0,0,2,266,2,266,0.302902000,0.2990
192.64.248.242,<->,144.232.206.14,2,104,0,0,2,104,0.298634000,0.3283
215.158.140.163,<->,8.222.0.246,2,239,0,0,2,239,0.297850000,0.0010
20.151.18.52,<->,0.112.13.35,2,160,0,0,2,160,0.297641000,1.0000
92.27.219.175,<->,33.57.79.36,2,113,0,0,2,113,0.297105000,0.0248
92.27.219.180,<->,57.116.92.187,2,230,0,0,2,230,0.290459000,0.7391
92.27.219.185,<->,88.0.194.179,2,104,0,0,2,104,0.289376000,0.4716
149.1.209.97,<->,20.207.104.91,0,0,2,276,2,276,0.274407000,0.4524
199.5.174.227,<->,92.27.219.51,0,0,2,104,2,104,0.273712000,0.0046
207.206.254.187,<->,102.50.110.21,0,0,2,266,2,266,0.272691000,0.6523
226.162.38.40,<->,109.1.65.112,0,0,2,435,2,435,0.272332000,0.5201
94.24.223.119,<->,92.27.219.180,0,0,2,104,2,104,0.271074000,0.0014
106.146.163.167,<->,89.183.104.160,0,0,2,526,2,526,0.270516000,0.1081
192.64.195.195,<->,113.203.146.133,2,104,0,0,2,104,0.269657000,0.8318
192.67.145.193,<->,134.5.66.49,2,266,0,0,2,266,0.263010000,0.6631
80.42.176.246,<->,53.90.7.85,2,132,0,0,2,132,0.262509000,1.0225
144.75.218.241,<->,138.127.225.151,2,541,0,0,2,541,0.259529000,1.0018
97.126.118.120,<->,29.223.31.98,2,114,0,0,2,114,0.256545000,0.2977
94.193.37.58,<->,92.181.115.14,0,0,2,266,2,266,0.256117000,1.5181
119.45.229.218,<->,97.168.127.135,0,0,2,1486,2,1486,0.256069000,0.0900
255.57.239.24,<->,247.136.235.134,0,0,2,160,2,160,0.253624000,1.1577
148.111.30.85,<->,144.75.218.246,0,0,2,150,2,150,0.253092000,0.4233
142.190.132.115,<->,89.183.104.230,0,0,2,104,2,104,0.249806000,0.0015
247.136.252.169,<->,113.203.214.122,2,119,0,0,2,119,0.248744000,1.4694
159.69.187.4,<->,6.147.69.18,2,149,0,0,2,149,0.246326000,0.4252
101.106.122.69,<->,89.183.104.189,0,0,2,456,2,456,0.244386000,0.2422
202.223.124.75,<->,98.129.83.35,0,0,2,266,2,266,0.243996000,0.3899
143.230.117.31,<->,129.224.112.252,0,0,2,153,2,153,0.240457000,1.4874
215.158.140.163,<->,120.155.87.47,2,282,0,0,2,282,0.228350000,0.2995
215.158.140.163,<->,111.151.107.247,2,320,0,0,2,320,0.224985000,0.0245
192.67.154.172,<->,103.13.74.78,2,104,0,0,2,104,0.213270000,0.0132
196.148.128.40,<->,148.157.241.119,2,104,0,0,2,104,0.212140000,1.4393
192.67.128.244,<->,142.205.143.22,2,268,0,0,2,268,0.206704000,0.2509
92.27.219.53,<->,33.57.74.178,2,474,0,0,2,474,0.204808000,1.4976
111.181.96.177,<->,98.150.107.178,2,100,0,0,2,100,0.204077000,1.0002
118.208.149.7,<->,89.183.104.248,0,0,2,104,2,104,0.203138000,0.1921
92.27.219.244,<->,29.131.188.62,2,104,0,0,2,104,0.197310000,0.0875
101.106.122.69,<->,89.183.104.172,0,0,2,276,2,276,0.197244000,0.9999
101.70.97.189,<->,53.239.1.154,2,336,0,0,2,336,0.197034000,0.7963
93.237.35.197,<->,92.27.27.182,0,0,2,2450,2,2450,0.193839000,0.9497
144.69.82.139,<->,22.50.59.223,2,147,0,0,2,147,0.187576000,0.8981
121.131.14.214,<->,80.40.25.242,0,0,2,122,2,122,0.184533000,1.1822
247.136.242.15,<->,40.202.65.141,2,266,0,0,2,266,0.182725000,0.5383
205.90.219.141,<->,92.27.219.247,0,0,2,104,2,104,0.182341000,0.0007
247.136.249.234,<->,158.50.201.152,2,104,0,0,2,104,0.180767000,0.0000
215.158.103.219,<->,120.155.86.176,2,154,0,0,2,154,0.177065000,0.5074
92.27.219.247,<->,75.95.103.248,2,104,0,0,2,104,0.169523000,0.0011
53.160.107.185,<->,48.53.51.110,0,0,2,678,2,678,0.158240000,0.2486
149.201.23.137,<->,89.183.104.254,0,0,2,104,2,104,0.156027000,0.0569
195.215.175.157,<->,92.27.27.150,0,0,2,104,2,104,0.154886000,1.5957
117.20.139.128,<->,92.27.219.229,0,0,2,104,2,104,0.153811000,0.0037
92.27.219.44,<->,6.79.214.215,2,176,0,0,2,176,0.148909000,1.7864
113.59.141.49,<->,92.27.219.46,0,0,2,506,2,506,0.147927000,0.6720
159.69.187.6,<->,144.108.80.170,2,136,0,0,2,136,0.141380000,0.7694
101.106.122.69,<->,92.27.27.178,0,0,2,378,2,378,0.138384000,0.1922
159.237.225.1,<->,105.124.196.37,2,104,0,0,2,104,0.134786000,0.0005
111.147.142.254,<->,54.92.206.16,2,118,0,0,2,118,0.133252000,0.0822
109.222.208.215,<->,103.254.210.135,2,120,0,0,2,120,0.132542000,0.4326
197.47.39.38,<->,109.222.208.215,0,0,2,120,2,120,0.130090000,0.5696
111.20.172.70,<->,33.233.141.0,0,0,2,574,2,574,0.129671000,0.9927
125.11.252.202,<->,80.42.168.43,0,0,2,104,2,104,0.122799000,0.0008
111.20.172.70,<->,33.233.141.8,0,0,2,585,2,585,0.122380000,0.9877
144.122.240.204,<->,144.108.80.170,2,145,0,0,2,145,0.119826000,0.7440
89.127.177.200,<->,29.211.214.82,0,0,2,174,2,174,0.116816000,0.6399
159.69.187.12,<->,144.108.80.170,2,141,0,0,2,141,0.115563000,0.6658
98.217.87.186,<->,89.183.104.130,0,0,2,104,2,104,0.114608000,0.0010
111.20.172.70,<->,101.224.89.130,0,0,2,255,2,255,0.111172000,0.0004
92.27.219.225,<->,38.253.226.186,2,104,0,0,2,104,0.109957000,0.1406
247.136.164.246,<->,115.186.140.175,2,272,0,0,2,272,0.109836000,1.0421
143.230.124.191,<->,129.224.112.252,0,0,2,175,2,175,0.103543000,0.5593
111.20.172.70,<->,101.224.89.222,0,0,2,396,2,396,0.101231000,0.9871
111.20.172.70,<->,101.224.89.155,0,0,2,263,2,263,0.092166000,0.0074
97.126.18.244,<->,53.197.137.20,2,112,0,0,2,112,0.090763000,0.0000
111.20.172.70,<->,101.224.89.228,0,0,2,589,2,589,0.090696000,1.0004
102.71.178.90,<->,48.53.25.210,0,0,2,2910,2,2910,0.090310000,1.4020
99.72.74.250,<->,33.78.156.234,2,104,0,0,2,104,0.089990000,0.0145
111.20.172.70,<->,33.233.141.32,0,0,2,264,2,264,0.086366000,1.0026
111.20.172.70,<->,101.224.89.139,0,0,2,290,2,290,0.082931000,1.0042
80.42.144.133,<->,48.106.37.233,2,104,0,0,2,104,0.080047000,0.5575
220.80.178.38,<->,202.206.68.225,2,266,0,0,2,266,0.080034000,1.4530
119.187.220.213,<->,92.27.219.19,0,0,2,104,2,104,0.075194000,0.7335
141.28.181.49,<->,92.27.219.149,0,0,2,2800,2,2800,0.071415000,0.0125
117.79.145.41,<->,80.41.32.57,0,0,2,104,2,104,0.066082000,0.0000
119.251.182.115,<->,92.27.219.244,0,0,2,104,2,104,0.064681000,1.7507
215.158.66.202,<->,133.178.227.201,0,0,2,231,2,231,0.063756000,0.9107
129.224.112.252,<->,27.127.251.102,2,163,0,0,2,163,0.061674000,0.0037
133.178.227.222,<->,69.31.239.50,2,244,0,0,2,244,0.059574000,0.0008
215.158.103.206,<->,131.92.221.146,2,208,0,0,2,208,0.059383000,0.3362
129.236.111.55,<->,129.224.112.252,0,0,2,143,2,143,0.058818000,0.0123
131.57.126.120,<->,108.134.95.188,0,0,2,248,2,248,0.058196000,1.0197
105.140.147.106,<->,89.183.104.163,0,0,2,104,2,104,0.058194000,0.0057
138.127.224.225,<->,33.233.141.16,0,0,2,478,2,478,0.054546000,0.0037
144.75.218.235,<->,138.127.231.148,2,731,0,0,2,731,0.050299000,0.0257
138.127.224.104,<->,101.224.89.208,0,0,2,580,2,580,0.050012000,0.0225
80.40.50.197,<->,57.47.64.50,2,135,0,0,2,135,0.047407000,0.1508
144.75.218.235,<->,8.47.122.178,2,200,0,0,2,200,0.043943000,0.3015
129.236.100.31,<->,129.224.112.252,0,0,2,156,2,156,0.041475000,0.0170
129.236.100.63,<->,129.224.112.252,0,0,2,182,2,182,0.039656000,0.0091
192.67.176.141,<->,134.245.148.207,2,104,0,0,2,104,0.039653000,0.0000
121.249.34.86,<->,97.168.105.140,0,0,2,100,2,100,0.039593000,0.1897
138.127.224.176,<->,111.20.168.21,0,0,2,526,2,526,0.038294000,0.0005
202.73.72.103,<->,92.27.219.224,0,0,2,686,2,686,0.034079000,0.0202
138.127.225.202,<->,33.233.141.73,0,0,2,560,2,560,0.023532000,0.0033
129.224.112.252,<->,92.160.15.190,2,150,0,0,2,150,0.022321000,0.0035
192.64.200.183,<->,0.233.39.208,2,316,0,0,2,316,0.018479000,0.9038
254.126.164.43,<->,129.224.112.252,0,0,2,152,2,152,0.018084000,1.5069
222.243.101.254,<->,111.20.168.6,0,0,2,297,2,297,0.011399000,0.0012
148.155.129.25,<->,101.224.89.152,0,0,2,345,2,345,0.011384000,1.0487
121.36.4.38,<->,92.27.219.244,0,0,2,104,2,104,0.009150000,1.8825
159.69.187.22,<->,144.108.64.184,2,127,0,0,2,127,0.005737000,1.0022
138.127.224.225,<->,33.233.141.75,0,0,2,474,2,474,0.002086000,0.0019
195.78.177.50,<->,100.92.78.42,0,0,1,52,1,52,1.999964000,0.0000
192.227.190.232,<->,136.25.188.194,0,0,1,106,1,106,1.999846000,0.0000
89.183.104.145,<->,29.138.52.78,1,159,0,0,1,159,1.999730000,0.0000
158.181.253.198,<->,137.74.92.246,0,0,1,102,1,102,1.999432000,0.0000
144.79.9.233,<->,92.27.26.162,0,0,1,68,1,68,1.999196000,0.0000
92.27.219.49,<->,88.1.228.33,1,52,0,0,1,52,1.998769000,0.0000
104.227.159.53,<->,20.194.26.211,0,0,1,79,1,79,1.997579000,0.0000
192.64.196.68,<->,125.5.189.55,1,52,0,0,1,52,1.996398000,0.0000
198.117.132.52,<->,101.224.184.81,0,0,1,57,1,57,1.995879000,0.0000
80.40.45.51,<->,33.184.89.31,1,149,0,0,1,149,1.994840000,0.0000
38.21.156.204,<->,20.232.230.195,0,0,1,82,1,82,1.994360000,0.0000
115.254.146.188,<->,109.222.222.203,0,0,1,74,1,74,1.994167000,0.0000
192.64.229.128,<->,0.235.158.222,1,50,0,0,1,50,1.994167000,0.0000
129.224.112.252,<->,114.145.102.35,1,80,0,0,1,80,1.994060000,0.0000
205.68.221.112,<->,97.168.64.50,0,0,1,135,1,135,1.993624000,0.0000
158.0.172.65,<->,20.80.104.99,0,0,1,76,1,76,1.993550000,0.0000
205.126.39.60,<->,20.163.79.166,0,0,1,72,1,72,1.993454000,0.0000
215.158.239.230,<->,29.212.43.168,1,90,0,0,1,90,1.993364000,0.0000
136.25.188.194,<->,120.154.178.37,1,135,0,0,1,135,1.993363000,0.0000
121.108.22.189,<->,109.222.250.46,0,0,1,52,1,52,1.992738000,0.0000
142.205.143.11,<->,99.75.122.245,0,0,1,134,1,134,1.992457000,0.0000
21.15.226.126,<->,20.193.16.89,0,0,1,82,1,82,1.991596000,0.0000
210.56.117.47,<->,8.52.187.43,0,0,1,52,1,52,1.991233000,0.0000
126.198.34.124,<->,99.73.108.110,0,0,1,330,1,330,1.990687000,0.0000
159.109.226.132,<->,74.87.157.196,1,62,0,0,1,62,1.990575000,0.0000
230.79.27.82,<->,34.53.255.128,0,0,1,52,1,52,1.989900000,0.0000
198.249.148.13,<->,98.129.91.19,0,0,1,135,1,135,1.989868000,0.0000
158.169.105.191,<->,92.27.219.253,0,0,1,100,1,100,1.989846000,0.0000
120.83.119.197,<->,89.183.104.255,0,0,1,326,1,326,1.989505000,0.0000
144.122.240.239,<->,144.108.80.172,1,65,0,0,1,65,1.989400000,0.0000
145.19.15.33,<->,127.255.88.114,1,82,0,0,1,82,1.988628000,0.0000
215.158.239.227,<->,111.151.107.247,1,225,0,0,1,225,1.988606000,0.0000
136.25.188.105,<->,57.51.96.228,1,115,0,0,1,115,1.988341000,0.0000
89.183.104.150,<->,59.145.182.77,1,52,0,0,1,52,1.988267000,0.0000
215.158.239.227,<->,8.220.7.92,1,165,0,0,1,165,1.987986000,0.0000
111.20.172.70,<->,101.224.89.214,0,0,1,109,1,109,1.986716000,0.0000
144.75.218.241,<->,74.87.249.24,1,84,0,0,1,84,1.986384000,0.0000
80.41.3.230,<->,40.222.159.21,1,138,0,0,1,138,1.985629000,0.0000
235.11.134.111,<->,92.27.26.96,0,0,1,57,1,57,1.985377000,0.0000
195.38.202.137,<->,111.146.248.194,0,0,1,135,1,135,1.985299000,0.0000
21.15.226.126,<->,20.193.16.28,0,0,1,82,1,82,1.984940000,0.0000
157.122.55.218,<->,139.163.81.173,0,0,1,130,1,130,1.984023000,0.0000
201.165.0.25,<->,92.27.219.224,0,0,1,62,1,62,1.983888000,0.0000
136.25.188.105,<->,135.79.42.213,1,421,0,0,1,421,1.983514000,0.0000
144.75.218.241,<->,138.127.225.228,1,365,0,0,1,365,1.983244000,0.0000
138.127.225.230,<->,101.224.89.214,0,0,1,234,1,234,1.982819000,0.0000
144.75.218.235,<->,66.121.105.164,1,272,0,0,1,272,1.982237000,0.0000
99.238.201.53,<->,92.27.219.145,0,0,1,116,1,116,1.981744000,0.0000
136.25.188.37,<->,60.110.124.16,1,111,0,0,1,111,1.981113000,0.0000
141.97.30.94,<->,109.222.212.23,0,0,1,52,1,52,1.980761000,0.0000
144.75.218.246,<->,138.127.224.194,1,190,0,0,1,190,1.980636000,0.0000
20.13.111.183,<->,0.200.50.50,1,60,0,0,1,60,1.980305000,0.0000
95.245.93.205,<->,34.198.150.184,0,0,1,52,1,52,1.980141000,0.0000
144.75.218.237,<->,138.127.225.96,1,289,0,0,1,289,1.979163000,0.0000
246.253.253.79,<->,129.245.206.220,1,736,0,0,1,736,1.979128000,0.0000
89.183.104.236,<->,0.66.204.156,1,147,0,0,1,147,1.978695000,0.0000
138.127.225.201,<->,101.224.89.170,0,0,1,245,1,245,1.978612000,0.0000
20.13.111.176,<->,0.200.50.50,1,60,0,0,1,60,1.978557000,0.0000
92.27.27.185,<->,72.52.29.6,1,718,0,0,1,718,1.977764000,0.0000
131.142.1.12,<->,20.91.67.234,0,0,1,74,1,74,1.977667000,0.0000
207.1.56.190,<->,100.95.213.81,0,0,1,59,1,59,1.975908000,0.0000
126.210.233.248,<->,100.93.87.235,0,0,1,136,1,136,1.975417000,0.0000
156.31.152.157,<->,39.128.209.5,0,0,1,80,1,80,1.975142000,0.0000
129.19.157.66,<->,89.139.241.98,0,0,1,130,1,130,1.974969000,0.0000
129.224.112.252,<->,92.162.219.75,1,92,0,0,1,92,1.974920000,0.0000
194.207.33.51,<->,100.94.11.80,0,0,1,62,1,62,1.974873000,0.0000
21.15.226.126,<->,20.193.16.194,0,0,1,82,1,82,1.974183000,0.0000
192.67.141.167,<->,40.212.154.182,1,52,0,0,1,52,1.974043000,0.0000
144.75.218.242,<->,140.138.71.29,1,73,0,0,1,73,1.973822000,0.0000
144.75.218.242,<->,138.127.225.176,1,264,0,0,1,264,1.972662000,0.0000
144.75.218.241,<->,143.46.2.230,1,122,0,0,1,122,1.972216000,0.0000
205.37.16.248,<->,100.95.97.95,0,0,1,321,1,321,1.971307000,0.0000
127.186.169.193,<->,92.27.219.235,0,0,1,351,1,351,1.971094000,0.0000
132.168.178.101,<->,132.149.113.27,0,0,1,69,1,69,1.969701000,0.0000
220.55.66.44,<->,126.198.120.245,1,196,0,0,1,196,1.969182000,0.0000
230.83.114.145,<->,138.73.32.96,0,0,1,133,1,133,1.968307000,0.0000
220.55.123.209,<->,57.140.246.54,1,76,0,0,1,76,1.967341000,0.0000
21.15.226.126,<->,20.193.16.198,0,0,1,82,1,82,1.966515000,0.0000
57.211.43.70,<->,6.228.19.248,0,0,1,76,1,76,1.966258000,0.0000
144.122.240.219,<->,144.108.80.172,1,67,0,0,1,67,1.963831000,0.0000
134.240.115.66,<->,20.28.40.159,0,0,1,75,1,75,1.963709000,0.0000
136.109.250.194,<->,97.126.11.149,0,0,1,67,1,67,1.962264000,0.0000
220.55.110.129,<->,129.213.110.99,1,481,0,0,1,481,1.962226000,0.0000
192.67.154.172,<->,92.18.109.207,1,52,0,0,1,52,1.962022000,0.0000
21.15.226.126,<->,20.193.16.200,0,0,1,82,1,82,1.961534000,0.0000
105.186.185.140,<->,80.41.16.79,0,0,1,149,1,149,1.961164000,0.0000
80.42.136.213,<->,66.63.73.20,1,133,0,0,1,133,1.961083000,0.0000
192.64.229.25,<->,105.163.85.135,1,52,0,0,1,52,1.960456000,0.0000
33.183.115.16,<->,20.130.12.194,0,0,1,74,1,74,1.959705000,0.0000
193.24.163.34,<->,98.128.56.197,0,0,1,104,1,104,1.959398000,0.0000
136.25.188.105,<->,135.79.32.181,1,421,0,0,1,421,1.957477000,0.0000
109.222.242.1,<->,39.53.18.121,1,79,0,0,1,79,1.956526000,0.0000
122.218.155.118,<->,97.126.114.255,0,0,1,76,1,76,1.955992000,0.0000
120.83.106.204,<->,89.183.104.146,0,0,1,326,1,326,1.955553000,0.0000
123.87.182.27,<->,20.207.7.39,0,0,1,179,1,179,1.955322000,0.0000
92.26.158.146,<->,42.124.209.56,1,85,0,0,1,85,1.955265000,0.0000
133.178.226.254,<->,113.23.56.27,1,90,0,0,1,90,1.954727000,0.0000
144.87.235.187,<->,29.211.97.161,1,142,0,0,1,142,1.954462000,0.0000
115.223.138.39,<->,8.228.211.21,0,0,1,79,1,79,1.953588000,0.0000
195.123.228.195,<->,99.75.237.141,0,0,1,133,1,133,1.953564000,0.0000
144.75.218.237,<->,138.127.230.88,1,284,0,0,1,284,1.953432000,0.0000
113.189.252.246,<->,20.206.136.250,0,0,1,68,1,68,1.952291000,0.0000
113.196.116.177,<->,92.27.219.203,0,0,1,52,1,52,1.951809000,0.0000
215.158.238.200,<->,131.141.218.123,1,163,0,0,1,163,1.951764000,0.0000
139.114.178.206,<->,99.72.214.85,0,0,1,119,1,119,1.951495000,0.0000
159.69.187.30,<->,144.108.64.185,1,59,0,0,1,59,1.951248000,0.0000
92.27.219.55,<->,77.49.20.48,1,62,0,0,1,62,1.950939000,0.0000
88.159.240.183,<->,80.42.185.67,0,0,1,52,1,52,1.950832000,0.0000
215.158.238.19,<->,215.158.6.245,1,85,0,0,1,85,1.950657000,0.0000
109.222.208.215,<->,80.248.212.137,1,84,0,0,1,84,1.949971000,0.0000
193.47.198.128,<->,8.43.212.44,0,0,1,67,1,67,1.948804000,0.0000
144.75.218.235,<->,138.127.225.75,1,67,0,0,1,67,1.948217000,0.0000
110.56.89.242,<->,97.126.114.17,0,0,1,78,1,78,1.947797000,0.0000
236.215.193.223,<->,144.122.240.200,0,0,1,70,1,70,1.947488000,0.0000
92.27.219.230,<->,57.224.189.60,1,325,0,0,1,325,1.947046000,0.0000
207.51.144.63,<->,20.181.202.148,0,0,1,75,1,75,1.946721000,0.0000
118.50.28.33,<->,92.27.219.246,0,0,1,272,1,272,1.946073000,0.0000
80.56.78.128,<->,8.182.121.229,1,85,0,0,1,85,1.946029000,0.0000
21.15.226.126,<->,20.193.17.216,0,0,1,82,1,82,1.945851000,0.0000
21.15.226.126,<->,20.193.17.255,0,0,1,82,1,82,1.945589000,0.0000
215.158.239.236,<->,29.212.43.168,1,90,0,0,1,90,1.945176000,0.0000
195.67.244.88,<->,39.201.89.227,0,0,1,50,1,50,1.944990000,0.0000
137.129.27.57,<->,100.50.97.15,1,98,0,0,1,98,1.944453000,0.0000
54.69.5.103,<->,50.224.78.60,0,0,1,69,1,69,1.944300000,0.0000
141.204.127.17,<->,133.178.226.245,0,0,1,719,1,719,1.944005000,0.0000
129.224.112.252,<->,92.162.219.30,1,98,0,0,1,98,1.943788000,0.0000
207.212.194.186,<->,92.27.27.172,0,0,1,263,1,263,1.943283000,0.0000
215.158.140.136,<->,128.194.246.148,1,105,0,0,1,105,1.941892000,0.0000
92.27.219.234,<->,33.240.42.133,1,309,0,0,1,309,1.941559000,0.0000
144.75.218.237,<->,132.208.73.30,1,186,0,0,1,186,1.939974000,0.0000
148.255.158.118,<->,20.44.169.38,0,0,1,76,1,76,1.939779000,0.0000
207.63.12.95,<->,20.5.20.49,0,0,1,68,1,68,1.939779000,0.0000
97.168.94.127,<->,50.221.176.241,1,69,0,0,1,69,1.939066000,0.0000
42.229.229.53,<->,20.115.121.156,0,0,1,68,1,68,1.938309000,0.0000
20.127.247.237,<->,6.147.69.18,1,66,0,0,1,66,1.938306000,0.0000
109.1.16.1,<->,27.188.163.162,1,444,0,0,1,444,1.938281000,0.0000
145.252.112.192,<->,98.219.117.118,1,80,0,0,1,80,1.937770000,0.0000
144.75.218.246,<->,98.101.89.6,1,809,0,0,1,809,1.937693000,0.0000
53.200.255.58,<->,50.224.78.62,0,0,1,68,1,68,1.937618000,0.0000
144.76.46.38,<->,99.75.123.162,0,0,1,50,1,50,1.937437000,0.0000
215.158.238.161,<->,98.166.239.40,1,85,0,0,1,85,1.937382000,0.0000
21.15.226.126,<->,20.193.17.238,0,0,1,82,1,82,1.936222000,0.0000
33.200.157.19,<->,20.129.242.221,0,0,1,74,1,74,1.935762000,0.0000
89.183.104.150,<->,33.245.20.181,1,52,0,0,1,52,1.935357000,0.0000
255.57.239.26,<->,80.40.15.111,0,0,1,80,1,80,1.935208000,0.0000
144.75.218.235,<->,138.127.230.221,1,84,0,0,1,84,1.935124000,0.0000
220.55.101.98,<->,132.43.156.54,1,137,0,0,1,137,1.934963000,0.0000
132.43.156.54,<->,80.38.6.51,0,0,1,799,1,799,1.934818000,0.0000
215.158.238.78,<->,8.40.50.223,1,85,0,0,1,85,1.933729000,0.0000
215.158.103.219,<->,192.171.13.190,1,98,0,0,1,98,1.933641000,0.0000
127.89.8.26,<->,80.40.41.27,0,0,1,84,1,84,1.932543000,0.0000
80.42.177.152,<->,38.136.68.19,1,135,0,0,1,135,1.932277000,0.0000
227.23.98.246,<->,89.183.104.128,0,0,1,53,1,53,1.932253000,0.0000
20.13.111.98,<->,0.200.50.50,1,60,0,0,1,60,1.932075000,0.0000
215.158.210.70,<->,29.211.214.82,0,0,1,96,1,96,1.931491000,0.0000
144.69.194.50,<->,136.25.188.105,0,0,1,283,1,283,1.930792000,0.0000
132.249.70.233,<->,129.176.84.9,1,86,0,0,1,86,1.930485000,0.0000
137.129.67.59,<->,92.27.219.59,0,0,1,52,1,52,1.930278000,0.0000
144.75.218.235,<->,138.127.231.59,1,365,0,0,1,365,1.930148000,0.0000
159.31.217.35,<->,67.236.244.154,1,52,0,0,1,52,1.930015000,0.0000
240.105.0.6,<->,136.25.188.105,0,0,1,183,1,183,1.929630000,0.0000
125.23.146.88,<->,109.222.203.52,0,0,1,78,1,78,1.928577000,0.0000
21.15.226.126,<->,20.193.17.240,0,0,1,82,1,82,1.928194000,0.0000
144.75.218.241,<->,138.127.225.234,1,254,0,0,1,254,1.926843000,0.0000
141.204.123.255,<->,109.81.202.64,0,0,1,206,1,206,1.926266000,0.0000
144.75.218.233,<->,138.127.225.215,1,347,0,0,1,347,1.925976000,0.0000
129.224.112.252,<->,60.100.161.172,1,63,0,0,1,63,1.925705000,0.0000
138.127.225.149,<->,97.126.26.70,0,0,1,246,1,246,1.925524000,0.0000
102.39.105.242,<->,50.224.76.131,0,0,1,79,1,79,1.924698000,0.0000
101.106.122.69,<->,89.183.104.168,0,0,1,133,1,133,1.924178000,0.0000
104.155.75.255,<->,50.224.110.86,0,0,1,74,1,74,1.923177000,0.0000
108.39.57.255,<->,74.235.94.149,1,67,0,0,1,67,1.922865000,0.0000
201.222.190.205,<->,80.41.58.237,0,0,1,135,1,135,1.922464000,0.0000
92.27.219.169,<->,4.130.13.37,1,240,0,0,1,240,1.922066000,0.0000
139.248.201.139,<->,137.69.107.44,1,80,0,0,1,80,1.920596000,0.0000
21.15.226.126,<->,20.193.17.105,0,0,1,82,1,82,1.920499000,0.0000
109.110.163.92,<->,92.27.219.156,0,0,1,84,1,84,1.918588000,0.0000
103.61.69.140,<->,20.203.160.189,0,0,1,70,1,70,1.916907000,0.0000
221.196.95.22,<->,192.67.140.220,0,0,1,319,1,319,1.916703000,0.0000
104.155.120.1,<->,89.183.104.189,0,0,1,319,1,319,1.915018000,0.0000
144.75.218.235,<->,138.127.230.211,1,254,0,0,1,254,1.914250000,0.0000
252.113.218.41,<->,50.224.93.122,0,0,1,82,1,82,1.913730000,0.0000
192.64.229.213,<->,159.230.56.202,1,128,0,0,1,128,1.912155000,0.0000
148.198.183.187,<->,108.134.127.192,0,0,1,81,1,81,1.911712000,0.0000
97.126.45.209,<->,33.248.124.218,1,62,0,0,1,62,1.911689000,0.0000
92.27.219.38,<->,42.41.254.51,1,103,0,0,1,103,1.910702000,0.0000
112.170.71.176,<->,20.192.37.227,0,0,1,84,1,84,1.910539000,0.0000
127.89.237.106,<->,109.222.200.25,0,0,1,77,1,77,1.909923000,0.0000
197.235.132.138,<->,20.185.195.160,0,0,1,78,1,78,1.908803000,0.0000
111.147.146.107,<->,75.101.83.45,1,69,0,0,1,69,1.908682000,0.0000
143.43.204.18,<->,20.87.86.90,0,0,1,68,1,68,1.907965000,0.0000
129.224.112.252,<->,114.145.122.218,1,80,0,0,1,80,1.907908000,0.0000
155.216.61.93,<->,108.39.160.74,0,0,1,130,1,130,1.907152000,0.0000
133.54.22.156,<->,131.144.248.28,1,84,0,0,1,84,1.906517000,0.0000
153.186.217.198,<->,34.108.191.93,0,0,1,72,1,72,1.906222000,0.0000
101.38.148.96,<->,97.168.94.127,0,0,1,75,1,75,1.905565000,0.0000
215.158.239.233,<->,192.227.190.250,1,90,0,0,1,90,1.905470000,0.0000
92.27.26.248,<->,33.215.4.219,1,57,0,0,1,57,1.905295000,0.0000
114.19.240.76,<->,98.67.159.10,0,0,1,68,1,68,1.905213000,0.0000
109.222.255.55,<->,86.13.37.241,1,69,0,0,1,69,1.905027000,0.0000
144.122.240.242,<->,137.179.251.23,1,71,0,0,1,71,1.903957000,0.0000
144.75.218.241,<->,65.95.70.36,1,140,0,0,1,140,1.903543000,0.0000
139.34.132.118,<->,136.25.188.72,0,0,1,1064,1,1064,1.903301000,0.0000
247.136.210.161,<->,105.221.82.56,1,319,0,0,1,319,1.903050000,0.0000
215.158.103.219,<->,53.227.188.6,1,253,0,0,1,253,1.902425000,0.0000
192.64.196.68,<->,134.106.251.179,1,52,0,0,1,52,1.902401000,0.0000
106.1.36.29,<->,92.27.219.241,0,0,1,135,1,135,1.902379000,0.0000
109.222.251.33,<->,6.88.34.156,1,77,0,0,1,77,1.902278000,0.0000
102.173.125.0,<->,80.40.31.154,0,0,1,133,1,133,1.901769000,0.0000
140.151.225.93,<->,92.27.219.128,0,0,1,52,1,52,1.901728000,0.0000
97.110.148.14,<->,92.162.252.12,0,0,1,139,1,139,1.901598000,0.0000
144.75.218.235,<->,138.127.225.194,1,237,0,0,1,237,1.901071000,0.0000
109.113.44.63,<->,56.121.35.77,0,0,1,224,1,224,1.900830000,0.0000
106.209.161.210,<->,89.183.104.129,0,0,1,52,1,52,1.900107000,0.0000
42.31.109.52,<->,39.162.179.136,0,0,1,70,1,70,1.899996000,0.0000
149.170.128.135,<->,100.92.66.100,0,0,1,130,1,130,1.899931000,0.0000
158.229.167.186,<->,20.66.117.235,0,0,1,74,1,74,1.899840000,0.0000
125.200.151.86,<->,80.40.50.197,0,0,1,52,1,52,1.899575000,0.0000
132.168.198.110,<->,38.98.95.10,1,135,0,0,1,135,1.898570000,0.0000
133.178.226.245,<->,8.181.148.225,1,111,0,0,1,111,1.898299000,0.0000
144.75.218.242,<->,100.185.121.91,1,87,0,0,1,87,1.898250000,0.0000
92.27.219.131,<->,82.180.168.184,1,62,0,0,1,62,1.898217000,0.0000
145.116.223.84,<->,136.25.189.63,0,0,1,104,1,104,1.898200000,0.0000
100.94.204.235,<->,33.241.241.76,1,70,0,0,1,70,1.897393000,0.0000
136.25.188.105,<->,131.153.125.208,1,191,0,0,1,191,1.897093000,0.0000
144.75.218.242,<->,89.155.210.245,1,99,0,0,1,99,1.896718000,0.0000
139.69.162.227,<->,29.211.214.82,0,0,1,96,1,96,1.896285000,0.0000
144.64.137.156,<->,143.73.162.176,1,73,0,0,1,73,1.896022000,0.0000
144.75.218.246,<->,138.127.224.167,1,242,0,0,1,242,1.894894000,0.0000
92.27.219.147,<->,40.208.235.139,1,256,0,0,1,256,1.894864000,0.0000
98.150.107.161,<->,97.190.215.3,0,0,1,50,1,50,1.894685000,0.0000
215.158.140.136,<->,128.194.246.149,1,134,0,0,1,134,1.894249000,0.0000
221.196.91.231,<->,109.222.250.145,0,0,1,136,1,136,1.892550000,0.0000
92.27.219.217,<->,29.143.252.140,1,62,0,0,1,62,1.891545000,0.0000
216.132.55.74,<->,20.194.30.147,0,0,1,52,1,52,1.890881000,0.0000
129.224.112.252,<->,114.186.133.50,1,74,0,0,1,74,1.890202000,0.0000
129.224.112.252,<->,92.162.219.203,1,73,0,0,1,73,1.888802000,0.0000
198.180.211.96,<->,80.41.32.162,0,0,1,138,1,138,1.888492000,0.0000
136.25.189.210,<->,8.57.163.164,1,111,0,0,1,111,1.888179000,0.0000
192.229.40.70,<->,136.25.188.59,0,0,1,85,1,85,1.887892000,0.0000
133.178.227.210,<->,80.56.91.244,1,1112,0,0,1,1112,1.887783000,0.0000
250.50.35.185,<->,80.40.60.88,0,0,1,74,1,74,1.887574000,0.0000
215.158.140.111,<->,8.191.9.38,1,1064,0,0,1,1064,1.886956000,0.0000
144.75.218.242,<->,139.252.1.225,1,159,0,0,1,159,1.885943000,0.0000
109.222.246.3,<->,60.89.248.196,1,73,0,0,1,73,1.885673000,0.0000
144.75.218.242,<->,138.127.231.222,1,267,0,0,1,267,1.885562000,0.0000
235.11.134.111,<->,101.224.191.89,0,0,1,57,1,57,1.883976000,0.0000
39.15.233.100,<->,0.54.22.103,1,86,0,0,1,86,1.883612000,0.0000
99.215.7.61,<->,20.176.121.25,0,0,1,76,1,76,1.882764000,0.0000
247.136.143.204,<->,75.214.216.116,1,52,0,0,1,52,1.882462000,0.0000
92.27.27.165,<->,78.49.192.10,1,52,0,0,1,52,1.882132000,0.0000
199.25.163.226,<->,159.137.226.12,0,0,1,79,1,79,1.882064000,0.0000
144.75.218.246,<->,53.160.253.194,1,126,0,0,1,126,1.881265000,0.0000
144.75.218.241,<->,138.127.225.113,1,366,0,0,1,366,1.880831000,0.0000
92.27.219.36,<->,78.46.85.213,1,1504,0,0,1,1504,1.880139000,0.0000
92.27.219.153,<->,29.134.223.74,1,52,0,0,1,52,1.878533000,0.0000
193.46.99.163,<->,109.222.250.135,0,0,1,129,1,129,1.877998000,0.0000
239.66.185.234,<->,144.71.47.67,0,0,1,140,1,140,1.877446000,0.0000
215.158.238.77,<->,118.20.100.60,1,84,0,0,1,84,1.877009000,0.0000
144.76.46.38,<->,99.72.178.167,0,0,1,135,1,135,1.876500000,0.0000
117.157.99.11,<->,109.222.199.230,0,0,1,72,1,72,1.875083000,0.0000
144.75.218.246,<->,138.127.225.82,1,355,0,0,1,355,1.875029000,0.0000
20.13.111.1,<->,0.200.50.50,1,60,0,0,1,60,1.873970000,0.0000
230.126.157.121,<->,192.67.73.190,0,0,1,133,1,133,1.873494000,0.0000
120.155.84.97,<->,92.27.219.197,0,0,1,110,1,110,1.873297000,0.0000
226.36.28.187,<->,92.27.219.156,0,0,1,84,1,84,1.873249000,0.0000
247.136.210.161,<->,125.153.53.155,1,321,0,0,1,321,1.872825000,0.0000
206.231.135.204,<->,89.183.104.150,0,0,1,58,1,58,1.872663000,0.0000
115.43.9.188,<->,92.27.219.204,0,0,1,59,1,59,1.872059000,0.0000
197.137.33.27,<->,92.27.219.36,0,0,1,52,1,52,1.871987000,0.0000
92.27.219.166,<->,33.22.37.126,1,52,0,0,1,52,1.871947000,0.0000
192.67.155.194,<->,38.173.83.126,1,52,0,0,1,52,1.871933000,0.0000
193.86.126.254,<->,192.67.178.158,0,0,1,50,1,50,1.871669000,0.0000
21.15.226.126,<->,20.193.18.21,0,0,1,82,1,82,1.871435000,0.0000
220.55.66.45,<->,126.198.120.245,1,196,0,0,1,196,1.870354000,0.0000
222.34.248.184,<->,92.27.27.169,0,0,1,436,1,436,1.869596000,0.0000
158.20.90.55,<->,133.178.226.245,0,0,1,116,1,116,1.869521000,0.0000
192.171.13.189,<->,8.176.8.229,0,0,1,112,1,112,1.869210000,0.0000
247.136.134.130,<->,205.88.59.195,1,135,0,0,1,135,1.868702000,0.0000
247.136.161.149,<->,238.11.170.11,1,298,0,0,1,298,1.868480000,0.0000
129.236.100.219,<->,129.224.112.252,0,0,1,74,1,74,1.866993000,0.0000
159.69.187.21,<->,144.108.64.179,1,67,0,0,1,67,1.866610000,0.0000
92.27.219.30,<->,27.172.7.238,1,52,0,0,1,52,1.866376000,0.0000
144.75.218.235,<->,138.127.231.222,1,238,0,0,1,238,1.866061000,0.0000
144.75.218.235,<->,138.127.231.132,1,236,0,0,1,236,1.865816000,0.0000
126.210.84.153,<->,39.203.35.145,0,0,1,75,1,75,1.863363000,0.0000
124.27.237.237,<->,39.201.32.176,0,0,1,70,1,70,1.863348000,0.0000
133.178.226.245,<->,8.221.197.206,1,141,0,0,1,141,1.862142000,0.0000
106.213.240.130,<->,99.72.161.129,0,0,1,135,1,135,1.862065000,0.0000
145.89.145.60,<->,144.81.142.56,1,217,0,0,1,217,1.861838000,0.0000
220.55.123.209,<->,57.140.246.52,1,72,0,0,1,72,1.861629000,0.0000
89.183.104.129,<->,48.105.40.132,1,52,0,0,1,52,1.861479000,0.0000
133.178.226.161,<->,0.68.1.25,1,89,0,0,1,89,1.860716000,0.0000
192.171.13.190,<->,8.176.8.195,0,0,1,122,1,122,1.860594000,0.0000
147.61.250.193,<->,111.147.186.234,0,0,1,138,1,138,1.859870000,0.0000
119.111.190.164,<->,97.198.97.149,0,0,1,83,1,83,1.858844000,0.0000
129.224.112.252,<->,114.145.101.174,1,80,0,0,1,80,1.857955000,0.0000
216.184.0.194,<->,98.232.172.60,0,0,1,90,1,90,1.857844000,0.0000
133.178.226.245,<->,122.158.247.84,1,141,0,0,1,141,1.857631000,0.0000
148.111.30.85,<->,144.75.218.242,0,0,1,75,1,75,1.857284000,0.0000
193.21.29.220,<->,92.27.219.28,0,0,1,326,1,326,1.857263000,0.0000
148.246.80.24,<->,80.38.6.51,0,0,1,544,1,544,1.856918000,0.0000
193.87.146.236,<->,192.67.167.160,0,0,1,321,1,321,1.856302000,0.0000
102.45.225.190,<->,97.126.26.70,0,0,1,62,1,62,1.855896000,0.0000
133.178.226.254,<->,8.191.0.37,1,90,0,0,1,90,1.854860000,0.0000
129.223.93.3,<->,97.126.26.71,0,0,1,699,1,699,1.854821000,0.0000
58.245.201.56,<->,39.54.0.31,0,0,1,70,1,70,1.854578000,0.0000
112.15.193.110,<->,92.27.27.166,0,0,1,52,1,52,1.854409000,0.0000
21.15.226.126,<->,20.193.18.209,0,0,1,82,1,82,1.854371000,0.0000
92.27.219.38,<->,33.46.220.222,1,52,0,0,1,52,1.854004000,0.0000
149.178.40.234,<->,144.75.218.235,0,0,1,144,1,144,1.853817000,0.0000
94.196.135.89,<->,92.27.219.39,0,0,1,321,1,321,1.853348000,0.0000
207.192.128.185,<->,39.175.29.44,0,0,1,80,1,80,1.851815000,0.0000
92.27.27.165,<->,78.44.97.48,1,52,0,0,1,52,1.851548000,0.0000
144.86.145.88,<->,132.43.156.54,1,259,0,0,1,259,1.850768000,0.0000
129.224.112.252,<->,8.61.93.25,1,80,0,0,1,80,1.850736000,0.0000
104.46.166.216,<->,92.27.219.54,0,0,1,52,1,52,1.850503000,0.0000
144.75.218.246,<->,138.127.231.122,1,253,0,0,1,253,1.849985000,0.0000
247.136.171.153,<->,152.35.69.219,1,100,0,0,1,100,1.849824000,0.0000
134.10.203.20,<->,80.42.172.225,0,0,1,52,1,52,1.849815000,0.0000
128.134.58.103,<->,20.214.252.198,0,0,1,72,1,72,1.849476000,0.0000
106.112.9.43,<->,92.27.219.139,0,0,1,52,1,52,1.849343000,0.0000
109.0.243.153,<->,105.170.45.15,1,174,0,0,1,174,1.848067000,0.0000
198.69.188.244,<->,92.27.27.99,0,0,1,135,1,135,1.847285000,0.0000
92.27.219.50,<->,64.214.68.218,1,135,0,0,1,135,1.847120000,0.0000
206.100.98.202,<->,192.67.160.34,0,0,1,135,1,135,1.846986000,0.0000
246.253.248.211,<->,53.202.56.24,1,87,0,0,1,87,1.846930000,0.0000
220.55.101.99,<->,8.47.188.160,1,132,0,0,1,132,1.846774000,0.0000
204.42.12.34,<->,89.183.104.246,0,0,1,321,1,321,1.845577000,0.0000
133.178.226.245,<->,8.252.136.247,1,141,0,0,1,141,1.845133000,0.0000
229.70.81.21,<->,109.1.16.219,0,0,1,52,1,52,1.845129000,0.0000
144.75.218.237,<->,138.127.231.127,1,259,0,0,1,259,1.844270000,0.0000
114.26.165.175,<->,92.27.219.147,0,0,1,52,1,52,1.843902000,0.0000
116.116.8.2,<->,89.183.104.246,0,0,1,138,1,138,1.843496000,0.0000
215.158.103.219,<->,80.56.76.189,1,566,0,0,1,566,1.842741000,0.0000
97.126.19.86,<->,58.218.173.51,1,74,0,0,1,74,1.842618000,0.0000
122.147.213.67,<->,20.86.191.178,0,0,1,72,1,72,1.842533000,0.0000
144.122.240.224,<->,144.108.64.179,1,75,0,0,1,75,1.842231000,0.0000
199.41.253.141,<->,99.75.171.124,0,0,1,50,1,50,1.841866000,0.0000
154.181.213.140,<->,8.228.214.124,0,0,1,78,1,78,1.841797000,0.0000
145.57.21.172,<->,133.0.67.60,0,0,1,412,1,412,1.840972000,0.0000
247.136.163.14,<->,48.106.148.95,1,55,0,0,1,55,1.840682000,0.0000
193.10.105.69,<->,92.27.219.178,0,0,1,135,1,135,1.840546000,0.0000
207.223.249.91,<->,92.27.27.176,0,0,1,52,1,52,1.840040000,0.0000
109.222.233.47,<->,97.119.43.23,1,68,0,0,1,68,1.839645000,0.0000
249.101.220.125,<->,29.214.217.95,1,106,0,0,1,106,1.838988000,0.0000
195.42.93.219,<->,20.148.166.172,0,0,1,80,1,80,1.838907000,0.0000
108.32.70.30,<->,92.27.219.61,0,0,1,52,1,52,1.838558000,0.0000
79.255.248.211,<->,34.97.244.196,0,0,1,62,1,62,1.838257000,0.0000
254.70.28.13,<->,192.67.173.65,0,0,1,213,1,213,1.838147000,0.0000
246.253.248.211,<->,53.187.62.98,1,89,0,0,1,89,1.838014000,0.0000
80.42.179.50,<->,27.193.66.236,1,77,0,0,1,77,1.837766000,0.0000
76.75.235.102,<->,39.32.47.110,0,0,1,99,1,99,1.837617000,0.0000
109.222.246.61,<->,14.224.78.123,1,79,0,0,1,79,1.837530000,0.0000
136.25.189.93,<->,89.86.110.252,1,83,0,0,1,83,1.837289000,0.0000
133.178.226.245,<->,131.148.22.184,1,183,0,0,1,183,1.836441000,0.0000
159.137.143.150,<->,100.19.49.44,1,75,0,0,1,75,1.836344000,0.0000
207.92.21.74,<->,92.27.219.50,0,0,1,52,1,52,1.836043000,0.0000
139.241.119.19,<->,98.235.198.99,1,93,0,0,1,93,1.835863000,0.0000
199.21.40.75,<->,99.72.131.232,0,0,1,52,1,52,1.835675000,0.0000
153.252.156.171,<->,109.3.157.147,0,0,1,133,1,133,1.835582000,0.0000
142.105.64.126,<->,39.201.125.228,0,0,1,75,1,75,1.834876000,0.0000
195.84.236.189,<->,39.167.77.109,0,0,1,70,1,70,1.834514000,0.0000
148.151.104.199,<->,80.38.12.231,0,0,1,76,1,76,1.833715000,0.0000
118.59.39.42,<->,92.27.219.223,0,0,1,351,1,351,1.831543000,0.0000
21.15.226.126,<->,20.193.19.157,0,0,1,82,1,82,1.831455000,0.0000
133.178.227.214,<->,80.47.152.53,1,156,0,0,1,156,1.831159000,0.0000
196.20.107.154,<->,89.183.104.179,0,0,1,62,1,62,1.831016000,0.0000
215.158.140.170,<->,8.220.7.141,1,96,0,0,1,96,1.830792000,0.0000
215.158.103.206,<->,138.127.231.137,1,249,0,0,1,249,1.830598000,0.0000
199.21.75.231,<->,99.73.155.191,0,0,1,149,1,149,1.830409000,0.0000
128.134.120.108,<->,20.162.44.67,0,0,1,78,1,78,1.828364000,0.0000
144.76.46.38,<->,99.75.83.112,0,0,1,86,1,86,1.827996000,0.0000
125.54.142.72,<->,80.42.160.210,0,0,1,135,1,135,1.827421000,0.0000
136.25.189.5,<->,131.36.66.69,1,84,0,0,1,84,1.826926000,0.0000
94.39.75.213,<->,39.154.116.186,0,0,1,80,1,80,1.826460000,0.0000
192.64.229.25,<->,112.218.200.144,1,99,0,0,1,99,1.825647000,0.0000
102.45.16.159,<->,61.60.31.115,1,50,0,0,1,50,1.825391000,0.0000
144.75.218.235,<->,130.229.11.147,1,136,0,0,1,136,1.825045000,0.0000
215.158.238.79,<->,118.20.100.60,1,84,0,0,1,84,1.823942000,0.0000
21.15.226.126,<->,20.193.19.159,0,0,1,82,1,82,1.823062000,0.0000
109.222.245.159,<->,80.227.44.110,1,76,0,0,1,76,1.822757000,0.0000
223.141.71.187,<->,92.27.219.205,0,0,1,62,1,62,1.822619000,0.0000
215.158.140.8,<->,69.132.241.159,1,90,0,0,1,90,1.822484000,0.0000
215.158.239.240,<->,8.240.125.62,1,90,0,0,1,90,1.822467000,0.0000
134.160.119.114,<->,80.40.14.22,0,0,1,653,1,653,1.822355000,0.0000
141.245.151.211,<->,136.47.66.197,1,86,0,0,1,86,1.822200000,0.0000
97.126.26.49,<->,76.82.133.14,1,86,0,0,1,86,1.822019000,0.0000
195.115.40.69,<->,92.27.219.39,0,0,1,52,1,52,1.821734000,0.0000
213.38.229.2,<->,59.36.99.236,1,351,0,0,1,351,1.821623000,0.0000
92.27.27.150,<->,42.31.145.160,1,319,0,0,1,319,1.821425000,0.0000
144.75.218.242,<->,138.127.224.59,1,285,0,0,1,285,1.820555000,0.0000
194.45.239.127,<->,89.183.104.254,0,0,1,52,1,52,1.820552000,0.0000
109.222.242.34,<->,96.191.62.123,1,75,0,0,1,75,1.820479000,0.0000
192.64.228.251,<->,123.155.89.112,1,133,0,0,1,133,1.820449000,0.0000
192.67.167.160,<->,27.147.179.30,1,331,0,0,1,331,1.820243000,0.0000
215.158.103.206,<->,53.178.69.33,1,140,0,0,1,140,1.818820000,0.0000
77.23.182.148,<->,6.75.224.242,0,0,1,133,1,133,1.818232000,0.0000
126.2.10.5,<->,20.154.109.237,0,0,1,86,1,86,1.818157000,0.0000
139.163.7.171,<->,138.127.225.228,1,267,0,0,1,267,1.818077000,0.0000
144.75.218.235,<->,138.127.224.169,1,259,0,0,1,259,1.817721000,0.0000
98.200.176.13,<->,70.208.156.132,1,90,0,0,1,90,1.817322000,0.0000
206.154.255.105,<->,192.65.148.55,0,0,1,103,1,103,1.817136000,0.0000
144.75.218.246,<->,138.127.231.26,1,366,0,0,1,366,1.816604000,0.0000
104.46.90.215,<->,92.27.27.147,0,0,1,357,1,357,1.815713000,0.0000
120.164.163.192,<->,89.183.104.151,0,0,1,52,1,52,1.815702000,0.0000
158.166.172.13,<->,136.25.188.37,0,0,1,109,1,109,1.815370000,0.0000
111.181.100.63,<->,52.26.227.26,1,65,0,0,1,65,1.814471000,0.0000
136.25.189.210,<->,33.209.222.135,1,111,0,0,1,111,1.814373000,0.0000
144.75.218.233,<->,138.127.230.128,1,236,0,0,1,236,1.813926000,0.0000
215.158.210.24,<->,29.211.214.254,0,0,1,96,1,96,1.813519000,0.0000
144.75.218.237,<->,138.127.231.171,1,159,0,0,1,159,1.813367000,0.0000
133.178.226.246,<->,8.191.0.37,1,90,0,0,1,90,1.812617000,0.0000
133.54.28.239,<->,59.4.229.71,1,75,0,0,1,75,1.809256000,0.0000
147.180.169.242,<->,34.229.165.106,0,0,1,132,1,132,1.809174000,0.0000
92.27.219.189,<->,42.45.91.160,1,344,0,0,1,344,1.809099000,0.0000
21.15.226.126,<->,20.193.19.107,0,0,1,82,1,82,1.808914000,0.0000
199.91.57.142,<->,39.224.191.198,0,0,1,75,1,75,1.808882000,0.0000
89.183.104.227,<->,33.57.79.42,1,52,0,0,1,52,1.808270000,0.0000
120.155.84.160,<->,98.190.121.68,0,0,1,108,1,108,1.808132000,0.0000
110.97.115.62,<->,92.27.26.102,0,0,1,57,1,57,1.808063000,0.0000
136.25.189.85,<->,29.211.206.37,1,83,0,0,1,83,1.807266000,0.0000
94.193.220.45,<->,34.47.144.136,0,0,1,52,1,52,1.807248000,0.0000
21.15.226.126,<->,20.193.19.98,0,0,1,82,1,82,1.807013000,0.0000
114.252.76.140,<->,20.43.111.128,0,0,1,52,1,52,1.806684000,0.0000
144.75.218.235,<->,138.127.230.2,1,238,0,0,1,238,1.806496000,0.0000
229.42.167.107,<->,92.27.27.99,0,0,1,213,1,213,1.804783000,0.0000
159.69.187.23,<->,6.147.33.6,1,73,0,0,1,73,1.804659000,0.0000
89.183.104.231,<->,0.97.210.244,1,52,0,0,1,52,1.803540000,0.0000
193.94.47.49,<->,109.222.226.221,0,0,1,64,1,64,1.803189000,0.0000
158.186.77.27,<->,89.183.104.171,0,0,1,81,1,81,1.802679000,0.0000
139.252.1.238,<->,39.14.27.228,0,0,1,201,1,201,1.802515000,0.0000
132.222.173.85,<->,132.43.156.54,1,346,0,0,1,346,1.802218000,0.0000
100.209.91.159,<->,92.27.219.221,0,0,1,52,1,52,1.801406000,0.0000
139.252.109.251,<->,80.56.78.128,0,0,1,97,1,97,1.801160000,0.0000
159.69.187.9,<->,144.108.64.179,1,66,0,0,1,66,1.800084000,0.0000
21.15.226.126,<->,20.193.19.78,0,0,1,82,1,82,1.799170000,0.0000
106.75.38.26,<->,92.27.27.173,0,0,1,300,1,300,1.797838000,0.0000
141.245.151.222,<->,53.244.113.73,1,305,0,0,1,305,1.797705000,0.0000
111.146.192.18,<->,97.160.194.93,1,65,0,0,1,65,1.797002000,0.0000
136.118.9.247,<->,129.221.194.218,1,165,0,0,1,165,1.795794000,0.0000
119.69.69.192,<->,92.27.219.222,0,0,1,52,1,52,1.795335000,0.0000
98.67.141.221,<->,49.41.242.61,1,65,0,0,1,65,1.795248000,0.0000
144.75.218.241,<->,138.127.231.3,1,301,0,0,1,301,1.794678000,0.0000
159.69.187.7,<->,144.108.64.179,1,69,0,0,1,69,1.794424000,0.0000
215.158.239.65,<->,6.116.31.8,1,85,0,0,1,85,1.794257000,0.0000
133.178.226.161,<->,29.211.126.97,1,90,0,0,1,90,1.793798000,0.0000
144.75.218.233,<->,129.35.251.34,1,140,0,0,1,140,1.792521000,0.0000
132.20.222.233,<->,129.224.112.253,0,0,1,63,1,63,1.792356000,0.0000
247.136.161.149,<->,193.87.145.139,1,319,0,0,1,319,1.791184000,0.0000
215.158.239.75,<->,29.212.183.183,1,85,0,0,1,85,1.790816000,0.0000
224.42.246.238,<->,20.146.99.67,0,0,1,72,1,72,1.790772000,0.0000
205.14.114.4,<->,92.27.219.141,0,0,1,52,1,52,1.790422000,0.0000
144.75.218.237,<->,138.127.225.8,1,248,0,0,1,248,1.789886000,0.0000
194.194.150.250,<->,102.50.172.123,0,0,1,58,1,58,1.787958000,0.0000
192.67.169.144,<->,117.65.167.57,1,50,0,0,1,50,1.787854000,0.0000
215.158.103.206,<->,129.201.176.4,1,792,0,0,1,792,1.787311000,0.0000
131.130.141.188,<->,20.87.123.170,0,0,1,66,1,66,1.787089000,0.0000
111.151.107.247,<->,8.252.222.117,0,0,1,134,1,134,1.786934000,0.0000
136.25.188.212,<->,120.155.222.33,1,106,0,0,1,106,1.786775000,0.0000
192.64.217.166,<->,112.177.147.253,1,52,0,0,1,52,1.786302000,0.0000
145.255.180.193,<->,144.75.218.233,0,0,1,175,1,175,1.784960000,0.0000
38.21.156.204,<->,20.232.230.156,0,0,1,82,1,82,1.784794000,0.0000
21.15.226.126,<->,20.193.20.59,0,0,1,82,1,82,1.784566000,0.0000
113.80.8.5,<->,39.61.116.154,0,0,1,136,1,136,1.784238000,0.0000
101.224.184.225,<->,38.103.13.199,1,50,0,0,1,50,1.784036000,0.0000
192.171.13.33,<->,8.252.223.8,0,0,1,96,1,96,1.783002000,0.0000
144.75.218.242,<->,97.94.119.43,1,77,0,0,1,77,1.780970000,0.0000
136.25.188.212,<->,8.253.128.68,1,106,0,0,1,106,1.779915000,0.0000
137.74.92.135,<->,45.186.235.53,1,65,0,0,1,65,1.779890000,0.0000
197.156.134.234,<->,89.183.104.251,0,0,1,52,1,52,1.779879000,0.0000
247.136.220.98,<->,88.142.1.240,1,149,0,0,1,149,1.779837000,0.0000
137.21.23.51,<->,111.151.107.247,1,225,0,0,1,225,1.778825000,0.0000
159.57.86.227,<->,144.75.218.233,0,0,1,200,1,200,1.778373000,0.0000
59.40.238.161,<->,6.74.97.62,0,0,1,130,1,130,1.778172000,0.0000
80.41.16.104,<->,4.123.53.96,1,130,0,0,1,130,1.777656000,0.0000
144.75.218.242,<->,97.94.148.45,1,84,0,0,1,84,1.777000000,0.0000
92.27.27.153,<->,4.111.11.130,1,52,0,0,1,52,1.776294000,0.0000
21.15.226.126,<->,20.193.20.39,0,0,1,82,1,82,1.775709000,0.0000
53.187.231.137,<->,39.15.169.14,0,0,1,87,1,87,1.775692000,0.0000
134.92.121.239,<->,92.27.219.19,0,0,1,115,1,115,1.775565000,0.0000
20.13.110.250,<->,0.200.50.50,1,60,0,0,1,60,1.774456000,0.0000
114.180.98.126,<->,89.183.104.231,0,0,1,52,1,52,1.773895000,0.0000
20.13.110.249,<->,0.200.50.50,1,60,0,0,1,60,1.773841000,0.0000
38.21.156.204,<->,20.232.230.158,0,0,1,82,1,82,1.773787000,0.0000
207.177.94.183,<->,109.222.246.96,0,0,1,52,1,52,1.772934000,0.0000
21.15.226.126,<->,20.193.20.71,0,0,1,82,1,82,1.772482000,0.0000
89.183.104.138,<->,32.214.170.72,1,52,0,0,1,52,1.772209000,0.0000
144.75.218.246,<->,33.238.66.4,1,489,0,0,1,489,1.771926000,0.0000
144.75.218.235,<->,138.127.231.71,1,252,0,0,1,252,1.771717000,0.0000
92.27.8.186,<->,57.170.97.96,1,79,0,0,1,79,1.771366000,0.0000
249.101.209.59,<->,119.131.53.203,1,52,0,0,1,52,1.770930000,0.0000
195.214.82.202,<->,111.181.96.243,0,0,1,321,1,321,1.770869000,0.0000
215.158.103.219,<->,114.93.159.36,1,77,0,0,1,77,1.770464000,0.0000
105.124.93.182,<->,92.27.219.60,0,0,1,135,1,135,1.769864000,0.0000
21.15.226.126,<->,20.193.20.44,0,0,1,82,1,82,1.769172000,0.0000
100.31.173.10,<->,80.42.135.244,0,0,1,77,1,77,1.768733000,0.0000
80.38.14.1,<->,17.60.158.28,1,80,0,0,1,80,1.768552000,0.0000
50.187.106.118,<->,48.54.240.26,0,0,1,52,1,52,1.767989000,0.0000
218.5.150.95,<->,144.75.218.241,0,0,1,139,1,139,1.767212000,0.0000
192.67.142.176,<->,126.196.234.152,1,133,0,0,1,133,1.767199000,0.0000
98.23.111.141,<->,92.27.209.105,0,0,1,50,1,50,1.764147000,0.0000
243.12.104.44,<->,136.25.188.105,0,0,1,136,1,136,1.762798000,0.0000
137.116.192.147,<->,92.27.219.228,0,0,1,62,1,62,1.762702000,0.0000
136.25.188.28,<->,111.151.107.247,1,114,0,0,1,114,1.762690000,0.0000
92.27.219.134,<->,38.68.132.30,1,52,0,0,1,52,1.762514000,0.0000
105.235.111.198,<->,80.40.48.131,0,0,1,50,1,50,1.762244000,0.0000
193.46.99.163,<->,192.64.213.70,0,0,1,129,1,129,1.762226000,0.0000
144.64.139.146,<->,57.140.246.54,1,70,0,0,1,70,1.762171000,0.0000
230.102.156.208,<->,129.224.112.252,0,0,1,78,1,78,1.762039000,0.0000
198.206.101.9,<->,20.23.176.109,0,0,1,138,1,138,1.761691000,0.0000
115.139.104.118,<->,89.183.104.147,0,0,1,52,1,52,1.761522000,0.0000
148.190.126.20,<->,133.178.227.8,0,0,1,85,1,85,1.761352000,0.0000
121.113.78.132,<->,0.195.210.15,0,0,1,158,1,158,1.760901000,0.0000
144.75.221.218,<->,138.98.246.1,0,0,1,123,1,123,1.760821000,0.0000
203.48.200.107,<->,39.1.58.234,0,0,1,72,1,72,1.760777000,0.0000
109.1.16.58,<->,27.188.163.162,1,446,0,0,1,446,1.760315000,0.0000
144.85.75.55,<->,53.156.60.32,1,66,0,0,1,66,1.759987000,0.0000
21.15.226.126,<->,20.193.20.137,0,0,1,82,1,82,1.759977000,0.0000
133.178.226.254,<->,91.57.162.49,1,91,0,0,1,91,1.759485000,0.0000
206.134.132.209,<->,89.183.104.135,0,0,1,347,1,347,1.759478000,0.0000
121.54.65.222,<->,80.41.3.230,0,0,1,135,1,135,1.759462000,0.0000
229.102.222.252,<->,20.197.122.244,0,0,1,60,1,60,1.759455000,0.0000
92.27.219.150,<->,48.108.228.77,1,52,0,0,1,52,1.758687000,0.0000
122.173.165.4,<->,100.95.138.197,0,0,1,130,1,130,1.757942000,0.0000
223.179.242.163,<->,109.222.254.165,0,0,1,94,1,94,1.757840000,0.0000
247.136.156.18,<->,33.215.53.77,1,103,0,0,1,103,1.757744000,0.0000
124.119.26.152,<->,39.47.255.177,0,0,1,72,1,72,1.757306000,0.0000
133.178.226.245,<->,111.151.107.247,1,134,0,0,1,134,1.757130000,0.0000
112.185.63.12,<->,39.174.251.232,0,0,1,68,1,68,1.756977000,0.0000
109.222.219.165,<->,66.210.2.210,1,79,0,0,1,79,1.756869000,0.0000
220.55.190.246,<->,80.40.61.250,0,0,1,149,1,149,1.756608000,0.0000
118.229.89.67,<->,109.222.192.55,0,0,1,52,1,52,1.756070000,0.0000
146.250.128.76,<->,129.224.112.252,0,0,1,89,1,89,1.755682000,0.0000
246.254.97.149,<->,37.103.76.210,1,79,0,0,1,79,1.755433000,0.0000
133.178.226.245,<->,8.191.0.37,1,90,0,0,1,90,1.754840000,0.0000
131.187.69.142,<->,92.27.27.147,0,0,1,273,1,273,1.754347000,0.0000
33.211.90.124,<->,20.177.85.11,0,0,1,70,1,70,1.754090000,0.0000
92.27.219.195,<->,82.99.190.137,1,52,0,0,1,52,1.753524000,0.0000
210.229.230.12,<->,158.187.177.85,1,52,0,0,1,52,1.753506000,0.0000
144.75.218.235,<->,109.115.48.64,1,132,0,0,1,132,1.752506000,0.0000
195.213.8.246,<->,99.72.147.6,0,0,1,149,1,149,1.752391000,0.0000
129.224.112.252,<->,127.19.235.252,1,69,0,0,1,69,1.752132000,0.0000
20.13.110.224,<->,0.200.50.50,1,60,0,0,1,60,1.752104000,0.0000
80.42.179.50,<->,78.3.177.2,1,69,0,0,1,69,1.751970000,0.0000
92.27.219.248,<->,92.19.180.10,1,353,0,0,1,353,1.751145000,0.0000
195.78.241.6,<->,100.92.54.27,0,0,1,135,1,135,1.751057000,0.0000
118.20.111.92,<->,97.126.26.70,0,0,1,100,1,100,1.750988000,0.0000
109.222.250.132,<->,22.47.119.98,1,76,0,0,1,76,1.750049000,0.0000
246.253.252.58,<->,133.185.237.41,1,116,0,0,1,116,1.749808000,0.0000
104.130.114.205,<->,92.27.219.50,0,0,1,52,1,52,1.749603000,0.0000
144.75.218.235,<->,139.252.1.230,1,90,0,0,1,90,1.749461000,0.0000
131.29.50.225,<->,129.224.112.221,0,0,1,59,1,59,1.749412000,0.0000
126.204.219.116,<->,99.72.71.250,0,0,1,130,1,130,1.749164000,0.0000
119.71.120.173,<->,92.27.219.30,0,0,1,52,1,52,1.748891000,0.0000
145.148.156.184,<->,138.98.246.1,0,0,1,118,1,118,1.748583000,0.0000
98.232.172.60,<->,29.214.120.107,1,88,0,0,1,88,1.748339000,0.0000
97.126.18.88,<->,14.172.128.222,1,80,0,0,1,80,1.747063000,0.0000
98.23.102.124,<->,29.211.214.82,0,0,1,86,1,86,1.746630000,0.0000
144.75.218.233,<->,138.127.224.239,1,366,0,0,1,366,1.746340000,0.0000
249.101.98.217,<->,76.75.223.231,1,168,0,0,1,168,1.746210000,0.0000
144.75.218.235,<->,143.204.138.236,1,177,0,0,1,177,1.745794000,0.0000
247.136.171.153,<->,40.219.7.103,1,138,0,0,1,138,1.744517000,0.0000
159.153.54.153,<->,159.69.187.31,0,0,1,69,1,69,1.744429000,0.0000
144.75.218.242,<->,97.232.6.180,1,145,0,0,1,145,1.743968000,0.0000
144.93.121.10,<->,98.151.29.220,1,50,0,0,1,50,1.743675000,0.0000
144.75.218.233,<->,138.24.14.249,1,93,0,0,1,93,1.743195000,0.0000
247.136.216.15,<->,115.181.233.214,1,50,0,0,1,50,1.742322000,0.0000
145.77.134.40,<->,136.25.188.37,0,0,1,268,1,268,1.741729000,0.0000
121.92.159.163,<->,39.45.164.231,0,0,1,88,1,88,1.740667000,0.0000
159.69.187.32,<->,144.108.80.170,1,69,0,0,1,69,1.740425000,0.0000
53.199.219.107,<->,39.15.169.14,0,0,1,88,1,88,1.739821000,0.0000
113.183.175.35,<->,109.222.199.156,0,0,1,138,1,138,1.739714000,0.0000
144.75.218.242,<->,138.127.231.102,1,263,0,0,1,263,1.738753000,0.0000
131.214.147.20,<->,20.223.147.81,0,0,1,126,1,126,1.737564000,0.0000
252.98.141.62,<->,132.43.156.56,1,537,0,0,1,537,1.737319000,0.0000
21.15.226.126,<->,20.193.20.186,0,0,1,82,1,82,1.737055000,0.0000
109.14.213.84,<->,80.56.78.92,0,0,1,90,1,90,1.736944000,0.0000
119.184.145.46,<->,89.183.104.255,0,0,1,273,1,273,1.736600000,0.0000
136.25.188.212,<->,131.31.145.149,1,135,0,0,1,135,1.736443000,0.0000
249.101.197.94,<->,193.46.99.163,1,300,0,0,1,300,1.735737000,0.0000
159.69.187.8,<->,144.108.80.170,1,68,0,0,1,68,1.735308000,0.0000
89.181.78.109,<->,69.169.140.254,1,133,0,0,1,133,1.735136000,0.0000
192.64.251.170,<->,112.55.69.6,1,130,0,0,1,130,1.735047000,0.0000
136.25.189.6,<->,89.86.110.252,1,83,0,0,1,83,1.734807000,0.0000
215.158.239.235,<->,97.1.150.245,1,119,0,0,1,119,1.734570000,0.0000
144.75.218.237,<->,138.127.230.226,1,241,0,0,1,241,1.734479000,0.0000
159.240.189.204,<->,159.69.187.46,0,0,1,65,1,65,1.734402000,0.0000
127.52.50.127,<->,20.215.179.208,0,0,1,74,1,74,1.733528000,0.0000
21.15.226.126,<->,20.193.21.200,0,0,1,82,1,82,1.733192000,0.0000
21.15.226.126,<->,20.193.21.207,0,0,1,82,1,82,1.732750000,0.0000
215.158.99.21,<->,29.211.214.254,0,0,1,96,1,96,1.732554000,0.0000
205.14.35.32,<->,80.42.153.35,0,0,1,130,1,130,1.732428000,0.0000
101.70.119.12,<->,48.40.197.2,1,70,0,0,1,70,1.732393000,0.0000
89.183.104.164,<->,29.239.126.131,1,52,0,0,1,52,1.732139000,0.0000
220.55.110.92,<->,8.47.188.160,1,95,0,0,1,95,1.731868000,0.0000
155.133.82.169,<->,20.141.54.228,0,0,1,52,1,52,1.731067000,0.0000
230.126.6.104,<->,39.227.65.70,0,0,1,52,1,52,1.731049000,0.0000
247.136.209.27,<->,235.226.212.248,1,485,0,0,1,485,1.730569000,0.0000
158.236.129.2,<->,39.11.131.163,0,0,1,74,1,74,1.729749000,0.0000
144.64.137.156,<->,141.95.30.10,1,89,0,0,1,89,1.728779000,0.0000
159.69.187.25,<->,144.108.80.164,1,74,0,0,1,74,1.727051000,0.0000
248.225.26.61,<->,53.190.60.6,1,96,0,0,1,96,1.726532000,0.0000
144.75.218.242,<->,33.229.58.179,1,128,0,0,1,128,1.726050000,0.0000
77.43.208.251,<->,8.238.100.28,0,0,1,133,1,133,1.725288000,0.0000
21.15.226.126,<->,20.193.21.222,0,0,1,82,1,82,1.725281000,0.0000
144.75.218.242,<->,98.192.190.17,1,233,0,0,1,233,1.724540000,0.0000
92.27.219.240,<->,40.208.251.226,1,52,0,0,1,52,1.724497000,0.0000
21.15.226.126,<->,20.193.21.218,0,0,1,82,1,82,1.724168000,0.0000
204.128.217.52,<->,39.52.63.66,0,0,1,74,1,74,1.724156000,0.0000
192.64.217.166,<->,117.79.29.177,1,52,0,0,1,52,1.723548000,0.0000
192.178.155.130,<->,145.242.126.41,0,0,1,80,1,80,1.723109000,0.0000
97.126.19.12,<->,87.58.45.107,1,77,0,0,1,77,1.722308000,0.0000
215.158.140.216,<->,192.171.13.190,1,297,0,0,1,297,1.721929000,0.0000
80.56.91.244,<->,8.252.223.158,0,0,1,1112,1,1112,1.721727000,0.0000
142.255.168.235,<->,97.68.226.205,0,0,1,68,1,68,1.721369000,0.0000
144.75.218.237,<->,140.2.100.1,1,111,0,0,1,111,1.720682000,0.0000
92.181.148.15,<->,66.208.116.91,1,273,0,0,1,273,1.720083000,0.0000
133.85.3.240,<->,92.27.219.239,0,0,1,245,1,245,1.719117000,0.0000
132.249.70.233,<->,127.106.198.124,1,82,0,0,1,82,1.719002000,0.0000
106.170.107.166,<->,80.40.34.206,0,0,1,130,1,130,1.718773000,0.0000
115.32.78.106,<->,97.168.67.159,0,0,1,73,1,73,1.716609000,0.0000
127.212.85.77,<->,92.27.27.143,0,0,1,52,1,52,1.716582000,0.0000
149.172.30.236,<->,144.75.218.242,0,0,1,134,1,134,1.716371000,0.0000
144.75.218.242,<->,138.127.224.222,1,365,0,0,1,365,1.715725000,0.0000
143.128.215.217,<->,20.204.85.16,0,0,1,76,1,76,1.715620000,0.0000
124.69.188.3,<->,92.27.27.165,0,0,1,79,1,79,1.715540000,0.0000
210.220.219.153,<->,138.127.225.156,1,288,0,0,1,288,1.715422000,0.0000
247.136.180.232,<->,65.58.158.114,1,135,0,0,1,135,1.715406000,0.0000
158.147.252.44,<->,145.252.120.138,0,0,1,60,1,60,1.714784000,0.0000
114.243.20.92,<->,39.30.46.223,0,0,1,88,1,88,1.714246000,0.0000
80.41.34.78,<->,38.169.174.244,1,72,0,0,1,72,1.713897000,0.0000
93.92.135.178,<->,80.42.140.207,0,0,1,52,1,52,1.713888000,0.0000
75.139.231.146,<->,39.233.251.76,0,0,1,62,1,62,1.713477000,0.0000
132.107.83.63,<->,89.183.104.189,0,0,1,52,1,52,1.713292000,0.0000
195.57.66.213,<->,92.27.219.224,0,0,1,52,1,52,1.713263000,0.0000
92.27.219.36,<->,33.156.10.96,1,351,0,0,1,351,1.713252000,0.0000
121.20.248.113,<->,99.72.148.194,0,0,1,135,1,135,1.712978000,0.0000
141.249.135.210,<->,92.27.219.224,0,0,1,52,1,52,1.712692000,0.0000
193.46.99.139,<->,192.67.161.171,0,0,1,129,1,129,1.712575000,0.0000
144.75.218.246,<->,138.127.231.246,1,269,0,0,1,269,1.712225000,0.0000
21.15.226.126,<->,20.193.21.148,0,0,1,82,1,82,1.711739000,0.0000
21.15.226.126,<->,20.193.21.151,0,0,1,82,1,82,1.711181000,0.0000
206.165.196.61,<->,92.27.27.182,0,0,1,52,1,52,1.711020000,0.0000
21.15.226.126,<->,20.193.21.167,0,0,1,82,1,82,1.710517000,0.0000
159.137.142.17,<->,135.207.217.74,1,78,0,0,1,78,1.710006000,0.0000
53.251.63.173,<->,39.15.169.14,0,0,1,87,1,87,1.709110000,0.0000
21.15.226.126,<->,20.193.21.144,0,0,1,82,1,82,1.709089000,0.0000
249.101.218.38,<->,40.154.48.215,1,340,0,0,1,340,1.708685000,0.0000
247.136.229.50,<->,144.46.53.180,1,99,0,0,1,99,1.708532000,0.0000
195.78.209.21,<->,99.75.149.84,0,0,1,66,1,66,1.707342000,0.0000
195.69.43.52,<->,20.123.2.65,0,0,1,74,1,74,1.707061000,0.0000
136.25.188.105,<->,135.228.158.61,1,268,0,0,1,268,1.706875000,0.0000
215.158.103.219,<->,138.127.224.38,1,355,0,0,1,355,1.706557000,0.0000
159.69.187.18,<->,144.108.80.170,1,66,0,0,1,66,1.705981000,0.0000
124.30.39.58,<->,92.27.219.42,0,0,1,116,1,116,1.705196000,0.0000
116.226.161.204,<->,20.129.44.50,0,0,1,68,1,68,1.705074000,0.0000
129.224.112.252,<->,114.145.64.123,1,83,0,0,1,83,1.704519000,0.0000
144.75.218.235,<->,138.127.230.84,1,366,0,0,1,366,1.704485000,0.0000
246.254.97.149,<->,8.240.125.22,1,93,0,0,1,93,1.703835000,0.0000
144.75.218.241,<->,131.65.15.83,1,141,0,0,1,141,1.702332000,0.0000
21.15.226.126,<->,20.193.21.174,0,0,1,82,1,82,1.701998000,0.0000
205.37.52.56,<->,102.50.96.106,0,0,1,351,1,351,1.701197000,0.0000
136.47.66.197,<->,111.146.146.108,0,0,1,80,1,80,1.700959000,0.0000
146.220.125.81,<->,129.224.112.252,0,0,1,90,1,90,1.700702000,0.0000
144.122.240.202,<->,144.108.64.179,1,71,0,0,1,71,1.700314000,0.0000
92.27.219.185,<->,67.240.227.196,1,62,0,0,1,62,1.700173000,0.0000
192.252.224.95,<->,136.181.50.99,0,0,1,293,1,293,1.698522000,0.0000
136.25.188.105,<->,63.73.200.51,1,137,0,0,1,137,1.698072000,0.0000
139.252.1.244,<->,136.25.188.164,0,0,1,184,1,184,1.696757000,0.0000
98.67.131.97,<->,65.44.36.70,1,68,0,0,1,68,1.696028000,0.0000
117.155.169.79,<->,99.75.239.34,0,0,1,100,1,100,1.695792000,0.0000
144.75.218.237,<->,53.149.3.155,1,81,0,0,1,81,1.695269000,0.0000
247.136.152.230,<->,104.50.172.179,1,344,0,0,1,344,1.694925000,0.0000
129.224.112.252,<->,97.242.126.198,1,71,0,0,1,71,1.694833000,0.0000
159.25.30.7,<->,64.253.134.141,1,52,0,0,1,52,1.694110000,0.0000
192.64.238.102,<->,110.4.15.52,1,353,0,0,1,353,1.693813000,0.0000
132.43.156.56,<->,89.139.241.98,0,0,1,167,1,167,1.693305000,0.0000
159.69.187.55,<->,144.108.80.170,1,64,0,0,1,64,1.693212000,0.0000
144.75.218.241,<->,116.126.255.82,1,89,0,0,1,89,1.692707000,0.0000
109.1.16.50,<->,27.188.163.162,1,447,0,0,1,447,1.692565000,0.0000
102.51.52.249,<->,93.137.103.10,1,629,0,0,1,629,1.691955000,0.0000
135.81.77.209,<->,92.27.219.216,0,0,1,135,1,135,1.690155000,0.0000
230.80.188.183,<->,80.42.177.161,0,0,1,133,1,133,1.690142000,0.0000
159.28.159.6,<->,129.224.112.252,0,0,1,89,1,89,1.689552000,0.0000
141.21.158.209,<->,20.135.157.252,0,0,1,74,1,74,1.689312000,0.0000
144.75.218.235,<->,138.127.230.78,1,365,0,0,1,365,1.689285000,0.0000
199.20.220.230,<->,136.25.188.105,0,0,1,139,1,139,1.689182000,0.0000
136.25.189.86,<->,89.86.110.252,1,83,0,0,1,83,1.688744000,0.0000
144.122.240.242,<->,101.176.22.220,1,87,0,0,1,87,1.688197000,0.0000
247.157.201.195,<->,77.47.138.255,1,133,0,0,1,133,1.688022000,0.0000
131.144.248.251,<->,129.224.112.252,0,0,1,74,1,74,1.687811000,0.0000
104.136.71.239,<->,102.51.73.163,0,0,1,149,1,149,1.687695000,0.0000
144.75.218.237,<->,8.47.123.78,1,132,0,0,1,132,1.686266000,0.0000
20.13.110.223,<->,0.200.50.50,1,60,0,0,1,60,1.685928000,0.0000
20.191.230.158,<->,18.195.16.153,1,140,0,0,1,140,1.684715000,0.0000
92.27.219.226,<->,80.233.117.143,1,52,0,0,1,52,1.684263000,0.0000
61.95.120.154,<->,34.106.38.67,0,0,1,52,1,52,1.683807000,0.0000
145.16.29.114,<->,138.127.230.158,1,301,0,0,1,301,1.683145000,0.0000
109.1.25.177,<->,27.87.88.245,1,135,0,0,1,135,1.682964000,0.0000
92.27.27.165,<->,38.227.135.0,1,52,0,0,1,52,1.682658000,0.0000
129.34.166.15,<->,101.224.183.195,0,0,1,86,1,86,1.681802000,0.0000
82.165.200.247,<->,80.40.41.29,0,0,1,52,1,52,1.681562000,0.0000
230.91.97.101,<->,92.181.151.40,0,0,1,94,1,94,1.681089000,0.0000
21.15.226.126,<->,20.193.21.16,0,0,1,82,1,82,1.680878000,0.0000
135.241.174.242,<->,89.183.104.178,0,0,1,135,1,135,1.679966000,0.0000
215.158.2.49,<->,80.56.78.92,0,0,1,87,1,87,1.678554000,0.0000
159.240.189.205,<->,159.69.187.44,0,0,1,67,1,67,1.678423000,0.0000
144.75.218.235,<->,138.127.224.190,1,242,0,0,1,242,1.678348000,0.0000
144.75.218.246,<->,139.252.1.219,1,87,0,0,1,87,1.677961000,0.0000
144.75.218.241,<->,138.127.230.247,1,345,0,0,1,345,1.677820000,0.0000
104.241.56.221,<->,39.42.64.37,0,0,1,92,1,92,1.677744000,0.0000
206.55.150.194,<->,192.64.193.89,0,0,1,135,1,135,1.677706000,0.0000
129.19.157.66,<->,80.38.62.126,0,0,1,130,1,130,1.676854000,0.0000
114.250.29.227,<->,20.40.80.181,0,0,1,84,1,84,1.676724000,0.0000
143.125.33.18,<->,20.241.43.58,0,0,1,75,1,75,1.676693000,0.0000
144.72.25.37,<->,136.25.189.210,0,0,1,140,1,140,1.676646000,0.0000
132.7.214.52,<->,80.41.31.9,0,0,1,169,1,169,1.674669000,0.0000
249.101.211.150,<->,193.21.29.234,1,342,0,0,1,342,1.672597000,0.0000
119.95.205.11,<->,20.223.116.61,0,0,1,531,1,531,1.672274000,0.0000
230.115.138.250,<->,50.128.49.96,0,0,1,130,1,130,1.671525000,0.0000
92.27.219.60,<->,38.246.57.185,1,52,0,0,1,52,1.671381000,0.0000
54.39.40.181,<->,48.53.8.41,0,0,1,52,1,52,1.671117000,0.0000
136.25.189.95,<->,109.205.55.54,1,84,0,0,1,84,1.671076000,0.0000
98.67.155.114,<->,26.215.169.221,1,294,0,0,1,294,1.669211000,0.0000
247.136.220.79,<->,199.12.111.105,1,86,0,0,1,86,1.668593000,0.0000
21.15.226.126,<->,20.193.22.96,0,0,1,82,1,82,1.668488000,0.0000
132.208.70.62,<->,92.27.219.204,0,0,1,647,1,647,1.667852000,0.0000
144.122.240.210,<->,144.108.64.179,1,73,0,0,1,73,1.667824000,0.0000
59.32.3.142,<->,34.175.70.188,0,0,1,52,1,52,1.667346000,0.0000
144.75.218.242,<->,138.127.225.202,1,281,0,0,1,281,1.666801000,0.0000
144.75.218.246,<->,138.127.230.199,1,156,0,0,1,156,1.666622000,0.0000
138.127.229.105,<->,99.74.26.170,0,0,1,202,1,202,1.665107000,0.0000
59.48.50.193,<->,39.246.50.147,0,0,1,75,1,75,1.665038000,0.0000
137.68.202.255,<->,92.27.219.244,0,0,1,52,1,52,1.664473000,0.0000
56.121.61.107,<->,45.144.219.2,1,78,0,0,1,78,1.664457000,0.0000
21.15.226.126,<->,20.193.22.105,0,0,1,82,1,82,1.663848000,0.0000
195.79.196.122,<->,100.94.21.80,0,0,1,52,1,52,1.663512000,0.0000
207.52.161.205,<->,92.27.8.182,0,0,1,137,1,137,1.663129000,0.0000
144.75.218.233,<->,114.145.99.171,1,252,0,0,1,252,1.662982000,0.0000
29.157.34.92,<->,20.96.230.181,0,0,1,65,1,65,1.662671000,0.0000
144.122.240.161,<->,144.108.64.179,1,64,0,0,1,64,1.661439000,0.0000
144.75.218.242,<->,102.45.225.190,1,71,0,0,1,71,1.661092000,0.0000
124.69.12.108,<->,39.148.38.40,0,0,1,68,1,68,1.660964000,0.0000
207.6.180.170,<->,20.59.1.124,0,0,1,66,1,66,1.660950000,0.0000
110.16.19.26,<->,109.222.250.46,0,0,1,133,1,133,1.659358000,0.0000
132.200.62.136,<->,132.200.50.12,1,540,0,0,1,540,1.659293000,0.0000
141.19.255.22,<->,20.182.201.244,0,0,1,70,1,70,1.659289000,0.0000
144.76.43.234,<->,80.56.78.94,0,0,1,94,1,94,1.659281000,0.0000
210.220.219.153,<->,136.42.3.53,1,305,0,0,1,305,1.658579000,0.0000
129.175.139.146,<->,29.211.214.254,0,0,1,90,1,90,1.657542000,0.0000
220.76.219.196,<->,20.3.94.150,0,0,1,70,1,70,1.657297000,0.0000
109.222.234.11,<->,22.73.14.11,1,66,0,0,1,66,1.657000000,0.0000
192.64.234.225,<->,125.44.173.36,1,50,0,0,1,50,1.656968000,0.0000
199.20.248.41,<->,129.224.112.252,0,0,1,66,1,66,1.656309000,0.0000
144.75.218.237,<->,141.37.226.95,1,86,0,0,1,86,1.655838000,0.0000
138.74.30.45,<->,111.150.58.148,1,81,0,0,1,81,1.655080000,0.0000
105.200.247.154,<->,98.236.254.250,0,0,1,77,1,77,1.654132000,0.0000
197.1.230.13,<->,109.1.52.14,0,0,1,135,1,135,1.653519000,0.0000
109.222.222.50,<->,103.5.47.180,1,66,0,0,1,66,1.652481000,0.0000
92.27.27.149,<->,69.175.112.209,1,99,0,0,1,99,1.651437000,0.0000
192.67.179.218,<->,93.165.188.179,1,105,0,0,1,105,1.650982000,0.0000
248.225.27.2,<->,29.214.217.95,1,141,0,0,1,141,1.650946000,0.0000
120.155.86.237,<->,8.252.222.232,0,0,1,134,1,134,1.650611000,0.0000
109.222.242.102,<->,8.224.46.33,1,74,0,0,1,74,1.648885000,0.0000
125.31.133.96,<->,80.41.32.57,0,0,1,321,1,321,1.648561000,0.0000
145.13.164.41,<->,136.25.189.210,0,0,1,111,1,111,1.647978000,0.0000
247.136.209.27,<->,158.150.64.93,1,501,0,0,1,501,1.647908000,0.0000
126.2.6.102,<->,39.128.168.188,0,0,1,96,1,96,1.647740000,0.0000
109.206.164.233,<->,50.224.92.54,0,0,1,161,1,161,1.647485000,0.0000
144.75.218.241,<->,50.149.206.89,1,126,0,0,1,126,1.646038000,0.0000
215.158.238.178,<->,192.170.179.2,1,1064,0,0,1,1064,1.645421000,0.0000
145.89.157.42,<->,67.219.231.169,1,130,0,0,1,130,1.645220000,0.0000
194.124.8.102,<->,39.144.84.198,0,0,1,76,1,76,1.644286000,0.0000
198.151.3.63,<->,22.59.13.208,0,0,1,72,1,72,1.644161000,0.0000
129.224.112.220,<->,114.186.133.55,1,86,0,0,1,86,1.643727000,0.0000
97.126.2.116,<->,95.89.187.66,1,66,0,0,1,66,1.642561000,0.0000
113.114.28.98,<->,89.183.104.135,0,0,1,52,1,52,1.640328000,0.0000
215.158.34.160,<->,136.25.189.94,0,0,1,1064,1,1064,1.639982000,0.0000
120.4.61.182,<->,80.42.191.110,0,0,1,321,1,321,1.638060000,0.0000
80.42.181.14,<->,77.101.137.113,1,79,0,0,1,79,1.637704000,0.0000
138.127.224.104,<->,92.27.219.227,0,0,1,371,1,371,1.637507000,0.0000
144.70.164.220,<->,101.224.172.116,0,0,1,68,1,68,1.637387000,0.0000
215.158.2.59,<->,159.123.32.28,0,0,1,89,1,89,1.636548000,0.0000
227.56.35.246,<->,144.75.218.237,0,0,1,150,1,150,1.636302000,0.0000
140.21.17.68,<->,20.234.93.132,0,0,1,68,1,68,1.635988000,0.0000
144.75.218.237,<->,128.8.21.253,1,159,0,0,1,159,1.635809000,0.0000
215.158.238.77,<->,144.56.210.43,1,84,0,0,1,84,1.635250000,0.0000
192.64.101.241,<->,105.170.162.64,1,98,0,0,1,98,1.634801000,0.0000
144.75.218.233,<->,138.127.230.15,1,366,0,0,1,366,1.634525000,0.0000
39.254.3.217,<->,27.114.181.217,1,88,0,0,1,88,1.633818000,0.0000
100.16.23.197,<->,92.27.219.34,0,0,1,369,1,369,1.633249000,0.0000
144.75.218.235,<->,120.155.84.208,1,150,0,0,1,150,1.632004000,0.0000
118.44.93.84,<->,101.224.204.193,0,0,1,227,1,227,1.629487000,0.0000
111.82.141.173,<->,80.41.15.57,0,0,1,138,1,138,1.629454000,0.0000
129.224.112.252,<->,80.27.155.182,1,74,0,0,1,74,1.628344000,0.0000
134.161.237.45,<->,92.27.219.39,0,0,1,52,1,52,1.627322000,0.0000
106.126.137.134,<->,89.183.104.171,0,0,1,105,1,105,1.627095000,0.0000
106.158.67.80,<->,92.27.219.189,0,0,1,52,1,52,1.626298000,0.0000
121.209.106.187,<->,92.27.219.130,0,0,1,99,1,99,1.625717000,0.0000
215.158.103.219,<->,129.223.93.3,1,795,0,0,1,795,1.624806000,0.0000
138.86.243.67,<->,20.185.113.162,0,0,1,66,1,66,1.624630000,0.0000
192.67.165.98,<->,57.248.174.7,1,52,0,0,1,52,1.624344000,0.0000
116.145.113.34,<->,80.41.36.78,0,0,1,130,1,130,1.623068000,0.0000
140.145.90.254,<->,39.129.92.211,0,0,1,70,1,70,1.620014000,0.0000
220.82.62.48,<->,100.230.7.117,1,50,0,0,1,50,1.619799000,0.0000
92.27.219.216,<->,48.105.201.130,1,1437,0,0,1,1437,1.619182000,0.0000
192.67.161.143,<->,105.71.224.108,1,130,0,0,1,130,1.616931000,0.0000
247.136.249.234,<->,124.19.52.147,1,332,0,0,1,332,1.616494000,0.0000
105.113.53.216,<->,97.168.89.179,0,0,1,78,1,78,1.615493000,0.0000
106.42.39.78,<->,89.183.104.235,0,0,1,52,1,52,1.615149000,0.0000
144.64.139.146,<->,141.95.30.8,1,78,0,0,1,78,1.614940000,0.0000
92.27.219.211,<->,29.170.153.193,1,52,0,0,1,52,1.613614000,0.0000
136.25.188.212,<->,122.158.53.79,1,106,0,0,1,106,1.613255000,0.0000
133.178.227.4,<->,120.190.31.252,1,85,0,0,1,85,1.612790000,0.0000
109.222.233.46,<->,50.213.212.120,1,72,0,0,1,72,1.612618000,0.0000
194.248.157.78,<->,80.42.184.239,0,0,1,273,1,273,1.612563000,0.0000
193.46.99.104,<->,92.27.219.58,0,0,1,129,1,129,1.612422000,0.0000
220.87.90.39,<->,77.10.246.184,1,130,0,0,1,130,1.611286000,0.0000
139.252.1.254,<->,92.27.27.144,0,0,1,371,1,371,1.610345000,0.0000
246.253.248.211,<->,53.165.88.118,1,87,0,0,1,87,1.610302000,0.0000
111.147.103.177,<->,74.143.202.144,1,133,0,0,1,133,1.608962000,0.0000
192.64.245.55,<->,64.145.129.216,1,133,0,0,1,133,1.608688000,0.0000
38.21.156.204,<->,20.232.230.111,0,0,1,82,1,82,1.608433000,0.0000
158.197.29.201,<->,132.249.70.62,0,0,1,79,1,79,1.608361000,0.0000
21.15.226.126,<->,20.193.23.29,0,0,1,82,1,82,1.608183000,0.0000
144.75.218.242,<->,53.245.2.193,1,389,0,0,1,389,1.607938000,0.0000
109.222.242.9,<->,33.122.48.183,1,135,0,0,1,135,1.607627000,0.0000
133.178.227.6,<->,69.132.194.25,1,85,0,0,1,85,1.604721000,0.0000
104.137.94.112,<->,100.93.156.236,0,0,1,52,1,52,1.603653000,0.0000
107.124.169.151,<->,20.108.208.6,0,0,1,138,1,138,1.603393000,0.0000
144.75.218.237,<->,143.204.138.237,1,147,0,0,1,147,1.602866000,0.0000
144.75.218.233,<->,139.252.1.240,1,176,0,0,1,176,1.602829000,0.0000
207.79.237.54,<->,80.42.179.14,0,0,1,133,1,133,1.602740000,0.0000
107.27.243.242,<->,92.27.209.223,0,0,1,64,1,64,1.602726000,0.0000
92.27.219.31,<->,48.106.6.25,1,52,0,0,1,52,1.601276000,0.0000
192.64.229.17,<->,125.22.183.127,1,50,0,0,1,50,1.601022000,0.0000
129.224.112.252,<->,6.255.241.212,1,71,0,0,1,71,1.600850000,0.0000
89.183.104.248,<->,65.63.203.208,1,52,0,0,1,52,1.600624000,0.0000
148.145.2.123,<->,80.38.23.182,0,0,1,83,1,83,1.600117000,0.0000
21.15.226.126,<->,20.193.23.151,0,0,1,82,1,82,1.600078000,0.0000
104.232.149.213,<->,92.27.219.242,0,0,1,1470,1,1470,1.598402000,0.0000
215.158.197.2,<->,29.211.214.32,0,0,1,95,1,95,1.597690000,0.0000
144.75.218.237,<->,132.107.75.195,1,139,0,0,1,139,1.597683000,0.0000
193.46.97.52,<->,144.75.218.241,0,0,1,255,1,255,1.597646000,0.0000
207.82.255.101,<->,100.94.116.200,0,0,1,133,1,133,1.596787000,0.0000
248.239.72.227,<->,230.126.217.254,1,52,0,0,1,52,1.596537000,0.0000
20.13.110.159,<->,0.200.50.50,1,60,0,0,1,60,1.596399000,0.0000
208.197.123.108,<->,144.75.218.237,0,0,1,173,1,173,1.596277000,0.0000
101.106.122.69,<->,92.27.219.153,0,0,1,135,1,135,1.596082000,0.0000
148.174.57.174,<->,20.253.43.110,0,0,1,75,1,75,1.595799000,0.0000
215.158.103.219,<->,138.12.41.133,1,260,0,0,1,260,1.595636000,0.0000
132.43.156.81,<->,99.72.128.44,0,0,1,140,1,140,1.594971000,0.0000
80.56.91.244,<->,8.176.8.66,0,0,1,1112,1,1112,1.594815000,0.0000
108.42.106.231,<->,20.83.31.66,0,0,1,66,1,66,1.594100000,0.0000
220.187.88.96,<->,92.27.219.166,0,0,1,101,1,101,1.593879000,0.0000
133.178.226.161,<->,50.50.242.205,1,86,0,0,1,86,1.593203000,0.0000
152.139.138.6,<->,20.65.179.36,0,0,1,120,1,120,1.591441000,0.0000
210.158.44.7,<->,112.219.53.218,1,101,0,0,1,101,1.591226000,0.0000
144.75.218.235,<->,54.38.169.95,1,126,0,0,1,126,1.590857000,0.0000
149.99.133.169,<->,39.131.216.132,0,0,1,75,1,75,1.589670000,0.0000
110.243.222.128,<->,92.27.27.144,0,0,1,135,1,135,1.589025000,0.0000
144.75.218.237,<->,138.127.224.106,1,351,0,0,1,351,1.588698000,0.0000
109.1.16.32,<->,27.188.163.162,1,444,0,0,1,444,1.588608000,0.0000
202.178.8.208,<->,137.21.3.65,0,0,1,78,1,78,1.587992000,0.0000
106.126.193.90,<->,92.27.27.165,0,0,1,52,1,52,1.587580000,0.0000
124.119.26.152,<->,39.160.108.83,0,0,1,70,1,70,1.587476000,0.0000
98.232.172.60,<->,38.93.187.200,1,84,0,0,1,84,1.587233000,0.0000
93.181.154.55,<->,92.27.219.18,0,0,1,263,1,263,1.587113000,0.0000
152.111.129.170,<->,109.0.243.153,0,0,1,133,1,133,1.586983000,0.0000
121.36.81.175,<->,92.27.219.244,0,0,1,52,1,52,1.586829000,0.0000
159.64.148.27,<->,80.38.7.6,0,0,1,73,1,73,1.586101000,0.0000
57.156.192.130,<->,20.56.46.101,0,0,1,68,1,68,1.585617000,0.0000
109.1.16.130,<->,27.188.163.162,1,443,0,0,1,443,1.585328000,0.0000
97.126.113.124,<->,20.149.248.50,1,75,0,0,1,75,1.585099000,0.0000
235.149.63.46,<->,136.25.188.105,0,0,1,534,1,534,1.584890000,0.0000
144.75.218.235,<->,128.124.28.90,1,126,0,0,1,126,1.584701000,0.0000
243.117.125.52,<->,129.224.112.252,0,0,1,76,1,76,1.584701000,0.0000
111.151.107.247,<->,8.176.8.191,0,0,1,154,1,154,1.582332000,0.0000
192.64.215.241,<->,0.236.1.58,1,130,0,0,1,130,1.581009000,0.0000
249.85.53.53,<->,144.75.218.246,0,0,1,155,1,155,1.580476000,0.0000
193.46.99.193,<->,101.70.98.5,0,0,1,300,1,300,1.579447000,0.0000
115.190.178.7,<->,80.41.31.15,0,0,1,52,1,52,1.579153000,0.0000
133.54.28.219,<->,119.5.13.52,1,79,0,0,1,79,1.578524000,0.0000
38.21.156.204,<->,20.232.230.97,0,0,1,82,1,82,1.577444000,0.0000
136.25.188.105,<->,128.171.253.114,1,87,0,0,1,87,1.577350000,0.0000
115.188.244.99,<->,80.41.8.174,0,0,1,84,1,84,1.577176000,0.0000
116.227.172.225,<->,20.134.11.149,0,0,1,88,1,88,1.576926000,0.0000
136.95.254.242,<->,136.25.188.40,0,0,1,103,1,103,1.576500000,0.0000
206.130.208.12,<->,8.228.208.40,0,0,1,97,1,97,1.576173000,0.0000
139.249.90.204,<->,92.27.51.139,1,80,0,0,1,80,1.576146000,0.0000
159.146.64.210,<->,109.1.13.143,0,0,1,91,1,91,1.575586000,0.0000
215.158.103.219,<->,193.119.135.81,1,162,0,0,1,162,1.574744000,0.0000
53.187.46.37,<->,39.15.169.14,0,0,1,88,1,88,1.574316000,0.0000
248.239.149.59,<->,123.237.154.160,1,319,0,0,1,319,1.574246000,0.0000
101.106.122.69,<->,89.183.104.239,0,0,1,99,1,99,1.574081000,0.0000
144.75.218.233,<->,137.250.6.109,1,108,0,0,1,108,1.573384000,0.0000
145.242.126.178,<->,53.77.205.113,1,220,0,0,1,220,1.573017000,0.0000
50.186.19.114,<->,48.53.216.116,0,0,1,120,1,120,1.572792000,0.0000
251.24.48.90,<->,100.93.135.55,0,0,1,52,1,52,1.572279000,0.0000
128.146.85.176,<->,50.224.96.35,0,0,1,68,1,68,1.571893000,0.0000
220.55.123.183,<->,126.231.183.55,1,84,0,0,1,84,1.571488000,0.0000
141.37.242.255,<->,92.27.219.238,0,0,1,133,1,133,1.570337000,0.0000
195.65.1.162,<->,101.224.204.141,0,0,1,91,1,91,1.570239000,0.0000
144.75.218.235,<->,138.127.231.195,1,276,0,0,1,276,1.570212000,0.0000
89.183.104.182,<->,29.220.173.205,1,1434,0,0,1,1434,1.569889000,0.0000
98.23.111.141,<->,92.27.209.104,0,0,1,50,1,50,1.568212000,0.0000
144.75.218.235,<->,53.214.223.92,1,93,0,0,1,93,1.567525000,0.0000
80.56.91.244,<->,6.73.247.8,0,0,1,1112,1,1112,1.566556000,0.0000
210.156.112.182,<->,157.208.214.27,1,130,0,0,1,130,1.565717000,0.0000
144.64.137.156,<->,100.225.82.253,1,83,0,0,1,83,1.565586000,0.0000
20.13.110.112,<->,0.200.50.50,1,60,0,0,1,60,1.564647000,0.0000
101.224.183.152,<->,92.169.158.35,1,87,0,0,1,87,1.564495000,0.0000
246.254.97.149,<->,48.131.156.46,1,93,0,0,1,93,1.562242000,0.0000
66.244.79.32,<->,16.137.241.141,0,0,1,68,1,68,1.562149000,0.0000
148.26.203.60,<->,89.183.104.136,0,0,1,367,1,367,1.562017000,0.0000
215.158.239.218,<->,126.219.197.235,1,90,0,0,1,90,1.561974000,0.0000
126.219.197.235,<->,99.74.87.243,0,0,1,91,1,91,1.561885000,0.0000
144.95.158.205,<->,144.75.218.242,0,0,1,126,1,126,1.561594000,0.0000
131.210.124.194,<->,89.183.104.255,0,0,1,62,1,62,1.561532000,0.0000
210.228.29.4,<->,139.163.13.117,0,0,1,113,1,113,1.561450000,0.0000
109.1.31.44,<->,40.204.4.71,1,351,0,0,1,351,1.560071000,0.0000
144.75.218.233,<->,100.185.121.91,1,128,0,0,1,128,1.559870000,0.0000
50.224.121.116,<->,6.124.44.105,1,70,0,0,1,70,1.558765000,0.0000
136.25.188.212,<->,111.20.61.178,1,80,0,0,1,80,1.558701000,0.0000
215.158.238.145,<->,136.169.91.98,1,1064,0,0,1,1064,1.558025000,0.0000
20.13.110.101,<->,0.200.50.50,1,60,0,0,1,60,1.557996000,0.0000
192.171.13.190,<->,8.252.222.118,0,0,1,128,1,128,1.557869000,0.0000
144.75.218.237,<->,138.127.230.213,1,177,0,0,1,177,1.557167000,0.0000
146.226.246.84,<->,129.224.112.252,0,0,1,66,1,66,1.556932000,0.0000
139.241.75.106,<->,136.25.188.212,0,0,1,134,1,134,1.556803000,0.0000
144.75.218.235,<->,138.127.225.87,1,355,0,0,1,355,1.556160000,0.0000
220.55.175.210,<->,98.23.111.141,1,50,0,0,1,50,1.555768000,0.0000
199.25.247.19,<->,92.27.8.182,0,0,1,162,1,162,1.554744000,0.0000
144.122.240.230,<->,144.108.64.181,1,67,0,0,1,67,1.554649000,0.0000
134.97.242.140,<->,92.27.219.41,0,0,1,52,1,52,1.554629000,0.0000
143.22.127.186,<->,20.238.50.141,0,0,1,72,1,72,1.554499000,0.0000
80.40.31.154,<->,58.164.24.130,1,130,0,0,1,130,1.553057000,0.0000
215.158.239.253,<->,80.56.91.244,1,1112,0,0,1,1112,1.552571000,0.0000
109.222.214.116,<->,29.94.101.68,1,325,0,0,1,325,1.551803000,0.0000
247.136.252.191,<->,198.182.27.178,1,133,0,0,1,133,1.551632000,0.0000
129.224.112.252,<->,100.185.124.124,1,61,0,0,1,61,1.550413000,0.0000
92.180.16.22,<->,89.183.104.172,0,0,1,52,1,52,1.550215000,0.0000
144.75.218.235,<->,138.127.231.213,1,240,0,0,1,240,1.549539000,0.0000
138.53.86.206,<->,129.224.112.252,0,0,1,62,1,62,1.549019000,0.0000
132.249.70.213,<->,101.229.93.34,1,106,0,0,1,106,1.548777000,0.0000
102.82.77.160,<->,92.27.219.53,0,0,1,300,1,300,1.547896000,0.0000
111.146.169.0,<->,33.219.156.216,1,138,0,0,1,138,1.547284000,0.0000
109.222.223.88,<->,57.191.84.224,1,75,0,0,1,75,1.546137000,0.0000
119.115.173.150,<->,111.147.164.221,0,0,1,61,1,61,1.545913000,0.0000
192.64.201.230,<->,40.221.208.240,1,102,0,0,1,102,1.545607000,0.0000
118.119.253.178,<->,89.183.104.237,0,0,1,260,1,260,1.545261000,0.0000
238.127.3.152,<->,220.55.174.117,0,0,1,57,1,57,1.545204000,0.0000
139.105.159.223,<->,114.88.250.79,1,95,0,0,1,95,1.545052000,0.0000
131.208.217.29,<->,39.146.43.127,0,0,1,74,1,74,1.544869000,0.0000
147.177.54.28,<->,34.245.12.50,0,0,1,80,1,80,1.544642000,0.0000
119.103.17.195,<->,89.183.104.173,0,0,1,263,1,263,1.544546000,0.0000
215.158.103.206,<->,159.151.93.228,1,120,0,0,1,120,1.544044000,0.0000
130.173.16.208,<->,39.235.152.130,0,0,1,67,1,67,1.543878000,0.0000
141.92.221.22,<->,129.224.112.252,0,0,1,74,1,74,1.543104000,0.0000
220.202.52.77,<->,92.27.219.54,0,0,1,317,1,317,1.542598000,0.0000
135.87.163.103,<->,92.27.27.148,0,0,1,135,1,135,1.541453000,0.0000
205.236.111.245,<->,92.27.27.165,0,0,1,52,1,52,1.541242000,0.0000
106.219.100.218,<->,92.27.219.175,0,0,1,373,1,373,1.539691000,0.0000
144.75.218.242,<->,138.127.224.106,1,351,0,0,1,351,1.539606000,0.0000
39.38.26.213,<->,0.52.16.104,1,94,0,0,1,94,1.539307000,0.0000
137.171.199.224,<->,126.219.141.190,1,99,0,0,1,99,1.538803000,0.0000
136.25.188.105,<->,112.60.14.238,1,233,0,0,1,233,1.538444000,0.0000
21.15.226.126,<->,20.193.24.49,0,0,1,82,1,82,1.537970000,0.0000
210.156.125.55,<->,59.46.180.152,1,133,0,0,1,133,1.537618000,0.0000
129.254.99.157,<->,129.224.112.252,0,0,1,68,1,68,1.536338000,0.0000
89.216.126.106,<->,29.143.180.235,1,138,0,0,1,138,1.536206000,0.0000
215.158.103.219,<->,206.226.66.178,1,84,0,0,1,84,1.535867000,0.0000
148.139.107.99,<->,39.0.193.227,0,0,1,74,1,74,1.535490000,0.0000
148.241.93.224,<->,89.139.241.98,0,0,1,190,1,190,1.534593000,0.0000
247.136.208.244,<->,127.87.18.39,1,52,0,0,1,52,1.532853000,0.0000
123.136.84.103,<->,89.183.104.156,0,0,1,321,1,321,1.532729000,0.0000
116.235.64.146,<->,89.183.104.243,0,0,1,62,1,62,1.532549000,0.0000
224.154.101.235,<->,20.202.18.54,0,0,1,50,1,50,1.532395000,0.0000
210.221.111.210,<->,106.170.251.39,1,100,0,0,1,100,1.532321000,0.0000
144.75.218.242,<->,138.127.230.47,1,366,0,0,1,366,1.531194000,0.0000
247.136.249.234,<->,149.110.42.130,1,401,0,0,1,401,1.531191000,0.0000
129.175.139.193,<->,29.211.214.254,0,0,1,92,1,92,1.530710000,0.0000
92.27.219.243,<->,8.47.188.160,1,92,0,0,1,92,1.530616000,0.0000
129.224.112.252,<->,114.145.102.4,1,80,0,0,1,80,1.530522000,0.0000
136.25.188.105,<->,131.49.122.22,1,121,0,0,1,121,1.530386000,0.0000
195.102.160.187,<->,20.188.180.53,0,0,1,72,1,72,1.530192000,0.0000
137.148.176.213,<->,97.126.26.70,0,0,1,83,1,83,1.528961000,0.0000
77.42.255.238,<->,34.189.255.223,0,0,1,52,1,52,1.528658000,0.0000
144.122.240.196,<->,136.64.7.221,1,74,0,0,1,74,1.528606000,0.0000
58.143.130.33,<->,34.187.59.238,0,0,1,78,1,78,1.527833000,0.0000
144.75.218.241,<->,138.127.224.136,1,318,0,0,1,318,1.527483000,0.0000
247.136.161.17,<->,50.94.83.219,1,56,0,0,1,56,1.526705000,0.0000
131.63.23.44,<->,129.224.112.252,0,0,1,74,1,74,1.526370000,0.0000
247.136.135.169,<->,125.36.246.176,1,341,0,0,1,341,1.526254000,0.0000
21.15.226.126,<->,20.193.24.155,0,0,1,82,1,82,1.525947000,0.0000
144.75.218.237,<->,132.43.156.54,1,177,0,0,1,177,1.525641000,0.0000
246.253.248.210,<->,224.213.241.54,1,79,0,0,1,79,1.525097000,0.0000
133.183.154.103,<->,60.108.145.249,1,52,0,0,1,52,1.524870000,0.0000
144.75.218.242,<->,138.127.230.152,1,366,0,0,1,366,1.524688000,0.0000
109.112.167.71,<->,104.157.23.202,1,76,0,0,1,76,1.523721000,0.0000
89.183.104.166,<->,66.244.63.171,1,52,0,0,1,52,1.523527000,0.0000
158.191.11.136,<->,99.73.163.224,0,0,1,135,1,135,1.523244000,0.0000
21.15.226.126,<->,20.193.24.168,0,0,1,82,1,82,1.523206000,0.0000
215.158.103.219,<->,206.226.68.41,1,84,0,0,1,84,1.522744000,0.0000
98.67.141.39,<->,96.93.140.98,1,80,0,0,1,80,1.522562000,0.0000
143.32.146.75,<->,39.153.0.161,0,0,1,66,1,66,1.522366000,0.0000
79.56.95.12,<->,34.15.85.130,0,0,1,74,1,74,1.521608000,0.0000
144.75.218.242,<->,138.127.231.130,1,250,0,0,1,250,1.521299000,0.0000
254.75.54.22,<->,89.183.104.179,0,0,1,62,1,62,1.520802000,0.0000
137.254.129.50,<->,80.56.78.128,0,0,1,94,1,94,1.519448000,0.0000
112.3.223.209,<->,92.27.219.151,0,0,1,99,1,99,1.518952000,0.0000
80.101.245.49,<->,50.224.62.69,0,0,1,76,1,76,1.517676000,0.0000
125.3.159.4,<->,92.27.219.218,0,0,1,52,1,52,1.517522000,0.0000
127.183.60.166,<->,8.228.208.38,0,0,1,351,1,351,1.517168000,0.0000
144.75.218.242,<->,139.252.1.230,1,90,0,0,1,90,1.516995000,0.0000
215.158.239.226,<->,53.84.175.252,1,343,0,0,1,343,1.516912000,0.0000
144.76.46.38,<->,100.92.129.50,0,0,1,204,1,204,1.516842000,0.0000
98.67.141.156,<->,15.76.174.124,1,68,0,0,1,68,1.515656000,0.0000
144.75.218.237,<->,138.127.231.77,1,254,0,0,1,254,1.514726000,0.0000
89.183.104.132,<->,33.156.71.15,1,52,0,0,1,52,1.514725000,0.0000
198.206.5.108,<->,138.98.181.238,0,0,1,78,1,78,1.513308000,0.0000
133.32.2.37,<->,0.81.95.103,1,393,0,0,1,393,1.511849000,0.0000
159.69.187.51,<->,144.108.64.184,1,71,0,0,1,71,1.511322000,0.0000
21.15.226.126,<->,20.193.24.249,0,0,1,82,1,82,1.510832000,0.0000
117.163.209.244,<->,92.27.219.248,0,0,1,52,1,52,1.510788000,0.0000
138.127.230.142,<->,97.126.26.70,0,0,1,231,1,231,1.509563000,0.0000
72.129.206.52,<->,20.207.90.89,0,0,1,72,1,72,1.509254000,0.0000
247.136.177.11,<->,127.80.215.53,1,52,0,0,1,52,1.508982000,0.0000
192.67.158.2,<->,38.140.182.62,1,402,0,0,1,402,1.507429000,0.0000
133.178.227.9,<->,69.132.194.25,1,85,0,0,1,85,1.506311000,0.0000
76.82.62.202,<->,20.21.152.161,0,0,1,74,1,74,1.505806000,0.0000
80.42.136.224,<->,68.185.184.17,1,77,0,0,1,77,1.505793000,0.0000
144.76.43.245,<->,39.248.134.206,0,0,1,87,1,87,1.505762000,0.0000
192.64.208.147,<->,38.105.160.195,1,102,0,0,1,102,1.505042000,0.0000
193.46.99.197,<->,132.168.196.169,0,0,1,129,1,129,1.503501000,0.0000
142.238.41.239,<->,92.27.27.158,0,0,1,52,1,52,1.503385000,0.0000
144.75.218.242,<->,128.203.247.100,1,88,0,0,1,88,1.503121000,0.0000
109.222.252.217,<->,100.180.142.104,1,68,0,0,1,68,1.502572000,0.0000
92.27.219.50,<->,78.55.247.203,1,62,0,0,1,62,1.501942000,0.0000
109.222.245.45,<->,6.210.30.49,1,67,0,0,1,67,1.501698000,0.0000
205.65.50.131,<->,92.27.219.203,0,0,1,62,1,62,1.501247000,0.0000
124.42.155.137,<->,109.112.164.138,0,0,1,128,1,128,1.500951000,0.0000
247.136.241.120,<->,127.15.90.195,1,90,0,0,1,90,1.500910000,0.0000
21.15.226.126,<->,20.193.25.175,0,0,1,82,1,82,1.500564000,0.0000
21.15.226.126,<->,20.193.25.166,0,0,1,82,1,82,1.499494000,0.0000
144.75.218.235,<->,138.127.224.254,1,341,0,0,1,341,1.499307000,0.0000
109.222.245.45,<->,102.208.213.203,1,67,0,0,1,67,1.499271000,0.0000
93.224.205.64,<->,92.27.219.143,0,0,1,52,1,52,1.499005000,0.0000
128.163.110.232,<->,109.1.60.149,0,0,1,97,1,97,1.497834000,0.0000
206.154.108.149,<->,89.183.104.236,0,0,1,147,1,147,1.497613000,0.0000
249.101.239.70,<->,57.211.43.71,1,68,0,0,1,68,1.497577000,0.0000
92.27.219.185,<->,4.240.214.61,1,1456,0,0,1,1456,1.497324000,0.0000
199.125.153.115,<->,39.24.39.33,0,0,1,50,1,50,1.497079000,0.0000
138.127.224.104,<->,97.126.26.71,0,0,1,281,1,281,1.495540000,0.0000
92.27.27.185,<->,87.52.183.37,1,719,0,0,1,719,1.495356000,0.0000
92.27.219.166,<->,48.110.114.26,1,52,0,0,1,52,1.494605000,0.0000
249.101.239.70,<->,57.211.43.70,1,68,0,0,1,68,1.494469000,0.0000
92.27.27.150,<->,42.129.191.23,1,52,0,0,1,52,1.494450000,0.0000
152.134.94.238,<->,39.154.194.32,0,0,1,130,1,130,1.493366000,0.0000
206.123.219.254,<->,92.27.219.39,0,0,1,321,1,321,1.492612000,0.0000
21.15.226.126,<->,20.193.25.192,0,0,1,82,1,82,1.491065000,0.0000
141.99.73.111,<->,20.135.132.217,0,0,1,135,1,135,1.491049000,0.0000
132.123.161.122,<->,98.236.254.250,0,0,1,61,1,61,1.489969000,0.0000
218.31.5.40,<->,129.224.112.252,0,0,1,76,1,76,1.489752000,0.0000
109.1.51.11,<->,64.214.45.152,1,405,0,0,1,405,1.489508000,0.0000
144.75.218.241,<->,144.69.195.30,1,102,0,0,1,102,1.489187000,0.0000
106.149.105.235,<->,92.27.219.161,0,0,1,309,1,309,1.489074000,0.0000
21.15.226.126,<->,20.193.25.202,0,0,1,82,1,82,1.488946000,0.0000
144.75.218.241,<->,136.99.66.245,1,174,0,0,1,174,1.487700000,0.0000
192.171.13.190,<->,8.176.8.196,0,0,1,97,1,97,1.487556000,0.0000
89.86.110.196,<->,8.252.222.105,0,0,1,135,1,135,1.486905000,0.0000
38.21.156.204,<->,20.232.230.81,0,0,1,82,1,82,1.486431000,0.0000
101.224.169.22,<->,0.35.171.199,1,110,0,0,1,110,1.486298000,0.0000
144.75.218.233,<->,53.165.133.164,1,80,0,0,1,80,1.486133000,0.0000
215.158.239.73,<->,143.88.15.74,1,84,0,0,1,84,1.486096000,0.0000
109.1.56.55,<->,57.46.39.166,1,50,0,0,1,50,1.485846000,0.0000
98.23.111.141,<->,92.27.209.196,0,0,1,50,1,50,1.484736000,0.0000
194.215.244.40,<->,80.42.160.104,0,0,1,215,1,215,1.484629000,0.0000
133.178.226.98,<->,6.29.108.86,1,1064,0,0,1,1064,1.484328000,0.0000
118.224.132.179,<->,109.1.22.16,0,0,1,138,1,138,1.483896000,0.0000
207.72.252.122,<->,39.15.169.14,0,0,1,86,1,86,1.483756000,0.0000
159.87.104.238,<->,138.127.198.233,1,75,0,0,1,75,1.482149000,0.0000
235.229.204.198,<->,92.27.27.153,0,0,1,62,1,62,1.482046000,0.0000
159.69.187.29,<->,144.108.80.172,1,71,0,0,1,71,1.481839000,0.0000
144.75.218.235,<->,140.142.131.1,1,77,0,0,1,77,1.481780000,0.0000
97.168.67.236,<->,63.255.106.50,1,80,0,0,1,80,1.480528000,0.0000
148.177.30.57,<->,39.193.207.217,0,0,1,1257,1,1257,1.480081000,0.0000
92.27.219.140,<->,91.231.209.45,1,89,0,0,1,89,1.479986000,0.0000
132.168.198.202,<->,52.60.231.223,1,65,0,0,1,65,1.479564000,0.0000
97.168.67.236,<->,93.2.217.58,1,80,0,0,1,80,1.479472000,0.0000
92.27.219.156,<->,87.49.215.40,1,84,0,0,1,84,1.479437000,0.0000
129.224.112.252,<->,56.125.221.95,1,63,0,0,1,63,1.477360000,0.0000
120.51.13.182,<->,89.183.104.145,0,0,1,328,1,328,1.477176000,0.0000
144.76.46.36,<->,102.50.179.112,0,0,1,130,1,130,1.476194000,0.0000
138.31.199.102,<->,53.212.149.246,1,74,0,0,1,74,1.476050000,0.0000
247.136.188.245,<->,148.196.121.220,1,130,0,0,1,130,1.475960000,0.0000
80.38.51.167,<->,8.47.188.160,1,148,0,0,1,148,1.475914000,0.0000
192.64.246.117,<->,98.150.107.181,1,50,0,0,1,50,1.475797000,0.0000
221.95.60.220,<->,77.8.75.237,1,135,0,0,1,135,1.475163000,0.0000
144.76.42.205,<->,144.64.138.24,0,0,1,76,1,76,1.474469000,0.0000
198.232.32.156,<->,92.27.219.229,0,0,1,52,1,52,1.473704000,0.0000
124.56.156.93,<->,109.222.202.37,0,0,1,79,1,79,1.473091000,0.0000
92.27.27.182,<->,29.138.102.202,1,56,0,0,1,56,1.473001000,0.0000
111.65.121.95,<->,92.27.219.38,0,0,1,80,1,80,1.472824000,0.0000
144.75.218.233,<->,98.101.89.7,1,82,0,0,1,82,1.472774000,0.0000
144.75.218.237,<->,138.127.224.17,1,294,0,0,1,294,1.472713000,0.0000
203.11.144.44,<->,92.27.27.157,0,0,1,52,1,52,1.472458000,0.0000
89.183.104.189,<->,38.87.154.202,1,52,0,0,1,52,1.472188000,0.0000
129.224.112.252,<->,99.187.125.196,1,78,0,0,1,78,1.471985000,0.0000
247.136.139.153,<->,119.76.158.162,1,62,0,0,1,62,1.470719000,0.0000
105.115.185.87,<->,102.50.219.230,0,0,1,393,1,393,1.469844000,0.0000
144.75.218.233,<->,138.127.224.174,1,67,0,0,1,67,1.469051000,0.0000
127.190.126.87,<->,56.121.48.108,0,0,1,74,1,74,1.468819000,0.0000
109.222.204.60,<->,109.36.8.231,1,77,0,0,1,77,1.468125000,0.0000
249.101.238.135,<->,94.233.224.195,1,133,0,0,1,133,1.467747000,0.0000
104.157.21.26,<->,39.205.60.126,0,0,1,70,1,70,1.467308000,0.0000
111.60.203.97,<->,109.222.195.232,0,0,1,71,1,71,1.466557000,0.0000
101.224.183.152,<->,97.193.106.236,1,68,0,0,1,68,1.466500000,0.0000
199.20.77.150,<->,109.222.195.53,0,0,1,52,1,52,1.466161000,0.0000
144.75.218.235,<->,138.127.231.194,1,365,0,0,1,365,1.465898000,0.0000
144.75.218.235,<->,132.200.120.209,1,142,0,0,1,142,1.465285000,0.0000
138.127.224.169,<->,97.126.26.70,0,0,1,252,1,252,1.465248000,0.0000
92.27.219.61,<->,88.45.125.170,1,52,0,0,1,52,1.465247000,0.0000
111.151.107.247,<->,8.252.222.246,0,0,1,155,1,155,1.465128000,0.0000
193.46.99.105,<->,109.1.34.223,0,0,1,304,1,304,1.464657000,0.0000
92.27.219.58,<->,0.66.204.255,1,149,0,0,1,149,1.464616000,0.0000
129.224.112.252,<->,114.145.122.138,1,80,0,0,1,80,1.463813000,0.0000
145.252.125.198,<->,97.110.148.19,1,87,0,0,1,87,1.463511000,0.0000
80.9.14.182,<->,48.53.90.113,0,0,1,323,1,323,1.462838000,0.0000
144.75.218.242,<->,138.127.231.29,1,254,0,0,1,254,1.462559000,0.0000
121.13.225.160,<->,109.222.214.116,0,0,1,99,1,99,1.462352000,0.0000
109.1.16.158,<->,27.188.163.162,1,445,0,0,1,445,1.462296000,0.0000
215.158.123.32,<->,136.25.189.94,0,0,1,1064,1,1064,1.460512000,0.0000
201.220.28.91,<->,109.1.36.149,0,0,1,135,1,135,1.460226000,0.0000
98.67.143.207,<->,58.20.165.33,1,79,0,0,1,79,1.459425000,0.0000
120.155.87.66,<->,8.176.8.96,0,0,1,157,1,157,1.458597000,0.0000
109.222.195.216,<->,105.18.118.50,1,74,0,0,1,74,1.458093000,0.0000
197.108.67.239,<->,129.224.112.252,0,0,1,74,1,74,1.457714000,0.0000
156.180.238.191,<->,39.33.251.202,0,0,1,52,1,52,1.457304000,0.0000
119.68.182.212,<->,89.183.104.231,0,0,1,52,1,52,1.454963000,0.0000
206.222.59.10,<->,89.183.104.167,0,0,1,52,1,52,1.454865000,0.0000
158.55.120.187,<->,144.75.218.246,0,0,1,162,1,162,1.454856000,0.0000
98.67.133.87,<->,92.34.2.222,1,71,0,0,1,71,1.454201000,0.0000
123.19.57.43,<->,92.27.219.239,0,0,1,373,1,373,1.453965000,0.0000
21.15.226.126,<->,20.193.25.48,0,0,1,82,1,82,1.453650000,0.0000
157.25.158.25,<->,144.75.218.246,0,0,1,87,1,87,1.453045000,0.0000
144.75.218.233,<->,138.127.225.78,1,269,0,0,1,269,1.452942000,0.0000
112.54.73.92,<->,97.126.18.23,0,0,1,71,1,71,1.452756000,0.0000
144.75.218.233,<->,138.127.231.139,1,366,0,0,1,366,1.451790000,0.0000
112.212.96.222,<->,20.188.21.207,0,0,1,539,1,539,1.451283000,0.0000
120.188.17.43,<->,39.143.92.27,0,0,1,136,1,136,1.450935000,0.0000
108.36.183.151,<->,89.183.104.253,0,0,1,221,1,221,1.450876000,0.0000
218.176.18.66,<->,29.211.214.32,0,0,1,87,1,87,1.449513000,0.0000
144.75.218.242,<->,138.127.225.88,1,366,0,0,1,366,1.449125000,0.0000
215.158.238.161,<->,118.20.100.200,1,84,0,0,1,84,1.448682000,0.0000
132.249.70.233,<->,57.29.149.23,1,157,0,0,1,157,1.447673000,0.0000
144.64.137.156,<->,57.140.246.52,1,71,0,0,1,71,1.447510000,0.0000
109.1.16.149,<->,27.188.163.162,1,445,0,0,1,445,1.447424000,0.0000
21.15.226.126,<->,20.193.26.8,0,0,1,82,1,82,1.446973000,0.0000
192.64.234.189,<->,29.201.141.148,1,50,0,0,1,50,1.446578000,0.0000
113.131.107.29,<->,109.222.255.59,0,0,1,75,1,75,1.445587000,0.0000
123.49.16.66,<->,89.183.104.245,0,0,1,321,1,321,1.444699000,0.0000
152.110.93.110,<->,34.246.35.155,0,0,1,52,1,52,1.444172000,0.0000
141.108.34.33,<->,20.216.214.17,0,0,1,136,1,136,1.443822000,0.0000
118.224.227.82,<->,111.147.76.145,0,0,1,319,1,319,1.443765000,0.0000
247.136.154.209,<->,134.201.197.42,1,130,0,0,1,130,1.443714000,0.0000
64.252.113.196,<->,39.158.64.219,0,0,1,52,1,52,1.443521000,0.0000
120.186.232.218,<->,80.41.59.67,0,0,1,129,1,129,1.443457000,0.0000
210.220.219.153,<->,84.200.124.13,1,319,0,0,1,319,1.443278000,0.0000
215.158.103.219,<->,138.127.224.210,1,274,0,0,1,274,1.442605000,0.0000
225.41.159.53,<->,138.98.246.1,0,0,1,120,1,120,1.441865000,0.0000
111.151.107.247,<->,8.252.222.118,0,0,1,134,1,134,1.441586000,0.0000
39.59.163.117,<->,38.75.253.23,1,70,0,0,1,70,1.441418000,0.0000
58.59.40.252,<->,20.234.57.9,0,0,1,136,1,136,1.441346000,0.0000
230.126.191.235,<->,98.128.199.38,0,0,1,130,1,130,1.441109000,0.0000
101.106.122.69,<->,92.27.219.138,0,0,1,138,1,138,1.440765000,0.0000
149.159.108.67,<->,20.214.223.135,0,0,1,72,1,72,1.440154000,0.0000
248.239.77.185,<->,48.19.203.121,1,133,0,0,1,133,1.440121000,0.0000
21.15.226.126,<->,20.193.26.38,0,0,1,82,1,82,1.440032000,0.0000
144.75.218.246,<->,138.127.231.114,1,289,0,0,1,289,1.440010000,0.0000
119.25.160.163,<->,109.1.34.223,0,0,1,325,1,325,1.439774000,0.0000
144.75.218.237,<->,53.244.198.185,1,86,0,0,1,86,1.439706000,0.0000
105.200.247.154,<->,89.139.240.18,0,0,1,74,1,74,1.439521000,0.0000
144.75.218.233,<->,138.127.224.203,1,182,0,0,1,182,1.438857000,0.0000
102.83.25.171,<->,33.156.232.44,1,169,0,0,1,169,1.438744000,0.0000
131.91.78.19,<->,109.222.242.9,0,0,1,136,1,136,1.438423000,0.0000
38.21.156.204,<->,20.232.230.10,0,0,1,82,1,82,1.438087000,0.0000
68.65.175.143,<->,34.165.178.132,0,0,1,74,1,74,1.438048000,0.0000
136.88.52.114,<->,20.204.98.130,0,0,1,80,1,80,1.437809000,0.0000
200.174.207.170,<->,80.9.234.254,1,144,0,0,1,144,1.436924000,0.0000
129.224.112.252,<->,100.185.124.114,1,57,0,0,1,57,1.436613000,0.0000
212.164.131.84,<->,119.135.216.72,1,92,0,0,1,92,1.435827000,0.0000
119.226.233.38,<->,92.27.219.51,0,0,1,351,1,351,1.435327000,0.0000
97.190.209.215,<->,48.18.195.101,1,133,0,0,1,133,1.434926000,0.0000
215.158.239.75,<->,143.88.15.74,1,84,0,0,1,84,1.434162000,0.0000
145.252.126.18,<->,136.221.27.98,1,96,0,0,1,96,1.434121000,0.0000
195.3.157.139,<->,129.224.112.220,0,0,1,88,1,88,1.433619000,0.0000
133.32.2.38,<->,129.245.60.234,1,131,0,0,1,131,1.433473000,0.0000
143.252.87.189,<->,20.46.159.59,0,0,1,75,1,75,1.433212000,0.0000
144.75.218.241,<->,138.127.225.28,1,254,0,0,1,254,1.432697000,0.0000
144.75.218.235,<->,132.43.156.54,1,148,0,0,1,148,1.432423000,0.0000
246.108.109.36,<->,100.94.137.213,0,0,1,61,1,61,1.432060000,0.0000
92.27.27.150,<->,4.111.14.58,1,52,0,0,1,52,1.430436000,0.0000
122.9.224.81,<->,109.222.205.228,0,0,1,73,1,73,1.430365000,0.0000
145.213.37.27,<->,129.224.112.252,0,0,1,80,1,80,1.429838000,0.0000
21.15.226.126,<->,20.193.26.47,0,0,1,82,1,82,1.429630000,0.0000
144.75.218.242,<->,104.157.133.177,1,245,0,0,1,245,1.429568000,0.0000
156.25.203.110,<->,39.165.220.234,0,0,1,126,1,126,1.427550000,0.0000
21.15.226.126,<->,20.193.26.52,0,0,1,82,1,82,1.427512000,0.0000
132.249.70.201,<->,53.76.66.87,1,220,0,0,1,220,1.427491000,0.0000
206.17.243.41,<->,192.67.167.86,0,0,1,52,1,52,1.427326000,0.0000
98.221.132.61,<->,98.67.140.42,0,0,1,68,1,68,1.426812000,0.0000
94.24.92.161,<->,92.27.219.182,0,0,1,1470,1,1470,1.426294000,0.0000
220.60.81.165,<->,136.25.189.137,0,0,1,1064,1,1064,1.425843000,0.0000
109.1.16.146,<->,27.188.163.162,1,445,0,0,1,445,1.425590000,0.0000
125.16.190.46,<->,89.183.104.168,0,0,1,52,1,52,1.425433000,0.0000
138.31.199.22,<->,135.196.81.226,1,71,0,0,1,71,1.424991000,0.0000
131.249.19.234,<->,39.33.250.45,0,0,1,68,1,68,1.423926000,0.0000
235.228.134.154,<->,89.183.104.226,0,0,1,52,1,52,1.422834000,0.0000
230.74.202.4,<->,98.128.220.206,0,0,1,94,1,94,1.422773000,0.0000
97.126.103.29,<->,96.207.170.56,1,384,0,0,1,384,1.421879000,0.0000
53.89.220.45,<->,39.15.169.14,0,0,1,87,1,87,1.421806000,0.0000
210.229.230.12,<->,123.195.212.52,1,52,0,0,1,52,1.420439000,0.0000
106.162.99.24,<->,20.138.185.24,0,0,1,79,1,79,1.419553000,0.0000
132.151.129.234,<->,118.10.0.235,1,77,0,0,1,77,1.418846000,0.0000
127.92.137.146,<->,109.1.23.39,0,0,1,357,1,357,1.418520000,0.0000
144.75.218.242,<->,138.127.230.26,1,254,0,0,1,254,1.418192000,0.0000
204.16.203.227,<->,102.50.141.39,0,0,1,147,1,147,1.417585000,0.0000
136.209.190.221,<->,80.56.78.92,0,0,1,100,1,100,1.417561000,0.0000
112.226.101.215,<->,80.42.168.43,0,0,1,1213,1,1213,1.416584000,0.0000
144.75.218.237,<->,93.181.133.172,1,159,0,0,1,159,1.416495000,0.0000
118.208.189.32,<->,89.183.104.250,0,0,1,52,1,52,1.416305000,0.0000
89.183.104.141,<->,33.240.17.69,1,52,0,0,1,52,1.415584000,0.0000
198.101.112.240,<->,92.27.219.169,0,0,1,315,1,315,1.414354000,0.0000
136.25.189.93,<->,29.211.206.37,1,83,0,0,1,83,1.412694000,0.0000
109.0.213.196,<->,33.219.189.220,1,355,0,0,1,355,1.412347000,0.0000
226.162.38.40,<->,99.75.4.225,0,0,1,145,1,145,1.411580000,0.0000
207.176.222.178,<->,89.183.104.137,0,0,1,52,1,52,1.411044000,0.0000
92.27.219.233,<->,33.250.48.170,1,326,0,0,1,326,1.409527000,0.0000
143.252.204.233,<->,129.224.112.252,0,0,1,76,1,76,1.409526000,0.0000
215.158.140.14,<->,192.171.13.188,1,167,0,0,1,167,1.408874000,0.0000
97.126.26.40,<->,53.167.244.138,1,126,0,0,1,126,1.408769000,0.0000
159.69.187.49,<->,144.108.64.185,1,66,0,0,1,66,1.408721000,0.0000
152.44.123.253,<->,92.27.235.58,0,0,1,133,1,133,1.408370000,0.0000
136.25.188.105,<->,100.185.121.91,1,119,0,0,1,119,1.407799000,0.0000
109.222.212.23,<->,69.196.212.63,1,1470,0,0,1,1470,1.406407000,0.0000
89.183.104.159,<->,75.95.12.84,1,52,0,0,1,52,1.405585000,0.0000
129.224.112.252,<->,92.162.219.215,1,74,0,0,1,74,1.405575000,0.0000
136.25.188.105,<->,33.223.144.204,1,88,0,0,1,88,1.405534000,0.0000
199.50.28.3,<->,92.27.219.235,0,0,1,52,1,52,1.403166000,0.0000
149.217.70.251,<->,8.228.215.123,0,0,1,135,1,135,1.403080000,0.0000
119.90.219.166,<->,39.172.28.65,0,0,1,76,1,76,1.403068000,0.0000
192.171.13.190,<->,133.178.226.222,0,0,1,153,1,153,1.402655000,0.0000
203.49.212.41,<->,129.224.112.252,0,0,1,79,1,79,1.402316000,0.0000
159.213.211.217,<->,144.86.122.246,1,76,0,0,1,76,1.402200000,0.0000
98.23.107.90,<->,92.27.27.233,0,0,1,86,1,86,1.401572000,0.0000
21.15.226.126,<->,20.193.26.213,0,0,1,82,1,82,1.400474000,0.0000
195.120.55.242,<->,20.159.32.62,0,0,1,71,1,71,1.399504000,0.0000
204.130.115.164,<->,29.211.214.32,0,0,1,106,1,106,1.399224000,0.0000
137.81.65.53,<->,101.87.248.102,1,76,0,0,1,76,1.398491000,0.0000
106.208.59.165,<->,39.162.9.20,0,0,1,68,1,68,1.398229000,0.0000
247.136.153.202,<->,104.53.162.197,1,97,0,0,1,97,1.397722000,0.0000
159.137.226.12,<->,142.246.30.12,1,75,0,0,1,75,1.397503000,0.0000
89.183.104.138,<->,88.5.193.50,1,52,0,0,1,52,1.397498000,0.0000
193.94.47.49,<->,8.52.181.39,0,0,1,64,1,64,1.397400000,0.0000
254.70.160.124,<->,80.42.185.67,0,0,1,135,1,135,1.396976000,0.0000
92.27.219.187,<->,78.55.239.161,1,52,0,0,1,52,1.396937000,0.0000
144.75.218.241,<->,138.127.231.226,1,250,0,0,1,250,1.396503000,0.0000
92.27.219.156,<->,78.49.228.11,1,52,0,0,1,52,1.395203000,0.0000
143.252.204.234,<->,97.68.226.205,0,0,1,74,1,74,1.394919000,0.0000
104.113.118.13,<->,80.40.34.206,0,0,1,97,1,97,1.394453000,0.0000
192.67.178.12,<->,120.214.189.111,1,130,0,0,1,130,1.393263000,0.0000
193.46.99.139,<->,111.147.173.47,0,0,1,129,1,129,1.390872000,0.0000
204.93.197.173,<->,100.92.12.131,0,0,1,52,1,52,1.390757000,0.0000
144.75.218.233,<->,138.127.230.52,1,169,0,0,1,169,1.389880000,0.0000
144.75.218.237,<->,96.45.188.119,1,84,0,0,1,84,1.389256000,0.0000
144.75.218.237,<->,97.6.59.193,1,194,0,0,1,194,1.389238000,0.0000
105.201.172.83,<->,100.93.171.75,0,0,1,90,1,90,1.389214000,0.0000
106.150.234.231,<->,92.27.27.185,0,0,1,213,1,213,1.388663000,0.0000
93.0.159.217,<->,92.27.27.151,0,0,1,133,1,133,1.388568000,0.0000
144.75.218.235,<->,138.127.224.19,1,366,0,0,1,366,1.388140000,0.0000
92.27.219.239,<->,77.49.51.18,1,293,0,0,1,293,1.387476000,0.0000
144.75.218.235,<->,138.127.231.185,1,366,0,0,1,366,1.386134000,0.0000
109.222.253.182,<->,84.2.158.229,1,68,0,0,1,68,1.384998000,0.0000
21.15.226.126,<->,20.193.27.63,0,0,1,82,1,82,1.383762000,0.0000
136.25.189.210,<->,80.47.43.233,1,89,0,0,1,89,1.382977000,0.0000
144.75.218.241,<->,100.215.74.232,1,128,0,0,1,128,1.381803000,0.0000
92.27.219.231,<->,57.62.62.79,1,325,0,0,1,325,1.381153000,0.0000
144.75.218.241,<->,138.127.230.1,1,365,0,0,1,365,1.380979000,0.0000
144.75.218.233,<->,138.127.224.111,1,366,0,0,1,366,1.380485000,0.0000
248.239.170.17,<->,124.26.85.55,1,130,0,0,1,130,1.380194000,0.0000
92.27.219.62,<->,80.38.154.203,1,52,0,0,1,52,1.379520000,0.0000
193.47.198.229,<->,8.52.222.230,0,0,1,67,1,67,1.379434000,0.0000
136.109.250.193,<->,97.126.11.149,0,0,1,78,1,78,1.378623000,0.0000
21.15.226.126,<->,20.193.27.28,0,0,1,82,1,82,1.378526000,0.0000
215.158.103.206,<->,138.127.224.10,1,242,0,0,1,242,1.378017000,0.0000
106.184.11.222,<->,92.27.219.31,0,0,1,52,1,52,1.376926000,0.0000
153.241.226.86,<->,144.105.43.34,0,0,1,133,1,133,1.376583000,0.0000
144.75.218.237,<->,138.127.231.76,1,261,0,0,1,261,1.375937000,0.0000
247.136.240.193,<->,122.116.49.171,1,321,0,0,1,321,1.375578000,0.0000
215.158.103.206,<->,148.111.30.85,1,75,0,0,1,75,1.375286000,0.0000
246.253.248.211,<->,140.143.190.248,1,86,0,0,1,86,1.373651000,0.0000
21.15.226.126,<->,20.193.27.47,0,0,1,82,1,82,1.373551000,0.0000
212.119.15.90,<->,144.75.218.242,0,0,1,84,1,84,1.373365000,0.0000
94.25.103.250,<->,92.27.27.175,0,0,1,52,1,52,1.372979000,0.0000
144.122.240.237,<->,144.76.43.238,1,75,0,0,1,75,1.372479000,0.0000
97.68.226.205,<->,50.131.177.136,1,79,0,0,1,79,1.372445000,0.0000
247.136.254.97,<->,121.179.37.149,1,149,0,0,1,149,1.372048000,0.0000
142.188.148.82,<->,20.214.92.24,0,0,1,78,1,78,1.371247000,0.0000
159.69.187.23,<->,144.108.64.181,1,78,0,0,1,78,1.371172000,0.0000
144.75.218.233,<->,138.127.230.151,1,68,0,0,1,68,1.369276000,0.0000
136.25.188.105,<->,56.112.1.18,1,129,0,0,1,129,1.369052000,0.0000
144.75.218.237,<->,138.127.225.225,1,366,0,0,1,366,1.368994000,0.0000
192.64.206.242,<->,64.214.57.1,1,55,0,0,1,55,1.368662000,0.0000
144.75.218.242,<->,139.252.1.219,1,87,0,0,1,87,1.368222000,0.0000
121.129.65.147,<->,20.213.26.98,0,0,1,107,1,107,1.367723000,0.0000
144.75.218.235,<->,138.127.230.46,1,366,0,0,1,366,1.366557000,0.0000
97.126.114.17,<->,69.32.87.30,1,80,0,0,1,80,1.366257000,0.0000
249.101.207.245,<->,131.99.111.30,1,389,0,0,1,389,1.366012000,0.0000
131.130.178.255,<->,92.27.219.16,0,0,1,343,1,343,1.365911000,0.0000
194.193.224.9,<->,89.183.104.137,0,0,1,52,1,52,1.365891000,0.0000
146.243.39.232,<->,133.53.173.234,0,0,1,133,1,133,1.364985000,0.0000
89.183.104.229,<->,0.246.11.19,1,130,0,0,1,130,1.364374000,0.0000
193.46.99.139,<->,92.27.27.176,0,0,1,90,1,90,1.364098000,0.0000
230.61.211.6,<->,98.128.96.179,0,0,1,138,1,138,1.363951000,0.0000
246.253.248.211,<->,126.219.191.103,1,79,0,0,1,79,1.362986000,0.0000
21.15.226.126,<->,20.193.27.11,0,0,1,82,1,82,1.362974000,0.0000
159.69.187.31,<->,144.108.64.183,1,68,0,0,1,68,1.362546000,0.0000
149.230.224.252,<->,20.253.18.223,0,0,1,76,1,76,1.361815000,0.0000
139.254.208.193,<->,58.132.150.196,1,93,0,0,1,93,1.361785000,0.0000
21.15.226.126,<->,20.193.27.12,0,0,1,82,1,82,1.361660000,0.0000
144.75.218.242,<->,138.127.225.123,1,182,0,0,1,182,1.360010000,0.0000
144.75.218.242,<->,138.127.230.243,1,252,0,0,1,252,1.359144000,0.0000
247.136.216.15,<->,127.163.229.198,1,50,0,0,1,50,1.358795000,0.0000
133.178.227.54,<->,8.220.7.31,1,120,0,0,1,120,1.358123000,0.0000
92.27.219.166,<->,90.40.190.167,1,135,0,0,1,135,1.357883000,0.0000
198.70.252.33,<->,39.54.235.145,0,0,1,78,1,78,1.357730000,0.0000
121.93.243.7,<->,20.160.39.53,0,0,1,84,1,84,1.357460000,0.0000
139.163.84.114,<->,47.197.43.218,1,65,0,0,1,65,1.357362000,0.0000
137.74.95.14,<->,116.89.156.110,1,76,0,0,1,76,1.357169000,0.0000
59.51.25.129,<->,39.56.224.78,0,0,1,70,1,70,1.357125000,0.0000
144.122.240.237,<->,144.76.43.234,1,81,0,0,1,81,1.356994000,0.0000
113.214.85.27,<->,89.183.104.238,0,0,1,52,1,52,1.355976000,0.0000
144.75.218.246,<->,132.107.75.195,1,139,0,0,1,139,1.355206000,0.0000
112.70.86.223,<->,111.147.167.22,0,0,1,130,1,130,1.353826000,0.0000
192.64.196.19,<->,105.92.102.28,1,138,0,0,1,138,1.353662000,0.0000
123.167.67.17,<->,20.101.11.88,0,0,1,78,1,78,1.353609000,0.0000
198.54.166.189,<->,92.27.219.38,0,0,1,52,1,52,1.353127000,0.0000
144.75.218.242,<->,138.127.224.239,1,366,0,0,1,366,1.353065000,0.0000
127.81.2.139,<->,92.27.27.178,0,0,1,135,1,135,1.352208000,0.0000
118.20.111.94,<->,89.183.104.142,0,0,1,117,1,117,1.351721000,0.0000
89.216.125.82,<->,22.1.74.1,1,80,0,0,1,80,1.349760000,0.0000
220.80.148.178,<->,202.236.106.249,1,130,0,0,1,130,1.349487000,0.0000
146.87.6.182,<->,50.224.118.107,0,0,1,72,1,72,1.349485000,0.0000
135.247.123.8,<->,92.27.219.45,0,0,1,62,1,62,1.348873000,0.0000
109.222.251.159,<->,104.224.175.8,1,70,0,0,1,70,1.348762000,0.0000
144.75.218.241,<->,138.127.224.115,1,337,0,0,1,337,1.347037000,0.0000
112.234.147.188,<->,80.41.32.57,0,0,1,135,1,135,1.346806000,0.0000
21.15.226.126,<->,20.193.27.145,0,0,1,82,1,82,1.346578000,0.0000
192.67.133.141,<->,29.221.88.147,1,52,0,0,1,52,1.346551000,0.0000
113.156.134.6,<->,111.147.232.81,0,0,1,73,1,73,1.345501000,0.0000
223.143.99.201,<->,89.183.110.85,0,0,1,130,1,130,1.345408000,0.0000
193.65.5.242,<->,92.27.219.224,0,0,1,325,1,325,1.343358000,0.0000
21.15.226.126,<->,20.193.27.152,0,0,1,82,1,82,1.343232000,0.0000
109.222.255.208,<->,101.181.221.23,1,79,0,0,1,79,1.342743000,0.0000
144.75.218.233,<->,138.127.224.241,1,303,0,0,1,303,1.342594000,0.0000
139.236.94.152,<->,20.249.155.2,0,0,1,80,1,80,1.342264000,0.0000
110.98.222.240,<->,89.183.104.141,0,0,1,351,1,351,1.342232000,0.0000
207.87.26.21,<->,129.224.112.252,0,0,1,68,1,68,1.341973000,0.0000
200.174.214.160,<->,50.189.251.185,1,319,0,0,1,319,1.341915000,0.0000
253.19.79.103,<->,80.40.57.229,0,0,1,135,1,135,1.341609000,0.0000
115.87.122.210,<->,39.33.127.188,0,0,1,84,1,84,1.340331000,0.0000
114.60.176.251,<->,92.27.219.239,0,0,1,52,1,52,1.339108000,0.0000
138.127.230.221,<->,97.126.26.40,0,0,1,84,1,84,1.338791000,0.0000
198.163.47.226,<->,20.221.86.62,0,0,1,69,1,69,1.338680000,0.0000
192.67.149.88,<->,38.84.60.6,1,52,0,0,1,52,1.337305000,0.0000
100.254.226.147,<->,20.18.2.102,0,0,1,68,1,68,1.337298000,0.0000
152.133.60.221,<->,8.238.112.20,0,0,1,130,1,130,1.336771000,0.0000
142.125.81.115,<->,20.0.1.10,0,0,1,75,1,75,1.336601000,0.0000
21.15.226.126,<->,20.193.27.223,0,0,1,82,1,82,1.336482000,0.0000
144.75.218.235,<->,53.165.133.164,1,83,0,0,1,83,1.335919000,0.0000
104.230.236.175,<->,92.27.219.224,0,0,1,62,1,62,1.335667000,0.0000
21.15.226.126,<->,20.193.27.202,0,0,1,82,1,82,1.335261000,0.0000
253.19.85.146,<->,92.27.219.205,0,0,1,52,1,52,1.334615000,0.0000
144.75.218.233,<->,140.142.187.19,1,76,0,0,1,76,1.333808000,0.0000
247.136.216.15,<->,149.156.171.10,1,50,0,0,1,50,1.332969000,0.0000
215.158.239.229,<->,8.181.148.227,1,141,0,0,1,141,1.332460000,0.0000
92.27.219.128,<->,38.113.224.85,1,52,0,0,1,52,1.332015000,0.0000
144.122.240.224,<->,144.76.43.237,1,74,0,0,1,74,1.331577000,0.0000
246.253.248.211,<->,54.61.158.158,1,88,0,0,1,88,1.330623000,0.0000
215.158.103.219,<->,192.178.163.107,1,114,0,0,1,114,1.329815000,0.0000
92.27.219.153,<->,27.72.144.170,1,52,0,0,1,52,1.329682000,0.0000
204.92.95.245,<->,192.67.143.62,0,0,1,77,1,77,1.329636000,0.0000
29.211.214.32,<->,8.35.106.238,1,122,0,0,1,122,1.329333000,0.0000
136.25.188.35,<->,114.142.109.74,1,142,0,0,1,142,1.328033000,0.0000
149.11.173.11,<->,111.146.229.38,0,0,1,1161,1,1161,1.327926000,0.0000
157.25.158.25,<->,144.75.218.242,0,0,1,86,1,86,1.327452000,0.0000
152.10.81.148,<->,92.27.219.50,0,0,1,124,1,124,1.326276000,0.0000
144.75.218.246,<->,138.127.231.48,1,239,0,0,1,239,1.326184000,0.0000
111.80.138.164,<->,8.228.214.124,0,0,1,78,1,78,1.325712000,0.0000
21.15.226.126,<->,20.193.28.82,0,0,1,82,1,82,1.325601000,0.0000
220.81.53.185,<->,106.213.164.217,1,321,0,0,1,321,1.325435000,0.0000
136.25.188.105,<->,135.88.170.10,1,137,0,0,1,137,1.325217000,0.0000
92.181.174.221,<->,69.170.195.175,1,181,0,0,1,181,1.325037000,0.0000
59.49.203.92,<->,39.56.33.14,0,0,1,72,1,72,1.324253000,0.0000
21.15.226.126,<->,20.193.27.199,0,0,1,82,1,82,1.324090000,0.0000
119.104.70.230,<->,100.93.189.226,0,0,1,52,1,52,1.324036000,0.0000
246.253.248.211,<->,148.195.254.219,1,75,0,0,1,75,1.323313000,0.0000
197.153.64.198,<->,39.243.94.186,0,0,1,68,1,68,1.322782000,0.0000
196.148.133.194,<->,29.155.156.81,1,1504,0,0,1,1504,1.322725000,0.0000
92.27.219.203,<->,33.63.141.162,1,133,0,0,1,133,1.322581000,0.0000
144.122.240.211,<->,144.108.64.185,1,70,0,0,1,70,1.321613000,0.0000
249.101.206.222,<->,201.8.119.226,1,133,0,0,1,133,1.321507000,0.0000
112.150.154.177,<->,97.126.19.185,0,0,1,321,1,321,1.321325000,0.0000
132.249.71.241,<->,132.249.70.154,0,0,1,220,1,220,1.320619000,0.0000
38.21.156.204,<->,20.232.230.46,0,0,1,82,1,82,1.320411000,0.0000
215.158.103.206,<->,139.252.1.255,1,191,0,0,1,191,1.320372000,0.0000
192.64.224.151,<->,155.19.248.167,1,300,0,0,1,300,1.320087000,0.0000
115.57.42.104,<->,109.1.46.25,0,0,1,58,1,58,1.318435000,0.0000
101.164.87.250,<->,4.133.108.1,1,133,0,0,1,133,1.318255000,0.0000
144.75.220.241,<->,50.224.103.166,0,0,1,81,1,81,1.316721000,0.0000
104.137.223.226,<->,102.50.80.105,0,0,1,58,1,58,1.316579000,0.0000
247.136.180.232,<->,134.97.14.154,1,52,0,0,1,52,1.316435000,0.0000
144.75.218.241,<->,138.127.224.21,1,289,0,0,1,289,1.316199000,0.0000
129.224.112.252,<->,56.9.177.179,1,81,0,0,1,81,1.315959000,0.0000
199.91.76.35,<->,20.8.71.202,0,0,1,74,1,74,1.315636000,0.0000
136.181.33.57,<->,27.126.142.151,1,349,0,0,1,349,1.314751000,0.0000
146.206.41.163,<->,34.140.83.85,0,0,1,140,1,140,1.314665000,0.0000
207.11.124.46,<->,20.126.125.212,0,0,1,75,1,75,1.313873000,0.0000
157.211.4.30,<->,39.63.180.220,0,0,1,130,1,130,1.313427000,0.0000
249.101.85.94,<->,92.27.51.141,1,80,0,0,1,80,1.312861000,0.0000
104.143.87.40,<->,100.93.96.116,0,0,1,309,1,309,1.312717000,0.0000
144.75.218.233,<->,138.127.224.136,1,334,0,0,1,334,1.312698000,0.0000
121.8.199.86,<->,8.252.222.35,0,0,1,83,1,83,1.312515000,0.0000
59.50.118.206,<->,39.129.248.66,0,0,1,75,1,75,1.312199000,0.0000
200.175.34.127,<->,6.187.59.90,1,52,0,0,1,52,1.312140000,0.0000
97.126.22.117,<->,29.54.21.217,1,69,0,0,1,69,1.311410000,0.0000
215.158.140.25,<->,58.11.224.13,1,84,0,0,1,84,1.310583000,0.0000
106.122.241.132,<->,80.41.12.201,0,0,1,133,1,133,1.310180000,0.0000
146.240.59.16,<->,129.224.112.252,0,0,1,71,1,71,1.309283000,0.0000
109.222.253.182,<->,40.169.181.94,1,66,0,0,1,66,1.309273000,0.0000
249.101.92.224,<->,53.160.20.106,1,85,0,0,1,85,1.308683000,0.0000
144.75.218.233,<->,132.43.156.81,1,154,0,0,1,154,1.308499000,0.0000
230.52.215.218,<->,220.87.53.31,0,0,1,138,1,138,1.307775000,0.0000
21.15.226.126,<->,20.193.28.137,0,0,1,82,1,82,1.307153000,0.0000
110.21.0.12,<->,92.27.219.58,0,0,1,197,1,197,1.306992000,0.0000
205.165.51.118,<->,92.27.219.188,0,0,1,344,1,344,1.306984000,0.0000
127.182.104.174,<->,80.41.16.213,0,0,1,135,1,135,1.306789000,0.0000
144.75.218.233,<->,140.114.135.111,1,139,0,0,1,139,1.306710000,0.0000
109.14.213.84,<->,29.211.214.191,0,0,1,75,1,75,1.305321000,0.0000
205.225.237.193,<->,109.1.34.223,0,0,1,304,1,304,1.304622000,0.0000
144.75.218.246,<->,138.127.224.83,1,170,0,0,1,170,1.304056000,0.0000
122.189.124.157,<->,101.70.126.222,0,0,1,67,1,67,1.303748000,0.0000
82.198.203.138,<->,37.49.230.49,1,52,0,0,1,52,1.303337000,0.0000
144.76.46.38,<->,99.75.36.192,0,0,1,528,1,528,1.303059000,0.0000
50.224.121.247,<->,4.241.88.57,1,50,0,0,1,50,1.301685000,0.0000
118.112.193.88,<->,92.27.219.166,0,0,1,135,1,135,1.300622000,0.0000
92.27.219.63,<->,33.59.148.87,1,62,0,0,1,62,1.300596000,0.0000
144.75.218.241,<->,129.35.250.197,1,147,0,0,1,147,1.300410000,0.0000
144.75.218.237,<->,138.127.230.93,1,315,0,0,1,315,1.298638000,0.0000
215.158.239.81,<->,143.88.15.74,1,84,0,0,1,84,1.298356000,0.0000
144.75.221.204,<->,139.163.86.189,0,0,1,77,1,77,1.297170000,0.0000
109.222.255.32,<->,76.227.20.83,1,69,0,0,1,69,1.297041000,0.0000
129.254.100.56,<->,129.224.112.252,0,0,1,72,1,72,1.296885000,0.0000
92.27.219.218,<->,0.243.138.167,1,62,0,0,1,62,1.296704000,0.0000
138.127.224.168,<->,97.126.26.70,0,0,1,303,1,303,1.295724000,0.0000
100.180.208.148,<->,92.27.219.46,0,0,1,52,1,52,1.295350000,0.0000
246.253.253.210,<->,199.36.151.146,1,125,0,0,1,125,1.294857000,0.0000
92.27.27.181,<->,89.166.53.86,1,397,0,0,1,397,1.294420000,0.0000
129.224.112.252,<->,114.145.122.251,1,80,0,0,1,80,1.293881000,0.0000
104.95.121.154,<->,98.129.112.137,0,0,1,97,1,97,1.293654000,0.0000
109.222.244.46,<->,55.221.163.100,1,70,0,0,1,70,1.293478000,0.0000
210.156.155.20,<->,156.29.237.157,1,130,0,0,1,130,1.292049000,0.0000
129.224.112.252,<->,97.242.126.187,1,68,0,0,1,68,1.292043000,0.0000
120.18.126.117,<->,109.222.234.241,0,0,1,70,1,70,1.290647000,0.0000
21.15.226.126,<->,20.193.28.182,0,0,1,82,1,82,1.290306000,0.0000
114.199.58.229,<->,109.222.192.25,0,0,1,52,1,52,1.290148000,0.0000
247.136.216.62,<->,38.65.197.7,1,52,0,0,1,52,1.289949000,0.0000
93.20.89.159,<->,89.183.104.238,0,0,1,224,1,224,1.289567000,0.0000
21.15.226.126,<->,20.193.28.175,0,0,1,82,1,82,1.289515000,0.0000
144.75.218.241,<->,138.127.225.198,1,289,0,0,1,289,1.289016000,0.0000
247.136.226.219,<->,27.75.209.190,1,485,0,0,1,485,1.288632000,0.0000
220.38.84.85,<->,215.158.140.11,0,0,1,90,1,90,1.287933000,0.0000
109.222.255.50,<->,10.185.194.151,1,78,0,0,1,78,1.287562000,0.0000
21.15.226.126,<->,20.193.28.177,0,0,1,82,1,82,1.287359000,0.0000
192.67.161.166,<->,134.254.80.75,1,135,0,0,1,135,1.285825000,0.0000
109.1.16.168,<->,27.188.163.162,1,446,0,0,1,446,1.285535000,0.0000
109.1.49.223,<->,74.239.239.153,1,133,0,0,1,133,1.285528000,0.0000
192.224.146.246,<->,133.178.226.107,0,0,1,1064,1,1064,1.285358000,0.0000
210.226.165.98,<->,53.84.186.205,1,56,0,0,1,56,1.284949000,0.0000
103.237.215.117,<->,92.27.219.208,0,0,1,52,1,52,1.283784000,0.0000
101.70.107.137,<->,82.136.228.64,1,70,0,0,1,70,1.282915000,0.0000
133.191.124.35,<->,129.175.139.119,1,88,0,0,1,88,1.282885000,0.0000
128.153.37.180,<->,20.183.64.44,0,0,1,72,1,72,1.282329000,0.0000
192.67.179.218,<->,89.183.104.233,0,0,1,263,1,263,1.282146000,0.0000
215.158.103.219,<->,138.127.231.206,1,155,0,0,1,155,1.282097000,0.0000
230.87.239.94,<->,109.3.163.238,0,0,1,351,1,351,1.281689000,0.0000
136.25.189.243,<->,102.42.102.64,1,329,0,0,1,329,1.281484000,0.0000
132.249.70.233,<->,128.231.178.26,1,158,0,0,1,158,1.281306000,0.0000
223.140.87.220,<->,8.228.214.124,0,0,1,98,1,98,1.280774000,0.0000
215.158.103.206,<->,129.221.194.239,1,525,0,0,1,525,1.279837000,0.0000
146.154.162.236,<->,39.171.2.46,0,0,1,74,1,74,1.279797000,0.0000
92.27.219.37,<->,33.57.79.34,1,135,0,0,1,135,1.279152000,0.0000
101.224.185.49,<->,48.104.80.96,1,57,0,0,1,57,1.278977000,0.0000
89.183.104.172,<->,42.246.37.114,1,52,0,0,1,52,1.278405000,0.0000
144.75.218.242,<->,140.136.104.193,1,121,0,0,1,121,1.276900000,0.0000
139.241.115.2,<->,80.56.78.94,0,0,1,84,1,84,1.275839000,0.0000
21.15.226.126,<->,20.193.28.247,0,0,1,82,1,82,1.275721000,0.0000
193.46.99.107,<->,89.183.104.136,0,0,1,90,1,90,1.275621000,0.0000
120.155.87.47,<->,8.252.222.181,0,0,1,132,1,132,1.275278000,0.0000
254.82.206.131,<->,221.150.250.237,0,0,1,134,1,134,1.274844000,0.0000
109.222.235.84,<->,105.83.237.194,1,79,0,0,1,79,1.274528000,0.0000
227.56.190.69,<->,144.75.218.233,0,0,1,63,1,63,1.274271000,0.0000
144.89.113.56,<->,129.224.112.252,0,0,1,76,1,76,1.273885000,0.0000
207.198.142.213,<->,92.27.219.33,0,0,1,52,1,52,1.273693000,0.0000
210.220.218.36,<->,78.126.223.125,1,68,0,0,1,68,1.273665000,0.0000
118.20.111.94,<->,8.176.8.85,0,0,1,161,1,161,1.273233000,0.0000
141.93.238.50,<->,129.224.112.252,0,0,1,80,1,80,1.272248000,0.0000
144.106.237.27,<->,139.163.114.182,0,0,1,116,1,116,1.271761000,0.0000
224.115.136.169,<->,111.146.249.17,0,0,1,129,1,129,1.270439000,0.0000
207.60.153.205,<->,20.209.211.182,0,0,1,75,1,75,1.270304000,0.0000
205.44.229.55,<->,20.194.30.195,0,0,1,52,1,52,1.269629000,0.0000
156.152.130.177,<->,129.224.112.252,0,0,1,77,1,77,1.269480000,0.0000
144.75.218.233,<->,54.38.169.95,1,126,0,0,1,126,1.268192000,0.0000
129.224.112.252,<->,106.213.35.197,1,73,0,0,1,73,1.267525000,0.0000
144.75.218.241,<->,115.151.47.145,1,203,0,0,1,203,1.267334000,0.0000
246.254.97.149,<->,148.215.253.0,1,84,0,0,1,84,1.267331000,0.0000
21.15.226.126,<->,20.193.28.194,0,0,1,82,1,82,1.267161000,0.0000
215.158.140.8,<->,29.212.192.189,1,90,0,0,1,90,1.266889000,0.0000
252.136.244.22,<->,97.68.226.205,0,0,1,77,1,77,1.266400000,0.0000
125.60.211.179,<->,89.183.104.178,0,0,1,62,1,62,1.266184000,0.0000
143.99.27.229,<->,20.97.6.71,0,0,1,76,1,76,1.265706000,0.0000
206.188.93.145,<->,192.64.247.45,0,0,1,103,1,103,1.264714000,0.0000
192.64.217.166,<->,122.102.188.46,1,52,0,0,1,52,1.264670000,0.0000
92.27.219.46,<->,69.196.187.52,1,52,0,0,1,52,1.264438000,0.0000
99.248.12.145,<->,92.27.219.196,0,0,1,135,1,135,1.263799000,0.0000
120.178.111.142,<->,92.27.219.20,0,0,1,62,1,62,1.263782000,0.0000
99.72.132.173,<->,27.151.38.15,1,62,0,0,1,62,1.263733000,0.0000
21.15.226.126,<->,20.193.29.211,0,0,1,82,1,82,1.263639000,0.0000
220.55.70.6,<->,143.252.64.235,1,72,0,0,1,72,1.263527000,0.0000
203.142.79.172,<->,92.27.27.183,0,0,1,52,1,52,1.263412000,0.0000
215.158.239.229,<->,113.23.83.211,1,141,0,0,1,141,1.263044000,0.0000
215.158.103.206,<->,159.151.90.195,1,138,0,0,1,138,1.262981000,0.0000
117.254.120.156,<->,89.183.104.233,0,0,1,263,1,263,1.261867000,0.0000
135.225.138.249,<->,92.27.219.205,0,0,1,52,1,52,1.260840000,0.0000
192.171.13.33,<->,8.252.222.189,0,0,1,95,1,95,1.260717000,0.0000
159.69.187.47,<->,144.108.80.167,1,73,0,0,1,73,1.260681000,0.0000
126.83.231.6,<->,20.194.30.195,0,0,1,52,1,52,1.260237000,0.0000
199.90.130.244,<->,144.75.218.241,0,0,1,165,1,165,1.260047000,0.0000
109.1.60.170,<->,33.240.107.135,1,52,0,0,1,52,1.259467000,0.0000
119.2.213.36,<->,39.29.91.231,0,0,1,90,1,90,1.259027000,0.0000
122.42.0.96,<->,92.27.235.58,0,0,1,97,1,97,1.257936000,0.0000
141.92.221.223,<->,129.224.112.252,0,0,1,74,1,74,1.257607000,0.0000
144.75.218.235,<->,138.127.224.208,1,253,0,0,1,253,1.257295000,0.0000
89.183.104.246,<->,38.183.250.139,1,52,0,0,1,52,1.256299000,0.0000
113.42.172.90,<->,92.27.219.250,0,0,1,52,1,52,1.255967000,0.0000
194.244.149.235,<->,20.186.90.234,0,0,1,75,1,75,1.253727000,0.0000
144.69.82.139,<->,113.186.98.254,1,69,0,0,1,69,1.253381000,0.0000
105.168.127.76,<->,98.236.254.250,0,0,1,76,1,76,1.252166000,0.0000
144.75.218.235,<->,100.117.19.29,1,81,0,0,1,81,1.251757000,0.0000
156.151.249.107,<->,34.17.114.255,0,0,1,72,1,72,1.249924000,0.0000
92.27.219.41,<->,50.98.176.213,1,309,0,0,1,309,1.249349000,0.0000
129.224.112.252,<->,117.159.118.99,1,75,0,0,1,75,1.249166000,0.0000
203.63.8.114,<->,80.42.149.110,0,0,1,52,1,52,1.248506000,0.0000
104.136.21.9,<->,99.73.231.161,0,0,1,52,1,52,1.248148000,0.0000
129.92.114.135,<->,29.216.97.203,1,73,0,0,1,73,1.247548000,0.0000
93.174.159.233,<->,80.41.12.225,0,0,1,321,1,321,1.246919000,0.0000
120.174.245.10,<->,39.206.71.15,0,0,1,74,1,74,1.246678000,0.0000
116.25.226.190,<->,98.129.64.162,0,0,1,97,1,97,1.246632000,0.0000
144.75.218.237,<->,58.134.5.66,1,178,0,0,1,178,1.245720000,0.0000
111.151.107.247,<->,8.252.222.105,0,0,1,224,1,224,1.245102000,0.0000
247.136.157.61,<->,127.91.126.8,1,52,0,0,1,52,1.244356000,0.0000
38.21.156.204,<->,20.232.228.127,0,0,1,82,1,82,1.243936000,0.0000
141.129.193.22,<->,101.224.89.139,0,0,1,255,1,255,1.243746000,0.0000
254.126.164.43,<->,97.68.226.205,0,0,1,77,1,77,1.243347000,0.0000
159.133.61.244,<->,53.149.236.92,1,129,0,0,1,129,1.242660000,0.0000
215.158.239.74,<->,143.88.15.74,1,84,0,0,1,84,1.242446000,0.0000
138.127.229.147,<->,132.222.173.36,0,0,1,355,1,355,1.242239000,0.0000
197.197.245.29,<->,139.207.222.11,0,0,1,89,1,89,1.241846000,0.0000
138.127.225.194,<->,109.222.238.0,0,0,1,216,1,216,1.241814000,0.0000
38.88.61.181,<->,20.3.36.209,0,0,1,76,1,76,1.241007000,0.0000
114.235.254.115,<->,92.27.219.183,0,0,1,135,1,135,1.240737000,0.0000
246.253.253.211,<->,196.28.180.242,1,125,0,0,1,125,1.240528000,0.0000
197.120.245.140,<->,129.224.112.252,0,0,1,78,1,78,1.240210000,0.0000
114.91.22.178,<->,80.40.61.163,0,0,1,99,1,99,1.239349000,0.0000
210.158.44.208,<->,120.49.223.215,1,671,0,0,1,671,1.235296000,0.0000
206.16.149.155,<->,192.64.217.166,0,0,1,52,1,52,1.234293000,0.0000
122.33.24.86,<->,92.27.219.175,0,0,1,190,1,190,1.234095000,0.0000
109.222.214.116,<->,87.11.192.79,1,325,0,0,1,325,1.232988000,0.0000
215.158.239.229,<->,210.140.5.233,1,136,0,0,1,136,1.232966000,0.0000
241.189.29.155,<->,144.75.218.241,0,0,1,125,1,125,1.232324000,0.0000
21.15.226.126,<->,20.193.29.155,0,0,1,82,1,82,1.232147000,0.0000
144.75.218.241,<->,138.127.230.220,1,257,0,0,1,257,1.231696000,0.0000
113.127.190.72,<->,89.183.104.156,0,0,1,99,1,99,1.230593000,0.0000
125.154.210.13,<->,92.27.219.193,0,0,1,52,1,52,1.230463000,0.0000
159.237.225.1,<->,121.227.142.184,1,52,0,0,1,52,1.229122000,0.0000
38.21.156.204,<->,20.232.228.122,0,0,1,82,1,82,1.228724000,0.0000
206.20.245.151,<->,92.27.219.17,0,0,1,52,1,52,1.226270000,0.0000
111.75.58.59,<->,56.121.48.108,0,0,1,74,1,74,1.226181000,0.0000
114.56.125.199,<->,101.224.204.193,0,0,1,147,1,147,1.225748000,0.0000
246.253.253.12,<->,57.18.136.2,1,116,0,0,1,116,1.225441000,0.0000
133.178.226.244,<->,131.36.201.66,1,90,0,0,1,90,1.225083000,0.0000
144.75.218.246,<->,138.127.225.234,1,254,0,0,1,254,1.224002000,0.0000
211.177.72.97,<->,33.233.141.230,0,0,1,92,1,92,1.223486000,0.0000
246.253.248.211,<->,53.212.189.88,1,87,0,0,1,87,1.222807000,0.0000
120.252.12.7,<->,111.146.132.89,0,0,1,78,1,78,1.221330000,0.0000
250.50.35.185,<->,92.27.219.53,0,0,1,74,1,74,1.221057000,0.0000
136.25.188.105,<->,124.63.211.122,1,236,0,0,1,236,1.220259000,0.0000
54.36.174.41,<->,48.53.146.152,0,0,1,52,1,52,1.219769000,0.0000
92.27.219.189,<->,27.117.27.216,1,317,0,0,1,317,1.219248000,0.0000
202.226.243.164,<->,145.89.157.42,0,0,1,130,1,130,1.218103000,0.0000
109.222.243.161,<->,48.120.106.220,1,80,0,0,1,80,1.217351000,0.0000
158.59.135.25,<->,92.27.219.38,0,0,1,52,1,52,1.215909000,0.0000
192.171.13.188,<->,8.176.8.207,0,0,1,101,1,101,1.215074000,0.0000
119.45.235.115,<->,89.183.104.149,0,0,1,309,1,309,1.215070000,0.0000
148.145.2.122,<->,101.224.204.141,0,0,1,80,1,80,1.213063000,0.0000
144.69.82.139,<->,100.120.38.126,1,75,0,0,1,75,1.212577000,0.0000
21.15.226.126,<->,20.193.30.1,0,0,1,82,1,82,1.212103000,0.0000
159.115.66.251,<->,78.51.80.203,1,52,0,0,1,52,1.211821000,0.0000
92.27.219.182,<->,66.247.36.243,1,136,0,0,1,136,1.211447000,0.0000
143.200.139.20,<->,129.224.112.252,0,0,1,80,1,80,1.210243000,0.0000
220.55.91.56,<->,139.155.70.249,1,149,0,0,1,149,1.210212000,0.0000
144.75.218.241,<->,138.127.231.83,1,253,0,0,1,253,1.210199000,0.0000
120.83.1.71,<->,92.27.219.224,0,0,1,129,1,129,1.209786000,0.0000
198.25.75.198,<->,80.40.57.229,0,0,1,130,1,130,1.208491000,0.0000
192.64.210.96,<->,126.119.197.36,1,319,0,0,1,319,1.208454000,0.0000
89.183.104.178,<->,38.87.182.252,1,62,0,0,1,62,1.208115000,0.0000
92.27.219.204,<->,29.169.76.213,1,1452,0,0,1,1452,1.208038000,0.0000
145.213.37.25,<->,136.129.94.109,0,0,1,84,1,84,1.207910000,0.0000
132.249.70.233,<->,53.178.104.39,1,87,0,0,1,87,1.205859000,0.0000
196.126.208.63,<->,92.27.219.242,0,0,1,52,1,52,1.201362000,0.0000
144.75.218.237,<->,138.127.230.5,1,279,0,0,1,279,1.201318000,0.0000
92.27.27.183,<->,33.245.146.245,1,52,0,0,1,52,1.200676000,0.0000
33.182.213.211,<->,20.61.49.107,0,0,1,80,1,80,1.200411000,0.0000
72.198.225.4,<->,39.227.147.56,0,0,1,66,1,66,1.199850000,0.0000
96.232.117.46,<->,92.27.219.128,0,0,1,151,1,151,1.199490000,0.0000
205.91.195.56,<->,89.183.104.191,0,0,1,52,1,52,1.198596000,0.0000
148.141.109.98,<->,8.228.214.59,0,0,1,112,1,112,1.196360000,0.0000
200.174.202.105,<->,6.186.47.64,1,273,0,0,1,273,1.195972000,0.0000
119.219.189.202,<->,80.41.53.34,0,0,1,325,1,325,1.195709000,0.0000
194.107.29.92,<->,20.169.41.156,0,0,1,174,1,174,1.195349000,0.0000
144.75.218.237,<->,130.61.250.229,1,126,0,0,1,126,1.194614000,0.0000
215.158.239.124,<->,112.88.209.14,1,140,0,0,1,140,1.194535000,0.0000
152.134.187.138,<->,39.18.16.156,0,0,1,541,1,541,1.194525000,0.0000
144.75.218.233,<->,138.127.225.15,1,197,0,0,1,197,1.194018000,0.0000
144.75.218.235,<->,139.252.1.234,1,180,0,0,1,180,1.193509000,0.0000
127.27.251.233,<->,39.166.150.51,0,0,1,128,1,128,1.193210000,0.0000
215.158.239.229,<->,8.47.188.160,1,151,0,0,1,151,1.193197000,0.0000
238.125.29.51,<->,136.25.188.105,0,0,1,138,1,138,1.192781000,0.0000
38.21.156.204,<->,20.232.228.104,0,0,1,82,1,82,1.192013000,0.0000
97.126.39.127,<->,57.141.118.57,1,97,0,0,1,97,1.191800000,0.0000
133.178.227.7,<->,29.211.165.84,1,85,0,0,1,85,1.191720000,0.0000
144.75.218.233,<->,138.127.224.73,1,184,0,0,1,184,1.190830000,0.0000
144.75.218.237,<->,33.229.58.179,1,127,0,0,1,127,1.189792000,0.0000
146.253.87.247,<->,136.25.188.105,0,0,1,126,1,126,1.189777000,0.0000
109.222.234.213,<->,26.239.129.100,1,72,0,0,1,72,1.189647000,0.0000
92.27.219.63,<->,29.165.54.202,1,52,0,0,1,52,1.189399000,0.0000
220.55.126.117,<->,220.28.104.139,1,76,0,0,1,76,1.188756000,0.0000
117.7.164.34,<->,39.32.47.103,0,0,1,84,1,84,1.188724000,0.0000
144.93.121.83,<->,131.2.34.14,1,104,0,0,1,104,1.188580000,0.0000
144.69.82.139,<->,35.62.71.37,1,58,0,0,1,58,1.188378000,0.0000
111.2.141.22,<->,39.28.155.53,0,0,1,89,1,89,1.188003000,0.0000
127.79.61.116,<->,89.183.104.155,0,0,1,149,1,149,1.187416000,0.0000
136.116.28.199,<->,8.193.74.84,1,1064,0,0,1,1064,1.186278000,0.0000
124.40.23.147,<->,92.27.219.49,0,0,1,52,1,52,1.185810000,0.0000
109.1.16.245,<->,27.188.163.162,1,443,0,0,1,443,1.185232000,0.0000
192.67.149.88,<->,117.111.143.108,1,853,0,0,1,853,1.184909000,0.0000
215.158.140.181,<->,111.151.107.247,1,96,0,0,1,96,1.184016000,0.0000
144.75.218.233,<->,138.127.224.184,1,365,0,0,1,365,1.183739000,0.0000
210.156.127.28,<->,94.194.6.39,1,133,0,0,1,133,1.183285000,0.0000
121.212.205.4,<->,92.27.219.169,0,0,1,110,1,110,1.182686000,0.0000
108.134.111.22,<->,57.31.51.159,1,83,0,0,1,83,1.182551000,0.0000
57.31.49.198,<->,39.14.27.228,0,0,1,125,1,125,1.182000000,0.0000
109.1.61.116,<->,74.245.228.7,1,133,0,0,1,133,1.181709000,0.0000
105.92.5.230,<->,20.122.133.235,0,0,1,80,1,80,1.181417000,0.0000
139.241.119.211,<->,39.15.169.14,0,0,1,86,1,86,1.181371000,0.0000
120.194.177.4,<->,92.27.27.164,0,0,1,103,1,103,1.180321000,0.0000
21.15.226.126,<->,20.193.30.67,0,0,1,82,1,82,1.179385000,0.0000
135.197.3.172,<->,132.249.70.233,0,0,1,120,1,120,1.179289000,0.0000
130.42.10.219,<->,97.126.26.70,0,0,1,173,1,173,1.178745000,0.0000
205.91.179.235,<->,89.183.104.150,0,0,1,52,1,52,1.176962000,0.0000
153.99.69.27,<->,20.147.15.136,0,0,1,62,1,62,1.176584000,0.0000
192.64.250.118,<->,115.179.112.80,1,50,0,0,1,50,1.176304000,0.0000
115.167.81.247,<->,111.20.168.4,0,0,1,110,1,110,1.175883000,0.0000
97.126.18.233,<->,80.200.62.165,1,70,0,0,1,70,1.175724000,0.0000
114.224.195.75,<->,109.222.193.244,0,0,1,77,1,77,1.175528000,0.0000
95.30.133.114,<->,8.228.217.218,0,0,1,67,1,67,1.175485000,0.0000
148.155.129.25,<->,101.224.89.180,0,0,1,173,1,173,1.174740000,0.0000
120.83.117.77,<->,89.183.104.168,0,0,1,309,1,309,1.174149000,0.0000
195.78.202.163,<->,109.222.249.216,0,0,1,99,1,99,1.173154000,0.0000
93.209.205.221,<->,89.183.104.237,0,0,1,84,1,84,1.172801000,0.0000
220.185.99.203,<->,89.183.104.146,0,0,1,351,1,351,1.172331000,0.0000
156.143.159.82,<->,20.2.234.129,0,0,1,68,1,68,1.172137000,0.0000
92.27.219.189,<->,48.106.243.183,1,135,0,0,1,135,1.171477000,0.0000
199.111.200.145,<->,100.93.64.127,0,0,1,138,1,138,1.171075000,0.0000
93.254.16.169,<->,92.27.219.63,0,0,1,52,1,52,1.171042000,0.0000
109.222.250.174,<->,109.124.187.222,1,76,0,0,1,76,1.169627000,0.0000
92.27.27.184,<->,29.217.237.116,1,52,0,0,1,52,1.169624000,0.0000
159.69.187.22,<->,144.76.43.246,1,76,0,0,1,76,1.169575000,0.0000
145.116.118.25,<->,110.195.195.90,1,133,0,0,1,133,1.169458000,0.0000
192.67.152.128,<->,120.118.162.203,1,54,0,0,1,54,1.169420000,0.0000
144.75.218.233,<->,138.127.231.39,1,256,0,0,1,256,1.169155000,0.0000
144.71.44.73,<->,124.125.130.196,1,116,0,0,1,116,1.168166000,0.0000
115.65.147.17,<->,92.27.27.179,0,0,1,330,1,330,1.167852000,0.0000
197.81.130.216,<->,39.5.176.34,0,0,1,126,1,126,1.167099000,0.0000
104.141.11.186,<->,102.51.24.236,0,0,1,130,1,130,1.166734000,0.0000
89.183.104.159,<->,38.139.96.253,1,52,0,0,1,52,1.166285000,0.0000
138.55.243.19,<->,39.15.234.173,0,0,1,76,1,76,1.166198000,0.0000
192.64.229.25,<->,124.149.71.236,1,77,0,0,1,77,1.166157000,0.0000
204.40.75.199,<->,99.75.19.169,0,0,1,102,1,102,1.165973000,0.0000
126.117.71.100,<->,92.27.219.48,0,0,1,97,1,97,1.165738000,0.0000
129.224.112.252,<->,114.145.109.163,1,80,0,0,1,80,1.165596000,0.0000
221.102.107.147,<->,100.230.7.100,1,50,0,0,1,50,1.165285000,0.0000
141.166.138.70,<->,39.8.240.172,0,0,1,126,1,126,1.164838000,0.0000
111.146.229.202,<->,42.119.56.135,1,168,0,0,1,168,1.164645000,0.0000
227.56.35.246,<->,33.233.141.123,0,0,1,167,1,167,1.163990000,0.0000
144.75.218.242,<->,144.44.177.217,1,162,0,0,1,162,1.163645000,0.0000
220.205.25.218,<->,218.4.168.6,0,0,1,80,1,80,1.163241000,0.0000
136.25.188.105,<->,132.4.136.122,1,166,0,0,1,166,1.162956000,0.0000
127.232.174.72,<->,39.239.109.202,0,0,1,70,1,70,1.162487000,0.0000
192.67.167.86,<->,87.62.187.115,1,52,0,0,1,52,1.162295000,0.0000
253.19.1.153,<->,80.40.24.220,0,0,1,54,1,54,1.162167000,0.0000
38.21.156.204,<->,20.232.228.99,0,0,1,82,1,82,1.161529000,0.0000
247.136.164.16,<->,57.241.133.147,1,97,0,0,1,97,1.160778000,0.0000
114.194.29.182,<->,89.183.104.146,0,0,1,322,1,322,1.160452000,0.0000
144.75.218.235,<->,138.127.224.83,1,229,0,0,1,229,1.160323000,0.0000
215.158.239.124,<->,131.65.15.204,1,715,0,0,1,715,1.160153000,0.0000
109.3.145.240,<->,61.51.212.221,1,133,0,0,1,133,1.159376000,0.0000
196.17.104.47,<->,80.42.160.104,0,0,1,52,1,52,1.158897000,0.0000
235.224.120.198,<->,192.64.215.178,0,0,1,136,1,136,1.158565000,0.0000
149.57.27.184,<->,89.183.104.177,0,0,1,263,1,263,1.158353000,0.0000
220.55.123.208,<->,27.11.34.178,1,85,0,0,1,85,1.156701000,0.0000
230.94.201.201,<->,100.182.191.235,0,0,1,138,1,138,1.156649000,0.0000
123.106.105.212,<->,20.185.77.89,0,0,1,68,1,68,1.156309000,0.0000
144.75.218.246,<->,97.110.148.13,1,67,0,0,1,67,1.154964000,0.0000
248.225.26.34,<->,95.221.85.227,1,893,0,0,1,893,1.154820000,0.0000
114.236.240.176,<->,92.27.219.28,0,0,1,319,1,319,1.154637000,0.0000
138.127.226.109,<->,129.179.50.133,0,0,1,222,1,222,1.153267000,0.0000
144.75.218.235,<->,65.95.70.36,1,140,0,0,1,140,1.152839000,0.0000
21.15.226.126,<->,20.193.30.195,0,0,1,82,1,82,1.152709000,0.0000
144.75.218.242,<->,139.252.1.232,1,151,0,0,1,151,1.152648000,0.0000
116.98.161.10,<->,109.1.61.190,0,0,1,149,1,149,1.152508000,0.0000
158.255.94.12,<->,129.224.112.252,0,0,1,71,1,71,1.152184000,0.0000
138.45.88.195,<->,136.25.189.215,0,0,1,90,1,90,1.151243000,0.0000
127.179.185.76,<->,89.183.104.172,0,0,1,52,1,52,1.150612000,0.0000
109.222.206.93,<->,37.150.196.39,1,80,0,0,1,80,1.150523000,0.0000
92.27.219.218,<->,57.50.83.249,1,330,0,0,1,330,1.149742000,0.0000
241.228.129.126,<->,153.189.34.81,1,293,0,0,1,293,1.149501000,0.0000
132.43.156.54,<->,129.13.225.151,0,0,1,351,1,351,1.149008000,0.0000
199.39.73.116,<->,92.27.27.145,0,0,1,52,1,52,1.148942000,0.0000
193.23.0.8,<->,92.27.27.182,0,0,1,52,1,52,1.148791000,0.0000
196.120.85.20,<->,39.28.34.214,0,0,1,80,1,80,1.148714000,0.0000
159.69.187.24,<->,144.69.101.196,1,80,0,0,1,80,1.148516000,0.0000
121.92.106.82,<->,39.9.31.78,0,0,1,86,1,86,1.148088000,0.0000
196.148.133.194,<->,123.86.109.137,1,321,0,0,1,321,1.147760000,0.0000
113.174.26.210,<->,99.75.149.54,0,0,1,133,1,133,1.147577000,0.0000
48.131.157.46,<->,8.176.8.84,0,0,1,89,1,89,1.146656000,0.0000
144.75.218.233,<->,138.127.230.149,1,366,0,0,1,366,1.146384000,0.0000
136.25.188.35,<->,98.28.95.54,1,111,0,0,1,111,1.145230000,0.0000
247.136.254.102,<->,117.91.158.107,1,52,0,0,1,52,1.145160000,0.0000
124.80.226.111,<->,100.92.42.66,0,0,1,321,1,321,1.145089000,0.0000
138.23.198.132,<->,8.219.186.186,1,90,0,0,1,90,1.144984000,0.0000
215.158.239.220,<->,48.131.157.46,1,90,0,0,1,90,1.144338000,0.0000
21.15.226.126,<->,20.193.30.220,0,0,1,82,1,82,1.143612000,0.0000
146.217.134.27,<->,101.224.169.159,0,0,1,57,1,57,1.143091000,0.0000
122.9.235.166,<->,99.73.166.232,0,0,1,52,1,52,1.143034000,0.0000
21.15.226.126,<->,20.193.30.218,0,0,1,82,1,82,1.142830000,0.0000
80.41.12.225,<->,38.136.169.74,1,52,0,0,1,52,1.140508000,0.0000
220.80.150.62,<->,119.230.159.219,1,133,0,0,1,133,1.140484000,0.0000
89.181.75.64,<->,74.249.239.112,1,293,0,0,1,293,1.140474000,0.0000
105.140.209.76,<->,20.143.42.40,0,0,1,52,1,52,1.140358000,0.0000
243.48.23.128,<->,144.75.218.235,0,0,1,152,1,152,1.140358000,0.0000
141.81.120.167,<->,33.233.141.32,0,0,1,78,1,78,1.139327000,0.0000
144.122.240.241,<->,144.108.64.183,1,69,0,0,1,69,1.139223000,0.0000
21.15.226.126,<->,20.193.30.222,0,0,1,82,1,82,1.139142000,0.0000
144.75.218.235,<->,138.127.224.125,1,348,0,0,1,348,1.138399000,0.0000
114.195.47.224,<->,89.183.104.135,0,0,1,62,1,62,1.138281000,0.0000
133.77.208.63,<->,129.224.112.252,0,0,1,65,1,65,1.138168000,0.0000
196.101.191.102,<->,109.1.58.78,0,0,1,80,1,80,1.137470000,0.0000
21.15.226.126,<->,20.193.31.250,0,0,1,82,1,82,1.137391000,0.0000
66.194.126.28,<->,8.228.214.59,0,0,1,52,1,52,1.137181000,0.0000
144.75.218.241,<->,143.204.138.236,1,177,0,0,1,177,1.137043000,0.0000
20.13.108.169,<->,0.200.50.50,1,60,0,0,1,60,1.136502000,0.0000
202.222.96.52,<->,8.238.168.0,0,0,1,133,1,133,1.136034000,0.0000
192.67.150.206,<->,110.6.236.172,1,52,0,0,1,52,1.135817000,0.0000
147.49.3.183,<->,39.243.208.129,0,0,1,52,1,52,1.135104000,0.0000
127.255.80.157,<->,92.27.219.49,0,0,1,52,1,52,1.134933000,0.0000
21.15.226.126,<->,20.193.31.229,0,0,1,82,1,82,1.134859000,0.0000
129.224.112.252,<->,92.162.219.51,1,90,0,0,1,90,1.134683000,0.0000
109.222.250.16,<->,17.142.246.251,1,72,0,0,1,72,1.134108000,0.0000
192.171.13.190,<->,8.252.222.54,0,0,1,138,1,138,1.134101000,0.0000
149.151.71.253,<->,80.42.156.128,0,0,1,135,1,135,1.133973000,0.0000
247.136.234.205,<->,75.95.145.227,1,84,0,0,1,84,1.133891000,0.0000
138.127.224.104,<->,136.25.188.29,0,0,1,286,1,286,1.133424000,0.0000
144.75.218.241,<->,138.127.224.185,1,366,0,0,1,366,1.133089000,0.0000
192.64.229.25,<->,121.196.222.187,1,99,0,0,1,99,1.132425000,0.0000
144.75.218.235,<->,138.127.225.222,1,366,0,0,1,366,1.132085000,0.0000
136.108.33.19,<->,39.144.127.89,1,77,0,0,1,77,1.131154000,0.0000
131.210.124.160,<->,111.20.168.141,0,0,1,203,1,203,1.131137000,0.0000
129.197.127.35,<->,97.126.117.98,0,0,1,170,1,170,1.130039000,0.0000
195.69.125.104,<->,20.103.184.243,0,0,1,66,1,66,1.130015000,0.0000
132.168.197.226,<->,129.245.206.220,1,723,0,0,1,723,1.129654000,0.0000
196.31.72.120,<->,111.181.116.40,0,0,1,52,1,52,1.129546000,0.0000
53.199.199.220,<->,39.15.169.14,0,0,1,86,1,86,1.128982000,0.0000
118.213.4.154,<->,92.27.219.150,0,0,1,52,1,52,1.128774000,0.0000
207.188.242.89,<->,20.167.128.198,0,0,1,68,1,68,1.128651000,0.0000
89.183.104.178,<->,27.40.186.140,1,52,0,0,1,52,1.128202000,0.0000
159.28.226.233,<->,132.123.40.70,0,0,1,70,1,70,1.127864000,0.0000
134.161.205.169,<->,92.27.27.175,0,0,1,52,1,52,1.127418000,0.0000
57.189.17.115,<->,39.231.195.68,0,0,1,74,1,74,1.126729000,0.0000
220.55.123.208,<->,206.195.194.146,1,83,0,0,1,83,1.126200000,0.0000
80.42.203.252,<->,66.210.105.224,1,130,0,0,1,130,1.122954000,0.0000
53.69.112.6,<->,33.233.141.19,0,0,1,124,1,124,1.122522000,0.0000
215.158.239.102,<->,78.128.203.59,1,116,0,0,1,116,1.122203000,0.0000
126.86.170.240,<->,20.20.251.226,0,0,1,76,1,76,1.121672000,0.0000
57.126.7.237,<->,39.138.199.229,0,0,1,68,1,68,1.121508000,0.0000
129.236.100.166,<->,129.224.112.252,0,0,1,76,1,76,1.120753000,0.0000
111.20.172.70,<->,33.233.141.33,0,0,1,290,1,290,1.120485000,0.0000
109.1.61.116,<->,104.236.121.73,1,149,0,0,1,149,1.119540000,0.0000
148.155.129.25,<->,33.233.141.39,0,0,1,170,1,170,1.119020000,0.0000
111.88.145.220,<->,92.27.219.248,0,0,1,149,1,149,1.119011000,0.0000
97.126.18.233,<->,15.15.125.115,1,72,0,0,1,72,1.118751000,0.0000
132.249.70.213,<->,53.152.211.127,1,116,0,0,1,116,1.118407000,0.0000
144.75.218.246,<->,140.142.187.19,1,77,0,0,1,77,1.117685000,0.0000
38.21.156.204,<->,20.232.228.86,0,0,1,82,1,82,1.117374000,0.0000
247.136.146.16,<->,126.198.69.217,1,321,0,0,1,321,1.116966000,0.0000
92.181.50.174,<->,74.249.120.178,1,130,0,0,1,130,1.116515000,0.0000
194.223.51.91,<->,99.75.183.47,0,0,1,97,1,97,1.116214000,0.0000
130.94.125.208,<->,80.41.21.72,0,0,1,136,1,136,1.115973000,0.0000
111.20.172.70,<->,111.20.168.215,0,0,1,288,1,288,1.115435000,0.0000
159.87.104.238,<->,100.211.114.205,1,87,0,0,1,87,1.115183000,0.0000
131.103.234.27,<->,39.45.58.107,0,0,1,75,1,75,1.114800000,0.0000
21.15.226.126,<->,20.193.31.101,0,0,1,82,1,82,1.114296000,0.0000
144.75.218.242,<->,138.127.225.234,1,254,0,0,1,254,1.113517000,0.0000
138.127.230.89,<->,132.168.197.226,0,0,1,156,1,156,1.113382000,0.0000
100.95.46.59,<->,27.13.70.75,1,52,0,0,1,52,1.113104000,0.0000
145.242.126.150,<->,144.43.70.2,1,76,0,0,1,76,1.112434000,0.0000
39.3.89.10,<->,38.69.22.246,1,75,0,0,1,75,1.112281000,0.0000
21.15.226.126,<->,20.193.31.104,0,0,1,82,1,82,1.112015000,0.0000
215.158.103.219,<->,193.41.156.225,1,810,0,0,1,810,1.111076000,0.0000
38.21.156.204,<->,20.232.228.83,0,0,1,82,1,82,1.110984000,0.0000
142.235.117.143,<->,80.40.1.240,0,0,1,62,1,62,1.110482000,0.0000
92.27.219.182,<->,42.78.196.77,1,170,0,0,1,170,1.109021000,0.0000
159.69.187.17,<->,144.76.43.246,1,80,0,0,1,80,1.107971000,0.0000
97.126.26.40,<->,53.75.247.118,1,122,0,0,1,122,1.107675000,0.0000
21.15.226.126,<->,20.193.31.111,0,0,1,82,1,82,1.107300000,0.0000
111.20.172.70,<->,33.233.141.20,0,0,1,108,1,108,1.106256000,0.0000
195.106.192.106,<->,39.26.61.138,0,0,1,70,1,70,1.105711000,0.0000
111.147.185.215,<->,53.161.125.14,1,104,0,0,1,104,1.105338000,0.0000
144.75.218.246,<->,126.231.170.67,1,226,0,0,1,226,1.104743000,0.0000
246.254.97.149,<->,131.1.232.48,1,93,0,0,1,93,1.104638000,0.0000
109.222.254.87,<->,61.45.126.114,1,79,0,0,1,79,1.103463000,0.0000
117.54.27.6,<->,92.27.219.224,0,0,1,263,1,263,1.102765000,0.0000
118.37.169.38,<->,89.183.104.233,0,0,1,147,1,147,1.102148000,0.0000
123.97.227.2,<->,20.222.101.110,0,0,1,149,1,149,1.101854000,0.0000
215.158.238.76,<->,115.232.101.107,1,83,0,0,1,83,1.101397000,0.0000
121.20.26.123,<->,100.94.146.138,0,0,1,97,1,97,1.101163000,0.0000
155.133.39.148,<->,78.123.16.211,0,0,1,325,1,325,1.101074000,0.0000
111.20.172.70,<->,101.224.89.251,0,0,1,101,1,101,1.101034000,0.0000
215.158.140.168,<->,111.151.107.247,1,146,0,0,1,146,1.099848000,0.0000
149.164.189.49,<->,144.75.218.235,0,0,1,87,1,87,1.098022000,0.0000
129.224.112.252,<->,27.127.251.59,1,77,0,0,1,77,1.097758000,0.0000
192.67.161.171,<->,114.132.77.146,1,52,0,0,1,52,1.097570000,0.0000
53.203.244.13,<->,33.233.141.69,0,0,1,148,1,148,1.097547000,0.0000
220.28.109.99,<->,144.69.82.139,0,0,1,79,1,79,1.097477000,0.0000
92.27.219.159,<->,4.240.232.244,1,317,0,0,1,317,1.097281000,0.0000
215.158.61.36,<->,80.56.78.92,0,0,1,96,1,96,1.096829000,0.0000
246.253.248.211,<->,54.61.179.29,1,87,0,0,1,87,1.096595000,0.0000
149.250.234.17,<->,92.27.219.218,0,0,1,659,1,659,1.096511000,0.0000
129.224.112.252,<->,92.162.219.101,1,103,0,0,1,103,1.096467000,0.0000
201.192.219.121,<->,129.224.112.252,0,0,1,75,1,75,1.096140000,0.0000
111.20.172.70,<->,101.224.89.171,0,0,1,292,1,292,1.095885000,0.0000
98.67.136.236,<->,18.215.146.2,1,76,0,0,1,76,1.095425000,0.0000
133.229.224.241,<->,80.56.78.128,0,0,1,95,1,95,1.094850000,0.0000
115.167.81.247,<->,33.233.141.56,0,0,1,113,1,113,1.093436000,0.0000
80.47.33.8,<->,29.211.214.82,0,0,1,86,1,86,1.093163000,0.0000
80.40.48.131,<->,66.127.213.175,1,50,0,0,1,50,1.093063000,0.0000
202.124.171.233,<->,108.39.208.231,0,0,1,138,1,138,1.092732000,0.0000
215.158.103.219,<->,158.189.38.26,1,88,0,0,1,88,1.092440000,0.0000
237.79.102.33,<->,20.214.82.212,0,0,1,52,1,52,1.092285000,0.0000
132.249.70.213,<->,53.80.105.51,1,116,0,0,1,116,1.092122000,0.0000
158.169.138.222,<->,101.224.172.135,0,0,1,57,1,57,1.090288000,0.0000
159.69.187.22,<->,144.108.64.183,1,68,0,0,1,68,1.089425000,0.0000
126.245.187.49,<->,80.40.45.77,0,0,1,52,1,52,1.089035000,0.0000
239.66.89.165,<->,102.51.131.202,0,0,1,50,1,50,1.088224000,0.0000
192.64.229.128,<->,134.248.13.131,1,50,0,0,1,50,1.088045000,0.0000
144.75.218.246,<->,138.127.231.151,1,253,0,0,1,253,1.088000000,0.0000
215.158.103.206,<->,113.188.130.131,1,122,0,0,1,122,1.087406000,0.0000
122.143.161.166,<->,80.41.58.237,0,0,1,319,1,319,1.087256000,0.0000
138.127.224.225,<->,101.224.89.252,0,0,1,231,1,231,1.087222000,0.0000
192.67.167.86,<->,92.45.66.15,1,52,0,0,1,52,1.086934000,0.0000
118.38.71.77,<->,20.233.54.222,0,0,1,66,1,66,1.086859000,0.0000
138.127.224.102,<->,33.233.141.93,0,0,1,240,1,240,1.086034000,0.0000
148.155.129.25,<->,33.233.141.1,0,0,1,170,1,170,1.084607000,0.0000
92.173.80.90,<->,92.27.27.99,0,0,1,52,1,52,1.084485000,0.0000
138.127.231.205,<->,132.168.197.226,0,0,1,157,1,157,1.084433000,0.0000
221.150.250.237,<->,97.22.32.10,1,178,0,0,1,178,1.084424000,0.0000
111.20.172.70,<->,101.224.89.168,0,0,1,299,1,299,1.084209000,0.0000
105.229.251.213,<->,92.27.219.146,0,0,1,349,1,349,1.083958000,0.0000
159.137.139.218,<->,136.25.189.2,0,0,1,1064,1,1064,1.083730000,0.0000
20.13.108.243,<->,0.200.50.50,1,60,0,0,1,60,1.083585000,0.0000
21.15.226.126,<->,20.193.56.77,0,0,1,82,1,82,1.083445000,0.0000
192.64.238.102,<->,120.250.240.90,1,349,0,0,1,349,1.083194000,0.0000
111.20.172.70,<->,33.233.141.4,0,0,1,288,1,288,1.082784000,0.0000
144.64.137.5,<->,115.151.119.225,1,74,0,0,1,74,1.082469000,0.0000
205.39.1.120,<->,0.195.210.15,0,0,1,158,1,158,1.081821000,0.0000
116.238.228.1,<->,39.157.36.128,0,0,1,92,1,92,1.081102000,0.0000
148.155.129.25,<->,101.224.89.248,0,0,1,170,1,170,1.080895000,0.0000
132.107.75.195,<->,111.147.202.234,0,0,1,360,1,360,1.080862000,0.0000
247.136.188.124,<->,93.172.27.17,1,52,0,0,1,52,1.080751000,0.0000
111.20.172.70,<->,33.233.141.231,0,0,1,107,1,107,1.080026000,0.0000
141.125.172.113,<->,39.131.11.141,0,0,1,80,1,80,1.079965000,0.0000
101.224.89.157,<->,57.176.113.202,1,101,0,0,1,101,1.078453000,0.0000
197.8.203.28,<->,92.27.219.198,0,0,1,52,1,52,1.078274000,0.0000
230.59.65.170,<->,192.64.114.92,0,0,1,130,1,130,1.078187000,0.0000
148.155.131.220,<->,101.224.89.178,0,0,1,172,1,172,1.077950000,0.0000
138.127.225.156,<->,33.233.141.64,0,0,1,281,1,281,1.077822000,0.0000
131.233.225.105,<->,39.248.134.206,0,0,1,82,1,82,1.077426000,0.0000
132.250.195.39,<->,33.233.141.71,0,0,1,183,1,183,1.077400000,0.0000
144.75.218.242,<->,138.127.225.175,1,366,0,0,1,366,1.075968000,0.0000
144.75.218.242,<->,141.37.226.95,1,86,0,0,1,86,1.075959000,0.0000
80.38.49.145,<->,48.115.121.162,1,82,0,0,1,82,1.075603000,0.0000
142.248.250.197,<->,20.106.72.13,0,0,1,74,1,74,1.074801000,0.0000
215.158.103.219,<->,136.103.157.90,1,123,0,0,1,123,1.074467000,0.0000
99.73.184.38,<->,27.12.26.177,1,168,0,0,1,168,1.074302000,0.0000
158.169.138.222,<->,101.224.191.186,0,0,1,57,1,57,1.073523000,0.0000
192.67.182.48,<->,120.235.249.7,1,56,0,0,1,56,1.072163000,0.0000
127.203.163.101,<->,92.27.219.190,0,0,1,399,1,399,1.072030000,0.0000
138.127.225.122,<->,33.233.141.112,0,0,1,73,1,73,1.071552000,0.0000
21.15.226.126,<->,20.193.56.48,0,0,1,82,1,82,1.071182000,0.0000
136.25.188.42,<->,111.151.107.247,1,149,0,0,1,149,1.070962000,0.0000
111.151.107.247,<->,8.176.8.180,0,0,1,111,1,111,1.070572000,0.0000
80.40.45.109,<->,0.41.236.81,1,100,0,0,1,100,1.070267000,0.0000
144.75.218.235,<->,95.244.145.61,1,185,0,0,1,185,1.069904000,0.0000
144.122.240.201,<->,144.108.64.184,1,65,0,0,1,65,1.068099000,0.0000
145.252.127.155,<->,132.43.156.54,1,802,0,0,1,802,1.067749000,0.0000
138.127.225.120,<->,33.233.141.94,0,0,1,254,1,254,1.067274000,0.0000
129.236.100.69,<->,129.224.112.252,0,0,1,74,1,74,1.067096000,0.0000
132.168.196.95,<->,40.114.68.23,1,71,0,0,1,71,1.066403000,0.0000
207.101.151.225,<->,39.141.13.87,0,0,1,68,1,68,1.066207000,0.0000
121.159.234.165,<->,92.27.219.42,0,0,1,52,1,52,1.065644000,0.0000
192.65.58.210,<->,105.170.238.230,1,130,0,0,1,130,1.065094000,0.0000
138.31.199.102,<->,53.162.162.35,1,74,0,0,1,74,1.064381000,0.0000
122.126.214.15,<->,80.41.8.174,0,0,1,51,1,51,1.061221000,0.0000
129.236.100.86,<->,129.224.112.252,0,0,1,78,1,78,1.060469000,0.0000
143.251.116.55,<->,39.14.29.45,0,0,1,87,1,87,1.060079000,0.0000
148.155.129.25,<->,111.20.168.215,0,0,1,165,1,165,1.059385000,0.0000
29.211.214.82,<->,8.240.120.169,1,85,0,0,1,85,1.058848000,0.0000
218.4.180.238,<->,144.76.46.38,1,128,0,0,1,128,1.057766000,0.0000
101.124.237.218,<->,79.132.31.6,1,79,0,0,1,79,1.056674000,0.0000
246.254.97.149,<->,8.33.227.9,1,93,0,0,1,93,1.055938000,0.0000
138.127.224.139,<->,109.222.238.0,0,0,1,218,1,218,1.055482000,0.0000
192.228.30.193,<->,8.176.8.237,0,0,1,111,1,111,1.055389000,0.0000
124.137.212.241,<->,39.15.250.7,0,0,1,70,1,70,1.054625000,0.0000
129.224.112.252,<->,92.160.14.119,1,77,0,0,1,77,1.053861000,0.0000
130.34.187.113,<->,20.32.37.250,0,0,1,80,1,80,1.053428000,0.0000
126.210.84.155,<->,39.57.19.30,0,0,1,80,1,80,1.053188000,0.0000
159.50.145.49,<->,89.183.104.177,0,0,1,101,1,101,1.052901000,0.0000
122.252.94.13,<->,20.242.117.110,0,0,1,75,1,75,1.051947000,0.0000
138.127.225.223,<->,111.20.168.215,0,0,1,236,1,236,1.051806000,0.0000
102.50.154.84,<->,27.15.128.177,1,321,0,0,1,321,1.050472000,0.0000
148.91.248.5,<->,111.147.92.83,0,0,1,52,1,52,1.050321000,0.0000
144.75.218.233,<->,138.127.225.49,1,365,0,0,1,365,1.050244000,0.0000
73.70.158.157,<->,20.42.38.105,0,0,1,130,1,130,1.050047000,0.0000
124.17.249.27,<->,20.17.136.36,0,0,1,74,1,74,1.049878000,0.0000
230.126.147.103,<->,8.238.93.151,0,0,1,133,1,133,1.049697000,0.0000
201.194.125.234,<->,20.94.75.215,0,0,1,52,1,52,1.049555000,0.0000
132.51.6.188,<->,121.232.73.135,1,71,0,0,1,71,1.049465000,0.0000
111.151.107.247,<->,8.176.8.237,0,0,1,126,1,126,1.049151000,0.0000
202.163.175.199,<->,20.194.30.147,0,0,1,133,1,133,1.048559000,0.0000
217.11.189.9,<->,109.222.237.159,0,0,1,446,1,446,1.048409000,0.0000
132.249.70.213,<->,111.27.182.215,1,117,0,0,1,117,1.048170000,0.0000
249.127.47.127,<->,80.42.162.159,0,0,1,138,1,138,1.047595000,0.0000
246.253.253.208,<->,196.22.168.122,1,125,0,0,1,125,1.047447000,0.0000
203.48.230.0,<->,20.202.16.220,0,0,1,74,1,74,1.046453000,0.0000
205.121.92.104,<->,39.145.180.229,0,0,1,70,1,70,1.046226000,0.0000
123.187.46.131,<->,92.27.219.207,0,0,1,52,1,52,1.045909000,0.0000
247.136.192.204,<->,134.53.44.185,1,52,0,0,1,52,1.045906000,0.0000
89.183.104.251,<->,75.95.64.72,1,52,0,0,1,52,1.045630000,0.0000
192.67.179.212,<->,118.71.90.92,1,331,0,0,1,331,1.045282000,0.0000
122.2.181.221,<->,89.183.104.146,0,0,1,351,1,351,1.045192000,0.0000
115.111.170.178,<->,80.42.186.32,0,0,1,113,1,113,1.045025000,0.0000
138.127.225.129,<->,33.233.141.116,0,0,1,241,1,241,1.044953000,0.0000
97.168.93.219,<->,30.214.60.217,1,68,0,0,1,68,1.044430000,0.0000
194.158.215.119,<->,89.183.104.249,0,0,1,148,1,148,1.044030000,0.0000
138.127.224.152,<->,101.224.89.244,0,0,1,295,1,295,1.043725000,0.0000
158.23.79.221,<->,80.40.24.193,0,0,1,317,1,317,1.043543000,0.0000
138.127.225.253,<->,101.224.89.244,0,0,1,251,1,251,1.042118000,0.0000
134.160.225.14,<->,89.183.104.159,0,0,1,263,1,263,1.041666000,0.0000
64.253.117.102,<->,39.32.193.211,0,0,1,52,1,52,1.041282000,0.0000
89.183.104.236,<->,29.163.12.197,1,52,0,0,1,52,1.040927000,0.0000
138.127.225.156,<->,101.224.89.251,0,0,1,338,1,338,1.040798000,0.0000
109.1.16.196,<->,27.188.163.162,1,445,0,0,1,445,1.040561000,0.0000
129.224.112.252,<->,27.127.251.103,1,78,0,0,1,78,1.040095000,0.0000
92.27.219.49,<->,33.215.68.189,1,52,0,0,1,52,1.039698000,0.0000
118.228.81.59,<->,102.231.178.198,0,0,1,141,1,141,1.039285000,0.0000
159.123.6.141,<->,144.81.142.50,1,154,0,0,1,154,1.038920000,0.0000
21.15.226.126,<->,20.193.56.216,0,0,1,82,1,82,1.038874000,0.0000
138.127.224.45,<->,33.233.141.228,0,0,1,242,1,242,1.038737000,0.0000
138.127.224.44,<->,33.233.141.27,0,0,1,234,1,234,1.037931000,0.0000
138.127.224.138,<->,111.20.168.58,0,0,1,267,1,267,1.037811000,0.0000
139.163.161.166,<->,133.178.226.255,0,0,1,90,1,90,1.037587000,0.0000
67.236.49.213,<->,34.217.112.95,0,0,1,52,1,52,1.037425000,0.0000
144.75.218.237,<->,53.146.81.135,1,227,0,0,1,227,1.037063000,0.0000
108.137.47.66,<->,89.183.104.175,0,0,1,52,1,52,1.036798000,0.0000
247.136.216.62,<->,117.87.250.107,1,52,0,0,1,52,1.036467000,0.0000
198.228.83.211,<->,102.51.75.158,0,0,1,135,1,135,1.035676000,0.0000
104.154.171.250,<->,20.117.32.68,0,0,1,70,1,70,1.035581000,0.0000
192.64.247.91,<->,122.114.203.218,1,52,0,0,1,52,1.034911000,0.0000
21.15.226.126,<->,20.193.56.196,0,0,1,82,1,82,1.034481000,0.0000
138.127.224.44,<->,33.233.141.20,0,0,1,234,1,234,1.033945000,0.0000
159.69.187.24,<->,144.108.64.184,1,67,0,0,1,67,1.033008000,0.0000
138.127.224.44,<->,101.224.89.150,0,0,1,234,1,234,1.033005000,0.0000
198.145.77.70,<->,111.146.137.31,0,0,1,136,1,136,1.032939000,0.0000
129.236.100.43,<->,129.224.112.252,0,0,1,73,1,73,1.032768000,0.0000
109.222.253.202,<->,48.175.134.33,1,74,0,0,1,74,1.032111000,0.0000
138.127.224.44,<->,111.20.168.21,0,0,1,234,1,234,1.032050000,0.0000
127.233.67.123,<->,109.222.251.204,0,0,1,69,1,69,1.031925000,0.0000
97.68.226.205,<->,91.100.190.227,1,70,0,0,1,70,1.031349000,0.0000
118.228.5.130,<->,99.75.168.154,0,0,1,325,1,325,1.030639000,0.0000
118.154.0.217,<->,98.128.251.58,0,0,1,99,1,99,1.030155000,0.0000
138.127.224.254,<->,101.224.89.171,0,0,1,255,1,255,1.029464000,0.0000
128.198.71.156,<->,92.27.27.179,0,0,1,367,1,367,1.028614000,0.0000
198.102.18.25,<->,99.72.107.172,0,0,1,136,1,136,1.028519000,0.0000
138.127.225.156,<->,33.233.141.107,0,0,1,284,1,284,1.028042000,0.0000
100.208.47.97,<->,78.54.198.249,1,99,0,0,1,99,1.027526000,0.0000
21.15.226.126,<->,20.193.57.252,0,0,1,82,1,82,1.027312000,0.0000
120.83.106.49,<->,92.27.219.146,0,0,1,324,1,324,1.025237000,0.0000
80.40.232.211,<->,33.219.133.71,1,135,0,0,1,135,1.025059000,0.0000
109.103.233.173,<->,92.27.219.171,0,0,1,78,1,78,1.024720000,0.0000
159.137.140.219,<->,100.230.7.102,1,50,0,0,1,50,1.024112000,0.0000
215.158.103.219,<->,138.127.224.55,1,250,0,0,1,250,1.023800000,0.0000
146.224.248.193,<->,20.158.8.215,0,0,1,78,1,78,1.023759000,0.0000
236.227.128.37,<->,144.75.218.242,0,0,1,116,1,116,1.023271000,0.0000
89.183.104.146,<->,33.58.232.13,1,351,0,0,1,351,1.022788000,0.0000
221.196.123.233,<->,111.147.240.74,0,0,1,97,1,97,1.022174000,0.0000
89.183.104.157,<->,6.85.11.53,1,101,0,0,1,101,1.021783000,0.0000
192.67.128.244,<->,119.87.77.32,1,149,0,0,1,149,1.021660000,0.0000
138.127.224.63,<->,33.233.141.101,0,0,1,283,1,283,1.021532000,0.0000
149.200.188.84,<->,80.41.16.28,0,0,1,52,1,52,1.021378000,0.0000
126.237.211.201,<->,92.27.219.207,0,0,1,263,1,263,1.021166000,0.0000
213.38.142.227,<->,91.231.135.160,1,101,0,0,1,101,1.019855000,0.0000
213.154.101.1,<->,137.81.65.54,0,0,1,81,1,81,1.019508000,0.0000
198.37.0.165,<->,89.183.104.159,0,0,1,263,1,263,1.019141000,0.0000
92.27.27.156,<->,42.27.224.194,1,94,0,0,1,94,1.019038000,0.0000
138.127.225.87,<->,33.233.141.117,0,0,1,251,1,251,1.018802000,0.0000
129.254.99.105,<->,129.224.112.252,0,0,1,68,1,68,1.018224000,0.0000
114.243.231.163,<->,92.27.219.133,0,0,1,135,1,135,1.017857000,0.0000
138.127.225.202,<->,33.233.141.101,0,0,1,277,1,277,1.017467000,0.0000
107.28.208.38,<->,92.27.219.228,0,0,1,80,1,80,1.017241000,0.0000
21.15.226.126,<->,20.193.57.234,0,0,1,82,1,82,1.017236000,0.0000
144.75.218.233,<->,138.127.224.188,1,365,0,0,1,365,1.016734000,0.0000
144.75.218.242,<->,138.127.224.83,1,253,0,0,1,253,1.016375000,0.0000
242.22.195.239,<->,144.75.218.237,0,0,1,146,1,146,1.015958000,0.0000
192.171.13.80,<->,8.252.222.104,0,0,1,155,1,155,1.015590000,0.0000
192.171.13.190,<->,8.176.8.192,0,0,1,149,1,149,1.014645000,0.0000
73.94.136.231,<->,20.169.213.25,0,0,1,52,1,52,1.014450000,0.0000
145.11.5.168,<->,136.25.188.105,0,0,1,175,1,175,1.014072000,0.0000
159.69.187.44,<->,144.108.64.184,1,73,0,0,1,73,1.014055000,0.0000
243.117.125.27,<->,129.224.112.252,0,0,1,71,1,71,1.013990000,0.0000
144.75.218.246,<->,129.227.132.30,1,76,0,0,1,76,1.013181000,0.0000
192.171.13.190,<->,8.176.8.202,0,0,1,170,1,170,1.012993000,0.0000
133.85.23.86,<->,92.27.219.128,0,0,1,84,1,84,1.012442000,0.0000
152.12.176.111,<->,92.27.219.132,0,0,1,213,1,213,1.011685000,0.0000
129.224.112.252,<->,109.212.125.157,1,77,0,0,1,77,1.011638000,0.0000
192.171.13.33,<->,8.252.222.56,0,0,1,95,1,95,1.010839000,0.0000
147.61.24.130,<->,129.224.112.252,0,0,1,74,1,74,1.009782000,0.0000
136.25.188.72,<->,111.15.98.226,1,1064,0,0,1,1064,1.009122000,0.0000
92.27.219.180,<->,78.53.131.215,1,69,0,0,1,69,1.008458000,0.0000
215.158.103.206,<->,8.220.7.31,1,150,0,0,1,150,1.008446000,0.0000
111.151.107.247,<->,8.176.8.192,0,0,1,155,1,155,1.008296000,0.0000
132.107.75.195,<->,97.126.26.71,0,0,1,377,1,377,1.007969000,0.0000
220.55.101.99,<->,140.142.131.2,1,76,0,0,1,76,1.007566000,0.0000
76.130.139.161,<->,34.192.17.207,0,0,1,52,1,52,1.007392000,0.0000
139.253.132.92,<->,20.163.70.221,0,0,1,135,1,135,1.006645000,0.0000
192.67.134.112,<->,63.3.46.143,1,65,0,0,1,65,1.006499000,0.0000
247.136.245.5,<->,87.52.69.178,1,99,0,0,1,99,1.006150000,0.0000
144.75.218.237,<->,138.127.231.255,1,268,0,0,1,268,1.005501000,0.0000
138.127.224.104,<->,111.20.168.1,0,0,1,286,1,286,1.005396000,0.0000
148.155.129.25,<->,33.233.141.77,0,0,1,173,1,173,1.005232000,0.0000
210.150.233.86,<->,50.224.76.131,0,0,1,79,1,79,1.004331000,0.0000
139.241.75.26,<->,29.211.214.82,0,0,1,90,1,90,1.003847000,0.0000
102.232.51.191,<->,97.126.3.177,0,0,1,67,1,67,1.003618000,0.0000
57.107.97.185,<->,22.59.13.208,0,0,1,64,1,64,1.003507000,0.0000
89.183.104.246,<->,51.249.86.31,1,321,0,0,1,321,1.002487000,0.0000
138.127.224.44,<->,33.233.141.66,0,0,1,234,1,234,1.002447000,0.0000
115.211.211.9,<->,89.183.104.236,0,0,1,147,1,147,1.001782000,0.0000
146.226.226.226,<->,144.75.218.241,0,0,1,85,1,85,1.001582000,0.0000
247.136.137.133,<->,122.100.180.56,1,62,0,0,1,62,1.001528000,0.0000
131.144.248.194,<->,129.224.112.252,0,0,1,75,1,75,1.000952000,0.0000
192.64.217.166,<->,93.162.13.46,1,52,0,0,1,52,1.000709000,0.0000
230.84.236.133,<->,92.170.252.76,0,0,1,133,1,133,1.000165000,0.0000
120.155.84.97,<->,33.233.141.227,0,0,1,103,1,103,0.999417000,0.0000
144.75.218.237,<->,129.35.251.34,1,147,0,0,1,147,0.998722000,0.0000
144.87.235.187,<->,138.127.224.104,1,293,0,0,1,293,0.998111000,0.0000
192.64.217.166,<->,134.227.83.143,1,52,0,0,1,52,0.998083000,0.0000
132.249.70.46,<->,110.37.156.14,1,52,0,0,1,52,0.998023000,0.0000
112.151.63.215,<->,92.27.219.54,0,0,1,52,1,52,0.997711000,0.0000
139.114.178.207,<->,100.92.48.99,0,0,1,77,1,77,0.997676000,0.0000
94.24.111.59,<->,92.27.219.250,0,0,1,62,1,62,0.997401000,0.0000
74.17.219.15,<->,66.11.15.168,0,0,1,243,1,243,0.996853000,0.0000
134.92.64.170,<->,20.163.197.248,0,0,1,75,1,75,0.996675000,0.0000
21.15.226.126,<->,20.193.57.139,0,0,1,82,1,82,0.996369000,0.0000
138.127.225.122,<->,33.233.141.77,0,0,1,73,1,73,0.996159000,0.0000
138.127.224.121,<->,33.233.141.3,0,0,1,217,1,217,0.995917000,0.0000
132.217.25.155,<->,100.197.98.222,0,0,1,89,1,89,0.994547000,0.0000
21.15.226.126,<->,20.193.57.129,0,0,1,82,1,82,0.993973000,0.0000
53.187.62.98,<->,39.15.169.14,0,0,1,85,1,85,0.993474000,0.0000
193.46.99.244,<->,109.1.51.39,0,0,1,129,1,129,0.992555000,0.0000
21.15.226.126,<->,20.193.57.63,0,0,1,82,1,82,0.992517000,0.0000
108.32.75.237,<->,92.27.219.56,0,0,1,340,1,340,0.992343000,0.0000
247.136.244.38,<->,27.14.102.33,1,181,0,0,1,181,0.992292000,0.0000
192.67.181.112,<->,42.80.251.187,1,50,0,0,1,50,0.991268000,0.0000
104.242.139.65,<->,39.219.79.13,0,0,1,84,1,84,0.991151000,0.0000
109.1.16.205,<->,27.188.163.162,1,445,0,0,1,445,0.991126000,0.0000
148.155.131.164,<->,101.224.89.214,0,0,1,172,1,172,0.990678000,0.0000
138.127.224.225,<->,101.224.89.157,0,0,1,233,1,233,0.990495000,0.0000
144.75.218.233,<->,138.127.224.78,1,365,0,0,1,365,0.990154000,0.0000
144.87.235.187,<->,138.127.225.111,1,261,0,0,1,261,0.989567000,0.0000
21.15.226.126,<->,20.193.57.23,0,0,1,82,1,82,0.988615000,0.0000
145.242.126.212,<->,126.151.110.115,1,78,0,0,1,78,0.988236000,0.0000
20.54.182.237,<->,4.123.179.128,1,52,0,0,1,52,0.987885000,0.0000
92.27.219.34,<->,42.204.7.69,1,320,0,0,1,320,0.987774000,0.0000
21.15.226.126,<->,20.193.57.60,0,0,1,82,1,82,0.987559000,0.0000
193.87.147.104,<->,89.183.104.146,0,0,1,322,1,322,0.987285000,0.0000
92.170.27.61,<->,64.144.33.216,1,130,0,0,1,130,0.987041000,0.0000
159.137.138.173,<->,144.76.43.242,1,84,0,0,1,84,0.986487000,0.0000
109.222.246.3,<->,43.6.133.220,1,71,0,0,1,71,0.986457000,0.0000
215.158.238.137,<->,80.56.76.30,1,127,0,0,1,127,0.986455000,0.0000
89.183.104.231,<->,78.49.139.79,1,52,0,0,1,52,0.986413000,0.0000
126.204.106.102,<->,89.183.104.188,0,0,1,52,1,52,0.985981000,0.0000
197.158.73.222,<->,20.59.67.2,0,0,1,75,1,75,0.985679000,0.0000
144.75.218.241,<->,139.252.1.219,1,87,0,0,1,87,0.985387000,0.0000
144.76.42.205,<->,144.64.138.25,0,0,1,76,1,76,0.984986000,0.0000
206.16.207.74,<->,192.67.162.92,0,0,1,52,1,52,0.984793000,0.0000
107.245.169.4,<->,97.126.116.15,0,0,1,73,1,73,0.984268000,0.0000
120.187.147.183,<->,6.75.156.217,0,0,1,133,1,133,0.984220000,0.0000
223.137.189.161,<->,39.166.59.155,0,0,1,78,1,78,0.983858000,0.0000
159.69.187.1,<->,144.108.80.163,1,74,0,0,1,74,0.983277000,0.0000
125.23.154.213,<->,109.1.16.21,0,0,1,50,1,50,0.983179000,0.0000
192.171.13.190,<->,8.176.8.69,0,0,1,114,1,114,0.982715000,0.0000
124.69.199.94,<->,92.27.219.49,0,0,1,62,1,62,0.982147000,0.0000
246.253.248.211,<->,53.164.37.149,1,87,0,0,1,87,0.981965000,0.0000
144.75.218.235,<->,97.110.148.11,1,84,0,0,1,84,0.981705000,0.0000
92.27.219.237,<->,33.36.35.205,1,344,0,0,1,344,0.981416000,0.0000
144.75.218.241,<->,138.127.230.170,1,254,0,0,1,254,0.981339000,0.0000
130.143.130.253,<->,39.133.32.7,0,0,1,70,1,70,0.981142000,0.0000
193.46.99.113,<->,111.146.212.68,0,0,1,90,1,90,0.980478000,0.0000
136.181.47.74,<->,0.197.90.160,1,135,0,0,1,135,0.980098000,0.0000
195.12.132.138,<->,20.6.146.190,0,0,1,68,1,68,0.978445000,0.0000
148.241.122.20,<->,89.183.104.172,0,0,1,52,1,52,0.978200000,0.0000
192.64.250.118,<->,122.126.97.27,1,50,0,0,1,50,0.976665000,0.0000
105.102.103.207,<->,100.95.247.23,0,0,1,135,1,135,0.976649000,0.0000
120.155.84.160,<->,109.222.236.213,0,0,1,119,1,119,0.976224000,0.0000
105.201.216.195,<->,100.94.40.183,0,0,1,330,1,330,0.975895000,0.0000
117.234.36.52,<->,92.27.219.212,0,0,1,52,1,52,0.975718000,0.0000
21.15.226.126,<->,20.193.57.33,0,0,1,82,1,82,0.975630000,0.0000
101.70.119.147,<->,66.68.27.29,1,73,0,0,1,73,0.975483000,0.0000
38.21.156.204,<->,20.232.228.23,0,0,1,82,1,82,0.972155000,0.0000
107.255.248.47,<->,97.168.92.35,0,0,1,74,1,74,0.971911000,0.0000
144.75.218.233,<->,120.87.222.172,1,133,0,0,1,133,0.971836000,0.0000
207.227.57.137,<->,39.34.233.92,0,0,1,78,1,78,0.971321000,0.0000
199.61.66.134,<->,20.82.99.93,0,0,1,72,1,72,0.971128000,0.0000
54.58.207.20,<->,48.53.68.163,0,0,1,136,1,136,0.970277000,0.0000
144.75.218.233,<->,138.127.224.132,1,249,0,0,1,249,0.970233000,0.0000
129.254.99.204,<->,129.224.112.252,0,0,1,64,1,64,0.970231000,0.0000
120.95.224.25,<->,92.27.219.166,0,0,1,135,1,135,0.970185000,0.0000
89.183.104.145,<->,36.120.170.69,1,349,0,0,1,349,0.968783000,0.0000
122.117.249.126,<->,92.27.219.237,0,0,1,330,1,330,0.968781000,0.0000
89.183.104.137,<->,27.50.133.40,1,52,0,0,1,52,0.968327000,0.0000
193.46.99.163,<->,192.67.183.76,0,0,1,300,1,300,0.967225000,0.0000
98.129.96.103,<->,33.156.177.142,1,255,0,0,1,255,0.967063000,0.0000
192.64.194.95,<->,148.145.88.210,1,133,0,0,1,133,0.966456000,0.0000
198.107.161.237,<->,102.51.181.240,0,0,1,136,1,136,0.965596000,0.0000
145.62.238.247,<->,144.75.218.233,0,0,1,112,1,112,0.965575000,0.0000
80.56.78.128,<->,8.188.179.8,1,98,0,0,1,98,0.965543000,0.0000
92.27.219.161,<->,77.147.19.155,1,135,0,0,1,135,0.964232000,0.0000
144.75.218.242,<->,141.192.67.251,1,144,0,0,1,144,0.964193000,0.0000
80.38.36.164,<->,53.233.145.111,1,75,0,0,1,75,0.963831000,0.0000
89.183.104.166,<->,78.44.34.243,1,62,0,0,1,62,0.963677000,0.0000
144.76.42.211,<->,144.64.138.25,0,0,1,76,1,76,0.962941000,0.0000
80.38.36.156,<->,53.249.181.146,1,75,0,0,1,75,0.962927000,0.0000
104.217.65.191,<->,80.41.42.158,0,0,1,52,1,52,0.961826000,0.0000
145.208.190.219,<->,66.87.55.243,1,130,0,0,1,130,0.961633000,0.0000
159.67.88.187,<->,89.183.104.249,0,0,1,323,1,323,0.961362000,0.0000
118.67.109.18,<->,92.27.219.234,0,0,1,99,1,99,0.961222000,0.0000
98.236.193.132,<->,97.242.126.200,1,88,0,0,1,88,0.959972000,0.0000
246.253.248.211,<->,53.212.138.208,1,86,0,0,1,86,0.959596000,0.0000
132.208.68.222,<->,132.168.197.226,0,0,1,729,1,729,0.959009000,0.0000
121.85.84.62,<->,39.13.192.98,0,0,1,94,1,94,0.958410000,0.0000
100.214.121.114,<->,75.70.20.154,1,77,0,0,1,77,0.958030000,0.0000
144.75.218.237,<->,138.127.225.234,1,281,0,0,1,281,0.957122000,0.0000
144.75.218.235,<->,98.184.9.185,1,97,0,0,1,97,0.956353000,0.0000
118.42.3.133,<->,99.73.150.56,0,0,1,50,1,50,0.955985000,0.0000
144.75.218.233,<->,138.127.225.46,1,329,0,0,1,329,0.954735000,0.0000
143.89.238.210,<->,92.27.219.237,0,0,1,351,1,351,0.953446000,0.0000
20.13.109.166,<->,0.200.50.50,1,60,0,0,1,60,0.953178000,0.0000
124.64.83.37,<->,89.183.104.164,0,0,1,369,1,369,0.952467000,0.0000
159.58.54.98,<->,89.183.104.135,0,0,1,50,1,50,0.951904000,0.0000
134.160.147.115,<->,92.27.219.230,0,0,1,52,1,52,0.951127000,0.0000
144.75.218.246,<->,138.127.225.188,1,352,0,0,1,352,0.951022000,0.0000
97.168.64.50,<->,40.153.136.228,1,130,0,0,1,130,0.950961000,0.0000
21.15.226.126,<->,20.193.58.37,0,0,1,82,1,82,0.950959000,0.0000
101.106.122.69,<->,92.27.27.179,0,0,1,136,1,136,0.950509000,0.0000
215.158.103.206,<->,138.127.231.113,1,263,0,0,1,263,0.949718000,0.0000
112.38.250.104,<->,92.27.219.187,0,0,1,52,1,52,0.949431000,0.0000
129.224.112.252,<->,97.242.126.176,1,73,0,0,1,73,0.948988000,0.0000
123.165.45.181,<->,20.208.96.223,0,0,1,72,1,72,0.948767000,0.0000
133.178.227.10,<->,131.1.235.233,1,85,0,0,1,85,0.948500000,0.0000
192.67.129.253,<->,81.108.138.135,1,72,0,0,1,72,0.947936000,0.0000
92.27.27.180,<->,59.146.67.216,1,81,0,0,1,81,0.947925000,0.0000
215.158.30.23,<->,29.211.214.254,0,0,1,92,1,92,0.946799000,0.0000
128.243.145.254,<->,80.38.4.56,0,0,1,945,1,945,0.946562000,0.0000
192.171.13.190,<->,8.252.222.246,0,0,1,159,1,159,0.945940000,0.0000
196.24.193.173,<->,102.51.41.126,0,0,1,135,1,135,0.945680000,0.0000
149.182.161.13,<->,20.79.105.212,0,0,1,70,1,70,0.945624000,0.0000
127.25.104.19,<->,20.111.132.186,0,0,1,134,1,134,0.944885000,0.0000
247.136.136.51,<->,40.192.85.12,1,52,0,0,1,52,0.944859000,0.0000
123.154.23.86,<->,92.27.219.231,0,0,1,370,1,370,0.944776000,0.0000
133.178.226.181,<->,91.247.40.69,1,1064,0,0,1,1064,0.944636000,0.0000
144.69.82.139,<->,99.168.30.209,1,73,0,0,1,73,0.944301000,0.0000
215.158.239.74,<->,122.158.51.62,1,83,0,0,1,83,0.943834000,0.0000
21.15.226.126,<->,20.193.58.44,0,0,1,82,1,82,0.942772000,0.0000
136.25.189.86,<->,133.73.8.230,1,83,0,0,1,83,0.942507000,0.0000
246.254.97.149,<->,131.233.225.105,1,88,0,0,1,88,0.942326000,0.0000
206.147.242.252,<->,80.41.39.119,0,0,1,321,1,321,0.941940000,0.0000
241.228.109.55,<->,230.60.108.54,1,181,0,0,1,181,0.941845000,0.0000
131.24.254.37,<->,39.167.31.1,0,0,1,91,1,91,0.941498000,0.0000
92.181.50.157,<->,77.29.50.38,1,140,0,0,1,140,0.941226000,0.0000
144.122.240.207,<->,144.108.80.163,1,64,0,0,1,64,0.940883000,0.0000
21.15.226.126,<->,20.193.58.55,0,0,1,82,1,82,0.940315000,0.0000
144.75.218.241,<->,139.252.1.237,1,163,0,0,1,163,0.940086000,0.0000
195.5.67.184,<->,50.224.52.70,0,0,1,80,1,80,0.939206000,0.0000
197.33.188.100,<->,192.64.251.202,0,0,1,135,1,135,0.939155000,0.0000
149.111.213.145,<->,109.1.61.240,0,0,1,351,1,351,0.939032000,0.0000
247.136.188.124,<->,0.233.104.95,1,52,0,0,1,52,0.938956000,0.0000
192.67.167.244,<->,144.54.95.244,1,136,0,0,1,136,0.938745000,0.0000
64.151.30.204,<->,50.162.21.37,0,0,1,133,1,133,0.938350000,0.0000
132.43.156.54,<->,132.10.25.131,0,0,1,358,1,358,0.936609000,0.0000
203.212.95.67,<->,92.27.219.21,0,0,1,52,1,52,0.936256000,0.0000
143.252.64.235,<->,129.224.112.252,0,0,1,71,1,71,0.935974000,0.0000
144.75.218.246,<->,138.127.224.230,1,366,0,0,1,366,0.935474000,0.0000
80.42.168.43,<->,33.61.126.211,1,293,0,0,1,293,0.935053000,0.0000
132.168.199.163,<->,93.223.122.242,1,349,0,0,1,349,0.935012000,0.0000
144.75.218.235,<->,138.127.224.46,1,253,0,0,1,253,0.934764000,0.0000
144.75.218.242,<->,132.43.156.54,1,135,0,0,1,135,0.934557000,0.0000
198.39.23.16,<->,92.27.219.246,0,0,1,100,1,100,0.934274000,0.0000
246.253.253.79,<->,129.203.66.31,1,633,0,0,1,633,0.932174000,0.0000
215.158.103.219,<->,138.127.225.198,1,355,0,0,1,355,0.932119000,0.0000
21.15.226.126,<->,20.193.58.141,0,0,1,82,1,82,0.931819000,0.0000
144.75.218.237,<->,138.127.225.89,1,366,0,0,1,366,0.930323000,0.0000
146.188.219.80,<->,92.27.219.175,0,0,1,52,1,52,0.930250000,0.0000
144.75.218.241,<->,138.127.224.169,1,261,0,0,1,261,0.930210000,0.0000
144.75.218.242,<->,138.127.230.199,1,176,0,0,1,176,0.929846000,0.0000
75.36.65.235,<->,33.233.141.49,0,0,1,178,1,178,0.928963000,0.0000
122.142.5.111,<->,89.183.104.150,0,0,1,52,1,52,0.928273000,0.0000
192.171.13.190,<->,8.252.222.11,0,0,1,146,1,146,0.927780000,0.0000
144.76.42.201,<->,101.224.183.152,0,0,1,74,1,74,0.926753000,0.0000
145.110.55.59,<->,144.82.14.49,1,73,0,0,1,73,0.925886000,0.0000
109.222.214.116,<->,93.208.12.164,1,293,0,0,1,293,0.925588000,0.0000
111.150.207.83,<->,8.176.8.201,0,0,1,162,1,162,0.925537000,0.0000
215.158.103.206,<->,132.43.156.56,1,535,0,0,1,535,0.925206000,0.0000
144.75.218.233,<->,138.127.224.80,1,268,0,0,1,268,0.925114000,0.0000
126.219.197.183,<->,8.176.8.83,0,0,1,112,1,112,0.923794000,0.0000
159.194.91.13,<->,48.110.179.206,1,52,0,0,1,52,0.923789000,0.0000
144.75.218.242,<->,138.127.230.2,1,238,0,0,1,238,0.923256000,0.0000
109.222.255.59,<->,68.91.45.69,1,79,0,0,1,79,0.923231000,0.0000
144.75.218.242,<->,97.68.93.11,1,707,0,0,1,707,0.922535000,0.0000
101.70.119.102,<->,50.49.60.53,1,74,0,0,1,74,0.921928000,0.0000
144.75.218.235,<->,138.127.230.242,1,230,0,0,1,230,0.921438000,0.0000
196.233.128.246,<->,92.27.219.54,0,0,1,52,1,52,0.920237000,0.0000
230.87.31.198,<->,192.65.58.253,0,0,1,133,1,133,0.919357000,0.0000
247.136.251.232,<->,122.78.204.6,1,52,0,0,1,52,0.918842000,0.0000
20.198.105.222,<->,4.129.137.231,1,52,0,0,1,52,0.918663000,0.0000
114.228.208.175,<->,89.183.104.253,0,0,1,84,1,84,0.918537000,0.0000
215.158.103.206,<->,124.55.106.24,1,121,0,0,1,121,0.918502000,0.0000
119.186.32.127,<->,89.183.104.224,0,0,1,52,1,52,0.918353000,0.0000
112.90.30.190,<->,109.1.8.71,0,0,1,62,1,62,0.918143000,0.0000
141.92.221.59,<->,129.224.112.252,0,0,1,73,1,73,0.917984000,0.0000
109.222.199.132,<->,83.96.53.127,1,80,0,0,1,80,0.917886000,0.0000
129.224.112.252,<->,114.186.133.56,1,85,0,0,1,85,0.916639000,0.0000
247.136.165.38,<->,119.77.92.156,1,138,0,0,1,138,0.916031000,0.0000
38.227.130.5,<->,20.135.180.25,0,0,1,68,1,68,0.913118000,0.0000
144.75.218.233,<->,138.127.225.255,1,553,0,0,1,553,0.912574000,0.0000
111.151.107.247,<->,8.176.8.195,0,0,1,109,1,109,0.910484000,0.0000
144.122.240.239,<->,144.108.64.179,1,71,0,0,1,71,0.909595000,0.0000
33.122.93.211,<->,20.4.216.75,0,0,1,70,1,70,0.909421000,0.0000
21.15.226.126,<->,20.193.59.231,0,0,1,82,1,82,0.907632000,0.0000
100.93.121.49,<->,27.2.218.0,1,141,0,0,1,141,0.907570000,0.0000
109.14.213.84,<->,80.56.78.208,0,0,1,76,1,76,0.906991000,0.0000
129.236.115.172,<->,98.236.245.223,0,0,1,81,1,81,0.906042000,0.0000
192.64.114.92,<->,119.33.213.28,1,74,0,0,1,74,0.905553000,0.0000
21.15.226.126,<->,20.193.59.225,0,0,1,82,1,82,0.904832000,0.0000
144.75.218.242,<->,138.127.225.198,1,289,0,0,1,289,0.904043000,0.0000
144.76.46.38,<->,100.93.18.30,0,0,1,130,1,130,0.903496000,0.0000
80.41.21.72,<->,66.245.95.147,1,135,0,0,1,135,0.903421000,0.0000
121.235.141.249,<->,80.42.173.192,0,0,1,141,1,141,0.900482000,0.0000
109.1.16.221,<->,27.188.163.162,1,444,0,0,1,444,0.899235000,0.0000
222.76.103.168,<->,66.26.4.171,1,73,0,0,1,73,0.898710000,0.0000
221.95.55.203,<->,77.16.192.127,1,94,0,0,1,94,0.898429000,0.0000
215.158.103.206,<->,119.159.23.44,1,83,0,0,1,83,0.897983000,0.0000
106.248.210.12,<->,101.224.186.79,0,0,1,57,1,57,0.896800000,0.0000
223.138.247.86,<->,92.27.219.165,0,0,1,52,1,52,0.896663000,0.0000
144.75.218.242,<->,138.57.179.198,1,102,0,0,1,102,0.895987000,0.0000
215.158.239.103,<->,8.50.118.106,1,111,0,0,1,111,0.895749000,0.0000
144.93.134.237,<->,19.249.77.2,1,76,0,0,1,76,0.894619000,0.0000
109.222.243.255,<->,104.77.185.182,1,97,0,0,1,97,0.894460000,0.0000
103.56.162.76,<->,92.27.219.175,0,0,1,52,1,52,0.894282000,0.0000
74.17.214.117,<->,66.11.15.28,0,0,1,130,1,130,0.894141000,0.0000
21.15.226.126,<->,20.193.59.219,0,0,1,82,1,82,0.893506000,0.0000
192.67.138.66,<->,122.111.197.164,1,209,0,0,1,209,0.892620000,0.0000
131.144.248.196,<->,129.224.112.252,0,0,1,79,1,79,0.891865000,0.0000
99.160.127.69,<->,92.27.219.138,0,0,1,330,1,330,0.891294000,0.0000
144.75.218.242,<->,8.4.159.141,1,130,0,0,1,130,0.890621000,0.0000
159.69.187.8,<->,144.108.64.179,1,72,0,0,1,72,0.889592000,0.0000
215.158.239.74,<->,133.73.8.230,1,84,0,0,1,84,0.889573000,0.0000
137.194.170.5,<->,129.78.116.244,0,0,1,84,1,84,0.889505000,0.0000
145.242.126.212,<->,129.34.149.207,1,84,0,0,1,84,0.888094000,0.0000
212.118.0.79,<->,144.75.218.235,0,0,1,91,1,91,0.887099000,0.0000
111.73.148.160,<->,80.40.57.96,0,0,1,213,1,213,0.887030000,0.0000
120.178.130.146,<->,20.212.190.189,0,0,1,75,1,75,0.886787000,0.0000
53.250.138.165,<->,39.15.169.14,0,0,1,86,1,86,0.886182000,0.0000
130.196.240.215,<->,89.183.104.135,0,0,1,52,1,52,0.885049000,0.0000
144.75.218.241,<->,66.90.38.226,1,159,0,0,1,159,0.884526000,0.0000
247.136.150.11,<->,88.13.7.38,1,55,0,0,1,55,0.884247000,0.0000
145.129.253.82,<->,39.35.177.63,0,0,1,86,1,86,0.883979000,0.0000
192.64.217.166,<->,125.16.223.239,1,52,0,0,1,52,0.883752000,0.0000
144.75.218.235,<->,138.127.225.146,1,276,0,0,1,276,0.883449000,0.0000
215.158.132.144,<->,6.228.6.58,0,0,1,102,1,102,0.883296000,0.0000
144.75.218.235,<->,139.252.1.253,1,148,0,0,1,148,0.883014000,0.0000
21.15.226.126,<->,20.193.59.83,0,0,1,82,1,82,0.882785000,0.0000
248.225.26.243,<->,100.185.121.91,1,236,0,0,1,236,0.882702000,0.0000
144.75.218.241,<->,6.73.13.34,1,288,0,0,1,288,0.882326000,0.0000
224.213.241.201,<->,144.75.218.242,0,0,1,336,1,336,0.881757000,0.0000
144.69.82.139,<->,33.98.46.95,1,73,0,0,1,73,0.881623000,0.0000
82.246.87.234,<->,20.237.75.42,0,0,1,91,1,91,0.881303000,0.0000
109.1.17.6,<->,27.188.163.162,1,446,0,0,1,446,0.881130000,0.0000
136.25.188.105,<->,98.114.18.76,1,140,0,0,1,140,0.881104000,0.0000
251.122.146.57,<->,136.41.13.4,0,0,1,116,1,116,0.880813000,0.0000
148.215.222.173,<->,136.25.188.105,0,0,1,143,1,143,0.880573000,0.0000
56.20.54.141,<->,20.246.199.217,0,0,1,91,1,91,0.880440000,0.0000
144.75.218.241,<->,97.94.119.43,1,72,0,0,1,72,0.879354000,0.0000
133.178.227.214,<->,89.77.198.191,1,156,0,0,1,156,0.879326000,0.0000
144.76.46.38,<->,100.92.64.28,0,0,1,168,1,168,0.879237000,0.0000
207.204.114.71,<->,102.51.41.126,0,0,1,135,1,135,0.878387000,0.0000
144.86.144.4,<->,4.187.50.170,1,80,0,0,1,80,0.877823000,0.0000
215.158.103.219,<->,92.57.203.43,1,154,0,0,1,154,0.877656000,0.0000
110.65.132.226,<->,92.27.219.189,0,0,1,325,1,325,0.877621000,0.0000
21.15.226.126,<->,20.193.59.179,0,0,1,82,1,82,0.877525000,0.0000
109.222.250.222,<->,18.69.22.36,1,74,0,0,1,74,0.876525000,0.0000
130.13.216.49,<->,39.18.45.147,0,0,1,80,1,80,0.876274000,0.0000
138.127.229.13,<->,133.32.2.38,0,0,1,240,1,240,0.875253000,0.0000
133.171.115.67,<->,131.133.154.154,1,84,0,0,1,84,0.875098000,0.0000
210.158.44.231,<->,109.119.182.216,1,119,0,0,1,119,0.873868000,0.0000
195.59.215.206,<->,100.93.81.9,0,0,1,130,1,130,0.873765000,0.0000
110.5.186.21,<->,109.222.218.217,0,0,1,80,1,80,0.873645000,0.0000
89.183.104.243,<->,18.203.228.30,1,1456,0,0,1,1456,0.872349000,0.0000
117.220.20.168,<->,108.134.118.71,0,0,1,60,1,60,0.871557000,0.0000
246.253.248.211,<->,53.150.231.79,1,89,0,0,1,89,0.871457000,0.0000
144.122.240.200,<->,144.108.80.170,1,74,0,0,1,74,0.870900000,0.0000
215.158.238.85,<->,141.204.127.17,1,772,0,0,1,772,0.869915000,0.0000
58.46.203.2,<->,20.151.73.24,0,0,1,76,1,76,0.869761000,0.0000
192.67.161.146,<->,74.252.52.17,1,77,0,0,1,77,0.869213000,0.0000
247.136.236.50,<->,113.207.254.105,1,280,0,0,1,280,0.868652000,0.0000
192.64.250.118,<->,112.90.36.143,1,279,0,0,1,279,0.868024000,0.0000
21.15.226.126,<->,20.193.59.5,0,0,1,82,1,82,0.867497000,0.0000
38.21.156.204,<->,20.232.228.55,0,0,1,82,1,82,0.866738000,0.0000
109.121.177.146,<->,69.171.220.179,1,133,0,0,1,133,0.866378000,0.0000
141.203.81.200,<->,20.151.228.71,0,0,1,75,1,75,0.864744000,0.0000
148.74.255.93,<->,20.146.20.10,0,0,1,70,1,70,0.864367000,0.0000
132.51.6.250,<->,22.34.2.52,1,186,0,0,1,186,0.863690000,0.0000
148.162.54.31,<->,35.56.102.252,0,0,1,138,1,138,0.863682000,0.0000
92.27.219.18,<->,33.57.77.143,1,52,0,0,1,52,0.863664000,0.0000
210.104.195.137,<->,133.178.226.254,0,0,1,90,1,90,0.863439000,0.0000
109.222.250.37,<->,8.232.74.206,1,296,0,0,1,296,0.863256000,0.0000
105.115.183.34,<->,100.93.179.222,0,0,1,106,1,106,0.863114000,0.0000
192.171.13.188,<->,109.222.230.12,0,0,1,98,1,98,0.863032000,0.0000
144.75.218.237,<->,138.127.230.158,1,202,0,0,1,202,0.862627000,0.0000
154.151.15.59,<->,39.26.64.156,0,0,1,52,1,52,0.862543000,0.0000
230.63.142.3,<->,91.251.82.156,0,0,1,130,1,130,0.862293000,0.0000
159.64.148.27,<->,29.211.214.82,0,0,1,89,1,89,0.861368000,0.0000
122.34.93.206,<->,89.183.104.135,0,0,1,52,1,52,0.861312000,0.0000
227.23.98.210,<->,89.183.104.150,0,0,1,52,1,52,0.860078000,0.0000
144.75.222.203,<->,144.69.82.139,0,0,1,74,1,74,0.860053000,0.0000
159.176.32.29,<->,144.75.218.246,0,0,1,76,1,76,0.859532000,0.0000
111.154.13.141,<->,109.222.255.85,0,0,1,78,1,78,0.859318000,0.0000
159.69.187.19,<->,144.108.80.170,1,73,0,0,1,73,0.859196000,0.0000
144.75.218.242,<->,132.156.82.239,1,156,0,0,1,156,0.857628000,0.0000
144.75.218.241,<->,138.127.224.140,1,365,0,0,1,365,0.857374000,0.0000
132.168.198.210,<->,116.173.88.56,1,72,0,0,1,72,0.856981000,0.0000
138.127.231.62,<->,97.126.26.70,0,0,1,282,1,282,0.856774000,0.0000
144.75.218.241,<->,138.127.230.136,1,366,0,0,1,366,0.856635000,0.0000
144.75.218.242,<->,132.43.156.81,1,154,0,0,1,154,0.856406000,0.0000
20.13.109.215,<->,0.200.50.50,1,60,0,0,1,60,0.856336000,0.0000
192.64.196.112,<->,119.219.188.63,1,52,0,0,1,52,0.855985000,0.0000
144.75.218.237,<->,53.245.2.193,1,110,0,0,1,110,0.855571000,0.0000
144.75.218.233,<->,138.127.230.12,1,186,0,0,1,186,0.855276000,0.0000
144.75.218.233,<->,108.134.82.93,1,206,0,0,1,206,0.854228000,0.0000
198.70.220.74,<->,39.134.146.48,0,0,1,72,1,72,0.854053000,0.0000
122.145.210.242,<->,80.42.179.209,0,0,1,133,1,133,0.853892000,0.0000
124.69.27.27,<->,39.12.84.160,0,0,1,74,1,74,0.853679000,0.0000
129.224.112.252,<->,114.187.51.237,1,72,0,0,1,72,0.853364000,0.0000
247.136.154.209,<->,38.173.226.37,1,52,0,0,1,52,0.852862000,0.0000
222.62.219.94,<->,48.53.227.245,0,0,1,321,1,321,0.852850000,0.0000
235.231.66.42,<->,92.27.219.33,0,0,1,351,1,351,0.851488000,0.0000
222.254.150.132,<->,144.75.218.233,0,0,1,128,1,128,0.849924000,0.0000
144.75.218.246,<->,136.144.124.253,1,77,0,0,1,77,0.849681000,0.0000
21.15.226.126,<->,20.193.59.46,0,0,1,82,1,82,0.848657000,0.0000
144.75.218.237,<->,102.45.225.190,1,85,0,0,1,85,0.848203000,0.0000
93.90.89.141,<->,80.40.45.77,0,0,1,52,1,52,0.847058000,0.0000
112.75.196.109,<->,92.27.219.43,0,0,1,325,1,325,0.846815000,0.0000
144.75.218.233,<->,138.127.230.53,1,365,0,0,1,365,0.845649000,0.0000
121.36.34.191,<->,92.27.219.171,0,0,1,135,1,135,0.845173000,0.0000
138.23.113.45,<->,78.128.203.59,1,151,0,0,1,151,0.844349000,0.0000
115.85.241.227,<->,0.195.210.15,0,0,1,158,1,158,0.843955000,0.0000
138.127.231.249,<->,97.126.26.71,0,0,1,282,1,282,0.843000000,0.0000
144.122.240.213,<->,144.108.64.179,1,70,0,0,1,70,0.842923000,0.0000
215.158.103.206,<->,138.127.230.24,1,259,0,0,1,259,0.842225000,0.0000
136.181.53.35,<->,104.140.75.204,1,135,0,0,1,135,0.841924000,0.0000
144.75.218.241,<->,132.43.156.56,1,151,0,0,1,151,0.841628000,0.0000
91.206.247.51,<->,56.121.46.220,0,0,1,68,1,68,0.840941000,0.0000
98.128.233.83,<->,64.146.18.101,1,130,0,0,1,130,0.840794000,0.0000
192.67.152.0,<->,38.170.162.131,1,52,0,0,1,52,0.839716000,0.0000
109.222.250.219,<->,99.237.92.17,1,341,0,0,1,341,0.839545000,0.0000
215.158.103.206,<->,138.127.230.221,1,84,0,0,1,84,0.839394000,0.0000
145.242.126.85,<->,144.75.221.206,1,81,0,0,1,81,0.839181000,0.0000
220.55.101.100,<->,128.203.247.101,1,76,0,0,1,76,0.838751000,0.0000
97.243.223.84,<->,6.75.250.3,0,0,1,193,1,193,0.838502000,0.0000
113.129.159.40,<->,89.183.104.132,0,0,1,52,1,52,0.838310000,0.0000
144.122.240.201,<->,144.108.64.183,1,63,0,0,1,63,0.836541000,0.0000
144.122.240.197,<->,144.108.80.170,1,72,0,0,1,72,0.836109000,0.0000
99.227.90.140,<->,92.27.27.161,0,0,1,52,1,52,0.835578000,0.0000
159.69.187.50,<->,144.108.64.179,1,77,0,0,1,77,0.835014000,0.0000
144.75.218.242,<->,97.68.93.9,1,707,0,0,1,707,0.834017000,0.0000
117.206.109.192,<->,89.183.104.141,0,0,1,62,1,62,0.832871000,0.0000
88.45.148.185,<->,80.40.56.209,0,0,1,135,1,135,0.832530000,0.0000
21.15.226.126,<->,20.193.60.101,0,0,1,82,1,82,0.832396000,0.0000
159.251.74.73,<->,136.25.188.72,0,0,1,1064,1,1064,0.832350000,0.0000
132.168.196.227,<->,126.229.209.161,1,77,0,0,1,77,0.831704000,0.0000
231.255.157.46,<->,215.158.239.117,0,0,1,100,1,100,0.831219000,0.0000
148.247.194.50,<->,20.55.0.110,0,0,1,135,1,135,0.830810000,0.0000
159.69.187.49,<->,144.108.80.170,1,78,0,0,1,78,0.830134000,0.0000
198.231.232.65,<->,6.122.154.156,0,0,1,52,1,52,0.829816000,0.0000
159.69.187.42,<->,144.108.80.170,1,71,0,0,1,71,0.829734000,0.0000
113.177.30.121,<->,20.105.243.223,0,0,1,78,1,78,0.829632000,0.0000
38.21.156.204,<->,20.232.228.154,0,0,1,82,1,82,0.829393000,0.0000
115.172.108.243,<->,109.1.46.25,0,0,1,97,1,97,0.828163000,0.0000
206.195.198.162,<->,102.50.194.26,0,0,1,309,1,309,0.828035000,0.0000
117.22.133.81,<->,89.183.108.143,0,0,1,133,1,133,0.827857000,0.0000
109.1.17.10,<->,27.188.163.162,1,446,0,0,1,446,0.827695000,0.0000
159.194.43.140,<->,48.54.33.224,0,0,1,133,1,133,0.827650000,0.0000
109.222.249.16,<->,80.12.152.248,1,78,0,0,1,78,0.827593000,0.0000
217.11.189.9,<->,35.32.8.129,0,0,1,439,1,439,0.827522000,0.0000
210.156.156.214,<->,74.239.244.43,1,130,0,0,1,130,0.826913000,0.0000
123.123.221.21,<->,89.183.104.151,0,0,1,52,1,52,0.826464000,0.0000
230.49.174.178,<->,220.83.21.43,0,0,1,130,1,130,0.826185000,0.0000
109.222.250.16,<->,42.233.156.138,1,70,0,0,1,70,0.824857000,0.0000
118.38.145.3,<->,97.168.105.154,0,0,1,1470,1,1470,0.824008000,0.0000
129.224.112.252,<->,97.242.126.203,1,83,0,0,1,83,0.823160000,0.0000
42.146.133.4,<->,20.242.183.249,0,0,1,76,1,76,0.822121000,0.0000
144.75.218.246,<->,138.127.224.105,1,366,0,0,1,366,0.822060000,0.0000
192.67.183.227,<->,128.180.33.172,1,52,0,0,1,52,0.821763000,0.0000
144.75.218.241,<->,138.127.225.8,1,366,0,0,1,366,0.821491000,0.0000
144.75.218.242,<->,97.110.148.11,1,138,0,0,1,138,0.821490000,0.0000
140.91.154.183,<->,92.27.27.186,0,0,1,135,1,135,0.820953000,0.0000
106.248.210.12,<->,92.27.209.159,0,0,1,57,1,57,0.819983000,0.0000
247.136.211.104,<->,92.62.110.238,1,84,0,0,1,84,0.818985000,0.0000
106.248.210.12,<->,92.27.26.178,0,0,1,57,1,57,0.818798000,0.0000
159.69.187.16,<->,144.108.80.170,1,68,0,0,1,68,0.816828000,0.0000
21.15.226.126,<->,20.193.60.141,0,0,1,82,1,82,0.816000000,0.0000
120.155.86.33,<->,8.176.8.97,0,0,1,111,1,111,0.815747000,0.0000
65.180.180.196,<->,50.224.96.136,0,0,1,76,1,76,0.815442000,0.0000
136.25.188.105,<->,130.28.164.201,1,139,0,0,1,139,0.814962000,0.0000
144.75.218.233,<->,128.8.18.241,1,298,0,0,1,298,0.814567000,0.0000
92.27.219.50,<->,88.0.112.42,1,52,0,0,1,52,0.813972000,0.0000
148.205.108.81,<->,80.42.154.197,0,0,1,79,1,79,0.813613000,0.0000
128.163.57.179,<->,109.1.44.191,0,0,1,50,1,50,0.813364000,0.0000
136.181.53.150,<->,127.200.10.57,1,149,0,0,1,149,0.812599000,0.0000
92.27.27.99,<->,88.4.164.151,1,52,0,0,1,52,0.812172000,0.0000
129.224.112.252,<->,92.162.219.175,1,73,0,0,1,73,0.812111000,0.0000
145.242.126.212,<->,98.57.209.158,1,78,0,0,1,78,0.811890000,0.0000
126.138.59.22,<->,89.183.104.168,0,0,1,263,1,263,0.811848000,0.0000
144.75.218.237,<->,139.252.1.234,1,87,0,0,1,87,0.810608000,0.0000
192.74.123.212,<->,92.27.219.182,0,0,1,176,1,176,0.810286000,0.0000
144.75.218.237,<->,138.127.225.67,1,366,0,0,1,366,0.809982000,0.0000
242.121.18.213,<->,138.98.134.1,0,0,1,79,1,79,0.809695000,0.0000
92.27.27.165,<->,78.51.214.152,1,52,0,0,1,52,0.809514000,0.0000
116.143.80.64,<->,92.27.219.230,0,0,1,133,1,133,0.808348000,0.0000
132.168.196.227,<->,93.163.135.26,1,79,0,0,1,79,0.806860000,0.0000
109.1.17.14,<->,27.188.163.162,1,444,0,0,1,444,0.805921000,0.0000
29.212.43.244,<->,8.252.222.202,0,0,1,105,1,105,0.805606000,0.0000
206.22.162.192,<->,192.64.195.195,0,0,1,52,1,52,0.804824000,0.0000
92.27.219.229,<->,80.226.83.121,1,80,0,0,1,80,0.804802000,0.0000
21.15.226.126,<->,20.193.60.212,0,0,1,82,1,82,0.804377000,0.0000
38.21.156.204,<->,20.232.228.157,0,0,1,82,1,82,0.803494000,0.0000
207.5.99.21,<->,192.67.181.192,0,0,1,98,1,98,0.803421000,0.0000
21.15.226.126,<->,20.193.60.220,0,0,1,82,1,82,0.803408000,0.0000
109.1.15.30,<->,93.160.237.240,1,152,0,0,1,152,0.802987000,0.0000
197.132.142.28,<->,92.27.219.50,0,0,1,135,1,135,0.802707000,0.0000
79.134.27.76,<->,35.56.103.56,0,0,1,50,1,50,0.802442000,0.0000
92.27.219.186,<->,48.105.172.255,1,52,0,0,1,52,0.802422000,0.0000
144.75.218.237,<->,58.48.88.117,1,93,0,0,1,93,0.802369000,0.0000
105.254.61.156,<->,92.27.27.165,0,0,1,52,1,52,0.802123000,0.0000
120.48.131.33,<->,20.172.45.171,0,0,1,78,1,78,0.801962000,0.0000
159.69.187.45,<->,144.76.43.234,1,75,0,0,1,75,0.801815000,0.0000
127.152.207.195,<->,92.27.219.49,0,0,1,52,1,52,0.801200000,0.0000
21.15.226.126,<->,20.193.60.176,0,0,1,82,1,82,0.801193000,0.0000
138.127.227.65,<->,136.99.137.179,0,0,1,243,1,243,0.801082000,0.0000
196.18.149.149,<->,92.27.27.166,0,0,1,52,1,52,0.800993000,0.0000
234.182.169.148,<->,133.32.2.37,0,0,1,82,1,82,0.800710000,0.0000
208.186.230.2,<->,132.200.62.147,0,0,1,72,1,72,0.800695000,0.0000
215.158.238.163,<->,131.95.192.187,1,85,0,0,1,85,0.800665000,0.0000
144.75.218.246,<->,139.114.208.35,1,132,0,0,1,132,0.800361000,0.0000
89.183.104.152,<->,66.13.115.56,1,153,0,0,1,153,0.800157000,0.0000
227.23.98.223,<->,92.27.219.231,0,0,1,53,1,53,0.799893000,0.0000
109.1.40.226,<->,29.239.233.207,1,99,0,0,1,99,0.799467000,0.0000
114.207.42.114,<->,92.27.219.46,0,0,1,52,1,52,0.799307000,0.0000
143.148.102.19,<->,20.16.122.94,0,0,1,72,1,72,0.799017000,0.0000
194.40.2.133,<->,92.27.219.21,0,0,1,52,1,52,0.798751000,0.0000
247.136.226.75,<->,104.99.156.136,1,97,0,0,1,97,0.797223000,0.0000
105.121.173.108,<->,80.41.16.207,0,0,1,133,1,133,0.796299000,0.0000
114.28.148.5,<->,92.27.219.238,0,0,1,149,1,149,0.795890000,0.0000
112.5.12.77,<->,20.181.69.66,0,0,1,72,1,72,0.795517000,0.0000
102.45.16.209,<->,78.45.210.42,1,52,0,0,1,52,0.795166000,0.0000
21.15.226.126,<->,20.193.60.211,0,0,1,82,1,82,0.794879000,0.0000
144.122.240.218,<->,144.108.80.170,1,72,0,0,1,72,0.794731000,0.0000
129.224.112.252,<->,92.162.219.96,1,76,0,0,1,76,0.793258000,0.0000
144.75.218.233,<->,17.197.194.60,1,163,0,0,1,163,0.792437000,0.0000
120.155.86.33,<->,8.176.8.83,0,0,1,131,1,131,0.792261000,0.0000
92.27.219.42,<->,29.11.138.97,1,174,0,0,1,174,0.791521000,0.0000
206.198.190.233,<->,92.27.219.140,0,0,1,319,1,319,0.791293000,0.0000
122.135.83.219,<->,89.183.104.160,0,0,1,332,1,332,0.791202000,0.0000
193.21.29.244,<->,100.94.40.183,0,0,1,335,1,335,0.790817000,0.0000
215.158.103.206,<->,129.221.194.218,1,801,0,0,1,801,0.789952000,0.0000
118.99.185.65,<->,89.183.104.138,0,0,1,213,1,213,0.789113000,0.0000
144.75.218.237,<->,138.127.225.252,1,356,0,0,1,356,0.787977000,0.0000
157.98.1.54,<->,129.224.112.252,0,0,1,82,1,82,0.787494000,0.0000
120.238.165.207,<->,101.224.172.52,0,0,1,57,1,57,0.786966000,0.0000
144.122.240.212,<->,144.76.43.234,1,77,0,0,1,77,0.786803000,0.0000
149.200.188.95,<->,80.40.24.130,0,0,1,490,1,490,0.786793000,0.0000
159.69.187.28,<->,99.168.117.210,1,72,0,0,1,72,0.786514000,0.0000
144.75.218.233,<->,138.127.224.115,1,348,0,0,1,348,0.786111000,0.0000
109.222.253.182,<->,52.194.161.199,1,70,0,0,1,70,0.785564000,0.0000
144.75.218.241,<->,138.127.230.35,1,356,0,0,1,356,0.785486000,0.0000
192.64.234.225,<->,149.59.98.246,1,50,0,0,1,50,0.785465000,0.0000
230.62.102.89,<->,39.38.85.55,0,0,1,710,1,710,0.785185000,0.0000
146.196.145.46,<->,129.224.112.252,0,0,1,75,1,75,0.783494000,0.0000
246.108.250.201,<->,144.75.218.246,0,0,1,72,1,72,0.782649000,0.0000
204.136.215.19,<->,39.53.87.17,0,0,1,72,1,72,0.781553000,0.0000
144.122.240.210,<->,144.108.64.181,1,69,0,0,1,69,0.781523000,0.0000
144.75.218.241,<->,138.127.231.14,1,254,0,0,1,254,0.781229000,0.0000
106.29.77.23,<->,92.27.219.229,0,0,1,334,1,334,0.780151000,0.0000
144.75.218.233,<->,138.127.231.91,1,238,0,0,1,238,0.779168000,0.0000
92.27.219.171,<->,27.77.123.31,1,263,0,0,1,263,0.778993000,0.0000
205.63.215.229,<->,92.27.219.217,0,0,1,1398,1,1398,0.778574000,0.0000
218.31.254.210,<->,129.224.112.252,0,0,1,72,1,72,0.777945000,0.0000
119.49.204.222,<->,20.255.131.77,0,0,1,74,1,74,0.777830000,0.0000
198.182.188.35,<->,80.41.12.171,0,0,1,120,1,120,0.777827000,0.0000
144.75.218.242,<->,138.127.224.101,1,84,0,0,1,84,0.777296000,0.0000
159.36.245.188,<->,92.27.219.231,0,0,1,213,1,213,0.776920000,0.0000
159.69.187.12,<->,144.69.101.196,1,75,0,0,1,75,0.775436000,0.0000
141.183.33.233,<->,39.220.231.11,0,0,1,72,1,72,0.774852000,0.0000
246.254.97.149,<->,8.35.106.83,1,101,0,0,1,101,0.774046000,0.0000
103.178.26.56,<->,98.67.130.21,0,0,1,76,1,76,0.773807000,0.0000
198.212.18.67,<->,92.27.219.160,0,0,1,52,1,52,0.773649000,0.0000
136.25.188.105,<->,133.9.254.177,1,94,0,0,1,94,0.773566000,0.0000
145.42.14.168,<->,129.78.116.244,0,0,1,84,1,84,0.772432000,0.0000
111.147.125.110,<->,79.116.131.173,1,72,0,0,1,72,0.770772000,0.0000
121.94.99.179,<->,20.222.244.52,0,0,1,84,1,84,0.769563000,0.0000
118.35.233.94,<->,89.183.104.243,0,0,1,98,1,98,0.769009000,0.0000
137.148.176.213,<->,97.126.26.40,0,0,1,83,1,83,0.767910000,0.0000
144.75.218.246,<->,138.127.224.42,1,296,0,0,1,296,0.767701000,0.0000
210.220.219.153,<->,138.127.231.62,1,293,0,0,1,293,0.765985000,0.0000
92.27.219.253,<->,38.84.5.250,1,149,0,0,1,149,0.764622000,0.0000
142.241.44.215,<->,92.27.219.251,0,0,1,52,1,52,0.762607000,0.0000
144.75.218.233,<->,138.127.231.102,1,263,0,0,1,263,0.762321000,0.0000
144.75.218.242,<->,138.127.230.146,1,253,0,0,1,253,0.762247000,0.0000
136.25.189.214,<->,8.35.106.206,1,90,0,0,1,90,0.762035000,0.0000
215.158.239.217,<->,8.35.106.206,1,90,0,0,1,90,0.761691000,0.0000
144.75.218.242,<->,138.127.225.171,1,354,0,0,1,354,0.761377000,0.0000
215.158.140.105,<->,111.151.237.52,1,1064,0,0,1,1064,0.761264000,0.0000
144.75.218.246,<->,138.127.230.144,1,242,0,0,1,242,0.761212000,0.0000
100.208.15.63,<->,68.0.226.41,1,156,0,0,1,156,0.761017000,0.0000
101.122.132.105,<->,94.254.2.109,1,65,0,0,1,65,0.759911000,0.0000
98.236.95.13,<->,53.89.213.104,1,89,0,0,1,89,0.758257000,0.0000
144.75.218.242,<->,143.204.138.237,1,148,0,0,1,148,0.758118000,0.0000
33.155.155.153,<->,8.228.214.59,0,0,1,52,1,52,0.757327000,0.0000
21.15.226.126,<->,20.193.61.72,0,0,1,82,1,82,0.757270000,0.0000
192.67.167.86,<->,132.7.32.230,1,52,0,0,1,52,0.756826000,0.0000
139.163.5.140,<->,106.167.226.231,1,62,0,0,1,62,0.756634000,0.0000
144.75.218.233,<->,138.127.230.209,1,279,0,0,1,279,0.755140000,0.0000
105.197.17.184,<->,101.70.119.37,0,0,1,67,1,67,0.755029000,0.0000
144.75.218.242,<->,130.54.191.244,1,75,0,0,1,75,0.754823000,0.0000
144.76.44.59,<->,99.75.234.139,0,0,1,125,1,125,0.754386000,0.0000
113.179.22.128,<->,39.10.114.234,0,0,1,78,1,78,0.753918000,0.0000
144.75.218.237,<->,138.127.224.46,1,258,0,0,1,258,0.753571000,0.0000
198.157.156.226,<->,92.27.219.140,0,0,1,307,1,307,0.752733000,0.0000
144.75.218.237,<->,56.120.138.124,1,143,0,0,1,143,0.752303000,0.0000
144.71.44.95,<->,97.242.126.198,1,84,0,0,1,84,0.751284000,0.0000
118.194.174.35,<->,89.183.104.135,0,0,1,324,1,324,0.751033000,0.0000
92.27.219.153,<->,48.111.9.167,1,273,0,0,1,273,0.750659000,0.0000
229.42.148.9,<->,89.183.104.151,0,0,1,52,1,52,0.750456000,0.0000
144.75.218.246,<->,98.184.9.185,1,126,0,0,1,126,0.750182000,0.0000
144.75.218.242,<->,138.127.224.190,1,242,0,0,1,242,0.749364000,0.0000
215.158.239.104,<->,138.127.224.238,1,232,0,0,1,232,0.749239000,0.0000
221.150.250.237,<->,111.48.21.51,1,106,0,0,1,106,0.748495000,0.0000
109.222.251.171,<->,101.62.32.153,1,136,0,0,1,136,0.747001000,0.0000
112.70.87.240,<->,39.49.187.123,0,0,1,296,1,296,0.746748000,0.0000
133.178.227.73,<->,131.1.235.233,1,85,0,0,1,85,0.746482000,0.0000
109.222.217.93,<->,8.251.185.161,1,73,0,0,1,73,0.745635000,0.0000
78.151.182.244,<->,20.40.147.118,0,0,1,78,1,78,0.745524000,0.0000
144.75.218.233,<->,111.40.16.13,1,87,0,0,1,87,0.745520000,0.0000
109.222.217.93,<->,81.193.109.18,1,73,0,0,1,73,0.745214000,0.0000
137.148.176.213,<->,97.126.26.71,0,0,1,83,1,83,0.745214000,0.0000
192.67.179.218,<->,110.103.159.83,1,105,0,0,1,105,0.744470000,0.0000
201.217.193.35,<->,92.27.27.146,0,0,1,132,1,132,0.743662000,0.0000
112.29.250.153,<->,92.27.27.171,0,0,1,62,1,62,0.743574000,0.0000
106.181.79.175,<->,102.51.33.111,0,0,1,135,1,135,0.743217000,0.0000
215.158.238.85,<->,139.252.1.253,1,135,0,0,1,135,0.742519000,0.0000
247.136.216.62,<->,33.233.160.168,1,123,0,0,1,123,0.741387000,0.0000
144.75.218.242,<->,120.155.84.208,1,152,0,0,1,152,0.741386000,0.0000
239.66.184.247,<->,100.92.119.180,0,0,1,270,1,270,0.740140000,0.0000
220.80.188.18,<->,93.177.118.32,1,133,0,0,1,133,0.739614000,0.0000
101.71.60.7,<->,92.27.27.144,0,0,1,317,1,317,0.739394000,0.0000
100.255.17.187,<->,97.126.116.84,0,0,1,65,1,65,0.738563000,0.0000
220.84.205.112,<->,61.93.34.188,1,135,0,0,1,135,0.738290000,0.0000
136.25.189.5,<->,33.209.218.54,1,218,0,0,1,218,0.738149000,0.0000
104.147.228.66,<->,89.183.104.136,0,0,1,100,1,100,0.737339000,0.0000
144.75.218.233,<->,138.127.224.105,1,366,0,0,1,366,0.735222000,0.0000
122.238.92.211,<->,20.46.130.124,0,0,1,75,1,75,0.732906000,0.0000
193.21.29.252,<->,192.67.161.238,0,0,1,136,1,136,0.732765000,0.0000
145.252.127.155,<->,144.76.46.38,1,90,0,0,1,90,0.732618000,0.0000
210.158.44.137,<->,124.58.26.202,1,119,0,0,1,119,0.732448000,0.0000
132.168.196.9,<->,115.78.45.1,1,52,0,0,1,52,0.731615000,0.0000
144.75.218.246,<->,138.127.224.168,1,314,0,0,1,314,0.731308000,0.0000
129.1.96.39,<->,112.70.50.181,1,149,0,0,1,149,0.731146000,0.0000
246.253.253.84,<->,192.204.123.23,1,83,0,0,1,83,0.730861000,0.0000
144.75.218.233,<->,138.127.230.213,1,286,0,0,1,286,0.730766000,0.0000
136.129.94.107,<->,92.27.219.23,0,0,1,123,1,123,0.730147000,0.0000
38.21.156.204,<->,20.232.228.175,0,0,1,82,1,82,0.729754000,0.0000
147.47.189.152,<->,34.139.217.179,0,0,1,134,1,134,0.729521000,0.0000
159.137.203.107,<->,141.134.231.203,1,72,0,0,1,72,0.729128000,0.0000
215.158.239.103,<->,192.171.13.35,1,102,0,0,1,102,0.728280000,0.0000
156.182.98.147,<->,20.29.39.250,0,0,1,120,1,120,0.727881000,0.0000
134.50.189.160,<->,89.183.104.251,0,0,1,62,1,62,0.727800000,0.0000
65.67.142.90,<->,39.169.11.74,0,0,1,52,1,52,0.726966000,0.0000
102.83.157.248,<->,64.146.112.197,1,169,0,0,1,169,0.726894000,0.0000
105.201.221.207,<->,80.42.150.137,0,0,1,326,1,326,0.726413000,0.0000
205.121.167.47,<->,89.139.241.98,0,0,1,151,1,151,0.725994000,0.0000
144.76.46.38,<->,136.181.39.4,0,0,1,112,1,112,0.725376000,0.0000
144.75.218.241,<->,8.47.122.178,1,100,0,0,1,100,0.724632000,0.0000
127.73.18.187,<->,97.126.35.236,0,0,1,187,1,187,0.723367000,0.0000
143.117.247.30,<->,89.139.241.98,0,0,1,136,1,136,0.723298000,0.0000
109.222.255.151,<->,81.18.77.118,1,66,0,0,1,66,0.722650000,0.0000
104.158.163.210,<->,39.193.150.67,0,0,1,52,1,52,0.722541000,0.0000
122.253.118.127,<->,89.183.104.135,0,0,1,52,1,52,0.721887000,0.0000
144.75.218.241,<->,138.127.231.54,1,333,0,0,1,333,0.720550000,0.0000
102.47.130.213,<->,50.224.118.187,0,0,1,80,1,80,0.720044000,0.0000
144.122.240.222,<->,144.108.64.185,1,64,0,0,1,64,0.719940000,0.0000
109.222.228.12,<->,109.122.86.55,1,92,0,0,1,92,0.719908000,0.0000
159.69.187.28,<->,144.108.64.183,1,66,0,0,1,66,0.719330000,0.0000
144.75.221.204,<->,97.198.100.142,0,0,1,87,1,87,0.717849000,0.0000
246.253.253.79,<->,159.57.86.227,1,198,0,0,1,198,0.717168000,0.0000
125.221.158.28,<->,89.183.104.160,0,0,1,270,1,270,0.716839000,0.0000
141.105.189.30,<->,20.36.214.32,0,0,1,72,1,72,0.716795000,0.0000
80.41.44.203,<->,64.214.44.93,1,52,0,0,1,52,0.716165000,0.0000
215.158.239.103,<->,29.214.217.188,1,336,0,0,1,336,0.715913000,0.0000
121.15.252.56,<->,109.1.52.158,0,0,1,99,1,99,0.714263000,0.0000
98.232.172.60,<->,89.211.37.130,1,84,0,0,1,84,0.714089000,0.0000
139.254.213.98,<->,129.205.208.245,1,614,0,0,1,614,0.714015000,0.0000
158.99.169.247,<->,80.40.13.234,0,0,1,136,1,136,0.712177000,0.0000
226.162.38.40,<->,99.75.41.170,0,0,1,63,1,63,0.712104000,0.0000
113.14.32.243,<->,20.9.89.19,0,0,1,72,1,72,0.711842000,0.0000
220.80.18.212,<->,158.93.155.23,1,67,0,0,1,67,0.711719000,0.0000
210.235.163.211,<->,22.34.2.52,1,186,0,0,1,186,0.711587000,0.0000
206.195.90.218,<->,100.50.202.45,0,0,1,70,1,70,0.709787000,0.0000
159.134.47.10,<->,159.87.104.238,0,0,1,76,1,76,0.709635000,0.0000
237.56.30.41,<->,20.39.199.134,0,0,1,78,1,78,0.709430000,0.0000
215.158.140.170,<->,131.189.98.171,1,211,0,0,1,211,0.707882000,0.0000
133.32.1.105,<->,26.225.57.159,1,69,0,0,1,69,0.707794000,0.0000
148.151.124.212,<->,8.252.222.202,0,0,1,135,1,135,0.707683000,0.0000
135.233.98.57,<->,129.224.112.220,0,0,1,54,1,54,0.706964000,0.0000
143.220.58.215,<->,39.246.51.182,0,0,1,75,1,75,0.706657000,0.0000
144.75.218.233,<->,8.47.122.178,1,100,0,0,1,100,0.706520000,0.0000
220.81.184.104,<->,89.183.104.168,0,0,1,80,1,80,0.705754000,0.0000
112.130.42.21,<->,109.222.251.27,0,0,1,77,1,77,0.705530000,0.0000
96.232.37.25,<->,89.183.108.200,0,0,1,78,1,78,0.705321000,0.0000
131.144.248.45,<->,129.224.112.252,0,0,1,83,1,83,0.705160000,0.0000
21.15.226.126,<->,20.193.63.180,0,0,1,82,1,82,0.704066000,0.0000
38.21.156.204,<->,20.232.228.246,0,0,1,82,1,82,0.703421000,0.0000
205.224.29.67,<->,100.93.232.193,0,0,1,326,1,326,0.703369000,0.0000
38.21.156.204,<->,20.232.228.254,0,0,1,82,1,82,0.701049000,0.0000
246.253.222.199,<->,52.152.91.154,1,79,0,0,1,79,0.700618000,0.0000
198.185.158.73,<->,92.27.219.17,0,0,1,130,1,130,0.700345000,0.0000
59.35.252.53,<->,39.235.56.149,0,0,1,76,1,76,0.700046000,0.0000
215.158.2.127,<->,8.176.8.234,0,0,1,90,1,90,0.699773000,0.0000
147.61.214.19,<->,136.129.71.19,0,0,1,146,1,146,0.699123000,0.0000
108.134.119.186,<->,107.99.137.90,1,89,0,0,1,89,0.698878000,0.0000
109.222.217.93,<->,108.246.28.215,1,77,0,0,1,77,0.698861000,0.0000
215.158.103.219,<->,159.151.90.195,1,137,0,0,1,137,0.697202000,0.0000
207.66.33.41,<->,129.224.112.252,0,0,1,79,1,79,0.696823000,0.0000
139.248.201.139,<->,96.190.12.63,1,80,0,0,1,80,0.696729000,0.0000
122.228.238.242,<->,39.23.51.74,0,0,1,68,1,68,0.696538000,0.0000
208.197.102.102,<->,98.232.172.60,0,0,1,75,1,75,0.695580000,0.0000
147.54.67.205,<->,34.230.150.26,0,0,1,538,1,538,0.695340000,0.0000
215.158.103.206,<->,53.222.171.58,1,82,0,0,1,82,0.694978000,0.0000
206.144.195.198,<->,20.247.123.14,0,0,1,80,1,80,0.694927000,0.0000
114.128.248.198,<->,109.1.3.222,0,0,1,58,1,58,0.694017000,0.0000
144.75.218.235,<->,138.127.231.201,1,237,0,0,1,237,0.693723000,0.0000
152.37.100.190,<->,99.162.73.8,0,0,1,135,1,135,0.693229000,0.0000
192.105.127.33,<->,133.178.226.77,0,0,1,1064,1,1064,0.691881000,0.0000
144.75.218.246,<->,138.127.230.221,1,365,0,0,1,365,0.691157000,0.0000
192.67.161.171,<->,79.255.218.236,1,133,0,0,1,133,0.690352000,0.0000
149.228.97.44,<->,144.75.218.235,0,0,1,127,1,127,0.690117000,0.0000
101.224.204.141,<->,89.211.37.130,1,85,0,0,1,85,0.689931000,0.0000
92.27.219.32,<->,29.135.115.226,1,351,0,0,1,351,0.689357000,0.0000
247.136.139.153,<->,126.198.202.12,1,317,0,0,1,317,0.688883000,0.0000
109.222.214.26,<->,97.36.109.42,1,66,0,0,1,66,0.688847000,0.0000
144.75.218.237,<->,138.127.224.241,1,215,0,0,1,215,0.688790000,0.0000
89.183.104.191,<->,38.52.7.49,1,52,0,0,1,52,0.688396000,0.0000
98.217.9.93,<->,74.240.66.155,1,130,0,0,1,130,0.687962000,0.0000
119.50.12.116,<->,39.133.58.192,0,0,1,78,1,78,0.687530000,0.0000
144.123.49.227,<->,120.155.84.161,1,139,0,0,1,139,0.687017000,0.0000
133.178.227.23,<->,128.156.144.228,1,80,0,0,1,80,0.685017000,0.0000
80.42.134.4,<->,57.218.111.137,1,321,0,0,1,321,0.684875000,0.0000
205.165.37.182,<->,92.27.219.185,0,0,1,349,1,349,0.684837000,0.0000
21.15.226.126,<->,20.193.63.140,0,0,1,82,1,82,0.684550000,0.0000
144.75.218.235,<->,138.127.224.239,1,366,0,0,1,366,0.684474000,0.0000
142.235.87.114,<->,99.73.184.38,0,0,1,100,1,100,0.684224000,0.0000
136.25.189.94,<->,29.212.196.10,1,83,0,0,1,83,0.683815000,0.0000
215.158.238.180,<->,159.49.96.73,1,1064,0,0,1,1064,0.681303000,0.0000
144.54.14.68,<->,132.249.70.213,0,0,1,141,1,141,0.680599000,0.0000
144.75.218.241,<->,132.6.55.46,1,147,0,0,1,147,0.679887000,0.0000
126.25.17.12,<->,20.220.65.11,0,0,1,147,1,147,0.679786000,0.0000
134.195.15.243,<->,92.27.219.232,0,0,1,66,1,66,0.679170000,0.0000
149.200.220.216,<->,145.242.126.23,0,0,1,80,1,80,0.679157000,0.0000
101.224.183.152,<->,100.211.114.205,1,79,0,0,1,79,0.678995000,0.0000
92.27.27.143,<->,72.43.45.118,1,52,0,0,1,52,0.677132000,0.0000
194.196.213.236,<->,39.146.97.79,0,0,1,70,1,70,0.677009000,0.0000
149.201.60.62,<->,39.160.63.11,0,0,1,130,1,130,0.676870000,0.0000
144.75.218.246,<->,140.142.131.1,1,77,0,0,1,77,0.676241000,0.0000
144.79.8.89,<->,89.183.110.30,0,0,1,68,1,68,0.675309000,0.0000
144.86.148.228,<->,27.11.52.246,1,95,0,0,1,95,0.675197000,0.0000
215.158.239.103,<->,139.252.1.233,1,160,0,0,1,160,0.675133000,0.0000
102.50.47.32,<->,42.90.92.235,1,326,0,0,1,326,0.674808000,0.0000
48.53.240.104,<->,6.130.73.133,1,52,0,0,1,52,0.674405000,0.0000
21.15.226.126,<->,20.193.63.27,0,0,1,82,1,82,0.674161000,0.0000
215.158.103.219,<->,157.110.115.195,1,89,0,0,1,89,0.673997000,0.0000
98.67.140.202,<->,92.22.181.95,1,68,0,0,1,68,0.672178000,0.0000
127.29.150.181,<->,39.224.180.235,0,0,1,74,1,74,0.672128000,0.0000
199.29.88.191,<->,92.27.27.151,0,0,1,263,1,263,0.671847000,0.0000
229.59.1.44,<->,220.55.79.118,0,0,1,70,1,70,0.671723000,0.0000
126.103.58.218,<->,92.27.219.237,0,0,1,321,1,321,0.670894000,0.0000
129.245.206.220,<->,89.183.104.157,0,0,1,659,1,659,0.670866000,0.0000
134.254.243.178,<->,101.224.191.148,0,0,1,50,1,50,0.669580000,0.0000
215.158.239.66,<->,122.158.179.74,1,85,0,0,1,85,0.669564000,0.0000
210.220.219.153,<->,111.20.47.86,1,118,0,0,1,118,0.669563000,0.0000
129.229.242.60,<->,97.126.116.180,0,0,1,142,1,142,0.669358000,0.0000
127.250.7.59,<->,98.67.136.238,0,0,1,78,1,78,0.668923000,0.0000
69.221.65.158,<->,34.92.85.203,0,0,1,52,1,52,0.668501000,0.0000
120.154.172.95,<->,8.176.8.215,0,0,1,111,1,111,0.667983000,0.0000
246.254.97.149,<->,144.95.255.201,1,89,0,0,1,89,0.667745000,0.0000
118.103.74.218,<->,80.40.48.220,0,0,1,130,1,130,0.666981000,0.0000
205.209.170.212,<->,80.40.24.193,0,0,1,319,1,319,0.666842000,0.0000
144.75.218.246,<->,138.127.231.82,1,254,0,0,1,254,0.663885000,0.0000
149.246.94.20,<->,136.25.188.105,0,0,1,180,1,180,0.663701000,0.0000
101.70.119.29,<->,86.242.75.89,1,135,0,0,1,135,0.663585000,0.0000
116.236.186.198,<->,39.22.82.29,0,0,1,667,1,667,0.663545000,0.0000
144.69.82.139,<->,54.60.194.157,1,75,0,0,1,75,0.663035000,0.0000
121.35.112.201,<->,92.27.219.128,0,0,1,1446,1,1446,0.662720000,0.0000
247.136.254.97,<->,221.196.94.56,1,136,0,0,1,136,0.662714000,0.0000
195.77.22.79,<->,159.137.212.194,0,0,1,104,1,104,0.662542000,0.0000
29.211.214.80,<->,8.219.186.181,1,73,0,0,1,73,0.662307000,0.0000
138.127.224.103,<->,97.126.26.70,0,0,1,226,1,226,0.662143000,0.0000
249.101.103.55,<->,76.72.246.226,1,133,0,0,1,133,0.661758000,0.0000
109.222.195.53,<->,105.234.75.198,1,52,0,0,1,52,0.660944000,0.0000
144.75.218.242,<->,138.127.225.29,1,365,0,0,1,365,0.659445000,0.0000
215.158.103.219,<->,80.56.76.191,1,77,0,0,1,77,0.659433000,0.0000
247.157.159.32,<->,230.115.135.194,1,133,0,0,1,133,0.659299000,0.0000
138.127.224.238,<->,89.139.241.98,0,0,1,221,1,221,0.658566000,0.0000
156.30.10.180,<->,8.238.59.156,0,0,1,133,1,133,0.657790000,0.0000
192.65.80.104,<->,112.70.38.65,1,349,0,0,1,349,0.657324000,0.0000
121.13.86.14,<->,20.176.48.109,0,0,1,50,1,50,0.657234000,0.0000
144.75.218.233,<->,138.127.231.221,1,310,0,0,1,310,0.656593000,0.0000
215.158.103.206,<->,29.214.217.32,1,146,0,0,1,146,0.654443000,0.0000
144.75.218.246,<->,138.127.225.29,1,365,0,0,1,365,0.654428000,0.0000
116.110.29.86,<->,92.162.252.32,0,0,1,119,1,119,0.654175000,0.0000
215.158.103.219,<->,65.192.53.21,1,135,0,0,1,135,0.653801000,0.0000
144.75.218.242,<->,93.77.5.122,1,77,0,0,1,77,0.653223000,0.0000
220.55.91.56,<->,57.212.60.129,1,122,0,0,1,122,0.652885000,0.0000
80.40.25.242,<->,38.52.146.167,1,52,0,0,1,52,0.652575000,0.0000
94.192.198.174,<->,90.240.131.44,0,0,1,319,1,319,0.651890000,0.0000
144.75.218.237,<->,138.127.231.102,1,263,0,0,1,263,0.651799000,0.0000
215.158.239.120,<->,158.85.35.242,1,141,0,0,1,141,0.651680000,0.0000
246.253.248.211,<->,53.199.195.19,1,86,0,0,1,86,0.651620000,0.0000
230.9.8.84,<->,220.87.49.198,0,0,1,130,1,130,0.650783000,0.0000
247.136.231.91,<->,206.54.196.41,1,52,0,0,1,52,0.650079000,0.0000
20.13.109.47,<->,0.200.50.50,1,60,0,0,1,60,0.649360000,0.0000
92.27.219.178,<->,57.208.126.68,1,52,0,0,1,52,0.647936000,0.0000
144.75.218.241,<->,56.115.164.225,1,175,0,0,1,175,0.647860000,0.0000
195.36.141.86,<->,20.69.10.247,0,0,1,74,1,74,0.645733000,0.0000
247.136.227.198,<->,118.100.40.167,1,321,0,0,1,321,0.645689000,0.0000
239.170.100.210,<->,136.25.189.5,0,0,1,165,1,165,0.645215000,0.0000
145.252.126.61,<->,67.128.27.205,1,76,0,0,1,76,0.644271000,0.0000
93.73.95.165,<->,89.183.104.232,0,0,1,52,1,52,0.644242000,0.0000
33.246.152.154,<->,20.238.248.215,0,0,1,72,1,72,0.644047000,0.0000
230.116.229.58,<->,98.129.112.215,0,0,1,149,1,149,0.643770000,0.0000
199.13.105.183,<->,100.92.220.68,0,0,1,52,1,52,0.642851000,0.0000
118.120.58.175,<->,100.94.88.51,0,0,1,149,1,149,0.641277000,0.0000
193.46.99.150,<->,92.27.219.187,0,0,1,90,1,90,0.641167000,0.0000
92.27.219.139,<->,87.62.245.7,1,101,0,0,1,101,0.640804000,0.0000
144.87.235.187,<->,138.127.225.227,1,252,0,0,1,252,0.640603000,0.0000
147.176.48.103,<->,39.39.180.244,0,0,1,140,1,140,0.640584000,0.0000
21.15.226.126,<->,20.193.62.73,0,0,1,82,1,82,0.640090000,0.0000
206.63.227.193,<->,92.27.219.231,0,0,1,1377,1,1377,0.640057000,0.0000
131.233.74.166,<->,39.11.125.130,0,0,1,76,1,76,0.638947000,0.0000
139.163.45.228,<->,138.127.224.243,1,245,0,0,1,245,0.638227000,0.0000
144.75.218.237,<->,136.129.94.109,1,90,0,0,1,90,0.637710000,0.0000
197.197.68.90,<->,129.224.112.252,0,0,1,73,1,73,0.637664000,0.0000
192.171.13.80,<->,8.252.222.119,0,0,1,134,1,134,0.636062000,0.0000
98.67.130.23,<->,72.145.48.171,1,80,0,0,1,80,0.635642000,0.0000
192.64.217.166,<->,133.202.60.104,1,52,0,0,1,52,0.635575000,0.0000
247.136.186.159,<->,38.254.212.90,1,58,0,0,1,58,0.635119000,0.0000
80.41.55.98,<->,69.95.118.50,1,130,0,0,1,130,0.634948000,0.0000
68.154.104.122,<->,20.167.131.155,0,0,1,517,1,517,0.634333000,0.0000
210.158.44.208,<->,120.155.84.161,1,125,0,0,1,125,0.633640000,0.0000
93.237.78.161,<->,92.27.219.171,0,0,1,261,1,261,0.632481000,0.0000
205.77.98.134,<->,92.27.27.142,0,0,1,97,1,97,0.632389000,0.0000
144.64.139.146,<->,124.152.54.18,1,80,0,0,1,80,0.630083000,0.0000
127.178.109.106,<->,39.40.129.5,0,0,1,70,1,70,0.629752000,0.0000
194.105.236.216,<->,129.224.112.252,0,0,1,83,1,83,0.629622000,0.0000
129.224.112.253,<->,33.110.84.133,1,79,0,0,1,79,0.629282000,0.0000
129.175.139.97,<->,29.211.214.32,0,0,1,121,1,121,0.628768000,0.0000
133.178.226.246,<->,8.181.148.191,1,90,0,0,1,90,0.628531000,0.0000
111.4.160.48,<->,109.222.246.201,0,0,1,72,1,72,0.628036000,0.0000
144.75.218.246,<->,138.127.224.134,1,366,0,0,1,366,0.626837000,0.0000
129.224.112.252,<->,105.69.92.96,1,67,0,0,1,67,0.626372000,0.0000
21.15.226.126,<->,20.193.62.180,0,0,1,82,1,82,0.626027000,0.0000
139.163.1.182,<->,64.76.59.13,1,73,0,0,1,73,0.626023000,0.0000
129.224.112.252,<->,105.67.198.52,1,60,0,0,1,60,0.626020000,0.0000
193.47.198.199,<->,8.53.8.151,0,0,1,67,1,67,0.625149000,0.0000
196.31.80.207,<->,89.183.104.254,0,0,1,52,1,52,0.624656000,0.0000
215.158.239.226,<->,53.85.130.165,1,343,0,0,1,343,0.624425000,0.0000
144.85.74.147,<->,95.5.80.232,1,78,0,0,1,78,0.623823000,0.0000
42.48.61.109,<->,20.194.127.11,0,0,1,84,1,84,0.623462000,0.0000
204.129.248.132,<->,111.147.184.124,0,0,1,50,1,50,0.622465000,0.0000
21.15.226.126,<->,20.193.62.175,0,0,1,82,1,82,0.622258000,0.0000
80.40.56.250,<->,69.255.253.238,1,62,0,0,1,62,0.622129000,0.0000
202.198.184.100,<->,92.181.30.186,0,0,1,133,1,133,0.621141000,0.0000
144.75.218.235,<->,138.127.231.127,1,300,0,0,1,300,0.620637000,0.0000
215.158.238.162,<->,126.219.102.216,1,85,0,0,1,85,0.619886000,0.0000
210.150.233.86,<->,50.224.103.163,0,0,1,82,1,82,0.619626000,0.0000
136.25.189.245,<->,8.35.106.225,1,90,0,0,1,90,0.619623000,0.0000
205.186.197.249,<->,92.27.219.224,0,0,1,135,1,135,0.619153000,0.0000
115.146.247.141,<->,92.27.219.221,0,0,1,52,1,52,0.618701000,0.0000
144.75.218.242,<->,63.69.219.68,1,151,0,0,1,151,0.616692000,0.0000
139.252.1.230,<->,136.25.189.5,0,0,1,150,1,150,0.616481000,0.0000
143.43.193.150,<->,20.55.81.183,0,0,1,80,1,80,0.616242000,0.0000
80.40.47.46,<->,38.176.33.155,1,130,0,0,1,130,0.614898000,0.0000
144.75.218.246,<->,61.72.2.11,1,184,0,0,1,184,0.614861000,0.0000
75.189.136.225,<->,39.131.50.38,0,0,1,73,1,73,0.614510000,0.0000
89.183.104.137,<->,29.90.24.187,1,52,0,0,1,52,0.613996000,0.0000
192.67.149.36,<->,27.41.97.78,1,135,0,0,1,135,0.613037000,0.0000
206.16.142.172,<->,109.222.192.55,0,0,1,98,1,98,0.612728000,0.0000
92.27.27.175,<->,69.175.125.228,1,55,0,0,1,55,0.611814000,0.0000
193.88.67.36,<->,92.27.219.203,0,0,1,133,1,133,0.611762000,0.0000
101.122.133.46,<->,17.3.209.41,1,1101,0,0,1,1101,0.609912000,0.0000
109.222.215.151,<->,43.40.65.48,1,66,0,0,1,66,0.609418000,0.0000
215.158.103.206,<->,138.127.224.101,1,84,0,0,1,84,0.609213000,0.0000
145.116.223.24,<->,136.25.189.5,0,0,1,105,1,105,0.608965000,0.0000
159.69.187.23,<->,144.108.80.174,1,63,0,0,1,63,0.608917000,0.0000
247.136.199.176,<->,206.193.40.158,1,133,0,0,1,133,0.608412000,0.0000
247.136.231.91,<->,126.254.93.101,1,151,0,0,1,151,0.608399000,0.0000
136.129.66.2,<->,4.129.155.120,1,98,0,0,1,98,0.604921000,0.0000
206.141.76.213,<->,22.59.8.212,0,0,1,57,1,57,0.604539000,0.0000
148.129.33.51,<->,80.42.150.137,0,0,1,319,1,319,0.604525000,0.0000
192.67.160.166,<->,112.179.117.29,1,309,0,0,1,309,0.604461000,0.0000
192.64.217.166,<->,119.74.223.209,1,52,0,0,1,52,0.603793000,0.0000
109.1.17.59,<->,27.188.163.162,1,445,0,0,1,445,0.603255000,0.0000
215.158.239.120,<->,158.85.35.245,1,111,0,0,1,111,0.602742000,0.0000
129.224.112.252,<->,97.203.79.109,1,85,0,0,1,85,0.601739000,0.0000
215.158.238.161,<->,38.30.142.248,1,84,0,0,1,84,0.601153000,0.0000
111.71.7.41,<->,92.27.27.167,0,0,1,80,1,80,0.600881000,0.0000
146.200.130.17,<->,20.10.108.125,0,0,1,128,1,128,0.600272000,0.0000
78.129.196.251,<->,39.15.169.14,0,0,1,87,1,87,0.600239000,0.0000
197.19.51.22,<->,39.29.190.79,0,0,1,136,1,136,0.599836000,0.0000
104.133.149.237,<->,92.27.219.184,0,0,1,52,1,52,0.599831000,0.0000
102.224.161.182,<->,13.13.239.177,1,66,0,0,1,66,0.599660000,0.0000
8.176.8.215,<->,8.33.227.3,1,112,0,0,1,112,0.599028000,0.0000
96.228.67.219,<->,8.176.8.211,0,0,1,175,1,175,0.598349000,0.0000
102.224.161.182,<->,33.43.48.64,1,66,0,0,1,66,0.597942000,0.0000
144.75.218.242,<->,138.127.231.255,1,268,0,0,1,268,0.596870000,0.0000
159.57.86.226,<->,144.75.218.241,0,0,1,200,1,200,0.596291000,0.0000
145.172.91.126,<->,92.27.219.61,0,0,1,197,1,197,0.596181000,0.0000
129.224.112.252,<->,129.209.91.81,1,67,0,0,1,67,0.595654000,0.0000
144.122.240.242,<->,144.69.101.193,1,87,0,0,1,87,0.595096000,0.0000
158.163.154.138,<->,80.41.53.34,0,0,1,323,1,323,0.594950000,0.0000
196.25.219.50,<->,99.72.161.96,0,0,1,321,1,321,0.594881000,0.0000
198.126.17.101,<->,8.228.214.155,0,0,1,135,1,135,0.594515000,0.0000
21.15.226.126,<->,20.193.62.245,0,0,1,82,1,82,0.594490000,0.0000
80.40.37.166,<->,42.90.92.230,1,88,0,0,1,88,0.594189000,0.0000
21.15.226.126,<->,20.193.62.246,0,0,1,82,1,82,0.592215000,0.0000
92.27.219.38,<->,73.71.104.177,1,52,0,0,1,52,0.591707000,0.0000
136.25.188.105,<->,99.115.245.101,1,338,0,0,1,338,0.591379000,0.0000
121.204.192.178,<->,92.27.219.187,0,0,1,77,1,77,0.590165000,0.0000
55.53.96.252,<->,8.228.209.63,0,0,1,77,1,77,0.589657000,0.0000
148.249.205.202,<->,39.196.108.21,0,0,1,75,1,75,0.588521000,0.0000
210.157.133.68,<->,89.183.104.178,0,0,1,52,1,52,0.588500000,0.0000
109.222.250.168,<->,107.255.237.151,1,69,0,0,1,69,0.587519000,0.0000
149.76.140.130,<->,92.27.219.210,0,0,1,120,1,120,0.586843000,0.0000
254.75.90.114,<->,92.27.219.224,0,0,1,106,1,106,0.586381000,0.0000
21.15.226.126,<->,20.193.55.141,0,0,1,82,1,82,0.585226000,0.0000
117.228.237.160,<->,92.27.209.236,0,0,1,57,1,57,0.584698000,0.0000
144.75.218.235,<->,138.127.230.228,1,366,0,0,1,366,0.584238000,0.0000
247.136.133.19,<->,127.210.82.224,1,135,0,0,1,135,0.583859000,0.0000
127.112.186.151,<->,92.27.219.43,0,0,1,52,1,52,0.582717000,0.0000
220.83.18.46,<->,156.142.17.231,1,133,0,0,1,133,0.582700000,0.0000
144.75.218.246,<->,138.127.224.10,1,241,0,0,1,241,0.581486000,0.0000
142.175.13.70,<->,99.75.234.175,0,0,1,133,1,133,0.581051000,0.0000
112.6.187.180,<->,39.62.136.53,0,0,1,68,1,68,0.579279000,0.0000
92.27.219.191,<->,50.163.36.233,1,52,0,0,1,52,0.578191000,0.0000
80.41.40.188,<->,42.239.97.78,1,298,0,0,1,298,0.577804000,0.0000
120.83.21.29,<->,92.27.219.197,0,0,1,309,1,309,0.577324000,0.0000
144.75.218.235,<->,89.154.144.66,1,80,0,0,1,80,0.577014000,0.0000
57.100.247.124,<->,56.121.37.92,0,0,1,69,1,69,0.576255000,0.0000
215.158.140.13,<->,138.127.230.203,1,290,0,0,1,290,0.575571000,0.0000
21.15.226.126,<->,20.193.55.123,0,0,1,82,1,82,0.575498000,0.0000
102.45.225.190,<->,97.126.26.39,0,0,1,62,1,62,0.575271000,0.0000
215.158.239.237,<->,112.103.134.95,1,89,0,0,1,89,0.573774000,0.0000
89.183.104.246,<->,64.214.61.236,1,52,0,0,1,52,0.573635000,0.0000
139.47.239.142,<->,129.187.19.186,1,74,0,0,1,74,0.573550000,0.0000
118.141.40.138,<->,80.42.175.248,0,0,1,52,1,52,0.572103000,0.0000
110.155.32.46,<->,109.1.59.159,0,0,1,77,1,77,0.572062000,0.0000
199.20.74.163,<->,109.222.241.65,0,0,1,149,1,149,0.571283000,0.0000
144.75.218.246,<->,128.203.247.101,1,89,0,0,1,89,0.571116000,0.0000
103.17.11.235,<->,101.122.134.124,0,0,1,1496,1,1496,0.569971000,0.0000
149.147.3.128,<->,132.249.70.233,0,0,1,150,1,150,0.569840000,0.0000
126.215.125.89,<->,92.27.219.193,0,0,1,373,1,373,0.567677000,0.0000
152.130.101.225,<->,98.217.116.59,0,0,1,135,1,135,0.566819000,0.0000
138.127.225.205,<->,97.126.26.70,0,0,1,277,1,277,0.566599000,0.0000
193.28.156.197,<->,136.25.189.86,0,0,1,84,1,84,0.564669000,0.0000
118.149.114.113,<->,80.41.16.104,0,0,1,133,1,133,0.564292000,0.0000
215.158.103.219,<->,128.176.179.33,1,260,0,0,1,260,0.564167000,0.0000
218.4.187.87,<->,134.185.116.206,1,99,0,0,1,99,0.563663000,0.0000
194.207.113.238,<->,139.207.222.11,0,0,1,91,1,91,0.563313000,0.0000
144.122.240.234,<->,144.108.64.185,1,74,0,0,1,74,0.563259000,0.0000
105.120.253.39,<->,101.224.204.193,0,0,1,350,1,350,0.562187000,0.0000
132.168.198.94,<->,99.30.53.247,1,77,0,0,1,77,0.561452000,0.0000
199.15.114.33,<->,56.121.49.77,0,0,1,52,1,52,0.560719000,0.0000
66.90.102.244,<->,34.100.96.54,0,0,1,408,1,408,0.560695000,0.0000
144.75.218.242,<->,100.117.27.56,1,288,0,0,1,288,0.560328000,0.0000
141.92.219.216,<->,129.224.112.252,0,0,1,79,1,79,0.559918000,0.0000
89.183.104.191,<->,65.60.169.114,1,52,0,0,1,52,0.559022000,0.0000
132.107.75.195,<->,111.147.206.130,0,0,1,764,1,764,0.558798000,0.0000
200.174.213.196,<->,139.79.72.238,1,52,0,0,1,52,0.557875000,0.0000
138.98.246.1,<->,136.117.93.137,1,120,0,0,1,120,0.556715000,0.0000
205.236.10.86,<->,97.168.124.101,0,0,1,135,1,135,0.556625000,0.0000
111.151.107.247,<->,8.176.8.71,0,0,1,119,1,119,0.556393000,0.0000
198.254.35.214,<->,80.40.23.183,0,0,1,130,1,130,0.556389000,0.0000
133.45.77.233,<->,92.27.27.185,0,0,1,80,1,80,0.556265000,0.0000
246.253.248.210,<->,53.150.234.220,1,88,0,0,1,88,0.555461000,0.0000
60.102.23.64,<->,34.186.147.158,0,0,1,52,1,52,0.555391000,0.0000
144.76.46.38,<->,99.73.41.205,0,0,1,158,1,158,0.555165000,0.0000
57.195.38.86,<->,20.128.171.146,0,0,1,140,1,140,0.554719000,0.0000
94.24.2.177,<->,89.183.104.176,0,0,1,52,1,52,0.554639000,0.0000
207.61.250.182,<->,109.222.242.9,0,0,1,133,1,133,0.554549000,0.0000
215.158.49.32,<->,29.211.214.254,0,0,1,93,1,93,0.553171000,0.0000
208.250.159.17,<->,136.25.188.105,0,0,1,247,1,247,0.553152000,0.0000
192.64.225.224,<->,93.93.180.74,1,59,0,0,1,59,0.553034000,0.0000
205.81.94.28,<->,20.117.123.128,0,0,1,531,1,531,0.552449000,0.0000
210.60.115.65,<->,102.51.167.35,0,0,1,136,1,136,0.552149000,0.0000
132.180.214.237,<->,80.56.78.128,0,0,1,90,1,90,0.552007000,0.0000
139.163.161.57,<->,136.25.188.228,0,0,1,106,1,106,0.550880000,0.0000
192.67.136.193,<->,131.187.212.157,1,52,0,0,1,52,0.549552000,0.0000
136.25.188.228,<->,8.220.7.141,1,129,0,0,1,129,0.549312000,0.0000
215.158.239.120,<->,131.49.94.82,1,199,0,0,1,199,0.548264000,0.0000
193.0.126.28,<->,20.193.222.246,0,0,1,76,1,76,0.546339000,0.0000
144.122.240.237,<->,98.119.212.204,1,75,0,0,1,75,0.546291000,0.0000
145.154.11.50,<->,80.56.78.92,0,0,1,94,1,94,0.545970000,0.0000
105.201.221.207,<->,102.50.236.87,0,0,1,342,1,342,0.545683000,0.0000
74.240.111.222,<->,39.247.17.160,0,0,1,52,1,52,0.544404000,0.0000
152.132.171.243,<->,102.81.141.95,0,0,1,135,1,135,0.542558000,0.0000
21.15.226.126,<->,20.193.55.76,0,0,1,82,1,82,0.542463000,0.0000
144.75.218.246,<->,113.180.95.20,1,87,0,0,1,87,0.542024000,0.0000
123.61.21.253,<->,92.27.219.56,0,0,1,52,1,52,0.541852000,0.0000
113.149.166.94,<->,20.205.188.94,0,0,1,82,1,82,0.541100000,0.0000
215.158.239.182,<->,111.151.107.247,1,109,0,0,1,109,0.541086000,0.0000
145.89.194.40,<->,69.155.129.29,1,133,0,0,1,133,0.541006000,0.0000
215.158.103.219,<->,208.186.165.27,1,176,0,0,1,176,0.539689000,0.0000
245.36.48.253,<->,92.27.209.104,0,0,1,57,1,57,0.539400000,0.0000
92.27.219.37,<->,29.221.165.171,1,293,0,0,1,293,0.539312000,0.0000
193.24.150.240,<->,20.65.77.106,0,0,1,74,1,74,0.538980000,0.0000
215.158.103.219,<->,53.74.147.102,1,84,0,0,1,84,0.538682000,0.0000
21.15.226.126,<->,20.193.55.60,0,0,1,82,1,82,0.537666000,0.0000
104.67.149.22,<->,39.9.119.18,0,0,1,205,1,205,0.537330000,0.0000
158.236.199.232,<->,92.27.219.186,0,0,1,119,1,119,0.536641000,0.0000
80.28.127.235,<->,20.215.28.95,0,0,1,130,1,130,0.535957000,0.0000
199.6.230.219,<->,99.73.7.110,0,0,1,100,1,100,0.535825000,0.0000
77.57.4.146,<->,20.162.52.126,0,0,1,52,1,52,0.535605000,0.0000
125.0.210.158,<->,80.42.138.177,0,0,1,102,1,102,0.535392000,0.0000
215.158.239.120,<->,33.209.211.2,1,111,0,0,1,111,0.535353000,0.0000
159.13.155.136,<->,53.245.2.193,1,173,0,0,1,173,0.534752000,0.0000
206.69.124.84,<->,80.41.19.144,0,0,1,52,1,52,0.534604000,0.0000
192.67.160.161,<->,88.152.22.110,1,52,0,0,1,52,0.532815000,0.0000
144.75.218.241,<->,17.136.21.99,1,147,0,0,1,147,0.532613000,0.0000
121.252.146.7,<->,100.92.34.81,0,0,1,325,1,325,0.532469000,0.0000
118.131.209.62,<->,101.70.127.0,0,0,1,74,1,74,0.532008000,0.0000
205.36.103.208,<->,20.164.129.62,0,0,1,135,1,135,0.531956000,0.0000
144.75.218.246,<->,65.95.70.36,1,212,0,0,1,212,0.531350000,0.0000
139.252.0.243,<->,56.121.49.50,0,0,1,154,1,154,0.526674000,0.0000
21.15.226.126,<->,20.193.54.71,0,0,1,82,1,82,0.525810000,0.0000
201.7.56.152,<->,192.64.215.135,0,0,1,321,1,321,0.525556000,0.0000
132.230.26.160,<->,48.53.6.253,0,0,1,97,1,97,0.525445000,0.0000
210.226.164.31,<->,18.80.190.251,1,73,0,0,1,73,0.524867000,0.0000
144.75.218.241,<->,138.127.230.27,1,359,0,0,1,359,0.524845000,0.0000
210.226.164.31,<->,54.42.135.102,1,65,0,0,1,65,0.524678000,0.0000
66.82.254.66,<->,34.198.231.134,0,0,1,129,1,129,0.524382000,0.0000
146.188.233.245,<->,92.27.219.132,0,0,1,213,1,213,0.523799000,0.0000
192.242.185.97,<->,20.134.143.27,0,0,1,80,1,80,0.523576000,0.0000
113.127.211.18,<->,92.27.219.190,0,0,1,52,1,52,0.523155000,0.0000
194.247.68.124,<->,20.23.114.165,0,0,1,78,1,78,0.523003000,0.0000
133.171.115.67,<->,131.133.154.159,1,84,0,0,1,84,0.522687000,0.0000
132.5.71.202,<->,97.126.119.191,0,0,1,435,1,435,0.522118000,0.0000
194.193.103.88,<->,100.92.38.121,0,0,1,66,1,66,0.518863000,0.0000
205.228.199.160,<->,92.27.219.163,0,0,1,52,1,52,0.518399000,0.0000
144.57.226.233,<->,139.248.201.139,0,0,1,80,1,80,0.518311000,0.0000
215.158.239.240,<->,8.181.148.227,1,90,0,0,1,90,0.518158000,0.0000
215.158.140.168,<->,120.155.87.47,1,137,0,0,1,137,0.518062000,0.0000
206.17.164.193,<->,192.64.195.195,0,0,1,52,1,52,0.517763000,0.0000
92.27.219.159,<->,30.192.53.215,1,102,0,0,1,102,0.517649000,0.0000
159.64.148.13,<->,144.122.240.196,0,0,1,88,1,88,0.517567000,0.0000
98.67.158.136,<->,79.58.237.62,1,76,0,0,1,76,0.516615000,0.0000
247.136.223.75,<->,124.243.26.28,1,97,0,0,1,97,0.516391000,0.0000
255.133.223.252,<->,221.95.62.8,0,0,1,80,1,80,0.515072000,0.0000
92.27.27.185,<->,57.59.47.200,1,52,0,0,1,52,0.514377000,0.0000
136.246.92.113,<->,92.27.219.205,0,0,1,52,1,52,0.514283000,0.0000
127.18.252.200,<->,109.222.205.45,0,0,1,76,1,76,0.514283000,0.0000
143.34.37.188,<->,39.44.61.15,0,0,1,80,1,80,0.513561000,0.0000
134.98.5.37,<->,109.222.243.81,0,0,1,147,1,147,0.513412000,0.0000
80.41.25.41,<->,57.156.213.42,1,73,0,0,1,73,0.513351000,0.0000
210.158.44.220,<->,128.156.80.162,1,90,0,0,1,90,0.512850000,0.0000
199.83.47.13,<->,92.27.27.166,0,0,1,135,1,135,0.510013000,0.0000
159.137.138.173,<->,139.7.227.58,1,82,0,0,1,82,0.509736000,0.0000
201.211.227.212,<->,89.183.104.166,0,0,1,61,1,61,0.509071000,0.0000
217.11.189.9,<->,20.192.130.71,0,0,1,443,1,443,0.509004000,0.0000
92.27.219.208,<->,66.1.74.3,1,52,0,0,1,52,0.507808000,0.0000
116.145.98.56,<->,80.42.204.150,0,0,1,138,1,138,0.506939000,0.0000
93.101.192.84,<->,92.27.219.145,0,0,1,52,1,52,0.506533000,0.0000
109.222.221.234,<->,83.95.154.244,1,76,0,0,1,76,0.505442000,0.0000
145.252.116.252,<->,98.219.126.40,1,78,0,0,1,78,0.503876000,0.0000
129.224.112.252,<->,92.162.219.79,1,104,0,0,1,104,0.502902000,0.0000
192.171.13.189,<->,136.25.188.28,0,0,1,157,1,157,0.502639000,0.0000
38.21.156.204,<->,20.232.228.202,0,0,1,82,1,82,0.501551000,0.0000
118.134.127.116,<->,109.222.229.119,0,0,1,76,1,76,0.501466000,0.0000
109.222.255.55,<->,27.139.49.9,1,79,0,0,1,79,0.501281000,0.0000
192.67.175.129,<->,125.25.133.190,1,52,0,0,1,52,0.501244000,0.0000
122.173.165.4,<->,102.51.89.173,0,0,1,130,1,130,0.499634000,0.0000
159.69.187.2,<->,144.108.64.185,1,75,0,0,1,75,0.499466000,0.0000
207.206.173.251,<->,102.50.164.175,0,0,1,52,1,52,0.499259000,0.0000
66.82.117.130,<->,34.130.34.18,0,0,1,80,1,80,0.499135000,0.0000
218.4.180.210,<->,116.47.123.91,1,52,0,0,1,52,0.499088000,0.0000
98.232.172.60,<->,57.211.62.10,1,81,0,0,1,81,0.498777000,0.0000
21.15.226.126,<->,20.193.54.41,0,0,1,82,1,82,0.498400000,0.0000
89.183.104.166,<->,29.251.39.222,1,52,0,0,1,52,0.497053000,0.0000
144.75.218.235,<->,100.185.121.91,1,128,0,0,1,128,0.496829000,0.0000
109.1.51.11,<->,48.110.135.132,1,93,0,0,1,93,0.496095000,0.0000
136.25.189.92,<->,60.99.169.229,1,84,0,0,1,84,0.495762000,0.0000
21.15.226.126,<->,20.193.54.200,0,0,1,82,1,82,0.494163000,0.0000
194.209.186.154,<->,20.10.111.145,0,0,1,76,1,76,0.494031000,0.0000
192.67.149.88,<->,38.180.36.123,1,69,0,0,1,69,0.493900000,0.0000
97.126.114.69,<->,17.188.67.212,1,69,0,0,1,69,0.493592000,0.0000
142.164.244.12,<->,39.150.16.215,0,0,1,68,1,68,0.493031000,0.0000
204.124.37.148,<->,109.222.250.107,0,0,1,52,1,52,0.493007000,0.0000
130.226.129.60,<->,39.202.190.137,0,0,1,74,1,74,0.490801000,0.0000
121.209.70.144,<->,20.77.192.214,0,0,1,72,1,72,0.490629000,0.0000
156.136.120.152,<->,20.61.206.202,0,0,1,74,1,74,0.490466000,0.0000
122.129.100.246,<->,89.183.104.137,0,0,1,52,1,52,0.490001000,0.0000
114.31.119.171,<->,80.40.36.227,0,0,1,132,1,132,0.489555000,0.0000
215.158.2.61,<->,29.211.214.254,0,0,1,90,1,90,0.489522000,0.0000
139.163.5.144,<->,119.6.123.164,1,74,0,0,1,74,0.488393000,0.0000
144.75.218.235,<->,138.127.231.3,1,194,0,0,1,194,0.488301000,0.0000
144.122.240.224,<->,144.108.64.185,1,76,0,0,1,76,0.487378000,0.0000
144.75.218.235,<->,143.204.138.237,1,153,0,0,1,153,0.487286000,0.0000
92.27.27.177,<->,48.108.82.241,1,52,0,0,1,52,0.486838000,0.0000
223.140.130.253,<->,39.18.139.86,0,0,1,62,1,62,0.486836000,0.0000
126.224.150.56,<->,20.253.65.221,0,0,1,72,1,72,0.486619000,0.0000
82.237.232.145,<->,74.51.75.47,1,78,0,0,1,78,0.486206000,0.0000
116.126.69.169,<->,92.27.219.173,0,0,1,80,1,80,0.486120000,0.0000
80.15.251.30,<->,48.53.137.25,0,0,1,156,1,156,0.485947000,0.0000
204.45.238.246,<->,192.67.136.165,0,0,1,135,1,135,0.485557000,0.0000
111.151.107.247,<->,8.176.8.215,0,0,1,163,1,163,0.484810000,0.0000
136.99.57.75,<->,20.249.228.251,0,0,1,70,1,70,0.484119000,0.0000
38.21.156.204,<->,20.232.229.121,0,0,1,82,1,82,0.483333000,0.0000
132.51.6.188,<->,106.188.198.187,1,71,0,0,1,71,0.482731000,0.0000
116.106.38.41,<->,8.252.221.166,0,0,1,85,1,85,0.481076000,0.0000
100.52.156.101,<->,92.27.27.160,0,0,1,117,1,117,0.481054000,0.0000
215.158.2.47,<->,145.108.46.93,0,0,1,89,1,89,0.479206000,0.0000
247.157.36.145,<->,230.72.210.85,1,109,0,0,1,109,0.478532000,0.0000
109.1.17.114,<->,27.188.163.162,1,443,0,0,1,443,0.477424000,0.0000
122.117.43.241,<->,80.40.11.228,0,0,1,52,1,52,0.476942000,0.0000
129.92.114.124,<->,33.0.223.69,1,138,0,0,1,138,0.475816000,0.0000
207.77.30.118,<->,20.182.107.103,0,0,1,75,1,75,0.475266000,0.0000
123.48.57.181,<->,92.27.219.17,0,0,1,52,1,52,0.475087000,0.0000
21.15.226.126,<->,20.193.54.241,0,0,1,82,1,82,0.474849000,0.0000
109.0.253.66,<->,61.91.181.221,1,130,0,0,1,130,0.474450000,0.0000
113.103.98.190,<->,92.27.27.171,0,0,1,62,1,62,0.473876000,0.0000
112.107.203.81,<->,89.183.104.175,0,0,1,52,1,52,0.473542000,0.0000
114.232.65.138,<->,109.222.251.212,0,0,1,70,1,70,0.471433000,0.0000
122.196.70.119,<->,92.27.27.177,0,0,1,135,1,135,0.471401000,0.0000
103.237.45.95,<->,92.27.209.121,0,0,1,80,1,80,0.469961000,0.0000
119.127.4.87,<->,111.147.111.98,0,0,1,135,1,135,0.468756000,0.0000
125.22.35.22,<->,80.41.44.203,0,0,1,133,1,133,0.467508000,0.0000
134.36.81.173,<->,92.27.219.141,0,0,1,52,1,52,0.467239000,0.0000
139.163.13.6,<->,105.168.127.133,1,76,0,0,1,76,0.466305000,0.0000
215.158.239.120,<->,80.57.208.241,1,111,0,0,1,111,0.465903000,0.0000
159.176.32.29,<->,144.75.218.237,0,0,1,76,1,76,0.465053000,0.0000
215.158.239.120,<->,159.137.139.217,1,110,0,0,1,110,0.465004000,0.0000
102.50.242.234,<->,27.14.169.221,1,261,0,0,1,261,0.464563000,0.0000
79.253.14.215,<->,34.83.130.169,0,0,1,52,1,52,0.464206000,0.0000
120.155.84.163,<->,97.126.26.71,0,0,1,138,1,138,0.463952000,0.0000
20.13.112.44,<->,0.200.50.50,1,60,0,0,1,60,0.463475000,0.0000
21.15.226.126,<->,20.193.53.248,0,0,1,82,1,82,0.463194000,0.0000
116.107.67.119,<->,20.119.101.62,0,0,1,72,1,72,0.462745000,0.0000
144.75.221.206,<->,138.98.246.1,0,0,1,122,1,122,0.462673000,0.0000
144.76.46.36,<->,99.75.63.38,0,0,1,126,1,126,0.461134000,0.0000
144.75.218.235,<->,132.208.122.193,1,141,0,0,1,141,0.459453000,0.0000
126.9.199.3,<->,39.232.168.43,0,0,1,96,1,96,0.458348000,0.0000
97.168.80.204,<->,56.24.164.8,1,65,0,0,1,65,0.458204000,0.0000
218.4.190.253,<->,116.244.100.27,1,404,0,0,1,404,0.457870000,0.0000
129.224.112.252,<->,98.166.239.25,1,75,0,0,1,75,0.457579000,0.0000
89.183.104.189,<->,88.152.120.203,1,52,0,0,1,52,0.457247000,0.0000
247.136.223.219,<->,38.53.173.20,1,129,0,0,1,129,0.456428000,0.0000
205.121.93.107,<->,20.6.228.54,0,0,1,78,1,78,0.456062000,0.0000
114.208.34.76,<->,89.183.104.178,0,0,1,321,1,321,0.454527000,0.0000
249.62.21.108,<->,215.158.103.206,0,0,1,103,1,103,0.452935000,0.0000
196.148.130.233,<->,59.168.201.49,1,65,0,0,1,65,0.452879000,0.0000
152.133.60.221,<->,138.73.60.223,0,0,1,130,1,130,0.452876000,0.0000
29.211.214.32,<->,8.240.117.44,1,115,0,0,1,115,0.452728000,0.0000
215.158.239.105,<->,149.201.135.194,1,141,0,0,1,141,0.449947000,0.0000
215.158.239.105,<->,120.154.177.88,1,111,0,0,1,111,0.449751000,0.0000
115.62.40.21,<->,97.126.115.22,0,0,1,75,1,75,0.448098000,0.0000
103.127.138.3,<->,101.70.126.246,0,0,1,70,1,70,0.447885000,0.0000
235.225.213.208,<->,89.183.104.231,0,0,1,52,1,52,0.447184000,0.0000
132.66.49.212,<->,97.126.26.70,0,0,1,574,1,574,0.447056000,0.0000
78.129.196.247,<->,39.15.169.14,0,0,1,87,1,87,0.446978000,0.0000
21.15.226.126,<->,20.193.53.218,0,0,1,82,1,82,0.446907000,0.0000
109.222.244.46,<->,19.215.46.158,1,68,0,0,1,68,0.446799000,0.0000
120.158.207.179,<->,20.170.191.9,0,0,1,72,1,72,0.446372000,0.0000
101.224.186.192,<->,18.200.87.230,1,57,0,0,1,57,0.446237000,0.0000
136.25.189.5,<->,27.178.41.11,1,83,0,0,1,83,0.446213000,0.0000
144.75.218.233,<->,138.127.225.217,1,366,0,0,1,366,0.445011000,0.0000
98.86.101.56,<->,80.41.32.151,0,0,1,69,1,69,0.444607000,0.0000
109.1.9.205,<->,98.231.239.31,1,52,0,0,1,52,0.443784000,0.0000
194.254.157.54,<->,39.14.127.159,0,0,1,144,1,144,0.442893000,0.0000
247.136.181.26,<->,118.191.203.243,1,97,0,0,1,97,0.442744000,0.0000
118.102.82.70,<->,80.41.14.234,0,0,1,321,1,321,0.442180000,0.0000
110.86.133.46,<->,109.1.51.11,0,0,1,325,1,325,0.441993000,0.0000
130.207.46.10,<->,92.27.219.240,0,0,1,88,1,88,0.441785000,0.0000
123.125.227.160,<->,80.42.175.248,0,0,1,61,1,61,0.441580000,0.0000
109.222.205.186,<->,75.95.84.115,1,97,0,0,1,97,0.440973000,0.0000
138.98.246.1,<->,56.17.255.70,1,120,0,0,1,120,0.440544000,0.0000
144.98.6.41,<->,139.241.119.19,0,0,1,76,1,76,0.439573000,0.0000
117.5.66.97,<->,111.146.219.79,0,0,1,158,1,158,0.439278000,0.0000
133.32.1.105,<->,29.99.92.24,1,69,0,0,1,69,0.439069000,0.0000
105.200.28.92,<->,20.207.140.172,0,0,1,74,1,74,0.439059000,0.0000
139.254.213.35,<->,129.224.112.252,0,0,1,76,1,76,0.439024000,0.0000
133.178.226.162,<->,128.23.167.222,1,90,0,0,1,90,0.439010000,0.0000
145.213.37.26,<->,136.129.94.109,0,0,1,84,1,84,0.438824000,0.0000
144.75.218.241,<->,138.127.225.156,1,298,0,0,1,298,0.438082000,0.0000
92.27.219.38,<->,57.151.234.220,1,97,0,0,1,97,0.438067000,0.0000
144.75.218.237,<->,141.15.18.59,1,229,0,0,1,229,0.437534000,0.0000
145.252.119.79,<->,132.43.156.56,1,752,0,0,1,752,0.437312000,0.0000
120.119.65.203,<->,89.183.104.171,0,0,1,52,1,52,0.437207000,0.0000
144.122.240.199,<->,144.108.64.185,1,63,0,0,1,63,0.437198000,0.0000
21.15.226.126,<->,20.193.53.101,0,0,1,82,1,82,0.436253000,0.0000
202.178.8.205,<->,144.64.139.146,0,0,1,67,1,67,0.435748000,0.0000
215.158.238.137,<->,120.155.86.237,1,117,0,0,1,117,0.434936000,0.0000
117.66.147.65,<->,80.41.18.181,0,0,1,1470,1,1470,0.434056000,0.0000
123.89.2.13,<->,92.27.219.132,0,0,1,213,1,213,0.433684000,0.0000
120.155.84.97,<->,98.190.126.215,0,0,1,141,1,141,0.433311000,0.0000
129.201.176.4,<->,97.126.26.70,0,0,1,840,1,840,0.433156000,0.0000
216.73.179.43,<->,20.137.239.172,0,0,1,52,1,52,0.432701000,0.0000
123.58.41.255,<->,92.27.219.169,0,0,1,52,1,52,0.431789000,0.0000
247.136.213.175,<->,33.213.250.150,1,170,0,0,1,170,0.431433000,0.0000
254.199.70.131,<->,109.222.246.242,0,0,1,69,1,69,0.429348000,0.0000
131.144.248.44,<->,129.224.112.252,0,0,1,80,1,80,0.427499000,0.0000
221.196.95.250,<->,89.183.104.136,0,0,1,136,1,136,0.427027000,0.0000
109.222.246.242,<->,99.206.178.33,1,69,0,0,1,69,0.426272000,0.0000
123.129.238.171,<->,39.154.1.169,0,0,1,72,1,72,0.425408000,0.0000
120.155.84.161,<->,92.27.219.42,0,0,1,133,1,133,0.425184000,0.0000
144.75.218.233,<->,138.127.225.213,1,227,0,0,1,227,0.423984000,0.0000
215.158.140.163,<->,130.61.219.1,1,671,0,0,1,671,0.422033000,0.0000
192.67.167.86,<->,108.180.89.175,1,66,0,0,1,66,0.421469000,0.0000
92.27.27.166,<->,27.64.145.201,1,326,0,0,1,326,0.421368000,0.0000
109.1.17.98,<->,27.188.163.162,1,445,0,0,1,445,0.419674000,0.0000
20.13.112.138,<->,0.200.50.50,1,60,0,0,1,60,0.419459000,0.0000
98.67.133.113,<->,40.240.144.244,1,74,0,0,1,74,0.418183000,0.0000
133.178.227.8,<->,89.70.190.180,1,85,0,0,1,85,0.417397000,0.0000
252.64.177.47,<->,247.136.245.208,0,0,1,321,1,321,0.415999000,0.0000
215.158.140.9,<->,56.23.171.110,1,1064,0,0,1,1064,0.415853000,0.0000
144.75.218.233,<->,143.230.117.93,1,248,0,0,1,248,0.415567000,0.0000
136.25.188.105,<->,131.16.151.86,1,135,0,0,1,135,0.415158000,0.0000
230.14.252.62,<->,39.6.171.212,0,0,1,52,1,52,0.414947000,0.0000
80.56.78.128,<->,80.47.34.171,1,101,0,0,1,101,0.414166000,0.0000
192.67.129.253,<->,107.21.28.148,1,76,0,0,1,76,0.413158000,0.0000
215.158.140.170,<->,130.61.230.62,1,678,0,0,1,678,0.412924000,0.0000
144.75.218.242,<->,139.114.208.35,1,131,0,0,1,131,0.412841000,0.0000
241.242.244.237,<->,138.127.227.251,1,233,0,0,1,233,0.412432000,0.0000
198.103.239.241,<->,92.27.219.19,0,0,1,52,1,52,0.412216000,0.0000
120.82.229.76,<->,80.41.16.79,0,0,1,97,1,97,0.412186000,0.0000
99.236.27.146,<->,92.27.219.159,0,0,1,62,1,62,0.411824000,0.0000
144.75.218.237,<->,138.127.230.130,1,253,0,0,1,253,0.411749000,0.0000
136.26.10.226,<->,8.228.217.101,0,0,1,120,1,120,0.410022000,0.0000
218.4.187.87,<->,140.91.191.15,1,99,0,0,1,99,0.409966000,0.0000
193.47.198.119,<->,8.52.161.253,0,0,1,67,1,67,0.407902000,0.0000
215.158.103.219,<->,159.176.32.28,1,76,0,0,1,76,0.407517000,0.0000
144.75.218.235,<->,136.99.66.244,1,174,0,0,1,174,0.406974000,0.0000
112.7.33.113,<->,39.8.201.124,0,0,1,66,1,66,0.405969000,0.0000
158.164.217.111,<->,39.242.94.199,0,0,1,78,1,78,0.405944000,0.0000
92.27.219.244,<->,59.146.81.189,1,52,0,0,1,52,0.405911000,0.0000
157.142.59.66,<->,20.139.218.107,0,0,1,52,1,52,0.405743000,0.0000
57.126.221.209,<->,39.43.98.237,0,0,1,88,1,88,0.405724000,0.0000
92.27.219.207,<->,64.214.63.86,1,62,0,0,1,62,0.403772000,0.0000
122.159.69.87,<->,50.224.110.122,0,0,1,86,1,86,0.402666000,0.0000
192.64.195.164,<->,104.251.192.216,1,50,0,0,1,50,0.402568000,0.0000
145.252.123.206,<->,35.62.71.37,1,68,0,0,1,68,0.402239000,0.0000
97.126.115.199,<->,49.89.97.93,1,78,0,0,1,78,0.402060000,0.0000
133.178.226.162,<->,126.219.197.206,1,90,0,0,1,90,0.401318000,0.0000
105.201.211.173,<->,102.51.227.2,0,0,1,330,1,330,0.401300000,0.0000
192.64.230.47,<->,122.112.203.205,1,52,0,0,1,52,0.400381000,0.0000
147.180.61.51,<->,89.216.126.106,0,0,1,97,1,97,0.400319000,0.0000
143.148.50.173,<->,39.160.238.214,0,0,1,75,1,75,0.399892000,0.0000
132.249.70.233,<->,124.51.228.76,1,159,0,0,1,159,0.399336000,0.0000
80.41.3.230,<->,38.18.60.250,1,135,0,0,1,135,0.397775000,0.0000
104.152.220.2,<->,89.183.104.227,0,0,1,52,1,52,0.396075000,0.0000
124.178.214.131,<->,92.27.219.23,0,0,1,149,1,149,0.395884000,0.0000
215.158.103.219,<->,129.220.171.193,1,782,0,0,1,782,0.395285000,0.0000
197.113.175.58,<->,129.224.112.252,0,0,1,93,1,93,0.395118000,0.0000
144.75.218.235,<->,138.127.225.253,1,291,0,0,1,291,0.394841000,0.0000
109.14.167.30,<->,79.255.66.183,1,130,0,0,1,130,0.394658000,0.0000
215.158.103.219,<->,126.84.20.136,1,166,0,0,1,166,0.394233000,0.0000
215.158.239.105,<->,215.158.214.222,1,141,0,0,1,141,0.394013000,0.0000
247.136.180.69,<->,57.85.32.67,1,149,0,0,1,149,0.393362000,0.0000
111.146.237.145,<->,33.49.23.119,1,135,0,0,1,135,0.393110000,0.0000
92.27.219.33,<->,38.94.255.65,1,58,0,0,1,58,0.393034000,0.0000
207.78.70.240,<->,92.27.219.242,0,0,1,52,1,52,0.392499000,0.0000
197.44.22.113,<->,89.183.104.138,0,0,1,52,1,52,0.391338000,0.0000
144.75.218.235,<->,129.35.251.34,1,136,0,0,1,136,0.390564000,0.0000
130.13.151.57,<->,92.27.219.63,0,0,1,52,1,52,0.390256000,0.0000
121.71.65.35,<->,92.27.219.182,0,0,1,102,1,102,0.390152000,0.0000
92.27.27.164,<->,18.200.206.47,1,315,0,0,1,315,0.390072000,0.0000
117.154.63.56,<->,100.94.16.235,0,0,1,105,1,105,0.389715000,0.0000
126.82.210.35,<->,92.27.219.19,0,0,1,52,1,52,0.389601000,0.0000
210.158.44.231,<->,8.220.7.206,1,149,0,0,1,149,0.389422000,0.0000
220.55.97.182,<->,27.11.68.126,1,148,0,0,1,148,0.389339000,0.0000
118.125.182.41,<->,39.140.92.107,0,0,1,140,1,140,0.388618000,0.0000
127.87.219.139,<->,80.42.165.24,0,0,1,135,1,135,0.388597000,0.0000
146.1.155.25,<->,144.75.218.246,0,0,1,171,1,171,0.388051000,0.0000
89.183.104.234,<->,33.95.62.155,1,321,0,0,1,321,0.387842000,0.0000
141.21.245.250,<->,129.224.112.252,0,0,1,59,1,59,0.387039000,0.0000
144.75.218.246,<->,138.127.230.151,1,68,0,0,1,68,0.386380000,0.0000
77.19.64.23,<->,34.248.11.46,0,0,1,132,1,132,0.385715000,0.0000
117.38.167.80,<->,89.183.104.177,0,0,1,263,1,263,0.385433000,0.0000
141.245.151.215,<->,136.47.66.197,1,85,0,0,1,85,0.384108000,0.0000
21.15.226.126,<->,20.193.52.72,0,0,1,82,1,82,0.382120000,0.0000
218.5.92.23,<->,159.133.63.103,0,0,1,76,1,76,0.382028000,0.0000
123.251.189.247,<->,109.222.250.174,0,0,1,78,1,78,0.381655000,0.0000
139.163.8.52,<->,105.201.221.207,1,88,0,0,1,88,0.381557000,0.0000
129.224.112.252,<->,33.78.13.33,1,79,0,0,1,79,0.380333000,0.0000
129.224.112.252,<->,114.187.168.248,1,70,0,0,1,70,0.379901000,0.0000
156.132.134.164,<->,34.16.125.126,0,0,1,72,1,72,0.379630000,0.0000
102.50.117.189,<->,92.27.27.181,0,0,1,397,1,397,0.379094000,0.0000
192.171.13.189,<->,8.252.222.10,0,0,1,157,1,157,0.378159000,0.0000
192.205.38.247,<->,29.211.214.254,0,0,1,92,1,92,0.377648000,0.0000
198.59.252.179,<->,89.183.104.231,0,0,1,52,1,52,0.376404000,0.0000
196.24.224.171,<->,100.94.72.189,0,0,1,130,1,130,0.376271000,0.0000
215.158.239.105,<->,159.147.253.1,1,220,0,0,1,220,0.376036000,0.0000
220.31.22.169,<->,144.75.218.237,0,0,1,248,1,248,0.375800000,0.0000
127.180.125.49,<->,97.168.91.134,0,0,1,72,1,72,0.375667000,0.0000
102.232.177.73,<->,52.220.244.34,1,71,0,0,1,71,0.375463000,0.0000
144.76.46.38,<->,100.93.238.68,0,0,1,158,1,158,0.374887000,0.0000
38.21.156.204,<->,20.232.229.96,0,0,1,82,1,82,0.374621000,0.0000
192.171.13.189,<->,8.176.8.71,0,0,1,138,1,138,0.373573000,0.0000
148.162.217.87,<->,39.249.24.116,0,0,1,78,1,78,0.372338000,0.0000
210.221.111.210,<->,155.17.159.75,1,109,0,0,1,109,0.372263000,0.0000
113.63.153.121,<->,89.183.104.243,0,0,1,98,1,98,0.371618000,0.0000
147.54.117.181,<->,39.43.170.225,0,0,1,134,1,134,0.370986000,0.0000
146.198.38.34,<->,99.160.105.66,0,0,1,67,1,67,0.370985000,0.0000
109.222.253.48,<->,26.81.16.237,1,75,0,0,1,75,0.369966000,0.0000
215.158.239.105,<->,210.104.195.8,1,256,0,0,1,256,0.368905000,0.0000
125.10.150.102,<->,80.42.160.210,0,0,1,99,1,99,0.368372000,0.0000
216.132.55.74,<->,80.41.16.226,0,0,1,52,1,52,0.368137000,0.0000
144.75.218.237,<->,50.149.206.150,1,205,0,0,1,205,0.367131000,0.0000
144.122.240.194,<->,144.108.80.170,1,61,0,0,1,61,0.366859000,0.0000
192.67.167.86,<->,103.147.216.59,1,83,0,0,1,83,0.366237000,0.0000
192.67.174.62,<->,50.62.255.14,1,97,0,0,1,97,0.365972000,0.0000
95.169.150.140,<->,92.27.219.34,0,0,1,52,1,52,0.365856000,0.0000
109.1.47.253,<->,93.170.103.133,1,50,0,0,1,50,0.365375000,0.0000
108.134.117.140,<->,97.242.126.187,1,75,0,0,1,75,0.364754000,0.0000
21.15.226.126,<->,20.193.52.152,0,0,1,82,1,82,0.364549000,0.0000
146.199.195.194,<->,39.58.191.75,0,0,1,134,1,134,0.364142000,0.0000
215.158.103.206,<->,120.155.87.47,1,102,0,0,1,102,0.363568000,0.0000
156.148.151.114,<->,39.53.120.116,0,0,1,531,1,531,0.363452000,0.0000
144.75.218.242,<->,138.127.224.235,1,306,0,0,1,306,0.362951000,0.0000
21.15.226.126,<->,20.193.52.158,0,0,1,82,1,82,0.362462000,0.0000
133.178.226.161,<->,111.150.207.83,1,163,0,0,1,163,0.362350000,0.0000
215.158.239.105,<->,192.226.44.43,1,111,0,0,1,111,0.362152000,0.0000
144.76.43.234,<->,138.98.141.131,0,0,1,83,1,83,0.361924000,0.0000
144.75.218.242,<->,138.127.225.21,1,254,0,0,1,254,0.360981000,0.0000
144.75.218.237,<->,132.208.122.193,1,133,0,0,1,133,0.360917000,0.0000
247.136.216.15,<->,127.162.227.139,1,50,0,0,1,50,0.359592000,0.0000
193.46.99.114,<->,80.42.150.137,0,0,1,300,1,300,0.358518000,0.0000
206.115.123.105,<->,192.64.224.151,0,0,1,135,1,135,0.357273000,0.0000
192.64.217.166,<->,112.238.34.98,1,52,0,0,1,52,0.356696000,0.0000
215.158.2.59,<->,133.81.199.205,0,0,1,88,1,88,0.355910000,0.0000
21.15.226.126,<->,20.193.52.171,0,0,1,82,1,82,0.355423000,0.0000
137.81.65.54,<->,107.99.228.94,1,77,0,0,1,77,0.354507000,0.0000
21.15.226.126,<->,20.193.52.175,0,0,1,82,1,82,0.354450000,0.0000
128.156.80.162,<->,92.162.252.175,0,0,1,142,1,142,0.353842000,0.0000
131.144.248.40,<->,129.224.112.252,0,0,1,77,1,77,0.352585000,0.0000
132.149.113.27,<->,68.206.114.172,1,130,0,0,1,130,0.352408000,0.0000
105.170.125.212,<->,98.128.84.189,0,0,1,906,1,906,0.352339000,0.0000
144.75.218.233,<->,129.165.131.13,1,189,0,0,1,189,0.351783000,0.0000
144.75.218.237,<->,137.23.166.213,1,279,0,0,1,279,0.351745000,0.0000
247.136.200.213,<->,120.146.111.188,1,319,0,0,1,319,0.351721000,0.0000
199.108.208.102,<->,92.27.219.182,0,0,1,1455,1,1455,0.351591000,0.0000
144.75.218.246,<->,129.127.53.251,1,141,0,0,1,141,0.351468000,0.0000
247.136.161.17,<->,82.106.63.160,1,52,0,0,1,52,0.351404000,0.0000
98.8.84.242,<->,34.93.69.102,0,0,1,134,1,134,0.351028000,0.0000
215.158.2.46,<->,159.123.32.28,0,0,1,88,1,88,0.349590000,0.0000
198.70.237.101,<->,92.27.219.46,0,0,1,52,1,52,0.349445000,0.0000
192.171.13.189,<->,8.252.222.11,0,0,1,143,1,143,0.349068000,0.0000
215.158.140.163,<->,126.219.102.124,1,106,0,0,1,106,0.348171000,0.0000
58.202.16.67,<->,34.9.89.117,0,0,1,52,1,52,0.347519000,0.0000
58.132.245.34,<->,20.182.55.13,0,0,1,52,1,52,0.347222000,0.0000
132.159.118.94,<->,100.230.144.109,1,79,0,0,1,79,0.347022000,0.0000
159.154.230.134,<->,67.103.130.54,1,130,0,0,1,130,0.346265000,0.0000
241.231.183.50,<->,141.92.221.24,1,87,0,0,1,87,0.346219000,0.0000
114.253.132.49,<->,80.40.25.242,0,0,1,61,1,61,0.346037000,0.0000
246.253.248.211,<->,216.184.0.236,1,79,0,0,1,79,0.345421000,0.0000
21.15.226.126,<->,20.193.51.231,0,0,1,82,1,82,0.344345000,0.0000
144.75.218.233,<->,138.127.230.49,1,263,0,0,1,263,0.344100000,0.0000
149.50.109.18,<->,20.138.181.255,0,0,1,75,1,75,0.342018000,0.0000
103.18.240.78,<->,80.40.50.197,0,0,1,52,1,52,0.341754000,0.0000
104.34.67.250,<->,92.27.219.194,0,0,1,135,1,135,0.340789000,0.0000
230.95.236.34,<->,89.181.189.56,0,0,1,130,1,130,0.340420000,0.0000
158.3.202.66,<->,39.8.88.74,0,0,1,78,1,78,0.339838000,0.0000
158.226.109.18,<->,20.20.200.106,0,0,1,80,1,80,0.339634000,0.0000
144.75.218.241,<->,137.132.222.177,1,110,0,0,1,110,0.339607000,0.0000
123.125.71.216,<->,100.94.190.20,0,0,1,52,1,52,0.339283000,0.0000
118.234.22.105,<->,89.183.104.141,0,0,1,52,1,52,0.338882000,0.0000
121.60.236.104,<->,92.27.27.164,0,0,1,349,1,349,0.338704000,0.0000
145.229.2.58,<->,138.68.168.244,0,0,1,347,1,347,0.338305000,0.0000
192.171.13.189,<->,136.25.188.217,0,0,1,138,1,138,0.338282000,0.0000
142.221.194.104,<->,92.27.27.156,0,0,1,351,1,351,0.338056000,0.0000
125.161.104.51,<->,92.27.219.242,0,0,1,52,1,52,0.337962000,0.0000
215.158.30.54,<->,29.211.214.254,0,0,1,87,1,87,0.336792000,0.0000
137.83.251.44,<->,112.17.31.45,1,50,0,0,1,50,0.335045000,0.0000
127.250.253.245,<->,97.126.26.71,0,0,1,82,1,82,0.334733000,0.0000
122.0.180.69,<->,80.41.41.240,0,0,1,135,1,135,0.331422000,0.0000
230.95.83.187,<->,192.64.91.148,0,0,1,133,1,133,0.329939000,0.0000
159.69.187.28,<->,144.108.80.174,1,63,0,0,1,63,0.329405000,0.0000
21.15.226.126,<->,20.193.51.183,0,0,1,82,1,82,0.328871000,0.0000
144.75.218.246,<->,102.45.225.190,1,74,0,0,1,74,0.328537000,0.0000
109.222.242.9,<->,76.75.85.195,1,133,0,0,1,133,0.328056000,0.0000
118.125.238.242,<->,99.75.217.171,0,0,1,76,1,76,0.327906000,0.0000
158.186.230.206,<->,136.181.50.197,0,0,1,169,1,169,0.327896000,0.0000
133.178.226.161,<->,113.92.168.222,1,90,0,0,1,90,0.326954000,0.0000
98.150.107.161,<->,97.126.24.188,0,0,1,50,1,50,0.326855000,0.0000
144.69.82.139,<->,129.19.247.27,1,65,0,0,1,65,0.326498000,0.0000
192.67.152.0,<->,125.5.241.52,1,52,0,0,1,52,0.325874000,0.0000
109.222.253.150,<->,39.247.154.221,1,74,0,0,1,74,0.325799000,0.0000
116.94.248.161,<->,109.222.246.241,0,0,1,76,1,76,0.324744000,0.0000
192.67.159.167,<->,118.51.58.214,1,138,0,0,1,138,0.324384000,0.0000
192.67.133.6,<->,134.103.233.204,1,135,0,0,1,135,0.323937000,0.0000
89.183.104.175,<->,27.41.82.122,1,1431,0,0,1,1431,0.322820000,0.0000
92.27.219.216,<->,42.204.6.217,1,309,0,0,1,309,0.321920000,0.0000
215.158.103.219,<->,138.127.224.207,1,299,0,0,1,299,0.321315000,0.0000
194.105.236.217,<->,129.224.112.252,0,0,1,82,1,82,0.320210000,0.0000
148.127.114.12,<->,92.27.219.50,0,0,1,52,1,52,0.318546000,0.0000
247.136.138.97,<->,104.230.130.153,1,97,0,0,1,97,0.318279000,0.0000
207.74.66.179,<->,20.130.242.39,0,0,1,66,1,66,0.318268000,0.0000
74.235.239.33,<->,39.252.18.244,0,0,1,72,1,72,0.318046000,0.0000
144.75.218.242,<->,138.127.230.139,1,366,0,0,1,366,0.317596000,0.0000
192.64.217.166,<->,127.15.227.181,1,135,0,0,1,135,0.317561000,0.0000
215.158.140.170,<->,97.4.116.236,1,103,0,0,1,103,0.317296000,0.0000
104.9.192.113,<->,92.27.219.148,0,0,1,130,1,130,0.315434000,0.0000
139.163.92.210,<->,65.212.33.33,1,78,0,0,1,78,0.315181000,0.0000
215.158.209.184,<->,215.158.140.170,0,0,1,106,1,106,0.314461000,0.0000
196.27.47.139,<->,102.51.189.104,0,0,1,262,1,262,0.313774000,0.0000
104.67.149.22,<->,39.9.119.23,0,0,1,205,1,205,0.313365000,0.0000
98.129.80.71,<->,59.33.166.136,1,138,0,0,1,138,0.313273000,0.0000
112.79.207.61,<->,89.183.104.138,0,0,1,149,1,149,0.313230000,0.0000
21.15.226.126,<->,20.193.51.161,0,0,1,82,1,82,0.312944000,0.0000
80.42.146.108,<->,33.58.164.61,1,174,0,0,1,174,0.311216000,0.0000
109.222.244.209,<->,75.92.184.28,1,105,0,0,1,105,0.310060000,0.0000
197.156.165.4,<->,39.213.127.191,0,0,1,68,1,68,0.309910000,0.0000
117.2.252.55,<->,92.27.219.250,0,0,1,321,1,321,0.309649000,0.0000
159.87.104.238,<->,129.121.121.12,1,72,0,0,1,72,0.309097000,0.0000
92.27.27.99,<->,29.219.16.87,1,293,0,0,1,293,0.308870000,0.0000
215.158.140.163,<->,29.211.93.14,1,105,0,0,1,105,0.308159000,0.0000
215.158.238.133,<->,56.23.171.247,1,1064,0,0,1,1064,0.308081000,0.0000
109.222.250.107,<->,95.221.85.194,1,877,0,0,1,877,0.307789000,0.0000
205.81.190.171,<->,111.146.169.0,0,0,1,138,1,138,0.307518000,0.0000
116.244.1.168,<->,20.82.95.229,0,0,1,65,1,65,0.307270000,0.0000
144.75.218.233,<->,136.99.66.245,1,174,0,0,1,174,0.306671000,0.0000
101.70.107.137,<->,6.44.81.76,1,66,0,0,1,66,0.306402000,0.0000
140.168.161.68,<->,92.27.27.182,0,0,1,99,1,99,0.306073000,0.0000
215.158.140.163,<->,113.24.0.152,1,134,0,0,1,134,0.305351000,0.0000
100.230.7.112,<->,92.162.252.191,0,0,1,50,1,50,0.304878000,0.0000
105.192.129.57,<->,98.67.140.11,0,0,1,97,1,97,0.304457000,0.0000
246.253.248.210,<->,131.230.134.171,1,86,0,0,1,86,0.304348000,0.0000
89.183.104.252,<->,48.107.168.216,1,52,0,0,1,52,0.303701000,0.0000
196.114.35.219,<->,20.56.131.162,0,0,1,72,1,72,0.303552000,0.0000
144.75.218.237,<->,138.127.225.249,1,265,0,0,1,265,0.303387000,0.0000
149.15.111.138,<->,20.28.157.87,0,0,1,76,1,76,0.303202000,0.0000
144.75.218.241,<->,111.20.61.182,1,86,0,0,1,86,0.302051000,0.0000
193.46.99.193,<->,92.27.218.64,0,0,1,129,1,129,0.301821000,0.0000
113.141.30.72,<->,89.183.104.173,0,0,1,357,1,357,0.300656000,0.0000
159.87.104.238,<->,106.5.213.19,1,83,0,0,1,83,0.300631000,0.0000
197.2.207.32,<->,109.1.61.240,0,0,1,61,1,61,0.299777000,0.0000
246.253.34.209,<->,78.200.213.11,1,52,0,0,1,52,0.299425000,0.0000
192.64.217.166,<->,112.236.179.11,1,52,0,0,1,52,0.299345000,0.0000
92.27.219.48,<->,68.227.114.115,1,52,0,0,1,52,0.297930000,0.0000
129.224.112.252,<->,114.187.50.12,1,79,0,0,1,79,0.297256000,0.0000
144.75.218.235,<->,138.127.224.103,1,365,0,0,1,365,0.297148000,0.0000
122.245.179.149,<->,89.183.104.238,0,0,1,52,1,52,0.296929000,0.0000
193.89.192.220,<->,92.27.219.58,0,0,1,50,1,50,0.296564000,0.0000
21.15.226.126,<->,20.193.48.7,0,0,1,82,1,82,0.296265000,0.0000
192.64.193.89,<->,27.50.54.159,1,135,0,0,1,135,0.295686000,0.0000
117.156.100.40,<->,99.73.202.52,0,0,1,138,1,138,0.295681000,0.0000
202.236.234.97,<->,109.3.149.0,0,0,1,319,1,319,0.295269000,0.0000
109.1.17.76,<->,27.188.163.162,1,447,0,0,1,447,0.295121000,0.0000
246.253.248.210,<->,143.127.56.179,1,87,0,0,1,87,0.294641000,0.0000
118.116.183.59,<->,92.27.219.38,0,0,1,52,1,52,0.293081000,0.0000
206.228.176.15,<->,92.27.219.18,0,0,1,133,1,133,0.293021000,0.0000
138.48.80.166,<->,132.249.70.213,0,0,1,116,1,116,0.293013000,0.0000
215.158.140.163,<->,130.61.208.238,1,671,0,0,1,671,0.292411000,0.0000
92.27.219.49,<->,48.105.23.184,1,52,0,0,1,52,0.292061000,0.0000
121.66.179.101,<->,89.183.104.181,0,0,1,52,1,52,0.291736000,0.0000
21.15.226.126,<->,20.193.48.10,0,0,1,82,1,82,0.291503000,0.0000
193.46.99.163,<->,192.67.152.196,0,0,1,129,1,129,0.291475000,0.0000
144.87.235.187,<->,138.127.224.156,1,292,0,0,1,292,0.291103000,0.0000
138.31.199.102,<->,53.212.157.83,1,74,0,0,1,74,0.290337000,0.0000
127.255.88.114,<->,109.222.195.135,0,0,1,82,1,82,0.290331000,0.0000
122.215.15.158,<->,92.27.209.222,0,0,1,64,1,64,0.289766000,0.0000
134.18.234.58,<->,92.27.27.185,0,0,1,52,1,52,0.288407000,0.0000
136.25.188.105,<->,73.45.221.12,1,203,0,0,1,203,0.288284000,0.0000
246.253.253.12,<->,106.187.78.231,1,116,0,0,1,116,0.287867000,0.0000
215.158.103.219,<->,159.151.89.197,1,137,0,0,1,137,0.287851000,0.0000
215.158.102.78,<->,29.211.214.82,0,0,1,89,1,89,0.287784000,0.0000
21.15.226.126,<->,20.193.48.72,0,0,1,82,1,82,0.287704000,0.0000
152.111.180.244,<->,34.255.14.181,0,0,1,52,1,52,0.287079000,0.0000
218.4.163.23,<->,122.128.183.218,1,52,0,0,1,52,0.286739000,0.0000
195.120.218.250,<->,39.157.97.41,0,0,1,66,1,66,0.284638000,0.0000
147.132.245.136,<->,97.199.155.37,0,0,1,125,1,125,0.284625000,0.0000
143.104.30.210,<->,92.27.219.229,0,0,1,52,1,52,0.284603000,0.0000
203.142.62.61,<->,109.222.220.52,0,0,1,135,1,135,0.284461000,0.0000
129.78.112.176,<->,106.5.213.20,1,70,0,0,1,70,0.284435000,0.0000
111.147.172.190,<->,33.62.52.114,1,307,0,0,1,307,0.283585000,0.0000
21.15.226.126,<->,20.193.48.86,0,0,1,82,1,82,0.282121000,0.0000
136.25.188.105,<->,127.174.45.1,1,117,0,0,1,117,0.280970000,0.0000
80.42.159.249,<->,38.49.54.206,1,105,0,0,1,105,0.280577000,0.0000
215.158.239.223,<->,80.47.154.203,1,90,0,0,1,90,0.280557000,0.0000
144.75.218.241,<->,138.127.230.49,1,324,0,0,1,324,0.280455000,0.0000
192.64.196.68,<->,134.150.128.85,1,52,0,0,1,52,0.279018000,0.0000
144.75.218.235,<->,56.112.1.18,1,297,0,0,1,297,0.278981000,0.0000
92.27.219.253,<->,60.81.96.138,1,135,0,0,1,135,0.277827000,0.0000
247.136.199.176,<->,38.182.1.6,1,52,0,0,1,52,0.276811000,0.0000
144.75.218.237,<->,138.127.231.211,1,242,0,0,1,242,0.276389000,0.0000
141.179.51.33,<->,33.233.141.29,0,0,1,177,1,177,0.276313000,0.0000
133.178.226.163,<->,8.191.10.185,1,1064,0,0,1,1064,0.276109000,0.0000
144.75.218.235,<->,139.252.1.252,1,139,0,0,1,139,0.275806000,0.0000
215.158.238.162,<->,8.50.118.32,1,84,0,0,1,84,0.275571000,0.0000
120.179.18.5,<->,92.27.219.205,0,0,1,52,1,52,0.275240000,0.0000
215.158.103.219,<->,139.252.1.248,1,220,0,0,1,220,0.274970000,0.0000
92.27.27.148,<->,88.1.14.140,1,52,0,0,1,52,0.274815000,0.0000
144.75.218.233,<->,138.127.230.221,1,84,0,0,1,84,0.274533000,0.0000
131.144.248.59,<->,129.224.112.252,0,0,1,78,1,78,0.274415000,0.0000
210.221.110.77,<->,122.3.36.157,1,135,0,0,1,135,0.274164000,0.0000
29.154.35.223,<->,20.198.120.124,0,0,1,50,1,50,0.272895000,0.0000
206.226.123.198,<->,56.121.35.12,0,0,1,111,1,111,0.272728000,0.0000
207.14.190.163,<->,109.222.241.65,0,0,1,138,1,138,0.271219000,0.0000
39.203.251.62,<->,30.191.108.39,1,88,0,0,1,88,0.270279000,0.0000
136.25.188.29,<->,8.220.7.141,1,110,0,0,1,110,0.270171000,0.0000
220.55.64.223,<->,132.43.156.54,1,391,0,0,1,391,0.269060000,0.0000
144.75.218.233,<->,138.127.224.167,1,268,0,0,1,268,0.268830000,0.0000
104.233.32.3,<->,89.183.104.227,0,0,1,52,1,52,0.268562000,0.0000
76.184.54.224,<->,39.237.134.65,0,0,1,70,1,70,0.268217000,0.0000
109.222.241.33,<->,76.228.54.2,1,76,0,0,1,76,0.268059000,0.0000
137.137.75.72,<->,119.214.7.55,1,69,0,0,1,69,0.267242000,0.0000
207.198.136.208,<->,109.222.242.9,0,0,1,135,1,135,0.267106000,0.0000
144.70.164.222,<->,89.183.104.185,0,0,1,164,1,164,0.265969000,0.0000
215.158.66.194,<->,29.211.214.254,0,0,1,114,1,114,0.265537000,0.0000
54.59.43.180,<->,48.53.158.62,0,0,1,52,1,52,0.265521000,0.0000
112.44.56.227,<->,20.165.246.40,0,0,1,68,1,68,0.265479000,0.0000
132.249.71.227,<->,132.249.70.154,0,0,1,283,1,283,0.265427000,0.0000
144.76.44.59,<->,100.93.133.50,0,0,1,85,1,85,0.265372000,0.0000
159.69.187.13,<->,144.108.80.170,1,69,0,0,1,69,0.265322000,0.0000
61.87.95.241,<->,39.254.135.162,0,0,1,52,1,52,0.263594000,0.0000
122.158.179.118,<->,8.252.221.175,0,0,1,83,1,83,0.260607000,0.0000
215.158.239.195,<->,8.220.7.141,1,184,0,0,1,184,0.259493000,0.0000
144.70.196.25,<->,72.204.156.37,1,78,0,0,1,78,0.259399000,0.0000
249.95.65.178,<->,246.253.248.210,0,0,1,82,1,82,0.259137000,0.0000
247.136.199.131,<->,121.245.128.167,1,130,0,0,1,130,0.258647000,0.0000
127.223.55.31,<->,89.183.104.233,0,0,1,52,1,52,0.258646000,0.0000
145.242.126.150,<->,57.1.228.46,1,89,0,0,1,89,0.258350000,0.0000
196.115.29.51,<->,39.15.169.14,0,0,1,86,1,86,0.257831000,0.0000
127.200.190.122,<->,80.40.25.242,0,0,1,61,1,61,0.256257000,0.0000
199.28.91.46,<->,102.51.182.178,0,0,1,138,1,138,0.256253000,0.0000
192.67.167.86,<->,50.109.250.60,1,52,0,0,1,52,0.255583000,0.0000
132.200.51.119,<->,129.224.112.221,0,0,1,68,1,68,0.255422000,0.0000
77.16.86.124,<->,34.146.103.93,0,0,1,52,1,52,0.255265000,0.0000
246.44.63.17,<->,98.231.199.23,1,84,0,0,1,84,0.254859000,0.0000
122.106.32.33,<->,92.27.27.178,0,0,1,102,1,102,0.254786000,0.0000
80.41.19.144,<->,27.186.225.200,1,149,0,0,1,149,0.254396000,0.0000
21.15.226.126,<->,20.193.48.155,0,0,1,82,1,82,0.254287000,0.0000
129.224.112.252,<->,92.162.219.197,1,86,0,0,1,86,0.254041000,0.0000
243.117.125.58,<->,129.224.112.252,0,0,1,78,1,78,0.253974000,0.0000
144.76.43.238,<->,80.56.78.31,0,0,1,88,1,88,0.253596000,0.0000
205.167.137.144,<->,92.27.219.170,0,0,1,100,1,100,0.253562000,0.0000
107.3.232.230,<->,20.163.148.110,0,0,1,74,1,74,0.253057000,0.0000
116.228.36.60,<->,39.48.99.38,0,0,1,90,1,90,0.252839000,0.0000
144.69.82.139,<->,53.163.249.141,1,76,0,0,1,76,0.252831000,0.0000
129.229.242.60,<->,97.126.26.70,0,0,1,637,1,637,0.250590000,0.0000
113.184.255.140,<->,8.228.209.32,0,0,1,76,1,76,0.249462000,0.0000
247.136.152.186,<->,57.46.23.242,1,52,0,0,1,52,0.249199000,0.0000
131.229.28.177,<->,39.155.51.81,0,0,1,76,1,76,0.249177000,0.0000
227.56.190.69,<->,144.75.218.237,0,0,1,128,1,128,0.248117000,0.0000
141.54.113.244,<->,92.27.27.143,0,0,1,135,1,135,0.248029000,0.0000
204.125.111.48,<->,89.183.104.142,0,0,1,52,1,52,0.247502000,0.0000
145.110.55.59,<->,100.185.124.124,1,67,0,0,1,67,0.246910000,0.0000
247.136.240.215,<->,0.47.150.192,1,52,0,0,1,52,0.246309000,0.0000
205.37.92.12,<->,100.93.234.54,0,0,1,80,1,80,0.246218000,0.0000
215.158.103.219,<->,158.235.98.75,1,129,0,0,1,129,0.244999000,0.0000
144.75.218.235,<->,124.57.86.149,1,133,0,0,1,133,0.244495000,0.0000
156.159.3.122,<->,39.241.209.211,0,0,1,76,1,76,0.243741000,0.0000
21.15.226.126,<->,20.193.49.243,0,0,1,82,1,82,0.243638000,0.0000
144.75.218.233,<->,102.45.225.190,1,79,0,0,1,79,0.243311000,0.0000
106.213.68.182,<->,20.225.145.108,0,0,1,91,1,91,0.242156000,0.0000
145.10.90.235,<->,20.15.48.254,0,0,1,79,1,79,0.241397000,0.0000
97.126.117.77,<->,74.11.146.36,1,75,0,0,1,75,0.240998000,0.0000
254.242.186.223,<->,193.58.6.142,1,544,0,0,1,544,0.240907000,0.0000
57.176.114.210,<->,33.233.141.43,0,0,1,181,1,181,0.240460000,0.0000
207.78.145.120,<->,102.50.89.64,0,0,1,52,1,52,0.240215000,0.0000
132.43.156.54,<->,80.38.62.78,0,0,1,271,1,271,0.240032000,0.0000
192.67.158.69,<->,125.178.10.70,1,321,0,0,1,321,0.239765000,0.0000
230.114.137.29,<->,34.56.142.22,0,0,1,52,1,52,0.239657000,0.0000
92.27.219.159,<->,42.210.179.82,1,52,0,0,1,52,0.239430000,0.0000
114.233.163.117,<->,92.27.219.203,0,0,1,52,1,52,0.238871000,0.0000
138.127.230.2,<->,97.126.26.71,0,0,1,227,1,227,0.238725000,0.0000
98.67.136.52,<->,53.64.4.18,1,75,0,0,1,75,0.238067000,0.0000
148.122.200.44,<->,80.40.14.171,0,0,1,68,1,68,0.237108000,0.0000
59.43.254.143,<->,34.236.217.103,0,0,1,132,1,132,0.235917000,0.0000
197.156.2.4,<->,92.27.219.249,0,0,1,52,1,52,0.235401000,0.0000
21.15.226.126,<->,20.193.49.230,0,0,1,82,1,82,0.234819000,0.0000
144.75.218.246,<->,138.127.230.33,1,366,0,0,1,366,0.234797000,0.0000
109.222.214.24,<->,98.150.107.182,1,50,0,0,1,50,0.234741000,0.0000
192.67.167.86,<->,110.55.21.179,1,52,0,0,1,52,0.233806000,0.0000
132.249.70.213,<->,98.60.126.27,1,126,0,0,1,126,0.233165000,0.0000
144.75.218.237,<->,138.127.225.27,1,366,0,0,1,366,0.232183000,0.0000
119.214.81.185,<->,39.63.255.88,0,0,1,66,1,66,0.231836000,0.0000
80.40.48.126,<->,58.164.1.58,1,133,0,0,1,133,0.231672000,0.0000
192.64.223.86,<->,88.158.96.85,1,52,0,0,1,52,0.230403000,0.0000
144.75.218.246,<->,143.89.38.224,1,174,0,0,1,174,0.230353000,0.0000
120.241.123.129,<->,92.27.219.163,0,0,1,52,1,52,0.229909000,0.0000
112.40.30.109,<->,92.27.219.165,0,0,1,52,1,52,0.229809000,0.0000
65.67.142.90,<->,20.188.210.191,0,0,1,52,1,52,0.228801000,0.0000
21.15.226.126,<->,20.193.49.216,0,0,1,82,1,82,0.228489000,0.0000
107.97.115.181,<->,92.27.219.38,0,0,1,80,1,80,0.228386000,0.0000
195.61.230.12,<->,39.132.89.30,0,0,1,68,1,68,0.228254000,0.0000
215.158.140.111,<->,141.204.127.17,1,711,0,0,1,711,0.226989000,0.0000
159.123.17.187,<->,144.81.143.55,1,244,0,0,1,244,0.226190000,0.0000
132.249.70.233,<->,132.43.156.54,1,366,0,0,1,366,0.226137000,0.0000
109.222.204.142,<->,53.190.154.67,1,91,0,0,1,91,0.225967000,0.0000
215.158.238.69,<->,29.214.109.116,1,85,0,0,1,85,0.224611000,0.0000
116.180.1.221,<->,92.27.219.22,0,0,1,329,1,329,0.224552000,0.0000
92.27.219.218,<->,33.75.241.254,1,52,0,0,1,52,0.224168000,0.0000
141.204.127.17,<->,80.27.155.177,0,0,1,770,1,770,0.223590000,0.0000
136.25.189.7,<->,120.155.84.162,1,145,0,0,1,145,0.223191000,0.0000
92.27.219.29,<->,50.106.153.97,1,213,0,0,1,213,0.223164000,0.0000
128.32.74.204,<->,92.27.219.38,0,0,1,171,1,171,0.223096000,0.0000
144.122.240.209,<->,144.108.80.170,1,72,0,0,1,72,0.222928000,0.0000
215.158.238.163,<->,139.106.73.252,1,85,0,0,1,85,0.222626000,0.0000
109.222.253.179,<->,94.254.151.249,1,68,0,0,1,68,0.222560000,0.0000
139.241.116.90,<->,129.224.112.252,0,0,1,81,1,81,0.222491000,0.0000
111.147.114.15,<->,98.150.171.73,1,120,0,0,1,120,0.221689000,0.0000
135.76.10.106,<->,20.159.151.24,0,0,1,70,1,70,0.221536000,0.0000
230.74.143.176,<->,89.181.159.131,0,0,1,138,1,138,0.221354000,0.0000
97.126.113.186,<->,89.59.163.56,1,65,0,0,1,65,0.220605000,0.0000
216.248.130.197,<->,192.64.201.230,0,0,1,317,1,317,0.220165000,0.0000
109.222.242.9,<->,57.25.19.14,1,135,0,0,1,135,0.220139000,0.0000
131.46.106.108,<->,129.224.112.253,0,0,1,79,1,79,0.219990000,0.0000
120.155.87.66,<->,8.176.8.94,0,0,1,142,1,142,0.219534000,0.0000
144.75.218.242,<->,61.72.0.237,1,182,0,0,1,182,0.218309000,0.0000
144.76.46.38,<->,99.73.216.23,0,0,1,130,1,130,0.218086000,0.0000
215.158.103.206,<->,149.169.27.6,1,113,0,0,1,113,0.217717000,0.0000
138.127.227.231,<->,136.99.189.93,0,0,1,231,1,231,0.217218000,0.0000
145.242.126.212,<->,22.50.111.16,1,84,0,0,1,84,0.216935000,0.0000
112.122.80.33,<->,109.1.25.177,0,0,1,135,1,135,0.216385000,0.0000
89.183.104.151,<->,38.94.249.76,1,52,0,0,1,52,0.214780000,0.0000
247.136.199.131,<->,0.235.53.64,1,135,0,0,1,135,0.214295000,0.0000
118.122.93.165,<->,97.126.45.209,0,0,1,62,1,62,0.213752000,0.0000
97.126.116.12,<->,76.243.226.34,1,70,0,0,1,70,0.213643000,0.0000
117.228.237.160,<->,92.27.26.161,0,0,1,57,1,57,0.213576000,0.0000
198.252.57.150,<->,89.183.104.146,0,0,1,102,1,102,0.213563000,0.0000
144.75.218.235,<->,120.155.84.160,1,160,0,0,1,160,0.213522000,0.0000
79.126.130.209,<->,8.228.216.133,0,0,1,65,1,65,0.211964000,0.0000
159.69.187.44,<->,145.213.37.25,1,81,0,0,1,81,0.211130000,0.0000
142.115.117.86,<->,39.53.4.98,0,0,1,70,1,70,0.210590000,0.0000
144.69.82.139,<->,106.183.227.126,1,70,0,0,1,70,0.210359000,0.0000
247.136.139.26,<->,235.229.248.237,1,321,0,0,1,321,0.209634000,0.0000
21.15.226.126,<->,20.193.49.126,0,0,1,82,1,82,0.209226000,0.0000
159.69.187.81,<->,144.108.80.170,1,73,0,0,1,73,0.208875000,0.0000
207.76.252.185,<->,100.93.226.244,0,0,1,78,1,78,0.208817000,0.0000
144.232.206.81,<->,6.74.105.34,0,0,1,52,1,52,0.207431000,0.0000
101.70.119.178,<->,42.54.4.230,1,73,0,0,1,73,0.207016000,0.0000
104.232.96.226,<->,39.218.181.127,0,0,1,92,1,92,0.207004000,0.0000
121.189.158.110,<->,20.6.36.107,0,0,1,80,1,80,0.205704000,0.0000
192.67.174.38,<->,104.48.135.250,1,52,0,0,1,52,0.204570000,0.0000
101.70.119.178,<->,61.52.123.61,1,73,0,0,1,73,0.204058000,0.0000
246.253.248.211,<->,53.162.7.29,1,88,0,0,1,88,0.203862000,0.0000
98.217.78.34,<->,74.240.206.47,1,138,0,0,1,138,0.202958000,0.0000
20.13.113.158,<->,0.200.50.50,1,60,0,0,1,60,0.201700000,0.0000
129.221.194.218,<->,97.126.26.70,0,0,1,764,1,764,0.201359000,0.0000
8.222.7.155,<->,8.176.8.60,0,0,1,1064,1,1064,0.200346000,0.0000
21.15.226.126,<->,20.193.49.108,0,0,1,82,1,82,0.200333000,0.0000
158.157.46.189,<->,92.27.235.58,0,0,1,138,1,138,0.200309000,0.0000
144.75.218.235,<->,138.127.224.160,1,233,0,0,1,233,0.200115000,0.0000
159.69.187.47,<->,144.108.64.183,1,65,0,0,1,65,0.200071000,0.0000
247.136.188.124,<->,121.195.8.117,1,343,0,0,1,343,0.199667000,0.0000
21.15.226.126,<->,20.193.49.110,0,0,1,82,1,82,0.198817000,0.0000
95.77.81.114,<->,34.182.191.36,0,0,1,52,1,52,0.198569000,0.0000
156.148.228.171,<->,34.69.154.140,0,0,1,135,1,135,0.198211000,0.0000
119.131.30.232,<->,100.92.32.36,0,0,1,105,1,105,0.197951000,0.0000
97.94.229.155,<->,56.121.54.98,0,0,1,687,1,687,0.197194000,0.0000
144.75.218.241,<->,53.162.176.63,1,83,0,0,1,83,0.196033000,0.0000
159.69.187.23,<->,144.108.64.184,1,65,0,0,1,65,0.195385000,0.0000
215.158.239.245,<->,122.158.176.232,1,1112,0,0,1,1112,0.195089000,0.0000
159.81.1.22,<->,132.249.70.233,0,0,1,355,1,355,0.194290000,0.0000
192.64.196.68,<->,29.198.187.160,1,135,0,0,1,135,0.194076000,0.0000
204.136.193.126,<->,39.26.17.188,0,0,1,80,1,80,0.194019000,0.0000
133.178.226.255,<->,56.97.187.145,1,89,0,0,1,89,0.193677000,0.0000
124.86.160.236,<->,39.61.169.227,0,0,1,80,1,80,0.193560000,0.0000
134.169.126.159,<->,89.183.104.249,0,0,1,193,1,193,0.193193000,0.0000
136.172.238.246,<->,92.27.219.47,0,0,1,331,1,331,0.192867000,0.0000
144.108.64.184,<->,97.199.169.50,0,0,1,70,1,70,0.191622000,0.0000
92.27.27.165,<->,8.47.122.177,1,126,0,0,1,126,0.191237000,0.0000
109.222.231.67,<->,106.18.141.73,1,69,0,0,1,69,0.191178000,0.0000
203.48.1.38,<->,39.216.85.179,0,0,1,70,1,70,0.191025000,0.0000
139.163.84.114,<->,109.48.94.18,1,73,0,0,1,73,0.190390000,0.0000
144.75.218.237,<->,130.61.250.228,1,140,0,0,1,140,0.188773000,0.0000
21.15.226.126,<->,20.193.49.95,0,0,1,82,1,82,0.188226000,0.0000
206.222.44.212,<->,92.27.219.134,0,0,1,147,1,147,0.186841000,0.0000
137.137.75.72,<->,0.247.67.42,1,62,0,0,1,62,0.186584000,0.0000
122.201.39.217,<->,89.183.104.231,0,0,1,62,1,62,0.186138000,0.0000
192.67.143.198,<->,115.185.23.246,1,319,0,0,1,319,0.184960000,0.0000
144.75.218.237,<->,139.254.118.32,1,163,0,0,1,163,0.184951000,0.0000
133.8.0.39,<->,50.224.76.131,0,0,1,79,1,79,0.184893000,0.0000
210.113.152.194,<->,144.81.142.226,1,102,0,0,1,102,0.183726000,0.0000
194.159.61.237,<->,129.224.112.252,0,0,1,76,1,76,0.183512000,0.0000
126.87.3.138,<->,99.73.153.222,0,0,1,62,1,62,0.183295000,0.0000
80.42.163.111,<->,0.195.46.144,1,135,0,0,1,135,0.182994000,0.0000
134.47.233.28,<->,92.27.219.19,0,0,1,103,1,103,0.182489000,0.0000
74.133.208.61,<->,39.225.125.120,0,0,1,52,1,52,0.181764000,0.0000
118.219.171.125,<->,89.183.104.246,0,0,1,62,1,62,0.180444000,0.0000
152.134.175.21,<->,34.136.235.105,0,0,1,126,1,126,0.179827000,0.0000
109.222.239.143,<->,86.113.249.211,1,69,0,0,1,69,0.179243000,0.0000
202.218.28.35,<->,100.182.162.67,0,0,1,583,1,583,0.179085000,0.0000
124.22.63.79,<->,39.236.54.14,0,0,1,74,1,74,0.178821000,0.0000
109.1.17.129,<->,27.188.163.162,1,444,0,0,1,444,0.178552000,0.0000
140.21.2.175,<->,39.160.87.110,0,0,1,70,1,70,0.178478000,0.0000
215.158.42.138,<->,136.25.188.26,0,0,1,1064,1,1064,0.177312000,0.0000
113.171.75.11,<->,101.70.98.5,0,0,1,135,1,135,0.177164000,0.0000
111.20.172.70,<->,101.224.89.174,0,0,1,78,1,78,0.175857000,0.0000
247.136.145.168,<->,127.161.24.212,1,52,0,0,1,52,0.175631000,0.0000
215.158.140.11,<->,128.157.72.138,1,117,0,0,1,117,0.175445000,0.0000
144.82.14.49,<->,129.224.112.252,0,0,1,84,1,84,0.174891000,0.0000
111.151.107.247,<->,8.176.8.97,0,0,1,166,1,166,0.172175000,0.0000
111.150.187.57,<->,6.73.247.150,0,0,1,106,1,106,0.172119000,0.0000
144.95.255.201,<->,109.222.246.240,0,0,1,468,1,468,0.171993000,0.0000
144.87.235.187,<->,138.127.225.69,1,229,0,0,1,229,0.170490000,0.0000
248.225.27.2,<->,95.221.82.237,1,52,0,0,1,52,0.169057000,0.0000
132.168.197.16,<->,52.102.236.155,1,65,0,0,1,65,0.167276000,0.0000
215.158.30.56,<->,29.211.214.254,0,0,1,94,1,94,0.166421000,0.0000
215.158.238.180,<->,132.58.23.96,1,155,0,0,1,155,0.166238000,0.0000
159.137.138.173,<->,133.8.0.39,1,79,0,0,1,79,0.165978000,0.0000
131.145.83.75,<->,92.27.219.244,0,0,1,52,1,52,0.164799000,0.0000
134.21.38.250,<->,92.27.219.43,0,0,1,52,1,52,0.163627000,0.0000
148.3.52.53,<->,144.85.74.113,0,0,1,187,1,187,0.162778000,0.0000
109.1.17.133,<->,27.188.163.162,1,446,0,0,1,446,0.162412000,0.0000
142.183.80.32,<->,92.27.219.149,0,0,1,1457,1,1457,0.161741000,0.0000
133.0.67.60,<->,108.11.71.121,1,395,0,0,1,395,0.161695000,0.0000
143.194.53.201,<->,80.38.33.214,0,0,1,519,1,519,0.159580000,0.0000
89.183.104.164,<->,50.163.69.12,1,52,0,0,1,52,0.159324000,0.0000
97.168.64.242,<->,42.90.92.188,1,88,0,0,1,88,0.159306000,0.0000
193.46.99.139,<->,8.228.219.176,0,0,1,129,1,129,0.159241000,0.0000
207.79.69.173,<->,100.95.244.53,0,0,1,62,1,62,0.158451000,0.0000
21.15.226.126,<->,20.193.40.119,0,0,1,82,1,82,0.157704000,0.0000
145.252.122.164,<->,132.43.156.54,1,260,0,0,1,260,0.157196000,0.0000
144.75.218.233,<->,138.127.225.221,1,365,0,0,1,365,0.156633000,0.0000
129.224.112.252,<->,41.137.22.107,1,85,0,0,1,85,0.155672000,0.0000
136.25.189.93,<->,8.219.184.149,1,83,0,0,1,83,0.155627000,0.0000
148.145.80.227,<->,145.252.123.97,0,0,1,84,1,84,0.155593000,0.0000
146.226.226.225,<->,144.75.218.246,0,0,1,82,1,82,0.154780000,0.0000
109.222.239.143,<->,102.103.77.216,1,71,0,0,1,71,0.154611000,0.0000
218.4.180.233,<->,137.64.13.252,1,85,0,0,1,85,0.154407000,0.0000
129.254.99.2,<->,129.224.112.252,0,0,1,67,1,67,0.153953000,0.0000
215.158.140.13,<->,145.234.87.73,1,1064,0,0,1,1064,0.153923000,0.0000
132.249.70.213,<->,56.115.253.42,1,117,0,0,1,117,0.152375000,0.0000
118.221.39.205,<->,92.27.219.226,0,0,1,149,1,149,0.152113000,0.0000
159.69.187.21,<->,144.108.64.183,1,64,0,0,1,64,0.151514000,0.0000
136.25.188.105,<->,93.12.2.192,1,115,0,0,1,115,0.151339000,0.0000
144.75.218.235,<->,138.127.231.117,1,254,0,0,1,254,0.150425000,0.0000
215.158.140.19,<->,139.252.1.230,1,150,0,0,1,150,0.149575000,0.0000
109.1.23.143,<->,93.174.65.127,1,50,0,0,1,50,0.149228000,0.0000
109.222.244.209,<->,93.167.142.44,1,213,0,0,1,213,0.149225000,0.0000
111.151.107.247,<->,8.252.223.245,0,0,1,112,1,112,0.148938000,0.0000
132.249.70.233,<->,109.203.229.64,1,148,0,0,1,148,0.148732000,0.0000
229.59.1.46,<->,144.86.151.120,0,0,1,75,1,75,0.148492000,0.0000
114.64.216.52,<->,92.27.219.145,0,0,1,135,1,135,0.148315000,0.0000
215.158.140.111,<->,139.252.33.121,1,106,0,0,1,106,0.148013000,0.0000
93.181.153.134,<->,92.27.219.187,0,0,1,52,1,52,0.147762000,0.0000
21.15.226.126,<->,20.193.40.97,0,0,1,82,1,82,0.147471000,0.0000
144.75.218.233,<->,138.127.231.98,1,355,0,0,1,355,0.146732000,0.0000
246.253.252.54,<->,137.254.128.4,1,116,0,0,1,116,0.146727000,0.0000
123.58.158.133,<->,92.27.219.159,0,0,1,52,1,52,0.146418000,0.0000
116.129.34.166,<->,80.41.32.232,0,0,1,130,1,130,0.146166000,0.0000
89.183.104.151,<->,8.47.122.95,1,368,0,0,1,368,0.146034000,0.0000
210.156.204.25,<->,77.21.127.1,1,99,0,0,1,99,0.145313000,0.0000
194.50.141.12,<->,129.224.112.252,0,0,1,84,1,84,0.143934000,0.0000
21.15.226.126,<->,20.193.40.72,0,0,1,82,1,82,0.143837000,0.0000
59.43.228.12,<->,50.162.22.58,0,0,1,130,1,130,0.143701000,0.0000
119.19.115.29,<->,92.27.219.212,0,0,1,52,1,52,0.143247000,0.0000
159.69.187.20,<->,144.108.80.170,1,70,0,0,1,70,0.142232000,0.0000
252.253.21.235,<->,139.207.222.11,0,0,1,91,1,91,0.140683000,0.0000
210.156.155.20,<->,66.222.188.102,1,130,0,0,1,130,0.140653000,0.0000
138.127.225.201,<->,89.216.125.35,0,0,1,233,1,233,0.140153000,0.0000
130.7.224.243,<->,39.192.133.218,0,0,1,246,1,246,0.138726000,0.0000
64.151.7.177,<->,39.37.194.165,0,0,1,74,1,74,0.138436000,0.0000
80.40.51.106,<->,33.70.117.88,1,193,0,0,1,193,0.138399000,0.0000
94.39.161.169,<->,39.129.254.142,0,0,1,52,1,52,0.138157000,0.0000
192.67.152.0,<->,127.85.120.31,1,135,0,0,1,135,0.138027000,0.0000
195.69.119.68,<->,20.106.150.158,0,0,1,66,1,66,0.137901000,0.0000
202.178.8.66,<->,144.69.82.139,0,0,1,66,1,66,0.136854000,0.0000
159.31.207.156,<->,77.38.63.32,1,213,0,0,1,213,0.136806000,0.0000
144.75.218.242,<->,138.127.230.15,1,366,0,0,1,366,0.136693000,0.0000
123.158.42.91,<->,89.183.104.246,0,0,1,135,1,135,0.136021000,0.0000
144.75.218.242,<->,130.61.211.1,1,91,0,0,1,91,0.136008000,0.0000
215.158.103.206,<->,144.72.25.35,1,208,0,0,1,208,0.135608000,0.0000
158.189.37.55,<->,144.75.218.246,0,0,1,88,1,88,0.135602000,0.0000
144.75.218.237,<->,138.127.230.79,1,262,0,0,1,262,0.135517000,0.0000
57.176.114.210,<->,33.233.141.72,0,0,1,181,1,181,0.134888000,0.0000
80.41.57.193,<->,64.214.27.68,1,62,0,0,1,62,0.134508000,0.0000
123.86.222.193,<->,109.222.213.94,0,0,1,321,1,321,0.133169000,0.0000
139.36.120.222,<->,6.73.247.72,0,0,1,1064,1,1064,0.133088000,0.0000
210.220.219.152,<->,138.127.224.90,1,250,0,0,1,250,0.132157000,0.0000
92.27.219.181,<->,29.170.244.6,1,351,0,0,1,351,0.131551000,0.0000
149.113.167.89,<->,80.42.189.6,0,0,1,373,1,373,0.130911000,0.0000
21.15.226.126,<->,20.193.40.232,0,0,1,82,1,82,0.130762000,0.0000
109.1.17.136,<->,27.188.163.162,1,447,0,0,1,447,0.129726000,0.0000
247.136.161.187,<->,74.253.156.4,1,130,0,0,1,130,0.129680000,0.0000
65.57.89.237,<->,39.135.171.205,0,0,1,80,1,80,0.129663000,0.0000
144.75.218.233,<->,138.127.230.98,1,366,0,0,1,366,0.129171000,0.0000
144.76.44.59,<->,100.95.30.204,0,0,1,104,1,104,0.129157000,0.0000
215.158.3.42,<->,29.211.214.32,0,0,1,95,1,95,0.128118000,0.0000
115.159.174.25,<->,89.183.104.179,0,0,1,102,1,102,0.127979000,0.0000
195.56.196.75,<->,92.27.219.175,0,0,1,132,1,132,0.126828000,0.0000
247.136.143.180,<->,103.102.107.103,1,138,0,0,1,138,0.126581000,0.0000
101.106.122.69,<->,92.27.219.157,0,0,1,135,1,135,0.125920000,0.0000
109.222.253.134,<->,80.157.173.15,1,80,0,0,1,80,0.125352000,0.0000
92.27.219.228,<->,33.156.47.131,1,135,0,0,1,135,0.125340000,0.0000
197.68.217.227,<->,39.35.72.49,0,0,1,78,1,78,0.124752000,0.0000
129.1.109.243,<->,105.170.21.183,1,258,0,0,1,258,0.123315000,0.0000
119.203.29.53,<->,109.1.25.177,0,0,1,97,1,97,0.122017000,0.0000
132.208.68.222,<->,92.27.219.62,0,0,1,612,1,612,0.120415000,0.0000
196.30.93.119,<->,99.75.116.169,0,0,1,133,1,133,0.119884000,0.0000
159.69.187.29,<->,144.108.80.170,1,74,0,0,1,74,0.119667000,0.0000
121.77.89.131,<->,20.193.13.103,0,0,1,66,1,66,0.119535000,0.0000
246.253.253.79,<->,138.127.231.3,1,274,0,0,1,274,0.118943000,0.0000
129.224.112.252,<->,42.119.57.109,1,81,0,0,1,81,0.118874000,0.0000
215.158.103.206,<->,138.127.230.247,1,332,0,0,1,332,0.118666000,0.0000
92.27.27.148,<->,78.48.155.49,1,136,0,0,1,136,0.118124000,0.0000
206.195.154.29,<->,99.75.116.59,0,0,1,324,1,324,0.117793000,0.0000
159.115.105.190,<->,64.214.44.95,1,77,0,0,1,77,0.116432000,0.0000
144.75.218.235,<->,139.254.119.192,1,163,0,0,1,163,0.116014000,0.0000
215.158.238.12,<->,145.213.46.36,1,1064,0,0,1,1064,0.115764000,0.0000
109.1.9.216,<->,100.176.233.172,1,94,0,0,1,94,0.115501000,0.0000
109.222.203.124,<->,106.255.129.196,1,70,0,0,1,70,0.115385000,0.0000
230.126.45.98,<->,34.146.122.74,0,0,1,52,1,52,0.115355000,0.0000
149.164.189.49,<->,144.75.218.246,0,0,1,87,1,87,0.114832000,0.0000
93.64.108.3,<->,8.228.208.18,0,0,1,94,1,94,0.114259000,0.0000
111.20.172.70,<->,101.224.89.153,0,0,1,283,1,283,0.113867000,0.0000
210.221.107.50,<->,8.220.7.141,1,114,0,0,1,114,0.113346000,0.0000
215.158.140.64,<->,58.49.163.215,1,85,0,0,1,85,0.113287000,0.0000
144.75.218.237,<->,138.127.231.221,1,246,0,0,1,246,0.113243000,0.0000
157.210.206.227,<->,34.223.219.192,0,0,1,80,1,80,0.113236000,0.0000
111.20.172.70,<->,33.233.141.10,0,0,1,284,1,284,0.112736000,0.0000
111.20.172.70,<->,111.20.168.9,0,0,1,153,1,153,0.112699000,0.0000
144.75.218.237,<->,138.127.230.75,1,259,0,0,1,259,0.112293000,0.0000
53.199.195.19,<->,39.15.169.14,0,0,1,87,1,87,0.111882000,0.0000
109.1.51.39,<->,29.219.94.61,1,321,0,0,1,321,0.111686000,0.0000
111.20.172.70,<->,101.224.89.178,0,0,1,289,1,289,0.111379000,0.0000
21.15.226.126,<->,20.193.41.142,0,0,1,82,1,82,0.111067000,0.0000
145.242.126.41,<->,53.177.245.183,1,80,0,0,1,80,0.111054000,0.0000
101.224.89.225,<->,89.155.8.207,1,165,0,0,1,165,0.110895000,0.0000
192.64.211.17,<->,125.202.240.38,1,331,0,0,1,331,0.110862000,0.0000
215.158.238.33,<->,139.36.120.222,1,1064,0,0,1,1064,0.110339000,0.0000
224.148.203.58,<->,89.204.254.169,1,238,0,0,1,238,0.110312000,0.0000
119.225.116.131,<->,92.27.27.172,0,0,1,52,1,52,0.109302000,0.0000
115.172.202.133,<->,20.15.122.79,0,0,1,80,1,80,0.108866000,0.0000
144.75.218.246,<->,138.127.224.171,1,254,0,0,1,254,0.108739000,0.0000
138.127.224.104,<->,97.126.31.65,0,0,1,273,1,273,0.108198000,0.0000
207.201.28.147,<->,20.207.104.118,0,0,1,78,1,78,0.108006000,0.0000
129.224.112.252,<->,92.160.15.151,1,74,0,0,1,74,0.107598000,0.0000
200.174.210.184,<->,6.147.99.23,1,135,0,0,1,135,0.107567000,0.0000
106.177.44.73,<->,20.21.245.186,0,0,1,80,1,80,0.107172000,0.0000
193.10.105.251,<->,92.27.27.150,0,0,1,52,1,52,0.106981000,0.0000
111.20.172.70,<->,33.233.141.116,0,0,1,284,1,284,0.106082000,0.0000
148.27.67.32,<->,109.222.214.116,0,0,1,334,1,334,0.106022000,0.0000
109.1.17.143,<->,27.188.163.162,1,446,0,0,1,446,0.105919000,0.0000
97.68.226.205,<->,96.114.3.72,1,84,0,0,1,84,0.105816000,0.0000
121.242.114.74,<->,80.40.38.153,0,0,1,317,1,317,0.104867000,0.0000
104.209.8.29,<->,20.248.239.41,0,0,1,90,1,90,0.104182000,0.0000
148.145.2.123,<->,101.224.204.141,0,0,1,80,1,80,0.103589000,0.0000
38.21.156.204,<->,20.232.229.47,0,0,1,82,1,82,0.103529000,0.0000
111.20.172.70,<->,33.233.141.35,0,0,1,296,1,296,0.103111000,0.0000
105.201.211.173,<->,100.95.179.115,0,0,1,330,1,330,0.102071000,0.0000
144.86.148.0,<->,97.4.79.164,1,328,0,0,1,328,0.101873000,0.0000
235.231.70.149,<->,89.183.104.182,0,0,1,52,1,52,0.101389000,0.0000
92.27.27.154,<->,66.244.13.112,1,102,0,0,1,102,0.101054000,0.0000
159.69.187.5,<->,144.76.43.238,1,75,0,0,1,75,0.100994000,0.0000
97.125.2.62,<->,20.240.46.64,0,0,1,66,1,66,0.100596000,0.0000
132.249.70.213,<->,101.229.93.37,1,106,0,0,1,106,0.098190000,0.0000
111.20.172.70,<->,33.233.141.41,0,0,1,284,1,284,0.098084000,0.0000
92.27.5.225,<->,6.74.81.60,0,0,1,237,1,237,0.097447000,0.0000
129.236.64.228,<->,129.224.112.252,0,0,1,84,1,84,0.097131000,0.0000
159.69.187.28,<->,144.108.80.170,1,78,0,0,1,78,0.096971000,0.0000
89.183.104.236,<->,57.98.252.180,1,147,0,0,1,147,0.096930000,0.0000
101.81.167.0,<->,89.183.104.186,0,0,1,52,1,52,0.096930000,0.0000
97.126.115.69,<->,46.223.205.111,1,71,0,0,1,71,0.096596000,0.0000
118.213.163.32,<->,92.27.27.177,0,0,1,309,1,309,0.096585000,0.0000
144.75.218.241,<->,132.200.124.228,1,189,0,0,1,189,0.096325000,0.0000
109.222.203.196,<->,77.68.220.47,1,74,0,0,1,74,0.095012000,0.0000
109.222.244.223,<->,84.218.178.97,1,66,0,0,1,66,0.094983000,0.0000
133.178.226.200,<->,8.220.7.141,1,163,0,0,1,163,0.094526000,0.0000
193.26.139.230,<->,39.164.72.145,0,0,1,70,1,70,0.094277000,0.0000
132.234.110.226,<->,20.206.36.216,0,0,1,70,1,70,0.093891000,0.0000
132.168.199.107,<->,75.144.222.194,1,75,0,0,1,75,0.093717000,0.0000
92.27.219.244,<->,67.240.107.172,1,52,0,0,1,52,0.093319000,0.0000
101.70.105.2,<->,38.70.90.237,1,96,0,0,1,96,0.093023000,0.0000
89.183.104.229,<->,38.64.182.46,1,52,0,0,1,52,0.092500000,0.0000
121.2.160.45,<->,80.42.134.4,0,0,1,130,1,130,0.092237000,0.0000
136.129.54.117,<->,77.11.199.239,1,133,0,0,1,133,0.092190000,0.0000
139.69.162.91,<->,80.56.78.208,0,0,1,82,1,82,0.092168000,0.0000
109.121.30.241,<->,20.218.116.168,0,0,1,89,1,89,0.092151000,0.0000
138.127.230.65,<->,97.126.26.70,0,0,1,261,1,261,0.091055000,0.0000
253.180.78.131,<->,80.40.3.132,0,0,1,321,1,321,0.090376000,0.0000
198.11.20.6,<->,92.27.219.40,0,0,1,52,1,52,0.090145000,0.0000
197.172.92.167,<->,101.70.105.2,0,0,1,96,1,96,0.090118000,0.0000
215.158.140.13,<->,8.218.118.27,1,1064,0,0,1,1064,0.089981000,0.0000
101.106.122.69,<->,92.27.27.156,0,0,1,138,1,138,0.089807000,0.0000
144.70.164.217,<->,109.222.253.89,0,0,1,68,1,68,0.088434000,0.0000
215.158.3.213,<->,80.56.78.94,0,0,1,87,1,87,0.087726000,0.0000
92.27.219.17,<->,27.187.59.205,1,138,0,0,1,138,0.087665000,0.0000
129.224.112.252,<->,92.162.219.32,1,73,0,0,1,73,0.087646000,0.0000
111.20.172.70,<->,33.233.141.76,0,0,1,307,1,307,0.087567000,0.0000
120.95.205.61,<->,89.183.104.146,0,0,1,102,1,102,0.087524000,0.0000
148.155.131.220,<->,101.224.89.159,0,0,1,161,1,161,0.086594000,0.0000
129.224.112.252,<->,113.24.138.85,1,83,0,0,1,83,0.086548000,0.0000
132.58.234.78,<->,39.255.143.133,0,0,1,66,1,66,0.085964000,0.0000
195.1.224.116,<->,102.51.8.102,0,0,1,138,1,138,0.084481000,0.0000
215.158.239.231,<->,192.171.13.190,1,120,0,0,1,120,0.084395000,0.0000
92.27.219.160,<->,29.27.248.15,1,52,0,0,1,52,0.083898000,0.0000
246.253.253.230,<->,100.225.82.253,1,91,0,0,1,91,0.082691000,0.0000
109.222.255.7,<->,41.241.188.79,1,78,0,0,1,78,0.082529000,0.0000
230.126.147.103,<->,192.67.182.164,0,0,1,133,1,133,0.082362000,0.0000
140.55.246.203,<->,16.139.9.35,0,0,1,52,1,52,0.081789000,0.0000
89.183.104.181,<->,42.204.53.59,1,326,0,0,1,326,0.081645000,0.0000
111.20.172.70,<->,33.233.141.119,0,0,1,293,1,293,0.081371000,0.0000
99.247.176.88,<->,8.228.219.4,0,0,1,147,1,147,0.080876000,0.0000
229.42.57.91,<->,89.183.104.182,0,0,1,52,1,52,0.079936000,0.0000
192.229.40.101,<->,133.178.226.95,0,0,1,84,1,84,0.078651000,0.0000
131.224.216.95,<->,89.183.104.135,0,0,1,52,1,52,0.077883000,0.0000
88.122.137.238,<->,0.195.210.46,0,0,1,1373,1,1373,0.076615000,0.0000
131.226.206.47,<->,39.32.114.93,0,0,1,70,1,70,0.076548000,0.0000
144.75.218.237,<->,138.127.224.171,1,254,0,0,1,254,0.076493000,0.0000
138.127.224.104,<->,101.224.89.252,0,0,1,293,1,293,0.076285000,0.0000
192.67.149.158,<->,105.185.224.18,1,130,0,0,1,130,0.075250000,0.0000
144.75.218.242,<->,138.127.231.72,1,168,0,0,1,168,0.075128000,0.0000
201.223.146.32,<->,92.27.27.153,0,0,1,52,1,52,0.074335000,0.0000
201.8.175.76,<->,8.228.214.59,0,0,1,120,1,120,0.074160000,0.0000
138.127.225.208,<->,111.20.168.13,0,0,1,232,1,232,0.073824000,0.0000
97.126.26.70,<->,80.56.76.30,1,114,0,0,1,114,0.072685000,0.0000
80.41.53.160,<->,57.123.246.235,1,135,0,0,1,135,0.072383000,0.0000
101.73.153.37,<->,4.9.45.56,1,68,0,0,1,68,0.072196000,0.0000
105.67.124.147,<->,8.52.165.247,0,0,1,75,1,75,0.071906000,0.0000
21.15.226.126,<->,20.193.41.106,0,0,1,82,1,82,0.071531000,0.0000
144.75.218.246,<->,138.127.224.113,1,365,0,0,1,365,0.071463000,0.0000
129.236.100.150,<->,129.224.112.252,0,0,1,77,1,77,0.071433000,0.0000
136.25.189.86,<->,29.214.109.249,1,84,0,0,1,84,0.071007000,0.0000
144.122.240.221,<->,144.108.80.170,1,69,0,0,1,69,0.070315000,0.0000
144.75.218.233,<->,99.187.128.217,1,203,0,0,1,203,0.069175000,0.0000
117.83.36.110,<->,80.42.160.210,0,0,1,52,1,52,0.069048000,0.0000
109.1.34.223,<->,27.150.244.150,1,334,0,0,1,334,0.068127000,0.0000
138.127.225.202,<->,101.224.89.180,0,0,1,282,1,282,0.068027000,0.0000
196.28.164.84,<->,99.72.132.173,0,0,1,62,1,62,0.067486000,0.0000
109.222.251.123,<->,108.242.8.175,1,73,0,0,1,73,0.067410000,0.0000
197.57.227.125,<->,20.121.29.24,0,0,1,74,1,74,0.067369000,0.0000
138.127.224.104,<->,111.20.168.154,0,0,1,276,1,276,0.066946000,0.0000
144.76.46.38,<->,99.75.159.71,0,0,1,129,1,129,0.066082000,0.0000
215.158.103.206,<->,158.225.58.19,1,126,0,0,1,126,0.066011000,0.0000
109.222.213.122,<->,90.150.165.141,1,65,0,0,1,65,0.065666000,0.0000
109.222.251.123,<->,79.202.246.0,1,73,0,0,1,73,0.065467000,0.0000
138.127.224.225,<->,33.233.141.39,0,0,1,234,1,234,0.065286000,0.0000
145.242.126.223,<->,6.94.58.6,1,80,0,0,1,80,0.064703000,0.0000
89.183.104.178,<->,27.122.135.142,1,52,0,0,1,52,0.064436000,0.0000
129.236.100.68,<->,129.224.112.252,0,0,1,70,1,70,0.064417000,0.0000
144.75.218.242,<->,138.127.230.104,1,257,0,0,1,257,0.064398000,0.0000
111.20.172.70,<->,33.233.141.75,0,0,1,292,1,292,0.064163000,0.0000
138.127.225.117,<->,101.224.89.159,0,0,1,167,1,167,0.064071000,0.0000
198.180.230.241,<->,92.27.219.193,0,0,1,106,1,106,0.063408000,0.0000
89.183.104.153,<->,30.58.151.59,1,100,0,0,1,100,0.063128000,0.0000
129.236.64.99,<->,129.224.112.221,0,0,1,76,1,76,0.062762000,0.0000
139.114.178.207,<->,102.50.202.136,0,0,1,116,1,116,0.062739000,0.0000
206.96.224.104,<->,89.183.104.151,0,0,1,135,1,135,0.062672000,0.0000
144.122.240.202,<->,144.108.64.183,1,64,0,0,1,64,0.061969000,0.0000
247.136.226.75,<->,198.251.121.255,1,135,0,0,1,135,0.061834000,0.0000
66.222.225.226,<->,6.74.208.29,0,0,1,130,1,130,0.061459000,0.0000
149.96.34.220,<->,20.105.217.52,0,0,1,118,1,118,0.059156000,0.0000
129.236.64.112,<->,129.224.112.252,0,0,1,76,1,76,0.058789000,0.0000
144.75.218.235,<->,99.197.78.193,1,76,0,0,1,76,0.056451000,0.0000
144.75.218.235,<->,132.234.109.230,1,150,0,0,1,150,0.056129000,0.0000
159.69.187.47,<->,144.108.64.184,1,62,0,0,1,62,0.055763000,0.0000
247.136.188.124,<->,33.250.131.215,1,373,0,0,1,373,0.055752000,0.0000
247.136.178.211,<->,61.58.39.197,1,317,0,0,1,317,0.055699000,0.0000
111.20.172.70,<->,33.233.141.40,0,0,1,146,1,146,0.055538000,0.0000
110.55.186.175,<->,92.27.219.129,0,0,1,79,1,79,0.055352000,0.0000
148.155.131.234,<->,101.224.89.208,0,0,1,166,1,166,0.054612000,0.0000
137.33.165.19,<->,39.14.27.228,0,0,1,238,1,238,0.053543000,0.0000
92.27.219.246,<->,27.67.139.81,1,110,0,0,1,110,0.052915000,0.0000
192.67.190.59,<->,97.94.179.54,1,50,0,0,1,50,0.052844000,0.0000
215.158.239.223,<->,33.209.217.191,1,78,0,0,1,78,0.052775000,0.0000
192.67.146.217,<->,115.222.251.133,1,97,0,0,1,97,0.051329000,0.0000
111.150.206.32,<->,80.56.78.92,0,0,1,86,1,86,0.051131000,0.0000
197.120.231.194,<->,129.224.112.252,0,0,1,83,1,83,0.050202000,0.0000
215.207.149.203,<->,33.233.141.24,0,0,1,66,1,66,0.050180000,0.0000
144.75.218.242,<->,138.127.225.48,1,168,0,0,1,168,0.050091000,0.0000
111.20.172.70,<->,33.233.141.12,0,0,1,286,1,286,0.049993000,0.0000
57.94.149.86,<->,20.20.217.100,0,0,1,78,1,78,0.049851000,0.0000
129.236.111.95,<->,129.224.112.252,0,0,1,88,1,88,0.049469000,0.0000
138.127.225.156,<->,101.224.89.208,0,0,1,341,1,341,0.049428000,0.0000
126.213.42.171,<->,8.228.218.69,0,0,1,133,1,133,0.049063000,0.0000
93.224.24.248,<->,89.183.104.189,0,0,1,52,1,52,0.048469000,0.0000
38.21.156.204,<->,20.232.229.18,0,0,1,82,1,82,0.048049000,0.0000
21.15.226.126,<->,20.193.41.28,0,0,1,82,1,82,0.047804000,0.0000
129.236.64.50,<->,129.224.112.252,0,0,1,75,1,75,0.047789000,0.0000
119.219.97.10,<->,101.224.204.141,0,0,1,80,1,80,0.047395000,0.0000
105.251.93.143,<->,50.224.111.129,0,0,1,66,1,66,0.047332000,0.0000
159.69.187.19,<->,144.108.64.184,1,66,0,0,1,66,0.045900000,0.0000
194.244.97.62,<->,20.98.98.52,0,0,1,80,1,80,0.045710000,0.0000
203.118.37.242,<->,92.27.219.243,0,0,1,52,1,52,0.045414000,0.0000
115.81.129.57,<->,89.183.104.252,0,0,1,62,1,62,0.044953000,0.0000
129.236.111.81,<->,129.224.112.252,0,0,1,75,1,75,0.044884000,0.0000
148.155.130.96,<->,101.224.89.251,0,0,1,174,1,174,0.044262000,0.0000
138.127.225.152,<->,33.233.141.97,0,0,1,246,1,246,0.043202000,0.0000
158.55.120.187,<->,144.75.218.235,0,0,1,150,1,150,0.043020000,0.0000
144.75.218.246,<->,100.185.121.91,1,85,0,0,1,85,0.042710000,0.0000
122.212.65.37,<->,89.183.104.252,0,0,1,52,1,52,0.042442000,0.0000
230.91.134.56,<->,109.3.162.222,0,0,1,133,1,133,0.042042000,0.0000
192.64.199.47,<->,105.227.214.36,1,52,0,0,1,52,0.042021000,0.0000
143.204.138.236,<->,136.25.188.105,0,0,1,125,1,125,0.041687000,0.0000
138.127.224.59,<->,33.233.141.88,0,0,1,249,1,249,0.041619000,0.0000
247.136.151.26,<->,64.214.35.158,1,135,0,0,1,135,0.041176000,0.0000
66.193.249.94,<->,34.154.0.26,0,0,1,66,1,66,0.041145000,0.0000
246.253.253.209,<->,142.232.107.172,1,221,0,0,1,221,0.039768000,0.0000
144.75.218.241,<->,138.127.225.194,1,238,0,0,1,238,0.038823000,0.0000
120.224.238.228,<->,20.142.137.62,0,0,1,126,1,126,0.038808000,0.0000
138.127.224.104,<->,101.224.89.130,0,0,1,289,1,289,0.038714000,0.0000
95.245.91.32,<->,8.238.222.86,0,0,1,135,1,135,0.038078000,0.0000
138.127.224.44,<->,101.224.89.251,0,0,1,234,1,234,0.037988000,0.0000
92.27.219.132,<->,64.214.44.95,1,105,0,0,1,105,0.037266000,0.0000
100.92.86.131,<->,27.14.150.165,1,169,0,0,1,169,0.037240000,0.0000
138.127.224.44,<->,101.224.89.244,0,0,1,234,1,234,0.036997000,0.0000
94.39.154.13,<->,92.27.27.144,0,0,1,52,1,52,0.036842000,0.0000
114.28.246.175,<->,92.27.219.221,0,0,1,52,1,52,0.036618000,0.0000
144.122.240.238,<->,144.108.64.183,1,64,0,0,1,64,0.035851000,0.0000
38.21.156.204,<->,20.232.229.4,0,0,1,82,1,82,0.035012000,0.0000
194.154.60.221,<->,129.224.112.252,0,0,1,63,1,63,0.034979000,0.0000
159.69.187.46,<->,144.108.64.184,1,73,0,0,1,73,0.033322000,0.0000
138.127.225.73,<->,33.233.141.34,0,0,1,86,1,86,0.033089000,0.0000
148.155.131.220,<->,101.224.89.175,0,0,1,172,1,172,0.032803000,0.0000
21.15.226.126,<->,20.193.43.244,0,0,1,82,1,82,0.032762000,0.0000
60.170.105.150,<->,20.66.59.200,0,0,1,52,1,52,0.031930000,0.0000
144.122.240.240,<->,144.108.64.184,1,93,0,0,1,93,0.030800000,0.0000
193.30.240.160,<->,89.139.241.98,0,0,1,152,1,152,0.030736000,0.0000
102.50.23.191,<->,89.183.104.177,0,0,1,393,1,393,0.030412000,0.0000
140.20.42.168,<->,111.146.188.194,0,0,1,50,1,50,0.029527000,0.0000
123.87.27.159,<->,20.128.169.18,0,0,1,184,1,184,0.029377000,0.0000
138.127.224.158,<->,33.233.141.74,0,0,1,290,1,290,0.028808000,0.0000
144.75.218.233,<->,8.47.123.77,1,111,0,0,1,111,0.028253000,0.0000
138.127.225.156,<->,101.224.89.222,0,0,1,284,1,284,0.027261000,0.0000
138.127.224.104,<->,33.233.141.114,0,0,1,276,1,276,0.026754000,0.0000
247.157.92.140,<->,154.149.9.215,1,130,0,0,1,130,0.026713000,0.0000
128.152.250.4,<->,20.212.200.7,0,0,1,72,1,72,0.026703000,0.0000
53.249.253.120,<->,39.15.169.14,0,0,1,88,1,88,0.026654000,0.0000
196.148.133.194,<->,105.102.187.17,1,103,0,0,1,103,0.026621000,0.0000
21.15.226.126,<->,20.193.43.228,0,0,1,82,1,82,0.026550000,0.0000
144.122.240.202,<->,144.108.80.163,1,65,0,0,1,65,0.025693000,0.0000
144.122.240.235,<->,144.108.64.184,1,67,0,0,1,67,0.025453000,0.0000
120.246.11.222,<->,89.183.104.236,0,0,1,52,1,52,0.025405000,0.0000
236.160.232.38,<->,92.27.27.189,0,0,1,260,1,260,0.025388000,0.0000
138.127.224.187,<->,33.233.141.73,0,0,1,235,1,235,0.024610000,0.0000
215.158.103.206,<->,159.118.210.230,1,84,0,0,1,84,0.023869000,0.0000
21.15.226.126,<->,20.193.43.239,0,0,1,82,1,82,0.023517000,0.0000
145.252.126.188,<->,0.247.66.228,1,71,0,0,1,71,0.022629000,0.0000
141.105.247.20,<->,136.129.94.107,0,0,1,84,1,84,0.021625000,0.0000
111.20.168.143,<->,81.96.106.185,1,175,0,0,1,175,0.020771000,0.0000
215.158.239.8,<->,144.90.109.23,1,122,0,0,1,122,0.020087000,0.0000
129.254.101.3,<->,129.224.112.252,0,0,1,63,1,63,0.019899000,0.0000
124.125.130.197,<->,80.38.49.144,0,0,1,82,1,82,0.019218000,0.0000
207.42.247.171,<->,39.0.118.174,0,0,1,68,1,68,0.018886000,0.0000
132.10.25.131,<->,132.3.191.238,1,638,0,0,1,638,0.018480000,0.0000
144.122.240.220,<->,144.84.228.247,1,79,0,0,1,79,0.018442000,0.0000
122.142.196.174,<->,92.27.219.148,0,0,1,105,1,105,0.018272000,0.0000
220.20.206.207,<->,129.224.112.252,0,0,1,81,1,81,0.017983000,0.0000
138.127.224.148,<->,33.233.141.32,0,0,1,289,1,289,0.017735000,0.0000
144.122.240.239,<->,144.108.64.184,1,63,0,0,1,63,0.017274000,0.0000
138.127.224.225,<->,101.224.89.168,0,0,1,243,1,243,0.016439000,0.0000
138.127.224.44,<->,33.233.141.68,0,0,1,234,1,234,0.016285000,0.0000
138.127.224.138,<->,33.233.141.113,0,0,1,264,1,264,0.016273000,0.0000
207.63.14.214,<->,20.119.116.167,0,0,1,70,1,70,0.015686000,0.0000
210.158.44.63,<->,33.229.58.179,1,638,0,0,1,638,0.014887000,0.0000
92.27.27.169,<->,27.11.106.159,1,52,0,0,1,52,0.014659000,0.0000
97.110.148.13,<->,33.233.141.30,0,0,1,98,1,98,0.014202000,0.0000
109.1.62.236,<->,38.239.76.149,1,72,0,0,1,72,0.013555000,0.0000
144.122.240.196,<->,144.108.64.184,1,70,0,0,1,70,0.013494000,0.0000
114.211.225.166,<->,92.27.27.144,0,0,1,52,1,52,0.012952000,0.0000
159.69.187.8,<->,144.108.64.183,1,72,0,0,1,72,0.012936000,0.0000
144.75.218.246,<->,139.252.1.244,1,244,0,0,1,244,0.012595000,0.0000
127.236.62.242,<->,109.222.217.93,0,0,1,69,1,69,0.012328000,0.0000
198.182.215.243,<->,109.1.34.223,0,0,1,325,1,325,0.010231000,0.0000
246.254.97.80,<->,50.145.195.49,1,92,0,0,1,92,0.009974000,0.0000
207.74.108.169,<->,20.67.179.246,0,0,1,72,1,72,0.008220000,0.0000
111.151.107.247,<->,99.74.26.144,0,0,1,217,1,217,0.008219000,0.0000
192.64.245.111,<->,33.200.176.52,1,135,0,0,1,135,0.008107000,0.0000
101.70.126.35,<->,35.122.9.250,1,80,0,0,1,80,0.008012000,0.0000
215.158.239.192,<->,138.127.225.15,1,191,0,0,1,191,0.007670000,0.0000
158.200.200.182,<->,20.207.97.201,0,0,1,110,1,110,0.007662000,0.0000
89.183.104.157,<->,18.201.152.85,1,325,0,0,1,325,0.006474000,0.0000
215.158.103.206,<->,138.127.231.160,1,153,0,0,1,153,0.005819000,0.0000
120.48.82.204,<->,80.38.25.142,0,0,1,78,1,78,0.005616000,0.0000
148.110.20.29,<->,89.183.104.189,0,0,1,135,1,135,0.005609000,0.0000
97.126.113.29,<->,97.19.107.13,1,152,0,0,1,152,0.005375000,0.0000
143.29.129.15,<->,136.25.188.105,0,0,1,159,1,159,0.004890000,0.0000
139.163.5.140,<->,120.231.123.174,1,62,0,0,1,62,0.003773000,0.0000
144.75.218.241,<->,138.127.224.135,1,238,0,0,1,238,0.002178000,0.0000
144.70.196.18,<->,59.130.179.247,1,65,0,0,1,65,0.001983000,0.0000
21.15.226.126,<->,20.193.43.25,0,0,1,82,1,82,0.001582000,0.0000
192.67.172.77,<->,75.148.75.193,1,133,0,0,1,133,0.001538000,0.0000
138.127.224.104,<->,111.20.168.22,0,0,1,197,1,197,0.000749000,0.0000
239.227.117.41,<->,230.94.217.98,1,61,0,0,1,61,0.000329000,0.0000
109.1.17.167,<->,27.188.163.162,1,445,0,0,1,445,0.000116000,0.0000
