src,<->,dest,in_frames,in_bytes,out_frames,out_bytes,total_frames,total_bytes,rel_start,duration
112.7.79.190,<->,80.38.36.39,0,0,15,1080,15,1080,0.069369000,1.7452
152.1.221.131,<->,20.213.77.127,0,0,14,840,14,840,0.117215000,1.7681
82.162.132.166,<->,8.220.200.250,0,0,13,832,13,832,0.075399000,1.2498
215.158.103.203,<->,17.6.149.126,11,968,0,0,11,968,0.378106000,1.2408
210.229.231.45,<->,210.229.230.19,0,0,10,640,10,640,1.435324000,0.2728
210.229.230.20,<->,42.124.194.93,8,512,0,0,8,512,0.067085000,0.7860
210.229.230.19,<->,113.176.55.114,7,448,0,0,7,448,1.042077000,0.8212
215.158.239.92,<->,207.63.144.128,7,4060,0,0,7,4060,0.300342000,1.4005
136.25.188.106,<->,17.153.122.93,7,1204,0,0,7,1204,0.259581000,1.3637
192.64.228.59,<->,130.238.51.137,5,420,0,0,5,420,0.808044000,0.0636
215.158.239.92,<->,196.104.167.37,4,457,0,0,4,457,0.798639000,0.9998
136.25.188.106,<->,99.17.108.35,4,240,0,0,4,240,0.637496000,1.0659
252.138.212.250,<->,136.25.188.161,0,0,3,326,3,326,1.960661000,0.0131
144.85.170.230,<->,91.231.218.55,3,204,0,0,3,204,1.933028000,0.0348
215.158.238.14,<->,122.158.239.127,3,429,0,0,3,429,1.739224000,0.0003
148.140.162.127,<->,89.183.104.178,0,0,3,204,3,204,1.632557000,0.2365
142.237.103.240,<->,136.25.188.55,0,0,3,363,3,363,1.247780000,0.0057
195.78.28.47,<->,144.85.170.228,0,0,3,204,3,204,1.133464000,0.3243
133.178.226.246,<->,8.33.227.71,2,278,0,0,2,278,1.790018000,0.0034
89.183.107.130,<->,89.3.133.24,2,344,0,0,2,344,1.576305000,0.0015
136.25.189.94,<->,29.211.206.37,2,293,0,0,2,293,1.453830000,0.0070
97.126.26.39,<->,33.3.70.169,2,208,0,0,2,208,1.399345000,0.1282
97.126.26.40,<->,33.3.70.169,2,208,0,0,2,208,1.382465000,0.1144
92.27.219.153,<->,78.45.136.53,2,266,0,0,2,266,1.083609000,0.0079
146.249.218.211,<->,8.252.222.162,0,0,2,320,2,320,0.949632000,0.0172
136.25.188.106,<->,131.13.136.222,2,344,0,0,2,344,0.931110000,0.4051
57.81.55.173,<->,20.192.127.218,0,0,2,176,2,176,0.893460000,0.9996
145.144.97.107,<->,53.230.58.251,2,176,0,0,2,176,0.843923000,1.0001
192.64.210.144,<->,91.250.185.182,2,188,0,0,2,188,0.817712000,0.9999
145.166.30.92,<->,92.27.219.205,0,0,2,168,2,168,0.810734000,1.0043
136.25.188.106,<->,131.45.197.200,2,120,0,0,2,120,0.792412000,0.3198
249.101.92.202,<->,94.39.140.57,2,184,0,0,2,184,0.789694000,1.0358
237.7.174.46,<->,100.94.177.44,0,0,2,164,2,164,0.774165000,0.2667
109.206.166.234,<->,50.224.92.222,0,0,2,300,2,300,0.737611000,1.0019
130.73.139.115,<->,39.1.152.199,0,0,2,136,2,136,0.727565000,1.0000
145.166.30.92,<->,92.27.219.52,0,0,2,168,2,168,0.725169000,1.0119
255.133.226.138,<->,8.20.87.7,0,0,2,344,2,344,0.702084000,0.9982
194.237.128.131,<->,136.25.188.242,0,0,2,522,2,522,0.686416000,0.0030
144.87.235.131,<->,124.62.152.8,2,176,0,0,2,176,0.584132000,1.0218
33.245.237.81,<->,20.115.209.25,0,0,2,513,2,513,0.564886000,0.0239
215.158.238.247,<->,6.15.202.155,2,136,0,0,2,136,0.510758000,1.0005
193.51.144.93,<->,35.56.98.12,0,0,2,100,2,100,0.480677000,1.0063
104.142.6.132,<->,80.41.53.16,0,0,2,350,2,350,0.472964000,0.0022
138.98.251.122,<->,99.16.186.18,2,120,0,0,2,120,0.472602000,1.0002
255.133.228.28,<->,136.25.189.94,0,0,2,200,2,200,0.422241000,0.9987
109.1.54.209,<->,18.49.202.252,2,176,0,0,2,176,0.221290000,0.2241
247.39.103.240,<->,35.56.98.12,0,0,2,100,2,100,0.214490000,1.0156
215.158.117.54,<->,129.254.122.124,0,0,2,200,2,200,0.201815000,1.0004
215.158.238.247,<->,113.93.93.125,2,200,0,0,2,200,0.160132000,0.9907
224.154.225.219,<->,139.193.141.139,0,0,2,176,2,176,0.155982000,1.0017
227.145.163.213,<->,129.254.122.124,0,0,2,200,2,200,0.143174000,1.0020
104.74.153.121,<->,92.27.219.224,0,0,2,120,2,120,0.137789000,1.5693
116.151.56.204,<->,97.126.89.196,0,0,2,120,2,120,0.074259000,0.0097
255.133.229.164,<->,111.146.144.109,0,0,1,100,1,100,1.998215000,0.0000
220.55.111.215,<->,76.115.75.72,1,52,0,0,1,52,1.996101000,0.0000
211.166.204.143,<->,89.183.104.145,0,0,1,60,1,60,1.993398000,0.0000
80.40.63.196,<->,33.241.148.5,1,104,0,0,1,104,1.991877000,0.0000
199.111.6.226,<->,99.75.86.46,0,0,1,80,1,80,1.988224000,0.0000
140.17.122.242,<->,92.181.189.237,0,0,1,50,1,50,1.987805000,0.0000
196.15.33.229,<->,20.52.37.66,0,0,1,60,1,60,1.983907000,0.0000
95.218.74.24,<->,20.181.23.119,0,0,1,90,1,90,1.982714000,0.0000
204.115.73.222,<->,8.228.208.181,0,0,1,125,1,125,1.974006000,0.0000
144.75.218.237,<->,27.9.184.49,1,50,0,0,1,50,1.963146000,0.0000
215.158.209.212,<->,8.43.213.44,0,0,1,1004,1,1004,1.963049000,0.0000
148.151.111.65,<->,39.30.20.140,0,0,1,60,1,60,1.959127000,0.0000
39.54.70.100,<->,33.96.221.241,1,103,0,0,1,103,1.956010000,0.0000
140.17.122.242,<->,98.200.189.252,0,0,1,50,1,50,1.952687000,0.0000
105.119.200.246,<->,8.220.206.28,0,0,1,704,1,704,1.951857000,0.0000
215.158.238.163,<->,98.166.239.40,1,134,0,0,1,134,1.951159000,0.0000
139.81.248.210,<->,8.182.121.21,1,68,0,0,1,68,1.948685000,0.0000
149.40.27.204,<->,20.65.103.234,0,0,1,50,1,50,1.945302000,0.0000
118.124.117.220,<->,20.69.59.180,0,0,1,98,1,98,1.944726000,0.0000
224.42.238.231,<->,20.230.128.154,0,0,1,100,1,100,1.943570000,0.0000
128.95.21.165,<->,39.236.57.111,0,0,1,94,1,94,1.940955000,0.0000
194.209.183.117,<->,39.38.165.209,0,0,1,96,1,96,1.935885000,0.0000
224.54.170.200,<->,192.224.198.242,0,0,1,704,1,704,1.931943000,0.0000
125.84.62.71,<->,8.220.203.35,0,0,1,704,1,704,1.915410000,0.0000
215.158.238.205,<->,192.230.221.194,1,1002,0,0,1,1002,1.914119000,0.0000
120.155.8.80,<->,8.52.129.50,0,0,1,1002,1,1002,1.912612000,0.0000
113.65.136.161,<->,39.51.246.85,0,0,1,72,1,72,1.912033000,0.0000
112.70.164.219,<->,8.52.251.213,0,0,1,1002,1,1002,1.911463000,0.0000
143.226.151.111,<->,8.220.201.13,0,0,1,704,1,704,1.911269000,0.0000
111.150.118.22,<->,56.121.35.12,0,0,1,68,1,68,1.910064000,0.0000
140.17.122.242,<->,98.128.202.45,0,0,1,50,1,50,1.909145000,0.0000
64.253.254.21,<->,39.144.12.43,0,0,1,60,1,60,1.908626000,0.0000
192.242.69.246,<->,20.144.125.58,0,0,1,104,1,104,1.896636000,0.0000
120.39.91.40,<->,92.27.219.215,0,0,1,80,1,80,1.896547000,0.0000
136.25.188.106,<->,57.108.116.104,1,60,0,0,1,60,1.896120000,0.0000
133.81.199.33,<->,58.132.153.38,1,1424,0,0,1,1424,1.891641000,0.0000
92.27.219.140,<->,66.245.103.93,1,353,0,0,1,353,1.888359000,0.0000
98.86.123.142,<->,20.197.150.148,0,0,1,98,1,98,1.887761000,0.0000
197.10.43.51,<->,101.70.109.4,0,0,1,65,1,65,1.886321000,0.0000
42.103.242.17,<->,39.200.8.4,0,0,1,84,1,84,1.877890000,0.0000
199.50.127.162,<->,136.25.188.255,0,0,1,129,1,129,1.877060000,0.0000
215.158.238.205,<->,89.76.50.211,1,84,0,0,1,84,1.877024000,0.0000
39.38.161.196,<->,33.56.203.251,1,94,0,0,1,94,1.875009000,0.0000
131.128.233.183,<->,8.52.162.215,0,0,1,1002,1,1002,1.873879000,0.0000
98.190.105.98,<->,29.214.110.52,1,1002,0,0,1,1002,1.872820000,0.0000
113.65.136.161,<->,39.51.246.5,0,0,1,72,1,72,1.870244000,0.0000
199.79.65.112,<->,20.84.237.80,0,0,1,106,1,106,1.870127000,0.0000
196.109.192.105,<->,39.228.20.193,0,0,1,106,1,106,1.869690000,0.0000
97.94.119.43,<->,35.56.98.12,0,0,1,50,1,50,1.862535000,0.0000
139.181.79.30,<->,8.188.179.3,1,68,0,0,1,68,1.862464000,0.0000
143.61.64.223,<->,8.220.197.41,0,0,1,704,1,704,1.858791000,0.0000
113.65.136.161,<->,39.51.246.6,0,0,1,72,1,72,1.857516000,0.0000
66.91.81.193,<->,34.47.39.226,0,0,1,60,1,60,1.855931000,0.0000
207.61.106.97,<->,136.25.188.253,0,0,1,129,1,129,1.854031000,0.0000
204.172.88.54,<->,39.11.130.186,0,0,1,103,1,103,1.852310000,0.0000
112.70.164.219,<->,8.220.205.50,0,0,1,704,1,704,1.852300000,0.0000
193.29.109.175,<->,20.190.177.115,0,0,1,92,1,92,1.848854000,0.0000
121.8.199.111,<->,8.220.204.215,0,0,1,704,1,704,1.846978000,0.0000
199.24.13.33,<->,8.53.1.205,0,0,1,84,1,84,1.844319000,0.0000
194.209.34.72,<->,8.250.151.29,0,0,1,704,1,704,1.840798000,0.0000
140.17.122.242,<->,92.170.49.231,0,0,1,50,1,50,1.839168000,0.0000
239.66.177.184,<->,100.94.63.248,0,0,1,98,1,98,1.838278000,0.0000
89.183.104.238,<->,76.180.48.254,1,100,0,0,1,100,1.836928000,0.0000
136.25.188.106,<->,123.130.129.156,1,100,0,0,1,100,1.833584000,0.0000
142.200.21.47,<->,8.52.165.54,0,0,1,1002,1,1002,1.831779000,0.0000
131.128.233.183,<->,8.220.193.21,0,0,1,704,1,704,1.825773000,0.0000
142.200.155.49,<->,20.123.155.57,0,0,1,100,1,100,1.822579000,0.0000
33.233.141.30,<->,8.182.121.33,1,68,0,0,1,68,1.821098000,0.0000
131.68.53.195,<->,109.1.61.202,0,0,1,60,1,60,1.815513000,0.0000
97.126.31.80,<->,29.211.224.183,1,1002,0,0,1,1002,1.810604000,0.0000
192.224.197.11,<->,73.186.221.255,1,704,0,0,1,704,1.809953000,0.0000
204.126.215.57,<->,8.53.8.233,0,0,1,84,1,84,1.806162000,0.0000
144.87.235.187,<->,8.188.179.5,1,68,0,0,1,68,1.805519000,0.0000
101.70.118.227,<->,56.107.48.212,1,68,0,0,1,68,1.799928000,0.0000
215.158.238.155,<->,8.191.134.189,1,72,0,0,1,72,1.796063000,0.0000
125.152.68.198,<->,39.150.207.107,0,0,1,60,1,60,1.791374000,0.0000
192.224.197.11,<->,8.182.120.235,1,704,0,0,1,704,1.787896000,0.0000
93.157.253.183,<->,8.52.187.45,0,0,1,1002,1,1002,1.787661000,0.0000
192.67.171.106,<->,135.85.163.173,1,580,0,0,1,580,1.786200000,0.0000
195.43.246.251,<->,136.25.188.211,0,0,1,129,1,129,1.785687000,0.0000
140.19.166.183,<->,8.52.240.220,0,0,1,1002,1,1002,1.785197000,0.0000
135.64.101.139,<->,20.59.201.50,0,0,1,60,1,60,1.785193000,0.0000
204.98.230.33,<->,39.26.196.109,0,0,1,94,1,94,1.781723000,0.0000
199.13.96.222,<->,39.152.255.125,0,0,1,60,1,60,1.781284000,0.0000
109.14.213.84,<->,80.56.78.128,0,0,1,196,1,196,1.780120000,0.0000
38.188.151.225,<->,20.151.101.68,0,0,1,103,1,103,1.778171000,0.0000
158.54.61.103,<->,138.98.230.77,0,0,1,96,1,96,1.776922000,0.0000
195.80.56.77,<->,20.57.96.153,0,0,1,60,1,60,1.774036000,0.0000
199.111.23.145,<->,20.7.109.134,0,0,1,95,1,95,1.774008000,0.0000
207.20.188.102,<->,39.221.27.219,0,0,1,98,1,98,1.766431000,0.0000
215.158.140.27,<->,131.36.211.148,1,84,0,0,1,84,1.754575000,0.0000
204.76.112.88,<->,39.192.121.15,0,0,1,96,1,96,1.752008000,0.0000
136.129.109.170,<->,20.6.49.213,0,0,1,94,1,94,1.749881000,0.0000
215.158.239.117,<->,57.210.104.184,1,68,0,0,1,68,1.749458000,0.0000
204.131.116.206,<->,20.18.9.25,0,0,1,60,1,60,1.747641000,0.0000
61.35.57.29,<->,39.20.154.131,0,0,1,94,1,94,1.746373000,0.0000
199.79.27.188,<->,39.49.28.0,0,0,1,106,1,106,1.743480000,0.0000
193.21.29.226,<->,99.72.180.56,0,0,1,184,1,184,1.738929000,0.0000
199.79.27.188,<->,39.48.43.157,0,0,1,104,1,104,1.738850000,0.0000
215.158.2.49,<->,8.176.8.237,0,0,1,139,1,139,1.733864000,0.0000
255.133.229.164,<->,22.59.31.115,0,0,1,100,1,100,1.725624000,0.0000
145.177.18.14,<->,20.225.97.201,0,0,1,97,1,97,1.723544000,0.0000
143.170.100.10,<->,8.53.14.227,0,0,1,84,1,84,1.723083000,0.0000
215.158.238.205,<->,8.223.246.237,1,1002,0,0,1,1002,1.722977000,0.0000
113.65.136.161,<->,39.51.246.8,0,0,1,72,1,72,1.722966000,0.0000
255.133.229.164,<->,39.202.171.223,0,0,1,100,1,100,1.722818000,0.0000
215.158.106.41,<->,136.25.189.137,0,0,1,1004,1,1004,1.719138000,0.0000
29.211.110.56,<->,8.220.176.226,0,0,1,704,1,704,1.719081000,0.0000
141.108.105.215,<->,20.18.119.54,0,0,1,50,1,50,1.717533000,0.0000
248.239.187.198,<->,116.38.118.146,1,60,0,0,1,60,1.715508000,0.0000
215.158.2.49,<->,8.176.8.188,0,0,1,139,1,139,1.712930000,0.0000
95.104.30.132,<->,39.33.64.254,0,0,1,108,1,108,1.712438000,0.0000
215.158.238.205,<->,8.245.10.23,1,704,0,0,1,704,1.711943000,0.0000
207.11.207.11,<->,39.8.21.74,0,0,1,108,1,108,1.711538000,0.0000
138.98.233.218,<->,98.8.90.134,1,60,0,0,1,60,1.706581000,0.0000
113.65.136.161,<->,39.51.246.18,0,0,1,72,1,72,1.706474000,0.0000
124.123.208.85,<->,39.135.223.159,0,0,1,94,1,94,1.705578000,0.0000
136.25.189.52,<->,131.173.115.1,1,704,0,0,1,704,1.704862000,0.0000
106.216.124.242,<->,20.80.232.32,0,0,1,60,1,60,1.704530000,0.0000
199.13.212.3,<->,39.153.33.20,0,0,1,94,1,94,1.704418000,0.0000
136.14.200.42,<->,20.111.98.239,0,0,1,60,1,60,1.694430000,0.0000
215.158.140.240,<->,192.170.158.219,1,704,0,0,1,704,1.689752000,0.0000
158.55.226.34,<->,89.183.104.134,0,0,1,80,1,80,1.689560000,0.0000
255.133.39.74,<->,29.209.14.200,1,1004,0,0,1,1004,1.685819000,0.0000
199.66.208.243,<->,39.162.166.120,0,0,1,101,1,101,1.685696000,0.0000
223.122.185.191,<->,8.43.220.234,0,0,1,704,1,704,1.684670000,0.0000
132.51.6.109,<->,119.158.24.205,1,60,0,0,1,60,1.683057000,0.0000
195.83.166.40,<->,39.147.89.158,0,0,1,60,1,60,1.681877000,0.0000
223.122.185.191,<->,8.43.209.194,0,0,1,704,1,704,1.681838000,0.0000
194.248.50.194,<->,39.15.83.238,0,0,1,67,1,67,1.679225000,0.0000
149.195.49.108,<->,132.51.6.109,0,0,1,64,1,64,1.679102000,0.0000
194.248.50.194,<->,39.15.83.196,0,0,1,67,1,67,1.675579000,0.0000
192.229.223.2,<->,149.199.118.25,1,704,0,0,1,704,1.675388000,0.0000
220.55.111.214,<->,112.14.199.242,1,60,0,0,1,60,1.674951000,0.0000
194.248.50.194,<->,39.15.83.195,0,0,1,67,1,67,1.673999000,0.0000
56.121.35.12,<->,8.32.89.211,1,84,0,0,1,84,1.673248000,0.0000
204.144.56.71,<->,39.158.19.99,0,0,1,104,1,104,1.672515000,0.0000
194.248.50.194,<->,39.15.83.129,0,0,1,67,1,67,1.672169000,0.0000
125.216.38.51,<->,8.43.212.233,0,0,1,704,1,704,1.671245000,0.0000
204.77.93.74,<->,39.199.197.135,0,0,1,106,1,106,1.668478000,0.0000
89.183.104.184,<->,75.92.131.181,1,60,0,0,1,60,1.666105000,0.0000
76.2.251.232,<->,8.220.195.10,0,0,1,704,1,704,1.666007000,0.0000
194.206.106.251,<->,20.172.50.83,0,0,1,101,1,101,1.661653000,0.0000
205.174.128.121,<->,39.195.244.14,0,0,1,60,1,60,1.661129000,0.0000
207.115.229.20,<->,20.139.79.137,0,0,1,102,1,102,1.659761000,0.0000
122.252.105.253,<->,39.206.221.49,0,0,1,106,1,106,1.657607000,0.0000
27.2.254.221,<->,20.116.199.147,0,0,1,106,1,106,1.649717000,0.0000
237.7.172.101,<->,99.73.143.215,0,0,1,84,1,84,1.649546000,0.0000
196.114.201.194,<->,39.146.221.234,0,0,1,105,1,105,1.648778000,0.0000
196.15.236.179,<->,39.200.37.227,0,0,1,60,1,60,1.648552000,0.0000
97.173.81.147,<->,39.138.159.99,0,0,1,102,1,102,1.641774000,0.0000
159.165.39.68,<->,8.220.178.8,0,0,1,704,1,704,1.640676000,0.0000
193.41.82.236,<->,20.192.194.65,0,0,1,106,1,106,1.640476000,0.0000
69.246.57.22,<->,34.2.220.7,0,0,1,60,1,60,1.635752000,0.0000
149.201.160.73,<->,137.21.23.55,0,0,1,1002,1,1002,1.632649000,0.0000
131.238.203.44,<->,92.27.219.19,0,0,1,80,1,80,1.630573000,0.0000
73.89.20.239,<->,39.233.87.102,0,0,1,60,1,60,1.630371000,0.0000
8.222.105.7,<->,8.52.235.218,0,0,1,1002,1,1002,1.627104000,0.0000
33.220.0.56,<->,8.52.168.54,0,0,1,1002,1,1002,1.622232000,0.0000
215.158.239.237,<->,8.191.134.109,1,72,0,0,1,72,1.620311000,0.0000
207.213.142.242,<->,39.38.105.44,0,0,1,100,1,100,1.619837000,0.0000
113.80.107.218,<->,39.41.185.141,0,0,1,60,1,60,1.614850000,0.0000
105.69.52.216,<->,20.224.91.117,0,0,1,108,1,108,1.609648000,0.0000
196.63.33.154,<->,39.197.80.179,0,0,1,102,1,102,1.609323000,0.0000
33.98.7.246,<->,20.211.27.230,0,0,1,60,1,60,1.608677000,0.0000
235.236.66.193,<->,20.116.228.206,0,0,1,103,1,103,1.608500000,0.0000
207.86.19.243,<->,80.40.29.132,0,0,1,107,1,107,1.606388000,0.0000
253.244.247.39,<->,20.192.253.166,0,0,1,104,1,104,1.603946000,0.0000
195.18.35.108,<->,20.199.175.244,0,0,1,100,1,100,1.603323000,0.0000
247.136.245.208,<->,38.164.213.201,1,80,0,0,1,80,1.598283000,0.0000
192.170.150.50,<->,6.73.247.16,0,0,1,704,1,704,1.591715000,0.0000
196.83.184.54,<->,39.133.102.99,0,0,1,100,1,100,1.589605000,0.0000
205.122.195.32,<->,8.220.198.219,0,0,1,704,1,704,1.589187000,0.0000
144.75.218.241,<->,96.129.66.231,1,100,0,0,1,100,1.587376000,0.0000
255.133.229.164,<->,39.220.108.12,0,0,1,100,1,100,1.586956000,0.0000
255.133.229.164,<->,39.169.17.209,0,0,1,100,1,100,1.584573000,0.0000
98.198.28.253,<->,8.53.11.58,0,0,1,84,1,84,1.582798000,0.0000
103.186.213.175,<->,20.30.19.163,0,0,1,60,1,60,1.580952000,0.0000
204.182.95.230,<->,39.142.105.230,0,0,1,98,1,98,1.579457000,0.0000
192.242.74.229,<->,20.206.185.169,0,0,1,96,1,96,1.579382000,0.0000
86.151.231.2,<->,8.220.177.253,0,0,1,704,1,704,1.577785000,0.0000
199.72.62.245,<->,136.25.188.197,0,0,1,129,1,129,1.576305000,0.0000
196.107.118.140,<->,20.0.254.190,0,0,1,107,1,107,1.566583000,0.0000
29.213.216.193,<->,8.52.171.60,0,0,1,1002,1,1002,1.565933000,0.0000
133.178.227.165,<->,112.40.39.255,1,704,0,0,1,704,1.561585000,0.0000
148.213.184.134,<->,39.163.210.75,0,0,1,95,1,95,1.556841000,0.0000
89.183.104.242,<->,38.242.5.161,1,80,0,0,1,80,1.547647000,0.0000
197.229.163.191,<->,39.230.77.30,0,0,1,64,1,64,1.545582000,0.0000
194.218.9.246,<->,99.75.65.137,0,0,1,112,1,112,1.543009000,0.0000
80.41.53.34,<->,40.202.64.181,1,158,0,0,1,158,1.540726000,0.0000
207.58.55.6,<->,136.25.188.54,0,0,1,129,1,129,1.540323000,0.0000
113.23.56.112,<->,8.220.193.21,0,0,1,704,1,704,1.537635000,0.0000
126.207.139.3,<->,20.8.210.209,0,0,1,50,1,50,1.535436000,0.0000
158.164.134.203,<->,39.32.36.158,0,0,1,72,1,72,1.529995000,0.0000
29.211.93.144,<->,8.220.201.13,0,0,1,704,1,704,1.526129000,0.0000
69.196.219.217,<->,39.172.87.102,0,0,1,96,1,96,1.526026000,0.0000
140.58.12.242,<->,39.46.137.28,0,0,1,60,1,60,1.523583000,0.0000
207.246.51.55,<->,20.206.124.139,0,0,1,98,1,98,1.521421000,0.0000
69.246.55.231,<->,39.204.213.172,0,0,1,60,1,60,1.519014000,0.0000
69.246.196.32,<->,8.43.197.220,0,0,1,704,1,704,1.519007000,0.0000
199.39.148.151,<->,136.25.188.53,0,0,1,129,1,129,1.514066000,0.0000
194.206.106.251,<->,20.238.92.151,0,0,1,100,1,100,1.512676000,0.0000
97.112.208.251,<->,8.220.197.41,0,0,1,704,1,704,1.512399000,0.0000
140.147.60.30,<->,39.62.96.24,0,0,1,60,1,60,1.509224000,0.0000
199.110.162.56,<->,20.31.201.129,0,0,1,95,1,95,1.507224000,0.0000
29.214.69.231,<->,8.52.241.18,0,0,1,1002,1,1002,1.505865000,0.0000
111.147.147.164,<->,38.171.123.218,1,80,0,0,1,80,1.505687000,0.0000
158.164.134.203,<->,39.32.36.159,0,0,1,72,1,72,1.504105000,0.0000
195.18.40.94,<->,20.85.197.248,0,0,1,98,1,98,1.500893000,0.0000
215.158.140.240,<->,29.214.68.246,1,704,0,0,1,704,1.499168000,0.0000
89.93.82.208,<->,8.43.212.233,0,0,1,704,1,704,1.489088000,0.0000
116.106.35.71,<->,8.52.136.253,0,0,1,1002,1,1002,1.483281000,0.0000
255.133.229.164,<->,98.67.154.65,0,0,1,100,1,100,1.480318000,0.0000
105.64.71.172,<->,20.86.113.253,0,0,1,104,1,104,1.479782000,0.0000
194.232.160.138,<->,136.25.188.177,0,0,1,188,1,188,1.475676000,0.0000
207.192.232.125,<->,39.157.186.151,0,0,1,97,1,97,1.475114000,0.0000
196.193.145.119,<->,39.208.214.31,0,0,1,60,1,60,1.474631000,0.0000
89.183.104.173,<->,18.201.237.149,1,60,0,0,1,60,1.472987000,0.0000
206.89.65.32,<->,8.43.154.226,0,0,1,704,1,704,1.472497000,0.0000
29.214.193.75,<->,8.43.219.55,0,0,1,704,1,704,1.472493000,0.0000
132.185.111.50,<->,20.211.220.249,0,0,1,88,1,88,1.471164000,0.0000
204.109.185.118,<->,39.246.168.218,0,0,1,106,1,106,1.470630000,0.0000
113.24.27.181,<->,97.126.31.80,0,0,1,1002,1,1002,1.468936000,0.0000
113.167.79.244,<->,20.116.112.253,0,0,1,60,1,60,1.468579000,0.0000
215.158.239.70,<->,207.114.98.247,1,96,0,0,1,96,1.466137000,0.0000
155.18.131.13,<->,20.169.96.107,0,0,1,64,1,64,1.462554000,0.0000
131.141.160.18,<->,20.197.31.46,0,0,1,106,1,106,1.462073000,0.0000
38.30.47.28,<->,20.116.161.33,0,0,1,100,1,100,1.461924000,0.0000
195.86.156.214,<->,20.31.149.15,0,0,1,100,1,100,1.460321000,0.0000
57.236.181.228,<->,39.150.98.123,0,0,1,106,1,106,1.457343000,0.0000
192.67.142.109,<->,0.68.165.164,1,80,0,0,1,80,1.456356000,0.0000
105.168.108.183,<->,92.27.27.175,0,0,1,80,1,80,1.453183000,0.0000
109.222.250.46,<->,38.25.250.39,1,80,0,0,1,80,1.452826000,0.0000
215.158.238.200,<->,144.90.218.168,1,1002,0,0,1,1002,1.450708000,0.0000
198.204.78.16,<->,8.52.223.43,0,0,1,1002,1,1002,1.447636000,0.0000
106.187.250.29,<->,8.228.223.193,0,0,1,60,1,60,1.446865000,0.0000
121.231.63.172,<->,39.216.213.92,0,0,1,100,1,100,1.446809000,0.0000
113.163.114.210,<->,20.6.42.212,0,0,1,99,1,99,1.443857000,0.0000
205.242.102.181,<->,192.229.213.169,0,0,1,60,1,60,1.440043000,0.0000
140.44.64.171,<->,92.27.27.177,0,0,1,90,1,90,1.439881000,0.0000
149.250.99.138,<->,39.203.116.110,0,0,1,60,1,60,1.438848000,0.0000
215.158.140.74,<->,83.248.10.49,1,137,0,0,1,137,1.438083000,0.0000
204.82.113.15,<->,39.154.165.188,0,0,1,96,1,96,1.437651000,0.0000
195.5.123.209,<->,20.222.114.179,0,0,1,102,1,102,1.435614000,0.0000
130.13.184.58,<->,20.177.4.48,0,0,1,101,1,101,1.435097000,0.0000
192.224.199.2,<->,29.214.65.5,1,704,0,0,1,704,1.432174000,0.0000
138.98.251.122,<->,57.108.116.73,1,60,0,0,1,60,1.429673000,0.0000
39.164.12.41,<->,38.182.85.209,1,107,0,0,1,107,1.420508000,0.0000
207.114.13.176,<->,39.214.99.120,0,0,1,60,1,60,1.415010000,0.0000
69.246.51.253,<->,34.232.145.108,0,0,1,60,1,60,1.414019000,0.0000
57.199.250.208,<->,8.52.187.45,0,0,1,1002,1,1002,1.412004000,0.0000
82.99.240.203,<->,8.220.203.35,0,0,1,704,1,704,1.409060000,0.0000
33.119.247.97,<->,20.203.209.207,0,0,1,76,1,76,1.407625000,0.0000
64.151.28.80,<->,39.136.184.119,0,0,1,100,1,100,1.402156000,0.0000
123.88.254.57,<->,8.220.176.226,0,0,1,84,1,84,1.401700000,0.0000
136.25.188.106,<->,26.180.97.85,1,60,0,0,1,60,1.397983000,0.0000
102.51.147.16,<->,38.177.5.39,1,102,0,0,1,102,1.396675000,0.0000
204.255.100.40,<->,39.17.249.238,0,0,1,108,1,108,1.391046000,0.0000
140.17.122.242,<->,80.42.230.174,0,0,1,50,1,50,1.390432000,0.0000
144.87.235.187,<->,80.47.23.44,1,68,0,0,1,68,1.389608000,0.0000
112.54.57.158,<->,39.135.54.44,0,0,1,108,1,108,1.385881000,0.0000
123.130.135.16,<->,8.250.153.211,0,0,1,704,1,704,1.383483000,0.0000
143.148.189.199,<->,20.126.76.167,0,0,1,106,1,106,1.380815000,0.0000
194.209.152.253,<->,39.24.140.88,0,0,1,108,1,108,1.378491000,0.0000
123.130.135.16,<->,8.220.204.215,0,0,1,704,1,704,1.377104000,0.0000
159.14.215.42,<->,133.32.39.1,0,0,1,1004,1,1004,1.375959000,0.0000
241.228.121.155,<->,140.17.122.242,1,50,0,0,1,50,1.372615000,0.0000
207.200.207.63,<->,8.252.222.225,0,0,1,580,1,580,1.372415000,0.0000
223.138.245.37,<->,111.147.149.36,0,0,1,106,1,106,1.368096000,0.0000
125.84.145.15,<->,8.43.223.42,0,0,1,704,1,704,1.364608000,0.0000
129.123.31.5,<->,20.84.249.144,0,0,1,60,1,60,1.358723000,0.0000
135.198.22.176,<->,20.149.111.109,0,0,1,60,1,60,1.344962000,0.0000
136.25.189.47,<->,91.57.168.91,1,704,0,0,1,704,1.344715000,0.0000
192.242.190.84,<->,20.30.189.31,0,0,1,102,1,102,1.341463000,0.0000
76.2.232.35,<->,39.154.179.227,0,0,1,60,1,60,1.340131000,0.0000
148.199.95.14,<->,8.220.188.205,0,0,1,84,1,84,1.337623000,0.0000
255.133.229.164,<->,39.130.149.25,0,0,1,100,1,100,1.334667000,0.0000
255.133.229.164,<->,39.145.30.84,0,0,1,100,1,100,1.332794000,0.0000
245.125.203.41,<->,20.124.191.6,0,0,1,100,1,100,1.332703000,0.0000
92.27.219.235,<->,67.225.64.201,1,60,0,0,1,60,1.331922000,0.0000
198.231.134.212,<->,100.93.245.167,0,0,1,166,1,166,1.331806000,0.0000
207.7.83.126,<->,39.57.249.220,0,0,1,104,1,104,1.329445000,0.0000
124.52.9.239,<->,39.170.215.132,0,0,1,108,1,108,1.325213000,0.0000
224.235.33.176,<->,39.246.193.33,0,0,1,101,1,101,1.321738000,0.0000
122.8.229.86,<->,89.183.104.226,0,0,1,60,1,60,1.315856000,0.0000
200.174.174.113,<->,53.148.173.181,1,80,0,0,1,80,1.311965000,0.0000
105.69.107.244,<->,20.239.49.55,0,0,1,96,1,96,1.309482000,0.0000
112.166.162.194,<->,8.220.189.253,0,0,1,84,1,84,1.308187000,0.0000
122.169.160.21,<->,39.203.137.15,0,0,1,60,1,60,1.306688000,0.0000
159.115.117.197,<->,8.188.179.5,1,68,0,0,1,68,1.306267000,0.0000
158.164.134.203,<->,39.32.36.190,0,0,1,72,1,72,1.306165000,0.0000
192.229.213.201,<->,60.110.158.164,1,84,0,0,1,84,1.304987000,0.0000
114.56.102.221,<->,20.157.109.194,0,0,1,60,1,60,1.294378000,0.0000
207.42.94.41,<->,39.217.0.88,0,0,1,106,1,106,1.290577000,0.0000
99.74.27.16,<->,8.58.151.38,1,704,0,0,1,704,1.287561000,0.0000
199.111.214.254,<->,39.24.236.92,0,0,1,50,1,50,1.287215000,0.0000
205.122.195.32,<->,8.52.178.7,0,0,1,1002,1,1002,1.286234000,0.0000
255.133.229.164,<->,39.12.83.214,0,0,1,100,1,100,1.277913000,0.0000
98.86.124.45,<->,20.41.215.170,0,0,1,107,1,107,1.273905000,0.0000
148.110.144.28,<->,20.200.169.39,0,0,1,103,1,103,1.272793000,0.0000
76.73.2.13,<->,39.130.202.200,0,0,1,106,1,106,1.270311000,0.0000
158.254.147.43,<->,20.98.74.96,0,0,1,105,1,105,1.262975000,0.0000
99.168.117.210,<->,8.220.178.8,0,0,1,84,1,84,1.254649000,0.0000
134.90.116.231,<->,39.145.152.187,0,0,1,100,1,100,1.254582000,0.0000
142.200.128.84,<->,39.0.84.115,0,0,1,105,1,105,1.251184000,0.0000
39.17.43.138,<->,37.49.116.88,1,103,0,0,1,103,1.250494000,0.0000
147.58.148.219,<->,20.144.37.110,0,0,1,60,1,60,1.245675000,0.0000
127.175.8.34,<->,8.220.206.28,0,0,1,84,1,84,1.239628000,0.0000
42.246.245.245,<->,39.140.116.193,0,0,1,104,1,104,1.235397000,0.0000
221.99.11.55,<->,136.25.189.47,0,0,1,704,1,704,1.231136000,0.0000
130.13.228.200,<->,8.220.233.50,0,0,1,84,1,84,1.228683000,0.0000
61.34.184.240,<->,8.52.135.2,0,0,1,1002,1,1002,1.228244000,0.0000
106.155.153.9,<->,8.250.153.211,0,0,1,84,1,84,1.226563000,0.0000
145.144.99.3,<->,123.135.85.172,1,64,0,0,1,64,1.223366000,0.0000
112.68.118.164,<->,8.220.205.50,0,0,1,84,1,84,1.223291000,0.0000
215.158.239.84,<->,199.20.7.225,1,160,0,0,1,160,1.221423000,0.0000
194.245.206.108,<->,39.149.97.33,0,0,1,96,1,96,1.213770000,0.0000
61.72.108.231,<->,8.43.210.250,0,0,1,84,1,84,1.211407000,0.0000
80.47.23.44,<->,8.176.8.70,0,0,1,68,1,68,1.210337000,0.0000
136.116.28.240,<->,8.53.32.195,1,704,0,0,1,704,1.200015000,0.0000
137.44.211.250,<->,8.250.148.227,0,0,1,84,1,84,1.196236000,0.0000
255.133.229.164,<->,39.173.227.135,0,0,1,100,1,100,1.192045000,0.0000
140.147.122.52,<->,8.250.157.211,0,0,1,84,1,84,1.187875000,0.0000
206.103.168.166,<->,133.32.39.0,0,0,1,84,1,84,1.187787000,0.0000
207.230.26.226,<->,109.112.164.219,0,0,1,72,1,72,1.185204000,0.0000
133.171.115.110,<->,130.170.125.252,1,88,0,0,1,88,1.176693000,0.0000
131.94.186.165,<->,20.233.129.168,0,0,1,102,1,102,1.175309000,0.0000
149.26.172.124,<->,8.43.212.233,0,0,1,84,1,84,1.173258000,0.0000
199.114.230.219,<->,39.53.168.180,0,0,1,60,1,60,1.168005000,0.0000
246.23.236.58,<->,136.25.188.27,0,0,1,1004,1,1004,1.160249000,0.0000
207.41.151.242,<->,39.61.209.87,0,0,1,100,1,100,1.152806000,0.0000
210.56.117.49,<->,8.52.177.25,0,0,1,52,1,52,1.152324000,0.0000
118.96.239.21,<->,20.187.188.146,0,0,1,104,1,104,1.147727000,0.0000
38.79.163.48,<->,8.43.222.27,0,0,1,704,1,704,1.147237000,0.0000
207.213.190.31,<->,39.19.67.136,0,0,1,94,1,94,1.146729000,0.0000
131.22.113.247,<->,8.52.222.211,0,0,1,1002,1,1002,1.146518000,0.0000
57.98.56.162,<->,39.223.126.153,0,0,1,104,1,104,1.145719000,0.0000
214.254.89.225,<->,8.220.202.13,0,0,1,84,1,84,1.144539000,0.0000
194.184.194.81,<->,39.1.75.247,0,0,1,60,1,60,1.143683000,0.0000
204.1.250.200,<->,136.25.188.198,0,0,1,129,1,129,1.143412000,0.0000
142.107.179.243,<->,39.196.88.45,0,0,1,96,1,96,1.143226000,0.0000
120.214.255.54,<->,101.70.103.119,0,0,1,100,1,100,1.141521000,0.0000
215.158.61.79,<->,137.21.23.51,0,0,1,1004,1,1004,1.141276000,0.0000
105.132.154.243,<->,92.27.219.237,0,0,1,177,1,177,1.136798000,0.0000
207.246.90.252,<->,39.167.240.97,0,0,1,60,1,60,1.134625000,0.0000
255.133.229.164,<->,39.154.138.43,0,0,1,100,1,100,1.133070000,0.0000
113.23.56.112,<->,8.52.130.205,0,0,1,1002,1,1002,1.126181000,0.0000
204.181.22.73,<->,20.105.166.91,0,0,1,98,1,98,1.126162000,0.0000
194.203.153.2,<->,20.197.66.186,0,0,1,60,1,60,1.124475000,0.0000
131.232.94.211,<->,8.43.180.200,0,0,1,84,1,84,1.119194000,0.0000
140.17.122.242,<->,66.0.155.46,0,0,1,50,1,50,1.109874000,0.0000
215.158.239.117,<->,68.231.30.247,1,68,0,0,1,68,1.107625000,0.0000
99.175.109.166,<->,66.195.127.30,1,369,0,0,1,369,1.106534000,0.0000
140.17.122.242,<->,108.38.76.199,0,0,1,50,1,50,1.105760000,0.0000
142.246.25.203,<->,97.126.31.80,0,0,1,1002,1,1002,1.097603000,0.0000
120.246.24.8,<->,20.234.133.151,0,0,1,94,1,94,1.093371000,0.0000
247.136.132.126,<->,99.46.152.189,1,60,0,0,1,60,1.091186000,0.0000
121.214.196.4,<->,39.18.56.245,0,0,1,104,1,104,1.088560000,0.0000
207.74.210.18,<->,99.73.183.72,0,0,1,96,1,96,1.087806000,0.0000
194.207.16.202,<->,39.171.77.160,0,0,1,108,1,108,1.086976000,0.0000
105.201.127.130,<->,20.204.46.15,0,0,1,100,1,100,1.086130000,0.0000
127.234.11.180,<->,39.18.204.0,0,0,1,95,1,95,1.082740000,0.0000
143.251.225.129,<->,39.225.208.109,0,0,1,99,1,99,1.081572000,0.0000
204.34.97.122,<->,159.137.212.194,0,0,1,64,1,64,1.080875000,0.0000
155.196.27.92,<->,39.4.3.119,0,0,1,50,1,50,1.079945000,0.0000
21.137.251.81,<->,20.201.26.204,0,0,1,100,1,100,1.078731000,0.0000
221.98.90.26,<->,130.78.11.165,1,84,0,0,1,84,1.073543000,0.0000
104.217.126.247,<->,80.40.56.197,0,0,1,90,1,90,1.073479000,0.0000
8.250.158.7,<->,6.15.117.9,1,84,0,0,1,84,1.072965000,0.0000
220.81.47.237,<->,140.17.122.242,1,50,0,0,1,50,1.072510000,0.0000
215.158.140.240,<->,89.70.190.184,1,704,0,0,1,704,1.069605000,0.0000
215.158.238.205,<->,193.29.116.75,1,1002,0,0,1,1002,1.069432000,0.0000
196.1.181.164,<->,39.163.208.57,0,0,1,100,1,100,1.068567000,0.0000
204.50.214.41,<->,39.53.61.242,0,0,1,60,1,60,1.068361000,0.0000
207.84.40.148,<->,39.230.176.240,0,0,1,108,1,108,1.058595000,0.0000
194.201.104.102,<->,39.12.12.151,0,0,1,108,1,108,1.052777000,0.0000
149.148.18.67,<->,39.9.181.205,0,0,1,97,1,97,1.052735000,0.0000
113.20.94.199,<->,8.220.202.13,0,0,1,704,1,704,1.047619000,0.0000
89.183.104.177,<->,33.57.79.42,1,80,0,0,1,80,1.046864000,0.0000
57.81.32.230,<->,20.253.71.162,0,0,1,108,1,108,1.045612000,0.0000
153.138.22.47,<->,8.250.150.192,0,0,1,704,1,704,1.043664000,0.0000
143.238.206.42,<->,39.235.17.232,0,0,1,104,1,104,1.041502000,0.0000
202.218.18.146,<->,34.138.142.207,0,0,1,100,1,100,1.040608000,0.0000
204.232.153.60,<->,89.183.104.233,0,0,1,127,1,127,1.036114000,0.0000
126.232.82.91,<->,20.240.146.235,0,0,1,96,1,96,1.035070000,0.0000
215.158.28.164,<->,113.5.159.26,1,84,0,0,1,84,1.034890000,0.0000
119.214.19.142,<->,39.211.101.151,0,0,1,94,1,94,1.034445000,0.0000
207.84.192.23,<->,20.33.63.69,0,0,1,100,1,100,1.028881000,0.0000
198.72.184.220,<->,39.130.111.23,0,0,1,94,1,94,1.025070000,0.0000
106.8.173.4,<->,89.183.104.173,0,0,1,385,1,385,1.024228000,0.0000
124.48.195.122,<->,20.23.40.135,0,0,1,64,1,64,1.023594000,0.0000
117.158.226.123,<->,99.75.102.6,0,0,1,80,1,80,1.018955000,0.0000
207.7.215.98,<->,39.59.18.154,0,0,1,106,1,106,1.012796000,0.0000
119.53.11.236,<->,20.66.246.29,0,0,1,100,1,100,1.006434000,0.0000
119.226.24.74,<->,109.1.60.13,0,0,1,80,1,80,1.004880000,0.0000
255.133.229.164,<->,39.197.190.13,0,0,1,100,1,100,1.003327000,0.0000
159.109.242.247,<->,8.182.123.121,1,68,0,0,1,68,1.000591000,0.0000
210.56.117.49,<->,8.52.188.226,0,0,1,52,1,52,0.998412000,0.0000
119.39.61.63,<->,8.52.224.215,0,0,1,1002,1,1002,0.997018000,0.0000
98.67.150.212,<->,74.71.225.42,1,60,0,0,1,60,0.996690000,0.0000
204.145.55.177,<->,39.168.197.90,0,0,1,106,1,106,0.996597000,0.0000
195.80.61.254,<->,39.248.95.177,0,0,1,94,1,94,0.994819000,0.0000
221.104.152.204,<->,99.74.27.16,0,0,1,704,1,704,0.992406000,0.0000
192.242.74.225,<->,20.126.28.155,0,0,1,93,1,93,0.990448000,0.0000
8.191.134.120,<->,8.176.8.185,0,0,1,72,1,72,0.988774000,0.0000
194.124.56.24,<->,20.189.245.103,0,0,1,95,1,95,0.987986000,0.0000
207.68.17.26,<->,39.52.44.181,0,0,1,102,1,102,0.982153000,0.0000
255.133.229.164,<->,39.17.239.147,0,0,1,100,1,100,0.981312000,0.0000
205.170.79.59,<->,20.64.226.120,0,0,1,60,1,60,0.974023000,0.0000
194.200.121.191,<->,39.60.248.131,0,0,1,108,1,108,0.973371000,0.0000
255.133.229.164,<->,39.47.99.30,0,0,1,100,1,100,0.963313000,0.0000
125.216.39.13,<->,8.52.172.227,0,0,1,1002,1,1002,0.961699000,0.0000
236.27.8.176,<->,8.220.177.253,0,0,1,704,1,704,0.954868000,0.0000
194.205.102.239,<->,8.220.205.50,0,0,1,704,1,704,0.953537000,0.0000
93.223.130.31,<->,8.43.204.226,0,0,1,704,1,704,0.950026000,0.0000
194.228.3.111,<->,20.175.14.141,0,0,1,98,1,98,0.946245000,0.0000
113.160.227.65,<->,20.122.197.0,0,0,1,60,1,60,0.946234000,0.0000
204.146.255.169,<->,39.208.143.32,0,0,1,106,1,106,0.939584000,0.0000
199.111.214.254,<->,39.7.198.136,0,0,1,50,1,50,0.938042000,0.0000
204.159.151.35,<->,20.65.182.35,0,0,1,104,1,104,0.937611000,0.0000
194.202.218.12,<->,20.70.242.215,0,0,1,60,1,60,0.936045000,0.0000
141.86.219.67,<->,20.240.40.74,0,0,1,99,1,99,0.935534000,0.0000
82.99.240.203,<->,8.52.136.253,0,0,1,1002,1,1002,0.935146000,0.0000
69.246.48.77,<->,39.174.169.119,0,0,1,60,1,60,0.926595000,0.0000
204.51.48.163,<->,20.144.133.86,0,0,1,60,1,60,0.924353000,0.0000
199.37.1.124,<->,39.205.105.158,0,0,1,98,1,98,0.918100000,0.0000
132.149.114.9,<->,89.71.0.216,1,84,0,0,1,84,0.915491000,0.0000
215.158.239.117,<->,215.158.42.24,1,68,0,0,1,68,0.915364000,0.0000
155.134.111.140,<->,20.227.82.82,0,0,1,99,1,99,0.908576000,0.0000
140.147.61.107,<->,34.6.219.234,0,0,1,60,1,60,0.906202000,0.0000
204.183.160.72,<->,39.22.75.169,0,0,1,98,1,98,0.905482000,0.0000
215.158.238.205,<->,126.219.128.233,1,704,0,0,1,704,0.903455000,0.0000
196.15.212.97,<->,20.97.98.198,0,0,1,60,1,60,0.902624000,0.0000
255.133.229.164,<->,39.23.81.12,0,0,1,100,1,100,0.898693000,0.0000
159.115.27.135,<->,140.17.122.242,1,50,0,0,1,50,0.897292000,0.0000
118.34.147.242,<->,20.223.212.74,0,0,1,100,1,100,0.892053000,0.0000
149.172.146.71,<->,8.52.254.194,0,0,1,1002,1,1002,0.892011000,0.0000
96.31.78.38,<->,8.188.179.4,1,68,0,0,1,68,0.889663000,0.0000
148.189.137.47,<->,8.43.208.242,0,0,1,704,1,704,0.887813000,0.0000
139.1.221.199,<->,8.52.129.50,0,0,1,1002,1,1002,0.887031000,0.0000
199.25.155.118,<->,39.13.199.97,0,0,1,103,1,103,0.886896000,0.0000
107.252.198.177,<->,39.152.58.6,0,0,1,60,1,60,0.886236000,0.0000
204.26.38.62,<->,39.254.248.197,0,0,1,50,1,50,0.883130000,0.0000
204.51.210.14,<->,39.8.146.234,0,0,1,60,1,60,0.881971000,0.0000
145.16.95.20,<->,111.151.138.245,1,68,0,0,1,68,0.881575000,0.0000
255.133.229.164,<->,39.138.56.223,0,0,1,100,1,100,0.881174000,0.0000
122.158.177.249,<->,8.220.197.41,0,0,1,704,1,704,0.878186000,0.0000
134.198.176.78,<->,20.224.160.101,0,0,1,103,1,103,0.877133000,0.0000
140.17.122.243,<->,39.3.77.163,0,0,1,50,1,50,0.869538000,0.0000
119.42.194.105,<->,39.139.143.112,0,0,1,76,1,76,0.867819000,0.0000
27.179.156.245,<->,8.53.15.23,0,0,1,84,1,84,0.860624000,0.0000
221.98.77.247,<->,146.196.193.192,1,84,0,0,1,84,0.858180000,0.0000
121.20.242.142,<->,111.146.147.173,0,0,1,345,1,345,0.852601000,0.0000
114.172.236.63,<->,92.27.219.232,0,0,1,60,1,60,0.841470000,0.0000
207.225.144.168,<->,192.224.198.242,0,0,1,704,1,704,0.840363000,0.0000
158.164.134.203,<->,39.32.36.250,0,0,1,72,1,72,0.837096000,0.0000
126.236.200.252,<->,20.185.108.33,0,0,1,98,1,98,0.829921000,0.0000
92.27.219.19,<->,27.155.166.226,1,80,0,0,1,80,0.826672000,0.0000
144.76.46.38,<->,100.94.196.208,0,0,1,68,1,68,0.826200000,0.0000
252.36.107.253,<->,20.103.143.148,0,0,1,98,1,98,0.818683000,0.0000
69.246.56.234,<->,34.234.134.77,0,0,1,60,1,60,0.818043000,0.0000
99.75.122.179,<->,38.57.141.132,1,80,0,0,1,80,0.814750000,0.0000
195.50.2.240,<->,8.53.5.41,0,0,1,84,1,84,0.813927000,0.0000
239.66.15.243,<->,99.72.145.246,0,0,1,64,1,64,0.813190000,0.0000
104.210.192.24,<->,20.9.5.37,0,0,1,104,1,104,0.811333000,0.0000
69.240.233.230,<->,39.195.94.33,0,0,1,60,1,60,0.809860000,0.0000
195.83.190.20,<->,39.40.222.150,0,0,1,104,1,104,0.806859000,0.0000
136.25.188.106,<->,26.180.89.205,1,60,0,0,1,60,0.805513000,0.0000
254.241.226.209,<->,20.78.92.41,0,0,1,100,1,100,0.804238000,0.0000
69.246.49.61,<->,34.10.142.245,0,0,1,60,1,60,0.803091000,0.0000
195.50.67.42,<->,39.41.165.253,0,0,1,60,1,60,0.800591000,0.0000
198.72.185.252,<->,39.238.52.248,0,0,1,102,1,102,0.787943000,0.0000
196.68.53.205,<->,39.159.132.13,0,0,1,102,1,102,0.787383000,0.0000
197.58.137.254,<->,39.2.31.60,0,0,1,93,1,93,0.785853000,0.0000
140.147.61.91,<->,34.10.195.118,0,0,1,60,1,60,0.782194000,0.0000
76.2.0.240,<->,8.220.187.40,0,0,1,704,1,704,0.781441000,0.0000
127.101.245.243,<->,20.147.148.238,0,0,1,50,1,50,0.779339000,0.0000
143.88.89.23,<->,20.144.65.238,0,0,1,108,1,108,0.773693000,0.0000
129.160.244.26,<->,8.52.163.194,0,0,1,1002,1,1002,0.773129000,0.0000
33.233.141.33,<->,8.53.119.12,1,84,0,0,1,84,0.770675000,0.0000
89.183.104.149,<->,38.70.6.0,1,80,0,0,1,80,0.769003000,0.0000
113.106.21.134,<->,8.52.153.226,0,0,1,84,1,84,0.766556000,0.0000
130.19.95.191,<->,8.52.149.39,0,0,1,84,1,84,0.759217000,0.0000
159.23.130.160,<->,8.43.217.24,0,0,1,704,1,704,0.747769000,0.0000
21.137.241.193,<->,20.90.229.185,0,0,1,100,1,100,0.743912000,0.0000
221.102.113.102,<->,195.3.98.35,1,91,0,0,1,91,0.742022000,0.0000
125.207.203.96,<->,8.250.147.200,0,0,1,704,1,704,0.740445000,0.0000
247.136.235.140,<->,38.247.215.91,1,80,0,0,1,80,0.739445000,0.0000
192.64.217.166,<->,112.42.249.60,1,80,0,0,1,80,0.738416000,0.0000
158.184.99.167,<->,8.220.201.13,0,0,1,704,1,704,0.734632000,0.0000
132.49.236.207,<->,20.131.57.54,0,0,1,108,1,108,0.731723000,0.0000
157.208.128.9,<->,39.3.103.232,0,0,1,60,1,60,0.726506000,0.0000
131.141.160.17,<->,39.152.8.182,0,0,1,60,1,60,0.720053000,0.0000
119.122.228.54,<->,20.154.75.10,0,0,1,98,1,98,0.714709000,0.0000
141.108.105.215,<->,20.18.119.55,0,0,1,50,1,50,0.710709000,0.0000
125.216.6.208,<->,8.43.221.43,0,0,1,704,1,704,0.702955000,0.0000
215.158.238.205,<->,192.205.47.68,1,1002,0,0,1,1002,0.702410000,0.0000
201.219.35.9,<->,109.222.246.106,0,0,1,90,1,90,0.699436000,0.0000
76.101.120.55,<->,8.220.205.50,0,0,1,704,1,704,0.697243000,0.0000
143.20.121.215,<->,8.220.185.34,0,0,1,704,1,704,0.696591000,0.0000
146.196.107.134,<->,20.40.206.169,0,0,1,60,1,60,0.693893000,0.0000
196.13.0.1,<->,20.241.76.36,0,0,1,108,1,108,0.693281000,0.0000
89.183.104.160,<->,75.95.159.50,1,353,0,0,1,353,0.692852000,0.0000
60.103.87.91,<->,34.172.170.229,0,0,1,60,1,60,0.688681000,0.0000
126.219.56.231,<->,8.43.194.5,0,0,1,704,1,704,0.686130000,0.0000
215.158.239.117,<->,123.130.135.22,1,68,0,0,1,68,0.683377000,0.0000
124.38.144.229,<->,39.251.205.147,0,0,1,108,1,108,0.682799000,0.0000
204.25.101.14,<->,39.44.219.49,0,0,1,60,1,60,0.675736000,0.0000
230.58.201.38,<->,34.27.72.179,0,0,1,60,1,60,0.672153000,0.0000
204.181.177.50,<->,39.162.68.8,0,0,1,60,1,60,0.671999000,0.0000
136.25.189.47,<->,111.151.78.40,1,704,0,0,1,704,0.670248000,0.0000
206.103.215.240,<->,192.229.212.235,0,0,1,704,1,704,0.669870000,0.0000
215.158.1.207,<->,6.73.247.62,0,0,1,84,1,84,0.669756000,0.0000
140.174.85.71,<->,8.43.213.44,0,0,1,704,1,704,0.669698000,0.0000
199.63.179.13,<->,39.35.61.17,0,0,1,107,1,107,0.667074000,0.0000
199.14.159.160,<->,136.25.188.210,0,0,1,157,1,157,0.662052000,0.0000
197.154.195.217,<->,136.25.188.199,0,0,1,121,1,121,0.661081000,0.0000
120.181.9.116,<->,80.40.48.131,0,0,1,60,1,60,0.658797000,0.0000
120.190.31.249,<->,8.43.210.250,0,0,1,704,1,704,0.655959000,0.0000
207.62.9.159,<->,136.25.188.242,0,0,1,125,1,125,0.654692000,0.0000
215.158.199.136,<->,8.43.182.237,0,0,1,704,1,704,0.654416000,0.0000
204.50.252.177,<->,39.159.227.58,0,0,1,60,1,60,0.651001000,0.0000
149.102.122.164,<->,50.224.76.234,0,0,1,65,1,65,0.647937000,0.0000
220.60.50.113,<->,8.53.3.217,0,0,1,84,1,84,0.647587000,0.0000
89.183.104.145,<->,40.204.213.22,1,164,0,0,1,164,0.646509000,0.0000
207.7.180.232,<->,39.164.8.246,0,0,1,60,1,60,0.645746000,0.0000
148.146.75.16,<->,8.220.180.244,0,0,1,704,1,704,0.643606000,0.0000
205.152.222.67,<->,92.27.219.158,0,0,1,163,1,163,0.636706000,0.0000
118.98.251.158,<->,20.139.193.185,0,0,1,100,1,100,0.630728000,0.0000
96.48.137.8,<->,8.52.139.2,0,0,1,1004,1,1004,0.627145000,0.0000
123.112.8.250,<->,20.251.180.11,0,0,1,106,1,106,0.625576000,0.0000
92.27.219.219,<->,48.107.13.127,1,90,0,0,1,90,0.625084000,0.0000
100.188.18.234,<->,20.78.55.39,0,0,1,103,1,103,0.620539000,0.0000
58.11.224.8,<->,8.250.148.227,0,0,1,704,1,704,0.617773000,0.0000
121.167.63.19,<->,20.71.28.76,0,0,1,103,1,103,0.603137000,0.0000
255.133.229.164,<->,98.129.104.84,0,0,1,100,1,100,0.590730000,0.0000
92.27.219.150,<->,37.180.17.62,1,60,0,0,1,60,0.587283000,0.0000
145.118.217.235,<->,8.220.179.3,0,0,1,704,1,704,0.579211000,0.0000
196.213.224.133,<->,39.206.112.126,0,0,1,60,1,60,0.578305000,0.0000
192.242.189.168,<->,20.224.202.109,0,0,1,97,1,97,0.572915000,0.0000
140.17.122.242,<->,108.38.94.131,0,0,1,50,1,50,0.570586000,0.0000
237.56.14.109,<->,20.117.249.185,0,0,1,104,1,104,0.569632000,0.0000
8.222.48.144,<->,8.52.132.199,0,0,1,1002,1,1002,0.563327000,0.0000
158.85.50.75,<->,8.220.180.244,0,0,1,704,1,704,0.561660000,0.0000
143.76.151.4,<->,20.62.161.147,0,0,1,103,1,103,0.556033000,0.0000
255.133.229.164,<->,39.175.24.255,0,0,1,100,1,100,0.550337000,0.0000
135.77.53.12,<->,8.43.200.253,0,0,1,704,1,704,0.549873000,0.0000
249.129.136.216,<->,215.158.199.180,1,704,0,0,1,704,0.546740000,0.0000
193.51.144.62,<->,35.56.98.12,0,0,1,50,1,50,0.544128000,0.0000
158.51.95.95,<->,39.172.24.199,0,0,1,95,1,95,0.531843000,0.0000
207.116.181.94,<->,39.210.191.46,0,0,1,103,1,103,0.519868000,0.0000
195.26.48.140,<->,99.73.242.92,0,0,1,133,1,133,0.517573000,0.0000
114.225.110.244,<->,109.222.218.39,0,0,1,112,1,112,0.517059000,0.0000
108.35.43.81,<->,50.224.89.243,0,0,1,50,1,50,0.513069000,0.0000
125.197.11.161,<->,89.183.104.182,0,0,1,166,1,166,0.511335000,0.0000
199.105.28.169,<->,20.3.247.58,0,0,1,108,1,108,0.509274000,0.0000
120.119.180.74,<->,89.183.104.144,0,0,1,177,1,177,0.503896000,0.0000
149.99.39.90,<->,8.176.38.226,0,0,1,84,1,84,0.502297000,0.0000
140.17.122.242,<->,98.217.56.124,0,0,1,50,1,50,0.501916000,0.0000
255.133.229.164,<->,39.39.162.79,0,0,1,100,1,100,0.501554000,0.0000
204.147.48.36,<->,39.247.151.203,0,0,1,98,1,98,0.500476000,0.0000
199.89.59.174,<->,20.193.94.114,0,0,1,94,1,94,0.498562000,0.0000
192.67.161.91,<->,120.51.234.57,1,80,0,0,1,80,0.498232000,0.0000
195.39.113.211,<->,20.54.175.5,0,0,1,93,1,93,0.491189000,0.0000
158.164.134.203,<->,39.32.36.252,0,0,1,72,1,72,0.485504000,0.0000
239.227.103.52,<->,140.17.122.242,1,50,0,0,1,50,0.479271000,0.0000
192.229.208.216,<->,68.231.18.69,1,704,0,0,1,704,0.478876000,0.0000
142.222.33.198,<->,39.201.102.236,0,0,1,107,1,107,0.477027000,0.0000
149.163.240.29,<->,39.44.250.229,0,0,1,104,1,104,0.474854000,0.0000
195.87.206.134,<->,39.152.165.33,0,0,1,93,1,93,0.465004000,0.0000
136.25.189.47,<->,100.117.164.198,1,1002,0,0,1,1002,0.462075000,0.0000
113.163.15.15,<->,8.220.192.194,0,0,1,704,1,704,0.455990000,0.0000
116.153.202.111,<->,8.220.187.40,0,0,1,704,1,704,0.452693000,0.0000
196.236.94.136,<->,39.204.251.84,0,0,1,94,1,94,0.451151000,0.0000
109.222.251.106,<->,33.57.74.147,1,125,0,0,1,125,0.449893000,0.0000
39.36.96.222,<->,38.183.156.183,1,93,0,0,1,93,0.449140000,0.0000
199.115.143.194,<->,39.128.123.154,0,0,1,103,1,103,0.444361000,0.0000
196.63.216.97,<->,39.41.176.229,0,0,1,60,1,60,0.444359000,0.0000
255.133.229.164,<->,39.167.65.47,0,0,1,100,1,100,0.439417000,0.0000
196.14.198.174,<->,20.148.210.229,0,0,1,102,1,102,0.433773000,0.0000
106.22.183.117,<->,20.64.170.2,0,0,1,60,1,60,0.424452000,0.0000
201.212.14.151,<->,39.207.143.241,0,0,1,64,1,64,0.420948000,0.0000
204.11.248.222,<->,39.193.8.8,0,0,1,94,1,94,0.414404000,0.0000
221.98.99.233,<->,148.57.134.57,1,84,0,0,1,84,0.401998000,0.0000
141.191.13.155,<->,39.0.95.117,0,0,1,104,1,104,0.399520000,0.0000
196.74.186.233,<->,39.20.46.0,0,0,1,104,1,104,0.397997000,0.0000
215.158.239.210,<->,111.151.71.75,1,84,0,0,1,84,0.393114000,0.0000
76.96.28.29,<->,20.226.92.160,0,0,1,60,1,60,0.390046000,0.0000
215.158.199.180,<->,101.65.255.233,0,0,1,704,1,704,0.386678000,0.0000
194.201.14.91,<->,20.23.44.25,0,0,1,103,1,103,0.380170000,0.0000
197.197.246.234,<->,39.243.58.114,0,0,1,108,1,108,0.380001000,0.0000
204.51.118.227,<->,39.6.23.0,0,0,1,60,1,60,0.376857000,0.0000
116.111.127.70,<->,39.141.135.129,0,0,1,60,1,60,0.371906000,0.0000
148.157.159.25,<->,8.43.220.234,0,0,1,84,1,84,0.370294000,0.0000
255.133.229.164,<->,39.48.242.143,0,0,1,100,1,100,0.369599000,0.0000
92.27.219.235,<->,60.149.94.152,1,132,0,0,1,132,0.363464000,0.0000
139.254.209.152,<->,8.182.123.88,1,68,0,0,1,68,0.359003000,0.0000
145.16.26.17,<->,113.188.193.169,1,68,0,0,1,68,0.356239000,0.0000
76.187.234.228,<->,39.211.201.158,0,0,1,103,1,103,0.353932000,0.0000
198.14.7.174,<->,39.140.36.23,0,0,1,104,1,104,0.350172000,0.0000
202.218.167.205,<->,34.121.158.24,0,0,1,106,1,106,0.347687000,0.0000
108.39.242.156,<->,65.26.119.133,1,60,0,0,1,60,0.347176000,0.0000
207.167.195.47,<->,39.149.0.141,0,0,1,102,1,102,0.346588000,0.0000
207.36.127.222,<->,39.154.44.30,0,0,1,60,1,60,0.346175000,0.0000
215.158.140.162,<->,139.69.162.109,1,1004,0,0,1,1004,0.344908000,0.0000
227.229.200.72,<->,39.141.146.133,0,0,1,100,1,100,0.344037000,0.0000
159.209.217.88,<->,145.19.9.13,0,0,1,88,1,88,0.343062000,0.0000
136.25.189.47,<->,124.172.20.249,1,1002,0,0,1,1002,0.337861000,0.0000
141.57.72.223,<->,111.147.221.24,0,0,1,60,1,60,0.336687000,0.0000
98.67.139.204,<->,8.198.182.253,1,84,0,0,1,84,0.336232000,0.0000
106.188.184.144,<->,8.220.203.35,0,0,1,704,1,704,0.334519000,0.0000
99.74.27.16,<->,8.251.27.197,1,704,0,0,1,704,0.333422000,0.0000
149.172.111.213,<->,109.222.192.25,0,0,1,166,1,166,0.331562000,0.0000
120.117.98.110,<->,39.171.195.90,0,0,1,60,1,60,0.327369000,0.0000
111.151.221.231,<->,97.126.31.65,0,0,1,1004,1,1004,0.308213000,0.0000
195.117.147.52,<->,39.60.111.77,0,0,1,104,1,104,0.307450000,0.0000
133.178.227.69,<->,6.73.247.37,1,72,0,0,1,72,0.307032000,0.0000
128.158.125.168,<->,8.43.214.50,0,0,1,84,1,84,0.306853000,0.0000
69.246.57.11,<->,34.216.36.20,0,0,1,60,1,60,0.304389000,0.0000
115.249.71.20,<->,8.43.212.233,0,0,1,84,1,84,0.301173000,0.0000
237.56.23.121,<->,20.112.155.153,0,0,1,60,1,60,0.300773000,0.0000
192.229.219.28,<->,93.188.226.109,1,84,0,0,1,84,0.299090000,0.0000
194.253.238.252,<->,20.237.231.240,0,0,1,99,1,99,0.297515000,0.0000
192.242.182.171,<->,20.79.117.226,0,0,1,103,1,103,0.296142000,0.0000
215.158.238.205,<->,29.212.198.219,1,1002,0,0,1,1002,0.295276000,0.0000
235.237.188.148,<->,20.163.77.9,0,0,1,107,1,107,0.294075000,0.0000
121.242.143.12,<->,80.41.18.181,0,0,1,369,1,369,0.280596000,0.0000
196.88.35.234,<->,136.25.188.253,0,0,1,129,1,129,0.278771000,0.0000
204.159.249.166,<->,20.112.194.213,0,0,1,104,1,104,0.273912000,0.0000
204.183.168.70,<->,20.187.113.160,0,0,1,104,1,104,0.270218000,0.0000
156.164.9.225,<->,39.208.64.39,0,0,1,94,1,94,0.267609000,0.0000
211.11.4.252,<->,92.27.27.143,0,0,1,80,1,80,0.267170000,0.0000
215.158.238.205,<->,8.61.250.216,1,704,0,0,1,704,0.260401000,0.0000
144.232.222.1,<->,89.183.107.46,0,0,1,88,1,88,0.260119000,0.0000
69.246.49.151,<->,20.19.230.173,0,0,1,60,1,60,0.256574000,0.0000
255.133.229.164,<->,102.50.107.213,0,0,1,100,1,100,0.256054000,0.0000
192.67.149.88,<->,134.97.174.253,1,80,0,0,1,80,0.250921000,0.0000
156.164.246.134,<->,39.144.16.99,0,0,1,102,1,102,0.250588000,0.0000
144.227.67.90,<->,128.156.85.198,1,1004,0,0,1,1004,0.242603000,0.0000
215.158.140.240,<->,8.213.202.204,1,704,0,0,1,704,0.238334000,0.0000
158.94.211.91,<->,8.52.132.199,0,0,1,84,1,84,0.237680000,0.0000
192.229.213.201,<->,115.236.122.18,1,84,0,0,1,84,0.229740000,0.0000
112.204.192.86,<->,8.250.148.227,0,0,1,84,1,84,0.227093000,0.0000
195.42.107.156,<->,136.25.188.199,0,0,1,92,1,92,0.226761000,0.0000
42.204.17.198,<->,20.151.146.24,0,0,1,50,1,50,0.226660000,0.0000
158.225.226.228,<->,8.220.234.210,0,0,1,84,1,84,0.223149000,0.0000
197.126.179.66,<->,39.173.118.217,0,0,1,103,1,103,0.216607000,0.0000
57.189.25.121,<->,39.40.0.45,0,0,1,103,1,103,0.215188000,0.0000
68.65.48.62,<->,34.6.83.121,0,0,1,60,1,60,0.212681000,0.0000
193.29.109.175,<->,20.251.205.87,0,0,1,92,1,92,0.208552000,0.0000
133.178.227.69,<->,29.211.238.48,1,72,0,0,1,72,0.203239000,0.0000
158.91.200.210,<->,8.43.197.220,0,0,1,84,1,84,0.200989000,0.0000
139.7.138.92,<->,133.178.227.69,0,0,1,72,1,72,0.199811000,0.0000
204.182.162.77,<->,20.14.198.141,0,0,1,103,1,103,0.198867000,0.0000
204.158.156.69,<->,20.177.115.146,0,0,1,106,1,106,0.193943000,0.0000
255.133.229.164,<->,39.7.107.249,0,0,1,100,1,100,0.188677000,0.0000
199.111.23.145,<->,39.34.6.147,0,0,1,96,1,96,0.185202000,0.0000
196.1.91.184,<->,39.145.4.201,0,0,1,100,1,100,0.178109000,0.0000
215.158.3.104,<->,6.73.247.2,0,0,1,72,1,72,0.170484000,0.0000
66.90.124.145,<->,34.176.134.118,0,0,1,102,1,102,0.169661000,0.0000
207.49.136.151,<->,8.52.228.245,0,0,1,84,1,84,0.168770000,0.0000
141.11.249.114,<->,20.159.134.46,0,0,1,96,1,96,0.155663000,0.0000
124.57.226.241,<->,20.196.179.188,0,0,1,96,1,96,0.147145000,0.0000
105.135.77.221,<->,20.97.187.132,0,0,1,60,1,60,0.146470000,0.0000
92.27.219.223,<->,38.64.55.57,1,90,0,0,1,90,0.142420000,0.0000
204.108.90.50,<->,39.138.25.78,0,0,1,100,1,100,0.137448000,0.0000
114.80.83.75,<->,8.43.213.44,0,0,1,84,1,84,0.135743000,0.0000
196.0.216.90,<->,39.131.52.108,0,0,1,96,1,96,0.128298000,0.0000
215.158.140.240,<->,192.170.210.149,1,1002,0,0,1,1002,0.124302000,0.0000
255.133.229.164,<->,39.50.242.7,0,0,1,100,1,100,0.123976000,0.0000
109.1.59.56,<->,80.235.12.235,1,176,0,0,1,176,0.121040000,0.0000
89.183.104.166,<->,67.0.122.210,1,90,0,0,1,90,0.119755000,0.0000
215.158.140.240,<->,122.158.70.36,1,1002,0,0,1,1002,0.117696000,0.0000
196.13.204.65,<->,39.63.226.253,0,0,1,60,1,60,0.116314000,0.0000
207.38.173.138,<->,20.183.65.116,0,0,1,96,1,96,0.111622000,0.0000
124.58.142.197,<->,8.52.241.18,0,0,1,84,1,84,0.105371000,0.0000
8.188.179.3,<->,8.176.8.68,0,0,1,68,1,68,0.097972000,0.0000
109.222.251.106,<->,93.226.210.241,1,84,0,0,1,84,0.097956000,0.0000
80.41.32.57,<->,38.169.20.202,1,80,0,0,1,80,0.094256000,0.0000
199.110.162.183,<->,39.165.126.12,0,0,1,102,1,102,0.093846000,0.0000
204.31.30.117,<->,39.1.151.145,0,0,1,102,1,102,0.090046000,0.0000
96.38.142.249,<->,8.52.255.8,0,0,1,84,1,84,0.082673000,0.0000
146.154.165.212,<->,39.144.112.17,0,0,1,60,1,60,0.080492000,0.0000
204.180.152.126,<->,20.174.114.169,0,0,1,103,1,103,0.079174000,0.0000
136.25.188.198,<->,111.78.214.43,1,157,0,0,1,157,0.077006000,0.0000
205.42.126.9,<->,39.206.191.193,0,0,1,60,1,60,0.074633000,0.0000
135.251.133.132,<->,92.27.219.148,0,0,1,80,1,80,0.069918000,0.0000
136.25.188.106,<->,26.180.89.62,1,60,0,0,1,60,0.066477000,0.0000
133.178.226.168,<->,8.58.230.11,1,84,0,0,1,84,0.065563000,0.0000
50.159.31.45,<->,8.250.152.227,0,0,1,84,1,84,0.064139000,0.0000
17.97.9.35,<->,8.52.173.56,0,0,1,84,1,84,0.062421000,0.0000
101.87.46.107,<->,8.220.201.13,0,0,1,84,1,84,0.062160000,0.0000
142.190.104.227,<->,136.25.188.226,0,0,1,84,1,84,0.057182000,0.0000
221.102.104.221,<->,158.236.141.190,1,84,0,0,1,84,0.045528000,0.0000
50.224.80.229,<->,50.224.13.98,1,100,0,0,1,100,0.045479000,0.0000
204.98.37.240,<->,39.41.183.33,0,0,1,100,1,100,0.044170000,0.0000
195.4.81.167,<->,20.108.206.120,0,0,1,98,1,98,0.043472000,0.0000
148.157.229.161,<->,144.75.218.241,0,0,1,60,1,60,0.040010000,0.0000
255.133.229.164,<->,39.252.118.186,0,0,1,100,1,100,0.037922000,0.0000
242.180.253.31,<->,8.220.199.37,0,0,1,84,1,84,0.037069000,0.0000
38.50.224.17,<->,20.202.58.224,0,0,1,104,1,104,0.025855000,0.0000
112.153.46.24,<->,92.27.219.252,0,0,1,80,1,80,0.025133000,0.0000
69.246.57.135,<->,20.29.17.125,0,0,1,60,1,60,0.023762000,0.0000
17.98.79.183,<->,8.52.239.51,0,0,1,84,1,84,0.020214000,0.0000
255.133.229.164,<->,39.225.232.32,0,0,1,100,1,100,0.020067000,0.0000
97.126.31.80,<->,89.124.155.59,1,1002,0,0,1,1002,0.019270000,0.0000
124.53.158.31,<->,20.12.117.106,0,0,1,108,1,108,0.009427000,0.0000
104.245.139.155,<->,89.183.104.145,0,0,1,164,1,164,0.003884000,0.0000
137.21.23.55,<->,8.218.124.70,1,1002,0,0,1,1002,0.002172000,0.0000
192.67.147.89,<->,122.4.58.170,1,60,0,0,1,60,0.000430000,0.0000
