src:port,sep,dst:port,inframes,inbytes,outframes,outbytes,totalframes,totalbytes,relstart,duration
109.97.67.71:36748,<->,92.27.27.185:http-alt,0,0,3880,5835520,3880,5835520,0.004506000,1.9954
252.98.181.203:ipsec-nat-t,<->,139.254.110.36:ipsec-nat-t,2080,2830768,0,0,2080,2830768,0.001749000,1.9975
92.27.27.179:59775,<->,148.214.83.199:34903,826,1203482,0,0,826,1203482,0.020736000,1.9750
131.148.66.172:at-nbp,<->,20.206.10.26:netbios-ns,0,0,762,62484,762,62484,0.220441000,1.6019
230.102.130.22:64732,<->,133.178.227.222:9043,0,0,733,624403,733,624403,0.000236000,1.9995
105.113.53.185:45778,<->,92.27.219.43:27734,0,0,718,378164,718,378164,0.022238000,1.9750
127.161.158.33:28605,<->,192.64.194.99:17891,0,0,707,1027988,707,1027988,0.005265000,1.9927
144.253.55.140:54330,<->,133.178.227.200:9043,0,0,482,504454,482,504454,0.018361000,1.9751
247.136.132.126:45892,<->,93.181.154.100:35846,442,23640,0,0,442,23640,0.010717000,1.9287
152.12.153.239:65325,<->,89.183.104.135:http-alt,0,0,435,358975,435,358975,0.102488000,1.8477
220.211.201.206:16402,<->,133.178.227.152:ibm3494,0,0,432,129034,432,129034,0.004044000,1.9924
124.59.106.210:15750,<->,109.222.212.23:14758,0,0,405,589680,405,589680,0.003362000,1.9962
69.31.239.50:47150,<->,133.178.227.207:9043,0,0,405,84372,405,84372,0.000599000,1.9952
192.67.146.96:60513,<->,232.111.67.19:ipsec-nat-t,401,350228,0,0,401,350228,0.017747000,1.9592
8.238.204.1:16402,<->,215.158.2.80:swr-port,399,92238,0,0,399,92238,0.002284000,1.9911
82.252.43.154:53479,<->,198.230.143.36:47682,368,360343,0,0,368,360343,0.000165000,1.9998
83.232.206.116:16402,<->,133.178.227.145:nut,0,0,355,104074,355,104074,0.000051000,1.9917
110.63.236.92:43940,<->,92.27.219.40:16029,0,0,345,502896,345,502896,0.003593000,1.9846
80.40.19.83:16469,<->,195.88.168.52:14613,284,14786,0,0,284,14786,0.037265000,1.9559
193.45.87.23:find,<->,192.67.144.51:15103,0,0,280,14560,280,14560,0.008529000,1.9801
192.67.183.27:35014,<->,148.54.19.75:12037,264,13728,0,0,264,13728,0.000340000,1.6919
67.240.216.233:59008,<->,92.27.219.165:http-alt,0,0,254,124054,254,124054,0.008929000,1.9788
80.47.152.63:52116,<->,133.178.227.223:9042,0,0,251,258007,251,258007,0.000119000,1.9993
249.101.194.110:53906,<->,122.228.233.173:22010,233,12116,0,0,233,12116,0.034969000,1.9233
108.39.227.100:16402,<->,215.158.2.83:colubris,223,127613,0,0,223,127613,0.007995000,1.9805
80.42.213.194:51074,<->,89.220.215.61:9124,207,19216,0,0,207,19216,0.007531000,1.9911
204.42.61.33:6237,<->,246.253.253.207:https,0,0,206,60326,206,60326,0.007781000,1.8655
108.32.18.191:63076,<->,89.183.104.136:http-alt,0,0,205,28513,205,28513,0.010844000,1.9848
76.72.21.156:37823,<->,111.147.141.67:35299,0,0,204,13868,204,13868,0.012287000,1.4502
144.93.121.86:39038,<->,113.171.246.29:23166,200,24800,0,0,200,24800,0.009066000,1.9900
144.93.121.86:55724,<->,113.171.246.29:23988,200,24800,0,0,200,24800,0.006739000,1.9900
113.171.246.29:33728,<->,144.93.121.86:12244,0,0,200,24800,200,24800,0.005167000,1.9900
144.93.121.86:60512,<->,113.171.246.29:29362,200,24800,0,0,200,24800,0.004041000,1.9900
113.171.246.29:31938,<->,144.93.121.10:10518,0,0,200,24800,200,24800,0.001568000,1.9900
89.183.104.172:38162,<->,119.255.203.35:32381,200,11143,0,0,200,11143,0.000684000,1.9114
117.18.226.85:36170,<->,92.27.219.151:25866,0,0,198,288684,198,288684,0.099355000,1.8940
230.102.130.12:45114,<->,133.178.227.215:9042,0,0,191,108620,191,108620,0.002217000,1.9738
111.147.65.245:61969,<->,76.15.3.35:blackjack,188,97500,0,0,188,97500,0.057234000,1.9394
89.183.104.231:38884,<->,33.57.74.172:38339,183,199661,0,0,183,199661,0.003270000,1.9929
50.51.22.133:56341,<->,133.178.227.145:ibm3494,0,0,180,35192,180,35192,0.153834000,0.8538
100.95.198.6:37939,<->,198.43.254.51:32605,172,247964,0,0,172,247964,0.817795000,1.1670
56.121.49.236:59532,<->,114.74.11.114:ipsec-nat-t,172,222592,0,0,172,222592,0.030899000,1.9665
114.193.59.188:58040,<->,92.27.27.187:http-alt,0,0,170,33042,170,33042,0.004065000,1.9924
92.27.27.151:28968,<->,243.156.114.200:26126,165,8580,0,0,165,8580,0.002802000,1.8734
249.101.104.134:62958,<->,139.165.148.255:https,164,37716,0,0,164,37716,0.013507000,1.9798
98.129.85.115:63615,<->,57.62.248.124:56592,143,7972,0,0,143,7972,0.004746000,1.8248
139.249.88.21:57179,<->,159.108.77.35:https,142,53094,0,0,142,53094,0.281171000,1.7030
104.81.132.140:62348,<->,92.27.219.195:33793,0,0,142,8161,142,8161,0.015562000,1.9696
215.158.66.194:ciscocsdb,<->,133.178.227.207:9043,0,0,137,54590,137,54590,0.007284000,1.9913
111.151.139.139:33713,<->,8.252.221.89:lansource,0,0,131,128147,131,128147,0.009239000,1.9664
109.222.219.127:65343,<->,50.182.187.249:18274,128,6704,0,0,128,6704,0.010013000,1.9703
89.183.104.251:42149,<->,141.37.44.96:21618,127,186690,0,0,127,186690,0.007375000,1.9632
192.64.200.221:52051,<->,35.56.30.5:7788,125,12558,0,0,125,12558,0.001173000,1.9918
117.20.112.178:65405,<->,89.183.104.229:http-alt,0,0,123,184992,123,184992,0.008152000,1.9833
109.222.209.181:59185,<->,206.248.77.125:22656,120,171520,0,0,120,171520,0.107554000,1.7583
148.141.174.148:62944,<->,35.56.97.156:7788,0,0,120,10560,120,10560,0.012461000,1.9820
112.151.85.120:52033,<->,35.56.97.124:7808,0,0,120,7110,120,7110,0.009325000,1.9808
89.183.110.45:fsc-port,<->,0.97.210.184:scol,119,13916,0,0,119,13916,0.161798000,1.8315
89.183.104.246:51622,<->,121.215.68.28:25597,117,162064,0,0,117,162064,0.149739000,1.8262
118.215.113.160:59299,<->,89.183.104.246:36647,0,0,116,170520,116,170520,0.221087000,1.7345
82.252.33.45:53809,<->,226.68.196.217:ipsec-nat-t,115,36396,0,0,115,36396,0.003846000,1.9796
76.178.78.215:53863,<->,89.183.104.141:http-alt,0,0,115,54959,115,54959,0.002944000,1.9715
105.104.5.199:56303,<->,39.48.2.224:domain,0,0,114,7036,114,7036,0.010138000,0.9405
194.220.68.39:51171,<->,246.253.253.210:https,0,0,110,17142,110,17142,0.015170000,1.9712
89.183.104.159:54251,<->,100.188.51.6:48319,109,121099,0,0,109,121099,0.020284000,1.9651
149.110.19.113:28773,<->,89.183.104.148:13261,0,0,105,151580,105,151580,0.525680000,1.2333
204.43.169.138:58817,<->,246.253.253.210:https,0,0,105,16565,105,16565,0.013499000,1.9775
149.193.32.35:26800,<->,102.51.78.239:12656,0,0,104,131456,104,131456,0.023613000,1.9108
200.174.209.33:37954,<->,102.72.16.148:22356,104,150432,0,0,104,150432,0.008944000,1.9721
204.42.246.7:61095,<->,246.253.253.208:https,0,0,103,16315,103,16315,0.011226000,1.9804
192.64.235.125:61477,<->,127.161.224.79:13047,103,14960,0,0,103,14960,0.003200000,1.9962
50.128.200.204:16402,<->,139.69.162.189:swr-port,102,13908,0,0,102,13908,0.015260000,1.9801
204.42.167.55:63851,<->,246.253.253.210:https,0,0,101,15857,101,15857,0.002039000,1.9954
111.146.189.146:64534,<->,132.227.248.61:https,101,16017,0,0,101,16017,0.000883000,1.9856
144.93.121.10:62066,<->,159.46.201.24:26428,101,20604,0,0,101,20604,0.000312000,1.9979
144.93.120.177:57858,<->,144.93.121.48:43288,0,0,100,20400,100,20400,0.019936000,1.9800
144.93.121.48:40336,<->,144.93.120.177:8774,100,20400,0,0,100,20400,0.019862000,1.9801
144.93.120.177:48816,<->,144.93.121.86:31530,0,0,100,20400,100,20400,0.019729000,1.9800
144.93.120.177:51370,<->,144.93.121.86:33090,0,0,100,20400,100,20400,0.019729000,1.9800
144.93.121.86:36268,<->,144.93.120.28:13710,100,20400,0,0,100,20400,0.019473000,1.9800
144.93.121.86:59612,<->,144.93.120.177:9180,100,20400,0,0,100,20400,0.019336000,1.9800
144.93.121.83:62090,<->,159.46.201.109:14744,100,20400,0,0,100,20400,0.019046000,1.9800
144.93.121.10:16304,<->,144.93.120.177:8314,100,20400,0,0,100,20400,0.018926000,1.9800
98.198.84.28:28600,<->,144.93.121.83:rtsp-alt,0,0,100,20400,100,20400,0.018886000,1.9800
144.93.121.10:42188,<->,144.93.120.177:28728,100,20400,0,0,100,20400,0.018805000,1.9800
144.93.121.48:47672,<->,144.93.120.177:9054,100,20400,0,0,100,20400,0.018738000,1.9800
144.93.120.177:46484,<->,144.93.121.50:37340,0,0,100,20400,100,20400,0.018584000,1.9800
144.93.121.10:32130,<->,144.93.120.177:23854,100,20400,0,0,100,20400,0.018574000,1.9800
144.93.125.49:50024,<->,144.93.121.86:29426,0,0,100,20400,100,20400,0.018570000,1.9800
144.93.121.86:33152,<->,144.93.120.177:27854,100,20400,0,0,100,20400,0.018539000,1.9800
144.93.121.10:63532,<->,144.93.120.177:50894,100,20400,0,0,100,20400,0.018370000,1.9800
144.93.121.48:60832,<->,144.93.120.177:23816,100,20400,0,0,100,20400,0.017968000,1.9800
144.93.120.177:60662,<->,144.93.121.10:29822,0,0,100,20400,100,20400,0.017943000,1.9800
144.93.120.177:20576,<->,144.93.121.10:9040,0,0,100,20400,100,20400,0.017935000,1.9800
144.93.121.48:54116,<->,144.93.120.177:50626,100,20400,0,0,100,20400,0.017883000,1.9800
144.93.121.48:40552,<->,144.93.120.177:18394,100,20400,0,0,100,20400,0.017846000,1.9800
144.93.120.177:63310,<->,144.93.121.48:25560,0,0,100,20400,100,20400,0.017828000,1.9800
144.93.120.28:38464,<->,144.93.121.86:11732,0,0,100,20400,100,20400,0.017797000,1.9800
144.93.120.177:45368,<->,144.93.121.86:9842,0,0,100,20400,100,20400,0.017778000,1.9800
144.93.121.48:27732,<->,144.93.120.177:22568,100,20400,0,0,100,20400,0.017732000,1.9800
144.93.121.86:62616,<->,144.93.120.177:24308,100,20400,0,0,100,20400,0.017730000,1.9800
144.93.121.48:50236,<->,144.93.120.177:18508,100,20400,0,0,100,20400,0.017539000,1.9800
144.93.125.38:28464,<->,144.93.121.86:6170,0,0,100,20400,100,20400,0.017301000,1.9800
144.93.125.48:58580,<->,144.93.121.86:28190,0,0,100,20400,100,20400,0.017249000,1.9800
144.93.121.86:32704,<->,144.93.120.177:17664,100,20400,0,0,100,20400,0.017083000,1.9800
144.93.121.10:40288,<->,144.93.120.177:10578,100,20400,0,0,100,20400,0.017052000,1.9800
144.93.121.86:30774,<->,144.93.120.177:9506,100,20400,0,0,100,20400,0.016832000,1.9800
144.93.121.48:22336,<->,144.93.120.28:18312,100,20400,0,0,100,20400,0.016822000,1.9800
144.93.121.50:22712,<->,144.93.120.28:13276,100,20400,0,0,100,20400,0.016721000,1.9800
144.93.121.86:51052,<->,144.93.120.177:20874,100,20400,0,0,100,20400,0.016699000,1.9800
144.93.121.10:46282,<->,144.93.120.177:10838,100,20400,0,0,100,20400,0.016378000,1.9800
144.93.121.86:35578,<->,144.93.120.177:8602,100,20400,0,0,100,20400,0.016106000,1.9800
144.93.125.32:43404,<->,144.93.121.50:25288,0,0,100,20400,100,20400,0.016079000,1.9800
144.93.120.177:33990,<->,144.93.121.48:22556,0,0,100,20400,100,20400,0.015661000,1.9800
144.93.120.177:54536,<->,144.93.121.10:18978,0,0,100,20400,100,20400,0.015653000,1.9800
144.93.121.86:54396,<->,144.93.125.49:20108,100,20400,0,0,100,20400,0.015572000,1.9800
144.93.121.86:54752,<->,144.93.125.49:50380,100,20400,0,0,100,20400,0.015519000,1.9800
144.93.120.177:33788,<->,144.93.121.86:27286,0,0,100,20400,100,20400,0.015254000,1.9800
144.93.120.177:33210,<->,144.93.121.86:11914,0,0,100,20400,100,20400,0.015170000,1.9800
144.93.120.177:62384,<->,144.93.121.50:36724,0,0,100,20400,100,20400,0.014954000,1.9800
144.93.120.177:58982,<->,144.93.121.86:53880,0,0,100,20400,100,20400,0.014911000,1.9800
144.93.121.10:41556,<->,144.93.125.49:34164,100,20400,0,0,100,20400,0.014556000,1.9800
159.46.201.28:22576,<->,144.93.121.86:11886,0,0,100,20400,100,20400,0.014532000,1.9799
144.93.121.50:48324,<->,144.93.120.177:18990,100,20400,0,0,100,20400,0.014425000,1.9800
144.93.121.48:48060,<->,144.93.120.177:46614,100,20400,0,0,100,20400,0.014422000,1.9800
144.93.125.48:55908,<->,144.93.121.86:39668,0,0,100,20400,100,20400,0.014297000,1.9800
144.93.125.48:64608,<->,144.93.121.86:42416,0,0,100,20400,100,20400,0.014267000,1.9800
144.93.120.177:31324,<->,144.93.121.86:14016,0,0,100,20400,100,20400,0.014226000,1.9800
145.2.46.169:21692,<->,144.93.121.10:21538,0,0,100,20400,100,20400,0.013898000,1.9800
144.93.121.86:24046,<->,144.93.120.177:7578,100,20400,0,0,100,20400,0.013847000,1.9800
144.93.120.177:64408,<->,144.93.121.10:48972,0,0,100,20400,100,20400,0.013678000,1.9800
144.93.121.83:45550,<->,101.71.113.171:30396,100,20400,0,0,100,20400,0.013602000,1.9800
144.93.125.49:38952,<->,144.93.121.10:21902,0,0,100,20400,100,20400,0.013600000,1.9800
144.93.125.48:54452,<->,144.93.121.86:51070,0,0,100,20400,100,20400,0.013255000,1.9800
144.93.121.10:19654,<->,144.93.120.177:acme,100,20400,0,0,100,20400,0.013049000,1.9800
144.93.121.10:igrid,<->,144.93.120.28:9906,100,20400,0,0,100,20400,0.012994000,1.9800
144.93.121.86:12258,<->,144.93.120.177:11606,100,20400,0,0,100,20400,0.012654000,1.9800
144.93.120.28:62500,<->,144.93.121.50:22228,0,0,100,20400,100,20400,0.012653000,1.9799
144.93.120.177:49450,<->,144.93.121.10:22892,0,0,100,20400,100,20400,0.012453000,1.9800
144.93.121.10:54866,<->,144.93.120.177:18966,100,20400,0,0,100,20400,0.012355000,1.9800
144.93.125.48:49140,<->,144.93.121.86:14010,0,0,100,20400,100,20400,0.012302000,1.9800
144.93.121.86:61894,<->,144.93.125.48:55284,100,20400,0,0,100,20400,0.012292000,1.9800
144.93.121.50:25124,<->,144.93.120.177:11456,100,20400,0,0,100,20400,0.012261000,1.9800
144.93.121.48:53268,<->,144.93.120.177:19818,100,20400,0,0,100,20400,0.012160000,1.9800
137.83.230.7:61990,<->,50.23.57.66:14570,100,20400,0,0,100,20400,0.011853000,1.9821
144.93.121.10:60768,<->,144.93.120.177:swa-4,100,20400,0,0,100,20400,0.011777000,1.9800
144.93.121.48:59260,<->,144.93.120.177:50996,100,20400,0,0,100,20400,0.011739000,1.9800
144.93.121.10:55606,<->,144.93.120.177:20568,100,20400,0,0,100,20400,0.011716000,1.9800
144.93.120.177:44830,<->,144.93.121.10:33814,0,0,100,20400,100,20400,0.011577000,1.9800
144.93.120.177:39342,<->,144.93.121.50:22640,0,0,100,20400,100,20400,0.011472000,1.9800
144.93.121.48:47684,<->,144.93.120.177:nta-ds,100,20400,0,0,100,20400,0.011332000,1.9800
144.93.120.177:53766,<->,144.93.121.48:24756,0,0,100,20400,100,20400,0.011179000,1.9800
144.93.121.10:60360,<->,144.93.120.177:15530,100,20400,0,0,100,20400,0.011029000,1.9800
113.178.109.84:50852,<->,144.93.121.83:22238,0,0,100,20400,100,20400,0.010880000,1.9800
144.93.121.86:50014,<->,144.93.120.177:entextlow,100,20400,0,0,100,20400,0.010785000,1.9800
144.93.120.177:59462,<->,144.93.121.86:58396,0,0,100,20400,100,20400,0.010636000,1.9800
220.14.74.249:55746,<->,35.56.98.184:8858,0,0,100,20400,100,20400,0.010615000,1.9800
144.93.120.177:35020,<->,144.93.121.48:31516,0,0,100,20400,100,20400,0.010587000,1.9799
144.93.125.49:36264,<->,144.93.121.10:17122,0,0,100,20400,100,20400,0.010580000,1.9800
144.93.125.49:63584,<->,144.93.121.10:41874,0,0,100,20400,100,20400,0.010574000,1.9800
144.93.120.28:50462,<->,144.93.121.10:13470,0,0,100,20400,100,20400,0.010542000,1.9799
144.93.120.177:39932,<->,144.93.121.48:37712,0,0,100,20400,100,20400,0.010447000,1.9800
144.93.120.177:46034,<->,144.93.121.50:20552,0,0,100,20400,100,20400,0.010308000,1.9800
144.93.121.10:51374,<->,144.93.125.38:27132,100,20400,0,0,100,20400,0.010250000,1.9800
144.93.120.28:26850,<->,144.93.121.50:24536,0,0,100,20400,100,20400,0.010245000,1.9800
220.14.74.198:49666,<->,35.56.98.184:9046,0,0,100,20400,100,20400,0.010182000,1.9800
144.93.121.50:62524,<->,144.93.120.177:60784,100,20400,0,0,100,20400,0.010162000,1.9800
144.93.121.10:45352,<->,144.93.120.177:44768,100,20400,0,0,100,20400,0.010049000,1.9800
144.93.121.86:59518,<->,144.93.120.177:21308,100,20400,0,0,100,20400,0.009985000,1.9800
144.93.120.177:35234,<->,144.93.121.48:20904,0,0,100,20400,100,20400,0.009949000,1.9800
210.213.21.66:49510,<->,92.26.144.99:documentum,0,0,100,20400,100,20400,0.009868000,1.9799
144.93.121.86:57980,<->,144.93.120.177:11768,100,20400,0,0,100,20400,0.009656000,1.9800
144.93.121.86:50708,<->,144.93.125.49:48304,100,20400,0,0,100,20400,0.009570000,1.9800
144.93.125.49:39200,<->,144.93.121.86:34684,0,0,100,20400,100,20400,0.009515000,1.9800
144.93.121.10:46522,<->,144.93.125.48:44880,100,20400,0,0,100,20400,0.009297000,1.9800
144.93.121.86:21766,<->,144.93.120.177:8852,100,20400,0,0,100,20400,0.009265000,1.9800
144.93.125.37:37096,<->,144.93.121.10:19008,0,0,100,20400,100,20400,0.009039000,1.9800
144.93.125.37:50432,<->,144.93.121.10:19250,0,0,100,20400,100,20400,0.009032000,1.9800
144.93.121.86:29972,<->,144.93.120.28:t2-drm,100,20400,0,0,100,20400,0.008875000,1.9800
144.93.120.177:44662,<->,144.93.121.86:19908,0,0,100,20400,100,20400,0.008585000,1.9800
144.93.121.10:53786,<->,144.93.120.177:46674,100,20400,0,0,100,20400,0.008581000,1.9800
144.93.121.10:40550,<->,144.93.125.49:37380,100,20400,0,0,100,20400,0.008537000,1.9800
144.93.120.177:42872,<->,144.93.121.50:32816,0,0,100,20400,100,20400,0.008528000,1.9800
144.93.121.50:44724,<->,144.93.120.177:13988,100,20400,0,0,100,20400,0.008367000,1.9800
144.93.120.177:28364,<->,144.93.121.50:23476,0,0,100,20400,100,20400,0.008290000,1.9800
144.93.120.28:56696,<->,144.93.121.10:43352,0,0,100,20400,100,20400,0.008229000,1.9799
144.93.120.177:49532,<->,144.93.121.48:24404,0,0,100,20400,100,20400,0.008180000,1.9800
144.93.120.177:60588,<->,144.93.121.86:7474,0,0,100,20400,100,20400,0.008047000,1.9800
144.93.120.177:58168,<->,144.93.121.48:30064,0,0,100,20400,100,20400,0.007805000,1.9800
144.93.121.48:62236,<->,144.93.120.177:35654,100,20400,0,0,100,20400,0.007695000,1.9800
144.93.121.86:58850,<->,144.93.125.49:56004,100,20400,0,0,100,20400,0.007566000,1.9800
144.93.121.48:25732,<->,144.93.120.177:apc-9950,100,20400,0,0,100,20400,0.007403000,1.9800
198.11.192.232:24528,<->,144.93.121.10:20758,0,0,100,20400,100,20400,0.007386000,1.9799
144.93.125.48:49716,<->,144.93.121.86:18276,0,0,100,20400,100,20400,0.007305000,1.9800
144.93.125.48:58228,<->,144.93.121.10:12192,0,0,100,20400,100,20400,0.007263000,1.9790
144.93.121.48:57980,<->,144.93.120.28:56128,100,20400,0,0,100,20400,0.007104000,1.9800
144.93.121.48:58976,<->,144.93.120.28:24740,100,20400,0,0,100,20400,0.006885000,1.9800
144.93.120.177:48112,<->,144.93.121.86:14238,0,0,100,20400,100,20400,0.006517000,1.9800
144.93.121.10:64358,<->,144.93.120.177:51482,100,20400,0,0,100,20400,0.006303000,1.9800
144.93.121.48:44756,<->,144.93.120.177:38772,100,20400,0,0,100,20400,0.005885000,1.9800
144.93.121.10:37100,<->,144.93.120.177:17676,100,20400,0,0,100,20400,0.005774000,1.9800
144.93.121.86:43642,<->,144.93.120.177:34346,100,20400,0,0,100,20400,0.005764000,1.9800
144.93.121.10:19666,<->,144.93.120.177:10098,100,20400,0,0,100,20400,0.005675000,1.9800
144.93.125.49:58696,<->,144.93.121.86:8604,0,0,100,20400,100,20400,0.005554000,1.9800
144.93.125.49:58276,<->,144.93.121.86:8778,0,0,100,20400,100,20400,0.005516000,1.9800
236.90.17.75:54064,<->,144.93.121.10:46334,0,0,100,20400,100,20400,0.005421000,1.9800
144.93.120.28:50614,<->,144.93.121.86:28790,0,0,100,20400,100,20400,0.005346000,1.9799
144.93.121.86:53372,<->,144.93.120.177:17552,100,20400,0,0,100,20400,0.005319000,1.9800
144.93.121.86:44722,<->,144.93.125.38:29592,100,20400,0,0,100,20400,0.005268000,1.9800
144.93.121.48:58032,<->,144.93.120.177:38256,100,20400,0,0,100,20400,0.005006000,1.9800
144.93.120.177:36464,<->,144.93.121.10:28938,0,0,100,20400,100,20400,0.004905000,1.9800
144.93.120.177:25922,<->,144.93.121.86:8940,0,0,100,20400,100,20400,0.004709000,1.9800
144.93.121.10:58502,<->,101.71.113.171:30102,100,20400,0,0,100,20400,0.004641000,1.9800
144.93.120.177:34578,<->,144.93.121.86:18610,0,0,100,20400,100,20400,0.004492000,1.9801
144.93.121.10:49040,<->,144.93.120.177:41902,100,20400,0,0,100,20400,0.004361000,1.9800
144.93.121.10:45284,<->,145.2.46.74:7370,100,20400,0,0,100,20400,0.004305000,1.9800
144.93.121.48:49700,<->,144.93.120.28:28292,100,20400,0,0,100,20400,0.004272000,1.9801
144.93.120.177:27812,<->,144.93.121.10:doip-disc,0,0,100,20400,100,20400,0.004048000,1.9800
144.93.121.86:61872,<->,144.93.120.177:40936,100,20400,0,0,100,20400,0.003868000,1.9800
144.93.120.28:56582,<->,144.93.121.86:10308,0,0,100,20400,100,20400,0.003369000,1.9853
144.93.121.48:32828,<->,144.93.120.177:19196,100,20400,0,0,100,20400,0.003339000,1.9800
144.93.121.48:56660,<->,144.93.120.28:9838,100,20400,0,0,100,20400,0.003336000,1.9801
144.93.125.32:48412,<->,144.93.121.10:20090,0,0,100,20400,100,20400,0.003085000,1.9800
144.93.121.50:45060,<->,144.93.120.177:24624,100,20400,0,0,100,20400,0.002953000,1.9800
144.93.120.177:64172,<->,144.93.121.50:28756,0,0,100,20400,100,20400,0.002825000,1.9800
144.93.121.86:35218,<->,144.93.120.177:7684,100,20400,0,0,100,20400,0.002794000,1.9800
144.93.125.49:64720,<->,144.93.121.10:64418,0,0,100,20400,100,20400,0.002590000,1.9800
144.93.121.86:50182,<->,144.93.125.49:35720,100,20400,0,0,100,20400,0.002566000,1.9800
144.93.120.177:31510,<->,144.93.121.10:20098,0,0,100,20400,100,20400,0.002453000,1.9800
220.14.74.198:49262,<->,35.56.98.184:9302,0,0,100,20400,100,20400,0.002321000,1.9800
144.93.121.48:48748,<->,144.93.120.177:33404,100,20400,0,0,100,20400,0.002298000,1.9800
144.93.120.177:60768,<->,144.93.121.86:30464,0,0,100,20400,100,20400,0.002287000,1.9800
144.93.120.177:64040,<->,144.93.121.50:56188,0,0,100,20400,100,20400,0.002278000,1.9800
144.93.120.177:55016,<->,144.93.121.10:13590,0,0,100,20400,100,20400,0.001876000,1.9800
144.93.120.177:48290,<->,144.93.121.86:14668,0,0,100,20400,100,20400,0.001763000,1.9800
144.93.125.49:61052,<->,144.93.121.10:14896,0,0,100,20400,100,20400,0.001558000,1.9800
144.93.121.86:22990,<->,144.93.120.177:15980,100,20400,0,0,100,20400,0.001384000,1.9800
144.93.121.10:62724,<->,145.2.46.75:10176,100,20400,0,0,100,20400,0.001381000,1.9800
144.93.121.48:55164,<->,144.93.120.177:7840,100,20400,0,0,100,20400,0.001380000,1.9800
144.93.121.86:55458,<->,144.93.125.38:48696,100,20400,0,0,100,20400,0.001312000,1.9809
144.93.120.177:65408,<->,144.93.121.86:42604,0,0,100,20400,100,20400,0.001075000,1.9800
144.93.121.48:37456,<->,144.93.120.177:9640,100,20400,0,0,100,20400,0.000853000,1.9800
144.93.121.48:42976,<->,144.93.120.177:36252,100,20400,0,0,100,20400,0.000797000,1.9801
144.93.121.83:26672,<->,98.198.84.11:16952,100,20400,0,0,100,20400,0.000715000,1.9800
144.93.121.86:60982,<->,144.93.125.49:32532,100,20400,0,0,100,20400,0.000564000,1.9800
144.93.125.49:56024,<->,144.93.121.10:32560,0,0,100,20400,100,20400,0.000556000,1.9800
144.93.120.177:56844,<->,144.93.121.50:37496,0,0,100,20400,100,20400,0.000327000,1.9800
144.93.121.10:39300,<->,144.93.125.48:21700,100,20400,0,0,100,20400,0.000280000,1.9800
144.93.121.86:46442,<->,113.171.246.29:27390,100,20400,0,0,100,20400,0.000263000,1.9801
144.93.121.10:18656,<->,144.93.120.177:7986,100,20400,0,0,100,20400,0.000132000,1.9800
144.93.121.43:37796,<->,144.93.125.32:33540,100,20400,0,0,100,20400,0.000031000,1.9800
144.93.125.49:43872,<->,144.93.121.10:17592,0,0,99,20196,99,20196,0.009534000,1.9800
144.93.120.28:45122,<->,144.93.121.10:19216,0,0,99,20196,99,20196,0.001919000,1.9601
226.36.250.224:45792,<->,92.27.27.178:12975,0,0,98,5120,98,5120,0.044841000,1.9455
121.212.70.115:61116,<->,92.27.27.182:53542,0,0,96,141120,96,141120,0.109522000,1.8810
92.170.244.173:16402,<->,215.158.2.89:swr-port,96,12321,0,0,96,12321,0.008123000,1.9006
108.128.237.16:57501,<->,101.224.167.233:28016,0,0,95,9610,95,9610,0.016295000,1.9481
204.114.166.12:64484,<->,92.27.219.133:44345,0,0,90,4746,90,4746,0.121285000,1.8013
89.207.131.9:16402,<->,133.178.227.143:ifsf-hb-port,0,0,89,56889,89,56889,0.005498000,1.9627
6.211.193.169:37488,<->,92.27.219.165:openvpn,0,0,88,36560,88,36560,0.048729000,1.9480
8.228.214.124:58457,<->,141.37.255.242:29335,88,128304,0,0,88,128304,0.001026000,1.9978
114.186.59.195:44723,<->,210.221.110.77:6881,0,0,87,119382,87,119382,0.376816000,1.5877
120.221.207.133:47021,<->,92.27.27.164:4268,0,0,87,111304,87,111304,0.033640000,1.7968
103.164.140.56:49921,<->,92.27.219.220:http-alt,0,0,86,11310,86,11310,0.342100000,1.5562
113.108.161.158:57830,<->,92.27.27.142:49077,0,0,85,123845,85,123845,0.263029000,1.7168
111.161.94.38:38344,<->,92.27.219.226:23576,0,0,85,67077,85,67077,0.086605000,1.8823
230.102.130.25:41766,<->,133.178.227.207:9042,0,0,82,18438,82,18438,0.170911000,1.6520
230.102.130.52:40809,<->,133.178.227.192:9042,0,0,81,30635,81,30635,0.053179000,1.9424
230.102.130.22:37218,<->,133.178.227.200:9042,0,0,80,61882,80,61882,0.029645000,1.9503
204.131.179.159:61640,<->,39.15.146.228:ipsec-nat-t,0,0,79,9596,79,9596,0.074676000,1.7273
223.143.15.189:58485,<->,92.27.27.165:16762,0,0,78,114660,78,114660,0.212845000,1.3017
89.183.104.175:49751,<->,223.138.87.163:16431,78,4170,0,0,78,4170,0.185415000,1.6680
42.27.151.57:51413,<->,89.183.104.243:11145,0,0,77,4799,77,4799,0.028416000,1.9570
201.67.203.4:58893,<->,109.112.164.42:ipsec-nat-t,0,0,74,9400,74,9400,0.104665000,1.8627
144.93.125.49:62448,<->,144.93.121.10:21154,0,0,72,14688,72,14688,0.561589000,1.4300
144.93.125.49:43916,<->,144.93.121.10:39500,0,0,72,14688,72,14688,0.557594000,1.4300
130.42.61.8:13198,<->,144.93.121.10:10468,0,0,71,14484,71,14484,0.304881000,1.6782
144.93.121.50:43216,<->,144.93.120.177:19936,68,13872,0,0,68,13872,0.015297000,1.3399
109.1.45.197:54661,<->,99.167.41.210:trivnet1,67,11936,0,0,67,11936,0.016779000,1.9793
230.102.130.14:58088,<->,133.178.227.198:9043,0,0,67,20592,67,20592,0.000400000,1.9991
146.188.124.240:54941,<->,39.23.131.210:domain,0,0,66,4030,66,4030,1.944340000,0.0517
92.27.27.185:45441,<->,27.233.131.196:39864,66,3943,0,0,66,3943,0.078802000,1.6807
109.222.230.140:23489,<->,224.250.33.165:intecom-ps1,64,18634,0,0,64,18634,0.014003000,1.9515
217.48.45.61:43191,<->,109.222.212.23:14758,0,0,64,67028,64,67028,0.013661000,1.9801
42.145.216.142:34689,<->,89.183.104.233:18213,0,0,63,88981,63,88981,0.275654000,1.7000
97.126.89.196:61000,<->,121.209.129.56:24557,63,91192,0,0,63,91192,0.022373000,1.9384
107.127.56.45:52397,<->,144.70.194.19:ipsec-nat-t,0,0,62,12632,62,12632,0.038739000,1.9464
92.28.243.121:udt-os,<->,80.41.50.144:udt-os,0,0,62,72447,62,72447,0.022882000,1.9101
102.50.97.18:40500,<->,207.178.235.42:29615,62,62341,0,0,62,62341,0.008476000,1.9907
109.222.221.183:ntp,<->,218.113.73.124:ssh,62,3100,0,0,62,3100,0.001178000,1.9714
98.128.99.20:xbox,<->,92.27.209.220:xbox,0,0,61,7967,61,7967,0.018947000,1.9524
158.10.218.189:23546,<->,92.27.219.33:l2f,0,0,60,15230,60,15230,0.225141000,1.6779
192.64.227.200:33058,<->,0.239.41.218:31463,60,3414,0,0,60,3414,0.113670000,1.8328
8.229.117.238:61584,<->,92.27.27.165:http-alt,0,0,60,90240,60,90240,0.081566000,1.8529
109.110.71.152:59765,<->,247.136.136.4:51908,0,0,60,85040,60,85040,0.077890000,1.8656
92.27.219.243:56245,<->,144.79.8.124:27037,60,40355,0,0,60,40355,0.022155000,1.9696
116.92.246.189:45110,<->,92.27.219.207:44296,0,0,59,3068,59,3068,0.110482000,1.4687
8.163.119.245:56603,<->,92.27.219.139:http-alt,0,0,59,87320,59,87320,0.053491000,1.9379
117.73.204.10:xbox,<->,80.41.58.244:xbox,0,0,59,7112,59,7112,0.013080000,1.9523
122.158.69.69:51259,<->,215.158.238.153:lansource,0,0,59,25826,59,25826,0.012355000,1.9834
127.101.167.95:39180,<->,89.183.104.147:10746,0,0,59,83472,59,83472,0.007190000,1.9813
122.140.135.247:55342,<->,89.183.104.135:32498,0,0,58,3058,58,3058,0.099621000,1.7454
143.120.91.175:50864,<->,246.253.253.211:https,0,0,58,8738,58,8738,0.086423000,1.9019
103.248.168.73:xbox,<->,92.27.209.222:xbox,0,0,58,7532,58,7532,0.009390000,1.9875
220.18.60.199:xbox,<->,92.27.209.213:xbox,0,0,57,7061,57,7061,0.033653000,1.9470
60.100.96.242:64694,<->,210.221.109.12:61346,0,0,57,10392,57,10392,0.003766000,1.9676
92.42.46.202:xbox,<->,92.27.209.220:xbox,0,0,56,7436,56,7436,0.009826000,1.9837
97.120.1.114:xbox,<->,92.27.209.212:xbox,0,0,56,6633,56,6633,0.009033000,1.9863
92.27.209.173:34080,<->,82.155.227.130:xbox,55,8112,0,0,55,8112,0.024845000,1.9703
222.12.110.202:36451,<->,92.27.209.213:xbox,0,0,55,6246,55,6246,0.023981000,1.9509
230.102.130.22:64732,<->,133.178.227.216:9043,0,0,55,16191,55,16191,0.019502000,1.9601
230.102.130.20:52540,<->,133.178.227.200:9042,0,0,55,36324,55,36324,0.013446000,1.9480
103.6.186.36:23460,<->,92.27.209.217:xbox,0,0,55,6404,55,6404,0.009975000,1.9500
110.85.114.41:41775,<->,247.136.187.136:33560,0,0,54,2808,54,2808,0.958450000,1.0177
116.74.122.224:28944,<->,92.27.27.175:20836,0,0,54,2958,54,2958,0.196163000,1.6581
92.27.209.115:34360,<->,92.2.166.138:xbox,54,6048,0,0,54,6048,0.025765000,1.9520
110.88.88.65:xbox,<->,92.27.209.213:xbox,0,0,54,8701,54,8701,0.010973000,1.9580
42.64.170.221:26560,<->,89.183.104.234:http-alt,0,0,53,79712,53,79712,0.064467000,1.9151
92.27.209.140:18140,<->,108.38.132.20:xbox,53,7088,0,0,53,7088,0.029269000,1.9654
226.61.137.133:xbox,<->,92.27.209.217:xbox,0,0,53,6861,53,6861,0.026502000,1.9480
42.189.76.202:51850,<->,80.40.59.129:17569,0,0,52,67942,52,67942,0.093338000,1.7391
109.1.15.193:59759,<->,121.14.135.231:22060,52,73604,0,0,52,73604,0.034397000,1.9550
92.27.209.140:34460,<->,110.50.143.159:xbox,52,7584,0,0,52,7584,0.016999000,1.9505
247.157.15.209:16402,<->,215.158.215.54:slim-devices,52,20270,0,0,52,20270,0.008978000,1.9899
192.67.152.25:52613,<->,98.23.121.94:http-alt,51,18639,0,0,51,18639,0.041236000,1.9466
220.55.175.209:33050,<->,159.46.22.47:xbox,50,6688,0,0,50,6688,0.002166000,1.9744
113.172.47.6:46102,<->,92.27.219.203:fmpro-v6,0,0,48,2730,48,2730,0.339407000,1.4879
92.27.219.165:42674,<->,152.12.3.191:25529,48,2496,0,0,48,2496,0.110922000,1.7280
33.57.74.137:61373,<->,109.1.15.193:59759,0,0,48,70560,48,70560,0.044918000,1.9455
220.55.171.232:xbox,<->,124.224.212.254:xbox,48,4728,0,0,48,4728,0.002313000,1.9650
59.158.157.234:50160,<->,215.158.238.86:lansource,0,0,47,19521,47,19521,0.013114000,1.9467
247.136.131.28:54031,<->,205.8.173.220:49412,46,6375,0,0,46,6375,0.036277000,1.9380
116.249.165.54:57274,<->,247.136.133.229:43611,0,0,46,2470,46,2470,0.008993000,1.9454
192.67.159.55:14124,<->,118.69.159.68:13164,45,3630,0,0,45,3630,0.146766000,1.7931
247.136.250.58:33681,<->,117.130.91.228:nmsd,45,65520,0,0,45,65520,0.128981000,1.5018
127.162.74.46:49049,<->,247.136.147.198:45796,0,0,44,64680,44,64680,0.058562000,1.6511
220.87.124.222:16402,<->,215.158.2.89:celatalk,44,10752,0,0,44,10752,0.013697000,1.9198
111.146.157.33:55401,<->,159.224.11.110:ipsec-nat-t,43,14508,0,0,43,14508,0.198541000,1.7775
77.28.69.25:61733,<->,108.39.7.100:52600,0,0,43,4767,43,4767,0.027568000,1.9432
100.110.50.212:xbox,<->,92.27.209.217:xbox,0,0,42,5202,42,5202,0.110862000,1.8383
119.250.57.185:48921,<->,92.27.219.154:35953,0,0,42,61740,42,61740,0.033998000,1.9197
230.102.130.54:46021,<->,133.178.227.207:9043,0,0,42,8722,42,8722,0.012647000,1.9398
92.27.219.19:29317,<->,198.249.136.154:26868,42,39632,0,0,42,39632,0.003629000,1.5169
57.203.86.245:62729,<->,0.195.210.12:52773,0,0,40,19943,40,19943,0.194542000,1.7379
98.191.25.119:34509,<->,136.25.188.27:valisys-lm,0,0,39,54159,39,54159,0.226153000,1.5620
115.85.99.120:50322,<->,109.222.212.23:14758,0,0,39,55752,39,55752,0.099191000,1.8207
102.50.97.18:40500,<->,204.19.149.79:7994,39,34109,0,0,39,34109,0.041394000,1.7306
252.98.149.196:55293,<->,198.8.144.150:33505,38,9222,0,0,38,9222,0.013297000,1.9799
230.102.130.22:37218,<->,133.178.227.192:9042,0,0,37,10951,37,10951,0.044820000,1.9288
107.19.40.128:61863,<->,92.27.219.197:http-alt,0,0,36,16324,36,16324,0.065685000,1.9203
100.94.188.95:64175,<->,117.156.242.240:55694,36,6415,0,0,36,6415,0.016437000,1.9776
102.28.84.233:58241,<->,22.59.8.111:9305,0,0,36,3835,36,3835,0.009681000,1.4859
89.183.104.165:59333,<->,206.69.16.143:10796,35,49590,0,0,35,49590,0.217881000,1.7736
27.79.198.231:61512,<->,92.27.219.225:46335,0,0,35,2347,35,2347,0.107910000,1.8518
197.108.9.58:26456,<->,109.1.0.79:13469,0,0,35,1820,35,1820,0.063395000,1.8930
80.42.159.46:28688,<->,106.209.215.4:27887,35,1922,0,0,35,1922,0.048031000,1.8955
69.93.67.175:32427,<->,0.195.210.15:stun,0,0,35,6762,35,6762,0.033132000,1.9299
146.188.27.11:40750,<->,0.195.210.15:stun,0,0,35,6140,35,6140,0.018878000,1.8646
204.47.12.101:udt-os,<->,100.93.156.90:udt-os,0,0,34,2078,34,2078,0.487461000,1.3344
59.145.64.89:54808,<->,89.183.104.136:http-alt,0,0,34,30282,34,30282,0.148757000,1.8385
92.27.219.230:56881,<->,110.3.31.65:49315,34,1768,0,0,34,1768,0.106923000,1.6766
197.199.10.134:55901,<->,196.148.128.241:dsm-scm-target,0,0,34,3426,34,3426,0.014096000,1.7155
111.151.139.247:59899,<->,249.129.136.212:lansource,0,0,34,15166,34,15166,0.013941000,1.9505
158.85.62.215:55933,<->,133.178.227.201:9043,0,0,34,12606,34,12606,0.012222000,1.9828
101.123.188.42:53963,<->,137.170.13.105:4433,34,7898,0,0,34,7898,0.011923000,1.9836
247.136.146.184:59019,<->,112.99.239.91:6881,34,1802,0,0,34,1802,0.010335000,1.9365
230.102.130.25:55127,<->,133.178.227.207:9043,0,0,34,12664,34,12664,0.001072000,1.9597
92.27.219.172:51413,<->,198.196.107.83:49015,33,48510,0,0,33,48510,0.127089000,1.8713
89.183.104.148:22856,<->,48.111.159.80:16526,33,45674,0,0,33,45674,0.068648000,1.8009
158.85.62.216:60877,<->,133.178.227.200:9043,0,0,33,10423,33,10423,0.053552000,1.9200
89.183.104.232:33920,<->,27.75.29.116:29633,33,24899,0,0,33,24899,0.025874000,1.9720
108.39.75.243:55221,<->,0.195.194.241:55076,33,8660,0,0,33,8660,0.002603000,1.9824
215.158.66.187:47880,<->,133.178.227.201:9043,0,0,32,20023,32,20023,0.970227000,0.4228
115.48.155.17:48076,<->,192.64.227.64:36106,0,0,32,1712,32,1712,0.118303000,1.6632
92.27.219.184:63650,<->,122.202.156.172:55194,32,2079,0,0,32,2079,0.039954000,1.8593
111.151.139.254:58621,<->,8.176.8.218:lansource,0,0,32,14642,32,14642,0.031381000,1.8292
89.183.104.186:43611,<->,117.9.179.125:35122,32,1820,0,0,32,1820,0.007750000,1.8656
99.72.8.232:ipsec-nat-t,<->,195.109.248.194:backburner,31,4506,0,0,31,4506,0.874077000,1.1082
114.48.32.71:53199,<->,101.70.183.44:ipsec-nat-t,0,0,31,4764,31,4764,0.072078000,1.9273
114.51.67.67:55001,<->,89.183.104.158:9408,0,0,31,45167,31,45167,0.038503000,1.9315
112.176.7.240:50588,<->,56.121.40.204:molly,0,0,31,45570,31,45570,0.036012000,1.9404
145.89.157.16:61568,<->,66.47.246.227:56837,30,3932,0,0,30,3932,0.024428000,1.9705
102.51.166.249:59623,<->,27.13.158.158:20714,30,1645,0,0,30,1645,0.019718000,1.9021
98.67.154.28:14769,<->,113.97.200.242:personal-agent,30,4006,0,0,30,4006,0.005186000,1.8519
6.10.112.30:49609,<->,92.27.219.148:41326,0,0,29,1670,29,1670,0.447779000,1.4434
121.64.198.129:59048,<->,92.27.219.228:41577,0,0,29,1508,29,1508,0.073173000,1.6707
125.194.228.63:50425,<->,92.27.27.175:19791,0,0,29,1508,29,1508,0.071841000,1.9016
100.95.177.132:52086,<->,204.92.39.211:29330,29,35540,0,0,29,35540,0.050302000,1.9307
80.42.149.110:17785,<->,114.68.69.205:12777,28,42112,0,0,28,42112,1.495617000,0.4942
144.93.120.177:53870,<->,144.93.121.48:33120,0,0,28,5712,28,5712,1.442902000,0.5400
104.136.21.135:63780,<->,99.73.221.249:57389,0,0,28,2895,28,2895,0.192580000,1.7810
109.222.196.120:65325,<->,137.170.13.110:4433,27,18479,0,0,27,18479,0.152987000,1.8096
149.110.222.182:60907,<->,22.59.8.111:9291,0,0,27,3011,27,3011,0.131743000,1.8676
122.158.176.131:56161,<->,136.25.188.42:lansource,0,0,27,12663,27,12663,0.003186000,1.9887
92.27.219.49:31313,<->,101.106.122.69:router,26,7230,0,0,26,7230,0.890714000,0.9753
80.42.175.248:61220,<->,115.170.189.64:57866,26,26885,0,0,26,26885,0.163557000,1.7903
65.26.114.146:48513,<->,8.252.221.79:9042,0,0,26,6298,26,6298,0.053302000,1.9377
122.158.69.2:40991,<->,215.158.140.214:lansource,0,0,26,10931,26,10931,0.001027000,1.9560
205.150.176.250:40500,<->,109.222.254.165:29218,0,0,25,1334,25,1334,0.663611000,1.2344
80.41.35.54:61624,<->,229.69.240.213:47379,25,1776,0,0,25,1776,0.223692000,1.3647
98.67.144.152:ntp,<->,75.211.26.129:ssh,25,1250,0,0,25,1250,0.184524000,1.7902
247.136.177.71:27032,<->,124.8.194.202:27032,23,1282,0,0,23,1282,0.430728000,1.5315
92.27.219.36:17901,<->,0.244.115.75:6881,23,32982,0,0,23,32982,0.101382000,1.8957
111.151.139.139:52425,<->,8.176.8.93:lansource,0,0,23,10836,23,10836,0.094901000,1.8853
125.9.106.97:29324,<->,109.1.17.245:27227,0,0,23,1334,23,1334,0.056086000,1.8929
48.106.195.65:63664,<->,192.64.219.151:24267,0,0,23,1208,23,1208,0.000079000,1.9818
195.120.129.171:56470,<->,99.75.125.132:51413,0,0,22,1144,22,1144,0.134814000,1.7746
119.238.208.112:63010,<->,109.222.251.151:6881,0,0,22,1289,22,1289,0.023816000,1.8070
40.213.57.116:16692,<->,92.27.219.241:7284,0,0,22,1276,22,1276,0.008020000,1.8363
125.181.234.162:63489,<->,89.183.104.230:42177,0,0,21,1104,21,1104,0.939663000,0.9710
80.41.18.181:63060,<->,125.3.248.172:12108,21,29452,0,0,21,29452,0.154441000,1.6603
92.27.27.183:vce,<->,76.178.137.163:10438,21,1092,0,0,21,1092,0.124174000,1.6102
80.42.164.116:43212,<->,33.57.78.82:36818,21,28034,0,0,21,28034,0.119700000,1.7643
121.139.59.102:61037,<->,101.224.167.97:58413,0,0,21,2274,21,2274,0.084958000,1.7490
92.27.219.175:50123,<->,105.155.60.93:24874,21,30492,0,0,21,30492,0.005625000,1.9932
144.93.121.10:64508,<->,144.93.120.177:46784,20,4080,0,0,20,4080,1.610704000,0.3800
111.151.139.154:42184,<->,215.158.140.216:lansource,0,0,20,7864,20,7864,0.341674000,1.6145
111.181.114.114:52629,<->,226.68.196.218:https,20,13556,0,0,20,13556,0.335775000,1.3800
92.27.219.51:16920,<->,114.216.173.200:bctp,20,20380,0,0,20,20380,0.030272000,1.9330
89.183.104.237:14419,<->,104.70.118.211:4331,19,8716,0,0,19,8716,0.117226000,1.8519
126.88.32.178:61985,<->,92.27.219.212:53466,0,0,19,13242,19,13242,0.100154000,1.7433
138.112.247.164:40113,<->,39.15.146.228:ipsec-nat-t,0,0,19,20412,19,20412,0.020455000,1.6541
121.42.178.118:56096,<->,192.67.129.30:38007,0,0,18,23624,18,23624,1.495758000,0.4895
123.129.231.146:52081,<->,92.27.219.242:43646,0,0,18,1010,18,1010,0.286823000,1.4219
101.70.127.226:ipsec-nat-t,<->,83.155.125.5:ipsec-nat-t,18,2208,0,0,18,2208,0.049054000,1.9044
92.27.27.150:51973,<->,29.162.32.50:18012,18,936,0,0,18,936,0.013959000,1.5665
192.64.201.167:64218,<->,232.111.67.19:ipsec-nat-t,17,3508,0,0,17,3508,1.026628000,0.6710
125.207.62.135:49239,<->,247.136.231.91:6881,0,0,17,902,17,902,0.172823000,1.1582
159.36.241.98:32103,<->,92.27.219.243:15277,0,0,17,8185,17,8185,0.141603000,1.8430
103.154.12.2:49814,<->,92.27.27.186:http-alt,0,0,17,2309,17,2309,0.090916000,1.6342
111.151.139.139:61362,<->,8.252.221.226:lansource,0,0,17,6310,17,6310,0.040258000,1.9564
214.245.140.57:44891,<->,50.224.118.88:ddi-udp-1,0,0,17,938,17,938,0.032028000,1.4720
111.151.139.138:52218,<->,8.252.221.214:lansource,0,0,17,6310,17,6310,0.029612000,1.9564
57.240.3.219:60191,<->,92.27.219.147:25703,0,0,17,19123,17,19123,0.025848000,1.3837
80.40.50.117:54423,<->,206.17.241.68:53906,17,884,0,0,17,884,0.022751000,0.7182
120.114.211.51:57249,<->,89.183.104.172:42213,0,0,17,986,17,986,0.005636000,1.9105
92.27.219.54:56216,<->,88.5.223.142:35484,16,1583,0,0,16,1583,0.137071000,1.7143
126.223.18.230:62348,<->,92.27.219.247:56214,0,0,16,1073,16,1073,0.104769000,1.8095
100.93.89.174:xbox,<->,207.117.160.72:1024,16,896,0,0,16,896,0.061927000,1.9055
130.217.163.17:61907,<->,92.27.219.171:10163,0,0,16,22891,16,22891,0.052071000,1.8801
101.224.174.212:60050,<->,120.193.155.221:16257,16,2055,0,0,16,2055,0.004688000,1.7525
106.149.129.48:25130,<->,89.183.104.152:7246,0,0,15,21855,15,21855,0.739426000,0.8782
92.27.219.165:52110,<->,99.251.31.170:1024,15,3594,0,0,15,3594,0.449175000,1.4126
92.27.219.143:42281,<->,4.111.14.19:37410,15,798,0,0,15,798,0.186142000,1.6501
200.175.234.79:51154,<->,50.189.172.216:14350,15,19302,0,0,15,19302,0.101063000,1.4480
197.45.74.148:19352,<->,89.183.104.147:10746,0,0,15,22050,15,22050,0.026869000,1.8635
118.221.45.56:48203,<->,89.183.104.174:45430,0,0,15,786,15,786,0.017909000,1.8553
117.84.5.182:45682,<->,192.64.223.86:22641,0,0,15,870,15,870,0.016930000,1.8764
122.127.16.36:29685,<->,192.67.176.153:6881,0,0,15,780,15,780,0.015260000,1.8021
223.141.212.240:57431,<->,39.54.1.198:domain,0,0,14,859,14,859,1.283440000,0.7107
101.70.118.35:ntp,<->,100.53.195.10:ssh,14,700,0,0,14,700,0.704514000,1.2425
92.27.27.174:59124,<->,105.65.117.137:26587,14,17744,0,0,14,17744,0.443902000,1.1441
92.27.27.99:56853,<->,119.126.161.254:10409,14,17125,0,0,14,17125,0.228385000,0.7626
92.27.219.181:41441,<->,121.210.96.252:24176,14,17528,0,0,14,17528,0.100861000,1.8224
117.166.148.72:40500,<->,92.27.219.219:30662,0,0,14,799,14,799,0.004270000,1.6243
144.93.121.86:34506,<->,144.93.120.177:20702,14,2856,0,0,14,2856,0.004226000,0.2600
107.8.60.69:21375,<->,92.27.219.204:14161,0,0,14,18551,14,18551,0.000765000,1.0508
111.82.148.238:64661,<->,192.67.167.86:62790,0,0,13,1349,13,1349,0.879175000,1.1164
218.4.168.98:56984,<->,121.211.58.14:16223,13,17692,0,0,13,17692,0.387532000,1.0199
38.84.57.194:62430,<->,92.27.219.217:21310,0,0,13,15440,13,15440,0.353117000,1.6318
33.57.79.43:34676,<->,89.183.104.252:32669,0,0,13,9328,13,9328,0.270361000,1.6904
220.55.175.209:18410,<->,98.102.221.116:xbox,13,936,0,0,13,936,0.202574000,1.7520
80.40.41.27:59789,<->,125.24.121.131:19752,13,809,0,0,13,809,0.172836000,1.6697
92.27.27.143:50199,<->,152.11.225.23:16090,13,718,0,0,13,718,0.160645000,1.8170
100.92.65.165:37502,<->,104.139.44.208:itap-ddtp,13,676,0,0,13,676,0.095045000,1.4171
205.254.139.169:xbox,<->,109.1.35.93:xbox,0,0,13,1240,13,1240,0.060612000,1.8872
48.109.16.112:32050,<->,92.27.27.145:15858,0,0,13,15724,13,15724,0.052430000,0.9103
104.149.211.148:64678,<->,80.40.13.234:55558,0,0,12,658,12,658,0.783984000,1.1439
89.183.104.224:35411,<->,207.198.85.65:20340,12,653,0,0,12,653,0.322046000,1.6035
59.158.157.233:34977,<->,136.25.188.43:lansource,0,0,12,5093,12,5093,0.271454000,1.6812
89.183.104.136:53395,<->,112.158.194.201:50759,12,17021,0,0,12,17021,0.242411000,0.1978
142.178.23.162:54544,<->,246.253.253.207:https,0,0,12,3644,12,3644,0.149740000,1.7915
92.27.219.201:63519,<->,194.214.160.24:59385,12,15110,0,0,12,15110,0.148515000,1.8287
6.228.37.66:51413,<->,230.95.240.156:29725,12,624,0,0,12,624,0.136359000,1.6988
54.92.206.16:56958,<->,109.1.39.166:25362,0,0,12,633,12,633,0.065768000,1.8659
104.39.26.5:54881,<->,92.27.219.207:40682,0,0,12,624,12,624,0.056169000,1.7689
80.42.175.248:61220,<->,113.79.203.253:52217,12,624,0,0,12,624,0.038983000,1.8655
100.94.114.216:50721,<->,6.242.28.74:20945,11,641,0,0,11,641,0.403473000,1.5778
92.27.27.163:52873,<->,33.57.77.133:39906,11,1566,0,0,11,1566,0.261281000,1.6139
207.83.100.194:63892,<->,246.253.253.207:https,0,0,11,3119,11,3119,0.220921000,1.6425
122.158.69.2:54989,<->,215.158.238.200:confluent,0,0,11,12232,11,12232,0.174375000,1.2393
204.44.84.191:52873,<->,102.50.97.18:40500,0,0,11,572,11,572,0.159183000,1.7759
122.158.176.233:41609,<->,215.158.239.102:lansource,0,0,11,4553,11,4553,0.132974000,1.6493
80.41.51.34:49548,<->,125.59.16.30:26907,11,638,0,0,11,638,0.106040000,1.2930
247.136.177.71:27032,<->,124.9.21.238:26544,11,833,0,0,11,833,0.071456000,1.7884
88.152.234.41:31604,<->,192.67.159.55:14124,0,0,10,520,10,520,1.334886000,0.6220
92.27.219.39:56697,<->,207.46.243.242:55101,10,11088,0,0,10,11088,1.048080000,0.9449
18.200.16.20:44063,<->,92.27.27.174:43642,0,0,10,526,10,526,0.638330000,1.2800
109.1.51.20:59353,<->,40.215.63.180:17199,10,622,0,0,10,622,0.565370000,0.9533
92.27.27.173:47636,<->,48.111.250.235:23527,10,520,0,0,10,520,0.525636000,1.3517
143.88.15.116:57436,<->,133.178.227.200:9043,0,0,10,1344,10,1344,0.442866000,1.2617
194.195.11.79:51145,<->,246.253.253.208:https,0,0,10,2210,10,2210,0.298494000,1.1089
6.251.66.197:49162,<->,89.183.109.183:dsm-scm-target,0,0,10,576,10,576,0.255095000,1.6442
205.186.190.236:60032,<->,92.27.27.146:http-alt,0,0,10,1714,10,1714,0.254926000,1.5306
247.136.240.193:53675,<->,229.69.132.202:8279,10,520,0,0,10,520,0.230000000,1.3909
80.42.175.248:61220,<->,127.13.41.126:55356,10,520,0,0,10,520,0.092987000,1.6524
134.53.24.179:38083,<->,89.183.104.144:14026,0,0,10,1554,10,1554,0.090550000,1.4070
247.136.205.189:56075,<->,118.244.125.226:40500,10,560,0,0,10,560,0.075578000,0.7905
192.67.128.252:46314,<->,29.196.111.121:1024,10,580,0,0,10,580,0.067606000,1.5625
113.224.216.39:20170,<->,92.27.219.21:8921,0,0,10,617,10,617,0.057150000,1.7630
122.158.69.68:37708,<->,97.126.31.73:lansource,0,0,10,3703,10,3703,0.034010000,1.7922
247.136.177.100:xbox,<->,110.46.216.59:xbox,10,1400,0,0,10,1400,0.028931000,1.8312
195.106.14.119:59502,<->,92.27.219.34:26265,0,0,10,3330,10,3330,0.012610000,1.7662
122.212.152.132:62348,<->,92.27.219.175:50166,0,0,9,12888,9,12888,1.069877000,0.9157
8.240.125.171:35359,<->,8.252.221.97:9043,0,0,9,1364,9,1364,0.985460000,0.9964
92.27.27.174:43628,<->,225.3.225.27:22514,9,13122,0,0,9,13122,0.843434000,1.0925
122.158.69.2:54989,<->,215.158.195.26:confluent,0,0,9,10008,9,10008,0.835458000,0.1893
48.53.141.23:61103,<->,89.158.50.248:59324,9,8981,0,0,9,8981,0.620636000,1.1253
89.183.104.247:37237,<->,66.13.105.220:27475,9,585,0,0,9,585,0.620326000,1.0263
122.143.169.253:61582,<->,92.27.219.201:8722,0,0,9,12485,9,12485,0.303954000,0.8233
138.98.157.180:tinc,<->,33.250.67.227:tinc,9,1044,0,0,9,1044,0.282285000,1.5657
57.37.120.78:64302,<->,80.42.175.248:61220,0,0,9,1201,9,1201,0.263080000,1.0566
69.31.239.89:49430,<->,133.178.227.215:9043,0,0,9,1200,9,1200,0.240585000,0.4134
247.136.136.53:61481,<->,110.2.33.25:ps-ams,9,2847,0,0,9,2847,0.198831000,1.7713
89.183.104.232:33920,<->,143.159.235.195:24275,9,7498,0,0,9,7498,0.178429000,0.3526
235.67.254.158:53553,<->,92.27.219.28:res-sap,0,0,9,468,9,468,0.126578000,1.7587
115.51.254.30:58370,<->,92.27.219.171:10171,0,0,9,3290,9,3290,0.081420000,1.4692
220.55.174.143:18010,<->,232.31.73.213:10839,9,470,0,0,9,470,0.075010000,1.8901
0.204.192.239:62358,<->,192.67.174.99:60335,0,0,9,1104,9,1104,0.029522000,1.9274
210.221.109.17:58485,<->,122.253.169.56:23206,9,13230,0,0,9,13230,0.012630000,1.9863
80.56.91.244:65436,<->,215.158.238.200:confluent,0,0,8,8896,8,8896,1.513717000,0.0001
136.41.13.4:plysrv-http,<->,110.69.249.11:pammratc,8,497,0,0,8,497,1.416436000,0.1166
134.21.115.23:61000,<->,109.1.40.226:43175,0,0,8,1093,8,1093,0.873528000,0.8604
18.203.68.39:38269,<->,92.27.219.22:openvpn,0,0,8,432,8,432,0.798312000,0.4649
159.133.254.197:51423,<->,89.183.104.156:11048,0,0,8,7836,8,7836,0.775465000,0.9993
92.27.27.145:43001,<->,72.150.20.100:20676,8,416,0,0,8,416,0.764186000,1.1100
204.90.4.135:56240,<->,246.253.253.211:https,0,0,8,1016,8,1016,0.739532000,1.0465
92.27.27.169:47587,<->,114.196.95.169:15161,8,416,0,0,8,416,0.506954000,0.9205
92.27.219.169:37329,<->,88.152.222.126:35461,8,422,0,0,8,422,0.433901000,1.4975
125.16.198.1:13171,<->,247.136.217.189:10646,0,0,8,464,8,464,0.411759000,1.4831
8.240.125.163:38354,<->,133.178.227.214:9043,0,0,8,1192,8,1192,0.391031000,1.5850
207.12.103.185:40600,<->,92.27.27.176:35255,0,0,8,451,8,451,0.360372000,1.3911
119.71.114.135:61907,<->,92.27.219.137:36906,0,0,8,6256,8,6256,0.340111000,1.5634
192.64.202.30:61642,<->,38.84.41.144:61354,8,434,0,0,8,434,0.213320000,1.3750
113.191.253.140:61667,<->,89.183.104.150:20359,0,0,8,1294,8,1294,0.211114000,0.6676
92.27.219.169:37687,<->,121.52.54.249:31609,8,11760,0,0,8,11760,0.188894000,1.7060
80.41.46.191:49246,<->,133.252.163.90:pichat,8,1034,0,0,8,1034,0.172619000,1.8271
118.202.255.160:40500,<->,80.41.15.57:14036,0,0,8,902,8,902,0.155734000,1.5684
89.183.104.172:42595,<->,104.158.138.181:20171,8,2320,0,0,8,2320,0.151781000,0.5711
89.183.104.170:60686,<->,18.202.108.16:29393,8,434,0,0,8,434,0.116772000,1.8168
101.224.89.154:57503,<->,111.20.172.70:domain,8,709,0,0,8,709,0.106704000,0.9927
32.167.157.157:53623,<->,109.81.202.72:domain,0,0,8,576,8,576,0.106486000,1.7255
195.70.106.235:13462,<->,92.27.219.171:9790,0,0,8,844,8,844,0.102563000,0.8865
6.248.194.160:39576,<->,92.27.219.217:20716,0,0,8,8220,8,8220,0.093467000,1.8423
123.228.59.190:35459,<->,80.42.159.46:28688,0,0,8,442,8,442,0.061483000,1.4096
92.27.219.142:36361,<->,42.204.158.155:26670,8,9820,0,0,8,9820,0.057683000,1.4833
230.72.92.160:55358,<->,8.238.225.188:34945,0,0,8,8000,8,8000,0.025560000,1.3849
38.69.117.31:57129,<->,247.136.217.189:10646,0,0,8,1293,8,1293,0.022554000,1.6044
75.94.225.251:63892,<->,89.183.104.130:18662,0,0,8,10344,8,10344,0.008654000,1.9745
192.64.246.197:24225,<->,33.78.194.97:21066,7,1261,0,0,7,1261,1.391083000,0.5201
80.42.175.248:61220,<->,87.9.72.93:50266,7,364,0,0,7,364,1.239198000,0.5001
118.208.11.148:50140,<->,89.183.104.245:47360,0,0,7,9856,7,9856,0.802822000,0.2424
198.100.2.208:33917,<->,89.183.104.167:l2f,0,0,7,706,7,706,0.753297000,1.2116
83.7.230.68:55953,<->,89.183.104.189:35950,0,0,7,1731,7,1731,0.390351000,1.2315
125.196.62.17:55419,<->,89.183.104.167:33278,0,0,7,10199,7,10199,0.298389000,0.5393
92.27.219.61:57885,<->,248.232.242.136:31185,7,1771,0,0,7,1771,0.270964000,1.5584
102.81.45.53:41367,<->,92.27.219.129:http-alt,0,0,7,1059,7,1059,0.258793000,0.1443
68.227.84.215:10753,<->,192.67.144.149:6881,0,0,7,5980,7,5980,0.215681000,1.7445
92.27.219.181:41441,<->,229.61.242.186:34234,7,364,0,0,7,364,0.200962000,1.7017
119.70.121.138:52689,<->,92.27.27.161:46903,0,0,7,379,7,379,0.191419000,1.6643
194.169.242.51:46535,<->,92.27.27.158:13494,0,0,7,364,7,364,0.176923000,1.4980
82.237.234.119:64193,<->,137.170.13.106:4433,7,1403,0,0,7,1403,0.174879000,1.5909
127.93.47.235:64554,<->,247.136.136.13:29474,0,0,7,394,7,394,0.136755000,1.1362
156.164.19.175:36170,<->,92.27.219.217:21308,0,0,7,10290,7,10290,0.099651000,1.6660
92.181.56.219:55913,<->,59.36.39.14:ps-ams,7,626,0,0,7,626,0.098990000,1.0025
80.40.9.90:63496,<->,125.50.212.165:60955,7,364,0,0,7,364,0.096842000,1.6101
103.250.23.108:50298,<->,80.40.50.197:50132,0,0,7,793,7,793,0.059447000,0.5408
117.35.5.6:24805,<->,92.27.219.150:24106,0,0,7,6309,7,6309,0.051068000,1.6493
220.82.24.60:31327,<->,198.196.222.46:20820,7,1214,0,0,7,1214,0.020597000,1.9193
80.41.12.225:61072,<->,127.86.88.161:47228,7,1241,0,0,7,1241,0.018838000,0.4874
98.236.206.251:38701,<->,84.202.238.91:snmp,7,1757,0,0,7,1757,0.003551000,1.9400
145.23.212.61:ipsec-nat-t,<->,80.40.0.124:ipsec-nat-t,0,0,6,808,6,808,1.707783000,0.1454
101.117.57.49:64248,<->,92.27.219.56:http-alt,0,0,6,1310,6,1310,0.823245000,0.9827
42.197.80.101:43627,<->,20.194.211.253:syslog,0,0,6,848,6,848,0.672956000,0.0712
137.132.207.124:10108,<->,132.49.148.23:10108,0,0,6,5120,6,5120,0.672113000,0.7609
110.85.216.27:58645,<->,89.183.104.137:http-alt,0,0,6,1230,6,1230,0.672089000,0.7339
149.91.110.39:37057,<->,92.27.219.52:openvpn,0,0,6,974,6,974,0.600815000,0.9301
135.204.166.170:45760,<->,133.178.227.198:9043,0,0,6,816,6,816,0.508972000,1.1240
118.234.243.5:40501,<->,92.27.27.160:6432,0,0,6,330,6,330,0.505506000,1.1784
108.39.122.228:64884,<->,89.183.104.152:http-alt,0,0,6,830,6,830,0.415202000,1.5390
80.42.189.6:22438,<->,123.215.22.204:14978,6,2430,0,0,6,2430,0.384704000,1.5623
80.40.10.148:44822,<->,206.23.120.250:22718,6,944,0,0,6,944,0.381866000,0.4606
92.18.173.95:64534,<->,192.67.167.86:6881,0,0,6,374,6,374,0.376925000,1.0831
122.158.69.2:54989,<->,215.158.140.149:confluent,0,0,6,6672,6,6672,0.370604000,1.0881
78.49.6.7:63617,<->,89.183.104.255:37163,0,0,6,329,6,329,0.351341000,1.5686
127.107.255.141:57079,<->,89.183.104.238:41364,0,0,6,8538,6,8538,0.290255000,1.1034
255.29.52.48:ipsec-nat-t,<->,97.168.79.200:ipsec-nat-t,0,0,6,1032,6,1032,0.281333000,1.4849
93.161.230.56:58219,<->,192.64.222.13:52070,0,0,6,348,6,348,0.259752000,1.5003
75.94.112.195:64610,<->,136.129.20.230:51413,0,0,6,964,6,964,0.214878000,1.1429
92.27.219.205:50019,<->,229.96.187.56:16611,6,3232,0,0,6,3232,0.177495000,1.6759
247.136.136.112:6881,<->,110.61.185.178:6881,6,668,0,0,6,668,0.171202000,0.1939
27.11.131.168:50716,<->,50.224.118.88:ddi-udp-1,0,0,6,344,6,344,0.168345000,1.6331
50.224.72.13:57790,<->,89.139.247.130:snmp,6,1171,0,0,6,1171,0.149997000,1.5391
207.13.138.222:40988,<->,92.27.27.158:13922,0,0,6,312,6,312,0.140128000,1.5675
104.14.70.23:26343,<->,92.27.219.251:25733,0,0,6,5928,6,5928,0.120841000,0.7686
92.27.219.168:62889,<->,205.188.191.243:59631,6,312,0,0,6,312,0.099703000,1.6822
89.183.104.145:64598,<->,202.163.117.156:16117,6,5928,0,0,6,5928,0.083990000,1.8356
33.245.119.91:40378,<->,89.183.104.185:29910,0,0,6,348,6,348,0.067468000,1.7681
60.99.160.252:64309,<->,92.27.219.36:22024,0,0,6,4566,6,4566,0.037116000,1.8688
145.129.249.172:mdap-port,<->,138.98.233.50:sns-protocol,0,0,6,1483,6,1483,0.016385000,1.9518
111.146.152.238:63004,<->,117.4.7.176:15795,6,980,0,0,6,980,0.013532000,0.2636
196.20.252.209:56560,<->,246.253.253.210:https,0,0,6,990,6,990,0.004442000,1.7291
93.141.161.227:47614,<->,92.27.219.43:41855,0,0,6,8688,6,8688,0.003427000,1.4970
117.128.153.245:57110,<->,92.27.219.178:x11,0,0,6,4692,6,4692,0.002881000,1.7458
108.8.186.194:9307,<->,101.235.70.72:9307,0,0,6,1717,6,1717,0.000844000,0.4848
122.158.176.235:46823,<->,215.158.140.235:lansource,0,0,5,7496,5,7496,1.712289000,0.0135
122.158.176.156:40698,<->,133.178.226.212:lansource,0,0,5,7496,5,7496,1.702169000,0.0135
80.243.150.152:65028,<->,109.1.54.101:chimera-hwm,0,0,5,944,5,944,1.684804000,0.2015
111.151.139.138:38784,<->,133.178.226.173:lansource,0,0,5,7496,5,7496,1.629522000,0.0139
89.183.104.173:49097,<->,112.28.115.238:43523,5,260,0,0,5,260,1.622756000,0.3769
101.143.64.164:59308,<->,109.1.54.101:6881,0,0,5,1046,5,1046,1.578396000,0.2726
93.66.55.106:40500,<->,80.40.25.242:40500,0,0,5,715,5,715,1.485566000,0.4768
80.42.168.206:61647,<->,194.210.255.197:26403,5,269,0,0,5,269,1.340762000,0.0396
92.27.27.150:14555,<->,115.59.77.95:13826,5,260,0,0,5,260,1.276471000,0.1579
198.253.49.109:54385,<->,92.27.27.184:43414,0,0,5,572,5,572,1.275038000,0.3821
92.27.27.182:57371,<->,57.68.48.112:40500,5,654,0,0,5,654,1.250788000,0.7066
92.36.36.224:50238,<->,109.1.54.101:chimera-hwm,0,0,5,823,5,823,1.237740000,0.1849
247.136.139.37:36443,<->,148.43.230.154:34365,5,255,0,0,5,255,1.024940000,0.8985
100.92.103.47:61720,<->,38.17.171.70:18953,5,869,0,0,5,869,0.896077000,0.9995
80.40.12.180:50606,<->,33.78.85.2:26664,5,277,0,0,5,277,0.889104000,0.1256
109.222.241.62:55129,<->,111.89.77.172:21807,5,276,0,0,5,276,0.859338000,0.0714
125.42.173.70:57866,<->,109.1.54.101:chimera-hwm,0,0,5,1208,5,1208,0.843715000,0.2996
33.240.77.13:53714,<->,132.168.196.9:51162,0,0,5,681,5,681,0.839124000,1.1391
125.5.234.225:32022,<->,80.40.61.86:15594,0,0,5,7280,5,7280,0.736508000,1.2615
32.215.241.105:49666,<->,92.27.27.162:24831,0,0,5,508,5,508,0.666286000,0.0120
143.184.207.146:16917,<->,92.27.219.192:12018,0,0,5,290,5,290,0.599440000,0.9188
89.183.104.145:64933,<->,78.55.252.81:45076,5,404,0,0,5,404,0.540357000,1.1479
194.195.244.244:udt-os,<->,102.51.189.86:udt-os,0,0,5,328,5,328,0.515267000,1.3054
205.81.149.14:33395,<->,92.27.219.139:30470,0,0,5,992,5,992,0.501474000,0.9944
234.127.80.157:24409,<->,109.222.251.106:6881,0,0,5,311,5,311,0.470397000,0.5273
66.14.88.15:48478,<->,79.20.59.166:42393,5,1524,0,0,5,1524,0.407189000,1.1885
92.27.27.99:45466,<->,121.205.145.177:20274,5,1148,0,0,5,1148,0.404061000,1.2729
92.27.219.165:62344,<->,88.45.20.228:10762,5,1668,0,0,5,1668,0.354749000,1.0274
59.158.143.25:39383,<->,215.158.140.216:lansource,0,0,5,1750,5,1750,0.324729000,1.4627
102.83.184.157:53583,<->,230.75.129.225:30933,5,483,0,0,5,483,0.318152000,0.4537
247.136.154.209:57619,<->,38.93.215.114:17924,5,266,0,0,5,266,0.306989000,0.4220
80.41.35.54:61624,<->,134.150.68.36:40283,5,260,0,0,5,260,0.282625000,1.6939
92.27.219.243:57881,<->,112.109.177.35:45261,5,4584,0,0,5,4584,0.241158000,1.5808
92.27.219.149:60795,<->,57.3.164.69:18701,5,7170,0,0,5,7170,0.189244000,0.0520
206.17.243.41:62815,<->,109.1.54.101:quasar-server,0,0,5,766,5,766,0.162415000,1.3270
89.183.104.243:37331,<->,149.230.23.62:22952,5,5634,0,0,5,5634,0.157956000,1.3013
98.181.20.37:53278,<->,247.136.227.198:11867,0,0,5,1378,5,1378,0.148459000,0.2708
92.27.27.181:33956,<->,106.145.155.77:10978,5,433,0,0,5,433,0.146727000,0.3695
118.85.247.93:40500,<->,192.64.211.88:12395,0,0,5,260,5,260,0.145952000,1.2755
92.27.219.32:58356,<->,113.192.25.253:51413,5,600,0,0,5,600,0.140448000,1.6832
247.136.177.71:27032,<->,42.36.26.179:4733,5,1164,0,0,5,1164,0.123536000,0.8800
78.48.176.130:48454,<->,89.183.104.174:46011,0,0,5,371,5,371,0.118573000,1.5801
140.145.218.36:55532,<->,133.178.227.217:9043,0,0,5,672,5,672,0.110957000,0.2170
114.48.32.71:59822,<->,101.70.183.44:ipsec-nat-t,0,0,5,724,5,724,0.101028000,1.8880
92.27.219.39:57262,<->,78.45.201.41:50001,5,519,0,0,5,519,0.085005000,1.5710
125.37.55.102:58755,<->,192.64.204.68:57706,0,0,5,888,5,888,0.077160000,1.1679
122.192.58.162:64711,<->,92.27.219.178:5869,0,0,5,5884,5,5884,0.076650000,1.8552
142.174.222.235:udt-os,<->,102.50.179.199:udt-os,0,0,5,342,5,342,0.074199000,1.8782
80.40.50.197:60666,<->,33.198.250.108:22299,5,1250,0,0,5,1250,0.065819000,1.6180
104.142.182.228:37582,<->,102.51.211.141:32917,0,0,5,651,5,651,0.029915000,0.4117
92.27.219.191:38594,<->,93.251.237.157:11886,5,513,0,0,5,513,0.018371000,0.8637
110.73.45.161:32435,<->,247.136.231.91:6881,0,0,5,503,5,503,0.012680000,0.6985
50.128.183.47:bacula-dir,<->,66.217.128.239:1024,5,485,0,0,5,485,0.008961000,0.2418
195.1.112.76:61021,<->,91.231.193.172:dsm-scm-target,0,0,5,250,5,250,0.007343000,1.9827
98.217.2.71:udt-os,<->,77.41.75.13:udt-os,5,314,0,0,5,314,0.004788000,1.3341
144.93.125.49:62756,<->,144.93.121.86:34346,0,0,5,1020,5,1020,0.000513000,0.0791
210.220.219.152:39688,<->,53.149.143.243:ipsec-nat-t,4,1968,0,0,4,1968,1.872277000,0.0849
215.158.66.184:46355,<->,8.252.221.80:9043,0,0,4,584,4,584,1.859238000,0.0608
119.69.154.213:32743,<->,92.27.219.229:32607,0,0,4,4244,4,4244,1.857164000,0.0288
198.107.230.163:65047,<->,99.73.153.222:64090,0,0,4,498,4,498,1.833386000,0.1595
80.56.91.244:65436,<->,8.252.221.215:confluent,0,0,4,4448,4,4448,1.687858000,0.2428
100.95.88.249:61841,<->,144.76.46.38:domain,4,520,0,0,4,520,1.596944000,0.0209
215.158.66.185:61234,<->,133.178.227.200:9043,0,0,4,508,4,508,1.554251000,0.0022
220.6.163.23:38168,<->,92.27.219.142:http-alt,0,0,4,740,4,740,1.509367000,0.3400
115.80.7.174:26402,<->,218.4.180.210:14999,0,0,4,428,4,428,1.358539000,0.6279
112.96.179.64:64035,<->,192.64.255.44:23342,0,0,4,276,4,276,1.290140000,0.5703
6.188.163.28:51413,<->,200.174.217.111:5144,0,0,4,592,4,592,0.995578000,0.9333
92.27.209.193:safetynetp,<->,114.251.126.39:11710,4,200,0,0,4,200,0.972973000,0.4664
50.200.173.137:32670,<->,139.248.201.139:ntp,0,0,4,320,4,320,0.919139000,0.1138
78.44.243.152:49160,<->,89.183.104.172:42623,0,0,4,693,4,693,0.885326000,1.0065
220.187.80.11:55736,<->,92.27.27.173:http-alt,0,0,4,628,4,628,0.855550000,0.7116
159.146.67.44:12340,<->,111.147.178.69:5390,0,0,4,364,4,364,0.839808000,0.6987
126.102.186.4:56480,<->,8.228.215.123:51413,0,0,4,489,4,489,0.804751000,1.1265
109.222.208.215:udt-os,<->,93.196.138.15:udt-os,4,240,0,0,4,240,0.757548000,1.0821
207.125.234.7:61722,<->,22.59.4.26:9145,0,0,4,200,4,200,0.752427000,1.2002
92.27.219.211:60674,<->,113.246.46.33:26910,4,708,0,0,4,708,0.721380000,0.7848
80.40.50.197:64247,<->,29.156.85.9:6881,4,1372,0,0,4,1372,0.703444000,1.1615
247.136.181.127:52572,<->,27.160.143.95:9040,4,200,0,0,4,200,0.701450000,1.2080
215.158.66.193:42134,<->,8.252.221.76:9043,0,0,4,508,4,508,0.683165000,0.0018
195.111.188.39:61629,<->,91.231.193.172:dsm-scm-target,0,0,4,200,4,200,0.682276000,1.2581
40.210.30.180:20988,<->,92.27.27.153:19494,0,0,4,802,4,802,0.665055000,0.4361
252.72.196.66:64954,<->,27.160.143.95:cslistener,4,200,0,0,4,200,0.609187000,1.0967
97.183.216.230:ntp,<->,92.27.226.86:ntp,4,320,0,0,4,320,0.581311000,0.1644
195.56.26.110:57491,<->,92.27.234.141:10060,0,0,4,200,4,200,0.572221000,1.0176
92.180.56.187:56300,<->,22.59.5.231:9389,0,0,4,200,4,200,0.543349000,1.2357
99.75.122.192:18053,<->,92.27.4.178:wilkenlistener,4,5880,0,0,4,5880,0.539949000,1.0402
207.1.199.234:55684,<->,92.27.234.141:10060,0,0,4,200,4,200,0.527775000,1.0944
82.135.81.66:51148,<->,22.59.5.231:9302,0,0,4,200,4,200,0.508028000,1.1998
207.88.23.78:10868,<->,246.253.238.229:snmp,0,0,4,304,4,304,0.486972000,0.0003
29.239.238.231:18874,<->,92.27.219.176:18104,0,0,4,208,4,208,0.474879000,0.9757
92.27.219.230:56679,<->,199.102.232.92:40959,4,208,0,0,4,208,0.452884000,1.3635
192.80.230.86:30344,<->,145.242.126.88:sip,0,0,4,3189,4,3189,0.444416000,1.1369
121.215.124.71:51551,<->,89.183.109.183:wap-wsp,0,0,4,200,4,200,0.427778000,1.1402
6.16.149.123:63863,<->,89.183.110.5:http,0,0,4,559,4,559,0.426670000,1.4367
78.46.152.207:55251,<->,92.27.219.169:36944,0,0,4,260,4,260,0.402961000,1.1739
92.181.136.240:58012,<->,22.59.6.26:9332,0,0,4,200,4,200,0.375560000,1.3600
192.64.224.151:45667,<->,74.172.3.5:17016,4,532,0,0,4,532,0.372015000,1.3282
195.5.16.230:57528,<->,196.148.128.9:9988,0,0,4,200,4,200,0.369153000,1.2281
102.50.212.241:10018,<->,207.79.207.171:6881,4,218,0,0,4,218,0.363501000,1.2630
237.33.122.147:46881,<->,92.27.27.158:18305,0,0,4,485,4,485,0.360669000,0.9830
119.253.25.166:62272,<->,89.183.110.45:peerwire,0,0,4,200,4,200,0.358157000,1.0611
111.151.139.235:37372,<->,29.211.214.80:domain,0,0,4,298,4,298,0.353042000,1.5031
100.93.144.191:52291,<->,194.194.3.109:13401,4,276,0,0,4,276,0.348739000,0.6922
142.104.79.22:39215,<->,92.27.219.190:29554,0,0,4,208,4,208,0.346826000,1.6411
207.235.120.66:56998,<->,196.148.128.241:dsm-scm-target,0,0,4,200,4,200,0.345324000,1.3240
119.52.114.180:26044,<->,80.41.16.79:6881,0,0,4,532,4,532,0.339498000,1.0511
200.175.231.151:54010,<->,6.130.18.22:42322,4,276,0,0,4,276,0.321010000,0.5980
89.183.104.244:62169,<->,98.23.118.150:9353,4,200,0,0,4,200,0.317638000,1.6008
57.148.44.122:59895,<->,210.221.111.77:6881,0,0,4,1626,4,1626,0.279456000,0.5004
94.39.218.34:24485,<->,111.146.248.83:14834,0,0,4,532,4,532,0.271166000,0.9038
82.247.233.205:42145,<->,92.27.234.6:wap-wsp-wtp-s,0,0,4,200,4,200,0.268649000,1.2621
120.117.233.56:62276,<->,192.67.168.13:43666,0,0,4,208,4,208,0.264115000,1.5795
72.63.102.180:28720,<->,92.27.27.175:20671,0,0,4,232,4,232,0.262341000,1.7028
192.64.200.73:60156,<->,35.56.31.165:45049,4,496,0,0,4,496,0.261816000,1.4403
119.70.246.26:45850,<->,92.27.219.237:5532,0,0,4,5880,4,5880,0.253093000,1.4670
132.168.196.9:51162,<->,122.22.230.148:44411,4,208,0,0,4,208,0.249148000,1.1128
110.247.87.162:51488,<->,91.231.194.54:dsm-scm-target,0,0,4,200,4,200,0.247656000,1.0637
207.196.145.247:56824,<->,92.27.234.141:10060,0,0,4,200,4,200,0.241946000,1.3134
114.60.0.6:52392,<->,22.59.5.231:9144,0,0,4,200,4,200,0.241221000,1.3875
92.27.209.212:xbox,<->,57.141.132.156:xbox,4,1560,0,0,4,1560,0.239280000,0.4295
207.197.78.90:44012,<->,109.222.212.23:14758,0,0,4,5736,4,5736,0.233934000,1.6851
57.33.182.12:62643,<->,92.27.27.177:60274,0,0,4,226,4,226,0.229670000,1.3630
157.208.232.75:udt-os,<->,108.39.53.224:udt-os,0,0,4,268,4,268,0.228090000,1.1264
88.61.181.164:15783,<->,50.224.81.197:7045,0,0,4,256,4,256,0.220446000,1.4995
6.75.237.59:51413,<->,119.230.159.211:22707,4,276,0,0,4,276,0.214845000,0.3527
122.158.69.2:54989,<->,215.158.238.155:confluent,0,0,4,4448,4,4448,0.211951000,1.0054
122.158.69.2:54989,<->,215.158.239.67:confluent,0,0,4,4448,4,4448,0.209107000,1.0072
205.109.5.113:56850,<->,22.59.36.31:rjcdb-vcards,0,0,4,200,4,200,0.208925000,1.4464
238.155.239.157:12074,<->,89.183.104.254:11956,0,0,4,208,4,208,0.205749000,1.1725
122.6.184.30:54562,<->,247.136.180.232:45849,0,0,4,655,4,655,0.154912000,1.5941
247.136.250.194:53578,<->,80.233.221.39:dsm-scm-target,4,200,0,0,4,200,0.148998000,1.0874
77.38.144.199:40500,<->,138.73.126.183:6881,0,0,4,244,4,244,0.123107000,1.7345
210.156.94.131:64795,<->,145.136.243.126:9122,4,200,0,0,4,200,0.113143000,1.0143
97.198.121.42:28705,<->,89.204.88.146:tinc,4,528,0,0,4,528,0.106889000,1.5003
192.67.139.145:mqe-broker,<->,243.49.232.125:hpvmmdata,4,244,0,0,4,244,0.095152000,1.1851
205.25.24.107:24883,<->,109.222.216.231:6881,0,0,4,540,4,540,0.081656000,0.2676
226.36.140.164:40265,<->,92.27.219.155:openvpn,0,0,4,572,4,572,0.076814000,1.2759
112.13.158.155:udt-os,<->,109.222.208.215:udt-os,0,0,4,268,4,268,0.075687000,1.7752
222.5.185.61:52405,<->,92.27.234.6:9153,0,0,4,200,4,200,0.064496000,1.2361
125.161.178.229:60017,<->,92.27.219.210:57839,0,0,4,500,4,500,0.059136000,0.4679
196.148.131.53:6985,<->,194.237.237.8:6795,4,320,0,0,4,320,0.058804000,1.5369
40.212.145.54:61245,<->,92.27.219.17:17291,0,0,4,226,4,226,0.052527000,1.5125
236.137.155.115:48630,<->,89.183.104.255:37248,0,0,4,647,4,647,0.043367000,0.2952
27.79.107.211:57875,<->,92.27.219.171:24595,0,0,4,208,4,208,0.041658000,0.8643
8.228.218.37:12815,<->,196.20.139.86:6881,4,208,0,0,4,208,0.040999000,1.3351
103.135.210.152:56066,<->,35.56.100.188:10065,0,0,4,200,4,200,0.031394000,1.5937
53.161.125.14:websm,<->,99.162.71.215:4230,0,0,4,416,4,416,0.015738000,1.0255
207.199.23.163:27349,<->,92.27.234.141:10060,0,0,4,200,4,200,0.011764000,1.5296
38.28.41.166:19482,<->,80.41.32.57:14804,0,0,4,208,4,208,0.011443000,1.8742
92.27.209.103:33010,<->,50.63.20.4:xbox,4,320,0,0,4,320,0.010861000,1.5149
80.42.175.248:61220,<->,104.125.215.35:50617,4,208,0,0,4,208,0.007313000,1.1163
249.113.218.249:36736,<->,97.126.26.166:snmp,0,0,4,316,4,316,0.002056000,0.1994
158.27.166.9:37372,<->,80.41.50.144:udt-os,0,0,4,268,4,268,0.001807000,1.8007
111.150.185.46:60940,<->,133.178.227.222:9043,0,0,3,428,3,428,1.861924000,0.0000
69.31.239.60:36560,<->,133.178.227.207:9043,0,0,3,428,3,428,1.799003000,0.0000
80.56.91.244:65436,<->,136.25.189.52:confluent,0,0,3,3336,3,3336,1.621547000,0.3110
89.183.104.254:63738,<->,122.34.74.206:31727,3,351,0,0,3,351,1.529692000,0.2779
113.13.87.152:38547,<->,92.27.219.29:openvpn,0,0,3,447,3,447,1.443051000,0.3990
110.108.83.73:49460,<->,109.1.54.101:chimera-hwm,0,0,3,224,3,224,1.411150000,0.2081
122.158.176.232:33055,<->,133.178.226.212:confluent,0,0,3,3336,3,3336,1.386140000,0.2407
109.1.21.169:55013,<->,139.36.49.54:ipsec-nat-t,3,540,0,0,3,540,1.362786000,0.2402
119.213.189.67:53703,<->,92.27.219.49:28556,0,0,3,174,3,174,1.342489000,0.2820
80.40.1.230:6881,<->,50.127.188.132:6881,3,156,0,0,3,156,1.337776000,0.0620
88.5.213.212:37503,<->,92.27.219.42:27728,0,0,3,203,3,203,1.328412000,0.3965
125.20.85.151:64419,<->,80.42.183.31:62491,0,0,3,156,3,156,1.319791000,0.6133
48.17.236.244:21320,<->,92.170.252.152:bacula-dir,0,0,3,399,3,399,1.298990000,0.4691
122.158.69.2:54989,<->,133.178.226.66:confluent,0,0,3,3336,3,3336,1.291794000,0.1608
121.205.33.55:44377,<->,89.183.104.137:19050,0,0,3,326,3,326,1.283132000,0.6219
115.179.195.96:58745,<->,80.41.20.208:21255,0,0,3,156,3,156,1.280126000,0.1744
136.116.10.96:16402,<->,215.158.2.83:plethora,3,300,0,0,3,300,1.219191000,0.6574
92.27.219.148:31319,<->,78.44.2.32:12955,3,156,0,0,3,156,1.179551000,0.4170
59.32.3.196:57255,<->,34.90.46.185:12453,0,0,3,166,3,166,1.146773000,0.1292
82.150.74.32:59485,<->,89.183.104.251:42097,0,0,3,156,3,156,1.135395000,0.0880
125.211.116.201:55066,<->,92.27.219.178:6357,0,0,3,156,3,156,1.132180000,0.3817
92.27.27.169:42201,<->,235.38.54.55:24518,3,156,0,0,3,156,1.091307000,0.6078
92.27.219.19:48575,<->,148.180.169.155:24203,3,156,0,0,3,156,1.078302000,0.2427
97.223.146.236:57791,<->,92.27.27.175:20792,0,0,3,161,3,161,1.025077000,0.1414
247.136.154.209:57619,<->,88.156.22.45:29079,3,234,0,0,3,234,1.012043000,0.4902
89.183.104.188:37177,<->,193.23.0.8:31597,3,156,0,0,3,156,1.006680000,0.8609
78.45.228.179:51131,<->,89.183.104.188:37177,0,0,3,156,3,156,0.995465000,0.5989
116.146.253.37:18318,<->,92.27.219.234:6881,0,0,3,156,3,156,0.942837000,0.5610
100.95.230.73:51413,<->,204.34.19.221:13965,3,253,0,0,3,253,0.920228000,0.6262
78.46.255.104:64216,<->,92.27.219.190:26221,0,0,3,4290,3,4290,0.898022000,0.9008
89.183.104.234:58963,<->,102.244.221.223:29643,3,166,0,0,3,166,0.895138000,0.7007
80.42.183.31:62491,<->,29.204.172.105:39476,3,156,0,0,3,156,0.886357000,0.4216
194.208.223.87:51413,<->,80.40.61.86:15594,0,0,3,234,3,234,0.858951000,0.5938
207.83.86.49:54657,<->,246.253.253.207:https,0,0,3,455,3,455,0.828564000,0.4127
146.188.154.183:54905,<->,92.27.219.145:44573,0,0,3,156,3,156,0.816519000,0.9594
206.216.71.6:34689,<->,89.183.104.249:10631,0,0,3,306,3,306,0.806255000,0.7619
105.249.105.196:53663,<->,192.64.212.179:14220,0,0,3,224,3,224,0.768615000,0.9036
122.140.81.210:51991,<->,89.183.104.142:http-alt,0,0,3,463,3,463,0.742669000,0.2534
20.50.240.231:38811,<->,152.1.121.89:6881,3,706,0,0,3,706,0.738709000,0.0996
127.177.15.49:40500,<->,192.64.211.88:12395,0,0,3,162,3,162,0.703835000,0.7095
89.183.104.230:62526,<->,203.135.215.71:29664,3,160,0,0,3,160,0.702933000,0.8029
126.88.138.182:51413,<->,92.27.219.232:51185,0,0,3,156,3,156,0.681467000,0.1961
88.155.32.239:20333,<->,92.27.219.214:18800,0,0,3,156,3,156,0.673871000,0.8394
136.6.92.157:oceansoft-lm,<->,246.253.253.210:https,0,0,3,375,3,375,0.671792000,0.2173
6.171.58.242:59696,<->,200.174.129.238:55570,0,0,3,3177,3,3177,0.666628000,0.9080
38.255.125.152:20755,<->,92.27.219.131:5187,0,0,3,156,3,156,0.664774000,0.5149
134.244.248.146:48004,<->,192.67.143.198:22464,0,0,3,156,3,156,0.654945000,0.7010
80.42.190.120:43688,<->,104.54.63.97:40101,3,160,0,0,3,160,0.638642000,1.0038
57.114.28.94:53093,<->,92.27.219.229:32640,0,0,3,174,3,174,0.615530000,0.6955
101.235.76.65:50023,<->,17.3.209.41:https,3,1527,0,0,3,1527,0.606724000,0.8295
80.40.38.190:14336,<->,120.248.160.71:rtsserv,3,496,0,0,3,496,0.606687000,1.1620
92.173.80.91:64084,<->,109.222.246.106:33606,0,0,3,156,3,156,0.580618000,1.3570
6.122.205.96:41363,<->,57.209.136.82:tag-pm,3,221,0,0,3,221,0.558846000,1.1543
6.171.78.167:47759,<->,48.53.210.97:37303,0,0,3,1689,3,1689,0.498104000,0.3361
92.27.219.153:50555,<->,158.15.212.118:30457,3,4221,0,0,3,4221,0.489300000,1.1580
119.117.27.67:39125,<->,92.27.27.158:13494,0,0,3,156,3,156,0.481450000,0.8788
206.57.21.191:32852,<->,80.41.53.163:28290,0,0,3,156,3,156,0.477288000,0.9360
98.242.57.201:55522,<->,92.27.219.230:http-alt,0,0,3,511,3,511,0.475164000,1.0140
133.24.118.119:40159,<->,92.27.27.174:http-alt,0,0,3,4512,3,4512,0.454327000,0.8795
98.236.122.10:44253,<->,92.27.219.137:37156,0,0,3,156,3,156,0.452768000,0.1352
104.154.237.127:57726,<->,109.1.9.150:55971,0,0,3,156,3,156,0.444840000,0.3040
38.80.130.180:11338,<->,92.27.219.178:http-alt,0,0,3,447,3,447,0.441906000,0.0063
80.42.184.112:61500,<->,93.142.250.183:21488,3,156,0,0,3,156,0.434955000,0.3999
78.45.12.81:40569,<->,80.40.2.168:40220,0,0,3,168,3,168,0.426336000,0.9784
142.218.110.190:57385,<->,99.73.151.145:smwan,0,0,3,316,3,316,0.416756000,0.3774
92.27.27.99:45503,<->,206.102.5.199:13116,3,156,0,0,3,156,0.411097000,0.4139
149.88.113.197:55788,<->,215.158.103.219:echo,0,0,3,1632,3,1632,0.410845000,1.4995
192.64.248.242:57994,<->,134.94.147.245:46810,3,506,0,0,3,506,0.395465000,0.2796
100.95.251.127:52387,<->,207.178.152.255:6881,3,162,0,0,3,162,0.392007000,1.3508
99.73.178.32:57874,<->,206.195.145.185:6881,3,156,0,0,3,156,0.378603000,1.5521
210.156.216.109:35136,<->,77.24.25.158:26500,3,495,0,0,3,495,0.377028000,0.7406
247.136.136.112:6881,<->,27.123.17.33:6881,3,156,0,0,3,156,0.354707000,0.2854
30.192.18.236:6603,<->,39.22.29.188:domain,0,0,3,203,3,203,0.344247000,0.1269
126.196.222.83:58895,<->,80.40.2.27:45757,0,0,3,224,3,224,0.342741000,0.4057
110.57.3.72:64379,<->,92.27.27.179:56878,0,0,3,263,3,263,0.340488000,0.5034
100.208.13.217:57076,<->,77.39.172.5:25371,3,399,0,0,3,399,0.335106000,0.6727
192.67.167.86:63248,<->,92.18.173.95:54013,3,331,0,0,3,331,0.327427000,0.1139
75.92.230.44:58966,<->,159.115.14.88:58528,0,0,3,156,3,156,0.321472000,0.6422
80.41.4.141:53340,<->,158.28.223.211:50022,3,601,0,0,3,601,0.310050000,0.0998
89.183.104.150:20329,<->,121.204.206.54:17533,3,156,0,0,3,156,0.305907000,0.3319
92.27.219.222:56329,<->,69.196.227.88:42953,3,156,0,0,3,156,0.297768000,1.6858
120.241.71.24:56621,<->,89.183.104.254:http-alt,0,0,3,463,3,463,0.266385000,0.4188
92.27.219.226:23576,<->,117.242.104.229:21734,3,161,0,0,3,161,0.259620000,0.3761
200.174.211.210:39188,<->,6.171.93.27:13249,3,393,0,0,3,393,0.255042000,1.5809
86.76.154.253:63772,<->,89.183.104.245:44186,0,0,3,156,3,156,0.253971000,0.5031
48.107.197.58:60265,<->,92.27.219.240:11800,0,0,3,4410,3,4410,0.251884000,1.1488
117.6.108.183:60337,<->,89.183.104.167:33341,0,0,3,156,3,156,0.251737000,0.1228
145.19.9.66:15401,<->,81.96.98.4:ntp,3,240,0,0,3,240,0.229797000,1.2411
92.27.219.180:36365,<->,72.62.223.132:10247,3,170,0,0,3,170,0.223184000,0.3787
29.44.96.146:52329,<->,92.27.219.238:30845,0,0,3,156,3,156,0.220858000,0.5448
99.72.167.52:60916,<->,207.79.157.237:43030,3,175,0,0,3,175,0.218059000,0.9135
33.124.235.126:50695,<->,22.59.37.233:9304,0,0,3,150,3,150,0.216193000,1.0013
92.27.219.61:58224,<->,92.181.148.15:42426,3,987,0,0,3,987,0.210369000,0.8640
118.100.76.40:53829,<->,109.222.212.23:14758,0,0,3,224,3,224,0.208381000,0.2157
121.10.132.194:56737,<->,92.27.219.63:ipsec-nat-t,0,0,3,652,3,652,0.187079000,0.6152
99.75.33.195:14163,<->,194.193.197.231:13997,3,190,0,0,3,190,0.177300000,1.0216
42.81.250.54:40500,<->,192.67.139.145:mqe-broker,0,0,3,183,3,183,0.175744000,0.6573
139.128.242.158:50117,<->,92.27.219.60:35504,0,0,3,156,3,156,0.156105000,1.2967
92.27.27.174:43622,<->,27.25.112.156:20260,3,156,0,0,3,156,0.138397000,0.1764
192.67.172.77:46324,<->,205.188.162.40:8620,3,399,0,0,3,399,0.134751000,1.8345
101.224.89.248:55589,<->,111.20.172.70:domain,3,272,0,0,3,272,0.123191000,0.0000
115.86.156.192:49969,<->,22.59.37.233:fjdmimgr,0,0,3,150,3,150,0.101065000,0.9984
89.183.104.147:sgi-lk,<->,104.40.239.30:bctp,3,2531,0,0,3,2531,0.096431000,0.4440
135.79.232.55:octopus,<->,109.1.54.145:6881,0,0,3,360,3,360,0.083059000,0.1006
111.146.175.90:38352,<->,145.216.238.18:26085,3,156,0,0,3,156,0.081616000,1.6182
92.27.219.247:56029,<->,118.209.199.81:50404,3,1011,0,0,3,1011,0.064541000,1.0466
193.1.1.67:54444,<->,101.70.111.87:netbios-ns,0,0,3,246,3,246,0.062990000,1.9284
96.31.74.8:48478,<->,230.60.74.150:25034,3,399,0,0,3,399,0.055423000,1.7190
102.244.195.51:60290,<->,35.56.100.188:10197,0,0,3,150,3,150,0.048812000,1.0001
134.18.200.92:46162,<->,192.64.200.112:33644,0,0,3,220,3,220,0.047836000,1.5874
210.221.111.77:6881,<->,60.92.18.35:6881,3,218,0,0,3,218,0.044636000,1.0334
107.127.118.108:63385,<->,109.1.54.101:quasar-server,0,0,3,335,3,335,0.043610000,0.1121
99.75.102.6:53453,<->,194.194.227.156:18073,3,156,0,0,3,156,0.023264000,0.1900
192.138.215.26:62128,<->,92.27.219.18:37232,0,0,3,216,3,216,0.015708000,1.7450
80.42.146.108:58409,<->,206.62.58.105:49951,3,268,0,0,3,268,0.010322000,0.8226
100.176.233.172:55050,<->,159.194.94.44:8590,0,0,3,306,3,306,0.003799000,1.8859
247.136.139.100:xbox,<->,120.71.141.210:xbox,2,136,0,0,2,136,1.964191000,0.0338
92.27.219.32:58466,<->,113.199.186.37:57707,2,373,0,0,2,373,1.941625000,0.0167
92.27.219.224:62348,<->,81.11.131.84:54229,2,457,0,0,2,457,1.940251000,0.0201
111.151.139.246:40203,<->,215.158.140.84:confluent,0,0,2,2224,2,2224,1.901690000,0.0804
111.151.139.246:40203,<->,8.252.223.171:confluent,0,0,2,2224,2,2224,1.897446000,0.0771
145.16.34.73:9340,<->,246.252.97.167:isakmp,2,488,0,0,2,488,1.891321000,0.0690
111.151.139.246:40203,<->,8.252.221.181:confluent,0,0,2,2224,2,2224,1.872122000,0.0658
111.151.139.246:40203,<->,8.176.8.185:confluent,0,0,2,2224,2,2224,1.869929000,0.0638
247.136.165.38:57891,<->,104.217.186.99:webobjects,2,104,0,0,2,104,1.866732000,0.1105
111.151.139.246:40203,<->,8.252.221.226:confluent,0,0,2,2224,2,2224,1.865133000,0.0602
70.191.71.13:19346,<->,111.147.103.177:6881,0,0,2,328,2,328,1.849525000,0.0922
93.221.37.138:53119,<->,92.27.219.244:36461,0,0,2,104,2,104,1.834387000,0.0895
158.13.202.176:59003,<->,92.27.27.154:15736,0,0,2,104,2,104,1.805091000,0.0336
92.27.219.141:44154,<->,101.106.122.69:14729,2,335,0,0,2,335,1.779677000,0.0898
116.166.253.26:58119,<->,192.67.183.227:51216,0,0,2,104,2,104,1.778409000,0.1037
121.242.88.242:61111,<->,247.136.169.35:54144,0,0,2,172,2,172,1.764348000,0.1344
54.42.69.14:50370,<->,109.222.246.106:33606,0,0,2,197,2,197,1.759436000,0.1450
98.23.111.141:34364,<->,92.27.209.234:7540,0,0,2,100,2,100,1.755096000,0.0000
149.200.188.126:40011,<->,192.67.146.69:20775,0,0,2,111,2,111,1.724981000,0.1115
48.53.19.217:59736,<->,6.147.62.230:51336,2,168,0,0,2,168,1.722406000,0.0060
102.51.154.36:62199,<->,207.3.85.49:51677,2,277,0,0,2,277,1.712290000,0.0000
144.75.218.242:14181,<->,8.222.218.199:domain,2,232,0,0,2,232,1.652466000,0.1145
159.231.131.109:53348,<->,254.242.186.155:snmp,0,0,2,337,2,337,1.641164000,0.0627
92.27.219.238:60206,<->,134.245.141.254:10584,2,331,0,0,2,331,1.624335000,0.3126
100.93.247.0:17777,<->,38.238.10.170:16883,2,104,0,0,2,104,1.606926000,0.0000
113.38.212.89:58326,<->,109.222.200.127:6881,0,0,2,114,2,114,1.596830000,0.1625
192.64.235.214:scol,<->,80.226.252.43:scol,2,189,0,0,2,189,1.590977000,0.2104
50.140.157.178:60403,<->,80.41.58.237:6881,0,0,2,326,2,326,1.581614000,0.1402
98.23.111.141:51131,<->,92.27.209.119:7700,0,0,2,100,2,100,1.564636000,0.0000
98.23.111.141:37789,<->,92.27.209.202:7370,0,0,2,100,2,100,1.563251000,0.0000
192.64.245.156:xbox,<->,80.237.224.21:xbox,2,228,0,0,2,228,1.550408000,0.4039
249.101.84.15:61787,<->,76.187.242.22:60520,2,168,0,0,2,168,1.546525000,0.0000
195.59.71.46:64052,<->,246.253.253.208:https,0,0,2,250,2,250,1.545489000,0.0000
136.41.13.4:58506,<->,98.198.167.139:https,2,1466,0,0,2,1466,1.528992000,0.0004
144.75.218.237:23007,<->,8.222.218.204:domain,2,238,0,0,2,238,1.513046000,0.3917
92.27.27.175:20805,<->,134.198.171.8:12505,2,104,0,0,2,104,1.509140000,0.2526
57.84.217.167:45320,<->,102.224.165.182:6889,0,0,2,698,2,698,1.506948000,0.0160
247.136.181.26:59614,<->,90.199.69.209:48787,2,686,0,0,2,686,1.502756000,0.0202
98.23.111.141:38752,<->,92.27.209.227:7290,0,0,2,100,2,100,1.495960000,0.0000
92.27.219.54:56682,<->,115.170.240.204:39907,2,231,0,0,2,231,1.490828000,0.3283
98.23.111.141:40616,<->,92.27.209.229:7650,0,0,2,100,2,100,1.484833000,0.0000
210.156.34.185:16493,<->,89.220.214.254:dka,2,255,0,0,2,255,1.484334000,0.1256
54.37.145.251:51900,<->,200.174.199.176:22970,0,0,2,194,2,194,1.464965000,0.1034
92.27.219.244:36461,<->,40.223.152.65:10424,2,104,0,0,2,104,1.457341000,0.0992
80.125.16.180:53910,<->,78.45.217.58:47656,2,104,0,0,2,104,1.446919000,0.0337
248.225.25.172:50002,<->,54.40.52.190:pcoip,2,200,0,0,2,200,1.431706000,0.3226
196.148.133.194:51413,<->,138.126.131.34:19212,2,404,0,0,2,404,1.421496000,0.0005
95.221.82.205:40015,<->,136.41.13.4:20101,0,0,2,1480,2,1480,1.371261000,0.0000
207.212.200.80:61954,<->,92.27.219.39:57137,0,0,2,2210,2,2210,1.361721000,0.3370
120.83.73.157:6881,<->,89.183.104.243:5186,0,0,2,648,2,648,1.350146000,0.2006
69.128.106.102:64332,<->,80.15.90.172:12717,2,644,0,0,2,644,1.330992000,0.3200
222.79.118.35:isakmp,<->,210.193.94.45:isakmp,2,248,0,0,2,248,1.308363000,0.0204
220.14.74.249:sip,<->,35.56.98.184:sip,0,0,2,1834,2,1834,1.248392000,0.5180
201.213.20.210:55180,<->,247.136.201.118:50821,0,0,2,194,2,194,1.246736000,0.0678
195.0.73.54:52188,<->,246.253.253.208:https,0,0,2,266,2,266,1.216497000,0.3425
222.65.26.49:30303,<->,33.250.210.16:30303,2,352,0,0,2,352,1.209339000,0.0010
200.226.80.179:15273,<->,129.92.113.143:chargen,0,0,2,100,2,100,1.187918000,0.0000
144.232.221.31:51659,<->,35.56.102.150:34354,0,0,2,100,2,100,1.187687000,0.0000
92.27.27.166:52566,<->,125.18.130.104:aurora-balaena,2,2916,0,0,2,2916,1.178012000,0.6379
92.27.27.156:61094,<->,121.211.213.138:58650,2,702,0,0,2,702,1.164427000,0.2681
98.33.78.19:51290,<->,92.27.219.188:11109,0,0,2,304,2,304,1.148128000,0.5097
92.27.234.195:49416,<->,92.27.51.139:domain,2,240,0,0,2,240,1.132421000,0.0000
209.60.50.164:39845,<->,192.67.154.172:6881,0,0,2,188,2,188,1.064733000,0.0000
57.46.23.242:54107,<->,192.64.223.86:22641,0,0,2,628,2,628,1.040863000,0.0106
143.147.2.220:62276,<->,92.27.219.139:29623,0,0,2,2940,2,2940,1.019209000,0.3979
195.114.88.237:41104,<->,92.27.27.164:dsx-agent,0,0,2,104,2,104,1.004544000,0.9776
252.98.141.99:9569,<->,8.47.122.178:domain,2,178,0,0,2,178,1.003184000,0.0060
109.1.14.71:46225,<->,105.90.194.26:17631,2,109,0,0,2,109,1.000076000,0.2154
109.26.79.44:55466,<->,111.146.250.198:49646,0,0,2,100,2,100,0.997472000,0.4005
201.222.32.9:64321,<->,80.41.21.72:26956,0,0,2,123,2,123,0.995273000,0.7217
131.153.183.226:isakmp,<->,56.121.47.18:isakmp,0,0,2,216,2,216,0.982503000,0.1522
38.71.255.21:21814,<->,192.67.162.92:10822,0,0,2,104,2,104,0.976520000,0.9555
111.147.242.225:55556,<->,229.102.219.67:prelude,2,104,0,0,2,104,0.967297000,0.3058
112.158.254.7:45593,<->,92.27.27.99:43944,0,0,2,297,2,297,0.953582000,0.0000
80.40.50.197:64208,<->,80.246.53.102:6881,2,132,0,0,2,132,0.919420000,0.4062
6.74.114.97:28247,<->,89.183.104.230:16126,0,0,2,104,2,104,0.915228000,0.0000
200.226.80.179:11787,<->,129.92.113.143:chargen,0,0,2,100,2,100,0.905707000,0.0000
144.75.218.237:43055,<->,8.222.218.198:domain,2,245,0,0,2,245,0.889698000,0.6422
66.11.253.17:53081,<->,92.27.219.235:33529,0,0,2,104,2,104,0.876143000,0.3549
247.136.141.15:51955,<->,75.95.120.8:46300,2,104,0,0,2,104,0.872734000,0.0010
8.228.215.123:51413,<->,143.192.84.146:12721,2,113,0,0,2,113,0.870049000,1.1127
197.196.47.226:49643,<->,92.27.219.19:48503,0,0,2,104,2,104,0.863142000,0.5189
8.240.125.165:55375,<->,133.178.227.206:9043,0,0,2,296,2,296,0.860868000,0.7007
108.134.108.77:55350,<->,106.157.38.242:37294,2,100,0,0,2,100,0.855193000,0.4341
77.21.42.142:51621,<->,247.157.0.168:8907,0,0,2,104,2,104,0.850916000,0.0080
97.126.119.191:55706,<->,140.136.9.105:domain,2,870,0,0,2,870,0.832198000,0.0232
92.27.219.159:35097,<->,101.106.122.69:33569,2,456,0,0,2,456,0.831445000,0.0919
80.40.61.163:46532,<->,110.9.120.22:29540,2,210,0,0,2,210,0.827678000,0.0501
92.27.219.34:26184,<->,104.252.174.36:15937,2,434,0,0,2,434,0.810801000,0.4412
100.230.7.112:34567,<->,6.122.144.87:33435,0,0,2,100,2,100,0.788339000,1.0000
92.27.219.129:55311,<->,67.226.174.178:17193,2,104,0,0,2,104,0.782421000,0.2665
109.1.38.119:51170,<->,205.127.142.147:32335,2,110,0,0,2,110,0.772932000,1.0336
121.67.9.245:25355,<->,89.183.104.135:6881,0,0,2,698,2,698,0.768859000,1.0257
89.183.104.137:64964,<->,38.182.16.102:28479,2,104,0,0,2,104,0.760533000,0.8000
92.27.219.238:62895,<->,112.73.216.90:6881,2,104,0,0,2,104,0.753463000,0.0005
132.168.196.174:57344,<->,53.78.162.188:19364,2,116,0,0,2,116,0.752769000,0.0398
20.151.0.202:47058,<->,119.43.150.48:ntp,2,160,0,0,2,160,0.747761000,0.9997
247.136.255.52:49345,<->,117.64.120.171:49271,2,238,0,0,2,238,0.745528000,0.1614
78.45.154.137:63636,<->,159.31.237.1:53020,0,0,2,184,2,184,0.742900000,0.5138
152.12.131.83:58839,<->,92.27.219.223:39639,0,0,2,642,2,642,0.741021000,0.0034
192.64.208.147:51899,<->,127.81.151.203:42149,2,172,0,0,2,172,0.735625000,0.6990
144.75.218.237:12635,<->,8.222.218.199:domain,2,263,0,0,2,263,0.732049000,0.2710
132.249.70.233:57387,<->,53.201.149.31:domain,2,171,0,0,2,171,0.730944000,1.0730
89.183.104.248:36027,<->,126.211.107.156:19593,2,397,0,0,2,397,0.726693000,1.0130
89.204.223.30:sip,<->,89.183.108.215:sip,0,0,2,1110,2,1110,0.718623000,1.0002
110.194.114.3:53603,<->,145.19.9.13:https,0,0,2,314,2,314,0.715694000,0.0367
195.123.175.8:6881,<->,100.94.55.113:6881,0,0,2,278,2,278,0.709545000,0.9772
27.242.250.182:63127,<->,247.136.192.204:52093,0,0,2,168,2,168,0.708877000,0.4130
230.83.120.210:49159,<->,220.81.57.237:6881,0,0,2,266,2,266,0.691242000,0.2200
137.137.124.206:49691,<->,122.235.215.40:domain,2,218,0,0,2,218,0.690957000,0.0204
239.29.96.45:ipsec-nat-t,<->,249.101.104.130:1024,0,0,2,216,2,216,0.667511000,0.0000
201.222.12.47:36742,<->,92.27.219.60:17406,0,0,2,2940,2,2940,0.660534000,0.0321
34.13.94.119:37714,<->,64.148.91.176:15359,2,114,0,0,2,114,0.649207000,0.0178
120.150.106.190:28129,<->,89.183.104.132:16051,0,0,2,104,2,104,0.641991000,0.7669
144.75.218.242:13011,<->,8.222.218.196:domain,2,235,0,0,2,235,0.632937000,0.3301
159.151.56.171:58840,<->,192.67.130.105:40775,0,0,2,104,2,104,0.632218000,0.6987
192.64.255.44:54030,<->,254.70.113.234:51793,2,168,0,0,2,168,0.620388000,0.0259
106.169.196.77:51093,<->,92.27.219.153:50555,0,0,2,362,2,362,0.619369000,0.0032
142.178.1.24:18795,<->,246.253.253.212:https,0,0,2,602,2,602,0.616618000,1.2548
100.176.233.172:55050,<->,200.174.214.48:buddy-draw,0,0,2,212,2,212,0.613566000,0.3347
50.224.121.247:14600,<->,48.130.165.6:commplex-link,2,100,0,0,2,100,0.582005000,1.0400
82.239.211.136:62794,<->,109.222.200.111:54675,0,0,2,100,2,100,0.577764000,1.2243
192.64.229.17:54475,<->,127.161.246.238:49361,2,132,0,0,2,132,0.559467000,1.0219
92.27.219.39:57216,<->,33.227.94.168:6889,2,662,0,0,2,662,0.535430000,0.9887
92.27.27.170:59445,<->,197.45.243.206:12547,2,151,0,0,2,151,0.532399000,0.0000
92.27.219.32:58466,<->,220.0.242.22:54172,2,104,0,0,2,104,0.524003000,0.0106
110.86.201.155:55556,<->,92.27.219.187:35152,0,0,2,284,2,284,0.523174000,0.0000
88.45.158.210:47804,<->,92.27.219.252:27013,0,0,2,104,2,104,0.523071000,1.4463
80.41.59.232:54721,<->,38.57.179.208:25332,2,1917,0,0,2,1917,0.522782000,0.6580
92.27.219.31:43612,<->,69.133.95.41:18852,2,121,0,0,2,121,0.522642000,0.7057
132.168.196.9:51162,<->,206.199.183.63:28456,2,104,0,0,2,104,0.513941000,0.0107
112.11.21.26:37257,<->,101.70.111.86:netbios-ns,0,0,2,164,2,164,0.511446000,1.0161
239.66.101.100:sip,<->,99.72.215.157:sip,0,0,2,1342,2,1342,0.503567000,0.9989
97.94.179.20:38364,<->,80.38.57.148:33435,0,0,2,100,2,100,0.499665000,1.1159
117.130.224.137:58581,<->,92.27.27.175:track,0,0,2,255,2,255,0.494274000,0.0078
33.240.23.50:50142,<->,192.67.145.193:23424,0,0,2,362,2,362,0.491590000,0.0651
109.0.228.28:52791,<->,4.122.107.17:10644,2,362,0,0,2,362,0.489446000,0.0897
92.27.219.236:41234,<->,138.126.224.187:9777,2,182,0,0,2,182,0.488140000,0.5883
115.121.192.145:49752,<->,92.27.219.237:6881,0,0,2,187,2,187,0.486848000,1.2936
139.47.239.231:29999,<->,110.109.231.156:29999,2,216,0,0,2,216,0.480777000,1.0182
42.46.193.243:46641,<->,92.27.27.167:41190,0,0,2,642,2,642,0.474630000,0.0000
121.195.174.188:48861,<->,89.183.104.166:tapeware,0,0,2,104,2,104,0.463979000,0.0002
48.53.123.29:53767,<->,222.59.244.202:33558,2,104,0,0,2,104,0.458056000,0.0000
122.158.176.232:33055,<->,133.178.227.168:confluent,0,0,2,2224,2,2224,0.456209000,0.1092
102.50.242.234:59533,<->,102.45.3.188:39874,2,809,0,0,2,809,0.453401000,0.1798
206.72.123.108:62361,<->,246.253.253.210:https,0,0,2,250,2,250,0.449575000,0.2485
133.252.81.46:64579,<->,247.136.192.204:52093,0,0,2,168,2,168,0.449165000,0.9681
80.238.60.11:57622,<->,109.1.54.101:chimera-hwm,0,0,2,240,2,240,0.444809000,1.1786
121.74.22.120:62424,<->,92.27.27.179:59397,0,0,2,104,2,104,0.426471000,0.0000
89.183.104.157:53993,<->,113.226.157.159:23779,2,104,0,0,2,104,0.418848000,0.2370
75.94.222.102:24449,<->,192.67.175.66:12677,0,0,2,104,2,104,0.405687000,1.0444
205.225.212.78:51413,<->,92.27.219.42:17292,0,0,2,806,2,806,0.397621000,0.1579
92.27.219.34:63640,<->,126.101.55.158:58485,2,104,0,0,2,104,0.397195000,0.8476
80.42.175.248:61220,<->,110.40.13.209:50981,2,113,0,0,2,113,0.395958000,0.5507
66.246.165.183:10010,<->,136.99.122.178:ipsec-nat-t,0,0,2,440,2,440,0.392547000,0.4760
80.42.129.116:6881,<->,113.173.255.26:sso-service,2,126,0,0,2,126,0.382100000,0.3282
92.181.251.39:49210,<->,152.105.92.208:21235,2,266,0,0,2,266,0.374682000,1.5311
144.93.121.10:42107,<->,207.189.68.218:metasys,2,224,0,0,2,224,0.368168000,1.0011
120.233.143.121:45682,<->,92.27.219.151:25821,0,0,2,600,2,600,0.347031000,0.0079
48.111.183.109:48235,<->,92.27.27.161:5206,0,0,2,104,2,104,0.333276000,0.9076
144.75.218.246:52441,<->,8.222.218.199:domain,2,223,0,0,2,223,0.326672000,0.4426
111.147.97.95:59430,<->,53.213.141.53:sip,2,1146,0,0,2,1146,0.325342000,0.0859
131.144.36.214:domain,<->,80.38.25.116:domain,0,0,2,412,2,412,0.323441000,0.9220
107.23.207.19:40500,<->,192.67.139.145:mqe-broker,0,0,2,122,2,122,0.315899000,1.5519
137.132.207.124:10108,<->,99.175.107.53:10108,0,0,2,640,2,640,0.310294000,0.0308
145.208.138.125:49150,<->,92.27.219.204:14506,0,0,2,2848,2,2848,0.310291000,0.2640
220.83.21.43:19170,<->,230.113.228.44:9179,2,266,0,0,2,266,0.302902000,0.2990
144.232.206.14:63328,<->,192.64.248.242:57994,0,0,2,104,2,104,0.298634000,0.3283
20.151.18.52:47646,<->,0.112.13.35:ntp,2,160,0,0,2,160,0.297641000,1.0000
33.57.79.36:57337,<->,92.27.219.175:50543,0,0,2,113,2,113,0.297105000,0.0248
57.116.92.187:40563,<->,92.27.219.180:36365,0,0,2,230,2,230,0.290459000,0.7391
92.27.219.185:53570,<->,88.0.194.179:52088,2,104,0,0,2,104,0.289376000,0.4716
200.226.80.179:41469,<->,129.92.113.143:chargen,0,0,2,100,2,100,0.282126000,0.0000
20.207.104.91:57899,<->,149.1.209.97:9365,2,276,0,0,2,276,0.274407000,0.4524
199.5.174.227:24507,<->,92.27.219.51:16920,0,0,2,104,2,104,0.273712000,0.0046
207.206.254.187:26659,<->,102.50.110.21:bacula-dir,0,0,2,266,2,266,0.272691000,0.6523
94.24.223.119:32506,<->,92.27.219.180:18409,0,0,2,104,2,104,0.271074000,0.0014
106.146.163.167:47203,<->,89.183.104.160:qubes,0,0,2,526,2,526,0.270516000,0.1081
192.64.195.195:53101,<->,113.203.146.133:14461,2,104,0,0,2,104,0.269657000,0.8318
192.67.145.193:23424,<->,134.5.66.49:esip,2,266,0,0,2,266,0.263010000,0.6631
80.42.176.246:51075,<->,53.90.7.85:7985,2,132,0,0,2,132,0.262509000,1.0225
29.223.31.98:52485,<->,97.126.118.120:20705,0,0,2,114,2,114,0.256545000,0.2977
92.181.115.14:39074,<->,94.193.37.58:27514,2,266,0,0,2,266,0.256117000,1.5181
97.168.127.135:56699,<->,119.45.229.218:54424,2,1486,0,0,2,1486,0.256069000,0.0900
89.183.104.230:60526,<->,142.190.132.115:52634,2,104,0,0,2,104,0.249806000,0.0015
247.136.252.169:17284,<->,113.203.214.122:6881,2,119,0,0,2,119,0.248744000,1.4694
89.183.104.189:45619,<->,101.106.122.69:26767,2,456,0,0,2,456,0.244386000,0.2422
98.129.83.35:51413,<->,202.223.124.75:23399,2,266,0,0,2,266,0.243996000,0.3899
144.75.218.241:44973,<->,8.222.218.207:domain,2,294,0,0,2,294,0.226296000,1.5942
192.67.128.244:51413,<->,142.205.143.22:16880,2,268,0,0,2,268,0.206704000,0.2509
92.27.219.53:42048,<->,33.57.74.178:35499,2,474,0,0,2,474,0.204808000,1.4976
98.150.107.178:35676,<->,111.181.96.177:33435,0,0,2,100,2,100,0.204077000,1.0002
118.208.149.7:17750,<->,89.183.104.248:bctp,0,0,2,104,2,104,0.203138000,0.1921
144.75.218.246:13248,<->,8.222.218.197:domain,2,347,0,0,2,347,0.198074000,0.7715
29.131.188.62:50562,<->,92.27.219.244:36529,0,0,2,104,2,104,0.197310000,0.0875
101.106.122.69:64622,<->,89.183.104.172:57933,0,0,2,276,2,276,0.197244000,0.9999
144.75.218.235:synapse-nhttp,<->,8.222.218.197:domain,2,220,0,0,2,220,0.195354000,0.2040
92.27.27.182:57410,<->,93.237.35.197:19955,2,2450,0,0,2,2450,0.193839000,0.9497
121.131.14.214:40500,<->,80.40.25.242:40500,0,0,2,122,2,122,0.184533000,1.1822
247.136.242.15:48513,<->,40.202.65.141:16001,2,266,0,0,2,266,0.182725000,0.5383
92.27.219.247:56214,<->,205.90.219.141:28461,2,104,0,0,2,104,0.182341000,0.0007
158.50.201.152:57807,<->,247.136.249.234:51413,0,0,2,104,2,104,0.180767000,0.0000
92.27.219.247:56241,<->,75.95.103.248:26723,2,104,0,0,2,104,0.169523000,0.0011
53.160.107.185:51413,<->,48.53.51.110:14735,0,0,2,678,2,678,0.158240000,0.2486
149.201.23.137:20281,<->,89.183.104.254:10928,0,0,2,104,2,104,0.156027000,0.0569
92.27.27.150:51929,<->,195.215.175.157:12315,2,104,0,0,2,104,0.154886000,1.5957
117.20.139.128:56263,<->,92.27.219.229:31236,0,0,2,104,2,104,0.153811000,0.0037
92.27.219.44:7759,<->,6.79.214.215:7759,2,176,0,0,2,176,0.148909000,1.7864
92.27.219.46:56110,<->,113.59.141.49:16564,2,506,0,0,2,506,0.147927000,0.6720
101.106.122.69:49382,<->,92.27.27.178:powwow-server,0,0,2,378,2,378,0.138384000,0.1922
159.237.225.1:52892,<->,105.124.196.37:44648,2,104,0,0,2,104,0.134786000,0.0005
54.92.206.16:56511,<->,111.147.142.254:10853,0,0,2,118,2,118,0.133252000,0.0822
109.222.208.215:udt-os,<->,103.254.210.135:udt-os,2,120,0,0,2,120,0.132542000,0.4326
197.47.39.38:26344,<->,109.222.208.215:udt-os,0,0,2,120,2,120,0.130090000,0.5696
111.20.168.23:37069,<->,111.20.172.70:domain,2,159,0,0,2,159,0.126622000,0.9930
125.11.252.202:23657,<->,80.42.168.43:17791,0,0,2,104,2,104,0.122799000,0.0008
89.183.104.130:53763,<->,98.217.87.186:23568,2,104,0,0,2,104,0.114608000,0.0010
106.157.38.242:37294,<->,108.134.108.77:10119,0,0,2,100,2,100,0.111970000,0.7358
38.253.226.186:51413,<->,92.27.219.225:46335,0,0,2,104,2,104,0.109957000,0.1406
247.136.164.246:6881,<->,115.186.140.175:6881,2,272,0,0,2,272,0.109836000,1.0421
144.75.218.242:linogridengine,<->,8.222.218.199:domain,2,231,0,0,2,231,0.094396000,1.2564
97.126.18.244:55000,<->,53.197.137.20:5558,2,112,0,0,2,112,0.090763000,0.0000
48.53.25.210:55772,<->,102.71.178.90:41739,2,2910,0,0,2,2910,0.090310000,1.4020
33.78.156.234:62008,<->,99.72.74.250:61289,0,0,2,104,2,104,0.089990000,0.0145
48.106.37.233:60827,<->,80.42.144.133:21015,0,0,2,104,2,104,0.080047000,0.5575
202.206.68.225:7441,<->,220.80.178.38:6881,0,0,2,266,2,266,0.080034000,1.4530
92.27.219.19:48579,<->,119.187.220.213:27682,2,104,0,0,2,104,0.075194000,0.7335
92.27.219.149:63051,<->,141.28.181.49:26561,2,2800,0,0,2,2800,0.071415000,0.0125
117.79.145.41:50436,<->,80.41.32.57:14745,0,0,2,104,2,104,0.066082000,0.0000
92.27.219.244:57196,<->,119.251.182.115:46584,2,104,0,0,2,104,0.064681000,1.7507
215.158.66.202:51012,<->,133.178.227.201:9043,0,0,2,231,2,231,0.063756000,0.9107
69.31.239.50:47150,<->,133.178.227.222:9043,0,0,2,244,2,244,0.059574000,0.0008
131.57.126.120:ipsec-nat-t,<->,108.134.95.188:ipsec-nat-t,0,0,2,248,2,248,0.058196000,1.0197
105.140.147.106:49146,<->,89.183.104.163:webmachine,0,0,2,104,2,104,0.058194000,0.0057
80.40.50.197:62237,<->,57.47.64.50:6881,2,135,0,0,2,135,0.047407000,0.1508
134.245.148.207:tolfab,<->,192.67.176.141:17884,0,0,2,104,2,104,0.039653000,0.0000
97.168.105.140:48007,<->,121.249.34.86:23858,2,100,0,0,2,100,0.039593000,0.1897
92.27.219.224:62348,<->,202.73.72.103:61280,2,686,0,0,2,686,0.034079000,0.0202
192.64.200.183:51581,<->,0.233.39.208:50515,2,316,0,0,2,316,0.018479000,0.9038
92.27.219.244:36529,<->,121.36.4.38:25351,2,104,0,0,2,104,0.009150000,1.8825
100.92.78.42:43611,<->,195.78.177.50:10925,1,52,0,0,1,52,1.999964000,0.0000
111.20.168.22:9649,<->,111.20.172.70:domain,1,149,0,0,1,149,1.999906000,0.0000
136.25.188.194:48597,<->,192.227.190.232:domain,1,106,0,0,1,106,1.999846000,0.0000
89.183.104.145:64598,<->,29.138.52.78:6881,1,159,0,0,1,159,1.999730000,0.0000
33.233.141.51:48777,<->,111.20.172.70:domain,1,96,0,0,1,96,1.999537000,0.0000
137.74.92.246:35057,<->,158.181.253.198:domain,1,102,0,0,1,102,1.999432000,0.0000
33.233.141.53:56725,<->,111.20.172.70:domain,1,101,0,0,1,101,1.999230000,0.0000
144.79.9.233:27017,<->,92.27.26.162:cvmmon,0,0,1,68,1,68,1.999196000,0.0000
101.224.89.132:63630,<->,111.20.172.70:domain,1,140,0,0,1,140,1.999024000,0.0000
88.1.228.33:31378,<->,92.27.219.49:31330,0,0,1,52,1,52,1.998769000,0.0000
33.233.141.83:47268,<->,111.20.172.70:domain,1,98,0,0,1,98,1.998081000,0.0000
144.75.218.242:39154,<->,8.222.218.199:domain,1,113,0,0,1,113,1.997974000,0.0000
104.227.159.53:52119,<->,20.194.26.211:domain,0,0,1,79,1,79,1.997579000,0.0000
101.224.89.225:56285,<->,111.20.172.70:domain,1,96,0,0,1,96,1.997448000,0.0000
144.75.218.242:12171,<->,8.222.218.199:domain,1,113,0,0,1,113,1.997082000,0.0000
33.233.141.53:52301,<->,111.20.172.70:domain,1,149,0,0,1,149,1.997018000,0.0000
125.5.189.55:49885,<->,192.64.196.68:41620,0,0,1,52,1,52,1.996398000,0.0000
198.117.132.52:61083,<->,101.224.184.81:27015,0,0,1,57,1,57,1.995879000,0.0000
101.224.89.158:10966,<->,111.20.172.70:domain,1,114,0,0,1,114,1.995480000,0.0000
144.75.218.233:acmsoda,<->,8.222.218.197:domain,1,113,0,0,1,113,1.995067000,0.0000
101.224.89.224:15134,<->,111.20.172.70:domain,1,145,0,0,1,145,1.994967000,0.0000
80.40.45.51:58815,<->,33.184.89.31:13441,1,149,0,0,1,149,1.994840000,0.0000
33.233.141.25:53150,<->,111.20.172.70:domain,1,146,0,0,1,146,1.994432000,0.0000
38.21.156.204:56633,<->,20.232.230.195:netbios-ns,0,0,1,82,1,82,1.994360000,0.0000
33.233.141.25:13999,<->,111.20.172.70:domain,1,116,0,0,1,116,1.994226000,0.0000
115.254.146.188:45653,<->,109.222.222.203:domain,0,0,1,74,1,74,1.994167000,0.0000
0.235.158.222:55148,<->,192.64.229.128:53877,0,0,1,50,1,50,1.994167000,0.0000
114.145.102.35:12206,<->,129.224.112.252:domain,0,0,1,80,1,80,1.994060000,0.0000
101.224.89.224:37077,<->,111.20.172.70:domain,1,100,0,0,1,100,1.993964000,0.0000
101.224.89.214:24707,<->,138.127.224.104:domain,1,283,0,0,1,283,1.993888000,0.0000
97.168.64.50:6881,<->,205.68.221.112:4893,1,135,0,0,1,135,1.993624000,0.0000
20.80.104.99:11427,<->,158.0.172.65:domain,1,76,0,0,1,76,1.993550000,0.0000
20.163.79.166:25735,<->,205.126.39.60:domain,1,72,0,0,1,72,1.993454000,0.0000
29.212.43.168:64241,<->,215.158.239.230:domain,0,0,1,90,1,90,1.993364000,0.0000
136.25.188.194:38734,<->,120.154.178.37:domain,1,135,0,0,1,135,1.993363000,0.0000
33.233.141.60:51801,<->,111.20.172.70:domain,1,150,0,0,1,150,1.993059000,0.0000
101.224.89.162:7422,<->,111.20.172.70:domain,1,148,0,0,1,148,1.992974000,0.0000
121.108.22.189:62312,<->,109.222.250.46:59037,0,0,1,52,1,52,1.992738000,0.0000
99.75.122.245:17339,<->,142.205.143.11:16880,1,134,0,0,1,134,1.992457000,0.0000
101.224.89.162:23447,<->,111.20.172.70:domain,1,95,0,0,1,95,1.992061000,0.0000
101.224.89.162:17751,<->,111.20.172.70:domain,1,145,0,0,1,145,1.992010000,0.0000
144.75.218.237:57080,<->,8.222.218.207:domain,1,109,0,0,1,109,1.991872000,0.0000
111.20.168.139:45694,<->,111.20.172.70:domain,1,99,0,0,1,99,1.991696000,0.0000
21.15.226.126:55104,<->,20.193.16.89:netbios-ns,0,0,1,82,1,82,1.991596000,0.0000
136.25.188.105:56594,<->,141.204.123.242:domain,1,166,0,0,1,166,1.991530000,0.0000
210.56.117.47:39221,<->,8.52.187.43:traceroute,0,0,1,52,1,52,1.991233000,0.0000
126.198.34.124:35996,<->,99.73.108.110:12849,0,0,1,330,1,330,1.990687000,0.0000
159.109.226.132:63630,<->,74.87.157.196:53321,1,62,0,0,1,62,1.990575000,0.0000
33.233.141.31:40770,<->,111.20.172.70:domain,1,140,0,0,1,140,1.990519000,0.0000
144.75.218.241:32129,<->,8.222.218.204:domain,1,122,0,0,1,122,1.990390000,0.0000
144.75.218.246:6540,<->,8.222.218.204:domain,1,122,0,0,1,122,1.990275000,0.0000
144.75.218.233:24352,<->,8.222.218.204:domain,1,123,0,0,1,123,1.990022000,0.0000
230.79.27.82:43125,<->,34.53.255.128:ddi-udp-4,0,0,1,52,1,52,1.989900000,0.0000
98.129.91.19:64806,<->,198.249.148.13:44933,1,135,0,0,1,135,1.989868000,0.0000
158.169.105.191:56064,<->,92.27.219.253:noteit,0,0,1,100,1,100,1.989846000,0.0000
33.233.141.31:27088,<->,111.20.172.70:domain,1,173,0,0,1,173,1.989722000,0.0000
144.75.218.237:54888,<->,120.155.84.97:domain,1,176,0,0,1,176,1.989714000,0.0000
101.224.89.162:14593,<->,111.20.172.70:domain,1,144,0,0,1,144,1.989621000,0.0000
144.75.218.241:4542,<->,120.155.84.97:domain,1,236,0,0,1,236,1.989590000,0.0000
120.83.119.197:6881,<->,89.183.104.255:fryeserv,0,0,1,326,1,326,1.989505000,0.0000
144.108.80.172:38787,<->,144.122.240.239:domain,0,0,1,65,1,65,1.989400000,0.0000
33.233.141.29:9792,<->,111.20.172.70:domain,1,144,0,0,1,144,1.989243000,0.0000
101.224.89.224:37212,<->,111.20.172.70:domain,1,209,0,0,1,209,1.989066000,0.0000
144.75.218.242:36067,<->,8.222.218.207:domain,1,111,0,0,1,111,1.988993000,0.0000
:::8587,<->,:::domain,1,113,0,0,1,113,1.988987000,0.0000
127.255.88.114:40297,<->,145.19.15.33:netbios-ns,0,0,1,82,1,82,1.988628000,0.0000
215.158.239.227:45738,<->,111.151.107.247:domain,1,225,0,0,1,225,1.988606000,0.0000
144.75.218.241:21189,<->,8.222.218.207:domain,1,122,0,0,1,122,1.988436000,0.0000
136.25.188.105:54337,<->,57.51.96.228:domain,1,115,0,0,1,115,1.988341000,0.0000
59.145.182.77:29911,<->,89.183.104.150:20329,0,0,1,52,1,52,1.988267000,0.0000
144.75.218.235:49576,<->,8.222.218.198:domain,1,122,0,0,1,122,1.988230000,0.0000
33.233.141.31:10464,<->,111.20.172.70:domain,1,114,0,0,1,114,1.988051000,0.0000
215.158.239.227:36225,<->,8.220.7.92:domain,1,165,0,0,1,165,1.987986000,0.0000
144.76.43.246:25084,<->,144.122.240.237:domain,0,0,1,75,1,75,1.987131000,0.0000
101.224.89.214:52753,<->,111.20.172.70:domain,1,109,0,0,1,109,1.986716000,0.0000
144.75.218.241:8825,<->,74.87.249.24:domain,1,84,0,0,1,84,1.986384000,0.0000
144.75.218.246:6780,<->,138.127.231.221:domain,1,310,0,0,1,310,1.985733000,0.0000
40.222.159.21:25359,<->,80.41.3.230:6881,0,0,1,138,1,138,1.985629000,0.0000
33.233.141.29:40030,<->,111.20.172.70:domain,1,149,0,0,1,149,1.985404000,0.0000
92.27.26.96:28016,<->,235.11.134.111:19766,1,57,0,0,1,57,1.985377000,0.0000
111.146.248.194:57997,<->,195.38.202.137:42875,1,135,0,0,1,135,1.985299000,0.0000
144.75.218.237:60896,<->,8.222.218.204:domain,1,113,0,0,1,113,1.985122000,0.0000
21.15.226.126:55104,<->,20.193.16.28:netbios-ns,0,0,1,82,1,82,1.984940000,0.0000
139.163.81.173:51413,<->,157.122.55.218:25054,1,130,0,0,1,130,1.984023000,0.0000
92.27.219.224:62348,<->,201.165.0.25:10921,1,62,0,0,1,62,1.983888000,0.0000
136.25.188.105:x11,<->,135.79.42.213:domain,1,421,0,0,1,421,1.983514000,0.0000
144.75.218.241:7636,<->,138.127.225.228:domain,1,365,0,0,1,365,1.983244000,0.0000
101.224.89.214:61879,<->,138.127.225.230:domain,1,234,0,0,1,234,1.982819000,0.0000
144.75.218.235:19759,<->,66.121.105.164:domain,1,272,0,0,1,272,1.982237000,0.0000
99.238.201.53:35144,<->,92.27.219.145:ipsec-nat-t,0,0,1,116,1,116,1.981744000,0.0000
136.25.188.37:49371,<->,60.110.124.16:domain,1,111,0,0,1,111,1.981113000,0.0000
33.233.141.31:34270,<->,111.20.172.70:domain,1,97,0,0,1,97,1.980867000,0.0000
111.20.168.156:5382,<->,111.20.172.70:domain,1,140,0,0,1,140,1.980797000,0.0000
141.97.30.94:55089,<->,109.222.212.23:14758,0,0,1,52,1,52,1.980761000,0.0000
33.233.141.86:40910,<->,111.20.172.70:domain,1,102,0,0,1,102,1.980684000,0.0000
144.75.218.246:5180,<->,138.127.224.194:domain,1,190,0,0,1,190,1.980636000,0.0000
0.200.50.50:34233,<->,20.13.111.183:domain,0,0,1,60,1,60,1.980305000,0.0000
95.245.93.205:34718,<->,34.198.150.184:ibm-pps,0,0,1,52,1,52,1.980141000,0.0000
149.178.48.81:14139,<->,129.224.112.252:domain,0,0,1,71,1,71,1.980069000,0.0000
144.75.218.237:60603,<->,8.222.218.207:domain,1,111,0,0,1,111,1.979909000,0.0000
111.20.168.139:34227,<->,111.20.172.70:domain,1,112,0,0,1,112,1.979809000,0.0000
33.233.141.86:60407,<->,111.20.172.70:domain,1,140,0,0,1,140,1.979284000,0.0000
144.75.218.237:16689,<->,138.127.225.96:domain,1,289,0,0,1,289,1.979163000,0.0000
246.253.253.79:54343,<->,129.245.206.220:domain,1,736,0,0,1,736,1.979128000,0.0000
111.20.168.139:35005,<->,111.20.172.70:domain,1,98,0,0,1,98,1.979067000,0.0000
136.25.188.105:64229,<->,132.43.156.81:domain,1,251,0,0,1,251,1.978852000,0.0000
111.20.168.156:60470,<->,111.20.172.70:domain,1,147,0,0,1,147,1.978771000,0.0000
89.183.104.236:61029,<->,0.66.204.156:27377,1,147,0,0,1,147,1.978695000,0.0000
101.224.89.170:50961,<->,138.127.225.201:domain,1,245,0,0,1,245,1.978612000,0.0000
0.200.50.50:34233,<->,20.13.111.176:domain,0,0,1,60,1,60,1.978557000,0.0000
72.52.29.6:62181,<->,92.27.27.185:6881,0,0,1,718,1,718,1.977764000,0.0000
20.91.67.234:51491,<->,131.142.1.12:domain,1,74,0,0,1,74,1.977667000,0.0000
144.75.218.246:33034,<->,8.222.218.197:domain,1,111,0,0,1,111,1.977661000,0.0000
33.233.141.115:43545,<->,138.127.224.225:domain,1,234,0,0,1,234,1.977365000,0.0000
144.75.218.237:41132,<->,8.222.218.198:domain,1,110,0,0,1,110,1.977355000,0.0000
144.75.218.241:44373,<->,8.222.218.204:domain,1,121,0,0,1,121,1.977192000,0.0000
111.20.168.139:12491,<->,111.20.172.70:domain,1,161,0,0,1,161,1.976571000,0.0000
144.111.184.84:13323,<->,132.249.70.233:domain,0,0,1,76,1,76,1.976255000,0.0000
100.95.213.81:44262,<->,207.1.56.190:31269,1,59,0,0,1,59,1.975908000,0.0000
126.210.233.248:51900,<->,100.93.87.235:48573,0,0,1,136,1,136,1.975417000,0.0000
39.128.209.5:crip,<->,156.31.152.157:domain,1,80,0,0,1,80,1.975142000,0.0000
89.139.241.98:62771,<->,129.19.157.66:domain,1,130,0,0,1,130,1.974969000,0.0000
92.162.219.75:46869,<->,129.224.112.252:domain,0,0,1,92,1,92,1.974920000,0.0000
194.207.33.51:med-supp,<->,100.94.11.80:17616,0,0,1,62,1,62,1.974873000,0.0000
21.15.226.126:55104,<->,20.193.16.194:netbios-ns,0,0,1,82,1,82,1.974183000,0.0000
40.212.154.182:63569,<->,192.67.141.167:33794,0,0,1,52,1,52,1.974043000,0.0000
144.75.218.242:41643,<->,140.138.71.29:domain,1,73,0,0,1,73,1.973822000,0.0000
144.75.218.241:61313,<->,8.222.218.207:domain,1,155,0,0,1,155,1.973503000,0.0000
144.75.218.242:11684,<->,138.127.225.176:domain,1,264,0,0,1,264,1.972662000,0.0000
144.75.218.241:46245,<->,143.46.2.230:domain,1,122,0,0,1,122,1.972216000,0.0000
144.75.218.241:61047,<->,120.155.84.97:domain,1,143,0,0,1,143,1.971849000,0.0000
33.233.141.115:61712,<->,138.127.224.225:domain,1,242,0,0,1,242,1.971311000,0.0000
205.37.16.248:41462,<->,100.95.97.95:1024,0,0,1,321,1,321,1.971307000,0.0000
127.186.169.193:23928,<->,92.27.219.235:apollo-relay,0,0,1,351,1,351,1.971094000,0.0000
33.233.141.115:42420,<->,138.127.224.225:domain,1,249,0,0,1,249,1.970842000,0.0000
136.25.188.105:55427,<->,135.88.171.34:domain,1,205,0,0,1,205,1.970673000,0.0000
144.75.218.237:48651,<->,8.222.218.207:domain,1,111,0,0,1,111,1.970272000,0.0000
132.149.113.27:6881,<->,132.168.178.101:danf-ak2,1,69,0,0,1,69,1.969701000,0.0000
144.75.218.242:64903,<->,8.222.218.199:domain,1,110,0,0,1,110,1.969582000,0.0000
220.55.66.44:38641,<->,126.198.120.245:domain,1,196,0,0,1,196,1.969182000,0.0000
230.83.114.145:21686,<->,138.73.32.96:6881,0,0,1,133,1,133,1.968307000,0.0000
144.75.218.241:6816,<->,138.127.225.148:domain,1,366,0,0,1,366,1.968269000,0.0000
57.140.246.54:39150,<->,220.55.123.209:domain,0,0,1,76,1,76,1.967341000,0.0000
21.15.226.126:55104,<->,20.193.16.198:netbios-ns,0,0,1,82,1,82,1.966515000,0.0000
6.228.19.248:proshare2,<->,57.211.43.70:domain,1,76,0,0,1,76,1.966258000,0.0000
144.75.218.242:54848,<->,8.222.218.199:domain,1,121,0,0,1,121,1.966008000,0.0000
144.75.218.237:25275,<->,8.222.218.207:domain,1,123,0,0,1,123,1.965520000,0.0000
144.108.80.172:46157,<->,144.122.240.219:domain,0,0,1,67,1,67,1.963831000,0.0000
20.28.40.159:60762,<->,134.240.115.66:domain,1,75,0,0,1,75,1.963709000,0.0000
144.75.218.235:58610,<->,8.222.218.198:domain,1,122,0,0,1,122,1.963700000,0.0000
144.75.218.237:19627,<->,120.155.84.97:domain,1,176,0,0,1,176,1.963598000,0.0000
144.75.218.242:18916,<->,138.127.231.3:domain,1,291,0,0,1,291,1.962781000,0.0000
136.109.250.194:31259,<->,97.126.11.149:domain,0,0,1,67,1,67,1.962264000,0.0000
220.55.110.129:asap-udp,<->,129.213.110.99:domain,1,481,0,0,1,481,1.962226000,0.0000
:::41883,<->,:::domain,1,141,0,0,1,141,1.962077000,0.0000
92.18.109.207:55367,<->,192.67.154.172:50995,0,0,1,52,1,52,1.962022000,0.0000
144.75.218.241:41719,<->,8.222.218.204:domain,1,123,0,0,1,123,1.961952000,0.0000
144.75.218.242:53673,<->,138.127.231.3:domain,1,294,0,0,1,294,1.961851000,0.0000
21.15.226.126:55104,<->,20.193.16.200:netbios-ns,0,0,1,82,1,82,1.961534000,0.0000
144.75.218.242:8874,<->,8.222.218.207:domain,1,122,0,0,1,122,1.961232000,0.0000
105.186.185.140:57601,<->,80.41.16.79:6881,0,0,1,149,1,149,1.961164000,0.0000
80.42.136.213:25324,<->,66.63.73.20:15577,1,133,0,0,1,133,1.961083000,0.0000
105.163.85.135:18976,<->,192.64.229.25:14743,0,0,1,52,1,52,1.960456000,0.0000
144.75.218.242:13795,<->,8.222.218.199:domain,1,123,0,0,1,123,1.960008000,0.0000
33.183.115.16:18480,<->,20.130.12.194:9683,0,0,1,74,1,74,1.959705000,0.0000
98.128.56.197:35971,<->,193.24.163.34:10865,1,104,0,0,1,104,1.959398000,0.0000
:::30551,<->,:::domain,1,156,0,0,1,156,1.958410000,0.0000
136.25.188.105:50715,<->,135.79.32.181:domain,1,421,0,0,1,421,1.957477000,0.0000
144.75.218.233:28812,<->,8.222.218.196:domain,1,122,0,0,1,122,1.957292000,0.0000
113.189.202.235:50368,<->,129.224.112.252:domain,0,0,1,72,1,72,1.957225000,0.0000
144.75.218.237:30684,<->,138.127.230.2:domain,1,201,0,0,1,201,1.957082000,0.0000
39.53.18.121:8425,<->,109.222.242.1:domain,0,0,1,79,1,79,1.956526000,0.0000
122.218.155.118:7090,<->,97.126.114.255:domain,0,0,1,76,1,76,1.955992000,0.0000
89.183.104.146:20396,<->,120.83.106.204:6881,1,326,0,0,1,326,1.955553000,0.0000
144.75.218.237:23808,<->,8.222.218.198:domain,1,181,0,0,1,181,1.955411000,0.0000
20.207.7.39:27874,<->,123.87.182.27:domain,1,179,0,0,1,179,1.955322000,0.0000
42.124.209.56:alaris-disc,<->,92.26.158.146:snmp,0,0,1,85,1,85,1.955265000,0.0000
144.75.218.237:51488,<->,8.222.218.207:domain,1,109,0,0,1,109,1.955045000,0.0000
144.75.218.242:47410,<->,8.222.218.204:domain,1,113,0,0,1,113,1.954846000,0.0000
113.23.56.27:56895,<->,133.178.226.254:domain,0,0,1,90,1,90,1.954727000,0.0000
144.87.235.187:47252,<->,29.211.97.161:domain,1,142,0,0,1,142,1.954462000,0.0000
115.223.138.39:6928,<->,8.228.211.21:domain,0,0,1,79,1,79,1.953588000,0.0000
99.75.237.141:36062,<->,195.123.228.195:23394,1,133,0,0,1,133,1.953564000,0.0000
144.75.218.237:30667,<->,138.127.230.88:domain,1,284,0,0,1,284,1.953432000,0.0000
20.206.136.250:43822,<->,113.189.252.246:domain,1,68,0,0,1,68,1.952291000,0.0000
92.27.219.203:44062,<->,113.196.116.177:22197,1,52,0,0,1,52,1.951809000,0.0000
215.158.238.200:35050,<->,131.141.218.123:domain,1,163,0,0,1,163,1.951764000,0.0000
99.72.214.85:57972,<->,139.114.178.206:domain,1,119,0,0,1,119,1.951495000,0.0000
144.75.218.242:18307,<->,8.222.218.204:domain,1,239,0,0,1,239,1.951419000,0.0000
144.108.64.185:30347,<->,159.69.187.30:domain,0,0,1,59,1,59,1.951248000,0.0000
77.49.20.48:44822,<->,92.27.219.55:43340,0,0,1,62,1,62,1.950939000,0.0000
80.42.185.67:18436,<->,88.159.240.183:13505,1,52,0,0,1,52,1.950832000,0.0000
215.158.6.245:57652,<->,215.158.238.19:domain,0,0,1,85,1,85,1.950657000,0.0000
109.222.208.215:udt-os,<->,80.248.212.137:udt-os,1,84,0,0,1,84,1.949971000,0.0000
144.75.218.241:13445,<->,8.222.218.204:domain,1,111,0,0,1,111,1.949127000,0.0000
144.76.43.245:50958,<->,80.56.78.128:domain,0,0,1,104,1,104,1.949095000,0.0000
144.75.218.242:22593,<->,8.222.218.199:domain,1,110,0,0,1,110,1.949061000,0.0000
144.75.218.242:5831,<->,8.222.218.207:domain,1,123,0,0,1,123,1.948995000,0.0000
193.47.198.128:60875,<->,8.43.212.44:bacnet,0,0,1,67,1,67,1.948804000,0.0000
144.75.218.235:21458,<->,138.127.225.75:domain,1,67,0,0,1,67,1.948217000,0.0000
:::43681,<->,:::domain,1,153,0,0,1,153,1.948096000,0.0000
110.56.89.242:14323,<->,97.126.114.17:domain,0,0,1,78,1,78,1.947797000,0.0000
236.215.193.223:36243,<->,144.122.240.200:domain,0,0,1,70,1,70,1.947488000,0.0000
144.75.218.233:45790,<->,8.222.218.197:domain,1,237,0,0,1,237,1.947373000,0.0000
92.27.219.230:57046,<->,57.224.189.60:12243,1,325,0,0,1,325,1.947046000,0.0000
:::8581,<->,:::domain,1,227,0,0,1,227,1.946963000,0.0000
20.181.202.148:35076,<->,207.51.144.63:domain,1,75,0,0,1,75,1.946721000,0.0000
144.75.218.246:8771,<->,8.222.218.204:domain,1,151,0,0,1,151,1.946405000,0.0000
143.252.64.230:22875,<->,129.224.112.252:domain,0,0,1,65,1,65,1.946111000,0.0000
92.27.219.246:57924,<->,118.50.28.33:6881,1,272,0,0,1,272,1.946073000,0.0000
8.182.121.229:39139,<->,80.56.78.128:domain,0,0,1,85,1,85,1.946029000,0.0000
21.15.226.126:55104,<->,20.193.17.216:netbios-ns,0,0,1,82,1,82,1.945851000,0.0000
21.15.226.126:55104,<->,20.193.17.255:netbios-ns,0,0,1,82,1,82,1.945589000,0.0000
29.212.43.168:64092,<->,215.158.239.236:domain,0,0,1,90,1,90,1.945176000,0.0000
39.201.89.227:62902,<->,195.67.244.88:domain,1,50,0,0,1,50,1.944990000,0.0000
137.129.27.57:46464,<->,100.50.97.15:stun,1,98,0,0,1,98,1.944453000,0.0000
54.69.5.103:11249,<->,50.224.78.60:domain,0,0,1,69,1,69,1.944300000,0.0000
133.178.226.245:50899,<->,141.204.127.17:domain,1,719,0,0,1,719,1.944005000,0.0000
92.162.219.30:34410,<->,129.224.112.252:domain,0,0,1,98,1,98,1.943788000,0.0000
92.27.27.172:54527,<->,207.212.194.186:21709,1,263,0,0,1,263,1.943283000,0.0000
144.75.218.246:39085,<->,8.222.218.204:domain,1,122,0,0,1,122,1.942223000,0.0000
215.158.140.136:64348,<->,128.194.246.148:domain,1,105,0,0,1,105,1.941892000,0.0000
92.27.219.234:46627,<->,33.240.42.133:42058,1,309,0,0,1,309,1.941559000,0.0000
144.75.218.246:61858,<->,8.222.218.199:domain,1,114,0,0,1,114,1.941543000,0.0000
144.75.218.242:13459,<->,8.222.218.199:domain,1,113,0,0,1,113,1.940699000,0.0000
136.25.188.105:55114,<->,135.88.171.34:domain,1,233,0,0,1,233,1.940119000,0.0000
144.75.218.237:6827,<->,132.208.73.30:domain,1,186,0,0,1,186,1.939974000,0.0000
144.75.218.237:12605,<->,8.222.218.198:domain,1,111,0,0,1,111,1.939813000,0.0000
20.44.169.38:50303,<->,148.255.158.118:domain,1,76,0,0,1,76,1.939779000,0.0000
20.5.20.49:32664,<->,207.63.12.95:domain,1,68,0,0,1,68,1.939779000,0.0000
50.221.176.241:45931,<->,97.168.94.127:domain,0,0,1,69,1,69,1.939066000,0.0000
215.158.103.206:58649,<->,129.211.22.194:domain,1,795,0,0,1,795,1.938888000,0.0000
136.25.188.105:58703,<->,132.43.156.54:domain,1,163,0,0,1,163,1.938819000,0.0000
20.115.121.156:36809,<->,42.229.229.53:21051,1,68,0,0,1,68,1.938309000,0.0000
20.127.247.237:56868,<->,6.147.69.18:domain,1,66,0,0,1,66,1.938306000,0.0000
27.188.163.162:i-net-2000-npr,<->,109.1.16.1:sip,0,0,1,444,1,444,1.938281000,0.0000
144.75.218.246:38982,<->,8.222.218.204:domain,1,111,0,0,1,111,1.938110000,0.0000
98.219.117.118:34211,<->,145.252.112.192:domain,0,0,1,80,1,80,1.937770000,0.0000
144.75.218.246:22807,<->,98.101.89.6:domain,1,809,0,0,1,809,1.937693000,0.0000
53.200.255.58:11984,<->,50.224.78.62:domain,0,0,1,68,1,68,1.937618000,0.0000
99.75.123.162:13927,<->,144.76.46.38:domain,1,50,0,0,1,50,1.937437000,0.0000
98.166.239.40:57904,<->,215.158.238.161:domain,0,0,1,85,1,85,1.937382000,0.0000
21.15.226.126:55104,<->,20.193.17.238:netbios-ns,0,0,1,82,1,82,1.936222000,0.0000
144.75.218.242:53567,<->,8.222.218.207:domain,1,113,0,0,1,113,1.936032000,0.0000
20.129.242.221:25114,<->,33.200.157.19:domain,1,74,0,0,1,74,1.935762000,0.0000
33.245.20.181:58076,<->,89.183.104.150:30335,0,0,1,52,1,52,1.935357000,0.0000
80.40.15.111:64008,<->,255.57.239.26:ntp,1,80,0,0,1,80,1.935208000,0.0000
144.75.218.235:13851,<->,138.127.230.221:domain,1,84,0,0,1,84,1.935124000,0.0000
220.55.101.98:63250,<->,132.43.156.54:domain,1,137,0,0,1,137,1.934963000,0.0000
80.38.6.51:8275,<->,132.43.156.54:domain,1,799,0,0,1,799,1.934818000,0.0000
8.40.50.223:56045,<->,215.158.238.78:domain,0,0,1,85,1,85,1.933729000,0.0000
215.158.103.219:36655,<->,192.171.13.190:domain,1,98,0,0,1,98,1.933641000,0.0000
144.75.218.242:11853,<->,8.222.218.199:domain,1,110,0,0,1,110,1.933309000,0.0000
144.75.218.242:30735,<->,8.222.218.196:domain,1,122,0,0,1,122,1.933243000,0.0000
144.75.218.241:24887,<->,8.222.218.207:domain,1,111,0,0,1,111,1.932882000,0.0000
127.89.8.26:60672,<->,80.40.41.27:58617,0,0,1,84,1,84,1.932543000,0.0000
144.75.218.233:32135,<->,8.222.218.204:domain,1,110,0,0,1,110,1.932314000,0.0000
144.75.218.246:50215,<->,8.222.218.204:domain,1,111,0,0,1,111,1.932307000,0.0000
80.42.177.152:31588,<->,38.136.68.19:22594,1,135,0,0,1,135,1.932277000,0.0000
227.23.98.246:40016,<->,89.183.104.128:31099,0,0,1,53,1,53,1.932253000,0.0000
0.200.50.50:34233,<->,20.13.111.98:domain,0,0,1,60,1,60,1.932075000,0.0000
144.76.43.245:57716,<->,80.56.78.128:domain,0,0,1,107,1,107,1.931512000,0.0000
144.75.218.233:59708,<->,8.222.218.204:domain,1,113,0,0,1,113,1.931501000,0.0000
215.158.210.70:59432,<->,29.211.214.82:domain,0,0,1,96,1,96,1.931491000,0.0000
136.25.188.105:20496,<->,144.69.194.50:domain,1,283,0,0,1,283,1.930792000,0.0000
129.176.84.9:39015,<->,132.249.70.233:domain,0,0,1,86,1,86,1.930485000,0.0000
137.129.67.59:54228,<->,92.27.219.59:44373,0,0,1,52,1,52,1.930278000,0.0000
144.75.218.235:33058,<->,138.127.231.59:domain,1,365,0,0,1,365,1.930148000,0.0000
144.75.218.235:17031,<->,8.222.218.198:domain,1,238,0,0,1,238,1.930019000,0.0000
67.236.244.154:27886,<->,159.31.217.35:8193,0,0,1,52,1,52,1.930015000,0.0000
136.25.188.105:49711,<->,240.105.0.6:domain,1,183,0,0,1,183,1.929630000,0.0000
144.75.218.237:38455,<->,8.222.218.197:domain,1,111,0,0,1,111,1.928966000,0.0000
125.23.146.88:6924,<->,109.222.203.52:domain,0,0,1,78,1,78,1.928577000,0.0000
21.15.226.126:55104,<->,20.193.17.240:netbios-ns,0,0,1,82,1,82,1.928194000,0.0000
144.75.218.246:19343,<->,8.222.218.199:domain,1,119,0,0,1,119,1.927699000,0.0000
144.75.218.237:42073,<->,138.127.225.165:domain,1,254,0,0,1,254,1.927097000,0.0000
144.75.218.241:59383,<->,8.222.218.196:domain,1,120,0,0,1,120,1.926903000,0.0000
144.75.218.241:37852,<->,138.127.225.234:domain,1,254,0,0,1,254,1.926843000,0.0000
144.75.218.242:35195,<->,8.222.218.207:domain,1,113,0,0,1,113,1.926586000,0.0000
109.81.202.64:33596,<->,141.204.123.255:domain,1,206,0,0,1,206,1.926266000,0.0000
144.75.218.233:9111,<->,138.127.225.215:domain,1,347,0,0,1,347,1.925976000,0.0000
60.100.161.172:obrpd,<->,129.224.112.252:domain,0,0,1,63,1,63,1.925705000,0.0000
97.126.26.70:21415,<->,138.127.225.149:domain,1,246,0,0,1,246,1.925524000,0.0000
136.25.188.105:49245,<->,143.46.12.204:domain,1,151,0,0,1,151,1.925060000,0.0000
102.39.105.242:18973,<->,50.224.76.131:domain,0,0,1,79,1,79,1.924698000,0.0000
144.93.125.48:63813,<->,144.93.121.86:28959,0,0,1,104,1,104,1.924507000,0.0000
101.106.122.69:38186,<->,89.183.104.168:23819,0,0,1,133,1,133,1.924178000,0.0000
144.75.218.241:54158,<->,120.155.84.97:domain,1,150,0,0,1,150,1.923690000,0.0000
50.224.110.86:sql-net,<->,104.155.75.255:domain,1,74,0,0,1,74,1.923177000,0.0000
74.235.94.149:22428,<->,108.39.57.255:opendeploy,0,0,1,67,1,67,1.922865000,0.0000
201.222.190.205:32832,<->,80.41.58.237:blackjack,0,0,1,135,1,135,1.922464000,0.0000
4.130.13.37:55726,<->,92.27.219.169:37455,0,0,1,240,1,240,1.922066000,0.0000
139.248.201.139:ntp,<->,137.69.107.44:ntp,1,80,0,0,1,80,1.920596000,0.0000
21.15.226.126:55104,<->,20.193.17.105:netbios-ns,0,0,1,82,1,82,1.920499000,0.0000
144.75.218.246:35499,<->,8.47.122.178:domain,1,99,0,0,1,99,1.919295000,0.0000
92.27.219.156:60442,<->,109.110.163.92:60335,1,84,0,0,1,84,1.918588000,0.0000
125.43.71.208:17491,<->,192.64.217.166:1024,0,0,1,52,1,52,1.916968000,0.0000
144.75.218.242:39571,<->,8.222.218.207:domain,1,111,0,0,1,111,1.916959000,0.0000
20.203.160.189:30583,<->,103.61.69.140:domain,1,70,0,0,1,70,1.916907000,0.0000
192.67.140.220:34779,<->,221.196.95.22:28830,1,319,0,0,1,319,1.916703000,0.0000
144.75.218.237:14661,<->,8.222.218.198:domain,1,122,0,0,1,122,1.915897000,0.0000
144.75.218.241:61087,<->,8.222.218.204:domain,1,113,0,0,1,113,1.915299000,0.0000
144.75.218.246:44471,<->,8.222.218.204:domain,1,153,0,0,1,153,1.915245000,0.0000
89.183.104.189:allpeers,<->,104.155.120.1:6881,1,319,0,0,1,319,1.915018000,0.0000
144.75.218.237:40503,<->,8.222.218.204:domain,1,111,0,0,1,111,1.914416000,0.0000
144.75.218.235:21731,<->,138.127.224.104:domain,1,313,0,0,1,313,1.914270000,0.0000
144.75.218.235:lv-frontpanel,<->,138.127.230.211:domain,1,254,0,0,1,254,1.914250000,0.0000
252.113.218.41:13137,<->,50.224.93.122:domain,0,0,1,82,1,82,1.913730000,0.0000
144.75.218.242:27809,<->,8.222.218.199:domain,1,122,0,0,1,122,1.913408000,0.0000
192.64.229.213:ipsec-nat-t,<->,159.230.56.202:ipsec-nat-t,1,128,0,0,1,128,1.912155000,0.0000
108.134.127.192:10396,<->,148.198.183.187:domain,1,81,0,0,1,81,1.911712000,0.0000
33.248.124.218:62003,<->,97.126.45.209:44099,0,0,1,62,1,62,1.911689000,0.0000
42.41.254.51:41473,<->,92.27.219.38:28828,0,0,1,103,1,103,1.910702000,0.0000
112.170.71.176:63766,<->,20.192.37.227:52797,0,0,1,84,1,84,1.910539000,0.0000
109.222.200.25:15804,<->,127.89.237.106:12214,1,77,0,0,1,77,1.909923000,0.0000
144.75.218.233:busycal,<->,8.222.218.204:domain,1,127,0,0,1,127,1.909626000,0.0000
20.185.195.160:34860,<->,197.235.132.138:domain,1,78,0,0,1,78,1.908803000,0.0000
75.101.83.45:38889,<->,111.147.146.107:domain,0,0,1,69,1,69,1.908682000,0.0000
144.75.218.237:9470,<->,120.155.84.97:domain,1,125,0,0,1,125,1.908265000,0.0000
144.75.218.242:10317,<->,8.222.218.199:domain,1,122,0,0,1,122,1.908087000,0.0000
20.87.86.90:48569,<->,143.43.204.18:domain,1,68,0,0,1,68,1.907965000,0.0000
114.145.122.218:34087,<->,129.224.112.252:domain,0,0,1,80,1,80,1.907908000,0.0000
:::6426,<->,:::domain,0,0,1,96,1,96,1.907298000,0.0000
155.216.61.93:7198,<->,108.39.160.74:6881,0,0,1,130,1,130,1.907152000,0.0000
144.75.218.242:6132,<->,8.222.218.207:domain,1,110,0,0,1,110,1.906689000,0.0000
131.144.248.28:30945,<->,133.54.22.156:domain,0,0,1,84,1,84,1.906517000,0.0000
144.76.43.246:22069,<->,80.56.78.128:domain,0,0,1,106,1,106,1.906472000,0.0000
144.75.218.233:51580,<->,8.222.218.197:domain,1,121,0,0,1,121,1.906325000,0.0000
34.108.191.93:5951,<->,153.186.217.198:domain,1,72,0,0,1,72,1.906222000,0.0000
144.75.218.242:56023,<->,8.222.218.199:domain,1,123,0,0,1,123,1.905950000,0.0000
101.38.148.96:5078,<->,97.168.94.127:domain,0,0,1,75,1,75,1.905565000,0.0000
192.227.190.250:59594,<->,215.158.239.233:domain,0,0,1,90,1,90,1.905470000,0.0000
33.215.4.219:53750,<->,92.27.26.248:27017,0,0,1,57,1,57,1.905295000,0.0000
114.19.240.76:46861,<->,98.67.159.10:domain,0,0,1,68,1,68,1.905213000,0.0000
86.13.37.241:36343,<->,109.222.255.55:domain,0,0,1,69,1,69,1.905027000,0.0000
192.227.190.250:47280,<->,80.56.78.208:domain,0,0,1,86,1,86,1.904395000,0.0000
137.179.251.23:13596,<->,144.122.240.242:domain,0,0,1,71,1,71,1.903957000,0.0000
144.75.218.233:27431,<->,8.222.218.197:domain,1,110,0,0,1,110,1.903704000,0.0000
144.75.218.241:51087,<->,65.95.70.36:domain,1,140,0,0,1,140,1.903543000,0.0000
139.34.132.118:44127,<->,136.25.188.72:12347,0,0,1,1064,1,1064,1.903301000,0.0000
247.136.210.161:32066,<->,105.221.82.56:6881,1,319,0,0,1,319,1.903050000,0.0000
144.75.218.233:62968,<->,8.222.218.204:domain,1,239,0,0,1,239,1.903021000,0.0000
215.158.103.219:25269,<->,53.227.188.6:domain,1,253,0,0,1,253,1.902425000,0.0000
192.64.196.68:41620,<->,134.106.251.179:28025,1,52,0,0,1,52,1.902401000,0.0000
92.27.219.241:43265,<->,106.1.36.29:31243,1,135,0,0,1,135,1.902379000,0.0000
6.88.34.156:34848,<->,109.222.251.33:domain,0,0,1,77,1,77,1.902278000,0.0000
136.25.188.105:54935,<->,129.70.124.49:domain,1,137,0,0,1,137,1.901996000,0.0000
80.40.31.154:29740,<->,102.173.125.0:swa-3,1,133,0,0,1,133,1.901769000,0.0000
92.27.219.128:45952,<->,140.151.225.93:35716,1,52,0,0,1,52,1.901728000,0.0000
92.162.252.12:58681,<->,97.110.148.14:domain,1,139,0,0,1,139,1.901598000,0.0000
144.75.218.235:26598,<->,138.127.225.194:domain,1,237,0,0,1,237,1.901071000,0.0000
56.121.35.77:8775,<->,109.113.44.63:domain,1,224,0,0,1,224,1.900830000,0.0000
106.209.161.210:51413,<->,89.183.104.129:11011,0,0,1,52,1,52,1.900107000,0.0000
39.162.179.136:52142,<->,42.31.109.52:domain,1,70,0,0,1,70,1.899996000,0.0000
100.92.66.100:52606,<->,149.170.128.135:25684,1,130,0,0,1,130,1.899931000,0.0000
20.66.117.235:10536,<->,158.229.167.186:domain,1,74,0,0,1,74,1.899840000,0.0000
125.200.151.86:60922,<->,80.40.50.197:56491,0,0,1,52,1,52,1.899575000,0.0000
97.126.26.71:25567,<->,56.90.112.160:domain,1,256,0,0,1,256,1.898794000,0.0000
132.168.198.110:32336,<->,38.98.95.10:10249,1,135,0,0,1,135,1.898570000,0.0000
133.178.226.245:61701,<->,8.181.148.225:domain,1,111,0,0,1,111,1.898299000,0.0000
144.75.218.242:18160,<->,100.185.121.91:domain,1,87,0,0,1,87,1.898250000,0.0000
92.27.219.131:53242,<->,82.180.168.184:51413,1,62,0,0,1,62,1.898217000,0.0000
136.25.189.63:65265,<->,145.116.223.84:domain,1,104,0,0,1,104,1.898200000,0.0000
215.158.103.219:31622,<->,129.203.66.31:domain,1,629,0,0,1,629,1.898073000,0.0000
100.94.204.235:31084,<->,33.241.241.76:14310,1,70,0,0,1,70,1.897393000,0.0000
136.25.188.105:56203,<->,131.153.125.208:domain,1,191,0,0,1,191,1.897093000,0.0000
144.75.218.242:23370,<->,89.155.210.245:domain,1,99,0,0,1,99,1.896718000,0.0000
144.75.218.235:27594,<->,8.222.218.198:domain,1,110,0,0,1,110,1.896495000,0.0000
139.69.162.227:55890,<->,29.211.214.82:domain,0,0,1,96,1,96,1.896285000,0.0000
143.73.162.176:5800,<->,144.64.137.156:domain,0,0,1,73,1,73,1.896022000,0.0000
144.75.218.246:33513,<->,138.127.224.167:domain,1,242,0,0,1,242,1.894894000,0.0000
144.75.218.241:32357,<->,8.222.218.207:domain,1,111,0,0,1,111,1.894890000,0.0000
40.208.235.139:33482,<->,92.27.219.147:26173,0,0,1,256,1,256,1.894864000,0.0000
98.150.107.161:35667,<->,97.190.215.3:33438,0,0,1,50,1,50,1.894685000,0.0000
113.171.246.29:29103,<->,144.93.121.10:23943,0,0,1,104,1,104,1.894426000,0.0000
97.126.26.71:34665,<->,56.90.112.160:domain,1,124,0,0,1,124,1.894396000,0.0000
215.158.140.136:38577,<->,128.194.246.149:domain,1,134,0,0,1,134,1.894249000,0.0000
144.75.218.237:53041,<->,8.222.218.204:domain,1,110,0,0,1,110,1.893625000,0.0000
192.227.190.250:64702,<->,80.56.78.208:domain,0,0,1,86,1,86,1.893608000,0.0000
144.75.218.242:35434,<->,8.222.218.207:domain,1,122,0,0,1,122,1.893598000,0.0000
109.222.250.145:43739,<->,221.196.91.231:30892,1,136,0,0,1,136,1.892550000,0.0000
29.143.252.140:57777,<->,92.27.219.217:15030,0,0,1,62,1,62,1.891545000,0.0000
20.194.30.147:33361,<->,216.132.55.74:21821,1,52,0,0,1,52,1.890881000,0.0000
144.75.218.235:32365,<->,8.222.218.197:domain,1,109,0,0,1,109,1.890591000,0.0000
114.186.133.50:27127,<->,129.224.112.252:domain,0,0,1,74,1,74,1.890202000,0.0000
:::59270,<->,:::domain,1,102,0,0,1,102,1.890029000,0.0000
92.162.219.203:53952,<->,129.224.112.252:domain,0,0,1,73,1,73,1.888802000,0.0000
80.41.32.162:29495,<->,198.180.211.96:24385,1,138,0,0,1,138,1.888492000,0.0000
144.75.218.241:39989,<->,8.222.218.207:domain,1,122,0,0,1,122,1.888212000,0.0000
136.25.189.210:64705,<->,8.57.163.164:domain,1,111,0,0,1,111,1.888179000,0.0000
144.75.218.246:10818,<->,8.222.218.204:domain,1,125,0,0,1,125,1.888128000,0.0000
136.25.188.105:54985,<->,132.43.156.81:domain,1,249,0,0,1,249,1.888025000,0.0000
192.229.40.70:49623,<->,136.25.188.59:domain,0,0,1,85,1,85,1.887892000,0.0000
80.56.91.244:65436,<->,133.178.227.210:confluent,0,0,1,1112,1,1112,1.887783000,0.0000
80.40.60.88:61226,<->,250.50.35.185:6881,1,74,0,0,1,74,1.887574000,0.0000
144.75.218.241:18493,<->,120.155.84.97:domain,1,150,0,0,1,150,1.887363000,0.0000
136.25.188.105:50710,<->,128.243.151.35:domain,1,506,0,0,1,506,1.886989000,0.0000
8.191.9.38:52240,<->,215.158.140.111:12347,0,0,1,1064,1,1064,1.886956000,0.0000
144.75.218.246:9361,<->,8.222.218.204:domain,1,125,0,0,1,125,1.886841000,0.0000
144.75.218.241:20053,<->,8.222.218.207:domain,1,110,0,0,1,110,1.886536000,0.0000
144.75.218.241:22700,<->,120.155.84.97:domain,1,145,0,0,1,145,1.886143000,0.0000
144.75.218.242:4794,<->,139.252.1.225:domain,1,159,0,0,1,159,1.885943000,0.0000
60.89.248.196:48251,<->,109.222.246.3:domain,0,0,1,73,1,73,1.885673000,0.0000
144.75.218.242:12813,<->,138.127.231.222:domain,1,267,0,0,1,267,1.885562000,0.0000
101.224.191.89:28016,<->,235.11.134.111:19766,1,57,0,0,1,57,1.883976000,0.0000
39.15.233.100:38767,<->,0.54.22.103:domain,1,86,0,0,1,86,1.883612000,0.0000
143.252.64.234:34054,<->,129.224.112.252:domain,0,0,1,68,1,68,1.883527000,0.0000
144.75.218.237:11938,<->,8.222.218.197:domain,1,113,0,0,1,113,1.883276000,0.0000
20.176.121.25:39717,<->,99.215.7.61:domain,1,76,0,0,1,76,1.882764000,0.0000
75.214.216.116:33328,<->,247.136.143.204:16431,0,0,1,52,1,52,1.882462000,0.0000
92.27.27.165:16763,<->,78.49.192.10:talnet,1,52,0,0,1,52,1.882132000,0.0000
199.25.163.226:64732,<->,159.137.226.12:domain,0,0,1,79,1,79,1.882064000,0.0000
144.75.218.242:10593,<->,8.222.218.196:domain,1,125,0,0,1,125,1.882020000,0.0000
144.75.218.246:61399,<->,53.160.253.194:domain,1,126,0,0,1,126,1.881265000,0.0000
144.75.218.241:48644,<->,138.127.225.113:domain,1,366,0,0,1,366,1.880831000,0.0000
78.46.85.213:51413,<->,92.27.219.36:17901,0,0,1,1504,1,1504,1.880139000,0.0000
106.157.38.242:53126,<->,108.134.108.77:34852,0,0,1,50,1,50,1.880040000,0.0000
144.75.218.237:44969,<->,8.222.218.207:domain,1,110,0,0,1,110,1.879280000,0.0000
108.134.108.77:63752,<->,106.157.38.242:53126,1,50,0,0,1,50,1.878973000,0.0000
29.134.223.74:57591,<->,92.27.219.153:49598,0,0,1,52,1,52,1.878533000,0.0000
106.157.38.242:53126,<->,108.134.108.77:47300,0,0,1,50,1,50,1.878470000,0.0000
109.222.250.135:33140,<->,193.46.99.163:21406,1,129,0,0,1,129,1.877998000,0.0000
108.134.108.77:54711,<->,106.157.38.242:53126,1,50,0,0,1,50,1.877725000,0.0000
106.157.38.242:53126,<->,108.134.108.77:connect-server,0,0,1,50,1,50,1.877691000,0.0000
136.25.188.105:51695,<->,132.5.71.202:domain,1,251,0,0,1,251,1.877595000,0.0000
144.71.47.67:37743,<->,239.66.185.234:domain,1,140,0,0,1,140,1.877446000,0.0000
141.95.30.9:here-lm,<->,129.224.112.252:domain,0,0,1,73,1,73,1.877123000,0.0000
118.20.100.60:42261,<->,215.158.238.77:domain,0,0,1,84,1,84,1.877009000,0.0000
106.157.38.242:53126,<->,108.134.108.77:31842,0,0,1,50,1,50,1.876984000,0.0000
:::51272,<->,:::domain,0,0,1,93,1,93,1.876815000,0.0000
106.157.38.242:53126,<->,108.134.108.77:21099,0,0,1,50,1,50,1.876706000,0.0000
144.75.218.242:46627,<->,8.222.218.199:domain,1,181,0,0,1,181,1.876563000,0.0000
99.72.178.167:35643,<->,144.76.46.38:domain,1,135,0,0,1,135,1.876500000,0.0000
106.157.38.242:53126,<->,108.134.108.77:16030,0,0,1,50,1,50,1.875732000,0.0000
106.157.38.242:53126,<->,108.134.108.77:27247,0,0,1,50,1,50,1.875094000,0.0000
117.157.99.11:18449,<->,109.222.199.230:domain,0,0,1,72,1,72,1.875083000,0.0000
144.75.218.246:precise-vip,<->,138.127.225.82:domain,1,355,0,0,1,355,1.875029000,0.0000
144.75.218.237:30703,<->,8.222.218.199:domain,1,122,0,0,1,122,1.874460000,0.0000
106.157.38.242:53126,<->,108.134.108.77:14933,0,0,1,50,1,50,1.874343000,0.0000
106.157.38.242:53126,<->,108.134.108.77:14007,0,0,1,50,1,50,1.874075000,0.0000
106.157.38.242:53126,<->,108.134.108.77:15621,0,0,1,50,1,50,1.874039000,0.0000
0.200.50.50:34233,<->,20.13.111.1:domain,0,0,1,60,1,60,1.873970000,0.0000
106.157.38.242:53126,<->,108.134.108.77:34990,0,0,1,50,1,50,1.873817000,0.0000
108.134.108.77:60062,<->,106.157.38.242:53126,1,50,0,0,1,50,1.873755000,0.0000
192.67.73.190:62972,<->,230.126.157.121:11479,1,133,0,0,1,133,1.873494000,0.0000
92.27.219.197:35503,<->,120.155.84.97:domain,1,110,0,0,1,110,1.873297000,0.0000
144.75.218.233:61069,<->,8.222.218.196:domain,1,237,0,0,1,237,1.873286000,0.0000
92.27.219.156:60442,<->,226.36.28.187:55915,1,84,0,0,1,84,1.873249000,0.0000
106.157.38.242:53126,<->,108.134.108.77:51523,0,0,1,50,1,50,1.873223000,0.0000
125.153.53.155:46628,<->,247.136.210.161:32066,0,0,1,321,1,321,1.872825000,0.0000
89.183.104.150:20329,<->,206.231.135.204:11229,1,58,0,0,1,58,1.872663000,0.0000
106.157.38.242:53126,<->,108.134.108.77:46290,0,0,1,50,1,50,1.872319000,0.0000
106.157.38.242:53126,<->,108.134.108.77:38962,0,0,1,50,1,50,1.872246000,0.0000
144.75.218.241:17019,<->,120.155.84.97:domain,1,150,0,0,1,150,1.872214000,0.0000
106.157.38.242:53126,<->,108.134.108.77:13843,0,0,1,50,1,50,1.872139000,0.0000
106.157.38.242:53126,<->,108.134.108.77:cpq-wbem,0,0,1,50,1,50,1.872124000,0.0000
106.157.38.242:53126,<->,108.134.108.77:39600,0,0,1,50,1,50,1.872110000,0.0000
115.43.9.188:50930,<->,92.27.219.204:13914,0,0,1,59,1,59,1.872059000,0.0000
197.137.33.27:51413,<->,92.27.219.36:17901,0,0,1,52,1,52,1.871987000,0.0000
33.22.37.126:55310,<->,92.27.219.166:33068,0,0,1,52,1,52,1.871947000,0.0000
38.173.83.126:57808,<->,192.67.155.194:6881,0,0,1,52,1,52,1.871933000,0.0000
192.67.178.158:59728,<->,193.86.126.254:56072,1,50,0,0,1,50,1.871669000,0.0000
21.15.226.126:55104,<->,20.193.18.21:netbios-ns,0,0,1,82,1,82,1.871435000,0.0000
106.157.38.242:53126,<->,108.134.108.77:35681,0,0,1,50,1,50,1.871338000,0.0000
144.75.218.237:40480,<->,8.222.218.199:domain,1,124,0,0,1,124,1.871105000,0.0000
144.75.218.241:44143,<->,8.222.218.207:domain,1,123,0,0,1,123,1.871060000,0.0000
220.55.66.45:33873,<->,126.198.120.245:domain,1,196,0,0,1,196,1.870354000,0.0000
144.75.218.235:33310,<->,145.255.180.193:domain,1,175,0,0,1,175,1.870210000,0.0000
144.75.218.246:10134,<->,8.222.218.204:domain,1,110,0,0,1,110,1.869881000,0.0000
108.134.108.77:60142,<->,106.157.38.242:53126,1,50,0,0,1,50,1.869770000,0.0000
92.27.27.169:46695,<->,222.34.248.184:6881,1,436,0,0,1,436,1.869596000,0.0000
133.178.226.245:60360,<->,158.20.90.55:domain,1,116,0,0,1,116,1.869521000,0.0000
8.176.8.229:61996,<->,192.171.13.189:domain,1,112,0,0,1,112,1.869210000,0.0000
144.75.218.235:11337,<->,145.255.180.193:domain,1,175,0,0,1,175,1.869129000,0.0000
108.134.108.77:55442,<->,106.157.38.242:53126,1,50,0,0,1,50,1.868911000,0.0000
247.136.134.130:55199,<->,205.88.59.195:12429,1,135,0,0,1,135,1.868702000,0.0000
247.136.161.149:53966,<->,238.11.170.11:51414,1,298,0,0,1,298,1.868480000,0.0000
144.75.218.241:20733,<->,8.222.218.196:domain,1,123,0,0,1,123,1.868227000,0.0000
144.75.218.246:61131,<->,8.222.218.197:domain,1,110,0,0,1,110,1.868221000,0.0000
144.75.218.242:40857,<->,8.222.218.207:domain,1,122,0,0,1,122,1.867872000,0.0000
108.134.108.77:58618,<->,106.157.38.242:53126,1,50,0,0,1,50,1.867158000,0.0000
129.236.100.219:63818,<->,129.224.112.252:domain,0,0,1,74,1,74,1.866993000,0.0000
:::11468,<->,:::domain,1,113,0,0,1,113,1.866612000,0.0000
144.108.64.179:47240,<->,159.69.187.21:domain,0,0,1,67,1,67,1.866610000,0.0000
144.75.218.237:45366,<->,8.222.218.198:domain,1,110,0,0,1,110,1.866439000,0.0000
92.27.219.30:45016,<->,27.172.7.238:pra-elmd,1,52,0,0,1,52,1.866376000,0.0000
144.75.218.235:30895,<->,138.127.231.222:domain,1,238,0,0,1,238,1.866061000,0.0000
144.75.218.235:42568,<->,138.127.231.132:domain,1,236,0,0,1,236,1.865816000,0.0000
144.75.218.237:41662,<->,8.222.218.197:domain,1,122,0,0,1,122,1.864508000,0.0000
144.75.218.237:61111,<->,8.222.218.207:domain,1,113,0,0,1,113,1.864307000,0.0000
39.203.35.145:29467,<->,126.210.84.153:domain,1,75,0,0,1,75,1.863363000,0.0000
39.201.32.176:4822,<->,124.27.237.237:domain,1,70,0,0,1,70,1.863348000,0.0000
133.178.226.245:36174,<->,8.221.197.206:domain,1,141,0,0,1,141,1.862142000,0.0000
106.213.240.130:14535,<->,99.72.161.129:bctp,0,0,1,135,1,135,1.862065000,0.0000
145.89.145.60:40148,<->,144.81.142.56:domain,1,217,0,0,1,217,1.861838000,0.0000
144.75.218.233:19905,<->,8.222.218.197:domain,1,127,0,0,1,127,1.861826000,0.0000
57.140.246.52:43486,<->,220.55.123.209:domain,0,0,1,72,1,72,1.861629000,0.0000
89.183.104.129:11311,<->,48.105.40.132:ndmp,1,52,0,0,1,52,1.861479000,0.0000
144.75.218.233:14979,<->,8.222.218.196:domain,1,121,0,0,1,121,1.861431000,0.0000
144.75.218.241:62825,<->,8.222.218.196:domain,1,157,0,0,1,157,1.861032000,0.0000
144.75.218.242:58235,<->,8.222.218.207:domain,1,110,0,0,1,110,1.861028000,0.0000
0.68.1.25:61185,<->,133.178.226.161:domain,0,0,1,89,1,89,1.860716000,0.0000
8.176.8.195:41096,<->,192.171.13.190:domain,1,122,0,0,1,122,1.860594000,0.0000
144.75.218.237:42843,<->,8.222.218.199:domain,1,108,0,0,1,108,1.860081000,0.0000
111.147.186.234:51569,<->,147.61.250.193:45187,1,138,0,0,1,138,1.859870000,0.0000
144.75.218.242:45047,<->,8.222.218.199:domain,1,114,0,0,1,114,1.859431000,0.0000
119.111.190.164:25511,<->,97.198.97.149:domain,0,0,1,83,1,83,1.858844000,0.0000
144.108.64.179:44953,<->,159.69.187.46:domain,0,0,1,70,1,70,1.858013000,0.0000
114.145.101.174:43130,<->,129.224.112.252:domain,0,0,1,80,1,80,1.857955000,0.0000
216.184.0.194:33395,<->,98.232.172.60:domain,0,0,1,90,1,90,1.857844000,0.0000
144.75.218.237:48046,<->,120.155.84.97:domain,1,236,0,0,1,236,1.857665000,0.0000
133.178.226.245:49945,<->,122.158.247.84:domain,1,141,0,0,1,141,1.857631000,0.0000
144.75.218.242:25296,<->,148.111.30.85:domain,1,75,0,0,1,75,1.857284000,0.0000
92.27.219.28:57107,<->,193.21.29.220:6881,1,326,0,0,1,326,1.857263000,0.0000
80.38.6.51:8137,<->,148.246.80.24:domain,1,544,0,0,1,544,1.856918000,0.0000
:::40210,<->,:::domain,1,130,0,0,1,130,1.856786000,0.0000
144.75.218.246:55470,<->,8.222.218.204:domain,1,122,0,0,1,122,1.856704000,0.0000
192.67.167.160:61354,<->,193.87.146.236:49001,1,321,0,0,1,321,1.856302000,0.0000
97.126.26.70:48306,<->,102.45.225.190:domain,1,62,0,0,1,62,1.855896000,0.0000
8.191.0.37:58463,<->,133.178.226.254:domain,0,0,1,90,1,90,1.854860000,0.0000
97.126.26.71:63201,<->,129.223.93.3:domain,1,699,0,0,1,699,1.854821000,0.0000
58.245.201.56:42532,<->,39.54.0.31:icl-twobase10,0,0,1,70,1,70,1.854578000,0.0000
92.27.27.166:21072,<->,112.15.193.110:20645,1,52,0,0,1,52,1.854409000,0.0000
21.15.226.126:55104,<->,20.193.18.209:netbios-ns,0,0,1,82,1,82,1.854371000,0.0000
33.46.220.222:59550,<->,92.27.219.38:25521,0,0,1,52,1,52,1.854004000,0.0000
144.75.218.235:contamac-icm,<->,149.178.40.234:domain,1,144,0,0,1,144,1.853817000,0.0000
92.27.219.39:57244,<->,94.196.135.89:7740,1,321,0,0,1,321,1.853348000,0.0000
144.75.218.241:14658,<->,8.222.218.204:domain,1,111,0,0,1,111,1.852808000,0.0000
144.75.218.246:35618,<->,138.127.225.75:domain,1,67,0,0,1,67,1.852562000,0.0000
39.175.29.44:44857,<->,207.192.128.185:domain,1,80,0,0,1,80,1.851815000,0.0000
78.44.97.48:53382,<->,92.27.27.165:25418,0,0,1,52,1,52,1.851548000,0.0000
144.86.145.88:6765,<->,132.43.156.54:domain,1,259,0,0,1,259,1.850768000,0.0000
8.61.93.25:57503,<->,129.224.112.252:domain,0,0,1,80,1,80,1.850736000,0.0000
92.27.219.54:56216,<->,104.46.166.216:27049,1,52,0,0,1,52,1.850503000,0.0000
144.75.218.246:56390,<->,138.127.231.122:domain,1,253,0,0,1,253,1.849985000,0.0000
247.136.171.153:51413,<->,152.35.69.219:6881,1,100,0,0,1,100,1.849824000,0.0000
134.10.203.20:55950,<->,80.42.172.225:51413,0,0,1,52,1,52,1.849815000,0.0000
144.75.218.242:45934,<->,8.222.218.204:domain,1,109,0,0,1,109,1.849620000,0.0000
20.214.252.198:udrive,<->,128.134.58.103:domain,1,72,0,0,1,72,1.849476000,0.0000
106.112.9.43:40358,<->,92.27.219.139:32219,0,0,1,52,1,52,1.849343000,0.0000
144.111.184.84:63710,<->,132.249.70.233:domain,0,0,1,76,1,76,1.848624000,0.0000
144.75.218.241:33029,<->,8.222.218.207:domain,1,110,0,0,1,110,1.848163000,0.0000
105.170.45.15:49001,<->,109.0.243.153:35920,0,0,1,174,1,174,1.848067000,0.0000
92.27.27.99:56853,<->,198.69.188.244:56681,1,135,0,0,1,135,1.847285000,0.0000
64.214.68.218:49152,<->,92.27.219.50:6881,0,0,1,135,1,135,1.847120000,0.0000
192.67.160.34:25695,<->,206.100.98.202:22414,1,135,0,0,1,135,1.846986000,0.0000
53.202.56.24:41148,<->,246.253.248.211:domain,0,0,1,87,1,87,1.846930000,0.0000
220.55.101.99:8483,<->,8.47.188.160:domain,1,132,0,0,1,132,1.846774000,0.0000
204.42.12.34:50763,<->,89.183.104.246:37847,0,0,1,321,1,321,1.845577000,0.0000
144.75.218.242:39056,<->,8.222.218.199:domain,1,111,0,0,1,111,1.845421000,0.0000
133.178.226.245:54645,<->,8.252.136.247:domain,1,141,0,0,1,141,1.845133000,0.0000
109.1.16.219:59190,<->,229.70.81.21:34888,1,52,0,0,1,52,1.845129000,0.0000
144.75.218.237:21766,<->,138.127.231.127:domain,1,259,0,0,1,259,1.844270000,0.0000
114.26.165.175:57716,<->,92.27.219.147:26595,0,0,1,52,1,52,1.843902000,0.0000
116.116.8.2:47656,<->,89.183.104.246:37082,0,0,1,138,1,138,1.843496000,0.0000
204.140.159.18:4758,<->,39.15.169.14:domain,0,0,1,83,1,83,1.842819000,0.0000
215.158.103.219:18450,<->,80.56.76.189:domain,1,566,0,0,1,566,1.842741000,0.0000
144.75.218.242:43589,<->,8.222.218.199:domain,1,125,0,0,1,125,1.842631000,0.0000
58.218.173.51:8621,<->,97.126.19.86:domain,0,0,1,74,1,74,1.842618000,0.0000
20.86.191.178:52985,<->,122.147.213.67:domain,1,72,0,0,1,72,1.842533000,0.0000
144.75.218.242:45812,<->,8.222.218.207:domain,1,114,0,0,1,114,1.842239000,0.0000
144.108.64.179:48053,<->,144.122.240.224:domain,0,0,1,75,1,75,1.842231000,0.0000
143.252.64.234:48575,<->,129.224.112.252:domain,0,0,1,79,1,79,1.841999000,0.0000
199.41.253.141:30726,<->,99.75.171.124:12538,0,0,1,50,1,50,1.841866000,0.0000
144.75.218.246:63341,<->,8.222.218.204:domain,1,127,0,0,1,127,1.841856000,0.0000
8.228.214.124:58457,<->,154.181.213.140:31517,1,78,0,0,1,78,1.841797000,0.0000
145.57.21.172:35116,<->,133.0.67.60:sip,0,0,1,412,1,412,1.840972000,0.0000
247.136.163.14:12062,<->,48.106.148.95:ams,1,55,0,0,1,55,1.840682000,0.0000
193.10.105.69:17353,<->,92.27.219.178:15738,0,0,1,135,1,135,1.840546000,0.0000
207.223.249.91:49806,<->,92.27.27.176:39894,0,0,1,52,1,52,1.840040000,0.0000
97.119.43.23:19220,<->,109.222.233.47:domain,0,0,1,68,1,68,1.839645000,0.0000
249.101.220.125:57301,<->,29.214.217.95:domain,1,106,0,0,1,106,1.838988000,0.0000
20.148.166.172:48019,<->,195.42.93.219:domain,1,80,0,0,1,80,1.838907000,0.0000
92.27.219.61:60605,<->,108.32.70.30:26556,1,52,0,0,1,52,1.838558000,0.0000
34.97.244.196:55304,<->,79.255.248.211:armtechdaemon,1,62,0,0,1,62,1.838257000,0.0000
254.70.28.13:21769,<->,192.67.173.65:16861,0,0,1,213,1,213,1.838147000,0.0000
53.187.62.98:10044,<->,246.253.248.211:domain,0,0,1,89,1,89,1.838014000,0.0000
144.75.218.235:44040,<->,8.222.218.198:domain,1,112,0,0,1,112,1.837848000,0.0000
27.193.66.236:50855,<->,80.42.179.50:domain,0,0,1,77,1,77,1.837766000,0.0000
76.75.235.102:37096,<->,39.32.47.110:14767,0,0,1,99,1,99,1.837617000,0.0000
14.224.78.123:22714,<->,109.222.246.61:domain,0,0,1,79,1,79,1.837530000,0.0000
89.86.110.252:33997,<->,136.25.189.93:domain,0,0,1,83,1,83,1.837289000,0.0000
133.178.226.245:39853,<->,131.148.22.184:domain,1,183,0,0,1,183,1.836441000,0.0000
100.19.49.44:32192,<->,159.137.143.150:domain,0,0,1,75,1,75,1.836344000,0.0000
207.92.21.74:46785,<->,92.27.219.50:15789,0,0,1,52,1,52,1.836043000,0.0000
144.75.218.246:22137,<->,8.222.218.199:domain,1,111,0,0,1,111,1.835888000,0.0000
144.75.218.235:20093,<->,8.222.218.204:domain,1,121,0,0,1,121,1.835877000,0.0000
139.241.119.19:13259,<->,98.235.198.99:domain,1,93,0,0,1,93,1.835863000,0.0000
99.72.131.232:23057,<->,199.21.40.75:17321,1,52,0,0,1,52,1.835675000,0.0000
109.3.157.147:26158,<->,153.252.156.171:7558,1,133,0,0,1,133,1.835582000,0.0000
39.201.125.228:53880,<->,142.105.64.126:domain,1,75,0,0,1,75,1.834876000,0.0000
39.167.77.109:32929,<->,195.84.236.189:domain,1,70,0,0,1,70,1.834514000,0.0000
148.151.104.199:48911,<->,80.38.12.231:domain,0,0,1,76,1,76,1.833715000,0.0000
144.75.218.235:56388,<->,8.222.218.204:domain,1,110,0,0,1,110,1.832845000,0.0000
144.75.218.235:61846,<->,8.222.218.197:domain,1,113,0,0,1,113,1.832416000,0.0000
144.75.218.246:58720,<->,138.127.225.148:domain,1,366,0,0,1,366,1.832274000,0.0000
92.27.219.223:19911,<->,118.59.39.42:15602,1,351,0,0,1,351,1.831543000,0.0000
21.15.226.126:55104,<->,20.193.19.157:netbios-ns,0,0,1,82,1,82,1.831455000,0.0000
80.47.152.53:65146,<->,133.178.227.214:9043,0,0,1,156,1,156,1.831159000,0.0000
196.20.107.154:47430,<->,89.183.104.179:nburn-id,0,0,1,62,1,62,1.831016000,0.0000
215.158.140.170:55005,<->,8.220.7.141:domain,1,96,0,0,1,96,1.830792000,0.0000
215.158.103.206:20148,<->,138.127.231.137:domain,1,249,0,0,1,249,1.830598000,0.0000
99.73.155.191:43492,<->,199.21.75.231:27526,1,149,0,0,1,149,1.830409000,0.0000
144.75.218.242:42299,<->,8.222.218.207:domain,1,122,0,0,1,122,1.830074000,0.0000
144.75.218.237:30453,<->,8.222.218.207:domain,1,110,0,0,1,110,1.828451000,0.0000
20.162.44.67:26738,<->,128.134.120.108:domain,1,78,0,0,1,78,1.828364000,0.0000
99.75.83.112:52605,<->,144.76.46.38:domain,1,86,0,0,1,86,1.827996000,0.0000
80.42.160.210:21905,<->,125.54.142.72:17806,1,135,0,0,1,135,1.827421000,0.0000
131.36.66.69:61227,<->,136.25.189.5:domain,0,0,1,84,1,84,1.826926000,0.0000
144.75.218.237:otmp,<->,8.222.218.197:domain,1,124,0,0,1,124,1.826727000,0.0000
144.75.218.246:57964,<->,8.222.218.199:domain,1,123,0,0,1,123,1.826659000,0.0000
39.154.116.186:60559,<->,94.39.75.213:14127,1,80,0,0,1,80,1.826460000,0.0000
144.75.218.242:64659,<->,8.222.218.199:domain,1,119,0,0,1,119,1.826173000,0.0000
192.64.229.25:36930,<->,112.218.200.144:19605,1,99,0,0,1,99,1.825647000,0.0000
61.60.31.115:50833,<->,102.45.16.159:16470,0,0,1,50,1,50,1.825391000,0.0000
144.75.218.242:61595,<->,8.222.218.207:domain,1,111,0,0,1,111,1.825235000,0.0000
144.75.218.235:62121,<->,130.229.11.147:domain,1,136,0,0,1,136,1.825045000,0.0000
108.134.108.77:56348,<->,106.157.38.242:37294,1,50,0,0,1,50,1.824557000,0.0000
144.75.218.242:56636,<->,8.222.218.196:domain,1,111,0,0,1,111,1.824382000,0.0000
106.157.38.242:37294,<->,108.134.108.77:10957,0,0,1,50,1,50,1.824350000,0.0000
118.20.100.60:44073,<->,215.158.238.79:domain,0,0,1,84,1,84,1.823942000,0.0000
21.15.226.126:55104,<->,20.193.19.159:netbios-ns,0,0,1,82,1,82,1.823062000,0.0000
144.75.218.241:62364,<->,120.155.84.97:domain,1,152,0,0,1,152,1.822961000,0.0000
80.227.44.110:10329,<->,109.222.245.159:domain,0,0,1,76,1,76,1.822757000,0.0000
108.134.108.77:63439,<->,106.157.38.242:37294,1,50,0,0,1,50,1.822623000,0.0000
92.27.219.205:54147,<->,223.141.71.187:46070,1,62,0,0,1,62,1.822619000,0.0000
69.132.241.159:47480,<->,215.158.140.8:domain,0,0,1,90,1,90,1.822484000,0.0000
8.240.125.62:37100,<->,215.158.239.240:domain,0,0,1,90,1,90,1.822467000,0.0000
134.160.119.114:43348,<->,80.40.14.22:34603,0,0,1,653,1,653,1.822355000,0.0000
141.245.151.211:62052,<->,136.47.66.197:domain,1,86,0,0,1,86,1.822200000,0.0000
144.75.218.237:27299,<->,8.222.218.197:domain,1,126,0,0,1,126,1.822200000,0.0000
76.82.133.14:29401,<->,97.126.26.49:domain,0,0,1,86,1,86,1.822019000,0.0000
106.157.38.242:37294,<->,108.134.108.77:9199,0,0,1,50,1,50,1.821925000,0.0000
92.27.219.39:57205,<->,195.115.40.69:51413,1,52,0,0,1,52,1.821734000,0.0000
59.36.99.236:59967,<->,213.38.229.2:37374,0,0,1,351,1,351,1.821623000,0.0000
92.27.27.150:51949,<->,42.31.145.160:50003,1,319,0,0,1,319,1.821425000,0.0000
106.157.38.242:37294,<->,108.134.108.77:16318,0,0,1,50,1,50,1.821042000,0.0000
106.157.38.242:37294,<->,108.134.108.77:boinc-client,0,0,1,50,1,50,1.820618000,0.0000
144.75.218.242:7117,<->,8.222.218.207:domain,1,111,0,0,1,111,1.820596000,0.0000
144.75.218.242:8737,<->,138.127.224.59:domain,1,285,0,0,1,285,1.820555000,0.0000
194.45.239.127:45682,<->,89.183.104.254:11956,0,0,1,52,1,52,1.820552000,0.0000
96.191.62.123:48920,<->,109.222.242.34:domain,0,0,1,75,1,75,1.820479000,0.0000
192.64.228.251:6881,<->,123.155.89.112:6881,1,133,0,0,1,133,1.820449000,0.0000
106.157.38.242:37294,<->,108.134.108.77:21391,0,0,1,50,1,50,1.820408000,0.0000
192.67.167.160:61354,<->,27.147.179.30:6889,1,331,0,0,1,331,1.820243000,0.0000
144.76.43.245:30682,<->,80.56.78.128:domain,0,0,1,97,1,97,1.820072000,0.0000
106.157.38.242:37294,<->,108.134.108.77:36976,0,0,1,50,1,50,1.819611000,0.0000
106.157.38.242:37294,<->,108.134.108.77:32765,0,0,1,50,1,50,1.818931000,0.0000
215.158.103.206:52065,<->,53.178.69.33:domain,1,140,0,0,1,140,1.818820000,0.0000
108.134.108.77:58386,<->,106.157.38.242:37294,1,50,0,0,1,50,1.818792000,0.0000
106.157.38.242:37294,<->,108.134.108.77:intel-rci-mp,0,0,1,50,1,50,1.818692000,0.0000
108.134.108.77:39635,<->,106.157.38.242:37294,1,50,0,0,1,50,1.818457000,0.0000
6.75.224.242:58554,<->,77.23.182.148:24417,1,133,0,0,1,133,1.818232000,0.0000
106.157.38.242:37294,<->,108.134.108.77:28463,0,0,1,50,1,50,1.818222000,0.0000
20.154.109.237:8423,<->,126.2.10.5:domain,1,86,0,0,1,86,1.818157000,0.0000
139.163.7.171:48715,<->,138.127.225.228:domain,1,267,0,0,1,267,1.818077000,0.0000
144.75.218.242:47491,<->,8.222.218.196:domain,1,113,0,0,1,113,1.817919000,0.0000
106.157.38.242:37294,<->,108.134.108.77:7757,0,0,1,50,1,50,1.817726000,0.0000
144.75.218.235:35538,<->,138.127.224.169:domain,1,259,0,0,1,259,1.817721000,0.0000
144.75.218.242:55475,<->,99.168.7.150:domain,1,135,0,0,1,135,1.817632000,0.0000
144.75.218.242:53448,<->,8.222.218.196:domain,1,122,0,0,1,122,1.817625000,0.0000
108.134.108.77:62122,<->,106.157.38.242:37294,1,50,0,0,1,50,1.817559000,0.0000
106.157.38.242:37294,<->,108.134.108.77:19755,0,0,1,50,1,50,1.817513000,0.0000
98.200.176.13:12358,<->,70.208.156.132:slinkysearch,1,90,0,0,1,90,1.817322000,0.0000
192.65.148.55:47430,<->,206.154.255.105:11460,1,103,0,0,1,103,1.817136000,0.0000
108.134.108.77:42135,<->,106.157.38.242:37294,1,50,0,0,1,50,1.816963000,0.0000
144.75.218.246:16339,<->,138.127.231.26:domain,1,366,0,0,1,366,1.816604000,0.0000
108.134.108.77:64161,<->,106.157.38.242:37294,1,50,0,0,1,50,1.815943000,0.0000
144.75.218.242:45436,<->,8.222.218.199:domain,1,109,0,0,1,109,1.815941000,0.0000
106.157.38.242:37294,<->,108.134.108.77:28831,0,0,1,50,1,50,1.815775000,0.0000
104.46.90.215:44824,<->,92.27.27.147:41668,0,0,1,357,1,357,1.815713000,0.0000
120.164.163.192:42181,<->,89.183.104.151:24338,0,0,1,52,1,52,1.815702000,0.0000
144.75.218.242:5613,<->,8.222.218.207:domain,1,113,0,0,1,113,1.815504000,0.0000
136.25.188.37:61354,<->,158.166.172.13:domain,1,109,0,0,1,109,1.815370000,0.0000
106.157.38.242:37294,<->,108.134.108.77:13481,0,0,1,50,1,50,1.815210000,0.0000
106.157.38.242:37294,<->,108.134.108.77:transmit-port,0,0,1,50,1,50,1.814642000,0.0000
52.26.227.26:12545,<->,111.181.100.63:domain,0,0,1,65,1,65,1.814471000,0.0000
144.93.125.48:31529,<->,144.93.121.86:8993,0,0,1,104,1,104,1.814447000,0.0000
136.25.189.210:59201,<->,33.209.222.135:domain,1,111,0,0,1,111,1.814373000,0.0000
108.134.108.77:46758,<->,106.157.38.242:37294,1,50,0,0,1,50,1.814275000,0.0000
144.75.218.233:60976,<->,138.127.230.128:domain,1,236,0,0,1,236,1.813926000,0.0000
136.25.188.105:52085,<->,140.136.9.105:domain,1,299,0,0,1,299,1.813698000,0.0000
144.76.43.245:60288,<->,80.56.78.128:domain,0,0,1,115,1,115,1.813615000,0.0000
215.158.210.24:58723,<->,29.211.214.254:domain,0,0,1,96,1,96,1.813519000,0.0000
144.75.218.237:23087,<->,138.127.231.171:domain,1,159,0,0,1,159,1.813367000,0.0000
108.134.108.77:44362,<->,106.157.38.242:37294,1,50,0,0,1,50,1.813359000,0.0000
144.75.218.242:25861,<->,138.127.230.221:domain,1,83,0,0,1,83,1.813173000,0.0000
144.75.218.246:30576,<->,99.168.7.150:domain,1,133,0,0,1,133,1.812806000,0.0000
106.157.38.242:37294,<->,108.134.108.77:22035,0,0,1,50,1,50,1.812758000,0.0000
139.241.115.221:38992,<->,29.211.214.254:domain,0,0,1,97,1,97,1.812649000,0.0000
8.191.0.37:40852,<->,133.178.226.246:domain,0,0,1,90,1,90,1.812617000,0.0000
106.157.38.242:37294,<->,108.134.108.77:34246,0,0,1,50,1,50,1.812418000,0.0000
144.75.218.241:6259,<->,8.222.218.204:domain,1,110,0,0,1,110,1.810311000,0.0000
144.75.218.246:56565,<->,8.222.218.197:domain,1,154,0,0,1,154,1.809274000,0.0000
144.75.218.233:23132,<->,8.222.218.196:domain,1,151,0,0,1,151,1.809256000,0.0000
59.4.229.71:55953,<->,133.54.28.239:domain,0,0,1,75,1,75,1.809256000,0.0000
34.229.165.106:43931,<->,147.180.169.242:domain,1,132,0,0,1,132,1.809174000,0.0000
92.27.219.189:47496,<->,42.45.91.160:6881,1,344,0,0,1,344,1.809099000,0.0000
144.75.218.242:11344,<->,8.222.218.199:domain,1,113,0,0,1,113,1.808971000,0.0000
21.15.226.126:55104,<->,20.193.19.107:netbios-ns,0,0,1,82,1,82,1.808914000,0.0000
39.224.191.198:33711,<->,199.91.57.142:domain,1,75,0,0,1,75,1.808882000,0.0000
89.183.104.227:51249,<->,33.57.79.42:37214,1,52,0,0,1,52,1.808270000,0.0000
98.190.121.68:36495,<->,120.155.84.160:domain,1,108,0,0,1,108,1.808132000,0.0000
110.97.115.62:52750,<->,92.27.26.102:proxy-gateway,0,0,1,57,1,57,1.808063000,0.0000
29.211.206.37:60446,<->,136.25.189.85:domain,0,0,1,83,1,83,1.807266000,0.0000
94.193.220.45:28933,<->,34.47.144.136:4254,0,0,1,52,1,52,1.807248000,0.0000
21.15.226.126:55104,<->,20.193.19.98:netbios-ns,0,0,1,82,1,82,1.807013000,0.0000
20.43.111.128:34495,<->,114.252.76.140:6883,1,52,0,0,1,52,1.806684000,0.0000
144.75.218.235:22036,<->,138.127.230.2:domain,1,238,0,0,1,238,1.806496000,0.0000
215.158.103.219:28259,<->,129.229.242.60:domain,1,795,0,0,1,795,1.806442000,0.0000
141.95.30.9:45400,<->,129.224.112.252:domain,0,0,1,74,1,74,1.806439000,0.0000
144.75.218.237:11941,<->,8.222.218.204:domain,1,121,0,0,1,121,1.805282000,0.0000
229.42.167.107:28187,<->,92.27.27.99:24136,0,0,1,213,1,213,1.804783000,0.0000
6.147.33.6:56441,<->,159.69.187.23:domain,0,0,1,73,1,73,1.804659000,0.0000
0.97.210.244:40719,<->,89.183.104.231:nbx-ser,0,0,1,52,1,52,1.803540000,0.0000
193.94.47.49:37197,<->,109.222.226.221:domain,0,0,1,64,1,64,1.803189000,0.0000
158.186.77.27:51413,<->,89.183.104.171:46627,0,0,1,81,1,81,1.802679000,0.0000
39.14.27.228:31587,<->,139.252.1.238:domain,1,201,0,0,1,201,1.802515000,0.0000
132.222.173.85:65439,<->,132.43.156.54:domain,1,346,0,0,1,346,1.802218000,0.0000
92.27.219.221:51973,<->,100.209.91.159:46003,1,52,0,0,1,52,1.801406000,0.0000
139.252.109.251:11698,<->,80.56.78.128:domain,0,0,1,97,1,97,1.801160000,0.0000
144.75.218.242:22663,<->,8.222.218.204:domain,1,111,0,0,1,111,1.800919000,0.0000
144.75.218.237:sftu,<->,8.222.218.207:domain,1,113,0,0,1,113,1.800181000,0.0000
144.75.218.235:16692,<->,145.255.180.193:domain,1,175,0,0,1,175,1.800160000,0.0000
144.108.64.179:56806,<->,159.69.187.9:domain,0,0,1,66,1,66,1.800084000,0.0000
21.15.226.126:55104,<->,20.193.19.78:netbios-ns,0,0,1,82,1,82,1.799170000,0.0000
144.75.218.242:55034,<->,8.222.218.199:domain,1,111,0,0,1,111,1.798540000,0.0000
92.27.27.173:37199,<->,106.75.38.26:21604,1,300,0,0,1,300,1.797838000,0.0000
141.245.151.222:24260,<->,53.244.113.73:domain,1,305,0,0,1,305,1.797705000,0.0000
97.160.194.93:55695,<->,111.146.192.18:domain,0,0,1,65,1,65,1.797002000,0.0000
207.20.140.168:30742,<->,129.224.112.252:domain,0,0,1,74,1,74,1.796510000,0.0000
144.108.64.179:58075,<->,159.69.187.46:domain,0,0,1,73,1,73,1.796074000,0.0000
136.118.9.247:13726,<->,129.221.194.218:domain,1,165,0,0,1,165,1.795794000,0.0000
119.69.69.192:11603,<->,92.27.219.222:paging-port,0,0,1,52,1,52,1.795335000,0.0000
89.183.104.143:8721,<->,205.80.53.82:domain,1,135,0,0,1,135,1.795286000,0.0000
49.41.242.61:27242,<->,98.67.141.221:domain,0,0,1,65,1,65,1.795248000,0.0000
144.75.218.241:22625,<->,138.127.231.3:domain,1,301,0,0,1,301,1.794678000,0.0000
144.108.64.179:22100,<->,159.69.187.7:domain,0,0,1,69,1,69,1.794424000,0.0000
6.116.31.8:55610,<->,215.158.239.65:domain,0,0,1,85,1,85,1.794257000,0.0000
144.75.218.237:57932,<->,53.167.244.138:domain,1,126,0,0,1,126,1.793835000,0.0000
29.211.126.97:55094,<->,133.178.226.161:domain,0,0,1,90,1,90,1.793798000,0.0000
144.75.218.233:45217,<->,8.222.218.204:domain,1,122,0,0,1,122,1.792724000,0.0000
144.75.218.233:29122,<->,129.35.251.34:domain,1,140,0,0,1,140,1.792521000,0.0000
132.20.222.233:51188,<->,129.224.112.253:domain,0,0,1,63,1,63,1.792356000,0.0000
139.241.115.221:37912,<->,29.211.214.254:domain,0,0,1,83,1,83,1.792007000,0.0000
247.136.161.149:53966,<->,193.87.145.139:49001,1,319,0,0,1,319,1.791184000,0.0000
139.241.115.221:45573,<->,29.211.214.254:domain,0,0,1,80,1,80,1.790816000,0.0000
29.212.183.183:36195,<->,215.158.239.75:domain,0,0,1,85,1,85,1.790816000,0.0000
20.146.99.67:10275,<->,224.42.246.238:domain,1,72,0,0,1,72,1.790772000,0.0000
92.27.219.141:35052,<->,205.14.114.4:32078,1,52,0,0,1,52,1.790422000,0.0000
144.75.218.242:22816,<->,8.222.218.199:domain,1,122,0,0,1,122,1.790319000,0.0000
144.75.218.237:36846,<->,120.155.84.97:domain,1,144,0,0,1,144,1.790253000,0.0000
144.75.218.246:64884,<->,138.127.225.148:domain,1,366,0,0,1,366,1.790008000,0.0000
144.75.218.237:35781,<->,138.127.225.8:domain,1,248,0,0,1,248,1.789886000,0.0000
144.75.218.246:58029,<->,8.222.218.199:domain,1,110,0,0,1,110,1.788141000,0.0000
144.75.218.246:58154,<->,8.222.218.204:domain,1,113,0,0,1,113,1.788017000,0.0000
144.75.218.242:59768,<->,8.222.218.207:domain,1,237,0,0,1,237,1.787999000,0.0000
194.194.150.250:39147,<->,102.50.172.123:34505,0,0,1,58,1,58,1.787958000,0.0000
117.65.167.57:61669,<->,192.67.169.144:54451,0,0,1,50,1,50,1.787854000,0.0000
215.158.103.206:46780,<->,129.201.176.4:domain,1,792,0,0,1,792,1.787311000,0.0000
20.87.123.170:39640,<->,131.130.141.188:domain,1,66,0,0,1,66,1.787089000,0.0000
8.252.222.117:51034,<->,111.151.107.247:domain,1,134,0,0,1,134,1.786934000,0.0000
136.25.188.212:58068,<->,120.155.222.33:domain,1,106,0,0,1,106,1.786775000,0.0000
112.177.147.253:55532,<->,192.64.217.166:1024,0,0,1,52,1,52,1.786302000,0.0000
144.75.218.237:17134,<->,8.222.218.204:domain,1,105,0,0,1,105,1.785633000,0.0000
144.75.218.233:48382,<->,145.255.180.193:domain,1,175,0,0,1,175,1.784960000,0.0000
38.21.156.204:56633,<->,20.232.230.156:netbios-ns,0,0,1,82,1,82,1.784794000,0.0000
21.15.226.126:55104,<->,20.193.20.59:netbios-ns,0,0,1,82,1,82,1.784566000,0.0000
80.40.37.166:56849,<->,132.60.99.180:domain,1,80,0,0,1,80,1.784296000,0.0000
39.61.116.154:56085,<->,113.80.8.5:domain,1,136,0,0,1,136,1.784238000,0.0000
144.75.218.242:52970,<->,8.222.218.207:domain,1,121,0,0,1,121,1.784114000,0.0000
38.103.13.199:18979,<->,101.224.184.225:12203,0,0,1,50,1,50,1.784036000,0.0000
136.25.188.105:64904,<->,132.43.156.81:domain,1,253,0,0,1,253,1.783369000,0.0000
144.75.218.242:47853,<->,8.222.218.204:domain,1,110,0,0,1,110,1.783264000,0.0000
8.252.223.8:56441,<->,192.171.13.33:domain,1,96,0,0,1,96,1.783002000,0.0000
139.241.115.221:36712,<->,29.211.214.254:domain,0,0,1,80,1,80,1.782138000,0.0000
144.108.80.170:49713,<->,159.69.187.1:domain,0,0,1,70,1,70,1.782067000,0.0000
139.241.115.221:59896,<->,29.211.214.254:domain,0,0,1,83,1,83,1.781588000,0.0000
144.75.218.246:5797,<->,8.222.218.204:domain,1,121,0,0,1,121,1.781064000,0.0000
144.75.218.242:35925,<->,97.94.119.43:domain,1,77,0,0,1,77,1.780970000,0.0000
139.241.115.221:48438,<->,29.211.214.254:domain,0,0,1,79,1,79,1.780728000,0.0000
215.158.103.206:55945,<->,129.223.93.3:domain,1,632,0,0,1,632,1.780576000,0.0000
139.241.115.221:57653,<->,29.211.214.254:domain,0,0,1,80,1,80,1.780564000,0.0000
136.25.188.212:40634,<->,8.253.128.68:domain,1,106,0,0,1,106,1.779915000,0.0000
45.186.235.53:irdmi2,<->,137.74.92.135:domain,0,0,1,65,1,65,1.779890000,0.0000
197.156.134.234:45982,<->,89.183.104.251:42097,0,0,1,52,1,52,1.779879000,0.0000
247.136.220.98:61199,<->,88.142.1.240:26212,1,149,0,0,1,149,1.779837000,0.0000
144.75.218.237:49507,<->,8.222.218.198:domain,1,110,0,0,1,110,1.779746000,0.0000
137.21.23.51:55999,<->,111.151.107.247:domain,1,225,0,0,1,225,1.778825000,0.0000
144.75.218.233:11598,<->,159.57.86.227:domain,1,200,0,0,1,200,1.778373000,0.0000
144.75.218.233:58591,<->,8.222.218.197:domain,1,113,0,0,1,113,1.778265000,0.0000
59.40.238.161:27248,<->,6.74.97.62:12779,0,0,1,130,1,130,1.778172000,0.0000
80.41.16.104:41197,<->,4.123.53.96:20228,1,130,0,0,1,130,1.777656000,0.0000
144.75.218.242:12502,<->,97.94.148.45:domain,1,84,0,0,1,84,1.777000000,0.0000
144.75.218.242:38866,<->,8.222.218.199:domain,1,111,0,0,1,111,1.776315000,0.0000
4.111.11.130:58583,<->,92.27.27.153:19450,0,0,1,52,1,52,1.776294000,0.0000
144.75.218.241:16165,<->,8.222.218.207:domain,1,122,0,0,1,122,1.775992000,0.0000
21.15.226.126:55104,<->,20.193.20.39:netbios-ns,0,0,1,82,1,82,1.775709000,0.0000
53.187.231.137:32415,<->,39.15.169.14:domain,0,0,1,87,1,87,1.775692000,0.0000
92.27.219.19:48575,<->,134.92.121.239:10010,1,115,0,0,1,115,1.775565000,0.0000
144.75.218.237:33156,<->,120.155.84.97:domain,1,116,0,0,1,116,1.774681000,0.0000
0.200.50.50:34233,<->,20.13.110.250:domain,0,0,1,60,1,60,1.774456000,0.0000
89.183.104.231:54640,<->,114.180.98.126:elxmgmt,1,52,0,0,1,52,1.773895000,0.0000
0.200.50.50:34233,<->,20.13.110.249:domain,0,0,1,60,1,60,1.773841000,0.0000
38.21.156.204:56633,<->,20.232.230.158:netbios-ns,0,0,1,82,1,82,1.773787000,0.0000
132.249.70.233:54049,<->,53.201.149.31:domain,1,84,0,0,1,84,1.773329000,0.0000
109.222.246.96:64130,<->,207.177.94.183:19298,1,52,0,0,1,52,1.772934000,0.0000
21.15.226.126:55104,<->,20.193.20.71:netbios-ns,0,0,1,82,1,82,1.772482000,0.0000
89.183.104.138:55294,<->,32.214.170.72:37990,1,52,0,0,1,52,1.772209000,0.0000
141.95.30.9:54629,<->,129.224.112.252:domain,0,0,1,76,1,76,1.772093000,0.0000
144.75.218.246:36820,<->,33.238.66.4:domain,1,489,0,0,1,489,1.771926000,0.0000
144.75.218.246:62231,<->,8.222.218.204:domain,1,127,0,0,1,127,1.771774000,0.0000
144.75.218.235:56687,<->,138.127.231.71:domain,1,252,0,0,1,252,1.771717000,0.0000
57.170.97.96:33535,<->,92.27.8.186:domain,0,0,1,79,1,79,1.771366000,0.0000
249.101.209.59:52871,<->,119.131.53.203:33881,1,52,0,0,1,52,1.770930000,0.0000
144.75.218.237:13187,<->,8.222.218.207:domain,1,123,0,0,1,123,1.770869000,0.0000
195.214.82.202:44506,<->,111.181.96.243:31238,0,0,1,321,1,321,1.770869000,0.0000
215.158.103.219:17986,<->,114.93.159.36:domain,1,77,0,0,1,77,1.770464000,0.0000
144.75.218.241:7723,<->,8.222.218.204:domain,1,124,0,0,1,124,1.770141000,0.0000
92.27.219.60:17406,<->,105.124.93.182:10129,1,135,0,0,1,135,1.769864000,0.0000
144.75.218.241:41906,<->,8.222.218.207:domain,1,112,0,0,1,112,1.769737000,0.0000
21.15.226.126:55104,<->,20.193.20.44:netbios-ns,0,0,1,82,1,82,1.769172000,0.0000
80.42.135.244:59532,<->,100.31.173.10:26664,1,77,0,0,1,77,1.768733000,0.0000
17.60.158.28:60932,<->,80.38.14.1:domain,0,0,1,80,1,80,1.768552000,0.0000
50.187.106.118:52238,<->,48.54.240.26:https,0,0,1,52,1,52,1.767989000,0.0000
144.75.218.246:38868,<->,8.222.218.197:domain,1,121,0,0,1,121,1.767329000,0.0000
132.249.70.233:53150,<->,139.114.208.34:domain,1,131,0,0,1,131,1.767240000,0.0000
144.75.218.241:4782,<->,218.5.150.95:domain,1,139,0,0,1,139,1.767212000,0.0000
192.67.142.176:18430,<->,126.196.234.152:11074,1,133,0,0,1,133,1.767199000,0.0000
144.75.218.242:55592,<->,8.222.218.204:domain,1,111,0,0,1,111,1.764746000,0.0000
98.23.111.141:51131,<->,92.27.209.105:7340,0,0,1,50,1,50,1.764147000,0.0000
144.75.218.241:56619,<->,120.155.84.97:domain,1,150,0,0,1,150,1.763372000,0.0000
125.43.71.208:17491,<->,192.64.217.166:14773,0,0,1,52,1,52,1.762949000,0.0000
136.25.188.105:61694,<->,243.12.104.44:domain,1,136,0,0,1,136,1.762798000,0.0000
137.116.192.147:57751,<->,92.27.219.228:24058,0,0,1,62,1,62,1.762702000,0.0000
136.25.188.28:46926,<->,111.151.107.247:domain,1,114,0,0,1,114,1.762690000,0.0000
144.75.218.242:19253,<->,8.222.218.199:domain,1,111,0,0,1,111,1.762545000,0.0000
38.68.132.30:49035,<->,92.27.219.134:20728,0,0,1,52,1,52,1.762514000,0.0000
105.235.111.198:51641,<->,80.40.48.131:16465,0,0,1,50,1,50,1.762244000,0.0000
193.46.99.163:21391,<->,192.64.213.70:6881,0,0,1,129,1,129,1.762226000,0.0000
57.140.246.54:59192,<->,144.64.139.146:domain,0,0,1,70,1,70,1.762171000,0.0000
230.102.156.208:64031,<->,129.224.112.252:domain,0,0,1,78,1,78,1.762039000,0.0000
20.23.176.109:18832,<->,198.206.101.9:domain,1,138,0,0,1,138,1.761691000,0.0000
89.183.104.147:53166,<->,115.139.104.118:gbjd816,1,52,0,0,1,52,1.761522000,0.0000
144.75.218.235:sgcip,<->,8.222.218.198:domain,1,113,0,0,1,113,1.761491000,0.0000
148.190.126.20:36855,<->,133.178.227.8:domain,0,0,1,85,1,85,1.761352000,0.0000
121.113.78.132:41123,<->,0.195.210.15:stun,0,0,1,158,1,158,1.760901000,0.0000
145.99.95.239:18963,<->,132.151.128.158:domain,0,0,1,77,1,77,1.760860000,0.0000
144.75.221.218:62765,<->,138.98.246.1:domain,0,0,1,123,1,123,1.760821000,0.0000
39.1.58.234:11040,<->,203.48.200.107:domain,1,72,0,0,1,72,1.760777000,0.0000
27.188.163.162:i-net-2000-npr,<->,109.1.16.58:sip,0,0,1,446,1,446,1.760315000,0.0000
53.156.60.32:50185,<->,144.85.75.55:domain,0,0,1,66,1,66,1.759987000,0.0000
21.15.226.126:55104,<->,20.193.20.137:netbios-ns,0,0,1,82,1,82,1.759977000,0.0000
91.57.162.49:48573,<->,133.178.226.254:domain,0,0,1,91,1,91,1.759485000,0.0000
206.134.132.209:13226,<->,89.183.104.135:6881,0,0,1,347,1,347,1.759478000,0.0000
121.54.65.222:13406,<->,80.41.3.230:6881,0,0,1,135,1,135,1.759462000,0.0000
229.102.222.252:57121,<->,20.197.122.244:domain,0,0,1,60,1,60,1.759455000,0.0000
144.75.218.242:30356,<->,138.127.225.15:domain,1,281,0,0,1,281,1.759377000,0.0000
48.108.228.77:39018,<->,92.27.219.150:24196,0,0,1,52,1,52,1.758687000,0.0000
:::40744,<->,:::domain,1,785,0,0,1,785,1.757951000,0.0000
100.95.138.197:44393,<->,122.173.165.4:23910,1,130,0,0,1,130,1.757942000,0.0000
109.222.254.165:29218,<->,223.179.242.163:11033,1,94,0,0,1,94,1.757840000,0.0000
247.136.156.18:31421,<->,33.215.53.77:25596,1,103,0,0,1,103,1.757744000,0.0000
145.99.95.239:18961,<->,132.151.128.158:domain,0,0,1,77,1,77,1.757541000,0.0000
148.158.222.19:28013,<->,129.224.112.252:domain,0,0,1,72,1,72,1.757402000,0.0000
39.47.255.177:37391,<->,124.119.26.152:domain,1,72,0,0,1,72,1.757306000,0.0000
215.158.140.136:43088,<->,139.252.1.230:domain,1,150,0,0,1,150,1.757208000,0.0000
133.178.226.245:48359,<->,111.151.107.247:domain,1,134,0,0,1,134,1.757130000,0.0000
39.174.251.232:9165,<->,112.185.63.12:domain,1,68,0,0,1,68,1.756977000,0.0000
215.158.140.136:64476,<->,139.252.1.230:domain,1,187,0,0,1,187,1.756904000,0.0000
66.210.2.210:62279,<->,109.222.219.165:domain,0,0,1,79,1,79,1.756869000,0.0000
215.158.140.136:54976,<->,139.252.1.230:domain,1,190,0,0,1,190,1.756823000,0.0000
144.75.218.233:30109,<->,8.222.218.204:domain,1,110,0,0,1,110,1.756657000,0.0000
215.158.140.136:50734,<->,139.252.1.230:domain,1,147,0,0,1,147,1.756656000,0.0000
220.55.190.246:28145,<->,80.40.61.250:qsm-gui,0,0,1,149,1,149,1.756608000,0.0000
144.75.218.233:7035,<->,8.222.218.197:domain,1,123,0,0,1,123,1.756415000,0.0000
143.252.64.224:63119,<->,129.224.112.252:domain,0,0,1,67,1,67,1.756291000,0.0000
215.158.140.136:43470,<->,139.252.1.230:domain,1,147,0,0,1,147,1.756241000,0.0000
118.229.89.67:55697,<->,109.222.192.55:47041,0,0,1,52,1,52,1.756070000,0.0000
146.250.128.76:50768,<->,129.224.112.252:domain,0,0,1,89,1,89,1.755682000,0.0000
37.103.76.210:43683,<->,246.254.97.149:domain,0,0,1,79,1,79,1.755433000,0.0000
215.158.140.136:48702,<->,139.252.1.230:domain,1,150,0,0,1,150,1.755359000,0.0000
215.158.140.136:48426,<->,139.252.1.230:domain,1,147,0,0,1,147,1.755323000,0.0000
215.158.140.136:41081,<->,139.252.1.230:domain,1,150,0,0,1,150,1.755195000,0.0000
215.158.140.136:62445,<->,139.252.1.230:domain,1,190,0,0,1,190,1.755060000,0.0000
215.158.140.136:59782,<->,139.252.1.230:domain,1,190,0,0,1,190,1.755047000,0.0000
8.191.0.37:49514,<->,133.178.226.245:domain,0,0,1,90,1,90,1.754840000,0.0000
215.158.140.136:46140,<->,139.252.1.230:domain,1,187,0,0,1,187,1.754655000,0.0000
215.158.140.136:46505,<->,139.252.1.230:domain,1,147,0,0,1,147,1.754535000,0.0000
92.27.27.147:41668,<->,131.187.69.142:14859,1,273,0,0,1,273,1.754347000,0.0000
215.158.140.136:42372,<->,139.252.1.230:domain,1,150,0,0,1,150,1.754287000,0.0000
20.177.85.11:49314,<->,33.211.90.124:domain,1,70,0,0,1,70,1.754090000,0.0000
215.158.140.136:49695,<->,139.252.1.230:domain,1,150,0,0,1,150,1.753935000,0.0000
82.99.190.137:26911,<->,92.27.219.195:6881,0,0,1,52,1,52,1.753524000,0.0000
158.187.177.85:40118,<->,210.229.230.12:6881,0,0,1,52,1,52,1.753506000,0.0000
144.75.218.235:41832,<->,109.115.48.64:domain,1,132,0,0,1,132,1.752506000,0.0000
99.72.147.6:58484,<->,195.213.8.246:48319,1,149,0,0,1,149,1.752391000,0.0000
144.75.218.237:42125,<->,8.222.218.204:domain,1,110,0,0,1,110,1.752304000,0.0000
127.19.235.252:24295,<->,129.224.112.252:domain,0,0,1,69,1,69,1.752132000,0.0000
0.200.50.50:34233,<->,20.13.110.224:domain,0,0,1,60,1,60,1.752104000,0.0000
78.3.177.2:14487,<->,80.42.179.50:domain,0,0,1,69,1,69,1.751970000,0.0000
144.75.218.237:62879,<->,8.222.218.199:domain,1,113,0,0,1,113,1.751640000,0.0000
136.25.188.37:35410,<->,111.151.107.247:domain,1,132,0,0,1,132,1.751549000,0.0000
92.27.219.248:34019,<->,92.19.180.10:bacula-dir,1,353,0,0,1,353,1.751145000,0.0000
195.78.241.6:58107,<->,100.92.54.27:35209,0,0,1,135,1,135,1.751057000,0.0000
97.126.26.70:progistics,<->,118.20.111.92:domain,1,100,0,0,1,100,1.750988000,0.0000
144.75.218.246:8864,<->,8.222.218.197:domain,1,123,0,0,1,123,1.750319000,0.0000
144.75.218.235:62531,<->,8.222.218.198:domain,1,122,0,0,1,122,1.750234000,0.0000
22.47.119.98:40335,<->,109.222.250.132:domain,0,0,1,76,1,76,1.750049000,0.0000
246.253.252.58:isakmp,<->,133.185.237.41:isakmp,1,116,0,0,1,116,1.749808000,0.0000
144.76.43.246:8584,<->,80.56.78.128:domain,0,0,1,93,1,93,1.749693000,0.0000
104.130.114.205:28647,<->,92.27.219.50:6881,0,0,1,52,1,52,1.749603000,0.0000
144.75.218.235:64631,<->,139.252.1.230:domain,1,90,0,0,1,90,1.749461000,0.0000
131.29.50.225:10750,<->,129.224.112.221:domain,0,0,1,59,1,59,1.749412000,0.0000
144.75.218.246:sitaramgmt,<->,138.127.225.75:domain,1,67,0,0,1,67,1.749200000,0.0000
99.72.71.250:20083,<->,126.204.219.116:11744,1,130,0,0,1,130,1.749164000,0.0000
119.71.120.173:58263,<->,92.27.219.30:45016,0,0,1,52,1,52,1.748891000,0.0000
145.148.156.184:24049,<->,138.98.246.1:domain,0,0,1,118,1,118,1.748583000,0.0000
29.214.120.107:53874,<->,98.232.172.60:domain,0,0,1,88,1,88,1.748339000,0.0000
144.75.218.237:11375,<->,8.222.218.199:domain,1,124,0,0,1,124,1.747392000,0.0000
14.172.128.222:49081,<->,97.126.18.88:domain,0,0,1,80,1,80,1.747063000,0.0000
144.75.218.237:36201,<->,132.200.124.228:domain,1,148,0,0,1,148,1.746929000,0.0000
144.75.218.241:47943,<->,8.222.218.207:domain,1,122,0,0,1,122,1.746699000,0.0000
98.23.102.124:48769,<->,29.211.214.82:domain,0,0,1,86,1,86,1.746630000,0.0000
144.75.218.233:18751,<->,138.127.224.239:domain,1,366,0,0,1,366,1.746340000,0.0000
249.101.98.217:57304,<->,76.75.223.231:25453,1,168,0,0,1,168,1.746210000,0.0000
144.75.218.235:smc-jmx,<->,143.204.138.236:domain,1,177,0,0,1,177,1.745794000,0.0000
136.25.188.105:49903,<->,135.88.171.34:domain,1,248,0,0,1,248,1.744642000,0.0000
144.75.218.246:46992,<->,97.94.119.43:domain,1,78,0,0,1,78,1.744631000,0.0000
40.219.7.103:30781,<->,247.136.171.153:6881,0,0,1,138,1,138,1.744517000,0.0000
159.153.54.153:64150,<->,159.69.187.31:domain,0,0,1,69,1,69,1.744429000,0.0000
144.75.218.246:imqtunnels,<->,8.222.218.197:domain,1,123,0,0,1,123,1.744302000,0.0000
144.75.218.242:49362,<->,97.232.6.180:domain,1,145,0,0,1,145,1.743968000,0.0000
98.151.29.220:36695,<->,144.93.121.10:33445,0,0,1,50,1,50,1.743675000,0.0000
144.75.218.233:28023,<->,138.24.14.249:domain,1,93,0,0,1,93,1.743195000,0.0000
115.181.233.214:61125,<->,247.136.216.15:56382,0,0,1,50,1,50,1.742322000,0.0000
144.75.218.246:13026,<->,8.222.218.197:domain,1,106,0,0,1,106,1.741947000,0.0000
136.25.188.37:39958,<->,145.77.134.40:domain,1,268,0,0,1,268,1.741729000,0.0000
144.75.218.246:51735,<->,8.222.218.199:domain,1,114,0,0,1,114,1.740851000,0.0000
39.45.164.231:29274,<->,121.92.159.163:domain,1,88,0,0,1,88,1.740667000,0.0000
144.108.80.170:16745,<->,159.69.187.32:domain,0,0,1,69,1,69,1.740425000,0.0000
53.199.219.107:34852,<->,39.15.169.14:domain,0,0,1,88,1,88,1.739821000,0.0000
113.183.175.35:54915,<->,109.222.199.156:6881,0,0,1,138,1,138,1.739714000,0.0000
144.75.218.242:18009,<->,138.127.231.102:domain,1,263,0,0,1,263,1.738753000,0.0000
20.223.147.81:12161,<->,131.214.147.20:domain,1,126,0,0,1,126,1.737564000,0.0000
252.98.141.62:19141,<->,132.43.156.56:domain,1,537,0,0,1,537,1.737319000,0.0000
21.15.226.126:55104,<->,20.193.20.186:netbios-ns,0,0,1,82,1,82,1.737055000,0.0000
109.14.213.84:42303,<->,80.56.78.92:domain,0,0,1,90,1,90,1.736944000,0.0000
89.183.104.255:37754,<->,119.184.145.46:13713,1,273,0,0,1,273,1.736600000,0.0000
136.25.188.212:61199,<->,131.31.145.149:domain,1,135,0,0,1,135,1.736443000,0.0000
249.101.197.94:46960,<->,193.46.99.163:xiostatus,1,300,0,0,1,300,1.735737000,0.0000
144.108.80.170:43700,<->,159.69.187.8:domain,0,0,1,68,1,68,1.735308000,0.0000
69.169.140.254:12779,<->,89.181.78.109:bacula-dir,0,0,1,133,1,133,1.735136000,0.0000
192.64.251.170:49552,<->,112.55.69.6:26403,1,130,0,0,1,130,1.735047000,0.0000
89.86.110.252:34129,<->,136.25.189.6:domain,0,0,1,83,1,83,1.734807000,0.0000
215.158.239.235:60691,<->,97.1.150.245:domain,1,119,0,0,1,119,1.734570000,0.0000
144.75.218.237:43821,<->,138.127.230.226:domain,1,241,0,0,1,241,1.734479000,0.0000
159.240.189.204:60163,<->,159.69.187.46:domain,0,0,1,65,1,65,1.734402000,0.0000
144.75.218.246:27590,<->,8.222.218.204:domain,1,122,0,0,1,122,1.733956000,0.0000
144.75.218.235:54683,<->,145.255.180.193:domain,1,175,0,0,1,175,1.733596000,0.0000
20.215.179.208:51198,<->,127.52.50.127:domain,1,74,0,0,1,74,1.733528000,0.0000
144.75.218.241:8043,<->,8.222.218.196:domain,1,111,0,0,1,111,1.733362000,0.0000
21.15.226.126:55104,<->,20.193.21.200:netbios-ns,0,0,1,82,1,82,1.733192000,0.0000
136.25.188.105:51680,<->,128.243.151.33:domain,1,249,0,0,1,249,1.732773000,0.0000
21.15.226.126:55104,<->,20.193.21.207:netbios-ns,0,0,1,82,1,82,1.732750000,0.0000
215.158.99.21:37722,<->,29.211.214.254:domain,0,0,1,96,1,96,1.732554000,0.0000
136.25.188.37:49025,<->,111.151.107.247:domain,1,163,0,0,1,163,1.732546000,0.0000
205.14.35.32:55080,<->,80.42.153.35:dsmcc-passthru,0,0,1,130,1,130,1.732428000,0.0000
48.40.197.2:22195,<->,101.70.119.12:domain,0,0,1,70,1,70,1.732393000,0.0000
89.183.104.164:52824,<->,29.239.126.131:16491,1,52,0,0,1,52,1.732139000,0.0000
220.55.110.92:42825,<->,8.47.188.160:domain,1,95,0,0,1,95,1.731868000,0.0000
144.75.218.235:53885,<->,8.222.218.198:domain,1,181,0,0,1,181,1.731814000,0.0000
20.141.54.228:25014,<->,155.133.82.169:17914,1,52,0,0,1,52,1.731067000,0.0000
39.227.65.70:48467,<->,230.126.6.104:10905,1,52,0,0,1,52,1.731049000,0.0000
136.25.188.105:58657,<->,141.204.123.255:domain,1,134,0,0,1,134,1.730779000,0.0000
247.136.209.27:12113,<->,235.226.212.248:websm,1,485,0,0,1,485,1.730569000,0.0000
89.183.104.143:49476,<->,205.80.53.82:domain,1,144,0,0,1,144,1.730323000,0.0000
136.25.188.37:37241,<->,111.151.107.247:domain,1,167,0,0,1,167,1.730031000,0.0000
39.11.131.163:24237,<->,158.236.129.2:domain,1,74,0,0,1,74,1.729749000,0.0000
141.95.30.10:36355,<->,144.64.137.156:domain,0,0,1,89,1,89,1.728779000,0.0000
144.75.218.237:62897,<->,120.155.84.97:domain,1,144,0,0,1,144,1.728519000,0.0000
143.230.117.31:19260,<->,129.224.112.252:domain,0,0,1,81,1,81,1.727876000,0.0000
144.108.80.164:43065,<->,159.69.187.25:domain,0,0,1,74,1,74,1.727051000,0.0000
248.225.26.61:57313,<->,53.190.60.6:49850,1,96,0,0,1,96,1.726532000,0.0000
144.75.218.242:29544,<->,33.229.58.179:domain,1,128,0,0,1,128,1.726050000,0.0000
77.43.208.251:12479,<->,8.238.100.28:6881,0,0,1,133,1,133,1.725288000,0.0000
21.15.226.126:55104,<->,20.193.21.222:netbios-ns,0,0,1,82,1,82,1.725281000,0.0000
144.75.218.242:12916,<->,98.192.190.17:domain,1,233,0,0,1,233,1.724540000,0.0000
92.27.219.240:35825,<->,40.208.251.226:12311,1,52,0,0,1,52,1.724497000,0.0000
21.15.226.126:55104,<->,20.193.21.218:netbios-ns,0,0,1,82,1,82,1.724168000,0.0000
39.52.63.66:36293,<->,204.128.217.52:domain,1,74,0,0,1,74,1.724156000,0.0000
117.79.29.177:59527,<->,192.64.217.166:1024,0,0,1,52,1,52,1.723548000,0.0000
80.238.60.11:54030,<->,109.1.54.101:chimera-hwm,0,0,1,52,1,52,1.723539000,0.0000
192.178.155.130:ntp,<->,145.242.126.41:ntp,0,0,1,80,1,80,1.723109000,0.0000
144.75.218.233:54535,<->,138.127.225.148:domain,1,366,0,0,1,366,1.723022000,0.0000
144.75.218.237:38016,<->,8.222.218.207:domain,1,111,0,0,1,111,1.722651000,0.0000
144.76.43.246:34796,<->,80.56.78.128:domain,0,0,1,107,1,107,1.722542000,0.0000
87.58.45.107:61084,<->,97.126.19.12:domain,0,0,1,77,1,77,1.722308000,0.0000
91.54.155.124:20234,<->,132.249.70.233:domain,0,0,1,72,1,72,1.722295000,0.0000
215.158.140.216:57982,<->,192.171.13.190:domain,1,297,0,0,1,297,1.721929000,0.0000
80.56.91.244:65436,<->,8.252.223.158:confluent,0,0,1,1112,1,1112,1.721727000,0.0000
144.75.218.246:25573,<->,8.222.218.204:domain,1,127,0,0,1,127,1.721448000,0.0000
142.255.168.235:csd-mgmt-port,<->,97.68.226.205:domain,0,0,1,68,1,68,1.721369000,0.0000
144.75.218.235:29243,<->,145.255.180.193:domain,1,175,0,0,1,175,1.720958000,0.0000
144.75.218.242:43409,<->,8.222.218.207:domain,1,110,0,0,1,110,1.720784000,0.0000
144.75.218.237:28253,<->,140.2.100.1:domain,1,111,0,0,1,111,1.720682000,0.0000
136.25.188.105:49898,<->,141.204.123.242:domain,1,129,0,0,1,129,1.720492000,0.0000
66.208.116.91:63646,<->,92.181.148.15:42426,0,0,1,273,1,273,1.720083000,0.0000
144.75.218.237:31996,<->,8.47.122.178:domain,1,100,0,0,1,100,1.719735000,0.0000
144.75.218.242:4205,<->,8.222.218.207:domain,1,114,0,0,1,114,1.719572000,0.0000
133.85.3.240:openvpn,<->,92.27.219.239:openvpn,0,0,1,245,1,245,1.719117000,0.0000
144.75.218.241:10264,<->,8.222.218.207:domain,1,153,0,0,1,153,1.719084000,0.0000
127.106.198.124:24536,<->,132.249.70.233:domain,0,0,1,82,1,82,1.719002000,0.0000
144.75.218.233:11923,<->,8.222.218.204:domain,1,110,0,0,1,110,1.718861000,0.0000
80.40.34.206:59696,<->,106.170.107.166:26376,1,130,0,0,1,130,1.718773000,0.0000
144.76.43.245:58620,<->,80.56.78.128:domain,0,0,1,107,1,107,1.716964000,0.0000
115.32.78.106:5825,<->,97.168.67.159:domain,0,0,1,73,1,73,1.716609000,0.0000
92.27.27.143:6881,<->,127.212.85.77:rxmon,1,52,0,0,1,52,1.716582000,0.0000
144.75.218.233:38319,<->,8.222.218.196:domain,1,110,0,0,1,110,1.716524000,0.0000
144.75.218.242:52700,<->,149.172.30.236:domain,1,134,0,0,1,134,1.716371000,0.0000
144.75.218.242:27007,<->,138.127.224.222:domain,1,365,0,0,1,365,1.715725000,0.0000
80.38.56.151:10428,<->,132.43.156.54:domain,1,760,0,0,1,760,1.715682000,0.0000
20.204.85.16:48282,<->,143.128.215.217:domain,1,76,0,0,1,76,1.715620000,0.0000
124.69.188.3:61168,<->,92.27.27.165:26657,0,0,1,79,1,79,1.715540000,0.0000
210.220.219.153:50288,<->,138.127.225.156:domain,1,288,0,0,1,288,1.715422000,0.0000
247.136.180.232:45849,<->,65.58.158.114:10226,1,135,0,0,1,135,1.715406000,0.0000
158.147.252.44:16183,<->,145.252.120.138:domain,0,0,1,60,1,60,1.714784000,0.0000
39.30.46.223:41219,<->,114.243.20.92:24543,1,88,0,0,1,88,1.714246000,0.0000
80.41.34.78:39647,<->,38.169.174.244:domain,1,72,0,0,1,72,1.713897000,0.0000
93.92.135.178:47682,<->,80.42.140.207:27667,0,0,1,52,1,52,1.713888000,0.0000
39.233.251.76:20115,<->,75.139.231.146:12186,1,62,0,0,1,62,1.713477000,0.0000
144.75.218.242:58672,<->,8.222.218.196:domain,1,110,0,0,1,110,1.713397000,0.0000
132.107.83.63:63689,<->,89.183.104.189:34505,0,0,1,52,1,52,1.713292000,0.0000
92.27.219.224:62348,<->,195.57.66.213:48319,1,52,0,0,1,52,1.713263000,0.0000
33.156.10.96:41008,<->,92.27.219.36:17352,0,0,1,351,1,351,1.713252000,0.0000
121.20.248.113:49559,<->,99.72.148.194:29636,0,0,1,135,1,135,1.712978000,0.0000
92.27.219.224:46624,<->,141.249.135.210:7379,1,52,0,0,1,52,1.712692000,0.0000
193.46.99.139:21327,<->,192.67.161.171:6881,0,0,1,129,1,129,1.712575000,0.0000
144.75.218.246:25704,<->,138.127.231.246:domain,1,269,0,0,1,269,1.712225000,0.0000
144.75.218.233:50300,<->,8.222.218.204:domain,1,111,0,0,1,111,1.712068000,0.0000
21.15.226.126:55104,<->,20.193.21.148:netbios-ns,0,0,1,82,1,82,1.711739000,0.0000
21.15.226.126:55104,<->,20.193.21.151:netbios-ns,0,0,1,82,1,82,1.711181000,0.0000
56.61.99.23:25095,<->,97.68.226.205:domain,0,0,1,86,1,86,1.711176000,0.0000
92.27.27.182:57461,<->,206.165.196.61:ssm-cvs,1,52,0,0,1,52,1.711020000,0.0000
144.75.218.237:34102,<->,8.222.218.204:domain,1,123,0,0,1,123,1.710583000,0.0000
21.15.226.126:55104,<->,20.193.21.167:netbios-ns,0,0,1,82,1,82,1.710517000,0.0000
144.75.218.237:28920,<->,8.222.218.204:domain,1,110,0,0,1,110,1.710398000,0.0000
135.207.217.74:56338,<->,159.137.142.17:domain,0,0,1,78,1,78,1.710006000,0.0000
53.251.63.173:34234,<->,39.15.169.14:domain,0,0,1,87,1,87,1.709110000,0.0000
21.15.226.126:55104,<->,20.193.21.144:netbios-ns,0,0,1,82,1,82,1.709089000,0.0000
249.101.218.38:59462,<->,40.154.48.215:bacula-dir,1,340,0,0,1,340,1.708685000,0.0000
247.136.229.50:52255,<->,144.46.53.180:stun,1,99,0,0,1,99,1.708532000,0.0000
144.75.218.233:19872,<->,8.222.218.197:domain,1,110,0,0,1,110,1.707925000,0.0000
144.75.218.237:60758,<->,8.222.218.199:domain,1,121,0,0,1,121,1.707755000,0.0000
144.75.218.242:12696,<->,8.222.218.199:domain,1,113,0,0,1,113,1.707355000,0.0000
195.78.209.21:49426,<->,99.75.149.84:20064,0,0,1,66,1,66,1.707342000,0.0000
20.123.2.65:13027,<->,195.69.43.52:domain,1,74,0,0,1,74,1.707061000,0.0000
136.25.188.105:21946,<->,135.228.158.61:domain,1,268,0,0,1,268,1.706875000,0.0000
215.158.103.219:62086,<->,138.127.224.38:domain,1,355,0,0,1,355,1.706557000,0.0000
144.108.80.170:44960,<->,159.69.187.18:domain,0,0,1,66,1,66,1.705981000,0.0000
136.25.188.105:63614,<->,128.243.151.33:domain,1,140,0,0,1,140,1.705817000,0.0000
144.93.121.86:55587,<->,113.171.246.29:28635,1,56,0,0,1,56,1.705348000,0.0000
124.30.39.58:46380,<->,92.27.219.42:17292,0,0,1,116,1,116,1.705196000,0.0000
144.75.218.246:24330,<->,8.222.218.197:domain,1,122,0,0,1,122,1.705161000,0.0000
20.129.44.50:62158,<->,116.226.161.204:domain,1,68,0,0,1,68,1.705074000,0.0000
114.145.64.123:45573,<->,129.224.112.252:domain,0,0,1,83,1,83,1.704519000,0.0000
144.75.218.235:43958,<->,138.127.230.84:domain,1,366,0,0,1,366,1.704485000,0.0000
8.240.125.22:43771,<->,246.254.97.149:domain,0,0,1,93,1,93,1.703835000,0.0000
144.75.218.242:22916,<->,138.127.225.15:domain,1,373,0,0,1,373,1.702926000,0.0000
144.75.218.242:59727,<->,8.222.218.199:domain,1,123,0,0,1,123,1.702334000,0.0000
144.75.218.241:64562,<->,131.65.15.83:domain,1,141,0,0,1,141,1.702332000,0.0000
21.15.226.126:55104,<->,20.193.21.174:netbios-ns,0,0,1,82,1,82,1.701998000,0.0000
144.75.218.241:49672,<->,8.222.218.196:domain,1,153,0,0,1,153,1.701713000,0.0000
102.50.96.106:57219,<->,205.37.52.56:43664,1,351,0,0,1,351,1.701197000,0.0000
144.75.218.246:trim-event,<->,8.222.218.197:domain,1,122,0,0,1,122,1.701127000,0.0000
80.40.37.166:62469,<->,132.60.99.180:domain,1,84,0,0,1,84,1.701106000,0.0000
111.146.146.108:41973,<->,136.47.66.197:ntp,1,80,0,0,1,80,1.700959000,0.0000
144.75.218.241:12740,<->,8.222.218.196:domain,1,110,0,0,1,110,1.700779000,0.0000
144.75.218.241:46809,<->,8.222.218.204:domain,1,110,0,0,1,110,1.700743000,0.0000
146.220.125.81:54670,<->,129.224.112.252:domain,0,0,1,90,1,90,1.700702000,0.0000
144.108.64.179:47088,<->,144.122.240.202:domain,0,0,1,71,1,71,1.700314000,0.0000
92.27.219.185:50657,<->,67.240.227.196:13185,1,62,0,0,1,62,1.700173000,0.0000
144.75.218.237:12415,<->,138.127.224.104:domain,1,278,0,0,1,278,1.699263000,0.0000
200.226.80.179:11506,<->,129.92.113.143:chargen,0,0,1,50,1,50,1.699017000,0.0000
192.252.224.95:45747,<->,136.181.50.99:10983,0,0,1,293,1,293,1.698522000,0.0000
136.25.188.105:64100,<->,63.73.200.51:domain,1,137,0,0,1,137,1.698072000,0.0000
136.25.188.164:57029,<->,139.252.1.244:domain,1,184,0,0,1,184,1.696757000,0.0000
136.25.188.105:59174,<->,140.136.9.105:domain,1,251,0,0,1,251,1.696448000,0.0000
65.44.36.70:4771,<->,98.67.131.97:domain,0,0,1,68,1,68,1.696028000,0.0000
99.75.239.34:55555,<->,117.155.169.79:55383,1,100,0,0,1,100,1.695792000,0.0000
144.75.218.242:trustestablish,<->,8.222.218.196:domain,1,153,0,0,1,153,1.695371000,0.0000
144.93.125.38:51317,<->,144.93.121.10:14129,0,0,1,104,1,104,1.695364000,0.0000
144.75.218.237:56211,<->,53.149.3.155:domain,1,81,0,0,1,81,1.695269000,0.0000
247.136.152.230:34732,<->,104.50.172.179:11888,1,344,0,0,1,344,1.694925000,0.0000
144.75.218.237:16996,<->,138.127.225.148:domain,1,366,0,0,1,366,1.694922000,0.0000
97.242.126.198:snifferserver,<->,129.224.112.252:domain,0,0,1,71,1,71,1.694833000,0.0000
144.75.218.246:37569,<->,138.127.224.104:domain,1,304,0,0,1,304,1.694534000,0.0000
200.226.80.179:ivecon-port,<->,129.92.113.143:chargen,0,0,1,50,1,50,1.694499000,0.0000
64.253.134.141:17598,<->,159.25.30.7:emfis-data,0,0,1,52,1,52,1.694110000,0.0000
192.64.238.102:14143,<->,110.4.15.52:bacula-dir,1,353,0,0,1,353,1.693813000,0.0000
89.139.241.98:41615,<->,132.43.156.56:domain,1,167,0,0,1,167,1.693305000,0.0000
144.108.80.170:39549,<->,159.69.187.55:domain,0,0,1,64,1,64,1.693212000,0.0000
144.75.218.241:pq-lic-mgmt,<->,116.126.255.82:domain,1,89,0,0,1,89,1.692707000,0.0000
144.75.218.242:17702,<->,8.222.218.207:domain,1,154,0,0,1,154,1.692682000,0.0000
27.188.163.162:i-net-2000-npr,<->,109.1.16.50:sip,0,0,1,447,1,447,1.692565000,0.0000
102.51.52.249:32826,<->,93.137.103.10:30023,1,629,0,0,1,629,1.691955000,0.0000
144.75.218.233:29850,<->,8.222.218.196:domain,1,110,0,0,1,110,1.691037000,0.0000
144.75.218.237:26220,<->,120.155.84.97:domain,1,148,0,0,1,148,1.690780000,0.0000
135.81.77.209:64496,<->,92.27.219.216:39396,0,0,1,135,1,135,1.690155000,0.0000
80.42.177.161:26248,<->,230.80.188.183:8689,1,133,0,0,1,133,1.690142000,0.0000
159.28.159.6:60687,<->,129.224.112.252:domain,0,0,1,89,1,89,1.689552000,0.0000
20.135.157.252:38896,<->,141.21.158.209:domain,1,74,0,0,1,74,1.689312000,0.0000
144.75.218.235:44711,<->,138.127.230.78:domain,1,365,0,0,1,365,1.689285000,0.0000
136.25.188.105:32272,<->,199.20.220.230:domain,1,139,0,0,1,139,1.689182000,0.0000
144.75.218.237:32519,<->,8.222.218.199:domain,1,154,0,0,1,154,1.688851000,0.0000
89.86.110.252:57258,<->,136.25.189.86:domain,0,0,1,83,1,83,1.688744000,0.0000
101.176.22.220:48908,<->,144.122.240.242:domain,0,0,1,87,1,87,1.688197000,0.0000
77.47.138.255:17176,<->,247.157.201.195:13222,0,0,1,133,1,133,1.688022000,0.0000
131.144.248.251:12939,<->,129.224.112.252:domain,0,0,1,74,1,74,1.687811000,0.0000
104.136.71.239:m2mservices,<->,102.51.73.163:6889,0,0,1,149,1,149,1.687695000,0.0000
144.75.218.237:42020,<->,8.47.123.78:domain,1,132,0,0,1,132,1.686266000,0.0000
0.200.50.50:34233,<->,20.13.110.223:domain,0,0,1,60,1,60,1.685928000,0.0000
144.75.218.237:29445,<->,138.127.231.62:domain,1,289,0,0,1,289,1.685315000,0.0000
20.191.230.158:6895,<->,18.195.16.153:domain,1,140,0,0,1,140,1.684715000,0.0000
144.75.218.242:41907,<->,8.222.218.207:domain,1,122,0,0,1,122,1.684444000,0.0000
144.75.218.246:7134,<->,8.222.218.199:domain,1,124,0,0,1,124,1.684299000,0.0000
92.27.219.226:51413,<->,80.233.117.143:38028,1,52,0,0,1,52,1.684263000,0.0000
144.75.218.237:51701,<->,8.222.218.198:domain,1,110,0,0,1,110,1.684166000,0.0000
61.95.120.154:61473,<->,34.106.38.67:24297,0,0,1,52,1,52,1.683807000,0.0000
:::57499,<->,:::domain,1,159,0,0,1,159,1.683325000,0.0000
145.16.29.114:61507,<->,138.127.230.158:domain,1,301,0,0,1,301,1.683145000,0.0000
109.1.25.177:20417,<->,27.87.88.245:13226,1,135,0,0,1,135,1.682964000,0.0000
38.227.135.0:51041,<->,92.27.27.165:26606,0,0,1,52,1,52,1.682658000,0.0000
129.34.166.15:7034,<->,101.224.183.195:domain,0,0,1,86,1,86,1.681802000,0.0000
144.75.218.235:53610,<->,138.127.225.15:domain,1,328,0,0,1,328,1.681748000,0.0000
82.165.200.247:52096,<->,80.40.41.29:4433,0,0,1,52,1,52,1.681562000,0.0000
230.91.97.101:22133,<->,92.181.151.40:6889,0,0,1,94,1,94,1.681089000,0.0000
21.15.226.126:55104,<->,20.193.21.16:netbios-ns,0,0,1,82,1,82,1.680878000,0.0000
144.76.43.246:45330,<->,80.56.78.128:domain,0,0,1,113,1,113,1.680314000,0.0000
89.183.104.178:19784,<->,135.241.174.242:15785,1,135,0,0,1,135,1.679966000,0.0000
144.75.218.237:38771,<->,8.222.218.207:domain,1,181,0,0,1,181,1.679561000,0.0000
136.25.188.105:52363,<->,140.136.9.105:domain,1,140,0,0,1,140,1.679529000,0.0000
215.158.2.49:59043,<->,80.56.78.92:domain,0,0,1,87,1,87,1.678554000,0.0000
159.240.189.205:6422,<->,159.69.187.44:domain,0,0,1,67,1,67,1.678423000,0.0000
144.75.218.235:41649,<->,138.127.224.190:domain,1,242,0,0,1,242,1.678348000,0.0000
144.75.218.246:38481,<->,139.252.1.219:domain,1,87,0,0,1,87,1.677961000,0.0000
144.75.218.241:58895,<->,138.127.230.247:domain,1,345,0,0,1,345,1.677820000,0.0000
39.42.64.37:51701,<->,104.241.56.221:18132,1,92,0,0,1,92,1.677744000,0.0000
192.64.193.89:43194,<->,206.55.150.194:26807,1,135,0,0,1,135,1.677706000,0.0000
80.38.62.126:37323,<->,129.19.157.66:domain,1,130,0,0,1,130,1.676854000,0.0000
20.40.80.181:49411,<->,114.250.29.227:10046,1,84,0,0,1,84,1.676724000,0.0000
20.241.43.58:56718,<->,143.125.33.18:domain,1,75,0,0,1,75,1.676693000,0.0000
144.75.218.242:10218,<->,8.222.218.199:domain,1,122,0,0,1,122,1.676656000,0.0000
136.25.189.210:57068,<->,144.72.25.37:domain,1,140,0,0,1,140,1.676646000,0.0000
144.75.218.246:7888,<->,139.252.1.242:domain,1,121,0,0,1,121,1.675172000,0.0000
144.75.218.246:26948,<->,8.222.218.197:domain,1,122,0,0,1,122,1.674679000,0.0000
132.7.214.52:43045,<->,80.41.31.9:42606,0,0,1,169,1,169,1.674669000,0.0000
144.75.218.237:48146,<->,8.222.218.198:domain,1,110,0,0,1,110,1.674232000,0.0000
144.75.218.233:56932,<->,8.222.218.204:domain,1,110,0,0,1,110,1.673396000,0.0000
144.75.218.241:62652,<->,8.222.218.196:domain,1,158,0,0,1,158,1.672881000,0.0000
249.101.211.150:43786,<->,193.21.29.234:23466,1,342,0,0,1,342,1.672597000,0.0000
144.75.218.242:65111,<->,8.222.218.207:domain,1,123,0,0,1,123,1.672483000,0.0000
20.223.116.61:43498,<->,119.95.205.11:domain,1,531,0,0,1,531,1.672274000,0.0000
144.75.218.233:54516,<->,8.222.218.197:domain,1,110,0,0,1,110,1.672240000,0.0000
50.128.49.96:29683,<->,230.115.138.250:12885,1,130,0,0,1,130,1.671525000,0.0000
38.246.57.185:25756,<->,92.27.219.60:25675,0,0,1,52,1,52,1.671381000,0.0000
54.39.40.181:51900,<->,48.53.8.41:51156,0,0,1,52,1,52,1.671117000,0.0000
109.205.55.54:34188,<->,136.25.189.95:domain,0,0,1,84,1,84,1.671076000,0.0000
136.25.188.105:49840,<->,135.88.171.34:domain,1,234,0,0,1,234,1.670518000,0.0000
98.67.155.114:39418,<->,26.215.169.221:domain,1,294,0,0,1,294,1.669211000,0.0000
247.136.220.79:48319,<->,199.12.111.105:1024,1,86,0,0,1,86,1.668593000,0.0000
21.15.226.126:55104,<->,20.193.22.96:netbios-ns,0,0,1,82,1,82,1.668488000,0.0000
92.27.219.204:46392,<->,132.208.70.62:domain,1,647,0,0,1,647,1.667852000,0.0000
144.108.64.179:43507,<->,144.122.240.210:domain,0,0,1,73,1,73,1.667824000,0.0000
59.32.3.142:43611,<->,34.175.70.188:28837,0,0,1,52,1,52,1.667346000,0.0000
144.75.218.242:44860,<->,138.127.225.202:domain,1,281,0,0,1,281,1.666801000,0.0000
144.75.218.246:54023,<->,138.127.230.199:domain,1,156,0,0,1,156,1.666622000,0.0000
99.74.26.170:55188,<->,138.127.229.105:domain,1,202,0,0,1,202,1.665107000,0.0000
39.246.50.147:52312,<->,59.48.50.193:domain,1,75,0,0,1,75,1.665038000,0.0000
92.27.219.244:36461,<->,137.68.202.255:31017,1,52,0,0,1,52,1.664473000,0.0000
45.144.219.2:43013,<->,56.121.61.107:domain,0,0,1,78,1,78,1.664457000,0.0000
21.15.226.126:55104,<->,20.193.22.105:netbios-ns,0,0,1,82,1,82,1.663848000,0.0000
100.94.21.80:50373,<->,195.79.196.122:41490,1,52,0,0,1,52,1.663512000,0.0000
144.75.218.242:13928,<->,8.222.218.199:domain,1,124,0,0,1,124,1.663322000,0.0000
92.27.8.182:65160,<->,207.52.161.205:domain,1,137,0,0,1,137,1.663129000,0.0000
144.75.218.233:53641,<->,114.145.99.171:domain,1,252,0,0,1,252,1.662982000,0.0000
144.75.218.242:21979,<->,8.222.218.199:domain,1,109,0,0,1,109,1.662676000,0.0000
29.157.34.92:34752,<->,20.96.230.181:16609,0,0,1,65,1,65,1.662671000,0.0000
210.158.44.36:15637,<->,129.148.253.17:domain,1,248,0,0,1,248,1.662387000,0.0000
144.75.218.241:19929,<->,8.222.218.204:domain,1,121,0,0,1,121,1.662238000,0.0000
144.75.218.242:16711,<->,8.222.218.199:domain,1,121,0,0,1,121,1.661947000,0.0000
144.108.64.179:16046,<->,144.122.240.161:domain,0,0,1,64,1,64,1.661439000,0.0000
144.75.218.242:38890,<->,102.45.225.190:domain,1,71,0,0,1,71,1.661092000,0.0000
39.148.38.40:46620,<->,124.69.12.108:domain,1,68,0,0,1,68,1.660964000,0.0000
20.59.1.124:55059,<->,207.6.180.170:domain,1,66,0,0,1,66,1.660950000,0.0000
144.75.218.233:27734,<->,8.222.218.204:domain,1,110,0,0,1,110,1.660885000,0.0000
144.75.218.242:40384,<->,8.222.218.204:domain,1,122,0,0,1,122,1.660287000,0.0000
144.75.218.237:44384,<->,8.222.218.204:domain,1,114,0,0,1,114,1.659985000,0.0000
144.75.218.242:10806,<->,8.222.218.204:domain,1,110,0,0,1,110,1.659387000,0.0000
109.222.250.46:59037,<->,110.16.19.26:9074,1,133,0,0,1,133,1.659358000,0.0000
132.200.62.136:36219,<->,132.200.50.12:domain,1,540,0,0,1,540,1.659293000,0.0000
20.182.201.244:61104,<->,141.19.255.22:domain,1,70,0,0,1,70,1.659289000,0.0000
144.76.43.234:47710,<->,80.56.78.94:domain,0,0,1,94,1,94,1.659281000,0.0000
144.75.218.237:33268,<->,120.155.84.97:domain,1,117,0,0,1,117,1.658973000,0.0000
144.75.218.241:57856,<->,8.222.218.196:domain,1,122,0,0,1,122,1.658861000,0.0000
210.220.219.153:50576,<->,136.42.3.53:domain,1,305,0,0,1,305,1.658579000,0.0000
136.25.188.105:62328,<->,135.88.171.34:domain,1,231,0,0,1,231,1.658183000,0.0000
144.75.218.237:41321,<->,8.222.218.199:domain,1,110,0,0,1,110,1.658141000,0.0000
144.75.218.241:53329,<->,139.252.1.253:domain,1,200,0,0,1,200,1.657548000,0.0000
144.75.218.237:63450,<->,156.143.11.242:domain,1,177,0,0,1,177,1.657546000,0.0000
129.175.139.146:65144,<->,29.211.214.254:domain,0,0,1,90,1,90,1.657542000,0.0000
20.3.94.150:46631,<->,220.76.219.196:domain,1,70,0,0,1,70,1.657297000,0.0000
144.75.218.242:46697,<->,8.222.218.199:domain,1,122,0,0,1,122,1.657241000,0.0000
22.73.14.11:55088,<->,109.222.234.11:domain,0,0,1,66,1,66,1.657000000,0.0000
192.64.234.225:60418,<->,125.44.173.36:57553,1,50,0,0,1,50,1.656968000,0.0000
199.20.248.41:59504,<->,129.224.112.252:domain,0,0,1,66,1,66,1.656309000,0.0000
144.75.218.237:37227,<->,8.222.218.197:domain,1,181,0,0,1,181,1.656155000,0.0000
144.75.218.237:8468,<->,141.37.226.95:domain,1,86,0,0,1,86,1.655838000,0.0000
136.25.188.105:62600,<->,135.88.171.34:domain,1,232,0,0,1,232,1.655694000,0.0000
144.75.218.242:60458,<->,8.222.218.199:domain,1,123,0,0,1,123,1.655430000,0.0000
111.150.58.148:58248,<->,138.74.30.45:domain,0,0,1,81,1,81,1.655080000,0.0000
144.75.218.237:54991,<->,8.222.218.204:domain,1,111,0,0,1,111,1.654837000,0.0000
144.75.218.242:63304,<->,8.222.218.204:domain,1,122,0,0,1,122,1.654755000,0.0000
210.158.44.36:64442,<->,129.148.253.17:domain,1,124,0,0,1,124,1.654401000,0.0000
144.75.218.242:63129,<->,8.222.218.204:domain,1,121,0,0,1,121,1.654384000,0.0000
105.200.247.154:41175,<->,98.236.254.250:domain,0,0,1,77,1,77,1.654132000,0.0000
144.75.218.241:iscape,<->,120.155.84.97:domain,1,118,0,0,1,118,1.653775000,0.0000
197.1.230.13:27694,<->,109.1.52.14:6881,0,0,1,135,1,135,1.653519000,0.0000
103.5.47.180:22010,<->,109.222.222.50:domain,0,0,1,66,1,66,1.652481000,0.0000
136.25.188.105:50929,<->,143.194.53.201:domain,1,251,0,0,1,251,1.652165000,0.0000
144.75.218.242:44986,<->,8.222.218.204:domain,1,113,0,0,1,113,1.652151000,0.0000
:::38817,<->,:::domain,1,154,0,0,1,154,1.652138000,0.0000
144.75.218.237:54180,<->,8.222.218.198:domain,1,123,0,0,1,123,1.652049000,0.0000
196.148.128.40:40980,<->,148.157.241.119:radius-acct,1,52,0,0,1,52,1.651483000,0.0000
92.27.27.149:rapidbase,<->,69.175.112.209:netarx,1,99,0,0,1,99,1.651437000,0.0000
56.61.99.23:18261,<->,97.68.226.205:domain,0,0,1,86,1,86,1.651340000,0.0000
93.165.188.179:29428,<->,192.67.179.218:6881,0,0,1,105,1,105,1.650982000,0.0000
248.225.27.2:14186,<->,29.214.217.95:domain,1,141,0,0,1,141,1.650946000,0.0000
8.252.222.232:33466,<->,120.155.86.237:domain,1,134,0,0,1,134,1.650611000,0.0000
144.75.218.242:pds,<->,8.222.218.196:domain,1,114,0,0,1,114,1.650436000,0.0000
144.75.218.237:45495,<->,8.222.218.198:domain,1,111,0,0,1,111,1.649018000,0.0000
8.224.46.33:23129,<->,109.222.242.102:domain,0,0,1,74,1,74,1.648885000,0.0000
125.31.133.96:29825,<->,80.41.32.57:14682,0,0,1,321,1,321,1.648561000,0.0000
136.25.189.210:40784,<->,145.13.164.41:domain,1,111,0,0,1,111,1.647978000,0.0000
158.150.64.93:22944,<->,247.136.209.27:12113,0,0,1,501,1,501,1.647908000,0.0000
39.128.168.188:65203,<->,126.2.6.102:domain,1,96,0,0,1,96,1.647740000,0.0000
144.75.218.246:39402,<->,132.200.124.228:domain,1,155,0,0,1,155,1.647705000,0.0000
144.75.218.246:57645,<->,8.222.218.199:domain,1,123,0,0,1,123,1.647687000,0.0000
144.75.218.246:39875,<->,8.222.218.197:domain,1,110,0,0,1,110,1.647610000,0.0000
50.224.92.54:6358,<->,109.206.164.233:domain,1,161,0,0,1,161,1.647485000,0.0000
144.75.218.241:dbref,<->,8.222.218.207:domain,1,122,0,0,1,122,1.647233000,0.0000
144.75.218.246:4584,<->,8.222.218.197:domain,1,113,0,0,1,113,1.646222000,0.0000
144.75.218.246:i-net-2000-npr,<->,8.222.218.199:domain,1,109,0,0,1,109,1.646167000,0.0000
144.75.218.241:21618,<->,50.149.206.89:domain,1,126,0,0,1,126,1.646038000,0.0000
136.25.188.105:58645,<->,132.5.71.202:domain,1,141,0,0,1,141,1.645734000,0.0000
192.170.179.2:34237,<->,215.158.238.178:12347,0,0,1,1064,1,1064,1.645421000,0.0000
67.219.231.169:17303,<->,145.89.157.42:6881,0,0,1,130,1,130,1.645220000,0.0000
39.144.84.198:31347,<->,194.124.8.102:documentum,1,76,0,0,1,76,1.644286000,0.0000
198.151.3.63:59703,<->,22.59.13.208:domain,0,0,1,72,1,72,1.644161000,0.0000
114.186.133.55:38028,<->,129.224.112.220:domain,0,0,1,86,1,86,1.643727000,0.0000
95.89.187.66:20749,<->,97.126.2.116:domain,0,0,1,66,1,66,1.642561000,0.0000
144.75.218.241:37497,<->,8.222.218.207:domain,1,111,0,0,1,111,1.641977000,0.0000
113.114.28.98:15619,<->,89.183.104.135:6881,0,0,1,52,1,52,1.640328000,0.0000
136.25.189.94:38641,<->,215.158.34.160:12347,1,1064,0,0,1,1064,1.639982000,0.0000
144.75.218.246:versatalk,<->,8.222.218.199:domain,1,157,0,0,1,157,1.638737000,0.0000
120.4.61.182:56307,<->,80.42.191.110:52063,0,0,1,321,1,321,1.638060000,0.0000
144.75.218.246:27484,<->,8.222.218.197:domain,1,109,0,0,1,109,1.637704000,0.0000
77.101.137.113:23101,<->,80.42.181.14:domain,0,0,1,79,1,79,1.637704000,0.0000
92.27.219.227:65178,<->,138.127.224.104:domain,1,371,0,0,1,371,1.637507000,0.0000
144.70.164.220:27019,<->,101.224.172.116:26901,0,0,1,68,1,68,1.637387000,0.0000
159.123.32.28:47712,<->,215.158.2.59:domain,1,89,0,0,1,89,1.636548000,0.0000
144.75.218.237:24717,<->,227.56.35.246:domain,1,150,0,0,1,150,1.636302000,0.0000
144.75.218.237:58430,<->,8.222.218.197:domain,1,157,0,0,1,157,1.636179000,0.0000
20.234.93.132:14182,<->,140.21.17.68:domain,1,68,0,0,1,68,1.635988000,0.0000
144.75.218.237:19699,<->,128.8.21.253:domain,1,159,0,0,1,159,1.635809000,0.0000
144.56.210.43:36325,<->,215.158.238.77:domain,0,0,1,84,1,84,1.635250000,0.0000
105.170.162.64:52524,<->,192.64.101.241:40349,0,0,1,98,1,98,1.634801000,0.0000
144.75.218.233:19153,<->,138.127.230.15:domain,1,366,0,0,1,366,1.634525000,0.0000
39.254.3.217:36889,<->,27.114.181.217:domain,1,88,0,0,1,88,1.633818000,0.0000
144.75.218.241:24137,<->,8.222.218.207:domain,1,123,0,0,1,123,1.633536000,0.0000
100.16.23.197:45584,<->,92.27.219.34:19591,0,0,1,369,1,369,1.633249000,0.0000
144.75.218.246:45999,<->,8.222.218.197:domain,1,123,0,0,1,123,1.632801000,0.0000
144.75.218.246:37926,<->,8.222.218.197:domain,1,111,0,0,1,111,1.632161000,0.0000
144.75.218.235:53564,<->,120.155.84.208:domain,1,150,0,0,1,150,1.632004000,0.0000
144.75.218.235:15739,<->,8.222.218.198:domain,1,122,0,0,1,122,1.631126000,0.0000
144.75.218.242:46793,<->,8.222.218.199:domain,1,123,0,0,1,123,1.629947000,0.0000
144.75.218.242:61942,<->,8.222.218.204:domain,1,110,0,0,1,110,1.629516000,0.0000
101.224.204.193:15746,<->,118.44.93.84:domain,1,227,0,0,1,227,1.629487000,0.0000
111.82.141.173:54460,<->,80.41.15.57:14036,0,0,1,138,1,138,1.629454000,0.0000
144.75.218.237:27019,<->,8.222.218.204:domain,1,110,0,0,1,110,1.628403000,0.0000
80.27.155.182:50473,<->,129.224.112.252:domain,0,0,1,74,1,74,1.628344000,0.0000
92.27.219.39:57932,<->,134.161.237.45:36631,1,52,0,0,1,52,1.627322000,0.0000
89.183.104.171:20313,<->,106.126.137.134:blackjack,1,105,0,0,1,105,1.627095000,0.0000
106.158.67.80:45595,<->,92.27.219.189:41442,0,0,1,52,1,52,1.626298000,0.0000
121.209.106.187:63702,<->,92.27.219.130:35401,0,0,1,99,1,99,1.625717000,0.0000
144.75.218.235:6556,<->,8.222.218.197:domain,1,153,0,0,1,153,1.625614000,0.0000
215.158.103.219:43408,<->,129.223.93.3:domain,1,795,0,0,1,795,1.624806000,0.0000
20.185.113.162:40294,<->,138.86.243.67:domain,1,66,0,0,1,66,1.624630000,0.0000
144.75.218.237:36562,<->,120.155.84.97:domain,1,236,0,0,1,236,1.624612000,0.0000
144.75.218.242:55071,<->,8.222.218.196:domain,1,138,0,0,1,138,1.624611000,0.0000
57.248.174.7:60988,<->,192.67.165.98:54104,0,0,1,52,1,52,1.624344000,0.0000
116.145.113.34:64915,<->,80.41.36.78:15074,0,0,1,130,1,130,1.623068000,0.0000
144.75.218.241:44556,<->,138.127.231.115:domain,1,366,0,0,1,366,1.621956000,0.0000
144.75.218.246:38165,<->,8.222.218.199:domain,1,111,0,0,1,111,1.621685000,0.0000
144.75.218.246:61168,<->,99.168.7.150:domain,1,154,0,0,1,154,1.621659000,0.0000
144.75.218.242:19923,<->,149.224.49.236:domain,1,70,0,0,1,70,1.620104000,0.0000
39.129.92.211:61332,<->,140.145.90.254:domain,1,70,0,0,1,70,1.620014000,0.0000
100.230.7.117:34553,<->,220.82.62.48:33435,0,0,1,50,1,50,1.619799000,0.0000
144.75.218.242:37943,<->,8.222.218.199:domain,1,181,0,0,1,181,1.619601000,0.0000
48.105.201.130:52397,<->,92.27.219.216:39821,0,0,1,1437,1,1437,1.619182000,0.0000
:::37512,<->,:::domain,1,184,0,0,1,184,1.619094000,0.0000
:::32894,<->,:::domain,1,184,0,0,1,184,1.618969000,0.0000
144.75.218.242:23697,<->,8.222.218.196:domain,1,110,0,0,1,110,1.618073000,0.0000
144.75.218.241:41268,<->,8.222.218.207:domain,1,114,0,0,1,114,1.617133000,0.0000
192.67.161.143:46809,<->,105.71.224.108:25607,1,130,0,0,1,130,1.616931000,0.0000
247.136.249.234:51413,<->,124.19.52.147:6881,1,332,0,0,1,332,1.616494000,0.0000
144.75.218.241:38988,<->,8.222.218.207:domain,1,123,0,0,1,123,1.616186000,0.0000
105.113.53.216:5091,<->,97.168.89.179:domain,0,0,1,78,1,78,1.615493000,0.0000
:::29771,<->,:::domain,1,503,0,0,1,503,1.615423000,0.0000
106.42.39.78:59059,<->,89.183.104.235:45028,0,0,1,52,1,52,1.615149000,0.0000
141.95.30.8:58255,<->,144.64.139.146:domain,0,0,1,78,1,78,1.614940000,0.0000
144.75.218.237:21356,<->,120.155.84.97:domain,1,230,0,0,1,230,1.614184000,0.0000
92.27.219.211:60451,<->,29.170.153.193:35064,1,52,0,0,1,52,1.613614000,0.0000
136.25.188.212:39811,<->,122.158.53.79:domain,1,106,0,0,1,106,1.613255000,0.0000
144.75.218.241:11384,<->,8.222.218.196:domain,1,113,0,0,1,113,1.613103000,0.0000
144.75.218.241:46894,<->,8.222.218.196:domain,1,111,0,0,1,111,1.612903000,0.0000
120.190.31.252:41881,<->,133.178.227.4:domain,0,0,1,85,1,85,1.612790000,0.0000
50.213.212.120:36386,<->,109.222.233.46:domain,0,0,1,72,1,72,1.612618000,0.0000
136.25.188.105:59106,<->,132.43.156.54:domain,1,127,0,0,1,127,1.612600000,0.0000
194.248.157.78:37219,<->,80.42.184.239:s3db,0,0,1,273,1,273,1.612563000,0.0000
193.46.99.104:21350,<->,92.27.219.58:6881,0,0,1,129,1,129,1.612422000,0.0000
144.75.218.241:55963,<->,120.155.84.97:domain,1,117,0,0,1,117,1.612352000,0.0000
220.87.90.39:19170,<->,77.10.246.184:15798,1,130,0,0,1,130,1.611286000,0.0000
144.75.218.241:5532,<->,33.238.69.117:domain,1,133,0,0,1,133,1.611165000,0.0000
92.27.27.144:47117,<->,139.252.1.254:domain,1,371,0,0,1,371,1.610345000,0.0000
53.165.88.118:26985,<->,246.253.248.211:domain,0,0,1,87,1,87,1.610302000,0.0000
144.75.218.246:14314,<->,8.222.218.204:domain,1,123,0,0,1,123,1.609775000,0.0000
144.75.218.242:41874,<->,8.222.218.199:domain,1,121,0,0,1,121,1.609431000,0.0000
144.75.218.241:30703,<->,8.222.218.204:domain,1,119,0,0,1,119,1.609068000,0.0000
111.147.103.177:51413,<->,74.143.202.144:vce,1,133,0,0,1,133,1.608962000,0.0000
192.64.245.55:51413,<->,64.145.129.216:15479,1,133,0,0,1,133,1.608688000,0.0000
38.21.156.204:56633,<->,20.232.230.111:netbios-ns,0,0,1,82,1,82,1.608433000,0.0000
158.197.29.201:56191,<->,132.249.70.62:domain,0,0,1,79,1,79,1.608361000,0.0000
144.75.218.237:7486,<->,8.222.218.207:domain,1,123,0,0,1,123,1.608300000,0.0000
21.15.226.126:55104,<->,20.193.23.29:netbios-ns,0,0,1,82,1,82,1.608183000,0.0000
144.75.218.242:43984,<->,53.245.2.193:domain,1,389,0,0,1,389,1.607938000,0.0000
33.122.48.183:41142,<->,109.222.242.9:bacula-dir,0,0,1,135,1,135,1.607627000,0.0000
144.75.218.235:25349,<->,8.222.218.197:domain,1,110,0,0,1,110,1.606633000,0.0000
144.75.218.237:14169,<->,8.222.218.197:domain,1,121,0,0,1,121,1.606393000,0.0000
144.75.218.241:40997,<->,8.222.218.204:domain,1,113,0,0,1,113,1.606160000,0.0000
92.26.149.106:46772,<->,148.187.166.178:snmp,1,87,0,0,1,87,1.605980000,0.0000
144.75.218.242:58149,<->,8.222.218.207:domain,1,113,0,0,1,113,1.605726000,0.0000
144.75.218.237:53925,<->,120.155.84.97:domain,1,144,0,0,1,144,1.604802000,0.0000
69.132.194.25:55635,<->,133.178.227.6:domain,0,0,1,85,1,85,1.604721000,0.0000
144.75.218.237:49520,<->,8.222.218.197:domain,1,111,0,0,1,111,1.604405000,0.0000
144.75.218.242:paycash-online,<->,138.127.225.15:domain,1,195,0,0,1,195,1.604069000,0.0000
144.75.218.241:28921,<->,138.127.231.115:domain,1,366,0,0,1,366,1.604013000,0.0000
144.75.218.237:21636,<->,8.222.218.204:domain,1,127,0,0,1,127,1.603809000,0.0000
100.93.156.236:53007,<->,104.137.94.112:1024,1,52,0,0,1,52,1.603653000,0.0000
20.108.208.6:58606,<->,107.124.169.151:domain,1,138,0,0,1,138,1.603393000,0.0000
144.75.218.237:36430,<->,143.204.138.237:domain,1,147,0,0,1,147,1.602866000,0.0000
144.75.218.233:51070,<->,139.252.1.240:domain,1,176,0,0,1,176,1.602829000,0.0000
207.79.237.54:16507,<->,80.42.179.14:6881,0,0,1,133,1,133,1.602740000,0.0000
107.27.243.242:20204,<->,92.27.209.223:xbox,0,0,1,64,1,64,1.602726000,0.0000
92.27.219.31:43465,<->,48.106.6.25:1024,1,52,0,0,1,52,1.601276000,0.0000
144.75.218.246:26337,<->,8.222.218.197:domain,1,123,0,0,1,123,1.601052000,0.0000
125.22.183.127:56346,<->,192.64.229.17:54475,0,0,1,50,1,50,1.601022000,0.0000
6.255.241.212:64108,<->,129.224.112.252:domain,0,0,1,71,1,71,1.600850000,0.0000
65.63.203.208:11206,<->,89.183.104.248:6881,0,0,1,52,1,52,1.600624000,0.0000
144.75.218.242:patrol-coll,<->,8.222.218.207:domain,1,110,0,0,1,110,1.600437000,0.0000
148.145.2.123:48068,<->,80.38.23.182:domain,0,0,1,83,1,83,1.600117000,0.0000
21.15.226.126:55104,<->,20.193.23.151:netbios-ns,0,0,1,82,1,82,1.600078000,0.0000
:::33408,<->,:::domain,1,503,0,0,1,503,1.598668000,0.0000
92.27.219.242:43880,<->,104.232.149.213:ndmp,1,1470,0,0,1,1470,1.598402000,0.0000
144.75.218.242:51600,<->,8.222.218.199:domain,1,122,0,0,1,122,1.598175000,0.0000
215.158.197.2:43545,<->,29.211.214.32:domain,0,0,1,95,1,95,1.597690000,0.0000
144.75.218.237:54615,<->,132.107.75.195:domain,1,139,0,0,1,139,1.597683000,0.0000
144.75.218.241:47087,<->,193.46.97.52:domain,1,255,0,0,1,255,1.597646000,0.0000
106.157.38.242:33959,<->,108.134.108.77:12709,0,0,1,50,1,50,1.597421000,0.0000
144.75.218.242:hpiod,<->,8.222.218.207:domain,1,157,0,0,1,157,1.597245000,0.0000
100.94.116.200:65263,<->,207.82.255.101:6881,1,133,0,0,1,133,1.596787000,0.0000
230.126.217.254:55735,<->,248.239.72.227:opsession-prxy,0,0,1,52,1,52,1.596537000,0.0000
144.75.218.241:39809,<->,8.222.218.204:domain,1,125,0,0,1,125,1.596531000,0.0000
0.200.50.50:34233,<->,20.13.110.159:domain,0,0,1,60,1,60,1.596399000,0.0000
144.75.218.237:50533,<->,208.197.123.108:domain,1,173,0,0,1,173,1.596277000,0.0000
101.106.122.69:55017,<->,92.27.219.153:29250,0,0,1,135,1,135,1.596082000,0.0000
125.152.68.220:21382,<->,144.64.139.146:domain,0,0,1,84,1,84,1.595810000,0.0000
20.253.43.110:56751,<->,148.174.57.174:domain,1,75,0,0,1,75,1.595799000,0.0000
8.176.8.177:50539,<->,192.171.13.189:domain,1,157,0,0,1,157,1.595755000,0.0000
215.158.103.219:18957,<->,138.12.41.133:domain,1,260,0,0,1,260,1.595636000,0.0000
144.75.218.233:27612,<->,8.222.218.204:domain,1,122,0,0,1,122,1.595585000,0.0000
144.75.218.233:20603,<->,8.222.218.196:domain,1,109,0,0,1,109,1.595463000,0.0000
99.72.128.44:64381,<->,132.43.156.81:domain,1,140,0,0,1,140,1.594971000,0.0000
80.56.91.244:65436,<->,8.176.8.66:confluent,0,0,1,1112,1,1112,1.594815000,0.0000
108.134.108.77:43583,<->,106.157.38.242:33959,1,50,0,0,1,50,1.594129000,0.0000
20.83.31.66:63091,<->,108.42.106.231:domain,1,66,0,0,1,66,1.594100000,0.0000
220.187.88.96:63045,<->,92.27.219.166:http-alt,0,0,1,101,1,101,1.593879000,0.0000
8.176.8.177:57101,<->,192.171.13.189:domain,1,157,0,0,1,157,1.593707000,0.0000
50.50.242.205:39446,<->,133.178.226.161:domain,0,0,1,86,1,86,1.593203000,0.0000
144.75.218.237:a3-sdunode,<->,8.222.218.198:domain,1,109,0,0,1,109,1.592779000,0.0000
144.75.218.237:62693,<->,8.222.218.198:domain,1,126,0,0,1,126,1.592777000,0.0000
144.75.218.242:53292,<->,8.222.218.199:domain,1,123,0,0,1,123,1.592092000,0.0000
152.139.138.6:60046,<->,20.65.179.36:pdp,0,0,1,120,1,120,1.591441000,0.0000
210.158.44.7:48158,<->,112.219.53.218:domain,1,101,0,0,1,101,1.591226000,0.0000
144.75.218.235:41976,<->,54.38.169.95:domain,1,126,0,0,1,126,1.590857000,0.0000
144.75.218.246:34365,<->,8.222.218.204:domain,1,110,0,0,1,110,1.590707000,0.0000
144.75.218.241:sercomm-wlink,<->,8.222.218.204:domain,1,157,0,0,1,157,1.590053000,0.0000
136.25.188.105:50061,<->,143.194.53.201:domain,1,139,0,0,1,139,1.589796000,0.0000
39.131.216.132:30450,<->,149.99.133.169:domain,1,75,0,0,1,75,1.589670000,0.0000
144.75.218.246:52976,<->,8.222.218.204:domain,1,153,0,0,1,153,1.589052000,0.0000
110.243.222.128:52385,<->,92.27.27.144:38547,0,0,1,135,1,135,1.589025000,0.0000
144.75.218.246:65155,<->,8.222.218.197:domain,1,122,0,0,1,122,1.589021000,0.0000
144.75.218.237:55981,<->,138.127.224.106:domain,1,351,0,0,1,351,1.588698000,0.0000
27.188.163.162:i-net-2000-npr,<->,109.1.16.32:sip,0,0,1,444,1,444,1.588608000,0.0000
144.75.218.246:15496,<->,8.222.218.197:domain,1,239,0,0,1,239,1.588404000,0.0000
202.178.8.208:58247,<->,137.21.3.65:domain,0,0,1,78,1,78,1.587992000,0.0000
144.75.218.235:44297,<->,8.222.218.197:domain,1,119,0,0,1,119,1.587654000,0.0000
106.126.193.90:54360,<->,92.27.27.165:16762,0,0,1,52,1,52,1.587580000,0.0000
39.160.108.83:56209,<->,124.119.26.152:domain,1,70,0,0,1,70,1.587476000,0.0000
38.93.187.200:50349,<->,98.232.172.60:domain,0,0,1,84,1,84,1.587233000,0.0000
93.181.154.55:43965,<->,92.27.219.18:38511,0,0,1,263,1,263,1.587113000,0.0000
109.0.243.153:35920,<->,152.111.129.170:14588,1,133,0,0,1,133,1.586983000,0.0000
121.36.81.175:47610,<->,92.27.219.244:36461,0,0,1,52,1,52,1.586829000,0.0000
159.64.148.27:62245,<->,80.38.7.6:domain,0,0,1,73,1,73,1.586101000,0.0000
108.134.108.77:34185,<->,106.157.38.242:33959,1,50,0,0,1,50,1.585763000,0.0000
20.56.46.101:33929,<->,57.156.192.130:domain,1,68,0,0,1,68,1.585617000,0.0000
27.188.163.162:i-net-2000-npr,<->,109.1.16.130:sip,0,0,1,443,1,443,1.585328000,0.0000
144.75.218.241:36297,<->,120.155.84.97:domain,1,149,0,0,1,149,1.585278000,0.0000
20.149.248.50:36956,<->,97.126.113.124:domain,0,0,1,75,1,75,1.585099000,0.0000
136.25.188.105:41871,<->,235.149.63.46:domain,1,534,0,0,1,534,1.584890000,0.0000
144.75.218.241:29101,<->,120.155.84.97:domain,1,239,0,0,1,239,1.584860000,0.0000
144.75.218.235:27884,<->,128.124.28.90:domain,1,126,0,0,1,126,1.584701000,0.0000
243.117.125.52:23446,<->,129.224.112.252:domain,0,0,1,76,1,76,1.584701000,0.0000
136.25.188.105:60484,<->,135.88.171.34:domain,1,230,0,0,1,230,1.583795000,0.0000
144.75.218.235:eis,<->,8.222.218.198:domain,1,111,0,0,1,111,1.583629000,0.0000
8.176.8.191:36188,<->,111.151.107.247:domain,1,154,0,0,1,154,1.582332000,0.0000
144.75.218.237:38743,<->,120.155.84.97:domain,1,122,0,0,1,122,1.581595000,0.0000
192.64.215.241:52590,<->,0.236.1.58:12950,1,130,0,0,1,130,1.581009000,0.0000
144.75.218.246:62445,<->,249.85.53.53:domain,1,155,0,0,1,155,1.580476000,0.0000
144.75.218.233:48730,<->,138.127.225.148:domain,1,366,0,0,1,366,1.579600000,0.0000
101.70.98.5:63562,<->,193.46.99.193:19133,1,300,0,0,1,300,1.579447000,0.0000
144.75.218.237:41854,<->,8.222.218.207:domain,1,122,0,0,1,122,1.579408000,0.0000
80.41.31.15:57403,<->,115.190.178.7:50932,1,52,0,0,1,52,1.579153000,0.0000
141.95.30.9:56162,<->,129.224.112.252:domain,0,0,1,78,1,78,1.578831000,0.0000
92.169.159.102:58338,<->,144.69.82.139:domain,0,0,1,71,1,71,1.578807000,0.0000
119.5.13.52:25855,<->,133.54.28.219:domain,0,0,1,79,1,79,1.578524000,0.0000
38.21.156.204:56633,<->,20.232.230.97:netbios-ns,0,0,1,82,1,82,1.577444000,0.0000
136.25.188.105:29010,<->,128.171.253.114:domain,1,87,0,0,1,87,1.577350000,0.0000
80.41.8.174:63836,<->,115.188.244.99:59744,1,84,0,0,1,84,1.577176000,0.0000
20.134.11.149:24931,<->,116.227.172.225:domain,1,88,0,0,1,88,1.576926000,0.0000
53.187.78.215:12268,<->,39.15.169.14:domain,0,0,1,87,1,87,1.576506000,0.0000
136.25.188.40:45380,<->,136.95.254.242:domain,1,103,0,0,1,103,1.576500000,0.0000
8.228.208.40:53309,<->,206.130.208.12:vlsi-lm,1,97,0,0,1,97,1.576173000,0.0000
139.249.90.204:52004,<->,92.27.51.139:ntp,1,80,0,0,1,80,1.576146000,0.0000
109.1.13.143:60526,<->,159.146.64.210:12340,1,91,0,0,1,91,1.575586000,0.0000
215.158.103.219:62364,<->,193.119.135.81:domain,1,162,0,0,1,162,1.574744000,0.0000
53.187.46.37:9276,<->,39.15.169.14:domain,0,0,1,88,1,88,1.574316000,0.0000
123.237.154.160:61749,<->,248.239.149.59:6881,0,0,1,319,1,319,1.574246000,0.0000
101.106.122.69:51015,<->,89.183.104.239:51015,0,0,1,99,1,99,1.574081000,0.0000
144.75.218.233:55590,<->,137.250.6.109:domain,1,108,0,0,1,108,1.573384000,0.0000
144.75.218.246:41807,<->,8.222.218.199:domain,1,111,0,0,1,111,1.573170000,0.0000
144.75.218.235:11950,<->,8.222.218.197:domain,1,110,0,0,1,110,1.573146000,0.0000
145.242.126.178:amberon,<->,53.77.205.113:amberon,1,220,0,0,1,220,1.573017000,0.0000
50.186.19.114:49706,<->,48.53.216.116:27246,0,0,1,120,1,120,1.572792000,0.0000
100.93.135.55:63945,<->,251.24.48.90:14793,1,52,0,0,1,52,1.572279000,0.0000
128.146.85.176:6396,<->,50.224.96.35:domain,0,0,1,68,1,68,1.571893000,0.0000
126.231.183.55:43003,<->,220.55.123.183:domain,0,0,1,84,1,84,1.571488000,0.0000
144.75.218.246:44485,<->,8.47.122.178:domain,1,100,0,0,1,100,1.570797000,0.0000
141.37.242.255:51651,<->,92.27.219.238:http-alt,0,0,1,133,1,133,1.570337000,0.0000
144.75.218.237:47653,<->,8.222.218.207:domain,1,123,0,0,1,123,1.570263000,0.0000
195.65.1.162:39162,<->,101.224.204.141:domain,0,0,1,91,1,91,1.570239000,0.0000
144.75.218.235:25669,<->,138.127.231.195:domain,1,276,0,0,1,276,1.570212000,0.0000
91.231.118.234:26854,<->,101.224.183.152:domain,0,0,1,85,1,85,1.570135000,0.0000
29.220.173.205:51413,<->,89.183.104.182:21057,0,0,1,1434,1,1434,1.569889000,0.0000
136.25.188.105:58972,<->,140.136.9.105:domain,1,279,0,0,1,279,1.568328000,0.0000
98.23.111.141:38921,<->,92.27.209.104:14221,0,0,1,50,1,50,1.568212000,0.0000
144.75.218.241:16548,<->,8.222.218.196:domain,1,110,0,0,1,110,1.567851000,0.0000
144.75.218.235:47010,<->,53.214.223.92:domain,1,93,0,0,1,93,1.567525000,0.0000
80.56.91.244:65436,<->,6.73.247.8:confluent,0,0,1,1112,1,1112,1.566556000,0.0000
144.75.218.235:57936,<->,8.222.218.197:domain,1,110,0,0,1,110,1.565987000,0.0000
210.156.112.182:44822,<->,157.208.214.27:12568,1,130,0,0,1,130,1.565717000,0.0000
144.75.218.242:32586,<->,8.222.218.207:domain,1,111,0,0,1,111,1.565675000,0.0000
100.225.82.253:19257,<->,144.64.137.156:domain,0,0,1,83,1,83,1.565586000,0.0000
0.200.50.50:34233,<->,20.13.110.112:domain,0,0,1,60,1,60,1.564647000,0.0000
92.169.158.35:accelenet-data,<->,101.224.183.152:domain,0,0,1,87,1,87,1.564495000,0.0000
74.1.12.213:16314,<->,129.224.112.252:domain,0,0,1,84,1,84,1.563903000,0.0000
144.75.218.242:45890,<->,8.222.218.199:domain,1,150,0,0,1,150,1.562382000,0.0000
48.131.156.46:61165,<->,246.254.97.149:domain,0,0,1,93,1,93,1.562242000,0.0000
16.137.241.141:25230,<->,66.244.79.32:domain,1,68,0,0,1,68,1.562149000,0.0000
89.183.104.136:58346,<->,148.26.203.60:49311,1,367,0,0,1,367,1.562017000,0.0000
126.219.197.235:45560,<->,215.158.239.218:domain,0,0,1,90,1,90,1.561974000,0.0000
126.219.197.235:60747,<->,99.74.87.243:domain,0,0,1,91,1,91,1.561885000,0.0000
144.75.218.242:15769,<->,144.95.158.205:domain,1,126,0,0,1,126,1.561594000,0.0000
89.183.104.255:62348,<->,131.210.124.194:51413,1,62,0,0,1,62,1.561532000,0.0000
139.163.13.117:59686,<->,210.228.29.4:domain,1,113,0,0,1,113,1.561450000,0.0000
144.75.218.235:48386,<->,8.222.218.198:domain,1,125,0,0,1,125,1.560158000,0.0000
144.75.218.242:54027,<->,8.222.218.204:domain,1,110,0,0,1,110,1.560122000,0.0000
40.204.4.71:40567,<->,109.1.31.44:27058,0,0,1,351,1,351,1.560071000,0.0000
144.75.218.233:44589,<->,100.185.121.91:domain,1,128,0,0,1,128,1.559870000,0.0000
144.75.218.241:25974,<->,8.222.218.207:domain,1,125,0,0,1,125,1.559527000,0.0000
144.75.218.246:10358,<->,8.222.218.197:domain,1,110,0,0,1,110,1.559337000,0.0000
144.75.218.246:7911,<->,8.222.218.199:domain,1,111,0,0,1,111,1.558952000,0.0000
6.124.44.105:aes-discovery,<->,50.224.121.116:domain,0,0,1,70,1,70,1.558765000,0.0000
136.25.188.212:40271,<->,111.20.61.178:domain,1,80,0,0,1,80,1.558701000,0.0000
136.25.188.105:55697,<->,143.46.12.204:domain,1,142,0,0,1,142,1.558270000,0.0000
144.75.218.235:12153,<->,8.222.218.204:domain,1,113,0,0,1,113,1.558260000,0.0000
136.169.91.98:56703,<->,215.158.238.145:12347,0,0,1,1064,1,1064,1.558025000,0.0000
0.200.50.50:34233,<->,20.13.110.101:domain,0,0,1,60,1,60,1.557996000,0.0000
8.252.222.118:37950,<->,192.171.13.190:domain,1,128,0,0,1,128,1.557869000,0.0000
144.75.218.237:60110,<->,138.127.230.213:domain,1,177,0,0,1,177,1.557167000,0.0000
146.226.246.84:60602,<->,129.224.112.252:domain,0,0,1,66,1,66,1.556932000,0.0000
136.25.188.212:46011,<->,139.241.75.106:domain,1,134,0,0,1,134,1.556803000,0.0000
144.75.218.235:10939,<->,138.127.225.87:domain,1,355,0,0,1,355,1.556160000,0.0000
144.75.218.237:43935,<->,8.222.218.207:domain,1,121,0,0,1,121,1.555853000,0.0000
98.23.111.141:46660,<->,220.55.175.210:18061,0,0,1,50,1,50,1.555768000,0.0000
145.213.37.27:45311,<->,136.129.94.107:domain,0,0,1,84,1,84,1.555755000,0.0000
92.27.8.182:57460,<->,199.25.247.19:domain,1,162,0,0,1,162,1.554744000,0.0000
144.108.64.181:12731,<->,144.122.240.230:domain,0,0,1,67,1,67,1.554649000,0.0000
92.27.219.41:32671,<->,134.97.242.140:22873,1,52,0,0,1,52,1.554629000,0.0000
144.75.218.235:35873,<->,8.222.218.198:domain,1,110,0,0,1,110,1.554541000,0.0000
20.238.50.141:swiftnet,<->,143.22.127.186:domain,1,72,0,0,1,72,1.554499000,0.0000
144.75.218.242:62109,<->,8.222.218.199:domain,1,181,0,0,1,181,1.554048000,0.0000
144.75.218.241:ivecon-port,<->,8.222.218.207:domain,1,121,0,0,1,121,1.553795000,0.0000
144.75.218.246:58923,<->,8.222.218.197:domain,1,124,0,0,1,124,1.553420000,0.0000
80.40.31.154:29704,<->,58.164.24.130:19774,1,130,0,0,1,130,1.553057000,0.0000
144.75.218.241:7233,<->,8.222.218.207:domain,1,113,0,0,1,113,1.552867000,0.0000
74.1.12.213:24871,<->,129.224.112.252:domain,0,0,1,94,1,94,1.552751000,0.0000
144.75.218.233:61502,<->,8.47.123.78:domain,1,169,0,0,1,169,1.552634000,0.0000
80.56.91.244:65436,<->,215.158.239.253:confluent,0,0,1,1112,1,1112,1.552571000,0.0000
144.75.218.241:15881,<->,120.155.84.97:domain,1,112,0,0,1,112,1.552545000,0.0000
144.75.218.233:50931,<->,8.222.218.204:domain,1,138,0,0,1,138,1.552401000,0.0000
109.222.214.116:42577,<->,29.94.101.68:40727,1,325,0,0,1,325,1.551803000,0.0000
247.136.252.191:23610,<->,198.182.27.178:8621,1,133,0,0,1,133,1.551632000,0.0000
100.185.124.124:51827,<->,129.224.112.252:domain,0,0,1,61,1,61,1.550413000,0.0000
89.183.104.172:54312,<->,92.180.16.22:20857,1,52,0,0,1,52,1.550215000,0.0000
144.75.218.237:22431,<->,8.222.218.199:domain,1,122,0,0,1,122,1.549783000,0.0000
144.75.218.235:21091,<->,138.127.231.213:domain,1,240,0,0,1,240,1.549539000,0.0000
138.53.86.206:40789,<->,129.224.112.252:domain,0,0,1,62,1,62,1.549019000,0.0000
149.178.48.72:44492,<->,129.224.112.252:domain,0,0,1,74,1,74,1.548912000,0.0000
144.75.218.237:18718,<->,8.222.218.198:domain,1,153,0,0,1,153,1.548857000,0.0000
101.229.93.34:18730,<->,132.249.70.213:domain,0,0,1,106,1,106,1.548777000,0.0000
92.27.219.53:60556,<->,102.82.77.160:48350,1,300,0,0,1,300,1.547896000,0.0000
111.146.169.0:55294,<->,33.219.156.216:34618,1,138,0,0,1,138,1.547284000,0.0000
144.75.218.237:23246,<->,8.222.218.204:domain,1,123,0,0,1,123,1.546427000,0.0000
57.191.84.224:pgps,<->,109.222.223.88:domain,0,0,1,75,1,75,1.546137000,0.0000
119.115.173.150:14610,<->,111.147.164.221:6881,0,0,1,61,1,61,1.545913000,0.0000
192.64.201.230:20479,<->,40.221.208.240:20026,1,102,0,0,1,102,1.545607000,0.0000
89.183.104.237:60151,<->,118.119.253.178:50355,1,260,0,0,1,260,1.545261000,0.0000
238.127.3.152:58504,<->,220.55.174.117:28016,0,0,1,57,1,57,1.545204000,0.0000
114.88.250.79:21715,<->,139.105.159.223:domain,0,0,1,95,1,95,1.545052000,0.0000
92.169.159.102:60064,<->,144.69.82.139:domain,0,0,1,71,1,71,1.544996000,0.0000
39.146.43.127:7372,<->,131.208.217.29:domain,1,74,0,0,1,74,1.544869000,0.0000
34.245.12.50:9934,<->,147.177.54.28:domain,1,80,0,0,1,80,1.544642000,0.0000
89.183.104.173:49330,<->,119.103.17.195:6881,1,263,0,0,1,263,1.544546000,0.0000
215.158.103.206:29708,<->,159.151.93.228:domain,1,120,0,0,1,120,1.544044000,0.0000
39.235.152.130:22345,<->,130.173.16.208:domain,1,67,0,0,1,67,1.543878000,0.0000
141.92.221.22:22915,<->,129.224.112.252:domain,0,0,1,74,1,74,1.543104000,0.0000
92.27.219.54:56598,<->,220.202.52.77:51413,1,317,0,0,1,317,1.542598000,0.0000
144.75.218.237:26029,<->,8.222.218.198:domain,1,121,0,0,1,121,1.542085000,0.0000
144.75.218.235:32747,<->,8.222.218.204:domain,1,111,0,0,1,111,1.542071000,0.0000
135.87.163.103:36832,<->,92.27.27.148:34629,0,0,1,135,1,135,1.541453000,0.0000
205.236.111.245:59305,<->,92.27.27.165:16762,0,0,1,52,1,52,1.541242000,0.0000
144.75.218.237:15242,<->,8.222.218.204:domain,1,190,0,0,1,190,1.540975000,0.0000
144.93.121.86:36321,<->,144.93.125.49:32253,1,104,0,0,1,104,1.540797000,0.0000
144.75.218.233:44364,<->,8.222.218.204:domain,1,153,0,0,1,153,1.540651000,0.0000
92.27.219.175:29830,<->,106.219.100.218:10254,1,373,0,0,1,373,1.539691000,0.0000
144.75.218.242:55911,<->,138.127.224.106:domain,1,351,0,0,1,351,1.539606000,0.0000
39.38.26.213:21121,<->,0.52.16.104:domain,1,94,0,0,1,94,1.539307000,0.0000
137.171.199.224:12301,<->,126.219.141.190:domain,1,99,0,0,1,99,1.538803000,0.0000
100.225.82.255:30866,<->,132.249.70.213:domain,0,0,1,117,1,117,1.538675000,0.0000
:::11476,<->,:::domain,1,160,0,0,1,160,1.538542000,0.0000
136.25.188.105:54362,<->,112.60.14.238:domain,1,233,0,0,1,233,1.538444000,0.0000
21.15.226.126:55104,<->,20.193.24.49:netbios-ns,0,0,1,82,1,82,1.537970000,0.0000
59.46.180.152:irdmi,<->,210.156.125.55:6881,0,0,1,133,1,133,1.537618000,0.0000
92.27.8.182:35802,<->,138.127.224.192:domain,1,166,0,0,1,166,1.537529000,0.0000
149.178.48.81:42505,<->,129.224.112.252:domain,0,0,1,75,1,75,1.537093000,0.0000
136.25.188.105:60060,<->,135.88.171.34:domain,1,288,0,0,1,288,1.537077000,0.0000
144.75.218.246:63890,<->,8.222.218.197:domain,1,110,0,0,1,110,1.536995000,0.0000
144.75.218.237:30594,<->,8.222.218.204:domain,1,111,0,0,1,111,1.536691000,0.0000
129.254.99.157:43301,<->,129.224.112.252:domain,0,0,1,68,1,68,1.536338000,0.0000
29.143.180.235:44973,<->,89.216.126.106:6881,0,0,1,138,1,138,1.536206000,0.0000
215.158.103.219:26322,<->,206.226.66.178:domain,1,84,0,0,1,84,1.535867000,0.0000
39.0.193.227:51461,<->,148.139.107.99:domain,1,74,0,0,1,74,1.535490000,0.0000
92.27.8.182:25423,<->,138.127.224.192:domain,1,166,0,0,1,166,1.535331000,0.0000
144.75.218.246:34768,<->,139.252.1.230:domain,1,90,0,0,1,90,1.534645000,0.0000
89.139.241.98:19482,<->,148.241.93.224:domain,1,190,0,0,1,190,1.534593000,0.0000
144.75.218.233:45473,<->,8.222.218.197:domain,1,111,0,0,1,111,1.534473000,0.0000
136.25.188.105:61348,<->,140.136.9.105:domain,1,185,0,0,1,185,1.534265000,0.0000
144.75.218.237:60673,<->,8.222.218.197:domain,1,110,0,0,1,110,1.534009000,0.0000
127.87.18.39:37641,<->,247.136.208.244:25511,0,0,1,52,1,52,1.532853000,0.0000
123.136.84.103:24042,<->,89.183.104.156:11197,0,0,1,321,1,321,1.532729000,0.0000
116.235.64.146:51413,<->,89.183.104.243:11480,0,0,1,62,1,62,1.532549000,0.0000
224.154.101.235:37667,<->,20.202.18.54:33435,0,0,1,50,1,50,1.532395000,0.0000
106.170.251.39:12570,<->,210.221.111.210:6881,0,0,1,100,1,100,1.532321000,0.0000
144.75.218.242:44378,<->,138.127.230.47:domain,1,366,0,0,1,366,1.531194000,0.0000
247.136.249.234:51413,<->,149.110.42.130:26474,1,401,0,0,1,401,1.531191000,0.0000
129.175.139.193:61134,<->,29.211.214.254:domain,0,0,1,92,1,92,1.530710000,0.0000
92.27.219.243:44635,<->,8.47.188.160:domain,1,92,0,0,1,92,1.530616000,0.0000
100.225.82.255:21706,<->,132.249.70.213:domain,0,0,1,101,1,101,1.530531000,0.0000
114.145.102.4:19601,<->,129.224.112.252:domain,0,0,1,80,1,80,1.530522000,0.0000
136.25.188.105:55295,<->,131.49.122.22:domain,1,121,0,0,1,121,1.530386000,0.0000
144.75.218.242:47162,<->,8.222.218.196:domain,1,124,0,0,1,124,1.530287000,0.0000
20.188.180.53:53430,<->,195.102.160.187:domain,1,72,0,0,1,72,1.530192000,0.0000
144.75.218.242:59146,<->,8.222.218.207:domain,1,124,0,0,1,124,1.530052000,0.0000
144.75.218.235:26281,<->,8.222.218.197:domain,1,112,0,0,1,112,1.528968000,0.0000
97.126.26.70:39616,<->,137.148.176.213:domain,1,83,0,0,1,83,1.528961000,0.0000
77.42.255.238:55968,<->,34.189.255.223:13209,0,0,1,52,1,52,1.528658000,0.0000
136.64.7.221:51752,<->,144.122.240.196:domain,0,0,1,74,1,74,1.528606000,0.0000
144.75.218.246:51887,<->,8.222.218.197:domain,1,122,0,0,1,122,1.528163000,0.0000
144.75.218.242:55504,<->,8.222.218.199:domain,1,110,0,0,1,110,1.528113000,0.0000
92.27.52.56:52451,<->,35.56.99.192:snmp,0,0,1,81,1,81,1.528076000,0.0000
34.187.59.238:19317,<->,58.143.130.33:domain,1,78,0,0,1,78,1.527833000,0.0000
144.75.218.241:33883,<->,138.127.224.136:domain,1,318,0,0,1,318,1.527483000,0.0000
144.75.218.237:42120,<->,8.222.218.204:domain,1,109,0,0,1,109,1.527247000,0.0000
144.75.218.233:58043,<->,8.222.218.197:domain,1,237,0,0,1,237,1.527042000,0.0000
:::35314,<->,:::domain,1,160,0,0,1,160,1.526810000,0.0000
144.75.218.237:26770,<->,8.222.218.204:domain,1,113,0,0,1,113,1.526721000,0.0000
50.94.83.219:20362,<->,247.136.161.17:6881,0,0,1,56,1,56,1.526705000,0.0000
131.63.23.44:50868,<->,129.224.112.252:domain,0,0,1,74,1,74,1.526370000,0.0000
247.136.135.169:35542,<->,125.36.246.176:6881,1,341,0,0,1,341,1.526254000,0.0000
:::41849,<->,:::domain,1,786,0,0,1,786,1.526178000,0.0000
125.152.68.220:5488,<->,144.64.139.146:domain,0,0,1,84,1,84,1.526143000,0.0000
21.15.226.126:55104,<->,20.193.24.155:netbios-ns,0,0,1,82,1,82,1.525947000,0.0000
144.75.218.237:42052,<->,132.43.156.54:domain,1,177,0,0,1,177,1.525641000,0.0000
144.75.218.241:4917,<->,8.222.218.207:domain,1,110,0,0,1,110,1.525494000,0.0000
224.213.241.54:34985,<->,246.253.248.210:domain,0,0,1,79,1,79,1.525097000,0.0000
254.126.164.43:51409,<->,129.224.112.252:domain,0,0,1,75,1,75,1.525008000,0.0000
144.75.218.241:12088,<->,8.222.218.207:domain,1,110,0,0,1,110,1.524980000,0.0000
60.108.145.249:42098,<->,133.183.154.103:26264,0,0,1,52,1,52,1.524870000,0.0000
144.75.218.242:x11,<->,138.127.230.152:domain,1,366,0,0,1,366,1.524688000,0.0000
144.75.218.242:fjicl-tep-a,<->,8.222.218.199:domain,1,110,0,0,1,110,1.523994000,0.0000
109.112.167.71:14886,<->,104.157.23.202:domain,1,76,0,0,1,76,1.523721000,0.0000
89.183.104.166:51413,<->,66.244.63.171:48295,1,52,0,0,1,52,1.523527000,0.0000
158.191.11.136:30020,<->,99.73.163.224:23479,0,0,1,135,1,135,1.523244000,0.0000
21.15.226.126:55104,<->,20.193.24.168:netbios-ns,0,0,1,82,1,82,1.523206000,0.0000
215.158.103.219:45053,<->,206.226.68.41:domain,1,84,0,0,1,84,1.522744000,0.0000
96.93.140.98:7974,<->,98.67.141.39:domain,0,0,1,80,1,80,1.522562000,0.0000
144.93.125.48:61465,<->,144.93.121.10:31251,0,0,1,104,1,104,1.522465000,0.0000
39.153.0.161:11919,<->,143.32.146.75:domain,1,66,0,0,1,66,1.522366000,0.0000
144.75.218.241:57287,<->,8.222.218.204:domain,1,109,0,0,1,109,1.522130000,0.0000
144.75.218.237:pjlink,<->,8.222.218.198:domain,1,114,0,0,1,114,1.521673000,0.0000
144.75.218.237:17252,<->,8.222.218.199:domain,1,122,0,0,1,122,1.521661000,0.0000
34.15.85.130:tserver,<->,79.56.95.12:domain,1,74,0,0,1,74,1.521608000,0.0000
144.75.218.242:mipv6tls,<->,138.127.231.130:domain,1,250,0,0,1,250,1.521299000,0.0000
144.75.218.242:17351,<->,8.222.218.207:domain,1,123,0,0,1,123,1.520842000,0.0000
89.183.104.179:40852,<->,254.75.54.22:12076,1,62,0,0,1,62,1.520802000,0.0000
132.249.70.233:62978,<->,53.201.149.31:domain,1,86,0,0,1,86,1.519485000,0.0000
137.254.129.50:53020,<->,80.56.78.128:domain,0,0,1,94,1,94,1.519448000,0.0000
144.75.218.241:63694,<->,120.155.84.97:domain,1,118,0,0,1,118,1.519320000,0.0000
92.27.219.151:41553,<->,112.3.223.209:12661,1,99,0,0,1,99,1.518952000,0.0000
148.158.222.19:20471,<->,129.224.112.252:domain,0,0,1,69,1,69,1.517999000,0.0000
80.101.245.49:5115,<->,50.224.62.69:domain,0,0,1,76,1,76,1.517676000,0.0000
92.27.219.218:61499,<->,125.3.159.4:17992,1,52,0,0,1,52,1.517522000,0.0000
80.38.56.151:7502,<->,132.43.156.54:domain,1,363,0,0,1,363,1.517235000,0.0000
127.183.60.166:57313,<->,8.228.208.38:56426,0,0,1,351,1,351,1.517168000,0.0000
144.75.218.241:31318,<->,8.222.218.207:domain,1,159,0,0,1,159,1.517088000,0.0000
144.75.218.242:25060,<->,139.252.1.230:domain,1,90,0,0,1,90,1.516995000,0.0000
215.158.239.226:51998,<->,53.84.175.252:domain,1,343,0,0,1,343,1.516912000,0.0000
100.92.129.50:56932,<->,144.76.46.38:domain,1,204,0,0,1,204,1.516842000,0.0000
136.25.188.105:49995,<->,140.136.9.105:domain,1,251,0,0,1,251,1.515870000,0.0000
15.76.174.124:26898,<->,98.67.141.156:domain,0,0,1,68,1,68,1.515656000,0.0000
144.75.218.242:qb-db-server,<->,8.222.218.199:domain,1,114,0,0,1,114,1.515098000,0.0000
144.75.218.237:20960,<->,138.127.231.77:domain,1,254,0,0,1,254,1.514726000,0.0000
89.183.104.132:16055,<->,33.156.71.15:linogridengine,1,52,0,0,1,52,1.514725000,0.0000
148.158.222.19:42618,<->,129.224.112.252:domain,0,0,1,69,1,69,1.514369000,0.0000
91.54.155.124:13597,<->,132.249.70.233:domain,0,0,1,76,1,76,1.514176000,0.0000
144.75.218.242:62385,<->,8.222.218.199:domain,1,109,0,0,1,109,1.514019000,0.0000
:::36659,<->,:::12844,0,0,1,79,1,79,1.513836000,0.0000
198.206.5.108:58156,<->,138.98.181.238:domain,0,0,1,78,1,78,1.513308000,0.0000
80.38.6.211:39661,<->,119.94.225.50:domain,1,143,0,0,1,143,1.513126000,0.0000
144.75.218.241:12298,<->,8.222.218.207:domain,1,120,0,0,1,120,1.512416000,0.0000
133.32.2.37:56123,<->,0.81.95.103:domain,1,393,0,0,1,393,1.511849000,0.0000
144.108.64.184:58956,<->,159.69.187.51:domain,0,0,1,71,1,71,1.511322000,0.0000
136.25.188.105:60930,<->,132.5.71.202:domain,1,180,0,0,1,180,1.511308000,0.0000
198.146.30.172:13605,<->,144.86.151.114:domain,0,0,1,79,1,79,1.511282000,0.0000
234.182.169.148:37886,<->,89.183.108.200:domain,0,0,1,77,1,77,1.511076000,0.0000
144.75.218.237:16396,<->,120.155.84.97:domain,1,161,0,0,1,161,1.510906000,0.0000
21.15.226.126:55104,<->,20.193.24.249:netbios-ns,0,0,1,82,1,82,1.510832000,0.0000
117.163.209.244:49276,<->,92.27.219.248:33690,0,0,1,52,1,52,1.510788000,0.0000
144.75.218.233:12223,<->,8.222.218.204:domain,1,111,0,0,1,111,1.510468000,0.0000
144.75.218.242:24467,<->,8.222.218.196:domain,1,110,0,0,1,110,1.509857000,0.0000
144.75.218.242:29953,<->,8.222.218.204:domain,1,122,0,0,1,122,1.509587000,0.0000
97.126.26.70:15237,<->,138.127.230.142:domain,1,231,0,0,1,231,1.509563000,0.0000
20.207.90.89:14431,<->,72.129.206.52:domain,1,72,0,0,1,72,1.509254000,0.0000
247.136.177.11:57557,<->,127.80.215.53:14189,1,52,0,0,1,52,1.508982000,0.0000
144.75.218.237:7776,<->,8.222.218.197:domain,1,110,0,0,1,110,1.508516000,0.0000
198.146.30.172:5177,<->,144.86.151.114:domain,0,0,1,97,1,97,1.508228000,0.0000
:::53973,<->,:::domain,0,0,1,69,1,69,1.507732000,0.0000
192.67.158.2:58988,<->,38.140.182.62:45682,1,402,0,0,1,402,1.507429000,0.0000
144.75.218.241:digital-notary,<->,120.155.84.97:domain,1,143,0,0,1,143,1.506656000,0.0000
144.75.218.241:27537,<->,120.155.84.97:domain,1,118,0,0,1,118,1.506482000,0.0000
69.132.194.25:41115,<->,133.178.227.9:domain,0,0,1,85,1,85,1.506311000,0.0000
20.21.152.161:32071,<->,76.82.62.202:domain,1,74,0,0,1,74,1.505806000,0.0000
68.185.184.17:12351,<->,80.42.136.224:domain,0,0,1,77,1,77,1.505793000,0.0000
144.76.43.245:49131,<->,39.248.134.206:domain,0,0,1,87,1,87,1.505762000,0.0000
144.75.218.237:33341,<->,156.143.11.242:domain,1,177,0,0,1,177,1.505740000,0.0000
192.64.208.147:51899,<->,38.105.160.195:28588,1,102,0,0,1,102,1.505042000,0.0000
144.75.218.235:53704,<->,8.222.218.197:domain,1,122,0,0,1,122,1.504849000,0.0000
148.158.222.19:47974,<->,129.224.112.252:domain,0,0,1,61,1,61,1.504445000,0.0000
144.75.218.235:63464,<->,8.222.218.198:domain,1,122,0,0,1,122,1.503776000,0.0000
132.168.196.169:25082,<->,193.46.99.197:21367,1,129,0,0,1,129,1.503501000,0.0000
92.27.27.158:13922,<->,142.238.41.239:http-alt,1,52,0,0,1,52,1.503385000,0.0000
144.75.218.241:22789,<->,120.155.84.97:domain,1,155,0,0,1,155,1.503247000,0.0000
144.75.218.242:15189,<->,128.203.247.100:domain,1,88,0,0,1,88,1.503121000,0.0000
144.75.218.242:13992,<->,8.222.218.199:domain,1,122,0,0,1,122,1.503077000,0.0000
100.180.142.104:radmin-port,<->,109.222.252.217:domain,0,0,1,68,1,68,1.502572000,0.0000
78.55.247.203:56363,<->,92.27.219.50:6881,0,0,1,62,1,62,1.501942000,0.0000
144.75.218.237:11018,<->,8.222.218.207:domain,1,110,0,0,1,110,1.501797000,0.0000
6.210.30.49:16597,<->,109.222.245.45:domain,0,0,1,67,1,67,1.501698000,0.0000
92.27.219.203:44062,<->,205.65.50.131:29542,1,62,0,0,1,62,1.501247000,0.0000
124.42.155.137:starfish,<->,109.112.164.138:giga-pocket,0,0,1,128,1,128,1.500951000,0.0000
136.25.188.105:51451,<->,128.243.151.33:domain,1,279,0,0,1,279,1.500925000,0.0000
127.15.90.195:51413,<->,247.136.241.120:24757,0,0,1,90,1,90,1.500910000,0.0000
21.15.226.126:55104,<->,20.193.25.175:netbios-ns,0,0,1,82,1,82,1.500564000,0.0000
21.15.226.126:55104,<->,20.193.25.166:netbios-ns,0,0,1,82,1,82,1.499494000,0.0000
144.75.218.235:64412,<->,138.127.224.254:domain,1,341,0,0,1,341,1.499307000,0.0000
102.208.213.203:46586,<->,109.222.245.45:domain,0,0,1,67,1,67,1.499271000,0.0000
92.27.219.143:53887,<->,93.224.205.64:44740,1,52,0,0,1,52,1.499005000,0.0000
128.163.110.232:50000,<->,109.1.60.149:46640,0,0,1,97,1,97,1.497834000,0.0000
89.183.104.236:61199,<->,206.154.108.149:27795,1,147,0,0,1,147,1.497613000,0.0000
57.211.43.71:ddi-udp-1,<->,249.101.239.70:1032,0,0,1,68,1,68,1.497577000,0.0000
144.75.218.241:44037,<->,120.155.84.97:domain,1,236,0,0,1,236,1.497427000,0.0000
4.240.214.61:56407,<->,92.27.219.185:http-alt,0,0,1,1456,1,1456,1.497324000,0.0000
39.24.39.33:13641,<->,199.125.153.115:domain,1,50,0,0,1,50,1.497079000,0.0000
8.252.222.19:51622,<->,192.171.13.80:domain,1,132,0,0,1,132,1.496167000,0.0000
97.126.26.71:47001,<->,138.127.224.104:domain,1,281,0,0,1,281,1.495540000,0.0000
87.52.183.37:19585,<->,92.27.27.185:6881,0,0,1,719,1,719,1.495356000,0.0000
48.110.114.26:43041,<->,92.27.219.166:33001,0,0,1,52,1,52,1.494605000,0.0000
57.211.43.70:ddi-udp-1,<->,249.101.239.70:1032,0,0,1,68,1,68,1.494469000,0.0000
92.27.27.150:52091,<->,42.129.191.23:31291,1,52,0,0,1,52,1.494450000,0.0000
39.154.194.32:34857,<->,152.134.94.238:domain,1,130,0,0,1,130,1.493366000,0.0000
80.38.6.211:54856,<->,119.94.225.50:domain,1,143,0,0,1,143,1.493146000,0.0000
92.27.219.39:57244,<->,206.123.219.254:34050,1,321,0,0,1,321,1.492612000,0.0000
144.75.218.237:28542,<->,8.222.218.207:domain,1,149,0,0,1,149,1.492015000,0.0000
144.75.218.242:19228,<->,8.222.218.207:domain,1,110,0,0,1,110,1.491922000,0.0000
144.75.218.242:63160,<->,8.222.218.199:domain,1,111,0,0,1,111,1.491299000,0.0000
21.15.226.126:55104,<->,20.193.25.192:netbios-ns,0,0,1,82,1,82,1.491065000,0.0000
20.135.132.217:45075,<->,141.99.73.111:domain,1,135,0,0,1,135,1.491049000,0.0000
144.75.218.246:60898,<->,8.222.218.197:domain,1,122,0,0,1,122,1.490194000,0.0000
144.75.218.237:41947,<->,8.222.218.207:domain,1,126,0,0,1,126,1.490034000,0.0000
132.123.161.122:57484,<->,98.236.254.250:domain,0,0,1,61,1,61,1.489969000,0.0000
218.31.5.40:29209,<->,129.224.112.252:domain,0,0,1,76,1,76,1.489752000,0.0000
109.1.51.11:47495,<->,64.214.45.152:37354,1,405,0,0,1,405,1.489508000,0.0000
144.75.218.241:33913,<->,144.69.195.30:domain,1,102,0,0,1,102,1.489187000,0.0000
106.149.105.235:60601,<->,92.27.219.161:57114,0,0,1,309,1,309,1.489074000,0.0000
21.15.226.126:55104,<->,20.193.25.202:netbios-ns,0,0,1,82,1,82,1.488946000,0.0000
234.182.169.148:35101,<->,89.183.108.200:domain,0,0,1,76,1,76,1.488569000,0.0000
144.75.218.241:10144,<->,136.99.66.245:domain,1,174,0,0,1,174,1.487700000,0.0000
8.176.8.196:55082,<->,192.171.13.190:domain,1,97,0,0,1,97,1.487556000,0.0000
91.54.155.124:15567,<->,132.249.70.233:domain,0,0,1,80,1,80,1.487553000,0.0000
8.252.222.105:37782,<->,89.86.110.196:domain,1,135,0,0,1,135,1.486905000,0.0000
144.75.218.233:55488,<->,8.222.218.197:domain,1,111,0,0,1,111,1.486554000,0.0000
38.21.156.204:56633,<->,20.232.230.81:netbios-ns,0,0,1,82,1,82,1.486431000,0.0000
101.224.169.22:16567,<->,0.35.171.199:5976,1,110,0,0,1,110,1.486298000,0.0000
144.75.218.237:43176,<->,8.222.218.199:domain,1,113,0,0,1,113,1.486196000,0.0000
144.75.218.233:46423,<->,53.165.133.164:domain,1,80,0,0,1,80,1.486133000,0.0000
143.88.15.74:39479,<->,215.158.239.73:domain,0,0,1,84,1,84,1.486096000,0.0000
109.1.56.55:59600,<->,57.46.39.166:57138,1,50,0,0,1,50,1.485846000,0.0000
144.75.218.237:13623,<->,120.155.84.97:domain,1,120,0,0,1,120,1.485734000,0.0000
144.75.218.246:18841,<->,8.47.122.178:domain,1,100,0,0,1,100,1.485713000,0.0000
98.23.111.141:40616,<->,92.27.209.196:silhouette,0,0,1,50,1,50,1.484736000,0.0000
194.215.244.40:18301,<->,80.42.160.104:6881,0,0,1,215,1,215,1.484629000,0.0000
91.54.155.124:cnhrp,<->,132.249.70.233:domain,0,0,1,84,1,84,1.484370000,0.0000
6.29.108.86:33328,<->,133.178.226.98:12347,0,0,1,1064,1,1064,1.484328000,0.0000
144.75.218.242:19314,<->,8.222.218.199:domain,1,111,0,0,1,111,1.484132000,0.0000
109.1.22.16:35910,<->,118.224.132.179:fnet-remote-ui,1,138,0,0,1,138,1.483896000,0.0000
144.75.218.241:53778,<->,8.222.218.207:domain,1,114,0,0,1,114,1.483855000,0.0000
207.72.252.122:10777,<->,39.15.169.14:domain,0,0,1,86,1,86,1.483756000,0.0000
144.75.218.246:9804,<->,8.222.218.204:domain,1,122,0,0,1,122,1.482708000,0.0000
91.54.155.124:55189,<->,132.249.70.233:domain,0,0,1,62,1,62,1.482562000,0.0000
144.75.218.235:9863,<->,8.222.218.197:domain,1,113,0,0,1,113,1.482304000,0.0000
138.127.198.233:52000,<->,159.87.104.238:domain,0,0,1,75,1,75,1.482149000,0.0000
92.27.27.153:36443,<->,235.229.204.198:15296,1,62,0,0,1,62,1.482046000,0.0000
144.108.80.172:44013,<->,159.69.187.29:domain,0,0,1,71,1,71,1.481839000,0.0000
144.75.218.235:lbc-watchdog,<->,140.142.131.1:domain,1,77,0,0,1,77,1.481780000,0.0000
144.75.218.246:58042,<->,8.222.218.204:domain,1,110,0,0,1,110,1.481540000,0.0000
144.76.43.245:56935,<->,80.56.78.128:domain,0,0,1,100,1,100,1.481290000,0.0000
144.75.218.237:lumimgrd,<->,99.168.7.150:domain,1,154,0,0,1,154,1.480738000,0.0000
63.255.106.50:63785,<->,97.168.67.236:domain,0,0,1,80,1,80,1.480528000,0.0000
141.245.151.199:46756,<->,136.47.66.197:domain,1,87,0,0,1,87,1.480106000,0.0000
39.193.207.217:34250,<->,148.177.30.57:domain,1,1257,0,0,1,1257,1.480081000,0.0000
92.27.219.140:palace-2,<->,91.231.209.45:palace-2,1,89,0,0,1,89,1.479986000,0.0000
52.60.231.223:54638,<->,132.168.198.202:domain,0,0,1,65,1,65,1.479564000,0.0000
93.2.217.58:44718,<->,97.168.67.236:domain,0,0,1,80,1,80,1.479472000,0.0000
92.27.219.156:60442,<->,87.49.215.40:57397,1,84,0,0,1,84,1.479437000,0.0000
144.75.218.241:52590,<->,8.222.218.204:domain,1,109,0,0,1,109,1.478623000,0.0000
144.75.218.246:39290,<->,8.222.218.199:domain,1,111,0,0,1,111,1.478564000,0.0000
97.242.126.186:23644,<->,129.224.112.252:domain,0,0,1,97,1,97,1.478430000,0.0000
56.125.221.95:64243,<->,129.224.112.252:domain,0,0,1,63,1,63,1.477360000,0.0000
89.183.104.145:53555,<->,120.51.13.182:10610,1,328,0,0,1,328,1.477176000,0.0000
144.75.218.237:61389,<->,8.222.218.198:domain,1,123,0,0,1,123,1.477139000,0.0000
144.75.218.241:38614,<->,99.168.7.150:domain,1,147,0,0,1,147,1.476700000,0.0000
131.233.164.64:64640,<->,129.224.112.252:domain,0,0,1,74,1,74,1.476351000,0.0000
102.50.179.112:46102,<->,144.76.46.36:domain,1,130,0,0,1,130,1.476194000,0.0000
53.212.149.246:22759,<->,138.31.199.102:domain,0,0,1,74,1,74,1.476050000,0.0000
247.136.188.245:37290,<->,148.196.121.220:29989,1,130,0,0,1,130,1.475960000,0.0000
80.38.51.167:19280,<->,8.47.188.160:domain,1,148,0,0,1,148,1.475914000,0.0000
98.150.107.181:35633,<->,192.64.246.117:33438,0,0,1,50,1,50,1.475797000,0.0000
144.75.218.235:11100,<->,8.222.218.204:domain,1,190,0,0,1,190,1.475624000,0.0000
220.55.96.152:ies-lm,<->,143.106.201.86:domain,1,149,0,0,1,149,1.475561000,0.0000
77.8.75.237:64485,<->,221.95.60.220:60997,0,0,1,135,1,135,1.475163000,0.0000
144.75.218.237:34477,<->,8.222.218.197:domain,1,122,0,0,1,122,1.475125000,0.0000
144.76.42.205:64948,<->,144.64.138.24:domain,0,0,1,76,1,76,1.474469000,0.0000
98.23.111.141:34364,<->,92.27.209.234:7460,0,0,1,50,1,50,1.473897000,0.0000
:::38097,<->,:::domain,1,726,0,0,1,726,1.473737000,0.0000
198.232.32.156:45543,<->,92.27.219.229:mvs-capacity,0,0,1,52,1,52,1.473704000,0.0000
124.56.156.93:13867,<->,109.222.202.37:domain,0,0,1,79,1,79,1.473091000,0.0000
92.27.27.182:57374,<->,29.138.102.202:50321,1,56,0,0,1,56,1.473001000,0.0000
92.27.219.38:48222,<->,111.65.121.95:6881,1,80,0,0,1,80,1.472824000,0.0000
144.75.218.233:33447,<->,98.101.89.7:domain,1,82,0,0,1,82,1.472774000,0.0000
144.75.218.237:saris,<->,138.127.224.17:domain,1,294,0,0,1,294,1.472713000,0.0000
101.224.204.193:25288,<->,139.252.1.217:domain,1,75,0,0,1,75,1.472546000,0.0000
215.158.102.78:62219,<->,129.224.112.252:domain,0,0,1,76,1,76,1.472480000,0.0000
203.11.144.44:64057,<->,92.27.27.157:25217,0,0,1,52,1,52,1.472458000,0.0000
38.87.154.202:51143,<->,89.183.104.189:call-sig-trans,0,0,1,52,1,52,1.472188000,0.0000
99.187.125.196:55870,<->,129.224.112.252:domain,0,0,1,78,1,78,1.471985000,0.0000
91.54.155.124:43619,<->,132.249.70.233:domain,0,0,1,79,1,79,1.471293000,0.0000
195.3.157.139:57807,<->,39.15.169.14:domain,0,0,1,86,1,86,1.471033000,0.0000
247.136.139.153:45405,<->,119.76.158.162:21826,1,62,0,0,1,62,1.470719000,0.0000
144.75.218.235:51235,<->,138.127.225.151:domain,1,263,0,0,1,263,1.470705000,0.0000
144.75.218.237:44590,<->,8.222.218.197:domain,1,126,0,0,1,126,1.470360000,0.0000
105.115.185.87:33433,<->,102.50.219.230:18819,0,0,1,393,1,393,1.469844000,0.0000
131.233.164.64:59784,<->,129.224.112.252:domain,0,0,1,74,1,74,1.469069000,0.0000
144.75.218.233:11527,<->,138.127.224.174:domain,1,67,0,0,1,67,1.469051000,0.0000
127.190.126.87:50090,<->,56.121.48.108:domain,0,0,1,74,1,74,1.468819000,0.0000
109.36.8.231:45402,<->,109.222.204.60:domain,0,0,1,77,1,77,1.468125000,0.0000
144.75.218.241:22838,<->,99.168.7.150:domain,1,137,0,0,1,137,1.467827000,0.0000
94.233.224.195:24079,<->,249.101.238.135:10316,0,0,1,133,1,133,1.467747000,0.0000
144.75.218.246:45645,<->,8.222.218.204:domain,1,109,0,0,1,109,1.467564000,0.0000
144.75.218.241:8491,<->,8.222.218.207:domain,1,121,0,0,1,121,1.467365000,0.0000
39.205.60.126:swa-1,<->,104.157.21.26:domain,1,70,0,0,1,70,1.467308000,0.0000
111.60.203.97:22201,<->,109.222.195.232:domain,0,0,1,71,1,71,1.466557000,0.0000
97.193.106.236:50513,<->,101.224.183.152:domain,0,0,1,68,1,68,1.466500000,0.0000
199.20.77.150:33504,<->,109.222.195.53:11136,0,0,1,52,1,52,1.466161000,0.0000
144.75.218.242:11544,<->,8.222.218.204:domain,1,122,0,0,1,122,1.466020000,0.0000
144.75.218.235:42348,<->,138.127.231.194:domain,1,365,0,0,1,365,1.465898000,0.0000
144.75.218.235:34352,<->,132.200.120.209:domain,1,142,0,0,1,142,1.465285000,0.0000
97.126.26.70:31727,<->,138.127.224.169:domain,1,252,0,0,1,252,1.465248000,0.0000
88.45.125.170:30395,<->,92.27.219.61:18321,0,0,1,52,1,52,1.465247000,0.0000
8.252.222.246:37307,<->,111.151.107.247:domain,1,155,0,0,1,155,1.465128000,0.0000
220.55.96.152:36484,<->,143.106.201.86:domain,1,122,0,0,1,122,1.464918000,0.0000
144.75.218.237:4748,<->,8.222.218.199:domain,1,111,0,0,1,111,1.464729000,0.0000
193.46.99.105:21355,<->,109.1.34.223:9797,0,0,1,304,1,304,1.464657000,0.0000
92.27.219.58:51413,<->,0.66.204.255:48181,1,149,0,0,1,149,1.464616000,0.0000
114.145.122.138:58640,<->,129.224.112.252:domain,0,0,1,80,1,80,1.463813000,0.0000
145.252.125.198:51317,<->,97.110.148.19:domain,1,87,0,0,1,87,1.463511000,0.0000
80.9.14.182:33508,<->,48.53.90.113:24311,0,0,1,323,1,323,1.462838000,0.0000
144.75.218.242:33763,<->,138.127.231.29:domain,1,254,0,0,1,254,1.462559000,0.0000
121.13.225.160:63210,<->,109.222.214.116:filenet-nch,0,0,1,99,1,99,1.462352000,0.0000
27.188.163.162:i-net-2000-npr,<->,109.1.16.158:sip,0,0,1,445,1,445,1.462296000,0.0000
91.54.155.124:14532,<->,132.249.70.233:domain,0,0,1,78,1,78,1.461792000,0.0000
144.75.218.246:5523,<->,8.222.218.199:domain,1,110,0,0,1,110,1.461019000,0.0000
144.75.218.246:44556,<->,8.222.218.197:domain,1,121,0,0,1,121,1.460884000,0.0000
136.25.189.94:38641,<->,215.158.123.32:12347,1,1064,0,0,1,1064,1.460512000,0.0000
201.220.28.91:54224,<->,109.1.36.149:29470,0,0,1,135,1,135,1.460226000,0.0000
58.20.165.33:7914,<->,98.67.143.207:domain,0,0,1,79,1,79,1.459425000,0.0000
8.176.8.96:40746,<->,120.155.87.66:domain,1,157,0,0,1,157,1.458597000,0.0000
105.18.118.50:62093,<->,109.222.195.216:domain,0,0,1,74,1,74,1.458093000,0.0000
197.108.67.239:50658,<->,129.224.112.252:domain,0,0,1,74,1,74,1.457714000,0.0000
144.75.218.246:csvr-sslproxy,<->,8.222.218.197:domain,1,122,0,0,1,122,1.457597000,0.0000
156.180.238.191:41741,<->,39.33.251.202:31499,0,0,1,52,1,52,1.457304000,0.0000
144.75.218.246:15658,<->,8.222.218.204:domain,1,122,0,0,1,122,1.456603000,0.0000
144.75.218.242:asdis,<->,8.222.218.199:domain,1,122,0,0,1,122,1.456530000,0.0000
144.75.218.242:17929,<->,8.222.218.199:domain,1,110,0,0,1,110,1.456486000,0.0000
144.75.218.242:50601,<->,8.222.218.196:domain,1,113,0,0,1,113,1.455287000,0.0000
144.75.218.242:44440,<->,8.222.218.207:domain,1,114,0,0,1,114,1.455165000,0.0000
92.169.159.101:7862,<->,144.69.82.139:domain,0,0,1,69,1,69,1.455160000,0.0000
89.183.104.231:54640,<->,119.68.182.212:49777,1,52,0,0,1,52,1.454963000,0.0000
89.183.104.167:51413,<->,206.222.59.10:36282,1,52,0,0,1,52,1.454865000,0.0000
144.75.218.246:11444,<->,158.55.120.187:domain,1,162,0,0,1,162,1.454856000,0.0000
144.75.218.235:64086,<->,138.127.231.62:domain,1,286,0,0,1,286,1.454281000,0.0000
92.34.2.222:39165,<->,98.67.133.87:domain,0,0,1,71,1,71,1.454201000,0.0000
123.19.57.43:55152,<->,92.27.219.239:31681,0,0,1,373,1,373,1.453965000,0.0000
21.15.226.126:55104,<->,20.193.25.48:netbios-ns,0,0,1,82,1,82,1.453650000,0.0000
144.75.218.246:10643,<->,157.25.158.25:domain,1,87,0,0,1,87,1.453045000,0.0000
144.75.218.235:26833,<->,8.222.218.204:domain,1,127,0,0,1,127,1.453015000,0.0000
144.75.218.233:26055,<->,138.127.225.78:domain,1,269,0,0,1,269,1.452942000,0.0000
144.75.218.246:14432,<->,8.222.218.204:domain,1,110,0,0,1,110,1.452797000,0.0000
112.54.73.92:55322,<->,97.126.18.23:domain,0,0,1,71,1,71,1.452756000,0.0000
144.75.218.233:64313,<->,138.127.231.139:domain,1,366,0,0,1,366,1.451790000,0.0000
144.75.218.241:49257,<->,8.222.218.204:domain,1,150,0,0,1,150,1.451614000,0.0000
20.188.21.207:10560,<->,112.212.96.222:domain,1,539,0,0,1,539,1.451283000,0.0000
39.143.92.27:62288,<->,120.188.17.43:domain,1,136,0,0,1,136,1.450935000,0.0000
108.36.183.151:55887,<->,89.183.104.253:openvpn,0,0,1,221,1,221,1.450876000,0.0000
218.176.18.66:9564,<->,29.211.214.32:domain,0,0,1,87,1,87,1.449513000,0.0000
144.75.218.246:27143,<->,138.127.225.148:domain,1,366,0,0,1,366,1.449396000,0.0000
144.75.218.242:26825,<->,138.127.225.88:domain,1,366,0,0,1,366,1.449125000,0.0000
118.20.100.200:44074,<->,215.158.238.161:domain,0,0,1,84,1,84,1.448682000,0.0000
132.249.70.233:53414,<->,57.29.149.23:domain,1,157,0,0,1,157,1.447673000,0.0000
57.140.246.52:53848,<->,144.64.137.156:domain,0,0,1,71,1,71,1.447510000,0.0000
27.188.163.162:i-net-2000-npr,<->,109.1.16.149:sip,0,0,1,445,1,445,1.447424000,0.0000
21.15.226.126:55104,<->,20.193.26.8:netbios-ns,0,0,1,82,1,82,1.446973000,0.0000
29.201.141.148:59464,<->,192.64.234.189:56277,0,0,1,50,1,50,1.446578000,0.0000
113.131.107.29:11228,<->,109.222.255.59:domain,0,0,1,75,1,75,1.445587000,0.0000
144.75.218.237:47368,<->,8.222.218.197:domain,1,110,0,0,1,110,1.445082000,0.0000
144.75.218.246:41161,<->,8.222.218.199:domain,1,237,0,0,1,237,1.444798000,0.0000
89.183.104.245:28841,<->,123.49.16.66:6411,1,321,0,0,1,321,1.444699000,0.0000
215.158.103.206:39718,<->,129.220.171.193:domain,1,792,0,0,1,792,1.444311000,0.0000
34.246.35.155:50625,<->,152.110.93.110:43012,1,52,0,0,1,52,1.444172000,0.0000
144.75.218.241:52801,<->,120.155.84.97:domain,1,171,0,0,1,171,1.443979000,0.0000
20.216.214.17:32207,<->,141.108.34.33:domain,1,136,0,0,1,136,1.443822000,0.0000
111.147.76.145:31003,<->,118.224.227.82:21032,1,319,0,0,1,319,1.443765000,0.0000
247.136.154.209:57619,<->,134.201.197.42:20339,1,130,0,0,1,130,1.443714000,0.0000
39.158.64.219:63821,<->,64.252.113.196:28908,1,52,0,0,1,52,1.443521000,0.0000
80.41.59.67:34651,<->,120.186.232.218:sgi-storman,1,129,0,0,1,129,1.443457000,0.0000
210.220.219.153:49811,<->,84.200.124.13:domain,1,319,0,0,1,319,1.443278000,0.0000
144.75.218.246:31200,<->,8.222.218.204:domain,1,123,0,0,1,123,1.443175000,0.0000
144.75.218.241:52827,<->,8.222.218.204:domain,1,219,0,0,1,219,1.442697000,0.0000
215.158.103.219:8941,<->,138.127.224.210:domain,1,274,0,0,1,274,1.442605000,0.0000
136.25.188.105:50869,<->,140.136.9.105:domain,1,184,0,0,1,184,1.442216000,0.0000
225.41.159.53:42134,<->,138.98.246.1:domain,0,0,1,120,1,120,1.441865000,0.0000
8.252.222.118:65363,<->,111.151.107.247:domain,1,134,0,0,1,134,1.441586000,0.0000
39.59.163.117:61931,<->,38.75.253.23:10005,1,70,0,0,1,70,1.441418000,0.0000
20.234.57.9:35677,<->,58.59.40.252:domain,1,136,0,0,1,136,1.441346000,0.0000
98.128.199.38:58911,<->,230.126.191.235:8406,1,130,0,0,1,130,1.441109000,0.0000
136.25.188.105:54419,<->,132.5.71.202:domain,1,253,0,0,1,253,1.440852000,0.0000
101.106.122.69:52485,<->,92.27.219.138:6457,0,0,1,138,1,138,1.440765000,0.0000
136.25.188.105:62355,<->,132.5.71.202:domain,1,288,0,0,1,288,1.440566000,0.0000
20.214.223.135:54760,<->,149.159.108.67:domain,1,72,0,0,1,72,1.440154000,0.0000
248.239.77.185:37045,<->,48.19.203.121:14474,1,133,0,0,1,133,1.440121000,0.0000
21.15.226.126:55104,<->,20.193.26.38:netbios-ns,0,0,1,82,1,82,1.440032000,0.0000
144.75.218.246:43900,<->,138.127.231.114:domain,1,289,0,0,1,289,1.440010000,0.0000
144.75.218.242:availant-mgr,<->,8.222.218.207:domain,1,109,0,0,1,109,1.439782000,0.0000
119.25.160.163:13099,<->,109.1.34.223:9797,0,0,1,325,1,325,1.439774000,0.0000
144.75.218.237:20434,<->,53.244.198.185:domain,1,86,0,0,1,86,1.439706000,0.0000
105.200.247.154:15603,<->,89.139.240.18:domain,0,0,1,74,1,74,1.439521000,0.0000
144.75.218.233:52397,<->,138.127.224.203:domain,1,182,0,0,1,182,1.438857000,0.0000
33.156.232.44:50822,<->,102.83.25.171:20337,0,0,1,169,1,169,1.438744000,0.0000
131.91.78.19:18465,<->,109.222.242.9:bacula-dir,0,0,1,136,1,136,1.438423000,0.0000
144.75.218.237:13799,<->,8.222.218.199:domain,1,109,0,0,1,109,1.438256000,0.0000
38.21.156.204:56633,<->,20.232.230.10:netbios-ns,0,0,1,82,1,82,1.438087000,0.0000
34.165.178.132:rnrp,<->,68.65.175.143:domain,1,74,0,0,1,74,1.438048000,0.0000
20.204.98.130:38033,<->,136.88.52.114:domain,1,80,0,0,1,80,1.437809000,0.0000
8.191.7.199:36880,<->,215.158.239.231:domain,0,0,1,89,1,89,1.437281000,0.0000
8.191.7.199:46011,<->,215.158.239.231:domain,0,0,1,90,1,90,1.437110000,0.0000
80.9.234.254:46301,<->,200.174.207.170:26725,0,0,1,144,1,144,1.436924000,0.0000
144.75.218.237:40808,<->,8.222.218.198:domain,1,114,0,0,1,114,1.436878000,0.0000
100.185.124.114:42465,<->,129.224.112.252:domain,0,0,1,57,1,57,1.436613000,0.0000
144.75.218.241:22671,<->,8.222.218.207:domain,1,179,0,0,1,179,1.436128000,0.0000
144.75.218.242:8597,<->,8.222.218.199:domain,1,110,0,0,1,110,1.436019000,0.0000
144.75.218.233:25278,<->,8.222.218.204:domain,1,110,0,0,1,110,1.435916000,0.0000
212.164.131.84:60118,<->,119.135.216.72:44464,1,92,0,0,1,92,1.435827000,0.0000
119.226.233.38:50123,<->,92.27.219.51:27480,0,0,1,351,1,351,1.435327000,0.0000
97.190.209.215:51413,<->,48.18.195.101:23556,1,133,0,0,1,133,1.434926000,0.0000
143.88.15.74:55766,<->,215.158.239.75:domain,0,0,1,84,1,84,1.434162000,0.0000
136.221.27.98:54175,<->,145.252.126.18:domain,0,0,1,96,1,96,1.434121000,0.0000
144.75.218.246:18202,<->,132.43.156.54:domain,1,144,0,0,1,144,1.433907000,0.0000
144.75.218.241:61730,<->,8.222.218.207:domain,1,121,0,0,1,121,1.433623000,0.0000
195.3.157.139:44006,<->,129.224.112.220:domain,0,0,1,88,1,88,1.433619000,0.0000
133.32.2.38:59378,<->,129.245.60.234:domain,1,131,0,0,1,131,1.433473000,0.0000
144.75.218.241:63945,<->,8.222.218.207:domain,1,110,0,0,1,110,1.433261000,0.0000
20.46.159.59:45230,<->,143.252.87.189:domain,1,75,0,0,1,75,1.433212000,0.0000
144.75.218.241:52579,<->,138.127.225.28:domain,1,254,0,0,1,254,1.432697000,0.0000
144.75.218.235:37007,<->,132.43.156.54:domain,1,148,0,0,1,148,1.432423000,0.0000
100.94.137.213:51413,<->,246.108.109.36:6881,1,61,0,0,1,61,1.432060000,0.0000
144.75.218.246:ars-master,<->,8.222.218.197:domain,1,122,0,0,1,122,1.431401000,0.0000
144.75.218.237:43737,<->,8.222.218.199:domain,1,121,0,0,1,121,1.431361000,0.0000
136.25.188.105:58656,<->,135.88.171.34:domain,1,288,0,0,1,288,1.430964000,0.0000
92.27.27.150:59999,<->,4.111.14.58:21524,1,52,0,0,1,52,1.430436000,0.0000
122.9.224.81:6591,<->,109.222.205.228:domain,0,0,1,73,1,73,1.430365000,0.0000
145.213.37.27:9973,<->,129.224.112.252:domain,0,0,1,80,1,80,1.429838000,0.0000
144.75.218.235:59753,<->,8.222.218.204:domain,1,136,0,0,1,136,1.429742000,0.0000
21.15.226.126:55104,<->,20.193.26.47:netbios-ns,0,0,1,82,1,82,1.429630000,0.0000
144.75.218.242:61982,<->,104.157.133.177:domain,1,245,0,0,1,245,1.429568000,0.0000
136.25.188.105:56983,<->,140.136.9.105:domain,1,244,0,0,1,244,1.428753000,0.0000
39.165.220.234:12899,<->,156.25.203.110:domain,1,126,0,0,1,126,1.427550000,0.0000
21.15.226.126:55104,<->,20.193.26.52:netbios-ns,0,0,1,82,1,82,1.427512000,0.0000
132.249.70.201:amberon,<->,53.76.66.87:amberon,1,220,0,0,1,220,1.427491000,0.0000
192.67.167.86:56043,<->,206.17.243.41:51805,1,52,0,0,1,52,1.427326000,0.0000
98.221.132.61:bootps,<->,98.67.140.42:domain,0,0,1,68,1,68,1.426812000,0.0000
144.75.218.237:36130,<->,132.200.124.228:domain,1,158,0,0,1,158,1.426698000,0.0000
94.24.92.161:igrid,<->,92.27.219.182:spearway,0,0,1,1470,1,1470,1.426294000,0.0000
136.25.189.137:40173,<->,220.60.81.165:12347,1,1064,0,0,1,1064,1.425843000,0.0000
27.188.163.162:i-net-2000-npr,<->,109.1.16.146:sip,0,0,1,445,1,445,1.425590000,0.0000
89.183.104.168:35852,<->,125.16.190.46:25567,1,52,0,0,1,52,1.425433000,0.0000
135.196.81.226:18853,<->,138.31.199.22:domain,0,0,1,71,1,71,1.424991000,0.0000
144.75.218.246:37081,<->,8.222.218.199:domain,1,126,0,0,1,126,1.424972000,0.0000
144.75.218.235:56636,<->,138.127.225.148:domain,1,366,0,0,1,366,1.424208000,0.0000
39.33.250.45:9249,<->,131.249.19.234:domain,1,68,0,0,1,68,1.423926000,0.0000
235.228.134.154:34948,<->,89.183.104.226:32706,0,0,1,52,1,52,1.422834000,0.0000
98.128.220.206:43621,<->,230.74.202.4:7650,1,94,0,0,1,94,1.422773000,0.0000
96.207.170.56:25048,<->,97.126.103.29:sip-tls,0,0,1,384,1,384,1.421879000,0.0000
53.89.220.45:44921,<->,39.15.169.14:domain,0,0,1,87,1,87,1.421806000,0.0000
144.75.218.235:19770,<->,138.127.224.104:domain,1,307,0,0,1,307,1.421355000,0.0000
144.75.218.237:9251,<->,8.222.218.198:domain,1,111,0,0,1,111,1.421259000,0.0000
144.75.218.237:9291,<->,8.222.218.207:domain,1,110,0,0,1,110,1.420634000,0.0000
123.195.212.52:12493,<->,210.229.230.12:6881,0,0,1,52,1,52,1.420439000,0.0000
20.138.185.24:52482,<->,106.162.99.24:domain,1,79,0,0,1,79,1.419553000,0.0000
118.10.0.235:57293,<->,132.151.129.234:domain,0,0,1,77,1,77,1.418846000,0.0000
144.75.218.237:54869,<->,8.222.218.207:domain,1,217,0,0,1,217,1.418801000,0.0000
109.1.23.39:59676,<->,127.92.137.146:42626,1,357,0,0,1,357,1.418520000,0.0000
144.75.218.242:11722,<->,8.222.218.204:domain,1,109,0,0,1,109,1.418410000,0.0000
130.37.102.18:25696,<->,39.214.55.177:domain,0,0,1,86,1,86,1.418321000,0.0000
144.75.218.242:23062,<->,138.127.230.26:domain,1,254,0,0,1,254,1.418192000,0.0000
102.50.141.39:43918,<->,204.16.203.227:caistoragemgr,1,147,0,0,1,147,1.417585000,0.0000
136.209.190.221:7172,<->,80.56.78.92:domain,0,0,1,100,1,100,1.417561000,0.0000
144.75.218.233:29565,<->,8.222.218.197:domain,1,223,0,0,1,223,1.417287000,0.0000
144.75.218.241:52540,<->,8.222.218.207:domain,1,124,0,0,1,124,1.417187000,0.0000
136.25.188.105:57648,<->,140.136.9.105:domain,1,296,0,0,1,296,1.416605000,0.0000
112.226.101.215:48984,<->,80.42.168.43:17791,0,0,1,1213,1,1213,1.416584000,0.0000
144.75.218.237:9431,<->,93.181.133.172:domain,1,159,0,0,1,159,1.416495000,0.0000
144.75.218.242:11202,<->,8.222.218.196:domain,1,111,0,0,1,111,1.416335000,0.0000
118.208.189.32:62127,<->,89.183.104.250:palace-4,0,0,1,52,1,52,1.416305000,0.0000
144.75.218.235:30501,<->,8.222.218.204:domain,1,114,0,0,1,114,1.415914000,0.0000
144.75.218.233:34060,<->,8.222.218.204:domain,1,123,0,0,1,123,1.415781000,0.0000
33.240.17.69:28059,<->,89.183.104.141:9648,0,0,1,52,1,52,1.415584000,0.0000
144.75.218.235:11500,<->,8.222.218.198:domain,1,150,0,0,1,150,1.414594000,0.0000
92.27.219.169:37272,<->,198.101.112.240:idac,1,315,0,0,1,315,1.414354000,0.0000
144.75.218.241:29795,<->,8.222.218.204:domain,1,113,0,0,1,113,1.413727000,0.0000
144.75.218.237:54735,<->,8.222.218.199:domain,1,109,0,0,1,109,1.413387000,0.0000
29.211.206.37:50989,<->,136.25.189.93:domain,0,0,1,83,1,83,1.412694000,0.0000
33.219.189.220:35691,<->,109.0.213.196:8387,0,0,1,355,1,355,1.412347000,0.0000
144.75.218.241:60142,<->,8.222.218.207:domain,1,121,0,0,1,121,1.411691000,0.0000
99.75.4.225:49264,<->,226.162.38.40:domain,1,145,0,0,1,145,1.411580000,0.0000
247.136.235.134:25078,<->,255.57.239.24:ntp,1,80,0,0,1,80,1.411326000,0.0000
89.183.104.137:64966,<->,207.176.222.178:62592,1,52,0,0,1,52,1.411044000,0.0000
:::35197,<->,:::domain,1,260,0,0,1,260,1.411014000,0.0000
144.75.218.246:63873,<->,8.222.218.197:domain,1,122,0,0,1,122,1.410408000,0.0000
144.75.218.237:43758,<->,8.222.218.199:domain,1,121,0,0,1,121,1.409829000,0.0000
92.27.219.233:51413,<->,33.250.48.170:43073,1,326,0,0,1,326,1.409527000,0.0000
143.252.204.233:42913,<->,129.224.112.252:domain,0,0,1,76,1,76,1.409526000,0.0000
215.158.140.14:55915,<->,192.171.13.188:domain,1,167,0,0,1,167,1.408874000,0.0000
97.126.26.40:54559,<->,53.167.244.138:domain,1,126,0,0,1,126,1.408769000,0.0000
144.108.64.185:cops,<->,159.69.187.49:domain,0,0,1,66,1,66,1.408721000,0.0000
144.75.218.237:48753,<->,8.222.218.207:domain,1,110,0,0,1,110,1.408399000,0.0000
152.44.123.253:27059,<->,92.27.235.58:20245,0,0,1,133,1,133,1.408370000,0.0000
106.157.38.242:53126,<->,108.134.108.77:writesrv,0,0,1,50,1,50,1.408228000,0.0000
136.25.188.105:62943,<->,100.185.121.91:domain,1,119,0,0,1,119,1.407799000,0.0000
106.157.38.242:53126,<->,108.134.108.77:19648,0,0,1,50,1,50,1.406516000,0.0000
109.222.212.23:14758,<->,69.196.212.63:1024,1,1470,0,0,1,1470,1.406407000,0.0000
144.75.218.241:56927,<->,8.222.218.204:domain,1,110,0,0,1,110,1.406405000,0.0000
144.75.218.237:4798,<->,8.222.218.198:domain,1,109,0,0,1,109,1.405685000,0.0000
89.183.104.159:51052,<->,75.95.12.84:11251,1,52,0,0,1,52,1.405585000,0.0000
92.162.219.215:49457,<->,129.224.112.252:domain,0,0,1,74,1,74,1.405575000,0.0000
136.25.188.105:32649,<->,33.223.144.204:domain,1,88,0,0,1,88,1.405534000,0.0000
144.76.42.211:40838,<->,144.64.138.24:domain,0,0,1,76,1,76,1.404902000,0.0000
199.50.28.3:16762,<->,92.27.219.235:10721,0,0,1,52,1,52,1.403166000,0.0000
149.217.70.251:54263,<->,8.228.215.123:51413,0,0,1,135,1,135,1.403080000,0.0000
39.172.28.65:24763,<->,119.90.219.166:domain,1,76,0,0,1,76,1.403068000,0.0000
144.75.218.237:62109,<->,138.127.231.114:domain,1,289,0,0,1,289,1.402909000,0.0000
133.178.226.222:47355,<->,192.171.13.190:domain,1,153,0,0,1,153,1.402655000,0.0000
108.134.108.77:59315,<->,106.157.38.242:53126,1,50,0,0,1,50,1.402495000,0.0000
203.49.212.41:26740,<->,129.224.112.252:domain,0,0,1,79,1,79,1.402316000,0.0000
144.86.122.246:aic-np,<->,159.213.211.217:snmp,0,0,1,76,1,76,1.402200000,0.0000
98.23.107.90:54549,<->,92.27.27.233:snmp,0,0,1,86,1,86,1.401572000,0.0000
144.75.218.237:23334,<->,120.155.84.97:domain,1,115,0,0,1,115,1.400832000,0.0000
21.15.226.126:55104,<->,20.193.26.213:netbios-ns,0,0,1,82,1,82,1.400474000,0.0000
144.108.80.170:24982,<->,159.69.187.1:domain,0,0,1,74,1,74,1.399843000,0.0000
87.9.230.170:57819,<->,192.67.139.111:18844,0,0,1,136,1,136,1.399766000,0.0000
195.120.55.242:52334,<->,20.159.32.62:domain,0,0,1,71,1,71,1.399504000,0.0000
204.130.115.164:40413,<->,29.211.214.32:domain,0,0,1,106,1,106,1.399224000,0.0000
101.87.248.102:42834,<->,137.81.65.53:domain,0,0,1,76,1,76,1.398491000,0.0000
39.162.9.20:17728,<->,106.208.59.165:domain,1,68,0,0,1,68,1.398229000,0.0000
247.136.153.202:33343,<->,104.53.162.197:6881,1,97,0,0,1,97,1.397722000,0.0000
142.246.30.12:54865,<->,159.137.226.12:domain,0,0,1,75,1,75,1.397503000,0.0000
88.5.193.50:53030,<->,89.183.104.138:oidocsvc,0,0,1,52,1,52,1.397498000,0.0000
193.94.47.49:52344,<->,8.52.181.39:domain,0,0,1,64,1,64,1.397400000,0.0000
144.75.218.242:51979,<->,8.222.218.196:domain,1,111,0,0,1,111,1.397042000,0.0000
254.70.160.124:58646,<->,80.42.185.67:18436,0,0,1,135,1,135,1.396976000,0.0000
92.27.219.187:62728,<->,78.55.239.161:35894,1,52,0,0,1,52,1.396937000,0.0000
144.108.80.170:27554,<->,159.69.187.25:domain,0,0,1,71,1,71,1.396895000,0.0000
144.75.218.235:39676,<->,8.222.218.204:domain,1,110,0,0,1,110,1.396607000,0.0000
144.75.218.241:28743,<->,138.127.231.226:domain,1,250,0,0,1,250,1.396503000,0.0000
215.158.103.206:11436,<->,129.220.171.193:domain,1,797,0,0,1,797,1.395656000,0.0000
92.27.219.156:53251,<->,78.49.228.11:18604,1,52,0,0,1,52,1.395203000,0.0000
215.158.103.206:37371,<->,129.229.242.60:domain,1,640,0,0,1,640,1.395077000,0.0000
144.75.218.241:19162,<->,8.222.218.207:domain,1,110,0,0,1,110,1.395075000,0.0000
143.252.204.234:25529,<->,97.68.226.205:domain,0,0,1,74,1,74,1.394919000,0.0000
144.75.218.235:49319,<->,129.188.130.3:domain,1,80,0,0,1,80,1.394801000,0.0000
80.40.34.206:59696,<->,104.113.118.13:6881,1,97,0,0,1,97,1.394453000,0.0000
144.75.218.237:55671,<->,8.222.218.204:domain,1,110,0,0,1,110,1.393431000,0.0000
192.67.178.12:23469,<->,120.214.189.111:9123,1,130,0,0,1,130,1.393263000,0.0000
136.25.188.105:60617,<->,132.5.71.202:domain,1,139,0,0,1,139,1.391643000,0.0000
111.147.173.47:49616,<->,193.46.99.139:5659,1,129,0,0,1,129,1.390872000,0.0000
204.93.197.173:36694,<->,100.92.12.131:32310,0,0,1,52,1,52,1.390757000,0.0000
144.75.218.241:23426,<->,8.222.218.207:domain,1,114,0,0,1,114,1.390652000,0.0000
144.75.218.233:22944,<->,138.127.230.52:domain,1,169,0,0,1,169,1.389880000,0.0000
144.75.218.237:13349,<->,8.222.218.199:domain,1,123,0,0,1,123,1.389833000,0.0000
144.75.218.237:20879,<->,8.222.218.204:domain,1,110,0,0,1,110,1.389641000,0.0000
144.75.218.237:20936,<->,96.45.188.119:domain,1,84,0,0,1,84,1.389256000,0.0000
144.75.218.237:58700,<->,97.6.59.193:domain,1,194,0,0,1,194,1.389238000,0.0000
100.93.171.75:51413,<->,105.201.172.83:44181,1,90,0,0,1,90,1.389214000,0.0000
144.75.218.233:18541,<->,8.222.218.204:domain,1,125,0,0,1,125,1.388974000,0.0000
144.75.218.235:17977,<->,138.127.225.148:domain,1,366,0,0,1,366,1.388704000,0.0000
106.150.234.231:52396,<->,92.27.27.185:46543,0,0,1,213,1,213,1.388663000,0.0000
92.27.27.151:29933,<->,93.0.159.217:17554,1,133,0,0,1,133,1.388568000,0.0000
144.108.64.184:32392,<->,159.69.187.49:domain,0,0,1,69,1,69,1.388350000,0.0000
144.75.218.235:20377,<->,138.127.224.19:domain,1,366,0,0,1,366,1.388140000,0.0000
144.75.218.241:42166,<->,8.222.218.196:domain,1,237,0,0,1,237,1.388050000,0.0000
144.75.218.233:4584,<->,8.222.218.196:domain,1,122,0,0,1,122,1.387495000,0.0000
77.49.51.18:40017,<->,92.27.219.239:31681,0,0,1,293,1,293,1.387476000,0.0000
:::55928,<->,:::domain,1,503,0,0,1,503,1.387322000,0.0000
144.75.218.242:22013,<->,8.222.218.204:domain,1,206,0,0,1,206,1.386805000,0.0000
144.75.218.235:44939,<->,138.127.231.185:domain,1,366,0,0,1,366,1.386134000,0.0000
145.213.37.27:64291,<->,136.129.94.109:domain,0,0,1,84,1,84,1.386092000,0.0000
136.25.188.105:59953,<->,135.88.171.34:domain,1,233,0,0,1,233,1.385139000,0.0000
144.75.218.241:27305,<->,120.155.84.97:domain,1,146,0,0,1,146,1.385041000,0.0000
84.2.158.229:20647,<->,109.222.253.182:domain,0,0,1,68,1,68,1.384998000,0.0000
144.75.218.233:radius-acct,<->,8.222.218.204:domain,1,122,0,0,1,122,1.384773000,0.0000
144.75.218.233:28475,<->,8.222.218.196:domain,1,153,0,0,1,153,1.384619000,0.0000
21.15.226.126:55104,<->,20.193.27.63:netbios-ns,0,0,1,82,1,82,1.383762000,0.0000
136.25.188.105:55029,<->,132.5.71.202:domain,1,140,0,0,1,140,1.383040000,0.0000
80.47.43.233:63530,<->,136.25.189.210:domain,0,0,1,89,1,89,1.382977000,0.0000
144.75.218.241:58886,<->,100.215.74.232:domain,1,128,0,0,1,128,1.381803000,0.0000
92.27.219.231:63142,<->,57.62.62.79:26528,1,325,0,0,1,325,1.381153000,0.0000
144.75.218.241:46594,<->,138.127.230.1:domain,1,365,0,0,1,365,1.380979000,0.0000
144.75.218.233:17354,<->,8.222.218.197:domain,1,110,0,0,1,110,1.380883000,0.0000
144.75.218.233:33734,<->,138.127.224.111:domain,1,366,0,0,1,366,1.380485000,0.0000
248.239.170.17:47904,<->,124.26.85.55:28962,1,130,0,0,1,130,1.380194000,0.0000
80.38.154.203:41328,<->,92.27.219.62:38379,0,0,1,52,1,52,1.379520000,0.0000
193.47.198.229:60746,<->,8.52.222.230:bacnet,0,0,1,67,1,67,1.379434000,0.0000
144.75.218.241:47106,<->,8.222.218.207:domain,1,123,0,0,1,123,1.379262000,0.0000
136.109.250.193:42472,<->,97.126.11.149:domain,0,0,1,78,1,78,1.378623000,0.0000
21.15.226.126:55104,<->,20.193.27.28:netbios-ns,0,0,1,82,1,82,1.378526000,0.0000
144.75.218.242:10934,<->,8.222.218.204:domain,1,126,0,0,1,126,1.378238000,0.0000
215.158.103.206:24384,<->,138.127.224.10:domain,1,242,0,0,1,242,1.378017000,0.0000
144.75.218.246:13828,<->,8.222.218.197:domain,1,113,0,0,1,113,1.377302000,0.0000
53.187.78.215:fcip-port,<->,39.15.169.14:domain,0,0,1,88,1,88,1.376946000,0.0000
106.184.11.222:47172,<->,92.27.219.31:41911,0,0,1,52,1,52,1.376926000,0.0000
144.105.43.34:25329,<->,153.241.226.86:16447,1,133,0,0,1,133,1.376583000,0.0000
144.75.218.242:hivep,<->,8.222.218.199:domain,1,109,0,0,1,109,1.376488000,0.0000
144.75.218.237:31401,<->,138.127.231.76:domain,1,261,0,0,1,261,1.375937000,0.0000
247.136.240.193:53675,<->,122.116.49.171:37117,1,321,0,0,1,321,1.375578000,0.0000
215.158.103.206:21022,<->,148.111.30.85:domain,1,75,0,0,1,75,1.375286000,0.0000
144.108.64.184:36000,<->,159.69.187.49:domain,0,0,1,81,1,81,1.375024000,0.0000
144.75.218.246:46872,<->,8.222.218.204:domain,1,122,0,0,1,122,1.374841000,0.0000
144.75.218.237:41075,<->,120.155.84.97:domain,1,141,0,0,1,141,1.374209000,0.0000
140.143.190.248:17616,<->,246.253.248.211:domain,0,0,1,86,1,86,1.373651000,0.0000
21.15.226.126:55104,<->,20.193.27.47:netbios-ns,0,0,1,82,1,82,1.373551000,0.0000
101.224.204.193:17847,<->,139.252.1.217:domain,1,75,0,0,1,75,1.373404000,0.0000
144.75.218.242:31707,<->,212.119.15.90:domain,1,84,0,0,1,84,1.373365000,0.0000
92.27.27.175:62214,<->,94.25.103.250:41533,1,52,0,0,1,52,1.372979000,0.0000
144.76.43.238:56402,<->,144.122.240.237:domain,0,0,1,75,1,75,1.372479000,0.0000
50.131.177.136:22516,<->,97.68.226.205:domain,0,0,1,79,1,79,1.372445000,0.0000
247.136.254.97:57948,<->,121.179.37.149:43671,1,149,0,0,1,149,1.372048000,0.0000
144.75.218.237:12663,<->,8.222.218.204:domain,1,123,0,0,1,123,1.371533000,0.0000
142.188.148.82:57253,<->,20.214.92.24:snmp,0,0,1,78,1,78,1.371247000,0.0000
144.108.64.181:40175,<->,159.69.187.23:domain,0,0,1,78,1,78,1.371172000,0.0000
144.75.218.237:55281,<->,8.222.218.198:domain,1,110,0,0,1,110,1.369412000,0.0000
144.75.218.233:12454,<->,138.127.230.151:domain,1,68,0,0,1,68,1.369276000,0.0000
136.25.188.105:61298,<->,56.112.1.18:domain,1,129,0,0,1,129,1.369052000,0.0000
144.75.218.237:57049,<->,138.127.225.225:domain,1,366,0,0,1,366,1.368994000,0.0000
192.64.206.242:56438,<->,64.214.57.1:9132,1,55,0,0,1,55,1.368662000,0.0000
144.75.218.242:16952,<->,139.252.1.219:domain,1,87,0,0,1,87,1.368222000,0.0000
20.213.26.98:22814,<->,121.129.65.147:boinc-client,1,107,0,0,1,107,1.367723000,0.0000
144.75.218.242:50518,<->,8.222.218.199:domain,1,110,0,0,1,110,1.367222000,0.0000
144.75.218.235:56558,<->,138.127.230.46:domain,1,366,0,0,1,366,1.366557000,0.0000
69.32.87.30:18077,<->,97.126.114.17:domain,0,0,1,80,1,80,1.366257000,0.0000
249.101.207.245:56673,<->,131.99.111.30:16891,1,389,0,0,1,389,1.366012000,0.0000
131.130.178.255:8621,<->,92.27.219.16:8435,0,0,1,343,1,343,1.365911000,0.0000
194.193.224.9:39656,<->,89.183.104.137:30132,0,0,1,52,1,52,1.365891000,0.0000
136.25.188.105:51703,<->,140.136.9.105:domain,1,251,0,0,1,251,1.365743000,0.0000
144.75.218.246:36753,<->,8.222.218.197:domain,1,110,0,0,1,110,1.365304000,0.0000
144.75.218.246:nfoldman,<->,8.222.218.204:domain,1,122,0,0,1,122,1.365262000,0.0000
146.243.39.232:25788,<->,133.53.173.234:6881,0,0,1,133,1,133,1.364985000,0.0000
144.75.218.233:12236,<->,8.222.218.197:domain,1,113,0,0,1,113,1.364937000,0.0000
0.246.11.19:12360,<->,89.183.104.229:4768,0,0,1,130,1,130,1.364374000,0.0000
92.27.27.176:35306,<->,193.46.99.139:21319,1,90,0,0,1,90,1.364098000,0.0000
144.76.42.211:52232,<->,144.64.138.24:domain,0,0,1,76,1,76,1.363963000,0.0000
230.61.211.6:13811,<->,98.128.96.179:10576,0,0,1,138,1,138,1.363951000,0.0000
126.219.191.103:52625,<->,246.253.248.211:domain,0,0,1,79,1,79,1.362986000,0.0000
21.15.226.126:55104,<->,20.193.27.11:netbios-ns,0,0,1,82,1,82,1.362974000,0.0000
144.108.64.183:19246,<->,159.69.187.31:domain,0,0,1,68,1,68,1.362546000,0.0000
144.75.218.233:45092,<->,8.222.218.204:domain,1,110,0,0,1,110,1.362383000,0.0000
144.75.218.237:46353,<->,8.222.218.199:domain,1,125,0,0,1,125,1.362108000,0.0000
20.253.18.223:cloanto-net-1,<->,149.230.224.252:domain,1,76,0,0,1,76,1.361815000,0.0000
58.132.150.196:59797,<->,139.254.208.193:https,0,0,1,93,1,93,1.361785000,0.0000
21.15.226.126:55104,<->,20.193.27.12:netbios-ns,0,0,1,82,1,82,1.361660000,0.0000
144.75.218.242:31867,<->,138.127.225.123:domain,1,182,0,0,1,182,1.360010000,0.0000
144.75.218.241:26291,<->,8.222.218.207:domain,1,181,0,0,1,181,1.359356000,0.0000
144.75.218.242:36790,<->,138.127.230.243:domain,1,252,0,0,1,252,1.359144000,0.0000
127.163.229.198:56712,<->,247.136.216.15:56382,0,0,1,50,1,50,1.358795000,0.0000
133.178.227.54:64404,<->,8.220.7.31:domain,1,120,0,0,1,120,1.358123000,0.0000
144.75.218.241:51056,<->,138.127.231.62:domain,1,304,0,0,1,304,1.358115000,0.0000
90.40.190.167:51092,<->,92.27.219.166:30810,0,0,1,135,1,135,1.357883000,0.0000
39.54.235.145:14427,<->,198.70.252.33:domain,1,78,0,0,1,78,1.357730000,0.0000
:::24211,<->,:::domain,1,142,0,0,1,142,1.357706000,0.0000
144.75.218.246:34419,<->,8.222.218.199:domain,1,151,0,0,1,151,1.357683000,0.0000
20.160.39.53:23508,<->,121.93.243.7:domain,1,84,0,0,1,84,1.357460000,0.0000
47.197.43.218:discp-client,<->,139.163.84.114:domain,0,0,1,65,1,65,1.357362000,0.0000
116.89.156.110:25572,<->,137.74.95.14:domain,0,0,1,76,1,76,1.357169000,0.0000
39.56.224.78:agslb,<->,59.51.25.129:domain,1,70,0,0,1,70,1.357125000,0.0000
144.76.43.234:9732,<->,144.122.240.237:domain,0,0,1,81,1,81,1.356994000,0.0000
100.50.96.76:48904,<->,136.129.83.88:domain,0,0,1,81,1,81,1.356092000,0.0000
113.214.85.27:50614,<->,89.183.104.238:13525,0,0,1,52,1,52,1.355976000,0.0000
144.75.218.246:57492,<->,8.222.218.204:domain,1,113,0,0,1,113,1.355947000,0.0000
144.75.218.237:37296,<->,8.222.218.204:domain,1,110,0,0,1,110,1.355832000,0.0000
144.75.218.237:58213,<->,138.127.231.62:domain,1,254,0,0,1,254,1.355770000,0.0000
139.241.73.46:55769,<->,129.224.112.221:domain,0,0,1,72,1,72,1.355411000,0.0000
144.75.218.246:52368,<->,132.107.75.195:domain,1,139,0,0,1,139,1.355206000,0.0000
97.242.126.186:34568,<->,129.224.112.252:domain,0,0,1,77,1,77,1.354836000,0.0000
111.147.167.22:59293,<->,112.70.86.223:20615,1,130,0,0,1,130,1.353826000,0.0000
192.64.196.19:33100,<->,105.92.102.28:blackjack,1,138,0,0,1,138,1.353662000,0.0000
20.101.11.88:37592,<->,123.167.67.17:domain,1,78,0,0,1,78,1.353609000,0.0000
198.54.166.189:40733,<->,92.27.219.38:25521,0,0,1,52,1,52,1.353127000,0.0000
144.75.218.242:60504,<->,138.127.224.239:domain,1,366,0,0,1,366,1.353065000,0.0000
144.75.218.235:62776,<->,138.127.225.148:domain,1,366,0,0,1,366,1.352877000,0.0000
144.93.121.86:51063,<->,144.93.125.49:23553,1,104,0,0,1,104,1.352855000,0.0000
144.75.218.233:27980,<->,8.222.218.197:domain,1,175,0,0,1,175,1.352827000,0.0000
:::41810,<->,:::domain,0,0,1,88,1,88,1.352630000,0.0000
144.75.218.241:56785,<->,120.155.84.97:domain,1,179,0,0,1,179,1.352468000,0.0000
92.27.27.178:64109,<->,127.81.2.139:61054,1,135,0,0,1,135,1.352208000,0.0000
89.183.104.142:31470,<->,118.20.111.94:domain,1,117,0,0,1,117,1.351721000,0.0000
132.249.70.233:62860,<->,222.20.200.135:domain,1,140,0,0,1,140,1.349931000,0.0000
89.216.125.82:43567,<->,22.1.74.1:ntp,1,80,0,0,1,80,1.349760000,0.0000
202.236.106.249:20127,<->,220.80.148.178:6881,0,0,1,130,1,130,1.349487000,0.0000
146.87.6.182:8885,<->,50.224.118.107:domain,0,0,1,72,1,72,1.349485000,0.0000
135.247.123.8:61693,<->,92.27.219.45:5210,0,0,1,62,1,62,1.348873000,0.0000
104.224.175.8:17796,<->,109.222.251.159:domain,0,0,1,70,1,70,1.348762000,0.0000
144.75.218.237:53830,<->,8.222.218.198:domain,1,110,0,0,1,110,1.348721000,0.0000
145.213.37.27:24792,<->,136.129.94.109:domain,0,0,1,84,1,84,1.348700000,0.0000
144.75.218.241:30308,<->,138.127.224.115:domain,1,337,0,0,1,337,1.347037000,0.0000
112.234.147.188:37696,<->,80.41.32.57:14597,0,0,1,135,1,135,1.346806000,0.0000
21.15.226.126:55104,<->,20.193.27.145:netbios-ns,0,0,1,82,1,82,1.346578000,0.0000
192.67.133.141:48360,<->,29.221.88.147:20513,1,52,0,0,1,52,1.346551000,0.0000
:::63843,<->,:::domain,1,758,0,0,1,758,1.346150000,0.0000
144.75.218.235:61640,<->,8.222.218.197:domain,1,122,0,0,1,122,1.346004000,0.0000
144.75.218.237:52821,<->,8.222.218.197:domain,1,113,0,0,1,113,1.345521000,0.0000
113.156.134.6:15864,<->,111.147.232.81:domain,0,0,1,73,1,73,1.345501000,0.0000
144.75.218.235:12103,<->,8.222.218.198:domain,1,237,0,0,1,237,1.345462000,0.0000
144.75.218.241:8811,<->,120.155.84.97:domain,1,176,0,0,1,176,1.345454000,0.0000
89.183.110.85:64296,<->,223.143.99.201:1024,1,130,0,0,1,130,1.345408000,0.0000
:::47824,<->,:::domain,1,175,0,0,1,175,1.344602000,0.0000
144.75.218.235:39231,<->,8.222.218.204:domain,1,110,0,0,1,110,1.344175000,0.0000
106.157.38.242:53126,<->,108.134.108.77:43004,0,0,1,50,1,50,1.344075000,0.0000
106.157.38.242:53126,<->,108.134.108.77:19580,0,0,1,50,1,50,1.343628000,0.0000
123.163.186.237:58386,<->,39.15.169.14:domain,0,0,1,88,1,88,1.343479000,0.0000
92.27.219.224:46837,<->,193.65.5.242:18068,1,325,0,0,1,325,1.343358000,0.0000
106.157.38.242:53126,<->,108.134.108.77:23983,0,0,1,50,1,50,1.343333000,0.0000
21.15.226.126:55104,<->,20.193.27.152:netbios-ns,0,0,1,82,1,82,1.343232000,0.0000
106.157.38.242:53126,<->,108.134.108.77:24329,0,0,1,50,1,50,1.342746000,0.0000
101.181.221.23:51310,<->,109.222.255.208:domain,0,0,1,79,1,79,1.342743000,0.0000
144.75.218.233:64408,<->,138.127.224.241:domain,1,303,0,0,1,303,1.342594000,0.0000
144.75.218.242:54363,<->,138.127.231.3:domain,1,297,0,0,1,297,1.342456000,0.0000
20.249.155.2:31115,<->,139.236.94.152:domain,1,80,0,0,1,80,1.342264000,0.0000
110.98.222.240:41444,<->,89.183.104.141:14619,0,0,1,351,1,351,1.342232000,0.0000
207.87.26.21:27126,<->,129.224.112.252:domain,0,0,1,68,1,68,1.341973000,0.0000
50.189.251.185:28874,<->,200.174.214.160:psmond,0,0,1,319,1,319,1.341915000,0.0000
144.75.218.233:25323,<->,8.222.218.196:domain,1,126,0,0,1,126,1.341903000,0.0000
253.19.79.103:40363,<->,80.40.57.229:ezmeeting-2,0,0,1,135,1,135,1.341609000,0.0000
106.157.38.242:53126,<->,108.134.108.77:19792,0,0,1,50,1,50,1.340953000,0.0000
129.175.139.190:59226,<->,29.211.214.32:domain,0,0,1,122,1,122,1.340859000,0.0000
115.87.122.210:50163,<->,39.33.127.188:domain,0,0,1,84,1,84,1.340331000,0.0000
144.75.218.241:comotionmaster,<->,8.222.218.207:domain,1,110,0,0,1,110,1.340124000,0.0000
144.75.218.237:32044,<->,120.155.84.97:domain,1,143,0,0,1,143,1.340085000,0.0000
144.75.218.242:nbx-ser,<->,8.222.218.204:domain,1,111,0,0,1,111,1.339625000,0.0000
106.157.38.242:53126,<->,108.134.108.77:41438,0,0,1,50,1,50,1.339261000,0.0000
92.27.219.239:38255,<->,114.60.176.251:15396,1,52,0,0,1,52,1.339108000,0.0000
108.134.108.77:63193,<->,106.157.38.242:53126,1,50,0,0,1,50,1.339009000,0.0000
97.126.26.40:47039,<->,138.127.230.221:domain,1,84,0,0,1,84,1.338791000,0.0000
20.221.86.62:49778,<->,198.163.47.226:domain,1,69,0,0,1,69,1.338680000,0.0000
144.75.218.246:54311,<->,8.222.218.197:domain,1,110,0,0,1,110,1.338614000,0.0000
106.157.38.242:53126,<->,108.134.108.77:43668,0,0,1,50,1,50,1.338611000,0.0000
144.75.218.246:6643,<->,8.222.218.199:domain,1,107,0,0,1,107,1.337879000,0.0000
106.157.38.242:53126,<->,108.134.108.77:7328,0,0,1,50,1,50,1.337721000,0.0000
106.157.38.242:53126,<->,108.134.108.77:37812,0,0,1,50,1,50,1.337548000,0.0000
38.84.60.6:50141,<->,192.67.149.88:38504,0,0,1,52,1,52,1.337305000,0.0000
20.18.2.102:22601,<->,100.254.226.147:domain,1,68,0,0,1,68,1.337298000,0.0000
106.157.38.242:53126,<->,108.134.108.77:34133,0,0,1,50,1,50,1.337259000,0.0000
106.157.38.242:53126,<->,108.134.108.77:27553,0,0,1,50,1,50,1.337149000,0.0000
8.238.112.20:32396,<->,152.133.60.221:15410,1,130,0,0,1,130,1.336771000,0.0000
144.75.218.237:20920,<->,8.222.218.197:domain,1,113,0,0,1,113,1.336735000,0.0000
20.0.1.10:outlaws,<->,142.125.81.115:domain,1,75,0,0,1,75,1.336601000,0.0000
106.157.38.242:53126,<->,108.134.108.77:43752,0,0,1,50,1,50,1.336514000,0.0000
21.15.226.126:55104,<->,20.193.27.223:netbios-ns,0,0,1,82,1,82,1.336482000,0.0000
106.157.38.242:53126,<->,108.134.108.77:253,0,0,1,50,1,50,1.336236000,0.0000
144.75.218.235:16501,<->,53.165.133.164:domain,1,83,0,0,1,83,1.335919000,0.0000
104.230.236.175:58295,<->,92.27.219.224:17413,0,0,1,62,1,62,1.335667000,0.0000
21.15.226.126:55104,<->,20.193.27.202:netbios-ns,0,0,1,82,1,82,1.335261000,0.0000
144.75.218.246:21695,<->,8.222.218.204:domain,1,141,0,0,1,141,1.335088000,0.0000
92.27.219.205:54070,<->,253.19.85.146:23405,1,52,0,0,1,52,1.334615000,0.0000
144.75.218.233:9646,<->,140.142.187.19:domain,1,76,0,0,1,76,1.333808000,0.0000
144.75.218.237:23935,<->,120.155.84.97:domain,1,168,0,0,1,168,1.333700000,0.0000
247.136.216.15:56382,<->,149.156.171.10:50639,1,50,0,0,1,50,1.332969000,0.0000
215.158.239.229:60666,<->,8.181.148.227:domain,1,141,0,0,1,141,1.332460000,0.0000
144.75.218.241:36608,<->,8.222.218.196:domain,1,109,0,0,1,109,1.332113000,0.0000
38.113.224.85:23020,<->,92.27.219.128:17187,0,0,1,52,1,52,1.332015000,0.0000
144.75.218.246:gv-pf,<->,8.222.218.197:domain,1,111,0,0,1,111,1.331807000,0.0000
144.76.43.237:34893,<->,144.122.240.224:domain,0,0,1,74,1,74,1.331577000,0.0000
54.61.158.158:25053,<->,246.253.248.211:domain,0,0,1,88,1,88,1.330623000,0.0000
215.158.103.219:24445,<->,192.178.163.107:domain,1,114,0,0,1,114,1.329815000,0.0000
132.249.70.233:54408,<->,192.178.173.46:domain,1,149,0,0,1,149,1.329719000,0.0000
92.27.219.153:50580,<->,27.72.144.170:24904,1,52,0,0,1,52,1.329682000,0.0000
204.92.95.245:45153,<->,192.67.143.62:33735,0,0,1,77,1,77,1.329636000,0.0000
8.35.106.238:63921,<->,29.211.214.32:domain,0,0,1,122,1,122,1.329333000,0.0000
144.75.218.237:4764,<->,8.222.218.199:domain,1,127,0,0,1,127,1.329070000,0.0000
144.75.218.235:52170,<->,8.222.218.204:domain,1,113,0,0,1,113,1.328803000,0.0000
144.75.218.235:14589,<->,8.222.218.204:domain,1,114,0,0,1,114,1.328369000,0.0000
144.75.218.233:33294,<->,8.222.218.204:domain,1,137,0,0,1,137,1.328165000,0.0000
136.25.188.35:47016,<->,114.142.109.74:domain,1,142,0,0,1,142,1.328033000,0.0000
149.11.173.11:64995,<->,111.146.229.38:53338,0,0,1,1161,1,1161,1.327926000,0.0000
144.75.218.242:12037,<->,157.25.158.25:domain,1,86,0,0,1,86,1.327452000,0.0000
136.25.188.105:55410,<->,132.5.71.202:domain,1,232,0,0,1,232,1.326557000,0.0000
92.27.219.50:15916,<->,152.10.81.148:1024,1,124,0,0,1,124,1.326276000,0.0000
144.75.218.246:12088,<->,138.127.231.48:domain,1,239,0,0,1,239,1.326184000,0.0000
8.228.214.124:58457,<->,111.80.138.164:49666,1,78,0,0,1,78,1.325712000,0.0000
144.75.218.235:surfcontrolcpa,<->,8.222.218.198:domain,1,111,0,0,1,111,1.325668000,0.0000
21.15.226.126:55104,<->,20.193.28.82:netbios-ns,0,0,1,82,1,82,1.325601000,0.0000
220.81.53.185:31617,<->,106.213.164.217:30236,1,321,0,0,1,321,1.325435000,0.0000
145.213.37.26:34227,<->,136.129.94.107:domain,0,0,1,84,1,84,1.325359000,0.0000
132.249.70.233:65033,<->,139.114.208.34:domain,1,130,0,0,1,130,1.325273000,0.0000
136.25.188.105:56573,<->,135.88.170.10:domain,1,137,0,0,1,137,1.325217000,0.0000
92.181.174.221:49852,<->,69.170.195.175:25866,1,181,0,0,1,181,1.325037000,0.0000
144.75.218.242:43386,<->,8.222.218.207:domain,1,123,0,0,1,123,1.324892000,0.0000
200.226.80.179:22931,<->,129.92.113.143:chargen,0,0,1,50,1,50,1.324415000,0.0000
39.56.33.14:28963,<->,59.49.203.92:documentum-s,1,72,0,0,1,72,1.324253000,0.0000
21.15.226.126:55104,<->,20.193.27.199:netbios-ns,0,0,1,82,1,82,1.324090000,0.0000
100.93.189.226:60734,<->,119.104.70.230:36236,1,52,0,0,1,52,1.324036000,0.0000
132.20.222.234:37863,<->,129.224.112.221:domain,0,0,1,87,1,87,1.323944000,0.0000
144.75.218.241:65454,<->,8.222.218.196:domain,1,153,0,0,1,153,1.323788000,0.0000
148.195.254.219:sco-peer-tta,<->,246.253.248.211:domain,0,0,1,75,1,75,1.323313000,0.0000
39.243.94.186:62012,<->,197.153.64.198:17992,1,68,0,0,1,68,1.322782000,0.0000
196.148.133.194:49273,<->,29.155.156.81:6881,1,1504,0,0,1,1504,1.322725000,0.0000
92.27.219.203:55949,<->,33.63.141.162:10053,1,133,0,0,1,133,1.322581000,0.0000
:::29953,<->,:::domain,1,758,0,0,1,758,1.321774000,0.0000
144.108.64.185:7755,<->,144.122.240.211:domain,0,0,1,70,1,70,1.321613000,0.0000
249.101.206.222:50713,<->,201.8.119.226:7896,1,133,0,0,1,133,1.321507000,0.0000
144.75.218.246:47322,<->,8.222.218.199:domain,1,125,0,0,1,125,1.321470000,0.0000
144.75.218.246:62766,<->,8.222.218.197:domain,1,127,0,0,1,127,1.321333000,0.0000
97.126.19.185:62140,<->,112.150.154.177:22601,1,321,0,0,1,321,1.321325000,0.0000
132.249.71.241:amberon,<->,132.249.70.154:amberon,0,0,1,220,1,220,1.320619000,0.0000
38.21.156.204:56633,<->,20.232.230.46:netbios-ns,0,0,1,82,1,82,1.320411000,0.0000
215.158.103.206:12476,<->,139.252.1.255:domain,1,191,0,0,1,191,1.320372000,0.0000
144.75.218.246:56898,<->,97.94.181.63:domain,1,172,0,0,1,172,1.320215000,0.0000
192.64.224.151:45667,<->,155.19.248.167:11838,1,300,0,0,1,300,1.320087000,0.0000
144.75.218.241:quest-disc,<->,8.222.218.196:domain,1,113,0,0,1,113,1.319910000,0.0000
204.140.159.18:44930,<->,39.15.169.14:domain,0,0,1,83,1,83,1.319683000,0.0000
144.75.218.241:23816,<->,120.155.84.97:domain,1,125,0,0,1,125,1.319614000,0.0000
115.57.42.104:46895,<->,109.1.46.25:8904,0,0,1,58,1,58,1.318435000,0.0000
101.164.87.250:39893,<->,4.133.108.1:6881,1,133,0,0,1,133,1.318255000,0.0000
144.75.218.237:40930,<->,139.252.1.230:domain,1,90,0,0,1,90,1.318190000,0.0000
144.75.218.233:35361,<->,8.222.218.204:domain,1,114,0,0,1,114,1.318053000,0.0000
144.75.218.242:35414,<->,8.222.218.199:domain,1,122,0,0,1,122,1.317829000,0.0000
144.75.218.246:18314,<->,8.222.218.197:domain,1,109,0,0,1,109,1.316922000,0.0000
144.75.218.237:49455,<->,120.155.84.97:domain,1,120,0,0,1,120,1.316792000,0.0000
144.75.218.235:58322,<->,8.222.218.197:domain,1,111,0,0,1,111,1.316730000,0.0000
144.75.220.241:48515,<->,50.224.103.166:domain,0,0,1,81,1,81,1.316721000,0.0000
102.50.80.105:51283,<->,104.137.223.226:31918,1,58,0,0,1,58,1.316579000,0.0000
136.25.188.105:55731,<->,129.70.124.49:domain,1,137,0,0,1,137,1.316528000,0.0000
247.136.180.232:45849,<->,134.97.14.154:43806,1,52,0,0,1,52,1.316435000,0.0000
144.75.218.241:15211,<->,138.127.224.21:domain,1,289,0,0,1,289,1.316199000,0.0000
56.9.177.179:40579,<->,129.224.112.252:domain,0,0,1,81,1,81,1.315959000,0.0000
92.169.159.101:51426,<->,144.69.82.139:domain,0,0,1,70,1,70,1.315791000,0.0000
20.8.71.202:54709,<->,199.91.76.35:domain,1,74,0,0,1,74,1.315636000,0.0000
27.126.142.151:48270,<->,136.181.33.57:44660,0,0,1,349,1,349,1.314751000,0.0000
34.140.83.85:941,<->,146.206.41.163:domain,1,140,0,0,1,140,1.314665000,0.0000
20.126.125.212:5846,<->,207.11.124.46:domain,1,75,0,0,1,75,1.313873000,0.0000
144.75.218.237:10280,<->,138.127.231.114:domain,1,289,0,0,1,289,1.313639000,0.0000
144.75.218.242:45770,<->,8.222.218.204:domain,1,123,0,0,1,123,1.313466000,0.0000
39.63.180.220:33449,<->,157.211.4.30:domain,1,130,0,0,1,130,1.313427000,0.0000
144.75.218.233:17053,<->,8.222.218.204:domain,1,110,0,0,1,110,1.313138000,0.0000
249.101.85.94:37704,<->,92.27.51.141:ntp,1,80,0,0,1,80,1.312861000,0.0000
100.93.96.116:49548,<->,104.143.87.40:11443,1,309,0,0,1,309,1.312717000,0.0000
144.75.218.233:proshare2,<->,138.127.224.136:domain,1,334,0,0,1,334,1.312698000,0.0000
121.8.199.86:38693,<->,8.252.222.35:domain,0,0,1,83,1,83,1.312515000,0.0000
39.129.248.66:27444,<->,59.50.118.206:domain,1,75,0,0,1,75,1.312199000,0.0000
144.75.218.241:45683,<->,139.252.1.230:domain,1,90,0,0,1,90,1.312186000,0.0000
6.187.59.90:62989,<->,200.175.34.127:31396,0,0,1,52,1,52,1.312140000,0.0000
144.75.218.242:50704,<->,8.222.218.207:domain,1,110,0,0,1,110,1.311581000,0.0000
29.54.21.217:xmlink-connect,<->,97.126.22.117:domain,0,0,1,69,1,69,1.311410000,0.0000
144.75.218.233:22184,<->,8.222.218.204:domain,1,153,0,0,1,153,1.311384000,0.0000
58.11.224.13:44336,<->,215.158.140.25:domain,0,0,1,84,1,84,1.310583000,0.0000
80.41.12.201:50809,<->,106.122.241.132:50321,1,133,0,0,1,133,1.310180000,0.0000
144.75.218.246:mrssrendezvous,<->,8.222.218.199:domain,1,237,0,0,1,237,1.310039000,0.0000
144.75.218.235:32444,<->,8.222.218.204:domain,1,154,0,0,1,154,1.309967000,0.0000
146.240.59.16:51322,<->,129.224.112.252:domain,0,0,1,71,1,71,1.309283000,0.0000
40.169.181.94:38709,<->,109.222.253.182:domain,0,0,1,66,1,66,1.309273000,0.0000
249.101.92.224:33943,<->,53.160.20.106:14461,1,85,0,0,1,85,1.308683000,0.0000
144.75.218.233:33717,<->,132.43.156.81:domain,1,154,0,0,1,154,1.308499000,0.0000
220.87.53.31:61137,<->,230.52.215.218:gap,1,138,0,0,1,138,1.307775000,0.0000
21.15.226.126:55104,<->,20.193.28.137:netbios-ns,0,0,1,82,1,82,1.307153000,0.0000
110.21.0.12:65379,<->,92.27.219.58:http-alt,0,0,1,197,1,197,1.306992000,0.0000
205.165.51.118:26444,<->,92.27.219.188:13350,0,0,1,344,1,344,1.306984000,0.0000
144.75.218.241:sysrqd,<->,8.222.218.207:domain,1,113,0,0,1,113,1.306867000,0.0000
127.182.104.174:53919,<->,80.41.16.213:44803,0,0,1,135,1,135,1.306789000,0.0000
144.75.218.233:55192,<->,140.114.135.111:domain,1,139,0,0,1,139,1.306710000,0.0000
144.75.218.242:worldscores,<->,8.222.218.207:domain,1,122,0,0,1,122,1.306671000,0.0000
144.75.218.237:29879,<->,8.222.218.207:domain,1,179,0,0,1,179,1.305838000,0.0000
109.14.213.84:27354,<->,29.211.214.191:domain,0,0,1,75,1,75,1.305321000,0.0000
205.225.237.193:51413,<->,109.1.34.223:9797,0,0,1,304,1,304,1.304622000,0.0000
144.75.218.235:36588,<->,99.168.7.150:domain,1,134,0,0,1,134,1.304455000,0.0000
144.75.218.246:64263,<->,138.127.224.83:domain,1,170,0,0,1,170,1.304056000,0.0000
122.189.124.157:14180,<->,101.70.126.222:domain,0,0,1,67,1,67,1.303748000,0.0000
37.49.230.49:44732,<->,82.198.203.138:5158,0,0,1,52,1,52,1.303337000,0.0000
99.75.36.192:53169,<->,144.76.46.38:https,1,528,0,0,1,528,1.303059000,0.0000
108.134.108.77:51214,<->,106.157.38.242:37294,1,50,0,0,1,50,1.303050000,0.0000
50.224.121.247:14573,<->,4.241.88.57:5015,1,50,0,0,1,50,1.301685000,0.0000
92.26.149.106:54928,<->,148.187.166.178:snmp,1,86,0,0,1,86,1.301337000,0.0000
144.75.218.237:17809,<->,8.222.218.204:domain,1,121,0,0,1,121,1.301176000,0.0000
144.75.218.235:50938,<->,8.222.218.204:domain,1,110,0,0,1,110,1.301144000,0.0000
144.75.218.235:cefd-vmp,<->,8.222.218.198:domain,1,114,0,0,1,114,1.301015000,0.0000
144.75.218.235:22365,<->,8.222.218.198:domain,1,153,0,0,1,153,1.300771000,0.0000
118.112.193.88:62031,<->,92.27.219.166:32893,0,0,1,135,1,135,1.300622000,0.0000
92.27.219.63:14254,<->,33.59.148.87:12218,1,62,0,0,1,62,1.300596000,0.0000
144.75.218.241:10599,<->,129.35.250.197:domain,1,147,0,0,1,147,1.300410000,0.0000
:::39041,<->,:::domain,1,97,0,0,1,97,1.300253000,0.0000
91.54.155.124:52774,<->,132.249.70.233:domain,0,0,1,74,1,74,1.299471000,0.0000
159.80.143.31:60010,<->,159.80.129.217:58662,0,0,1,128,1,128,1.299391000,0.0000
106.157.38.242:37294,<->,108.134.108.77:15370,0,0,1,50,1,50,1.299094000,0.0000
144.75.218.237:57658,<->,138.127.230.93:domain,1,315,0,0,1,315,1.298638000,0.0000
144.75.218.237:41166,<->,120.155.84.97:domain,1,147,0,0,1,147,1.298598000,0.0000
143.88.15.74:63463,<->,215.158.239.81:domain,0,0,1,84,1,84,1.298356000,0.0000
144.75.218.242:63424,<->,8.222.218.207:domain,1,121,0,0,1,121,1.298349000,0.0000
106.157.38.242:37294,<->,108.134.108.77:891,0,0,1,50,1,50,1.297589000,0.0000
91.54.155.124:48305,<->,132.249.70.233:domain,0,0,1,72,1,72,1.297278000,0.0000
144.75.221.204:15034,<->,139.163.86.189:domain,0,0,1,77,1,77,1.297170000,0.0000
76.227.20.83:12811,<->,109.222.255.32:domain,0,0,1,69,1,69,1.297041000,0.0000
129.254.100.56:33315,<->,129.224.112.252:domain,0,0,1,72,1,72,1.296885000,0.0000
92.27.219.218:61499,<->,0.243.138.167:55650,1,62,0,0,1,62,1.296704000,0.0000
106.157.38.242:37294,<->,108.134.108.77:33220,0,0,1,50,1,50,1.296630000,0.0000
101.224.89.159:14974,<->,148.155.129.25:domain,1,169,0,0,1,169,1.296602000,0.0000
144.75.218.241:43593,<->,8.222.218.207:domain,1,123,0,0,1,123,1.296419000,0.0000
106.157.38.242:37294,<->,108.134.108.77:18621,0,0,1,50,1,50,1.296005000,0.0000
97.126.26.70:45638,<->,138.127.224.168:domain,1,303,0,0,1,303,1.295724000,0.0000
100.180.208.148:44822,<->,92.27.219.46:38641,0,0,1,52,1,52,1.295350000,0.0000
144.75.218.237:48121,<->,8.222.218.204:domain,1,114,0,0,1,114,1.295160000,0.0000
144.75.218.242:cisco-sccp,<->,8.222.218.199:domain,1,124,0,0,1,124,1.294983000,0.0000
199.36.151.146:54328,<->,246.253.253.210:https,0,0,1,125,1,125,1.294857000,0.0000
144.75.218.242:52700,<->,8.222.218.196:domain,1,141,0,0,1,141,1.294702000,0.0000
92.27.27.181:19399,<->,89.166.53.86:13524,1,397,0,0,1,397,1.294420000,0.0000
136.25.188.105:54718,<->,135.88.171.34:domain,1,234,0,0,1,234,1.294227000,0.0000
114.145.122.251:32579,<->,129.224.112.252:domain,0,0,1,80,1,80,1.293881000,0.0000
104.95.121.154:6881,<->,98.129.112.137:6881,0,0,1,97,1,97,1.293654000,0.0000
106.157.38.242:37294,<->,108.134.108.77:21421,0,0,1,50,1,50,1.293631000,0.0000
55.221.163.100:35352,<->,109.222.244.46:domain,0,0,1,70,1,70,1.293478000,0.0000
106.157.38.242:37294,<->,108.134.108.77:35496,0,0,1,50,1,50,1.292776000,0.0000
106.157.38.242:37294,<->,108.134.108.77:37211,0,0,1,50,1,50,1.292696000,0.0000
144.75.218.246:20592,<->,132.200.124.228:domain,1,150,0,0,1,150,1.292622000,0.0000
108.134.108.77:63558,<->,106.157.38.242:37294,1,50,0,0,1,50,1.292135000,0.0000
210.156.155.20:41203,<->,156.29.237.157:10029,1,130,0,0,1,130,1.292049000,0.0000
97.242.126.187:51334,<->,129.224.112.252:domain,0,0,1,68,1,68,1.292043000,0.0000
144.75.218.237:58652,<->,120.155.84.97:domain,1,174,0,0,1,174,1.291715000,0.0000
108.134.108.77:46492,<->,106.157.38.242:37294,1,50,0,0,1,50,1.291430000,0.0000
101.224.89.159:39016,<->,148.155.129.25:domain,1,173,0,0,1,173,1.291120000,0.0000
106.157.38.242:37294,<->,108.134.108.77:34797,0,0,1,50,1,50,1.291022000,0.0000
106.157.38.242:37294,<->,108.134.108.77:31410,0,0,1,50,1,50,1.290864000,0.0000
120.18.126.117:56278,<->,109.222.234.241:domain,0,0,1,70,1,70,1.290647000,0.0000
21.15.226.126:55104,<->,20.193.28.182:netbios-ns,0,0,1,82,1,82,1.290306000,0.0000
109.222.192.25:41304,<->,114.199.58.229:delta-mcp,1,52,0,0,1,52,1.290148000,0.0000
144.75.218.241:9356,<->,8.222.218.207:domain,1,113,0,0,1,113,1.289966000,0.0000
38.65.197.7:45161,<->,247.136.216.62:24682,0,0,1,52,1,52,1.289949000,0.0000
144.75.218.237:44944,<->,138.127.225.148:domain,1,355,0,0,1,355,1.289914000,0.0000
108.134.108.77:58527,<->,106.157.38.242:37294,1,50,0,0,1,50,1.289820000,0.0000
108.134.108.77:60753,<->,106.157.38.242:37294,1,50,0,0,1,50,1.289660000,0.0000
93.20.89.159:10478,<->,89.183.104.238:lofr-lm,0,0,1,224,1,224,1.289567000,0.0000
21.15.226.126:55104,<->,20.193.28.175:netbios-ns,0,0,1,82,1,82,1.289515000,0.0000
144.75.218.241:7739,<->,138.127.225.198:domain,1,289,0,0,1,289,1.289016000,0.0000
144.75.218.241:5622,<->,8.222.218.196:domain,1,121,0,0,1,121,1.288898000,0.0000
247.136.226.219:60200,<->,27.75.209.190:44844,1,485,0,0,1,485,1.288632000,0.0000
106.157.38.242:37294,<->,108.134.108.77:14086,0,0,1,50,1,50,1.288124000,0.0000
220.38.84.85:37055,<->,215.158.140.11:domain,0,0,1,90,1,90,1.287933000,0.0000
10.185.194.151:25464,<->,109.222.255.50:domain,0,0,1,78,1,78,1.287562000,0.0000
21.15.226.126:55104,<->,20.193.28.177:netbios-ns,0,0,1,82,1,82,1.287359000,0.0000
144.75.218.242:34829,<->,8.222.218.199:domain,1,110,0,0,1,110,1.286981000,0.0000
144.75.218.242:41418,<->,8.222.218.199:domain,1,110,0,0,1,110,1.286925000,0.0000
144.75.218.246:36565,<->,8.222.218.204:domain,1,122,0,0,1,122,1.286845000,0.0000
108.134.108.77:53549,<->,106.157.38.242:37294,1,50,0,0,1,50,1.286830000,0.0000
144.75.218.241:4933,<->,8.222.218.207:domain,1,110,0,0,1,110,1.285928000,0.0000
192.67.161.166:42685,<->,134.254.80.75:32247,1,135,0,0,1,135,1.285825000,0.0000
136.25.188.105:51828,<->,132.5.71.202:domain,1,289,0,0,1,289,1.285817000,0.0000
27.188.163.162:i-net-2000-npr,<->,109.1.16.168:sip,0,0,1,446,1,446,1.285535000,0.0000
109.1.49.223:35108,<->,74.239.239.153:10414,1,133,0,0,1,133,1.285528000,0.0000
192.224.146.246:35732,<->,133.178.226.107:12347,0,0,1,1064,1,1064,1.285358000,0.0000
210.226.165.98:38997,<->,53.84.186.205:8245,1,56,0,0,1,56,1.284949000,0.0000
103.237.215.117:39702,<->,92.27.219.208:14502,0,0,1,52,1,52,1.283784000,0.0000
144.75.218.233:49504,<->,132.200.124.228:domain,1,143,0,0,1,143,1.283419000,0.0000
144.75.218.246:29718,<->,8.222.218.199:domain,1,110,0,0,1,110,1.283290000,0.0000
82.136.228.64:38959,<->,101.70.107.137:domain,0,0,1,70,1,70,1.282915000,0.0000
133.191.124.35:53860,<->,129.175.139.119:domain,1,88,0,0,1,88,1.282885000,0.0000
20.183.64.44:20554,<->,128.153.37.180:domain,1,72,0,0,1,72,1.282329000,0.0000
89.183.104.233:37820,<->,192.67.179.218:6881,1,263,0,0,1,263,1.282146000,0.0000
215.158.103.219:35074,<->,138.127.231.206:domain,1,155,0,0,1,155,1.282097000,0.0000
144.75.218.237:45309,<->,8.222.218.204:domain,1,110,0,0,1,110,1.282055000,0.0000
230.87.239.94:62735,<->,109.3.163.238:49751,0,0,1,351,1,351,1.281689000,0.0000
136.25.189.243:41764,<->,102.42.102.64:domain,1,329,0,0,1,329,1.281484000,0.0000
132.249.70.233:63730,<->,128.231.178.26:domain,1,158,0,0,1,158,1.281306000,0.0000
8.228.214.124:58457,<->,223.140.87.220:32838,1,98,0,0,1,98,1.280774000,0.0000
144.75.218.235:51130,<->,8.222.218.198:domain,1,139,0,0,1,139,1.280446000,0.0000
215.158.103.206:41149,<->,129.221.194.239:domain,1,525,0,0,1,525,1.279837000,0.0000
39.171.2.46:19243,<->,146.154.162.236:domain,1,74,0,0,1,74,1.279797000,0.0000
:::33384,<->,:::domain,0,0,1,69,1,69,1.279680000,0.0000
33.57.79.34:40052,<->,92.27.219.37:13502,0,0,1,135,1,135,1.279152000,0.0000
144.75.218.242:13347,<->,8.222.218.199:domain,1,109,0,0,1,109,1.279144000,0.0000
144.75.218.241:6470,<->,8.222.218.196:domain,1,121,0,0,1,121,1.279084000,0.0000
101.224.185.49:25445,<->,48.104.80.96:listcrt-port,1,57,0,0,1,57,1.278977000,0.0000
89.183.104.172:54312,<->,42.246.37.114:30277,1,52,0,0,1,52,1.278405000,0.0000
144.75.218.242:45243,<->,149.224.49.236:domain,1,70,0,0,1,70,1.277672000,0.0000
144.75.218.237:17820,<->,8.222.218.204:domain,1,122,0,0,1,122,1.277538000,0.0000
144.75.218.242:38748,<->,140.136.104.193:domain,1,121,0,0,1,121,1.276900000,0.0000
139.241.115.2:43858,<->,80.56.78.94:domain,0,0,1,84,1,84,1.275839000,0.0000
21.15.226.126:55104,<->,20.193.28.247:netbios-ns,0,0,1,82,1,82,1.275721000,0.0000
89.183.104.136:30770,<->,193.46.99.107:21366,1,90,0,0,1,90,1.275621000,0.0000
8.252.222.181:52521,<->,120.155.87.47:domain,1,132,0,0,1,132,1.275278000,0.0000
97.242.126.200:50719,<->,129.224.112.252:domain,0,0,1,75,1,75,1.275208000,0.0000
221.150.250.237:59737,<->,254.82.206.131:domain,1,134,0,0,1,134,1.274844000,0.0000
105.83.237.194:26838,<->,109.222.235.84:domain,0,0,1,79,1,79,1.274528000,0.0000
144.75.218.233:ccu-comm-1,<->,227.56.190.69:domain,1,63,0,0,1,63,1.274271000,0.0000
144.76.43.246:29322,<->,144.122.240.237:domain,0,0,1,75,1,75,1.273889000,0.0000
144.89.113.56:7519,<->,129.224.112.252:domain,0,0,1,76,1,76,1.273885000,0.0000
92.27.219.33:37318,<->,207.198.142.213:1024,1,52,0,0,1,52,1.273693000,0.0000
78.126.223.125:49057,<->,210.220.218.36:domain,0,0,1,68,1,68,1.273665000,0.0000
144.75.218.237:6117,<->,120.155.84.97:domain,1,146,0,0,1,146,1.273571000,0.0000
8.176.8.85:48674,<->,118.20.111.94:domain,1,161,0,0,1,161,1.273233000,0.0000
141.93.238.50:aocp,<->,129.224.112.252:domain,0,0,1,80,1,80,1.272248000,0.0000
144.75.218.237:41075,<->,8.222.218.198:domain,1,125,0,0,1,125,1.271982000,0.0000
144.106.237.27:isakmp,<->,139.163.114.182:isakmp,0,0,1,116,1,116,1.271761000,0.0000
224.115.136.169:55100,<->,111.146.249.17:44644,0,0,1,129,1,129,1.270439000,0.0000
20.209.211.182:26105,<->,207.60.153.205:domain,1,75,0,0,1,75,1.270304000,0.0000
20.194.30.195:63859,<->,205.44.229.55:56871,1,52,0,0,1,52,1.269629000,0.0000
144.75.218.235:18125,<->,8.222.218.197:domain,1,122,0,0,1,122,1.269543000,0.0000
156.152.130.177:50719,<->,129.224.112.252:domain,0,0,1,77,1,77,1.269480000,0.0000
144.75.218.237:12888,<->,8.222.218.204:domain,1,122,0,0,1,122,1.268428000,0.0000
144.75.218.233:52919,<->,54.38.169.95:domain,1,126,0,0,1,126,1.268192000,0.0000
106.213.35.197:52511,<->,129.224.112.252:domain,0,0,1,73,1,73,1.267525000,0.0000
144.75.218.241:14745,<->,8.222.218.207:domain,1,126,0,0,1,126,1.267337000,0.0000
144.75.218.241:41733,<->,115.151.47.145:domain,1,203,0,0,1,203,1.267334000,0.0000
148.215.253.0:16342,<->,246.254.97.149:domain,0,0,1,84,1,84,1.267331000,0.0000
21.15.226.126:55104,<->,20.193.28.194:netbios-ns,0,0,1,82,1,82,1.267161000,0.0000
29.212.192.189:45838,<->,215.158.140.8:domain,0,0,1,90,1,90,1.266889000,0.0000
252.136.244.22:29188,<->,97.68.226.205:domain,0,0,1,77,1,77,1.266400000,0.0000
106.157.38.242:33959,<->,108.134.108.77:28763,0,0,1,50,1,50,1.266202000,0.0000
125.60.211.179:51413,<->,89.183.104.178:13570,0,0,1,62,1,62,1.266184000,0.0000
101.87.248.103:55448,<->,132.249.70.213:domain,0,0,1,125,1,125,1.266013000,0.0000
20.97.6.71:hppronetman,<->,143.99.27.229:domain,1,76,0,0,1,76,1.265706000,0.0000
192.64.247.45:49333,<->,206.188.93.145:18157,1,103,0,0,1,103,1.264714000,0.0000
122.102.188.46:54814,<->,192.64.217.166:1024,0,0,1,52,1,52,1.264670000,0.0000
215.158.103.219:34509,<->,129.229.242.60:domain,1,789,0,0,1,789,1.264612000,0.0000
92.27.219.46:45213,<->,69.196.187.52:33925,1,52,0,0,1,52,1.264438000,0.0000
106.157.38.242:33959,<->,108.134.108.77:9677,0,0,1,50,1,50,1.264289000,0.0000
108.134.108.77:63396,<->,106.157.38.242:33959,1,50,0,0,1,50,1.264179000,0.0000
106.157.38.242:33959,<->,108.134.108.77:gbs-smp,0,0,1,50,1,50,1.264024000,0.0000
99.248.12.145:29388,<->,92.27.219.196:10422,0,0,1,135,1,135,1.263799000,0.0000
120.178.111.142:57161,<->,92.27.219.20:49160,0,0,1,62,1,62,1.263782000,0.0000
99.72.132.173:4433,<->,27.151.38.15:itscomm-ns,1,62,0,0,1,62,1.263733000,0.0000
21.15.226.126:55104,<->,20.193.29.211:netbios-ns,0,0,1,82,1,82,1.263639000,0.0000
143.252.64.235:20982,<->,220.55.70.6:domain,0,0,1,72,1,72,1.263527000,0.0000
92.27.27.183:46879,<->,203.142.79.172:15730,1,52,0,0,1,52,1.263412000,0.0000
215.158.239.229:64104,<->,113.23.83.211:domain,1,141,0,0,1,141,1.263044000,0.0000
215.158.103.206:26113,<->,159.151.90.195:domain,1,138,0,0,1,138,1.262981000,0.0000
89.183.104.233:37912,<->,117.254.120.156:30359,1,263,0,0,1,263,1.261867000,0.0000
144.75.218.241:20196,<->,138.127.225.151:domain,1,261,0,0,1,261,1.261300000,0.0000
144.75.218.233:37207,<->,99.168.7.150:domain,1,126,0,0,1,126,1.261244000,0.0000
108.134.108.77:51623,<->,106.157.38.242:33959,1,50,0,0,1,50,1.261052000,0.0000
92.27.219.205:64007,<->,135.225.138.249:36595,1,52,0,0,1,52,1.260840000,0.0000
108.134.108.77:44119,<->,106.157.38.242:33959,1,50,0,0,1,50,1.260717000,0.0000
8.252.222.189:61063,<->,192.171.13.33:domain,1,95,0,0,1,95,1.260717000,0.0000
144.108.80.167:50373,<->,159.69.187.47:domain,0,0,1,73,1,73,1.260681000,0.0000
108.134.108.77:37690,<->,106.157.38.242:33959,1,50,0,0,1,50,1.260625000,0.0000
20.194.30.195:63859,<->,126.83.231.6:17671,1,52,0,0,1,52,1.260237000,0.0000
144.75.218.241:17255,<->,199.90.130.244:domain,1,165,0,0,1,165,1.260047000,0.0000
144.75.218.237:11687,<->,8.222.218.199:domain,1,239,0,0,1,239,1.259670000,0.0000
33.240.107.135:62693,<->,109.1.60.170:57937,0,0,1,52,1,52,1.259467000,0.0000
144.75.218.237:53713,<->,8.222.218.207:domain,1,123,0,0,1,123,1.259196000,0.0000
39.29.91.231:62410,<->,119.2.213.36:domain,1,90,0,0,1,90,1.259027000,0.0000
144.75.218.237:16927,<->,8.222.218.197:domain,1,113,0,0,1,113,1.258917000,0.0000
106.157.38.242:33959,<->,108.134.108.77:masc,0,0,1,50,1,50,1.258742000,0.0000
144.75.218.237:ita-agent,<->,120.155.84.97:domain,1,118,0,0,1,118,1.258312000,0.0000
122.42.0.96:61000,<->,92.27.235.58:20245,0,0,1,97,1,97,1.257936000,0.0000
141.92.221.223:facsys-router,<->,129.224.112.252:domain,0,0,1,74,1,74,1.257607000,0.0000
108.134.108.77:50669,<->,106.157.38.242:33959,1,50,0,0,1,50,1.257577000,0.0000
144.75.218.235:26253,<->,138.127.224.208:domain,1,253,0,0,1,253,1.257295000,0.0000
106.157.38.242:33959,<->,108.134.108.77:6383,0,0,1,50,1,50,1.257266000,0.0000
144.75.218.246:63113,<->,8.222.218.197:domain,1,111,0,0,1,111,1.256502000,0.0000
144.75.218.237:45287,<->,8.222.218.204:domain,1,110,0,0,1,110,1.256375000,0.0000
89.183.104.246:30774,<->,38.183.250.139:10714,1,52,0,0,1,52,1.256299000,0.0000
106.157.38.242:33959,<->,108.134.108.77:29630,0,0,1,50,1,50,1.256269000,0.0000
92.27.219.250:54654,<->,113.42.172.90:45634,1,52,0,0,1,52,1.255967000,0.0000
144.75.218.233:37331,<->,8.222.218.196:domain,1,110,0,0,1,110,1.255712000,0.0000
144.75.218.237:25347,<->,8.222.218.197:domain,1,140,0,0,1,140,1.255463000,0.0000
144.75.218.246:50202,<->,8.222.218.199:domain,1,122,0,0,1,122,1.255461000,0.0000
144.75.218.241:45728,<->,8.222.218.204:domain,1,114,0,0,1,114,1.254585000,0.0000
144.75.218.237:48845,<->,120.155.84.97:domain,1,236,0,0,1,236,1.254339000,0.0000
20.186.90.234:22893,<->,194.244.149.235:domain,1,75,0,0,1,75,1.253727000,0.0000
113.186.98.254:64111,<->,144.69.82.139:domain,0,0,1,69,1,69,1.253381000,0.0000
144.75.218.237:61912,<->,8.47.122.178:domain,1,100,0,0,1,100,1.252654000,0.0000
105.168.127.76:41992,<->,98.236.254.250:domain,0,0,1,76,1,76,1.252166000,0.0000
144.75.218.235:52285,<->,100.117.19.29:domain,1,81,0,0,1,81,1.251757000,0.0000
144.75.218.237:47754,<->,8.222.218.198:domain,1,110,0,0,1,110,1.250949000,0.0000
34.17.114.255:59804,<->,156.151.249.107:domain,1,72,0,0,1,72,1.249924000,0.0000
92.27.219.41:49700,<->,50.98.176.213:44619,1,309,0,0,1,309,1.249349000,0.0000
144.75.218.242:j-lan-p,<->,8.222.218.204:domain,1,153,0,0,1,153,1.249276000,0.0000
117.159.118.99:51692,<->,129.224.112.252:domain,0,0,1,75,1,75,1.249166000,0.0000
80.42.149.110:17785,<->,203.63.8.114:13350,1,52,0,0,1,52,1.248506000,0.0000
144.75.218.241:unot,<->,8.222.218.196:domain,1,122,0,0,1,122,1.248428000,0.0000
99.73.231.161:59927,<->,104.136.21.9:32123,1,52,0,0,1,52,1.248148000,0.0000
29.216.97.203:4708,<->,129.92.114.135:domain,0,0,1,73,1,73,1.247548000,0.0000
80.41.12.225:61072,<->,93.174.159.233:16179,1,321,0,0,1,321,1.246919000,0.0000
39.206.71.15:36488,<->,120.174.245.10:domain,1,74,0,0,1,74,1.246678000,0.0000
98.129.64.162:31129,<->,116.25.226.190:6881,1,97,0,0,1,97,1.246632000,0.0000
136.25.188.105:50165,<->,135.88.171.34:domain,1,131,0,0,1,131,1.246242000,0.0000
144.75.218.246:27389,<->,8.222.218.199:domain,1,110,0,0,1,110,1.245937000,0.0000
144.75.218.237:40200,<->,58.134.5.66:domain,1,178,0,0,1,178,1.245720000,0.0000
8.252.222.105:57085,<->,111.151.107.247:domain,1,224,0,0,1,224,1.245102000,0.0000
144.75.218.241:10756,<->,99.168.7.150:domain,1,101,0,0,1,101,1.244452000,0.0000
127.91.126.8:46435,<->,247.136.157.61:13044,0,0,1,52,1,52,1.244356000,0.0000
38.21.156.204:56633,<->,20.232.228.127:netbios-ns,0,0,1,82,1,82,1.243936000,0.0000
101.224.89.139:46394,<->,141.129.193.22:domain,1,255,0,0,1,255,1.243746000,0.0000
254.126.164.43:49885,<->,97.68.226.205:domain,0,0,1,77,1,77,1.243347000,0.0000
144.75.218.242:43567,<->,8.222.218.199:domain,1,121,0,0,1,121,1.243268000,0.0000
144.75.218.246:smauth-port,<->,138.127.224.104:domain,1,299,0,0,1,299,1.242806000,0.0000
144.75.218.241:7914,<->,138.127.224.101:domain,1,84,0,0,1,84,1.242795000,0.0000
159.133.61.244:33315,<->,53.149.236.92:domain,1,129,0,0,1,129,1.242660000,0.0000
143.88.15.74:41347,<->,215.158.239.74:domain,0,0,1,84,1,84,1.242446000,0.0000
132.222.173.36:5883,<->,138.127.229.147:domain,1,355,0,0,1,355,1.242239000,0.0000
197.197.245.29:42725,<->,139.207.222.11:domain,0,0,1,89,1,89,1.241846000,0.0000
109.222.238.0:54549,<->,138.127.225.194:domain,1,216,0,0,1,216,1.241814000,0.0000
20.3.36.209:64235,<->,38.88.61.181:domain,1,76,0,0,1,76,1.241007000,0.0000
114.235.254.115:49201,<->,92.27.219.183:orbixd,0,0,1,135,1,135,1.240737000,0.0000
196.28.180.242:57790,<->,246.253.253.211:https,0,0,1,125,1,125,1.240528000,0.0000
149.178.48.72:15787,<->,129.224.112.252:domain,0,0,1,73,1,73,1.240371000,0.0000
197.120.245.140:7135,<->,129.224.112.252:domain,0,0,1,78,1,78,1.240210000,0.0000
80.40.61.163:46532,<->,114.91.22.178:22402,1,99,0,0,1,99,1.239349000,0.0000
:::37011,<->,:::domain,1,691,0,0,1,691,1.238919000,0.0000
144.75.218.235:24718,<->,8.222.218.198:domain,1,122,0,0,1,122,1.238232000,0.0000
144.75.218.237:30941,<->,8.222.218.207:domain,1,122,0,0,1,122,1.237190000,0.0000
:::26947,<->,:::domain,1,796,0,0,1,796,1.237030000,0.0000
144.75.218.241:34339,<->,8.222.218.204:domain,1,126,0,0,1,126,1.236429000,0.0000
144.75.218.233:52098,<->,8.222.218.196:domain,1,169,0,0,1,169,1.235457000,0.0000
210.158.44.208:42067,<->,120.49.223.215:domain,1,671,0,0,1,671,1.235296000,0.0000
200.226.80.179:omginitialrefs,<->,129.92.113.143:chargen,0,0,1,50,1,50,1.234869000,0.0000
206.16.149.155:22881,<->,192.64.217.166:14773,0,0,1,52,1,52,1.234293000,0.0000
:::45048,<->,:::domain,1,438,0,0,1,438,1.234241000,0.0000
144.75.218.237:32838,<->,120.155.84.97:domain,1,144,0,0,1,144,1.234126000,0.0000
92.27.219.175:31503,<->,122.33.24.86:19595,1,190,0,0,1,190,1.234095000,0.0000
144.75.218.246:36035,<->,8.222.218.204:domain,1,121,0,0,1,121,1.233228000,0.0000
144.75.218.233:25258,<->,8.222.218.204:domain,1,122,0,0,1,122,1.233000000,0.0000
87.11.192.79:58723,<->,109.222.214.116:42577,0,0,1,325,1,325,1.232988000,0.0000
215.158.239.229:52587,<->,210.140.5.233:domain,1,136,0,0,1,136,1.232966000,0.0000
144.75.218.241:37445,<->,241.189.29.155:domain,1,125,0,0,1,125,1.232324000,0.0000
21.15.226.126:55104,<->,20.193.29.155:netbios-ns,0,0,1,82,1,82,1.232147000,0.0000
144.75.218.241:hrpd-ith-at-an,<->,138.127.230.220:domain,1,257,0,0,1,257,1.231696000,0.0000
144.75.218.246:60149,<->,8.222.218.204:domain,1,239,0,0,1,239,1.230715000,0.0000
113.127.190.72:59670,<->,89.183.104.156:50121,0,0,1,99,1,99,1.230593000,0.0000
125.154.210.13:61747,<->,92.27.219.193:37002,0,0,1,52,1,52,1.230463000,0.0000
8.252.222.105:33005,<->,192.171.13.189:domain,1,142,0,0,1,142,1.230079000,0.0000
144.75.218.246:9220,<->,8.222.218.199:domain,1,113,0,0,1,113,1.229271000,0.0000
159.237.225.1:51413,<->,121.227.142.184:49707,1,52,0,0,1,52,1.229122000,0.0000
38.21.156.204:56633,<->,20.232.228.122:netbios-ns,0,0,1,82,1,82,1.228724000,0.0000
144.75.218.237:16668,<->,8.222.218.198:domain,1,110,0,0,1,110,1.228671000,0.0000
8.252.222.105:38422,<->,192.171.13.189:domain,1,142,0,0,1,142,1.228442000,0.0000
78.128.203.22:55526,<->,39.15.169.14:domain,0,0,1,87,1,87,1.227219000,0.0000
132.249.70.233:53706,<->,192.178.173.46:domain,1,150,0,0,1,150,1.226714000,0.0000
206.20.245.151:36539,<->,92.27.219.17:17246,0,0,1,52,1,52,1.226270000,0.0000
111.75.58.59:50254,<->,56.121.48.108:domain,0,0,1,74,1,74,1.226181000,0.0000
101.224.204.193:41796,<->,114.56.125.199:domain,1,147,0,0,1,147,1.225748000,0.0000
246.253.253.12:isakmp,<->,57.18.136.2:isakmp,1,116,0,0,1,116,1.225441000,0.0000
144.75.218.237:61743,<->,8.222.218.207:domain,1,110,0,0,1,110,1.225190000,0.0000
144.75.218.237:sdo-ssh,<->,8.222.218.197:domain,1,110,0,0,1,110,1.225183000,0.0000
144.75.218.246:28073,<->,8.222.218.197:domain,1,127,0,0,1,127,1.225116000,0.0000
131.36.201.66:54995,<->,133.178.226.244:domain,0,0,1,90,1,90,1.225083000,0.0000
132.249.70.233:56984,<->,53.201.149.31:domain,1,98,0,0,1,98,1.224866000,0.0000
144.75.218.246:57013,<->,138.127.225.234:domain,1,254,0,0,1,254,1.224002000,0.0000
132.249.70.233:49995,<->,222.20.200.135:domain,1,136,0,0,1,136,1.223791000,0.0000
144.75.218.246:21457,<->,8.222.218.204:domain,1,122,0,0,1,122,1.223524000,0.0000
33.233.141.230:55229,<->,211.177.72.97:domain,1,92,0,0,1,92,1.223486000,0.0000
144.75.218.242:34489,<->,8.222.218.207:domain,1,122,0,0,1,122,1.222957000,0.0000
53.212.189.88:20405,<->,246.253.248.211:domain,0,0,1,87,1,87,1.222807000,0.0000
92.160.14.37:65364,<->,129.224.112.252:domain,0,0,1,80,1,80,1.222462000,0.0000
144.75.218.246:16298,<->,8.222.218.197:domain,1,110,0,0,1,110,1.222286000,0.0000
144.75.218.241:ironmail,<->,120.155.84.97:domain,1,222,0,0,1,222,1.222150000,0.0000
144.75.218.242:ecp,<->,8.222.218.199:domain,1,124,0,0,1,124,1.221573000,0.0000
111.146.132.89:10411,<->,120.252.12.7:domain,1,78,0,0,1,78,1.221330000,0.0000
92.27.219.53:48176,<->,250.50.35.185:6881,1,74,0,0,1,74,1.221057000,0.0000
108.134.108.77:52999,<->,106.157.38.242:33959,1,50,0,0,1,50,1.220955000,0.0000
143.252.64.230:27140,<->,129.224.112.252:domain,0,0,1,70,1,70,1.220833000,0.0000
144.75.218.237:64418,<->,8.222.218.207:domain,1,149,0,0,1,149,1.220563000,0.0000
144.75.218.235:20363,<->,8.222.218.198:domain,1,122,0,0,1,122,1.220529000,0.0000
136.25.188.105:16542,<->,124.63.211.122:domain,1,236,0,0,1,236,1.220259000,0.0000
33.57.74.181:38741,<->,220.55.75.167:domain,0,0,1,75,1,75,1.219945000,0.0000
48.53.146.152:63105,<->,54.36.174.41:24094,1,52,0,0,1,52,1.219769000,0.0000
144.75.218.242:48093,<->,8.222.218.199:domain,1,110,0,0,1,110,1.219551000,0.0000
27.117.27.216:51413,<->,92.27.219.189:47496,0,0,1,317,1,317,1.219248000,0.0000
106.157.38.242:33959,<->,108.134.108.77:spw-dialer,0,0,1,50,1,50,1.219092000,0.0000
106.157.38.242:33959,<->,108.134.108.77:k-block,0,0,1,50,1,50,1.218915000,0.0000
92.160.14.37:61460,<->,129.224.112.252:domain,0,0,1,78,1,78,1.218894000,0.0000
108.134.108.77:61129,<->,106.157.38.242:33959,1,50,0,0,1,50,1.218646000,0.0000
108.134.108.77:61576,<->,106.157.38.242:33959,1,50,0,0,1,50,1.218241000,0.0000
202.226.243.164:16984,<->,145.89.157.42:6881,0,0,1,130,1,130,1.218103000,0.0000
106.157.38.242:33959,<->,108.134.108.77:22923,0,0,1,50,1,50,1.217941000,0.0000
144.75.218.246:17734,<->,8.222.218.204:domain,1,111,0,0,1,111,1.217512000,0.0000
48.120.106.220:64329,<->,109.222.243.161:domain,0,0,1,80,1,80,1.217351000,0.0000
108.134.108.77:54865,<->,106.157.38.242:33959,1,50,0,0,1,50,1.217294000,0.0000
108.134.108.77:57543,<->,106.157.38.242:33959,1,50,0,0,1,50,1.216384000,0.0000
144.75.218.246:50253,<->,8.222.218.197:domain,1,114,0,0,1,114,1.216321000,0.0000
145.213.37.26:47046,<->,136.129.94.107:domain,0,0,1,84,1,84,1.215928000,0.0000
158.59.135.25:48392,<->,92.27.219.38:25521,0,0,1,52,1,52,1.215909000,0.0000
8.176.8.207:59278,<->,192.171.13.188:domain,1,101,0,0,1,101,1.215074000,0.0000
89.183.104.149:16554,<->,119.45.235.115:6881,1,309,0,0,1,309,1.215070000,0.0000
144.75.218.246:27068,<->,8.222.218.197:domain,1,123,0,0,1,123,1.214705000,0.0000
108.134.108.77:47937,<->,106.157.38.242:33959,1,50,0,0,1,50,1.214641000,0.0000
108.134.108.77:47341,<->,106.157.38.242:33959,1,50,0,0,1,50,1.214221000,0.0000
144.75.218.235:43946,<->,8.222.218.197:domain,1,122,0,0,1,122,1.214074000,0.0000
108.134.108.77:57909,<->,106.157.38.242:33959,1,50,0,0,1,50,1.213847000,0.0000
108.134.108.77:54002,<->,106.157.38.242:33959,1,50,0,0,1,50,1.213755000,0.0000
148.145.2.122:48925,<->,101.224.204.141:domain,0,0,1,80,1,80,1.213063000,0.0000
108.134.108.77:34559,<->,106.157.38.242:33959,1,50,0,0,1,50,1.212995000,0.0000
144.75.218.241:37868,<->,8.222.218.207:domain,1,123,0,0,1,123,1.212586000,0.0000
100.120.38.126:56611,<->,144.69.82.139:domain,0,0,1,75,1,75,1.212577000,0.0000
144.93.125.48:50885,<->,144.93.121.10:18385,0,0,1,104,1,104,1.212431000,0.0000
21.15.226.126:55104,<->,20.193.30.1:netbios-ns,0,0,1,82,1,82,1.212103000,0.0000
78.51.80.203:64060,<->,159.115.66.251:51413,0,0,1,52,1,52,1.211821000,0.0000
92.27.219.182:34255,<->,66.247.36.243:8551,1,136,0,0,1,136,1.211447000,0.0000
143.200.139.20:23917,<->,129.224.112.252:domain,0,0,1,80,1,80,1.210243000,0.0000
220.55.91.56:domain,<->,139.155.70.249:domain,1,149,0,0,1,149,1.210212000,0.0000
144.75.218.241:9576,<->,138.127.231.83:domain,1,253,0,0,1,253,1.210199000,0.0000
144.75.218.246:plato-lm,<->,8.222.218.204:domain,1,110,0,0,1,110,1.210193000,0.0000
144.75.218.233:6748,<->,8.222.218.197:domain,1,113,0,0,1,113,1.210119000,0.0000
144.75.218.237:54444,<->,8.222.218.198:domain,1,113,0,0,1,113,1.210112000,0.0000
92.27.219.224:46837,<->,120.83.1.71:6881,1,129,0,0,1,129,1.209786000,0.0000
144.75.218.237:65103,<->,8.222.218.207:domain,1,110,0,0,1,110,1.209098000,0.0000
198.25.75.198:18354,<->,80.40.57.229:bacula-dir,0,0,1,130,1,130,1.208491000,0.0000
126.119.197.36:61629,<->,192.64.210.96:50321,0,0,1,319,1,319,1.208454000,0.0000
89.183.104.178:18509,<->,38.87.182.252:14107,1,62,0,0,1,62,1.208115000,0.0000
29.169.76.213:25159,<->,92.27.219.204:14506,0,0,1,1452,1,1452,1.208038000,0.0000
144.75.218.246:25506,<->,8.222.218.204:domain,1,107,0,0,1,107,1.208001000,0.0000
145.213.37.25:61477,<->,136.129.94.109:domain,0,0,1,84,1,84,1.207910000,0.0000
144.75.218.246:37866,<->,8.222.218.199:domain,1,179,0,0,1,179,1.206550000,0.0000
101.229.93.43:48459,<->,132.249.70.213:domain,0,0,1,106,1,106,1.206097000,0.0000
132.200.108.136:52166,<->,129.224.112.221:domain,0,0,1,92,1,92,1.205925000,0.0000
132.249.70.233:61594,<->,53.178.104.39:domain,1,87,0,0,1,87,1.205859000,0.0000
92.27.8.182:39451,<->,138.127.224.192:domain,1,162,0,0,1,162,1.205340000,0.0000
144.75.218.241:34758,<->,8.222.218.207:domain,1,124,0,0,1,124,1.204783000,0.0000
144.75.218.242:34823,<->,8.222.218.199:domain,1,151,0,0,1,151,1.203280000,0.0000
144.75.218.242:49540,<->,8.222.218.207:domain,1,113,0,0,1,113,1.202365000,0.0000
144.75.218.242:59778,<->,8.222.218.196:domain,1,110,0,0,1,110,1.201745000,0.0000
92.27.219.242:43593,<->,196.126.208.63:40753,1,52,0,0,1,52,1.201362000,0.0000
144.75.218.237:62565,<->,138.127.230.5:domain,1,279,0,0,1,279,1.201318000,0.0000
144.75.218.241:47527,<->,8.222.218.196:domain,1,110,0,0,1,110,1.201207000,0.0000
33.245.146.245:15309,<->,92.27.27.183:11407,0,0,1,52,1,52,1.200676000,0.0000
144.75.218.242:31435,<->,8.222.218.199:domain,1,122,0,0,1,122,1.200529000,0.0000
33.182.213.211:15323,<->,20.61.49.107:rimsl,0,0,1,80,1,80,1.200411000,0.0000
39.227.147.56:48236,<->,72.198.225.4:domain,1,66,0,0,1,66,1.199850000,0.0000
144.75.218.237:18526,<->,8.222.218.197:domain,1,123,0,0,1,123,1.199620000,0.0000
92.27.219.128:46007,<->,96.232.117.46:domain,1,151,0,0,1,151,1.199490000,0.0000
205.91.195.56:29431,<->,89.183.104.191:ftp-data,0,0,1,52,1,52,1.198596000,0.0000
144.75.218.242:aura,<->,8.222.218.204:domain,1,123,0,0,1,123,1.197987000,0.0000
8.228.214.59:62355,<->,148.141.109.98:6881,1,112,0,0,1,112,1.196360000,0.0000
144.75.218.246:26570,<->,8.222.218.197:domain,1,123,0,0,1,123,1.196349000,0.0000
6.186.47.64:11706,<->,200.174.202.105:vsamredirector,0,0,1,273,1,273,1.195972000,0.0000
119.219.189.202:40899,<->,80.41.53.34:12242,0,0,1,325,1,325,1.195709000,0.0000
144.75.218.237:54235,<->,120.155.84.97:domain,1,144,0,0,1,144,1.195538000,0.0000
144.75.218.241:20634,<->,8.222.218.207:domain,1,123,0,0,1,123,1.195459000,0.0000
20.169.41.156:60983,<->,194.107.29.92:domain,1,174,0,0,1,174,1.195349000,0.0000
:::39551,<->,:::domain,1,691,0,0,1,691,1.195108000,0.0000
132.249.70.233:57718,<->,139.114.208.34:domain,1,131,0,0,1,131,1.194785000,0.0000
144.75.218.237:6563,<->,130.61.250.229:domain,1,126,0,0,1,126,1.194614000,0.0000
215.158.239.124:62138,<->,112.88.209.14:domain,1,140,0,0,1,140,1.194535000,0.0000
39.18.16.156:14727,<->,152.134.187.138:domain,1,541,0,0,1,541,1.194525000,0.0000
144.75.218.233:21328,<->,138.127.225.15:domain,1,197,0,0,1,197,1.194018000,0.0000
144.75.218.242:45694,<->,8.222.218.199:domain,1,110,0,0,1,110,1.193887000,0.0000
144.75.218.235:31668,<->,139.252.1.234:domain,1,180,0,0,1,180,1.193509000,0.0000
144.75.218.246:6169,<->,8.222.218.204:domain,1,122,0,0,1,122,1.193493000,0.0000
39.166.150.51:58887,<->,127.27.251.233:domain,1,128,0,0,1,128,1.193210000,0.0000
215.158.239.229:37009,<->,8.47.188.160:domain,1,151,0,0,1,151,1.193197000,0.0000
136.25.188.105:62066,<->,238.125.29.51:domain,1,138,0,0,1,138,1.192781000,0.0000
144.76.43.242:12648,<->,80.56.78.128:domain,0,0,1,98,1,98,1.192591000,0.0000
144.75.218.246:50935,<->,8.222.218.199:domain,1,111,0,0,1,111,1.192293000,0.0000
144.75.218.241:17438,<->,8.222.218.207:domain,1,111,0,0,1,111,1.192170000,0.0000
38.21.156.204:56633,<->,20.232.228.104:netbios-ns,0,0,1,82,1,82,1.192013000,0.0000
97.126.39.127:13546,<->,57.141.118.57:6881,1,97,0,0,1,97,1.191800000,0.0000
29.211.165.84:37364,<->,133.178.227.7:domain,0,0,1,85,1,85,1.191720000,0.0000
144.75.218.246:51310,<->,8.222.218.199:domain,1,190,0,0,1,190,1.191616000,0.0000
144.75.218.233:7081,<->,138.127.224.73:domain,1,184,0,0,1,184,1.190830000,0.0000
136.25.188.105:51771,<->,128.243.151.33:domain,1,251,0,0,1,251,1.190251000,0.0000
144.75.218.237:49757,<->,8.222.218.197:domain,1,111,0,0,1,111,1.190078000,0.0000
144.75.218.242:10774,<->,8.222.218.207:domain,1,110,0,0,1,110,1.189951000,0.0000
144.75.218.235:38662,<->,8.222.218.198:domain,1,122,0,0,1,122,1.189948000,0.0000
144.75.218.237:25815,<->,33.229.58.179:domain,1,127,0,0,1,127,1.189792000,0.0000
136.25.188.105:53858,<->,146.253.87.247:domain,1,126,0,0,1,126,1.189777000,0.0000
26.239.129.100:34122,<->,109.222.234.213:domain,0,0,1,72,1,72,1.189647000,0.0000
29.165.54.202:57610,<->,92.27.219.63:vlsi-lm,0,0,1,52,1,52,1.189399000,0.0000
33.233.141.70:45263,<->,111.20.172.70:domain,1,97,0,0,1,97,1.188762000,0.0000
220.28.104.139:22071,<->,220.55.126.117:domain,0,0,1,76,1,76,1.188756000,0.0000
117.7.164.34:57061,<->,39.32.47.103:52568,0,0,1,84,1,84,1.188724000,0.0000
144.93.121.83:42129,<->,131.2.34.14:28407,1,104,0,0,1,104,1.188580000,0.0000
35.62.71.37:14608,<->,144.69.82.139:domain,0,0,1,58,1,58,1.188378000,0.0000
39.28.155.53:54118,<->,111.2.141.22:domain,1,89,0,0,1,89,1.188003000,0.0000
89.183.104.155:58746,<->,127.79.61.116:33436,1,149,0,0,1,149,1.187416000,0.0000
144.75.218.235:30111,<->,138.127.231.62:domain,1,204,0,0,1,204,1.186372000,0.0000
8.193.74.84:61715,<->,136.116.28.199:12347,0,0,1,1064,1,1064,1.186278000,0.0000
144.75.218.242:39301,<->,8.222.218.207:domain,1,113,0,0,1,113,1.185870000,0.0000
124.40.23.147:48810,<->,92.27.219.49:31258,0,0,1,52,1,52,1.185810000,0.0000
27.188.163.162:i-net-2000-npr,<->,109.1.16.245:sip,0,0,1,443,1,443,1.185232000,0.0000
117.111.143.108:41132,<->,192.67.149.88:38504,0,0,1,853,1,853,1.184909000,0.0000
215.158.140.181:60603,<->,111.151.107.247:domain,1,96,0,0,1,96,1.184016000,0.0000
144.75.218.233:42673,<->,138.127.224.184:domain,1,365,0,0,1,365,1.183739000,0.0000
210.156.127.28:bacula-dir,<->,94.194.6.39:7756,1,133,0,0,1,133,1.183285000,0.0000
144.75.218.237:56218,<->,99.168.7.150:domain,1,135,0,0,1,135,1.182808000,0.0000
92.27.219.169:37272,<->,121.212.205.4:linx,1,110,0,0,1,110,1.182686000,0.0000
57.31.51.159:64758,<->,108.134.111.22:domain,0,0,1,83,1,83,1.182551000,0.0000
215.158.103.219:38275,<->,129.203.66.31:domain,1,672,0,0,1,672,1.182086000,0.0000
39.14.27.228:fjappmgrbulk,<->,57.31.49.198:domain,1,125,0,0,1,125,1.182000000,0.0000
109.1.61.116:64222,<->,74.245.228.7:8864,1,133,0,0,1,133,1.181709000,0.0000
144.75.218.237:55752,<->,8.222.218.197:domain,1,122,0,0,1,122,1.181682000,0.0000
20.122.133.235:43372,<->,105.92.5.230:domain,1,80,0,0,1,80,1.181417000,0.0000
139.241.119.211:48197,<->,39.15.169.14:domain,0,0,1,86,1,86,1.181371000,0.0000
120.194.177.4:60321,<->,92.27.27.164:40047,0,0,1,103,1,103,1.180321000,0.0000
144.75.218.235:45329,<->,8.222.218.198:domain,1,114,0,0,1,114,1.180291000,0.0000
144.75.218.242:35764,<->,8.222.218.199:domain,1,110,0,0,1,110,1.180156000,0.0000
144.75.218.233:9723,<->,8.222.218.204:domain,1,113,0,0,1,113,1.179813000,0.0000
21.15.226.126:55104,<->,20.193.30.67:netbios-ns,0,0,1,82,1,82,1.179385000,0.0000
132.249.70.233:62410,<->,135.197.3.172:domain,1,120,0,0,1,120,1.179289000,0.0000
97.126.26.70:41734,<->,130.42.10.219:domain,1,173,0,0,1,173,1.178745000,0.0000
144.75.218.242:50664,<->,8.222.218.199:domain,1,114,0,0,1,114,1.177226000,0.0000
132.249.70.233:60454,<->,53.201.149.31:domain,1,88,0,0,1,88,1.176986000,0.0000
89.183.104.150:20329,<->,205.91.179.235:17576,1,52,0,0,1,52,1.176962000,0.0000
20.147.15.136:50557,<->,153.99.69.27:netinfo-local,1,62,0,0,1,62,1.176584000,0.0000
144.75.218.233:37545,<->,8.222.218.197:domain,1,125,0,0,1,125,1.176550000,0.0000
192.64.250.118:64672,<->,115.179.112.80:62210,1,50,0,0,1,50,1.176304000,0.0000
111.20.168.4:42406,<->,115.167.81.247:domain,1,110,0,0,1,110,1.175883000,0.0000
80.200.62.165:63976,<->,97.126.18.233:domain,0,0,1,70,1,70,1.175724000,0.0000
114.224.195.75:62346,<->,109.222.193.244:domain,0,0,1,77,1,77,1.175528000,0.0000
95.30.133.114:29156,<->,8.228.217.218:domain,0,0,1,67,1,67,1.175485000,0.0000
144.75.218.246:41931,<->,8.222.218.204:domain,1,113,0,0,1,113,1.174966000,0.0000
101.224.89.180:14763,<->,148.155.129.25:domain,1,173,0,0,1,173,1.174740000,0.0000
144.75.218.246:60541,<->,8.222.218.197:domain,1,111,0,0,1,111,1.174574000,0.0000
136.25.188.105:55309,<->,140.136.9.105:domain,1,139,0,0,1,139,1.174505000,0.0000
144.75.218.246:metaedit-ws,<->,8.222.218.197:domain,1,121,0,0,1,121,1.174242000,0.0000
89.183.104.168:55793,<->,120.83.117.77:6881,1,309,0,0,1,309,1.174149000,0.0000
144.75.218.242:39181,<->,8.222.218.199:domain,1,111,0,0,1,111,1.174112000,0.0000
144.75.218.237:dns-llq,<->,8.222.218.199:domain,1,110,0,0,1,110,1.174110000,0.0000
144.75.218.237:44596,<->,8.222.218.207:domain,1,150,0,0,1,150,1.173673000,0.0000
195.78.202.163:63095,<->,109.222.249.216:44836,0,0,1,99,1,99,1.173154000,0.0000
144.75.218.246:63436,<->,8.222.218.199:domain,1,110,0,0,1,110,1.173078000,0.0000
93.209.205.221:58724,<->,89.183.104.237:55457,0,0,1,84,1,84,1.172801000,0.0000
144.75.218.246:50648,<->,8.222.218.197:domain,1,121,0,0,1,121,1.172760000,0.0000
220.185.99.203:20518,<->,89.183.104.146:20396,0,0,1,351,1,351,1.172331000,0.0000
144.75.218.235:60416,<->,138.127.225.151:domain,1,263,0,0,1,263,1.172213000,0.0000
20.2.234.129:locus-con,<->,156.143.159.82:domain,1,68,0,0,1,68,1.172137000,0.0000
92.27.219.189:47284,<->,48.106.243.183:1024,1,135,0,0,1,135,1.171477000,0.0000
199.111.200.145:49813,<->,100.93.64.127:36201,0,0,1,138,1,138,1.171075000,0.0000
93.254.16.169:64933,<->,92.27.219.63:9533,0,0,1,52,1,52,1.171042000,0.0000
144.75.218.241:groove-dpp,<->,130.61.211.1:domain,1,70,0,0,1,70,1.170574000,0.0000
109.124.187.222:18201,<->,109.222.250.174:domain,0,0,1,76,1,76,1.169627000,0.0000
29.217.237.116:56501,<->,92.27.27.184:13845,0,0,1,52,1,52,1.169624000,0.0000
144.76.43.246:53136,<->,159.69.187.22:domain,0,0,1,76,1,76,1.169575000,0.0000
110.195.195.90:52014,<->,145.116.118.25:https,0,0,1,133,1,133,1.169458000,0.0000
192.67.152.128:60012,<->,120.118.162.203:5811,1,54,0,0,1,54,1.169420000,0.0000
144.75.218.233:24966,<->,138.127.231.39:domain,1,256,0,0,1,256,1.169155000,0.0000
102.51.208.201:40907,<->,144.76.46.38:domain,1,158,0,0,1,158,1.169027000,0.0000
144.75.218.237:37937,<->,8.222.218.197:domain,1,127,0,0,1,127,1.168194000,0.0000
144.71.44.73:12604,<->,124.125.130.196:domain,1,116,0,0,1,116,1.168166000,0.0000
92.27.27.179:59939,<->,115.65.147.17:6881,1,330,0,0,1,330,1.167852000,0.0000
136.25.188.105:33325,<->,129.70.124.49:domain,1,355,0,0,1,355,1.167743000,0.0000
144.75.218.233:56546,<->,99.168.7.150:domain,1,124,0,0,1,124,1.167235000,0.0000
39.5.176.34:52675,<->,197.81.130.216:domain,1,126,0,0,1,126,1.167099000,0.0000
144.75.218.237:49645,<->,53.167.244.138:domain,1,126,0,0,1,126,1.166783000,0.0000
104.141.11.186:25145,<->,102.51.24.236:6881,0,0,1,130,1,130,1.166734000,0.0000
89.183.104.159:56120,<->,38.139.96.253:28562,1,52,0,0,1,52,1.166285000,0.0000
39.15.234.173:56723,<->,138.55.243.19:53329,1,76,0,0,1,76,1.166198000,0.0000
124.149.71.236:44187,<->,192.64.229.25:36930,0,0,1,77,1,77,1.166157000,0.0000
144.75.218.237:57718,<->,8.222.218.199:domain,1,111,0,0,1,111,1.166090000,0.0000
140.9.184.155:36766,<->,129.224.112.252:domain,0,0,1,80,1,80,1.166013000,0.0000
99.75.19.169:44974,<->,204.40.75.199:ibm-abtact,1,102,0,0,1,102,1.165973000,0.0000
144.75.218.242:64442,<->,8.222.218.196:domain,1,111,0,0,1,111,1.165872000,0.0000
92.27.219.48:44514,<->,126.117.71.100:6881,1,97,0,0,1,97,1.165738000,0.0000
114.145.109.163:5855,<->,129.224.112.252:domain,0,0,1,80,1,80,1.165596000,0.0000
144.75.218.241:xoraya,<->,8.222.218.207:domain,1,110,0,0,1,110,1.165305000,0.0000
100.230.7.100:34580,<->,221.102.107.147:33438,0,0,1,50,1,50,1.165285000,0.0000
:::6194,<->,:::domain,1,172,0,0,1,172,1.165279000,0.0000
144.75.218.235:30747,<->,8.222.218.197:domain,1,122,0,0,1,122,1.164860000,0.0000
39.8.240.172:16738,<->,141.166.138.70:domain,1,126,0,0,1,126,1.164838000,0.0000
42.119.56.135:50306,<->,111.146.229.202:48824,0,0,1,168,1,168,1.164645000,0.0000
33.233.141.123:20868,<->,227.56.35.246:domain,1,167,0,0,1,167,1.163990000,0.0000
144.75.218.242:4392,<->,144.44.177.217:domain,1,162,0,0,1,162,1.163645000,0.0000
144.75.218.246:11048,<->,8.222.218.204:domain,1,122,0,0,1,122,1.163260000,0.0000
220.205.25.218:ntp,<->,218.4.168.6:ntp,0,0,1,80,1,80,1.163241000,0.0000
140.9.184.155:28808,<->,129.224.112.252:domain,0,0,1,81,1,81,1.163075000,0.0000
136.25.188.105:53972,<->,135.88.171.34:domain,1,231,0,0,1,231,1.162985000,0.0000
136.25.188.105:58283,<->,132.4.136.122:domain,1,166,0,0,1,166,1.162956000,0.0000
39.239.109.202:23515,<->,127.232.174.72:domain,1,70,0,0,1,70,1.162487000,0.0000
144.75.218.246:64394,<->,8.222.218.197:domain,1,113,0,0,1,113,1.162385000,0.0000
87.62.187.115:61168,<->,192.67.167.86:55106,0,0,1,52,1,52,1.162295000,0.0000
253.19.1.153:22723,<->,80.40.24.220:13986,0,0,1,54,1,54,1.162167000,0.0000
92.160.15.143:35844,<->,129.224.112.252:domain,0,0,1,79,1,79,1.161649000,0.0000
38.21.156.204:56633,<->,20.232.228.99:netbios-ns,0,0,1,82,1,82,1.161529000,0.0000
144.75.218.242:29919,<->,8.222.218.207:domain,1,122,0,0,1,122,1.161440000,0.0000
144.75.218.233:58558,<->,8.222.218.204:domain,1,122,0,0,1,122,1.161304000,0.0000
247.136.164.16:6881,<->,57.241.133.147:6881,1,97,0,0,1,97,1.160778000,0.0000
89.183.104.146:20396,<->,114.194.29.182:6881,1,322,0,0,1,322,1.160452000,0.0000
144.108.64.184:10433,<->,159.69.187.48:domain,0,0,1,62,1,62,1.160394000,0.0000
144.75.218.235:22244,<->,138.127.224.83:domain,1,229,0,0,1,229,1.160323000,0.0000
215.158.239.124:57448,<->,131.65.15.204:domain,1,715,0,0,1,715,1.160153000,0.0000
144.75.218.242:9079,<->,8.222.218.199:domain,1,109,0,0,1,109,1.160078000,0.0000
144.75.218.233:24219,<->,8.222.218.196:domain,1,122,0,0,1,122,1.159978000,0.0000
92.160.15.143:synchronet-upd,<->,129.224.112.252:domain,0,0,1,71,1,71,1.159460000,0.0000
109.3.145.240:55697,<->,61.51.212.221:11587,1,133,0,0,1,133,1.159376000,0.0000
196.17.104.47:18982,<->,80.42.160.104:6881,0,0,1,52,1,52,1.158897000,0.0000
144.75.218.242:21521,<->,8.222.218.196:domain,1,111,0,0,1,111,1.158798000,0.0000
192.64.215.178:10039,<->,235.224.120.198:6881,1,136,0,0,1,136,1.158565000,0.0000
89.183.104.177:33155,<->,149.57.27.184:21954,1,263,0,0,1,263,1.158353000,0.0000
144.75.218.237:52797,<->,139.252.1.230:domain,1,90,0,0,1,90,1.157632000,0.0000
144.75.218.233:63361,<->,8.222.218.196:domain,1,110,0,0,1,110,1.156917000,0.0000
136.25.188.105:59329,<->,132.43.156.81:domain,1,286,0,0,1,286,1.156783000,0.0000
27.11.34.178:14440,<->,220.55.123.208:domain,0,0,1,85,1,85,1.156701000,0.0000
230.94.201.201:45512,<->,100.182.191.235:12801,0,0,1,138,1,138,1.156649000,0.0000
20.185.77.89:51049,<->,123.106.105.212:domain,1,68,0,0,1,68,1.156309000,0.0000
144.75.218.237:17986,<->,8.222.218.199:domain,1,124,0,0,1,124,1.155606000,0.0000
144.75.218.235:60754,<->,8.222.218.198:domain,1,113,0,0,1,113,1.155283000,0.0000
144.75.218.246:63212,<->,8.222.218.199:domain,1,110,0,0,1,110,1.154984000,0.0000
144.75.218.246:32420,<->,97.110.148.13:domain,1,67,0,0,1,67,1.154964000,0.0000
248.225.26.34:42906,<->,95.221.85.227:40033,1,893,0,0,1,893,1.154820000,0.0000
144.75.218.237:24496,<->,8.222.218.207:domain,1,126,0,0,1,126,1.154656000,0.0000
114.236.240.176:10367,<->,92.27.219.28:ns-cfg-server,0,0,1,319,1,319,1.154637000,0.0000
129.179.50.133:62083,<->,138.127.226.109:domain,1,222,0,0,1,222,1.153267000,0.0000
144.75.218.242:28356,<->,8.222.218.199:domain,1,111,0,0,1,111,1.152923000,0.0000
144.75.218.235:15692,<->,65.95.70.36:domain,1,140,0,0,1,140,1.152839000,0.0000
21.15.226.126:55104,<->,20.193.30.195:netbios-ns,0,0,1,82,1,82,1.152709000,0.0000
144.75.218.242:62724,<->,139.252.1.232:domain,1,151,0,0,1,151,1.152648000,0.0000
116.98.161.10:27118,<->,109.1.61.190:24714,0,0,1,149,1,149,1.152508000,0.0000
158.255.94.12:16223,<->,129.224.112.252:domain,0,0,1,71,1,71,1.152184000,0.0000
144.75.218.241:64205,<->,8.222.218.207:domain,1,110,0,0,1,110,1.151940000,0.0000
138.45.88.195:55117,<->,136.25.189.215:domain,0,0,1,90,1,90,1.151243000,0.0000
127.179.185.76:49890,<->,89.183.104.172:42623,0,0,1,52,1,52,1.150612000,0.0000
37.150.196.39:18620,<->,109.222.206.93:domain,0,0,1,80,1,80,1.150523000,0.0000
144.75.218.241:48013,<->,8.222.218.196:domain,1,114,0,0,1,114,1.150432000,0.0000
144.75.218.246:9902,<->,8.222.218.199:domain,1,110,0,0,1,110,1.150275000,0.0000
57.50.83.249:44705,<->,92.27.219.218:6281,0,0,1,330,1,330,1.149742000,0.0000
153.189.34.81:47890,<->,241.228.129.126:6881,0,0,1,293,1,293,1.149501000,0.0000
144.75.218.233:35132,<->,8.222.218.204:domain,1,122,0,0,1,122,1.149259000,0.0000
129.13.225.151:62295,<->,132.43.156.54:domain,1,351,0,0,1,351,1.149008000,0.0000
199.39.73.116:58623,<->,92.27.27.145:55513,0,0,1,52,1,52,1.148942000,0.0000
92.27.27.182:57367,<->,193.23.0.8:31597,1,52,0,0,1,52,1.148791000,0.0000
39.28.34.214:28503,<->,196.120.85.20:domain,1,80,0,0,1,80,1.148714000,0.0000
144.75.218.246:13266,<->,8.222.218.199:domain,1,121,0,0,1,121,1.148531000,0.0000
144.69.101.196:28296,<->,159.69.187.24:domain,0,0,1,80,1,80,1.148516000,0.0000
39.9.31.78:12637,<->,121.92.106.82:domain,1,86,0,0,1,86,1.148088000,0.0000
196.148.133.194:20740,<->,123.86.109.137:10158,1,321,0,0,1,321,1.147760000,0.0000
99.75.149.54:25410,<->,113.174.26.210:6881,1,133,0,0,1,133,1.147577000,0.0000
144.75.218.235:11354,<->,8.222.218.204:domain,1,114,0,0,1,114,1.147330000,0.0000
48.131.157.46:36348,<->,8.176.8.84:domain,0,0,1,89,1,89,1.146656000,0.0000
144.75.218.233:63645,<->,138.127.230.149:domain,1,366,0,0,1,366,1.146384000,0.0000
144.75.218.246:41038,<->,8.222.218.204:domain,1,123,0,0,1,123,1.146285000,0.0000
144.75.218.241:26288,<->,120.155.84.97:domain,1,145,0,0,1,145,1.146234000,0.0000
:::31663,<->,:::domain,1,119,0,0,1,119,1.145466000,0.0000
136.25.188.35:54111,<->,98.28.95.54:domain,1,111,0,0,1,111,1.145230000,0.0000
117.91.158.107:59213,<->,247.136.254.102:15367,0,0,1,52,1,52,1.145160000,0.0000
144.75.218.246:18818,<->,8.222.218.197:domain,1,119,0,0,1,119,1.145111000,0.0000
124.80.226.111:43984,<->,100.92.42.66:19159,0,0,1,321,1,321,1.145089000,0.0000
8.219.186.186:45113,<->,138.23.198.132:domain,0,0,1,90,1,90,1.144984000,0.0000
144.75.218.237:58407,<->,8.222.218.207:domain,1,151,0,0,1,151,1.144835000,0.0000
48.131.157.46:52164,<->,215.158.239.220:domain,0,0,1,90,1,90,1.144338000,0.0000
144.75.218.241:enc-tunnel,<->,8.222.218.207:domain,1,122,0,0,1,122,1.144083000,0.0000
144.75.218.235:11997,<->,8.222.218.204:domain,1,122,0,0,1,122,1.143881000,0.0000
21.15.226.126:55104,<->,20.193.30.220:netbios-ns,0,0,1,82,1,82,1.143612000,0.0000
56.61.99.23:28373,<->,97.68.226.205:domain,0,0,1,86,1,86,1.143605000,0.0000
146.217.134.27:53419,<->,101.224.169.159:27015,0,0,1,57,1,57,1.143091000,0.0000
99.73.166.232:14485,<->,122.9.235.166:6a44,1,52,0,0,1,52,1.143034000,0.0000
21.15.226.126:55104,<->,20.193.30.218:netbios-ns,0,0,1,82,1,82,1.142830000,0.0000
144.75.218.237:19670,<->,132.200.124.228:domain,1,460,0,0,1,460,1.142493000,0.0000
144.76.43.246:18210,<->,80.56.78.128:domain,0,0,1,107,1,107,1.142330000,0.0000
80.41.12.225:61072,<->,38.136.169.74:29498,1,52,0,0,1,52,1.140508000,0.0000
220.80.150.62:42406,<->,119.230.159.219:19915,1,133,0,0,1,133,1.140484000,0.0000
89.181.75.64:53811,<->,74.249.239.112:22709,1,293,0,0,1,293,1.140474000,0.0000
105.140.209.76:44461,<->,20.143.42.40:30233,0,0,1,52,1,52,1.140358000,0.0000
144.75.218.235:18843,<->,243.48.23.128:domain,1,152,0,0,1,152,1.140358000,0.0000
215.158.30.32:37790,<->,29.211.214.254:domain,0,0,1,109,1,109,1.140164000,0.0000
33.233.141.32:63108,<->,141.81.120.167:domain,1,78,0,0,1,78,1.139327000,0.0000
144.108.64.183:55660,<->,144.122.240.241:domain,0,0,1,69,1,69,1.139223000,0.0000
144.75.218.241:46222,<->,8.222.218.207:domain,1,122,0,0,1,122,1.139172000,0.0000
21.15.226.126:55104,<->,20.193.30.222:netbios-ns,0,0,1,82,1,82,1.139142000,0.0000
144.75.218.233:20398,<->,8.222.218.197:domain,1,122,0,0,1,122,1.138791000,0.0000
144.75.218.241:43444,<->,8.222.218.204:domain,1,122,0,0,1,122,1.138546000,0.0000
144.75.218.235:42817,<->,138.127.224.125:domain,1,348,0,0,1,348,1.138399000,0.0000
89.183.104.135:57600,<->,114.195.47.224:21850,1,62,0,0,1,62,1.138281000,0.0000
133.77.208.63:61632,<->,129.224.112.252:domain,0,0,1,65,1,65,1.138168000,0.0000
136.25.188.35:49603,<->,138.127.224.166:domain,1,283,0,0,1,283,1.138141000,0.0000
97.242.126.193:62884,<->,129.224.112.252:domain,0,0,1,96,1,96,1.137818000,0.0000
136.25.188.35:58665,<->,138.127.224.166:domain,1,278,0,0,1,278,1.137546000,0.0000
109.1.58.78:53030,<->,196.101.191.102:ntp,1,80,0,0,1,80,1.137470000,0.0000
21.15.226.126:55104,<->,20.193.31.250:netbios-ns,0,0,1,82,1,82,1.137391000,0.0000
136.25.188.35:55722,<->,138.127.224.166:domain,1,274,0,0,1,274,1.137377000,0.0000
8.228.214.59:62355,<->,66.194.126.28:28939,1,52,0,0,1,52,1.137181000,0.0000
144.75.218.241:63827,<->,143.204.138.236:domain,1,177,0,0,1,177,1.137043000,0.0000
101.224.89.128:19264,<->,111.20.172.70:domain,1,145,0,0,1,145,1.136867000,0.0000
0.200.50.50:34233,<->,20.13.108.169:domain,0,0,1,60,1,60,1.136502000,0.0000
144.75.218.246:9977,<->,8.222.218.199:domain,1,121,0,0,1,121,1.136248000,0.0000
202.222.96.52:27350,<->,8.238.168.0:13843,0,0,1,133,1,133,1.136034000,0.0000
136.25.188.35:45442,<->,138.127.224.166:domain,1,284,0,0,1,284,1.135943000,0.0000
110.6.236.172:26213,<->,192.67.150.206:6882,0,0,1,52,1,52,1.135817000,0.0000
136.25.188.35:50579,<->,138.127.224.166:domain,1,304,0,0,1,304,1.135687000,0.0000
147.49.3.183:64000,<->,39.243.208.129:37970,0,0,1,52,1,52,1.135104000,0.0000
92.27.219.49:64509,<->,127.255.80.157:44470,1,52,0,0,1,52,1.134933000,0.0000
136.25.188.35:58883,<->,138.127.224.166:domain,1,270,0,0,1,270,1.134866000,0.0000
21.15.226.126:55104,<->,20.193.31.229:netbios-ns,0,0,1,82,1,82,1.134859000,0.0000
136.25.188.35:55425,<->,138.127.224.166:domain,1,287,0,0,1,287,1.134743000,0.0000
92.162.219.51:51066,<->,129.224.112.252:domain,0,0,1,90,1,90,1.134683000,0.0000
17.142.246.251:ms-cluster-net,<->,109.222.250.16:domain,0,0,1,72,1,72,1.134108000,0.0000
8.252.222.54:35288,<->,192.171.13.190:domain,1,138,0,0,1,138,1.134101000,0.0000
80.42.156.128:62348,<->,149.151.71.253:53276,1,135,0,0,1,135,1.133973000,0.0000
247.136.234.205:52409,<->,75.95.145.227:hpss-ndapi,1,84,0,0,1,84,1.133891000,0.0000
136.25.188.29:60471,<->,138.127.224.104:domain,1,286,0,0,1,286,1.133424000,0.0000
144.75.218.233:12626,<->,8.222.218.204:domain,1,153,0,0,1,153,1.133421000,0.0000
97.242.126.193:19710,<->,129.224.112.252:domain,0,0,1,75,1,75,1.133096000,0.0000
144.75.218.241:14777,<->,138.127.224.185:domain,1,366,0,0,1,366,1.133089000,0.0000
102.51.208.201:63906,<->,144.76.46.38:domain,1,323,0,0,1,323,1.133063000,0.0000
144.75.218.237:28918,<->,138.127.225.148:domain,1,366,0,0,1,366,1.132978000,0.0000
144.93.125.49:45297,<->,144.93.121.10:32825,0,0,1,104,1,104,1.132792000,0.0000
144.75.218.242:59954,<->,8.222.218.196:domain,1,111,0,0,1,111,1.132558000,0.0000
121.196.222.187:23159,<->,192.64.229.25:14743,0,0,1,99,1,99,1.132425000,0.0000
136.25.188.35:61947,<->,138.127.224.166:domain,1,268,0,0,1,268,1.132335000,0.0000
136.25.188.35:45592,<->,138.127.224.166:domain,1,284,0,0,1,284,1.132240000,0.0000
144.75.218.235:synchronet-upd,<->,138.127.225.222:domain,1,366,0,0,1,366,1.132085000,0.0000
136.25.188.105:63006,<->,143.194.53.201:domain,1,286,0,0,1,286,1.131852000,0.0000
139.81.45.38:51864,<->,138.98.246.1:domain,0,0,1,116,1,116,1.131356000,0.0000
39.144.127.89:21151,<->,136.108.33.19:domain,0,0,1,77,1,77,1.131154000,0.0000
111.20.168.141:35278,<->,131.210.124.160:domain,1,203,0,0,1,203,1.131137000,0.0000
144.75.218.237:26340,<->,120.155.84.97:domain,1,121,0,0,1,121,1.130627000,0.0000
97.126.117.98:51144,<->,129.197.127.35:domain,1,170,0,0,1,170,1.130039000,0.0000
20.103.184.243:27793,<->,195.69.125.104:domain,1,66,0,0,1,66,1.130015000,0.0000
132.168.197.226:40799,<->,129.245.206.220:domain,1,723,0,0,1,723,1.129654000,0.0000
196.31.72.120:42151,<->,111.181.116.40:19821,0,0,1,52,1,52,1.129546000,0.0000
53.199.199.220:46777,<->,39.15.169.14:domain,0,0,1,86,1,86,1.128982000,0.0000
118.213.4.154:59447,<->,92.27.219.150:21268,0,0,1,52,1,52,1.128774000,0.0000
20.167.128.198:13246,<->,207.188.242.89:domain,1,68,0,0,1,68,1.128651000,0.0000
27.40.186.140:28410,<->,89.183.104.178:dsom-server,0,0,1,52,1,52,1.128202000,0.0000
159.28.226.233:57909,<->,132.123.40.70:domain,0,0,1,70,1,70,1.127864000,0.0000
134.161.205.169:64024,<->,92.27.27.175:19749,0,0,1,52,1,52,1.127418000,0.0000
39.231.195.68:16507,<->,57.189.17.115:domain,1,74,0,0,1,74,1.126729000,0.0000
144.75.218.246:47813,<->,8.222.218.204:domain,1,110,0,0,1,110,1.126522000,0.0000
144.75.218.242:24214,<->,8.222.218.204:domain,1,177,0,0,1,177,1.126409000,0.0000
206.195.194.146:65524,<->,220.55.123.208:domain,0,0,1,83,1,83,1.126200000,0.0000
144.75.218.246:57188,<->,8.222.218.199:domain,1,223,0,0,1,223,1.124599000,0.0000
33.233.141.120:60613,<->,111.20.172.70:domain,1,115,0,0,1,115,1.124459000,0.0000
144.75.218.237:13575,<->,8.222.218.199:domain,1,153,0,0,1,153,1.124376000,0.0000
33.233.141.49:20302,<->,111.20.172.70:domain,1,169,0,0,1,169,1.124079000,0.0000
101.224.89.134:49065,<->,111.20.172.70:domain,1,201,0,0,1,201,1.123931000,0.0000
33.233.141.91:22109,<->,111.20.172.70:domain,1,254,0,0,1,254,1.123743000,0.0000
101.224.89.128:48519,<->,111.20.172.70:domain,1,153,0,0,1,153,1.123719000,0.0000
33.233.141.93:53824,<->,111.20.172.70:domain,1,173,0,0,1,173,1.123252000,0.0000
144.75.218.242:int-rcv-cntrl,<->,8.222.218.199:domain,1,122,0,0,1,122,1.123218000,0.0000
80.42.203.252:39263,<->,66.210.105.224:7909,1,130,0,0,1,130,1.122954000,0.0000
33.233.141.19:40327,<->,53.69.112.6:domain,1,124,0,0,1,124,1.122522000,0.0000
33.233.141.0:51936,<->,111.20.172.70:domain,1,290,0,0,1,290,1.122398000,0.0000
215.158.239.102:60920,<->,78.128.203.59:domain,1,116,0,0,1,116,1.122203000,0.0000
33.233.141.49:38860,<->,111.20.172.70:domain,1,153,0,0,1,153,1.122075000,0.0000
33.233.141.28:10656,<->,111.20.172.70:domain,1,250,0,0,1,250,1.121988000,0.0000
20.20.251.226:60107,<->,126.86.170.240:domain,1,76,0,0,1,76,1.121672000,0.0000
39.138.199.229:5880,<->,57.126.7.237:domain,1,68,0,0,1,68,1.121508000,0.0000
144.75.218.241:24226,<->,8.222.218.207:domain,1,122,0,0,1,122,1.121464000,0.0000
101.224.89.134:25676,<->,111.20.172.70:domain,1,104,0,0,1,104,1.120865000,0.0000
129.236.100.166:40008,<->,129.224.112.252:domain,0,0,1,76,1,76,1.120753000,0.0000
33.233.141.33:18347,<->,111.20.172.70:domain,1,290,0,0,1,290,1.120485000,0.0000
111.20.168.154:32674,<->,111.20.172.70:domain,1,95,0,0,1,95,1.120481000,0.0000
144.75.218.242:59651,<->,138.127.225.15:domain,1,201,0,0,1,201,1.120352000,0.0000
33.233.141.93:9365,<->,111.20.172.70:domain,1,99,0,0,1,99,1.120051000,0.0000
33.233.141.120:20303,<->,111.20.172.70:domain,1,160,0,0,1,160,1.119772000,0.0000
109.1.61.116:64222,<->,104.236.121.73:54562,1,149,0,0,1,149,1.119540000,0.0000
111.20.168.4:xss-port,<->,111.20.172.70:domain,1,181,0,0,1,181,1.119388000,0.0000
111.20.168.4:50844,<->,111.20.172.70:domain,1,140,0,0,1,140,1.119365000,0.0000
33.233.141.80:57838,<->,111.20.172.70:domain,1,113,0,0,1,113,1.119264000,0.0000
33.233.141.82:39730,<->,111.20.172.70:domain,1,166,0,0,1,166,1.119250000,0.0000
33.233.141.49:35423,<->,111.20.172.70:domain,1,94,0,0,1,94,1.119064000,0.0000
33.233.141.39:nuts-bootp,<->,148.155.129.25:domain,1,170,0,0,1,170,1.119020000,0.0000
111.88.145.220:52898,<->,92.27.219.248:openvpn,0,0,1,149,1,149,1.119011000,0.0000
33.233.141.80:38184,<->,111.20.172.70:domain,1,170,0,0,1,170,1.118869000,0.0000
33.233.141.49:16812,<->,111.20.172.70:domain,1,140,0,0,1,140,1.118815000,0.0000
15.15.125.115:12553,<->,97.126.18.233:domain,0,0,1,72,1,72,1.118751000,0.0000
144.76.43.245:26499,<->,80.56.78.128:domain,0,0,1,110,1,110,1.118665000,0.0000
33.233.141.22:37546,<->,111.20.172.70:domain,1,95,0,0,1,95,1.118421000,0.0000
53.152.211.127:34312,<->,132.249.70.213:domain,0,0,1,116,1,116,1.118407000,0.0000
111.20.168.12:38861,<->,111.20.172.70:domain,1,101,0,0,1,101,1.118308000,0.0000
101.224.89.134:35139,<->,111.20.172.70:domain,1,124,0,0,1,124,1.118087000,0.0000
111.20.168.4:55005,<->,111.20.172.70:domain,1,102,0,0,1,102,1.118044000,0.0000
33.233.141.28:37537,<->,111.20.172.70:domain,1,98,0,0,1,98,1.117843000,0.0000
144.75.218.246:32566,<->,140.142.187.19:domain,1,77,0,0,1,77,1.117685000,0.0000
144.75.218.242:59562,<->,8.222.218.199:domain,1,109,0,0,1,109,1.117685000,0.0000
111.20.168.4:24384,<->,111.20.172.70:domain,1,144,0,0,1,144,1.117435000,0.0000
38.21.156.204:56633,<->,20.232.228.86:netbios-ns,0,0,1,82,1,82,1.117374000,0.0000
33.233.141.120:10871,<->,111.20.172.70:domain,1,160,0,0,1,160,1.117342000,0.0000
144.75.218.241:13354,<->,8.222.218.207:domain,1,121,0,0,1,121,1.117314000,0.0000
33.233.141.80:64478,<->,111.20.172.70:domain,1,96,0,0,1,96,1.117284000,0.0000
101.224.89.247:48688,<->,111.20.172.70:domain,1,151,0,0,1,151,1.117040000,0.0000
111.20.168.12:20418,<->,111.20.172.70:domain,1,105,0,0,1,105,1.117026000,0.0000
126.198.69.217:55645,<->,247.136.146.16:36637,0,0,1,321,1,321,1.116966000,0.0000
33.233.141.94:13113,<->,111.20.172.70:domain,1,131,0,0,1,131,1.116849000,0.0000
33.233.141.96:11570,<->,111.20.172.70:domain,1,106,0,0,1,106,1.116767000,0.0000
33.233.141.96:lm-webwatcher,<->,111.20.172.70:domain,1,105,0,0,1,105,1.116713000,0.0000
33.233.141.39:52943,<->,111.20.172.70:domain,1,290,0,0,1,290,1.116599000,0.0000
74.249.120.178:27805,<->,92.181.50.174:sgi-gcd,0,0,1,130,1,130,1.116515000,0.0000
144.75.218.242:63097,<->,8.222.218.199:domain,1,111,0,0,1,111,1.116440000,0.0000
101.224.89.128:42932,<->,111.20.172.70:domain,1,140,0,0,1,140,1.116433000,0.0000
101.224.89.128:56036,<->,111.20.172.70:domain,1,100,0,0,1,100,1.116389000,0.0000
111.20.168.4:62085,<->,111.20.172.70:domain,1,173,0,0,1,173,1.116355000,0.0000
33.233.141.120:8790,<->,111.20.172.70:domain,1,169,0,0,1,169,1.116318000,0.0000
101.224.89.248:17163,<->,111.20.172.70:domain,1,106,0,0,1,106,1.116294000,0.0000
111.20.168.12:12870,<->,111.20.172.70:domain,1,144,0,0,1,144,1.116286000,0.0000
33.233.141.63:40003,<->,111.20.172.70:domain,1,103,0,0,1,103,1.116274000,0.0000
99.75.183.47:19180,<->,194.223.51.91:6881,1,97,0,0,1,97,1.116214000,0.0000
33.233.141.22:24724,<->,111.20.172.70:domain,1,103,0,0,1,103,1.116109000,0.0000
101.224.89.131:14538,<->,111.20.172.70:domain,1,104,0,0,1,104,1.116069000,0.0000
130.94.125.208:40500,<->,80.41.21.72:26956,0,0,1,136,1,136,1.115973000,0.0000
33.233.141.120:4315,<->,111.20.172.70:domain,1,155,0,0,1,155,1.115933000,0.0000
33.233.141.59:59259,<->,111.20.172.70:domain,1,101,0,0,1,101,1.115829000,0.0000
101.224.89.134:lms,<->,111.20.172.70:domain,1,97,0,0,1,97,1.115788000,0.0000
33.233.141.80:4217,<->,111.20.172.70:domain,1,150,0,0,1,150,1.115731000,0.0000
33.233.141.90:essbase,<->,111.20.172.70:domain,1,141,0,0,1,141,1.115500000,0.0000
111.20.168.215:11825,<->,111.20.172.70:domain,1,288,0,0,1,288,1.115435000,0.0000
111.20.168.8:33796,<->,111.20.172.70:domain,1,155,0,0,1,155,1.115391000,0.0000
33.233.141.120:65434,<->,111.20.172.70:domain,1,153,0,0,1,153,1.115382000,0.0000
101.224.89.161:sns-gateway,<->,111.20.172.70:domain,1,105,0,0,1,105,1.115361000,0.0000
129.236.100.84:52891,<->,129.224.112.252:domain,0,0,1,73,1,73,1.115350000,0.0000
33.233.141.120:31977,<->,111.20.172.70:domain,1,104,0,0,1,104,1.115240000,0.0000
111.20.168.13:11861,<->,111.20.172.70:domain,1,106,0,0,1,106,1.115201000,0.0000
100.211.114.205:63857,<->,159.87.104.238:domain,0,0,1,87,1,87,1.115183000,0.0000
33.233.141.94:61608,<->,111.20.172.70:domain,1,147,0,0,1,147,1.115052000,0.0000
33.233.141.59:27757,<->,111.20.172.70:domain,1,81,0,0,1,81,1.114968000,0.0000
101.224.89.128:16307,<->,111.20.172.70:domain,1,97,0,0,1,97,1.114935000,0.0000
39.45.58.107:authentx,<->,131.103.234.27:domain,1,75,0,0,1,75,1.114800000,0.0000
33.233.141.49:34196,<->,111.20.172.70:domain,1,167,0,0,1,167,1.114618000,0.0000
111.20.168.8:39064,<->,111.20.172.70:domain,1,148,0,0,1,148,1.114586000,0.0000
33.233.141.62:47780,<->,111.20.172.70:domain,1,102,0,0,1,102,1.114556000,0.0000
33.233.141.80:52480,<->,111.20.172.70:domain,1,100,0,0,1,100,1.114510000,0.0000
92.160.15.146:19538,<->,129.224.112.252:domain,0,0,1,77,1,77,1.114482000,0.0000
33.233.141.71:11047,<->,111.20.172.70:domain,1,148,0,0,1,148,1.114410000,0.0000
33.233.141.120:18095,<->,111.20.172.70:domain,1,169,0,0,1,169,1.114344000,0.0000
101.224.89.134:25231,<->,111.20.172.70:domain,1,174,0,0,1,174,1.114335000,0.0000
21.15.226.126:55104,<->,20.193.31.101:netbios-ns,0,0,1,82,1,82,1.114296000,0.0000
144.75.218.233:18629,<->,8.222.218.196:domain,1,111,0,0,1,111,1.114235000,0.0000
33.233.141.103:50405,<->,111.20.172.70:domain,1,106,0,0,1,106,1.114082000,0.0000
101.224.89.131:61326,<->,111.20.172.70:domain,1,152,0,0,1,152,1.114008000,0.0000
33.233.141.71:54672,<->,111.20.172.70:domain,1,96,0,0,1,96,1.113996000,0.0000
33.233.141.93:31709,<->,111.20.172.70:domain,1,149,0,0,1,149,1.113904000,0.0000
101.224.89.161:43313,<->,111.20.172.70:domain,1,146,0,0,1,146,1.113852000,0.0000
144.75.218.242:41584,<->,8.222.218.207:domain,1,110,0,0,1,110,1.113574000,0.0000
144.75.218.242:22825,<->,138.127.225.234:domain,1,254,0,0,1,254,1.113517000,0.0000
132.168.197.226:61578,<->,138.127.230.89:domain,1,156,0,0,1,156,1.113382000,0.0000
101.224.89.144:27097,<->,111.20.172.70:domain,1,100,0,0,1,100,1.113366000,0.0000
136.25.188.105:50480,<->,135.88.171.34:domain,1,279,0,0,1,279,1.113355000,0.0000
27.13.70.75:36326,<->,100.95.46.59:28584,0,0,1,52,1,52,1.113104000,0.0000
33.233.141.62:57331,<->,111.20.172.70:domain,1,158,0,0,1,158,1.113013000,0.0000
111.20.168.12:49432,<->,111.20.172.70:domain,1,104,0,0,1,104,1.113009000,0.0000
33.233.141.71:63843,<->,111.20.172.70:domain,1,146,0,0,1,146,1.112909000,0.0000
101.224.89.144:15607,<->,111.20.172.70:domain,1,160,0,0,1,160,1.112491000,0.0000
144.43.70.2:29545,<->,145.242.126.150:domain,0,0,1,76,1,76,1.112434000,0.0000
33.233.141.22:38259,<->,111.20.172.70:domain,1,147,0,0,1,147,1.112374000,0.0000
39.3.89.10:29725,<->,38.69.22.246:domain,1,75,0,0,1,75,1.112281000,0.0000
130.37.102.18:38264,<->,39.214.55.177:domain,0,0,1,86,1,86,1.112274000,0.0000
:::59774,<->,:::domain,1,282,0,0,1,282,1.112271000,0.0000
33.233.141.71:57566,<->,111.20.172.70:domain,1,82,0,0,1,82,1.112205000,0.0000
21.15.226.126:55104,<->,20.193.31.104:netbios-ns,0,0,1,82,1,82,1.112015000,0.0000
33.233.141.84:22994,<->,111.20.172.70:domain,1,143,0,0,1,143,1.112012000,0.0000
33.233.141.19:57894,<->,111.20.172.70:domain,1,143,0,0,1,143,1.111929000,0.0000
101.224.89.247:63764,<->,111.20.172.70:domain,1,109,0,0,1,109,1.111575000,0.0000
92.160.15.146:40664,<->,129.224.112.252:domain,0,0,1,75,1,75,1.111566000,0.0000
8.252.222.18:58944,<->,192.171.13.189:domain,1,139,0,0,1,139,1.111561000,0.0000
101.224.89.247:6204,<->,111.20.172.70:domain,1,148,0,0,1,148,1.111552000,0.0000
8.252.222.166:45844,<->,192.171.13.33:domain,1,155,0,0,1,155,1.111529000,0.0000
92.160.15.146:31429,<->,129.224.112.252:domain,0,0,1,86,1,86,1.111441000,0.0000
33.233.141.39:33600,<->,111.20.172.70:domain,1,293,0,0,1,293,1.111414000,0.0000
111.20.168.154:61295,<->,111.20.172.70:domain,1,95,0,0,1,95,1.111321000,0.0000
111.20.168.8:65342,<->,111.20.172.70:domain,1,96,0,0,1,96,1.111303000,0.0000
33.233.141.103:18760,<->,111.20.172.70:domain,1,147,0,0,1,147,1.111230000,0.0000
101.224.89.145:31002,<->,111.20.172.70:domain,1,96,0,0,1,96,1.111212000,0.0000
33.233.141.90:51130,<->,111.20.172.70:domain,1,103,0,0,1,103,1.111183000,0.0000
111.20.168.12:7665,<->,111.20.172.70:domain,1,155,0,0,1,155,1.111155000,0.0000
215.158.103.219:55738,<->,193.41.156.225:domain,1,810,0,0,1,810,1.111076000,0.0000
38.21.156.204:56633,<->,20.232.228.83:netbios-ns,0,0,1,82,1,82,1.110984000,0.0000
33.233.141.58:53817,<->,111.20.172.70:domain,1,148,0,0,1,148,1.110964000,0.0000
33.233.141.24:array-manager,<->,111.20.172.70:domain,1,140,0,0,1,140,1.110871000,0.0000
33.233.141.24:19150,<->,111.20.172.70:domain,1,153,0,0,1,153,1.110868000,0.0000
33.233.141.62:10983,<->,111.20.172.70:domain,1,101,0,0,1,101,1.110841000,0.0000
33.233.141.57:56750,<->,111.20.172.70:domain,1,201,0,0,1,201,1.110671000,0.0000
92.160.15.146:34008,<->,129.224.112.252:domain,0,0,1,75,1,75,1.110669000,0.0000
33.233.141.24:30735,<->,111.20.172.70:domain,1,108,0,0,1,108,1.110565000,0.0000
80.40.1.240:18808,<->,142.235.117.143:6881,1,62,0,0,1,62,1.110482000,0.0000
33.233.141.71:17488,<->,111.20.172.70:domain,1,94,0,0,1,94,1.110481000,0.0000
92.160.15.146:39827,<->,129.224.112.252:domain,0,0,1,75,1,75,1.110328000,0.0000
33.233.141.8:netiq-ncap,<->,111.20.172.70:domain,1,290,0,0,1,290,1.110084000,0.0000
92.160.15.146:24779,<->,129.224.112.252:domain,0,0,1,78,1,78,1.110042000,0.0000
33.233.141.84:6138,<->,111.20.172.70:domain,1,107,0,0,1,107,1.109974000,0.0000
33.233.141.103:29857,<->,111.20.172.70:domain,1,103,0,0,1,103,1.109908000,0.0000
111.20.168.8:52999,<->,111.20.172.70:domain,1,153,0,0,1,153,1.109853000,0.0000
33.233.141.62:38448,<->,111.20.172.70:domain,1,146,0,0,1,146,1.109852000,0.0000
101.224.89.161:25256,<->,111.20.172.70:domain,1,96,0,0,1,96,1.109786000,0.0000
92.160.15.146:28531,<->,129.224.112.252:domain,0,0,1,75,1,75,1.109436000,0.0000
33.233.141.123:icl-twobase8,<->,111.20.172.70:domain,1,145,0,0,1,145,1.109396000,0.0000
144.75.218.235:62039,<->,8.222.218.198:domain,1,110,0,0,1,110,1.109271000,0.0000
111.20.168.13:48386,<->,111.20.172.70:domain,1,153,0,0,1,153,1.109023000,0.0000
42.78.196.77:49001,<->,92.27.219.182:tcoregagent,0,0,1,170,1,170,1.109021000,0.0000
101.224.89.144:55000,<->,111.20.172.70:domain,1,106,0,0,1,106,1.108920000,0.0000
101.224.89.161:56507,<->,111.20.172.70:domain,1,98,0,0,1,98,1.108879000,0.0000
101.224.89.144:10022,<->,111.20.172.70:domain,1,144,0,0,1,144,1.108676000,0.0000
33.233.141.63:29650,<->,111.20.172.70:domain,1,141,0,0,1,141,1.108576000,0.0000
111.20.168.13:39283,<->,111.20.172.70:domain,1,100,0,0,1,100,1.108557000,0.0000
33.233.141.19:52830,<->,111.20.172.70:domain,1,98,0,0,1,98,1.108456000,0.0000
101.224.89.129:40243,<->,111.20.172.70:domain,1,140,0,0,1,140,1.108327000,0.0000
33.233.141.84:22649,<->,111.20.172.70:domain,1,159,0,0,1,159,1.108064000,0.0000
33.233.141.71:34766,<->,111.20.172.70:domain,1,178,0,0,1,178,1.108000000,0.0000
144.76.43.246:theta-lm,<->,159.69.187.17:domain,0,0,1,80,1,80,1.107971000,0.0000
33.233.141.57:42249,<->,111.20.172.70:domain,1,98,0,0,1,98,1.107900000,0.0000
144.75.218.235:48688,<->,8.222.218.197:domain,1,121,0,0,1,121,1.107741000,0.0000
97.126.26.40:microcom-sbp,<->,53.75.247.118:domain,1,122,0,0,1,122,1.107675000,0.0000
144.75.218.242:60968,<->,8.222.218.204:domain,1,239,0,0,1,239,1.107642000,0.0000
33.233.141.24:48594,<->,111.20.172.70:domain,1,105,0,0,1,105,1.107514000,0.0000
33.233.141.27:28117,<->,111.20.172.70:domain,1,153,0,0,1,153,1.107309000,0.0000
21.15.226.126:55104,<->,20.193.31.111:netbios-ns,0,0,1,82,1,82,1.107300000,0.0000
144.75.218.237:33642,<->,8.222.218.197:domain,1,122,0,0,1,122,1.107034000,0.0000
33.233.141.123:64397,<->,111.20.172.70:domain,1,247,0,0,1,247,1.106861000,0.0000
101.224.89.244:25910,<->,111.20.172.70:domain,1,140,0,0,1,140,1.106800000,0.0000
33.233.141.97:18499,<->,111.20.172.70:domain,1,140,0,0,1,140,1.106797000,0.0000
8.252.222.18:57940,<->,192.171.13.189:domain,1,142,0,0,1,142,1.106697000,0.0000
101.224.89.129:14615,<->,111.20.172.70:domain,1,149,0,0,1,149,1.106679000,0.0000
8.252.222.18:53709,<->,192.171.13.189:domain,1,134,0,0,1,134,1.106616000,0.0000
101.224.89.145:49920,<->,111.20.172.70:domain,1,103,0,0,1,103,1.106571000,0.0000
33.233.141.84:51671,<->,111.20.172.70:domain,1,107,0,0,1,107,1.106447000,0.0000
200.226.80.179:54699,<->,129.92.113.143:chargen,0,0,1,50,1,50,1.106288000,0.0000
33.233.141.57:17792,<->,111.20.172.70:domain,1,112,0,0,1,112,1.106270000,0.0000
33.233.141.20:10209,<->,111.20.172.70:domain,1,108,0,0,1,108,1.106256000,0.0000
101.224.89.129:43071,<->,111.20.172.70:domain,1,100,0,0,1,100,1.106128000,0.0000
111.20.168.27:18548,<->,111.20.172.70:domain,1,100,0,0,1,100,1.105998000,0.0000
33.233.141.61:tram,<->,111.20.172.70:domain,1,160,0,0,1,160,1.105974000,0.0000
101.224.89.145:23844,<->,111.20.172.70:domain,1,144,0,0,1,144,1.105899000,0.0000
33.233.141.27:46020,<->,111.20.172.70:domain,1,140,0,0,1,140,1.105794000,0.0000
39.26.61.138:32943,<->,195.106.192.106:domain,1,70,0,0,1,70,1.105711000,0.0000
33.233.141.71:11699,<->,111.20.172.70:domain,1,126,0,0,1,126,1.105707000,0.0000
33.233.141.24:30122,<->,111.20.172.70:domain,1,105,0,0,1,105,1.105604000,0.0000
111.147.185.215:25959,<->,53.161.125.14:http-alt,1,104,0,0,1,104,1.105338000,0.0000
33.233.141.88:37078,<->,111.20.172.70:domain,1,124,0,0,1,124,1.105230000,0.0000
111.20.168.27:ace-client,<->,111.20.172.70:domain,1,144,0,0,1,144,1.105152000,0.0000
33.233.141.52:53122,<->,111.20.172.70:domain,1,104,0,0,1,104,1.105137000,0.0000
101.224.89.129:53066,<->,111.20.172.70:domain,1,109,0,0,1,109,1.104997000,0.0000
33.233.141.62:42675,<->,111.20.172.70:domain,1,103,0,0,1,103,1.104831000,0.0000
33.233.141.71:hpvirtctrl,<->,111.20.172.70:domain,1,101,0,0,1,101,1.104765000,0.0000
144.75.218.246:48718,<->,126.231.170.67:domain,1,226,0,0,1,226,1.104743000,0.0000
144.75.218.242:13924,<->,8.222.218.199:domain,1,237,0,0,1,237,1.104700000,0.0000
131.1.232.48:62542,<->,246.254.97.149:domain,0,0,1,93,1,93,1.104638000,0.0000
8.252.222.18:56780,<->,192.171.13.189:domain,1,134,0,0,1,134,1.104556000,0.0000
8.252.222.18:36769,<->,192.171.13.189:domain,1,140,0,0,1,140,1.104538000,0.0000
33.233.141.97:30054,<->,111.20.172.70:domain,1,140,0,0,1,140,1.104513000,0.0000
111.20.168.142:56770,<->,111.20.172.70:domain,1,145,0,0,1,145,1.104510000,0.0000
111.20.168.27:4261,<->,111.20.172.70:domain,1,147,0,0,1,147,1.104482000,0.0000
129.236.100.84:44669,<->,129.224.112.252:domain,0,0,1,78,1,78,1.104334000,0.0000
101.224.89.129:45682,<->,111.20.172.70:domain,1,147,0,0,1,147,1.104329000,0.0000
33.233.141.52:31825,<->,111.20.172.70:domain,1,99,0,0,1,99,1.104260000,0.0000
111.20.168.58:49349,<->,111.20.172.70:domain,1,149,0,0,1,149,1.104241000,0.0000
101.224.89.145:15486,<->,111.20.172.70:domain,1,102,0,0,1,102,1.103777000,0.0000
33.233.141.84:14337,<->,111.20.172.70:domain,1,160,0,0,1,160,1.103740000,0.0000
144.75.218.237:46964,<->,53.165.133.164:domain,1,83,0,0,1,83,1.103650000,0.0000
101.224.89.145:61583,<->,111.20.172.70:domain,1,105,0,0,1,105,1.103643000,0.0000
111.20.168.141:35694,<->,111.20.172.70:domain,1,100,0,0,1,100,1.103502000,0.0000
61.45.126.114:bip,<->,109.222.254.87:domain,0,0,1,79,1,79,1.103463000,0.0000
33.233.141.27:28055,<->,111.20.172.70:domain,1,155,0,0,1,155,1.103380000,0.0000
111.20.168.21:56215,<->,111.20.172.70:domain,1,101,0,0,1,101,1.103258000,0.0000
144.75.218.246:54578,<->,8.222.218.199:domain,1,110,0,0,1,110,1.103103000,0.0000
101.224.89.145:26338,<->,111.20.172.70:domain,1,140,0,0,1,140,1.103046000,0.0000
33.233.141.52:53184,<->,111.20.172.70:domain,1,99,0,0,1,99,1.102917000,0.0000
101.224.89.145:17631,<->,111.20.172.70:domain,1,97,0,0,1,97,1.102916000,0.0000
33.233.141.52:acp-conduit,<->,111.20.172.70:domain,1,97,0,0,1,97,1.102830000,0.0000
33.233.141.52:37694,<->,111.20.172.70:domain,1,105,0,0,1,105,1.102768000,0.0000
92.27.219.224:46941,<->,117.54.27.6:12416,1,263,0,0,1,263,1.102765000,0.0000
33.233.141.123:51565,<->,111.20.172.70:domain,1,100,0,0,1,100,1.102594000,0.0000
111.20.168.27:15956,<->,111.20.172.70:domain,1,96,0,0,1,96,1.102523000,0.0000
33.233.141.97:18815,<->,111.20.172.70:domain,1,149,0,0,1,149,1.102250000,0.0000
89.183.104.233:37916,<->,118.37.169.38:22841,1,147,0,0,1,147,1.102148000,0.0000
123.97.227.2:48134,<->,20.222.101.110:kerberos,0,0,1,149,1,149,1.101854000,0.0000
33.233.141.52:17463,<->,111.20.172.70:domain,1,143,0,0,1,143,1.101773000,0.0000
33.233.141.57:vrts-auth-port,<->,111.20.172.70:domain,1,148,0,0,1,148,1.101753000,0.0000
111.20.168.157:45448,<->,111.20.172.70:domain,1,140,0,0,1,140,1.101748000,0.0000
33.233.141.88:29304,<->,111.20.172.70:domain,1,140,0,0,1,140,1.101745000,0.0000
111.20.168.142:62577,<->,111.20.172.70:domain,1,145,0,0,1,145,1.101580000,0.0000
101.224.89.244:13995,<->,111.20.172.70:domain,1,104,0,0,1,104,1.101526000,0.0000
33.233.141.97:29054,<->,111.20.172.70:domain,1,96,0,0,1,96,1.101494000,0.0000
111.20.168.157:34709,<->,111.20.172.70:domain,1,101,0,0,1,101,1.101432000,0.0000
115.232.101.107:65481,<->,215.158.238.76:domain,0,0,1,83,1,83,1.101397000,0.0000
129.175.139.190:54450,<->,29.211.214.32:domain,0,0,1,122,1,122,1.101365000,0.0000
111.20.168.21:35664,<->,111.20.172.70:domain,1,95,0,0,1,95,1.101232000,0.0000
100.94.146.138:31640,<->,121.20.26.123:sqlexec-ssl,1,97,0,0,1,97,1.101163000,0.0000
155.133.39.148:59361,<->,78.123.16.211:14493,0,0,1,325,1,325,1.101074000,0.0000
101.224.89.251:37464,<->,111.20.172.70:domain,1,101,0,0,1,101,1.101034000,0.0000
33.233.141.230:56026,<->,148.155.129.25:domain,1,170,0,0,1,170,1.101011000,0.0000
111.20.168.157:11885,<->,111.20.172.70:domain,1,106,0,0,1,106,1.100976000,0.0000
101.224.89.161:23110,<->,111.20.172.70:domain,1,107,0,0,1,107,1.100970000,0.0000
33.233.141.122:18647,<->,111.20.172.70:domain,1,145,0,0,1,145,1.100811000,0.0000
33.233.141.57:55494,<->,111.20.172.70:domain,1,146,0,0,1,146,1.100796000,0.0000
111.20.168.27:51887,<->,111.20.172.70:domain,1,96,0,0,1,96,1.100720000,0.0000
33.233.141.88:7247,<->,111.20.172.70:domain,1,158,0,0,1,158,1.100702000,0.0000
111.20.168.10:29101,<->,111.20.172.70:domain,1,97,0,0,1,97,1.100456000,0.0000
101.224.89.129:19163,<->,111.20.172.70:domain,1,105,0,0,1,105,1.100406000,0.0000
33.233.141.88:21935,<->,111.20.172.70:domain,1,175,0,0,1,175,1.100302000,0.0000
111.20.168.157:52202,<->,111.20.172.70:domain,1,140,0,0,1,140,1.100280000,0.0000
215.158.140.168:52890,<->,111.151.107.247:domain,1,146,0,0,1,146,1.099848000,0.0000
33.233.141.88:19481,<->,111.20.172.70:domain,1,201,0,0,1,201,1.099661000,0.0000
33.233.141.61:16615,<->,111.20.172.70:domain,1,104,0,0,1,104,1.099577000,0.0000
111.20.168.58:easy-soft-mux,<->,111.20.172.70:domain,1,140,0,0,1,140,1.098992000,0.0000
144.75.218.235:50037,<->,97.94.119.24:domain,1,77,0,0,1,77,1.098082000,0.0000
144.75.218.235:37199,<->,149.164.189.49:domain,1,87,0,0,1,87,1.098022000,0.0000
33.233.141.230:22655,<->,148.155.129.25:domain,1,170,0,0,1,170,1.097825000,0.0000
27.127.251.59:lmcs,<->,129.224.112.252:domain,0,0,1,77,1,77,1.097758000,0.0000
192.67.161.171:6881,<->,114.132.77.146:6881,1,52,0,0,1,52,1.097570000,0.0000
33.233.141.69:11533,<->,53.203.244.13:domain,1,148,0,0,1,148,1.097547000,0.0000
220.28.109.99:31303,<->,144.69.82.139:domain,0,0,1,79,1,79,1.097477000,0.0000
144.75.218.237:38553,<->,8.222.218.204:domain,1,110,0,0,1,110,1.097391000,0.0000
4.240.232.244:49548,<->,92.27.219.159:35154,0,0,1,317,1,317,1.097281000,0.0000
33.233.141.102:15969,<->,111.20.172.70:domain,1,160,0,0,1,160,1.097180000,0.0000
215.158.61.36:52098,<->,80.56.78.92:domain,0,0,1,96,1,96,1.096829000,0.0000
33.233.141.88:46892,<->,111.20.172.70:domain,1,146,0,0,1,146,1.096787000,0.0000
54.61.179.29:22280,<->,246.253.248.211:domain,0,0,1,87,1,87,1.096595000,0.0000
92.27.219.218:6925,<->,149.250.234.17:domain,1,659,0,0,1,659,1.096511000,0.0000
92.162.219.101:42985,<->,129.224.112.252:domain,0,0,1,103,1,103,1.096467000,0.0000
33.233.141.101:60114,<->,111.20.172.70:domain,1,201,0,0,1,201,1.096404000,0.0000
111.20.168.58:23196,<->,111.20.172.70:domain,1,100,0,0,1,100,1.096338000,0.0000
201.192.219.121:49294,<->,129.224.112.252:domain,0,0,1,75,1,75,1.096140000,0.0000
111.20.168.141:33284,<->,111.20.172.70:domain,1,95,0,0,1,95,1.095927000,0.0000
101.224.89.171:53405,<->,111.20.172.70:domain,1,292,0,0,1,292,1.095885000,0.0000
33.233.141.104:inova-ip-disco,<->,111.20.172.70:domain,1,103,0,0,1,103,1.095555000,0.0000
18.215.146.2:35245,<->,98.67.136.236:domain,0,0,1,76,1,76,1.095425000,0.0000
144.93.125.38:54809,<->,144.93.121.10:imip,0,0,1,104,1,104,1.095363000,0.0000
111.20.168.157:21935,<->,111.20.172.70:domain,1,160,0,0,1,160,1.095092000,0.0000
33.233.141.56:21492,<->,111.20.172.70:domain,1,109,0,0,1,109,1.095055000,0.0000
133.229.224.241:39702,<->,80.56.78.128:domain,0,0,1,95,1,95,1.094850000,0.0000
33.233.141.101:15442,<->,111.20.172.70:domain,1,124,0,0,1,124,1.094848000,0.0000
144.75.218.242:23259,<->,8.222.218.199:domain,1,111,0,0,1,111,1.094435000,0.0000
33.233.141.56:32588,<->,111.20.172.70:domain,1,143,0,0,1,143,1.094004000,0.0000
33.233.141.101:52613,<->,111.20.172.70:domain,1,160,0,0,1,160,1.093979000,0.0000
33.233.141.50:24600,<->,111.20.172.70:domain,1,154,0,0,1,154,1.093448000,0.0000
33.233.141.56:5809,<->,115.167.81.247:domain,1,113,0,0,1,113,1.093436000,0.0000
33.233.141.102:35930,<->,111.20.172.70:domain,1,140,0,0,1,140,1.093198000,0.0000
80.47.33.8:36579,<->,29.211.214.82:domain,0,0,1,86,1,86,1.093163000,0.0000
66.127.213.175:54879,<->,80.40.48.131:16470,0,0,1,50,1,50,1.093063000,0.0000
33.233.141.101:48898,<->,111.20.172.70:domain,1,99,0,0,1,99,1.093020000,0.0000
101.224.89.136:46321,<->,111.20.172.70:domain,1,99,0,0,1,99,1.092977000,0.0000
202.124.171.233:25215,<->,108.39.208.231:bctp,0,0,1,138,1,138,1.092732000,0.0000
215.158.103.219:63941,<->,158.189.38.26:domain,1,88,0,0,1,88,1.092440000,0.0000
20.214.82.212:61936,<->,237.79.102.33:39123,1,52,0,0,1,52,1.092285000,0.0000
53.80.105.51:mc-brk-srv,<->,132.249.70.213:domain,0,0,1,116,1,116,1.092122000,0.0000
33.233.141.89:53433,<->,111.20.172.70:domain,1,144,0,0,1,144,1.091681000,0.0000
:::autonoc,<->,:::domain,1,155,0,0,1,155,1.091378000,0.0000
101.224.89.228:17924,<->,111.20.172.70:domain,1,286,0,0,1,286,1.091117000,0.0000
101.224.89.243:46673,<->,111.20.172.70:domain,1,112,0,0,1,112,1.090870000,0.0000
111.20.168.20:25420,<->,111.20.172.70:domain,1,105,0,0,1,105,1.090690000,0.0000
33.233.141.56:piranha2,<->,111.20.172.70:domain,1,119,0,0,1,119,1.090580000,0.0000
33.233.141.104:65498,<->,111.20.172.70:domain,1,97,0,0,1,97,1.090487000,0.0000
158.169.138.222:53965,<->,101.224.172.135:28016,0,0,1,57,1,57,1.090288000,0.0000
129.236.100.136:26513,<->,129.224.112.252:domain,0,0,1,76,1,76,1.090220000,0.0000
111.20.168.14:17272,<->,111.20.172.70:domain,1,149,0,0,1,149,1.090193000,0.0000
111.20.168.144:dssiapi,<->,111.20.172.70:domain,1,124,0,0,1,124,1.090066000,0.0000
144.75.218.235:52206,<->,8.222.218.197:domain,1,113,0,0,1,113,1.089625000,0.0000
101.224.89.137:47088,<->,111.20.172.70:domain,1,140,0,0,1,140,1.089618000,0.0000
33.233.141.121:36659,<->,111.20.172.70:domain,1,97,0,0,1,97,1.089461000,0.0000
144.108.64.183:25103,<->,159.69.187.22:domain,0,0,1,68,1,68,1.089425000,0.0000
33.233.141.47:tcoregagent,<->,111.20.172.70:domain,1,102,0,0,1,102,1.089413000,0.0000
111.20.168.14:16348,<->,111.20.172.70:domain,1,140,0,0,1,140,1.089237000,0.0000
33.233.141.102:fjinvmgr,<->,111.20.172.70:domain,1,148,0,0,1,148,1.089174000,0.0000
126.245.187.49:49361,<->,80.40.45.77:6882,0,0,1,52,1,52,1.089035000,0.0000
33.233.141.122:53597,<->,111.20.172.70:domain,1,144,0,0,1,144,1.088970000,0.0000
33.233.141.32:40334,<->,111.20.172.70:domain,1,179,0,0,1,179,1.088926000,0.0000
33.233.141.102:38414,<->,111.20.172.70:domain,1,160,0,0,1,160,1.088808000,0.0000
33.233.141.70:netview-aix-3,<->,111.20.172.70:domain,1,103,0,0,1,103,1.088745000,0.0000
33.233.141.104:41565,<->,111.20.172.70:domain,1,142,0,0,1,142,1.088370000,0.0000
101.224.89.222:41478,<->,111.20.172.70:domain,1,99,0,0,1,99,1.088305000,0.0000
239.66.89.165:sip-tls,<->,102.51.131.202:sip,0,0,1,50,1,50,1.088224000,0.0000
192.64.229.128:53877,<->,134.248.13.131:cap,1,50,0,0,1,50,1.088045000,0.0000
111.20.168.143:33400,<->,111.20.172.70:domain,1,152,0,0,1,152,1.088006000,0.0000
144.75.218.246:49082,<->,138.127.231.151:domain,1,253,0,0,1,253,1.088000000,0.0000
111.20.168.144:31389,<->,111.20.172.70:domain,1,111,0,0,1,111,1.087970000,0.0000
111.20.168.10:52084,<->,111.20.172.70:domain,1,106,0,0,1,106,1.087949000,0.0000
144.75.218.237:14604,<->,8.222.218.204:domain,1,111,0,0,1,111,1.087778000,0.0000
111.20.168.143:47890,<->,111.20.172.70:domain,1,140,0,0,1,140,1.087758000,0.0000
144.75.218.237:27163,<->,8.222.218.199:domain,1,110,0,0,1,110,1.087520000,0.0000
144.75.218.246:sunscalar-dns,<->,8.222.218.197:domain,1,122,0,0,1,122,1.087426000,0.0000
215.158.103.206:56958,<->,113.188.130.131:domain,1,122,0,0,1,122,1.087406000,0.0000
144.75.218.241:43171,<->,120.155.84.97:domain,1,147,0,0,1,147,1.087328000,0.0000
122.143.161.166:19543,<->,80.41.58.237:blackjack,0,0,1,319,1,319,1.087256000,0.0000
101.224.89.252:34212,<->,138.127.224.225:domain,1,231,0,0,1,231,1.087222000,0.0000
33.233.141.56:tunatic,<->,111.20.172.70:domain,1,110,0,0,1,110,1.087217000,0.0000
101.224.89.139:38170,<->,111.20.172.70:domain,1,150,0,0,1,150,1.087133000,0.0000
192.67.167.86:62821,<->,92.45.66.15:58806,1,52,0,0,1,52,1.086934000,0.0000
20.233.54.222:56589,<->,118.38.71.77:domain,1,66,0,0,1,66,1.086859000,0.0000
33.233.141.101:12536,<->,111.20.172.70:domain,1,179,0,0,1,179,1.086828000,0.0000
33.233.141.101:43878,<->,111.20.172.70:domain,1,220,0,0,1,220,1.086518000,0.0000
8.252.222.166:34502,<->,192.171.13.33:domain,1,402,0,0,1,402,1.086358000,0.0000
129.236.100.120:50149,<->,129.224.112.252:domain,0,0,1,76,1,76,1.086100000,0.0000
33.233.141.93:61692,<->,138.127.224.102:domain,1,240,0,0,1,240,1.086034000,0.0000
111.20.168.14:32436,<->,111.20.172.70:domain,1,149,0,0,1,149,1.085928000,0.0000
111.20.168.143:4824,<->,111.20.172.70:domain,1,146,0,0,1,146,1.085846000,0.0000
33.233.141.101:hhb-gateway,<->,111.20.172.70:domain,1,201,0,0,1,201,1.085799000,0.0000
111.20.168.144:com-bardac-dw,<->,111.20.172.70:domain,1,166,0,0,1,166,1.085781000,0.0000
22.50.59.223:37643,<->,144.69.82.139:domain,0,0,1,75,1,75,1.085650000,0.0000
33.233.141.101:17877,<->,111.20.172.70:domain,1,93,0,0,1,93,1.085639000,0.0000
144.75.218.246:16143,<->,8.222.218.199:domain,1,111,0,0,1,111,1.085288000,0.0000
33.233.141.1:52786,<->,148.155.129.25:domain,1,170,0,0,1,170,1.084607000,0.0000
101.224.89.243:39278,<->,111.20.172.70:domain,1,94,0,0,1,94,1.084602000,0.0000
33.233.141.81:14478,<->,111.20.172.70:domain,1,86,0,0,1,86,1.084507000,0.0000
92.173.80.90:53760,<->,92.27.27.99:45466,0,0,1,52,1,52,1.084485000,0.0000
132.168.197.226:39366,<->,138.127.231.205:domain,1,157,0,0,1,157,1.084433000,0.0000
221.150.250.237:58599,<->,97.22.32.10:domain,1,178,0,0,1,178,1.084424000,0.0000
101.224.89.168:38114,<->,111.20.172.70:domain,1,299,0,0,1,299,1.084209000,0.0000
111.20.168.20:40222,<->,111.20.172.70:domain,1,160,0,0,1,160,1.084051000,0.0000
105.229.251.213:21176,<->,92.27.219.146:bctp,0,0,1,349,1,349,1.083958000,0.0000
111.20.168.20:19509,<->,111.20.172.70:domain,1,173,0,0,1,173,1.083922000,0.0000
129.236.100.120:32512,<->,129.224.112.252:domain,0,0,1,75,1,75,1.083780000,0.0000
159.137.139.218:42576,<->,136.25.189.2:12347,0,0,1,1064,1,1064,1.083730000,0.0000
33.233.141.81:9169,<->,111.20.172.70:domain,1,151,0,0,1,151,1.083706000,0.0000
0.200.50.50:34233,<->,20.13.108.243:domain,0,0,1,60,1,60,1.083585000,0.0000
21.15.226.126:55104,<->,20.193.56.77:netbios-ns,0,0,1,82,1,82,1.083445000,0.0000
111.20.168.143:44865,<->,111.20.172.70:domain,1,98,0,0,1,98,1.083382000,0.0000
143.252.64.234:44425,<->,129.224.112.252:domain,0,0,1,72,1,72,1.083368000,0.0000
111.20.168.144:62827,<->,111.20.172.70:domain,1,157,0,0,1,157,1.083223000,0.0000
120.250.240.90:53983,<->,192.64.238.102:14143,0,0,1,349,1,349,1.083194000,0.0000
33.233.141.4:37840,<->,111.20.172.70:domain,1,288,0,0,1,288,1.082784000,0.0000
215.158.103.206:10496,<->,129.211.22.194:domain,1,803,0,0,1,803,1.082759000,0.0000
101.224.89.243:24401,<->,111.20.172.70:domain,1,108,0,0,1,108,1.082560000,0.0000
115.151.119.225:46436,<->,144.64.137.5:domain,0,0,1,74,1,74,1.082469000,0.0000
33.233.141.30:34391,<->,111.20.172.70:domain,1,103,0,0,1,103,1.082357000,0.0000
33.233.141.101:48111,<->,111.20.172.70:domain,1,148,0,0,1,148,1.082249000,0.0000
111.20.168.14:54545,<->,111.20.172.70:domain,1,155,0,0,1,155,1.082130000,0.0000
144.75.218.235:5809,<->,8.222.218.204:domain,1,110,0,0,1,110,1.081857000,0.0000
205.39.1.120:46684,<->,0.195.210.15:stun,0,0,1,158,1,158,1.081821000,0.0000
33.233.141.101:41884,<->,111.20.172.70:domain,1,97,0,0,1,97,1.081426000,0.0000
111.20.168.144:30548,<->,111.20.172.70:domain,1,96,0,0,1,96,1.081399000,0.0000
33.233.141.100:16220,<->,111.20.172.70:domain,1,98,0,0,1,98,1.081249000,0.0000
116.238.228.1:10005,<->,39.157.36.128:hacl-poll,0,0,1,92,1,92,1.081102000,0.0000
144.75.218.246:x11,<->,8.222.218.197:domain,1,110,0,0,1,110,1.080947000,0.0000
101.224.89.248:6776,<->,148.155.129.25:domain,1,170,0,0,1,170,1.080895000,0.0000
111.147.202.234:52974,<->,132.107.75.195:domain,1,360,0,0,1,360,1.080862000,0.0000
101.224.89.138:31641,<->,111.20.172.70:domain,1,97,0,0,1,97,1.080795000,0.0000
33.233.141.47:37618,<->,111.20.172.70:domain,1,104,0,0,1,104,1.080752000,0.0000
93.172.27.17:40187,<->,247.136.188.124:gnutella-svc,0,0,1,52,1,52,1.080751000,0.0000
33.233.141.231:39453,<->,111.20.172.70:domain,1,107,0,0,1,107,1.080026000,0.0000
111.20.168.144:52197,<->,111.20.172.70:domain,1,101,0,0,1,101,1.079980000,0.0000
144.75.218.246:53880,<->,8.222.218.199:domain,1,111,0,0,1,111,1.079968000,0.0000
39.131.11.141:9195,<->,141.125.172.113:domain,1,80,0,0,1,80,1.079965000,0.0000
33.233.141.121:emb-proj-cmd,<->,111.20.172.70:domain,1,98,0,0,1,98,1.079913000,0.0000
111.20.168.20:11497,<->,111.20.172.70:domain,1,150,0,0,1,150,1.079853000,0.0000
136.25.188.105:50405,<->,143.194.53.201:domain,1,241,0,0,1,241,1.079613000,0.0000
33.233.141.30:36497,<->,111.20.172.70:domain,1,152,0,0,1,152,1.079363000,0.0000
144.75.218.246:grubd,<->,8.222.218.204:domain,1,125,0,0,1,125,1.078725000,0.0000
:::11999,<->,:::domain,1,111,0,0,1,111,1.078482000,0.0000
101.224.89.157:25317,<->,57.176.113.202:domain,1,101,0,0,1,101,1.078453000,0.0000
33.233.141.30:21553,<->,111.20.172.70:domain,1,160,0,0,1,160,1.078435000,0.0000
144.75.218.246:12500,<->,132.43.156.54:domain,1,175,0,0,1,175,1.078380000,0.0000
92.27.219.198:30339,<->,197.8.203.28:24172,1,52,0,0,1,52,1.078274000,0.0000
111.20.168.11:22392,<->,111.20.172.70:domain,1,124,0,0,1,124,1.078235000,0.0000
192.64.114.92:64059,<->,230.59.65.170:19981,1,130,0,0,1,130,1.078187000,0.0000
101.224.89.152:7446,<->,111.20.172.70:domain,1,291,0,0,1,291,1.077985000,0.0000
101.224.89.178:22041,<->,148.155.131.220:domain,1,172,0,0,1,172,1.077950000,0.0000
33.233.141.64:39739,<->,138.127.225.156:domain,1,281,0,0,1,281,1.077822000,0.0000
144.75.218.242:61877,<->,159.57.86.226:domain,1,198,0,0,1,198,1.077642000,0.0000
131.233.225.105:20638,<->,39.248.134.206:domain,0,0,1,82,1,82,1.077426000,0.0000
33.233.141.71:27658,<->,132.250.195.39:domain,1,183,0,0,1,183,1.077400000,0.0000
101.224.89.243:25906,<->,111.20.172.70:domain,1,140,0,0,1,140,1.077387000,0.0000
129.236.100.136:sapv1,<->,129.224.112.252:domain,0,0,1,73,1,73,1.077369000,0.0000
33.233.141.81:m3da-disc,<->,111.20.172.70:domain,1,111,0,0,1,111,1.077146000,0.0000
101.224.89.138:28581,<->,111.20.172.70:domain,1,104,0,0,1,104,1.076911000,0.0000
101.224.89.152:17570,<->,111.20.172.70:domain,1,291,0,0,1,291,1.076654000,0.0000
111.20.168.6:45178,<->,111.20.172.70:domain,1,100,0,0,1,100,1.076636000,0.0000
111.20.168.6:52648,<->,111.20.172.70:domain,1,167,0,0,1,167,1.076532000,0.0000
33.233.141.2:34595,<->,138.127.224.225:domain,1,241,0,0,1,241,1.076078000,0.0000
144.75.218.242:23661,<->,138.127.225.175:domain,1,366,0,0,1,366,1.075968000,0.0000
144.75.218.242:42080,<->,141.37.226.95:domain,1,86,0,0,1,86,1.075959000,0.0000
144.75.218.235:esl-lm,<->,99.168.7.150:domain,1,156,0,0,1,156,1.075703000,0.0000
101.224.89.138:21029,<->,111.20.172.70:domain,1,149,0,0,1,149,1.075612000,0.0000
48.115.121.162:39328,<->,80.38.49.145:domain,0,0,1,82,1,82,1.075603000,0.0000
101.224.89.180:16598,<->,138.127.224.225:domain,1,234,0,0,1,234,1.075516000,0.0000
101.224.89.138:14777,<->,111.20.172.70:domain,1,101,0,0,1,101,1.075461000,0.0000
33.233.141.2:37744,<->,138.127.224.225:domain,1,239,0,0,1,239,1.075226000,0.0000
144.75.218.235:30972,<->,99.168.7.150:domain,1,146,0,0,1,146,1.075033000,0.0000
33.233.141.47:35398,<->,111.20.172.70:domain,1,160,0,0,1,160,1.074940000,0.0000
20.106.72.13:52477,<->,142.248.250.197:domain,1,74,0,0,1,74,1.074801000,0.0000
111.20.168.144:28281,<->,111.20.172.70:domain,1,124,0,0,1,124,1.074719000,0.0000
33.233.141.2:magbind,<->,138.127.224.225:domain,1,248,0,0,1,248,1.074670000,0.0000
33.233.141.21:29906,<->,111.20.172.70:domain,1,140,0,0,1,140,1.074666000,0.0000
33.233.141.89:62210,<->,111.20.172.70:domain,1,154,0,0,1,154,1.074656000,0.0000
111.20.168.6:kentrox-prot,<->,111.20.172.70:domain,1,140,0,0,1,140,1.074651000,0.0000
111.20.168.11:19692,<->,111.20.172.70:domain,1,98,0,0,1,98,1.074651000,0.0000
101.224.89.133:47006,<->,111.20.172.70:domain,1,102,0,0,1,102,1.074478000,0.0000
215.158.103.219:15076,<->,136.103.157.90:domain,1,123,0,0,1,123,1.074467000,0.0000
27.12.26.177:50138,<->,99.73.184.38:45089,0,0,1,168,1,168,1.074302000,0.0000
33.233.141.30:36415,<->,111.20.172.70:domain,1,140,0,0,1,140,1.074168000,0.0000
158.169.138.222:53965,<->,101.224.191.186:28026,0,0,1,57,1,57,1.073523000,0.0000
111.20.168.6:23965,<->,111.20.172.70:domain,1,190,0,0,1,190,1.073381000,0.0000
33.233.141.2:4528,<->,138.127.224.225:domain,1,242,0,0,1,242,1.073295000,0.0000
144.75.218.242:47289,<->,8.222.218.199:domain,1,122,0,0,1,122,1.073063000,0.0000
33.233.141.2:14301,<->,138.127.224.225:domain,1,246,0,0,1,246,1.072647000,0.0000
33.233.141.2:lotusnote,<->,138.127.224.225:domain,1,241,0,0,1,241,1.072508000,0.0000
33.233.141.21:46363,<->,111.20.172.70:domain,1,140,0,0,1,140,1.072447000,0.0000
120.235.249.7:47181,<->,192.67.182.48:22222,0,0,1,56,1,56,1.072163000,0.0000
33.233.141.2:28888,<->,138.127.224.225:domain,1,241,0,0,1,241,1.072054000,0.0000
127.203.163.101:37718,<->,92.27.219.190:29893,0,0,1,399,1,399,1.072030000,0.0000
144.75.218.246:21233,<->,99.168.7.150:domain,1,133,0,0,1,133,1.071950000,0.0000
33.233.141.112:13754,<->,138.127.225.122:domain,1,73,0,0,1,73,1.071552000,0.0000
111.20.168.23:46428,<->,111.20.172.70:domain,1,98,0,0,1,98,1.071415000,0.0000
101.224.89.133:22267,<->,111.20.172.70:domain,1,144,0,0,1,144,1.071401000,0.0000
33.233.141.21:46186,<->,111.20.172.70:domain,1,142,0,0,1,142,1.071207000,0.0000
21.15.226.126:55104,<->,20.193.56.48:netbios-ns,0,0,1,82,1,82,1.071182000,0.0000
144.75.218.242:34640,<->,119.94.225.50:domain,1,141,0,0,1,141,1.071113000,0.0000
136.25.188.42:60846,<->,111.151.107.247:domain,1,149,0,0,1,149,1.070962000,0.0000
101.224.89.133:63355,<->,111.20.172.70:domain,1,103,0,0,1,103,1.070879000,0.0000
101.224.89.137:17551,<->,111.20.172.70:domain,1,160,0,0,1,160,1.070873000,0.0000
111.20.168.23:63122,<->,111.20.172.70:domain,1,158,0,0,1,158,1.070842000,0.0000
:::44258,<->,:::domain,1,165,0,0,1,165,1.070822000,0.0000
111.20.168.11:csdmbase,<->,111.20.172.70:domain,1,178,0,0,1,178,1.070705000,0.0000
111.20.168.2:9683,<->,111.20.172.70:domain,1,140,0,0,1,140,1.070664000,0.0000
8.176.8.180:39539,<->,111.151.107.247:domain,1,111,0,0,1,111,1.070572000,0.0000
33.233.141.2:8847,<->,138.127.224.225:domain,1,238,0,0,1,238,1.070473000,0.0000
111.20.168.23:15907,<->,111.20.172.70:domain,1,82,0,0,1,82,1.070397000,0.0000
111.20.168.11:56992,<->,111.20.172.70:domain,1,168,0,0,1,168,1.070364000,0.0000
0.41.236.81:10209,<->,80.40.45.109:1024,0,0,1,100,1,100,1.070267000,0.0000
144.75.218.235:59506,<->,95.244.145.61:domain,1,185,0,0,1,185,1.069904000,0.0000
111.20.168.22:8852,<->,111.20.172.70:domain,1,201,0,0,1,201,1.069633000,0.0000
111.20.168.11:9922,<->,111.20.172.70:domain,1,160,0,0,1,160,1.069126000,0.0000
111.20.168.6:13479,<->,111.20.172.70:domain,1,144,0,0,1,144,1.068744000,0.0000
101.224.89.178:55644,<->,138.127.224.225:domain,1,244,0,0,1,244,1.068602000,0.0000
144.108.64.184:64044,<->,144.122.240.201:domain,0,0,1,65,1,65,1.068099000,0.0000
101.224.89.133:35881,<->,111.20.172.70:domain,1,171,0,0,1,171,1.068088000,0.0000
101.224.89.178:10907,<->,138.127.224.225:domain,1,253,0,0,1,253,1.068086000,0.0000
33.233.141.70:64523,<->,111.20.172.70:domain,1,149,0,0,1,149,1.068040000,0.0000
145.252.127.155:62329,<->,132.43.156.54:domain,1,802,0,0,1,802,1.067749000,0.0000
101.224.89.180:46790,<->,138.127.224.225:domain,1,237,0,0,1,237,1.067675000,0.0000
111.20.168.11:7604,<->,111.20.172.70:domain,1,160,0,0,1,160,1.067468000,0.0000
33.233.141.94:31633,<->,138.127.225.120:domain,1,254,0,0,1,254,1.067274000,0.0000
144.75.218.246:18240,<->,8.222.218.204:domain,1,110,0,0,1,110,1.067132000,0.0000
129.236.100.69:29073,<->,129.224.112.252:domain,0,0,1,74,1,74,1.067096000,0.0000
144.108.64.184:43317,<->,159.69.187.48:domain,0,0,1,61,1,61,1.066507000,0.0000
40.114.68.23:49516,<->,132.168.196.95:domain,0,0,1,71,1,71,1.066403000,0.0000
101.224.89.208:13837,<->,138.127.224.225:domain,1,236,0,0,1,236,1.066274000,0.0000
33.233.141.1:14161,<->,138.127.224.225:domain,1,250,0,0,1,250,1.066234000,0.0000
144.75.218.242:webmail-2,<->,8.222.218.199:domain,1,112,0,0,1,112,1.066228000,0.0000
39.141.13.87:10666,<->,207.101.151.225:domain,1,68,0,0,1,68,1.066207000,0.0000
33.233.141.30:45772,<->,111.20.172.70:domain,1,156,0,0,1,156,1.065945000,0.0000
92.27.219.42:54493,<->,121.159.234.165:11881,1,52,0,0,1,52,1.065644000,0.0000
101.224.89.178:56812,<->,138.127.224.225:domain,1,242,0,0,1,242,1.065332000,0.0000
111.20.168.23:17164,<->,111.20.172.70:domain,1,108,0,0,1,108,1.065175000,0.0000
33.233.141.30:56805,<->,111.20.172.70:domain,1,101,0,0,1,101,1.065164000,0.0000
111.20.168.22:55784,<->,111.20.172.70:domain,1,124,0,0,1,124,1.065156000,0.0000
192.65.58.210:23195,<->,105.170.238.230:20210,1,130,0,0,1,130,1.065094000,0.0000
111.20.168.22:57889,<->,111.20.172.70:domain,1,140,0,0,1,140,1.065054000,0.0000
144.75.218.241:52967,<->,8.222.218.207:domain,1,110,0,0,1,110,1.064915000,0.0000
144.75.218.246:59623,<->,8.222.218.204:domain,1,110,0,0,1,110,1.064769000,0.0000
144.75.218.242:57616,<->,8.222.218.207:domain,1,175,0,0,1,175,1.064685000,0.0000
33.233.141.95:36007,<->,111.20.172.70:domain,1,156,0,0,1,156,1.064449000,0.0000
53.162.162.35:7324,<->,138.31.199.102:domain,0,0,1,74,1,74,1.064381000,0.0000
98.67.155.63:52599,<->,53.196.208.123:domain,1,150,0,0,1,150,1.063858000,0.0000
111.20.168.1:40306,<->,111.20.172.70:domain,1,103,0,0,1,103,1.063836000,0.0000
111.20.168.28:22328,<->,111.20.172.70:domain,1,147,0,0,1,147,1.063719000,0.0000
129.236.111.66:57700,<->,129.224.112.252:domain,0,0,1,75,1,75,1.063500000,0.0000
144.75.218.235:vmodem,<->,99.168.7.150:domain,1,134,0,0,1,134,1.063374000,0.0000
33.233.141.1:53314,<->,138.127.224.225:domain,1,243,0,0,1,243,1.063365000,0.0000
101.224.89.178:56456,<->,138.127.224.225:domain,1,241,0,0,1,241,1.063352000,0.0000
144.75.218.242:42674,<->,8.222.218.199:domain,1,122,0,0,1,122,1.063274000,0.0000
129.236.111.66:prosharedata,<->,129.224.112.252:domain,0,0,1,75,1,75,1.063141000,0.0000
101.224.89.225:48137,<->,111.20.172.70:domain,1,140,0,0,1,140,1.063071000,0.0000
144.75.218.246:34287,<->,8.222.218.199:domain,1,111,0,0,1,111,1.063063000,0.0000
33.233.141.95:38197,<->,111.20.172.70:domain,1,152,0,0,1,152,1.062318000,0.0000
101.224.89.208:13943,<->,138.127.224.225:domain,1,238,0,0,1,238,1.062247000,0.0000
33.233.141.91:vmodem,<->,111.20.172.70:domain,1,168,0,0,1,168,1.062179000,0.0000
111.20.168.22:46367,<->,111.20.172.70:domain,1,102,0,0,1,102,1.061999000,0.0000
101.224.89.133:17657,<->,111.20.172.70:domain,1,110,0,0,1,110,1.061924000,0.0000
101.224.89.208:55756,<->,148.155.129.25:domain,1,170,0,0,1,170,1.061894000,0.0000
144.75.218.241:50494,<->,120.155.84.97:domain,1,136,0,0,1,136,1.061781000,0.0000
111.20.168.1:48263,<->,111.20.172.70:domain,1,146,0,0,1,146,1.061401000,0.0000
80.41.8.174:63836,<->,122.126.214.15:60296,1,51,0,0,1,51,1.061221000,0.0000
144.75.218.237:16410,<->,120.155.84.97:domain,1,174,0,0,1,174,1.060987000,0.0000
144.75.218.241:41999,<->,139.252.1.230:domain,1,90,0,0,1,90,1.060885000,0.0000
129.236.100.86:46497,<->,129.224.112.252:domain,0,0,1,78,1,78,1.060469000,0.0000
144.75.218.237:9454,<->,120.155.84.97:domain,1,146,0,0,1,146,1.060374000,0.0000
101.224.89.152:35168,<->,148.155.129.25:domain,1,173,0,0,1,173,1.060108000,0.0000
143.251.116.55:64711,<->,39.14.29.45:domain,0,0,1,87,1,87,1.060079000,0.0000
101.224.89.208:31876,<->,148.155.129.25:domain,1,165,0,0,1,165,1.059926000,0.0000
111.20.168.215:54526,<->,148.155.129.25:domain,1,165,0,0,1,165,1.059385000,0.0000
111.20.168.23:15876,<->,111.20.172.70:domain,1,178,0,0,1,178,1.059233000,0.0000
111.20.168.22:22642,<->,111.20.172.70:domain,1,110,0,0,1,110,1.059070000,0.0000
111.20.168.1:62892,<->,111.20.172.70:domain,1,101,0,0,1,101,1.058974000,0.0000
8.240.120.169:50835,<->,29.211.214.82:domain,0,0,1,85,1,85,1.058848000,0.0000
111.20.168.22:56333,<->,111.20.172.70:domain,1,97,0,0,1,97,1.058788000,0.0000
111.20.168.11:27158,<->,111.20.172.70:domain,1,150,0,0,1,150,1.058661000,0.0000
8.176.8.237:49426,<->,192.171.13.35:domain,1,102,0,0,1,102,1.058396000,0.0000
8.176.8.237:50849,<->,192.171.13.35:domain,1,102,0,0,1,102,1.058377000,0.0000
218.4.180.238:53919,<->,144.76.46.38:domain,1,128,0,0,1,128,1.057766000,0.0000
144.108.64.184:46898,<->,144.122.240.217:domain,0,0,1,74,1,74,1.057096000,0.0000
33.233.141.15:50451,<->,111.20.172.70:domain,1,157,0,0,1,157,1.056735000,0.0000
79.132.31.6:8887,<->,101.124.237.218:domain,0,0,1,79,1,79,1.056674000,0.0000
144.75.218.233:57507,<->,8.222.218.196:domain,1,110,0,0,1,110,1.056454000,0.0000
144.75.218.241:5646,<->,120.155.84.97:domain,1,144,0,0,1,144,1.056292000,0.0000
33.233.141.53:62574,<->,111.20.172.70:domain,1,98,0,0,1,98,1.056154000,0.0000
8.33.227.9:48028,<->,246.254.97.149:domain,0,0,1,93,1,93,1.055938000,0.0000
33.233.141.95:19743,<->,111.20.172.70:domain,1,148,0,0,1,148,1.055672000,0.0000
33.233.141.15:35093,<->,111.20.172.70:domain,1,104,0,0,1,104,1.055649000,0.0000
33.233.141.15:12389,<->,111.20.172.70:domain,1,143,0,0,1,143,1.055637000,0.0000
129.236.111.79:50153,<->,129.224.112.252:domain,0,0,1,75,1,75,1.055505000,0.0000
109.222.238.0:54584,<->,138.127.224.139:domain,1,218,0,0,1,218,1.055482000,0.0000
8.176.8.237:50253,<->,192.228.30.193:domain,1,111,0,0,1,111,1.055389000,0.0000
8.176.8.237:63084,<->,192.171.13.35:domain,1,418,0,0,1,418,1.054663000,0.0000
39.15.250.7:43263,<->,124.137.212.241:domain,1,70,0,0,1,70,1.054625000,0.0000
144.108.64.184:7064,<->,144.122.240.217:domain,0,0,1,68,1,68,1.054564000,0.0000
144.108.64.184:12751,<->,144.122.240.217:domain,0,0,1,68,1,68,1.054540000,0.0000
92.160.14.119:55145,<->,129.224.112.252:domain,0,0,1,77,1,77,1.053861000,0.0000
144.75.218.246:swismgr2,<->,8.222.218.199:domain,1,121,0,0,1,121,1.053724000,0.0000
20.32.37.250:28125,<->,130.34.187.113:domain,1,80,0,0,1,80,1.053428000,0.0000
39.57.19.30:14707,<->,126.210.84.155:domain,1,80,0,0,1,80,1.053188000,0.0000
111.20.168.2:8594,<->,111.20.172.70:domain,1,108,0,0,1,108,1.053005000,0.0000
129.236.111.82:sabams,<->,129.224.112.252:domain,0,0,1,78,1,78,1.052984000,0.0000
89.183.104.177:33155,<->,159.50.145.49:25069,1,101,0,0,1,101,1.052901000,0.0000
33.233.141.91:41261,<->,111.20.172.70:domain,1,147,0,0,1,147,1.052720000,0.0000
27.127.251.61:10181,<->,129.224.112.252:domain,0,0,1,81,1,81,1.052530000,0.0000
144.75.218.242:bbn-mmc,<->,138.127.230.221:domain,1,84,0,0,1,84,1.052342000,0.0000
144.75.218.242:38626,<->,8.222.218.199:domain,1,237,0,0,1,237,1.052313000,0.0000
20.242.117.110:27065,<->,122.252.94.13:domain,1,75,0,0,1,75,1.051947000,0.0000
111.20.168.215:13002,<->,138.127.225.223:domain,1,236,0,0,1,236,1.051806000,0.0000
:::49867,<->,:::domain,1,333,0,0,1,333,1.051579000,0.0000
144.75.218.242:31933,<->,8.222.218.204:domain,1,110,0,0,1,110,1.051002000,0.0000
144.75.218.241:26710,<->,130.61.211.1:domain,1,141,0,0,1,141,1.050782000,0.0000
136.25.188.105:52071,<->,132.43.156.81:domain,1,250,0,0,1,250,1.050737000,0.0000
:::8456,<->,:::domain,1,125,0,0,1,125,1.050697000,0.0000
102.50.154.84:51562,<->,27.15.128.177:22467,1,321,0,0,1,321,1.050472000,0.0000
111.147.92.83:51621,<->,148.91.248.5:45627,1,52,0,0,1,52,1.050321000,0.0000
144.75.218.233:63408,<->,138.127.225.49:domain,1,365,0,0,1,365,1.050244000,0.0000
111.20.168.2:48633,<->,111.20.172.70:domain,1,98,0,0,1,98,1.050203000,0.0000
20.42.38.105:15377,<->,73.70.158.157:domain,1,130,0,0,1,130,1.050047000,0.0000
129.236.111.79:4440,<->,129.224.112.252:domain,0,0,1,78,1,78,1.050040000,0.0000
20.17.136.36:26031,<->,124.17.249.27:domain,1,74,0,0,1,74,1.049878000,0.0000
111.20.168.23:27777,<->,111.20.172.70:domain,1,155,0,0,1,155,1.049855000,0.0000
8.238.93.151:6881,<->,230.126.147.103:5700,1,133,0,0,1,133,1.049697000,0.0000
201.194.125.234:safetynetp,<->,20.94.75.215:29908,0,0,1,52,1,52,1.049555000,0.0000
121.232.73.135:23566,<->,132.51.6.188:domain,0,0,1,71,1,71,1.049465000,0.0000
8.176.8.237:57356,<->,111.151.107.247:domain,1,126,0,0,1,126,1.049151000,0.0000
101.224.89.251:6843,<->,138.127.224.225:domain,1,241,0,0,1,241,1.049137000,0.0000
101.224.89.251:25499,<->,138.127.224.225:domain,1,251,0,0,1,251,1.049107000,0.0000
27.127.251.61:checkpoint-rtm,<->,129.224.112.252:domain,0,0,1,81,1,81,1.048942000,0.0000
202.163.175.199:21041,<->,20.194.30.147:20860,0,0,1,133,1,133,1.048559000,0.0000
217.11.189.9:x11,<->,109.222.237.159:powerschool,0,0,1,446,1,446,1.048409000,0.0000
129.236.111.82:cpqrpm-server,<->,129.224.112.252:domain,0,0,1,77,1,77,1.048193000,0.0000
111.27.182.215:27193,<->,132.249.70.213:domain,0,0,1,117,1,117,1.048170000,0.0000
101.224.89.251:18335,<->,138.127.224.225:domain,1,237,0,0,1,237,1.048089000,0.0000
144.75.218.241:47830,<->,8.222.218.196:domain,1,121,0,0,1,121,1.047871000,0.0000
80.42.162.159:51413,<->,249.127.47.127:35852,1,138,0,0,1,138,1.047595000,0.0000
144.108.64.184:15882,<->,144.122.240.192:domain,0,0,1,66,1,66,1.047545000,0.0000
196.22.168.122:49750,<->,246.253.253.208:https,0,0,1,125,1,125,1.047447000,0.0000
144.75.218.246:39173,<->,8.222.218.199:domain,1,110,0,0,1,110,1.047232000,0.0000
33.233.141.15:55884,<->,111.20.172.70:domain,1,102,0,0,1,102,1.046991000,0.0000
144.75.218.233:34747,<->,8.222.218.204:domain,1,110,0,0,1,110,1.046906000,0.0000
27.127.251.61:30926,<->,129.224.112.252:domain,0,0,1,75,1,75,1.046781000,0.0000
144.75.218.242:33866,<->,8.222.218.199:domain,1,153,0,0,1,153,1.046735000,0.0000
144.108.64.184:13569,<->,144.122.240.192:domain,0,0,1,66,1,66,1.046706000,0.0000
20.202.16.220:9028,<->,203.48.230.0:domain,1,74,0,0,1,74,1.046453000,0.0000
39.145.180.229:41977,<->,205.121.92.104:domain,1,70,0,0,1,70,1.046226000,0.0000
123.187.46.131:55369,<->,92.27.219.207:44656,0,0,1,52,1,52,1.045909000,0.0000
247.136.192.204:63855,<->,134.53.44.185:13777,1,52,0,0,1,52,1.045906000,0.0000
144.75.218.246:14879,<->,129.35.251.34:domain,1,163,0,0,1,163,1.045790000,0.0000
27.127.251.31:29543,<->,129.224.112.252:domain,0,0,1,72,1,72,1.045726000,0.0000
144.75.218.241:csms,<->,8.222.218.196:domain,1,121,0,0,1,121,1.045669000,0.0000
75.95.64.72:64118,<->,89.183.104.251:62633,0,0,1,52,1,52,1.045630000,0.0000
111.20.168.2:27066,<->,111.20.172.70:domain,1,178,0,0,1,178,1.045612000,0.0000
192.67.179.212:38198,<->,118.71.90.92:6889,1,331,0,0,1,331,1.045282000,0.0000
111.20.168.23:39593,<->,111.20.172.70:domain,1,105,0,0,1,105,1.045273000,0.0000
122.2.181.221:62211,<->,89.183.104.146:20396,0,0,1,351,1,351,1.045192000,0.0000
111.20.168.2:alta-ana-lm,<->,111.20.172.70:domain,1,101,0,0,1,101,1.045157000,0.0000
111.20.168.2:40900,<->,111.20.172.70:domain,1,101,0,0,1,101,1.045050000,0.0000
115.111.170.178:61487,<->,80.42.186.32:52297,0,0,1,113,1,113,1.045025000,0.0000
33.233.141.91:10290,<->,111.20.172.70:domain,1,173,0,0,1,173,1.044997000,0.0000
33.233.141.116:59760,<->,138.127.225.129:domain,1,241,0,0,1,241,1.044953000,0.0000
144.108.64.184:24287,<->,144.122.240.217:domain,0,0,1,68,1,68,1.044928000,0.0000
144.108.64.184:30380,<->,144.122.240.217:domain,0,0,1,67,1,67,1.044840000,0.0000
144.108.64.184:19046,<->,144.122.240.217:domain,0,0,1,68,1,68,1.044704000,0.0000
30.214.60.217:15217,<->,97.168.93.219:domain,0,0,1,68,1,68,1.044430000,0.0000
136.25.188.105:31871,<->,129.70.124.49:domain,1,358,0,0,1,358,1.044323000,0.0000
89.183.104.249:32471,<->,194.158.215.119:17821,1,148,0,0,1,148,1.044030000,0.0000
101.224.89.244:37391,<->,138.127.224.152:domain,1,295,0,0,1,295,1.043725000,0.0000
158.23.79.221:46691,<->,80.40.24.193:6881,0,0,1,317,1,317,1.043543000,0.0000
33.233.141.83:mfserver,<->,111.20.172.70:domain,1,181,0,0,1,181,1.043469000,0.0000
33.233.141.107:8761,<->,138.127.224.225:domain,1,242,0,0,1,242,1.043406000,0.0000
144.108.64.184:52915,<->,144.122.240.217:domain,0,0,1,68,1,68,1.043337000,0.0000
136.25.188.105:51218,<->,129.70.124.49:domain,1,352,0,0,1,352,1.043306000,0.0000
144.108.64.184:28419,<->,144.122.240.192:domain,0,0,1,66,1,66,1.042344000,0.0000
144.108.64.184:38590,<->,144.122.240.192:domain,0,0,1,66,1,66,1.042149000,0.0000
101.224.89.244:34499,<->,138.127.225.253:domain,1,251,0,0,1,251,1.042118000,0.0000
27.127.251.31:56489,<->,129.224.112.252:domain,0,0,1,82,1,82,1.042020000,0.0000
33.233.141.15:29927,<->,111.20.172.70:domain,1,111,0,0,1,111,1.041912000,0.0000
134.160.225.14:55492,<->,89.183.104.159:54281,0,0,1,263,1,263,1.041666000,0.0000
101.224.89.171:13745,<->,138.127.224.225:domain,1,235,0,0,1,235,1.041594000,0.0000
101.224.89.158:60277,<->,111.20.172.70:domain,1,109,0,0,1,109,1.041433000,0.0000
64.253.117.102:61137,<->,39.32.193.211:13152,0,0,1,52,1,52,1.041282000,0.0000
89.183.104.236:61234,<->,29.163.12.197:6881,1,52,0,0,1,52,1.040927000,0.0000
101.224.89.251:59323,<->,138.127.225.156:domain,1,338,0,0,1,338,1.040798000,0.0000
101.224.89.171:46835,<->,138.127.224.225:domain,1,243,0,0,1,243,1.040594000,0.0000
27.188.163.162:i-net-2000-npr,<->,109.1.16.196:sip,0,0,1,445,1,445,1.040561000,0.0000
144.75.218.237:16488,<->,8.222.218.207:domain,1,110,0,0,1,110,1.040545000,0.0000
144.108.64.184:50739,<->,144.122.240.192:domain,0,0,1,66,1,66,1.040323000,0.0000
144.75.218.246:41069,<->,8.222.218.204:domain,1,123,0,0,1,123,1.040180000,0.0000
27.127.251.103:46429,<->,129.224.112.252:domain,0,0,1,78,1,78,1.040095000,0.0000
144.75.218.237:43910,<->,8.222.218.204:domain,1,121,0,0,1,121,1.039873000,0.0000
92.27.219.49:31258,<->,33.215.68.189:20960,1,52,0,0,1,52,1.039698000,0.0000
111.20.168.23:42666,<->,111.20.172.70:domain,1,218,0,0,1,218,1.039605000,0.0000
144.75.218.235:62886,<->,8.222.218.198:domain,1,111,0,0,1,111,1.039526000,0.0000
118.228.81.59:36492,<->,102.231.178.198:26085,0,0,1,141,1,141,1.039285000,0.0000
144.75.218.246:11429,<->,8.222.218.199:domain,1,114,0,0,1,114,1.039054000,0.0000
159.123.6.141:43781,<->,144.81.142.50:domain,1,154,0,0,1,154,1.038920000,0.0000
144.108.64.184:13190,<->,144.122.240.192:domain,0,0,1,66,1,66,1.038904000,0.0000
21.15.226.126:55104,<->,20.193.56.216:netbios-ns,0,0,1,82,1,82,1.038874000,0.0000
33.233.141.228:61596,<->,138.127.224.45:domain,1,242,0,0,1,242,1.038737000,0.0000
:::36330,<->,:::domain,1,308,0,0,1,308,1.038672000,0.0000
:::47763,<->,:::domain,1,314,0,0,1,314,1.038471000,0.0000
27.127.251.31:42492,<->,129.224.112.252:domain,0,0,1,82,1,82,1.038191000,0.0000
33.233.141.27:7257,<->,138.127.224.44:domain,1,234,0,0,1,234,1.037931000,0.0000
111.20.168.58:54641,<->,138.127.224.138:domain,1,267,0,0,1,267,1.037811000,0.0000
139.163.161.166:65175,<->,133.178.226.255:domain,0,0,1,90,1,90,1.037587000,0.0000
67.236.49.213:59363,<->,34.217.112.95:14208,0,0,1,52,1,52,1.037425000,0.0000
144.75.218.237:30125,<->,53.146.81.135:domain,1,227,0,0,1,227,1.037063000,0.0000
89.183.104.175:39702,<->,108.137.47.66:26596,1,52,0,0,1,52,1.036798000,0.0000
33.233.141.107:52558,<->,138.127.224.225:domain,1,247,0,0,1,247,1.036751000,0.0000
33.233.141.100:63136,<->,111.20.172.70:domain,1,140,0,0,1,140,1.036646000,0.0000
247.136.216.62:24682,<->,117.87.250.107:21137,1,52,0,0,1,52,1.036467000,0.0000
101.224.89.175:48339,<->,148.155.129.25:domain,1,173,0,0,1,173,1.036423000,0.0000
33.233.141.107:39843,<->,138.127.224.225:domain,1,243,0,0,1,243,1.036016000,0.0000
102.51.75.158:24891,<->,198.228.83.211:1024,1,135,0,0,1,135,1.035676000,0.0000
144.75.218.235:13227,<->,8.222.218.197:domain,1,177,0,0,1,177,1.035597000,0.0000
20.117.32.68:22286,<->,104.154.171.250:domain,1,70,0,0,1,70,1.035581000,0.0000
33.233.141.95:64354,<->,111.20.172.70:domain,1,145,0,0,1,145,1.035138000,0.0000
122.114.203.218:45635,<->,192.64.247.91:30665,0,0,1,52,1,52,1.034911000,0.0000
21.15.226.126:55104,<->,20.193.56.196:netbios-ns,0,0,1,82,1,82,1.034481000,0.0000
144.108.64.184:29970,<->,144.122.240.192:domain,0,0,1,66,1,66,1.034341000,0.0000
33.233.141.20:18723,<->,138.127.224.44:domain,1,234,0,0,1,234,1.033945000,0.0000
:::37068,<->,:::domain,1,292,0,0,1,292,1.033413000,0.0000
33.233.141.114:5621,<->,138.127.224.225:domain,1,236,0,0,1,236,1.033260000,0.0000
144.108.64.184:4521,<->,159.69.187.24:domain,0,0,1,67,1,67,1.033008000,0.0000
101.224.89.150:23519,<->,138.127.224.44:domain,1,234,0,0,1,234,1.033005000,0.0000
33.233.141.114:8123,<->,138.127.224.225:domain,1,236,0,0,1,236,1.032942000,0.0000
111.146.137.31:43686,<->,198.145.77.70:12893,1,136,0,0,1,136,1.032939000,0.0000
144.75.218.237:56155,<->,8.222.218.199:domain,1,124,0,0,1,124,1.032885000,0.0000
129.236.100.43:64413,<->,129.224.112.252:domain,0,0,1,73,1,73,1.032768000,0.0000
48.175.134.33:26305,<->,109.222.253.202:domain,0,0,1,74,1,74,1.032111000,0.0000
111.20.168.21:56082,<->,138.127.224.44:domain,1,234,0,0,1,234,1.032050000,0.0000
127.233.67.123:25196,<->,109.222.251.204:domain,0,0,1,69,1,69,1.031925000,0.0000
101.224.89.158:49631,<->,111.20.172.70:domain,1,105,0,0,1,105,1.031787000,0.0000
131.144.248.187:62116,<->,129.224.112.252:domain,0,0,1,89,1,89,1.031391000,0.0000
91.100.190.227:49175,<->,97.68.226.205:domain,0,0,1,70,1,70,1.031349000,0.0000
33.233.141.107:16602,<->,138.127.224.225:domain,1,244,0,0,1,244,1.031343000,0.0000
144.75.218.241:23283,<->,8.222.218.196:domain,1,110,0,0,1,110,1.031202000,0.0000
101.224.89.158:9275,<->,111.20.172.70:domain,1,96,0,0,1,96,1.031197000,0.0000
101.224.89.175:41766,<->,148.155.129.25:domain,1,172,0,0,1,172,1.031042000,0.0000
118.228.5.130:62364,<->,99.75.168.154:21102,0,0,1,325,1,325,1.030639000,0.0000
33.233.141.15:7537,<->,111.20.172.70:domain,1,147,0,0,1,147,1.030502000,0.0000
118.154.0.217:62654,<->,98.128.251.58:61034,0,0,1,99,1,99,1.030155000,0.0000
101.224.89.171:26681,<->,138.127.224.254:domain,1,255,0,0,1,255,1.029464000,0.0000
144.75.218.242:21500,<->,8.222.218.207:domain,1,110,0,0,1,110,1.029341000,0.0000
92.27.27.179:59939,<->,128.198.71.156:38898,1,367,0,0,1,367,1.028614000,0.0000
99.72.107.172:25294,<->,198.102.18.25:dnp,1,136,0,0,1,136,1.028519000,0.0000
136.25.188.105:58130,<->,128.243.151.33:domain,1,139,0,0,1,139,1.028256000,0.0000
33.233.141.107:24587,<->,138.127.225.156:domain,1,284,0,0,1,284,1.028042000,0.0000
144.75.218.246:17662,<->,97.68.93.9:domain,1,707,0,0,1,707,1.027644000,0.0000
100.208.47.97:58036,<->,78.54.198.249:29266,1,99,0,0,1,99,1.027526000,0.0000
21.15.226.126:55104,<->,20.193.57.252:netbios-ns,0,0,1,82,1,82,1.027312000,0.0000
144.75.218.246:jeol-nsddp-1,<->,132.200.124.228:domain,1,143,0,0,1,143,1.027276000,0.0000
144.75.218.246:20736,<->,8.222.218.197:domain,1,125,0,0,1,125,1.026585000,0.0000
144.75.218.237:53085,<->,8.222.218.198:domain,1,125,0,0,1,125,1.026528000,0.0000
136.25.188.105:61554,<->,143.194.53.201:domain,1,250,0,0,1,250,1.026002000,0.0000
92.27.219.146:bctp,<->,120.83.106.49:6881,1,324,0,0,1,324,1.025237000,0.0000
33.233.141.53:64949,<->,111.20.172.70:domain,1,147,0,0,1,147,1.025175000,0.0000
33.219.133.71:37205,<->,80.40.232.211:34182,0,0,1,135,1,135,1.025059000,0.0000
144.75.218.242:36780,<->,8.222.218.199:domain,1,113,0,0,1,113,1.025007000,0.0000
101.224.89.222:17580,<->,138.127.224.225:domain,1,241,0,0,1,241,1.024757000,0.0000
109.103.233.173:46373,<->,92.27.219.171:10178,0,0,1,78,1,78,1.024720000,0.0000
101.224.89.222:60011,<->,138.127.224.225:domain,1,232,0,0,1,232,1.024422000,0.0000
144.75.218.242:27989,<->,8.222.218.204:domain,1,125,0,0,1,125,1.024402000,0.0000
100.230.7.102:34541,<->,159.137.140.219:33440,0,0,1,50,1,50,1.024112000,0.0000
144.75.218.241:49812,<->,8.222.218.196:domain,1,126,0,0,1,126,1.024078000,0.0000
144.75.218.235:3m-image-lm,<->,8.222.218.197:domain,1,110,0,0,1,110,1.023834000,0.0000
215.158.103.219:9615,<->,138.127.224.55:domain,1,250,0,0,1,250,1.023800000,0.0000
20.158.8.215:7536,<->,146.224.248.193:domain,1,78,0,0,1,78,1.023759000,0.0000
144.75.218.242:27062,<->,236.227.128.37:domain,1,116,0,0,1,116,1.023271000,0.0000
144.75.218.233:19058,<->,8.222.218.197:domain,1,114,0,0,1,114,1.023030000,0.0000
33.58.232.13:32529,<->,89.183.104.146:20396,0,0,1,351,1,351,1.022788000,0.0000
101.224.89.225:34341,<->,111.20.172.70:domain,1,96,0,0,1,96,1.022746000,0.0000
221.196.123.233:63102,<->,111.147.240.74:37018,0,0,1,97,1,97,1.022174000,0.0000
144.75.218.246:metatude-mds,<->,138.127.224.101:domain,1,84,0,0,1,84,1.021893000,0.0000
6.85.11.53:60282,<->,89.183.104.157:openvpn,0,0,1,101,1,101,1.021783000,0.0000
119.87.77.32:11329,<->,192.67.128.244:6881,0,0,1,149,1,149,1.021660000,0.0000
33.233.141.101:60399,<->,138.127.224.63:domain,1,283,0,0,1,283,1.021532000,0.0000
149.200.188.84:40001,<->,80.41.16.28:15782,0,0,1,52,1,52,1.021378000,0.0000
:::16519,<->,:::domain,1,117,0,0,1,117,1.021367000,0.0000
126.237.211.201:51769,<->,92.27.219.207:44969,0,0,1,263,1,263,1.021166000,0.0000
215.158.103.206:41262,<->,129.229.242.60:domain,1,792,0,0,1,792,1.020979000,0.0000
101.224.89.222:cpsp,<->,138.127.224.225:domain,1,253,0,0,1,253,1.020792000,0.0000
144.75.218.235:51451,<->,8.222.218.204:domain,1,181,0,0,1,181,1.020257000,0.0000
111.20.168.2:57516,<->,111.20.172.70:domain,1,103,0,0,1,103,1.020203000,0.0000
213.38.142.227:59195,<->,91.231.135.160:6885,1,101,0,0,1,101,1.019855000,0.0000
213.154.101.1:54782,<->,137.81.65.54:domain,0,0,1,81,1,81,1.019508000,0.0000
33.233.141.15:31017,<->,111.20.172.70:domain,1,140,0,0,1,140,1.019499000,0.0000
149.178.48.72:59361,<->,129.224.112.252:domain,0,0,1,89,1,89,1.019276000,0.0000
144.75.218.246:30496,<->,8.222.218.197:domain,1,110,0,0,1,110,1.019151000,0.0000
89.183.104.159:54281,<->,198.37.0.165:22930,1,263,0,0,1,263,1.019141000,0.0000
144.75.218.235:38858,<->,8.222.218.197:domain,1,150,0,0,1,150,1.019123000,0.0000
92.27.27.156:14932,<->,42.27.224.194:6881,1,94,0,0,1,94,1.019038000,0.0000
136.25.188.105:59533,<->,128.243.151.37:domain,1,136,0,0,1,136,1.018854000,0.0000
33.233.141.117:56826,<->,138.127.225.87:domain,1,251,0,0,1,251,1.018802000,0.0000
144.75.218.241:57040,<->,8.222.218.207:domain,1,111,0,0,1,111,1.018375000,0.0000
129.254.99.105:34203,<->,129.224.112.252:domain,0,0,1,68,1,68,1.018224000,0.0000
144.75.218.246:40562,<->,8.222.218.197:domain,1,111,0,0,1,111,1.018204000,0.0000
114.243.231.163:61998,<->,92.27.219.133:45576,0,0,1,135,1,135,1.017857000,0.0000
33.233.141.101:19851,<->,138.127.225.202:domain,1,277,0,0,1,277,1.017467000,0.0000
92.27.219.228:31650,<->,107.28.208.38:6881,1,80,0,0,1,80,1.017241000,0.0000
21.15.226.126:55104,<->,20.193.57.234:netbios-ns,0,0,1,82,1,82,1.017236000,0.0000
144.108.64.184:35005,<->,144.122.240.204:domain,0,0,1,77,1,77,1.017166000,0.0000
144.75.218.233:15595,<->,8.222.218.196:domain,1,127,0,0,1,127,1.017059000,0.0000
144.75.218.233:16596,<->,138.127.224.188:domain,1,365,0,0,1,365,1.016734000,0.0000
144.75.218.242:15416,<->,138.127.224.83:domain,1,253,0,0,1,253,1.016375000,0.0000
33.233.141.53:49987,<->,111.20.172.70:domain,1,146,0,0,1,146,1.016066000,0.0000
144.75.218.246:34405,<->,8.222.218.197:domain,1,124,0,0,1,124,1.016058000,0.0000
144.75.218.237:49041,<->,242.22.195.239:domain,1,146,0,0,1,146,1.015958000,0.0000
144.75.218.237:4619,<->,120.155.84.97:domain,1,131,0,0,1,131,1.015925000,0.0000
132.249.70.233:62020,<->,148.198.183.187:domain,1,81,0,0,1,81,1.015672000,0.0000
144.75.218.241:52600,<->,8.222.218.196:domain,1,237,0,0,1,237,1.015642000,0.0000
8.252.222.104:50386,<->,192.171.13.80:domain,1,155,0,0,1,155,1.015590000,0.0000
8.176.8.192:60777,<->,192.171.13.190:domain,1,149,0,0,1,149,1.014645000,0.0000
73.94.136.231:59072,<->,20.169.213.25:softrack-meter,0,0,1,52,1,52,1.014450000,0.0000
136.25.188.105:60883,<->,145.11.5.168:domain,1,175,0,0,1,175,1.014072000,0.0000
144.108.64.184:7076,<->,159.69.187.44:domain,0,0,1,73,1,73,1.014055000,0.0000
243.117.125.27:24617,<->,129.224.112.252:domain,0,0,1,71,1,71,1.013990000,0.0000
144.75.218.235:rdmnet-device,<->,8.222.218.198:domain,1,110,0,0,1,110,1.013233000,0.0000
144.75.218.246:22732,<->,129.227.132.30:domain,1,76,0,0,1,76,1.013181000,0.0000
8.176.8.202:38658,<->,192.171.13.190:domain,1,170,0,0,1,170,1.012993000,0.0000
144.75.218.237:49952,<->,138.127.224.104:domain,1,302,0,0,1,302,1.012979000,0.0000
144.75.218.233:22821,<->,8.222.218.204:domain,1,175,0,0,1,175,1.012978000,0.0000
133.85.23.86:53326,<->,92.27.219.128:50696,0,0,1,84,1,84,1.012442000,0.0000
144.75.218.246:47789,<->,8.222.218.197:domain,1,123,0,0,1,123,1.011744000,0.0000
92.27.219.132:49367,<->,152.12.176.111:15393,1,213,0,0,1,213,1.011685000,0.0000
109.212.125.157:58582,<->,129.224.112.252:domain,0,0,1,77,1,77,1.011638000,0.0000
8.252.222.56:56670,<->,192.171.13.33:domain,1,95,0,0,1,95,1.010839000,0.0000
147.61.24.130:45529,<->,129.224.112.252:domain,0,0,1,74,1,74,1.009782000,0.0000
144.75.218.235:8529,<->,8.222.218.198:domain,1,110,0,0,1,110,1.009403000,0.0000
111.15.98.226:52160,<->,136.25.188.72:12347,0,0,1,1064,1,1064,1.009122000,0.0000
106.157.38.242:53126,<->,108.134.108.77:44895,0,0,1,50,1,50,1.009101000,0.0000
92.27.219.180:17650,<->,78.53.131.215:14970,1,69,0,0,1,69,1.008458000,0.0000
215.158.103.206:57389,<->,8.220.7.31:domain,1,150,0,0,1,150,1.008446000,0.0000
8.176.8.192:53925,<->,111.151.107.247:domain,1,155,0,0,1,155,1.008296000,0.0000
97.126.26.71:46212,<->,132.107.75.195:domain,1,377,0,0,1,377,1.007969000,0.0000
144.108.64.184:52814,<->,159.69.187.22:domain,0,0,1,62,1,62,1.007946000,0.0000
220.55.101.99:43033,<->,140.142.131.2:domain,1,76,0,0,1,76,1.007566000,0.0000
76.130.139.161:44809,<->,34.192.17.207:11051,0,0,1,52,1,52,1.007392000,0.0000
106.157.38.242:53126,<->,108.134.108.77:41751,0,0,1,50,1,50,1.007323000,0.0000
106.157.38.242:53126,<->,108.134.108.77:34723,0,0,1,50,1,50,1.007178000,0.0000
144.75.218.242:37981,<->,8.222.218.196:domain,1,125,0,0,1,125,1.006967000,0.0000
144.108.64.184:7366,<->,144.122.240.204:domain,0,0,1,82,1,82,1.006715000,0.0000
20.163.70.221:23252,<->,139.253.132.92:domain,1,135,0,0,1,135,1.006645000,0.0000
63.3.46.143:15154,<->,192.67.134.112:domain,0,0,1,65,1,65,1.006499000,0.0000
108.134.108.77:60795,<->,106.157.38.242:53126,1,50,0,0,1,50,1.006494000,0.0000
87.52.69.178:42706,<->,247.136.245.5:39193,0,0,1,99,1,99,1.006150000,0.0000
144.75.218.233:28190,<->,8.222.218.196:domain,1,110,0,0,1,110,1.006082000,0.0000
144.75.218.237:59108,<->,8.222.218.197:domain,1,114,0,0,1,114,1.005788000,0.0000
144.75.218.237:28756,<->,138.127.231.255:domain,1,268,0,0,1,268,1.005501000,0.0000
111.20.168.1:31063,<->,138.127.224.104:domain,1,286,0,0,1,286,1.005396000,0.0000
143.252.64.224:62285,<->,129.224.112.252:domain,0,0,1,65,1,65,1.005347000,0.0000
33.233.141.77:39306,<->,148.155.129.25:domain,1,173,0,0,1,173,1.005232000,0.0000
144.75.218.237:46515,<->,50.149.206.145:domain,1,233,0,0,1,233,1.005197000,0.0000
144.75.218.237:60833,<->,8.222.218.199:domain,1,127,0,0,1,127,1.004882000,0.0000
210.150.233.86:39327,<->,50.224.76.131:domain,0,0,1,79,1,79,1.004331000,0.0000
144.75.218.241:40955,<->,8.222.218.207:domain,1,111,0,0,1,111,1.004303000,0.0000
108.134.108.77:55849,<->,106.157.38.242:53126,1,50,0,0,1,50,1.004184000,0.0000
139.241.75.26:61181,<->,29.211.214.82:domain,0,0,1,90,1,90,1.003847000,0.0000
144.75.218.233:42852,<->,8.222.218.204:domain,1,158,0,0,1,158,1.003715000,0.0000
102.232.51.191:64438,<->,97.126.3.177:domain,0,0,1,67,1,67,1.003618000,0.0000
57.107.97.185:42550,<->,22.59.13.208:domain,0,0,1,64,1,64,1.003507000,0.0000
144.75.218.237:25267,<->,8.222.218.207:domain,1,123,0,0,1,123,1.003199000,0.0000
106.157.38.242:53126,<->,108.134.108.77:30637,0,0,1,50,1,50,1.003040000,0.0000
144.75.218.233:15972,<->,8.222.218.204:domain,1,122,0,0,1,122,1.002973000,0.0000
33.233.141.83:53656,<->,111.20.172.70:domain,1,124,0,0,1,124,1.002855000,0.0000
139.241.119.19:53005,<->,210.228.29.0:domain,1,130,0,0,1,130,1.002748000,0.0000
108.134.108.77:54692,<->,106.157.38.242:53126,1,50,0,0,1,50,1.002651000,0.0000
89.183.104.246:19083,<->,51.249.86.31:14618,1,321,0,0,1,321,1.002487000,0.0000
33.233.141.66:24058,<->,138.127.224.44:domain,1,234,0,0,1,234,1.002447000,0.0000
144.75.218.233:50445,<->,8.222.218.196:domain,1,125,0,0,1,125,1.001857000,0.0000
89.183.104.236:61199,<->,115.211.211.9:59404,1,147,0,0,1,147,1.001782000,0.0000
101.224.89.162:24208,<->,111.20.172.70:domain,1,148,0,0,1,148,1.001774000,0.0000
144.75.218.241:61317,<->,146.226.226.226:domain,1,85,0,0,1,85,1.001582000,0.0000
122.100.180.56:50759,<->,247.136.137.133:20577,0,0,1,62,1,62,1.001528000,0.0000
139.241.119.19:28699,<->,210.228.29.0:domain,1,130,0,0,1,130,1.001390000,0.0000
33.233.141.53:MOS-soap,<->,111.20.172.70:domain,1,144,0,0,1,144,1.001308000,0.0000
101.224.89.162:48948,<->,111.20.172.70:domain,1,104,0,0,1,104,1.001236000,0.0000
144.75.218.237:airshot,<->,8.222.218.197:domain,1,126,0,0,1,126,1.001226000,0.0000
131.144.248.194:4587,<->,129.224.112.252:domain,0,0,1,75,1,75,1.000952000,0.0000
101.224.89.158:25399,<->,111.20.172.70:domain,1,149,0,0,1,149,1.000910000,0.0000
93.162.13.46:39242,<->,192.64.217.166:14773,0,0,1,52,1,52,1.000709000,0.0000
144.75.218.237:31475,<->,138.127.224.104:domain,1,393,0,0,1,393,1.000239000,0.0000
92.170.252.76:25066,<->,230.84.236.133:15671,1,133,0,0,1,133,1.000165000,0.0000
106.157.38.242:53126,<->,108.134.108.77:catalyst,0,0,1,50,1,50,0.999630000,0.0000
33.233.141.227:30628,<->,120.155.84.97:domain,1,103,0,0,1,103,0.999417000,0.0000
33.233.141.83:58909,<->,111.20.172.70:domain,1,164,0,0,1,164,0.998895000,0.0000
33.233.141.25:37188,<->,111.20.172.70:domain,1,149,0,0,1,149,0.998877000,0.0000
144.75.218.237:22890,<->,129.35.251.34:domain,1,147,0,0,1,147,0.998722000,0.0000
144.75.218.241:35336,<->,8.222.218.207:domain,1,110,0,0,1,110,0.998720000,0.0000
144.75.218.241:38422,<->,8.222.218.196:domain,1,137,0,0,1,137,0.998546000,0.0000
101.224.89.132:55203,<->,111.20.172.70:domain,1,146,0,0,1,146,0.998403000,0.0000
144.87.235.187:44212,<->,138.127.224.104:domain,1,293,0,0,1,293,0.998111000,0.0000
134.227.83.143:19847,<->,192.64.217.166:1024,0,0,1,52,1,52,0.998083000,0.0000
132.249.70.46:x11,<->,110.37.156.14:nim,1,52,0,0,1,52,0.998023000,0.0000
92.27.219.54:59381,<->,112.151.63.215:11209,1,52,0,0,1,52,0.997711000,0.0000
100.92.48.99:odbcpathway,<->,139.114.178.207:domain,1,77,0,0,1,77,0.997676000,0.0000
92.27.219.250:54654,<->,94.24.111.59:33140,1,62,0,0,1,62,0.997401000,0.0000
106.157.38.242:53126,<->,108.134.108.77:42266,0,0,1,50,1,50,0.997317000,0.0000
101.224.89.132:50196,<->,111.20.172.70:domain,1,154,0,0,1,154,0.997218000,0.0000
131.1.235.233:36446,<->,133.178.227.30:domain,0,0,1,85,1,85,0.996881000,0.0000
74.17.219.15:40682,<->,66.11.15.168:24711,0,0,1,243,1,243,0.996853000,0.0000
134.92.64.170:12501,<->,20.163.197.248:4475,0,0,1,75,1,75,0.996675000,0.0000
144.75.218.246:14680,<->,8.222.218.204:domain,1,110,0,0,1,110,0.996665000,0.0000
131.1.235.233:40413,<->,133.178.227.30:domain,0,0,1,85,1,85,0.996455000,0.0000
106.157.38.242:53126,<->,108.134.108.77:13502,0,0,1,50,1,50,0.996432000,0.0000
21.15.226.126:55104,<->,20.193.57.139:netbios-ns,0,0,1,82,1,82,0.996369000,0.0000
106.157.38.242:53126,<->,108.134.108.77:11109,0,0,1,50,1,50,0.996204000,0.0000
33.233.141.51:27274,<->,111.20.172.70:domain,1,149,0,0,1,149,0.996189000,0.0000
33.233.141.77:4694,<->,138.127.225.122:domain,1,73,0,0,1,73,0.996159000,0.0000
33.233.141.3:12351,<->,138.127.224.121:domain,1,217,0,0,1,217,0.995917000,0.0000
33.233.141.83:17400,<->,111.20.172.70:domain,1,113,0,0,1,113,0.995326000,0.0000
33.233.141.229:37551,<->,111.20.172.70:domain,1,290,0,0,1,290,0.995014000,0.0000
33.233.141.25:49266,<->,111.20.172.70:domain,1,94,0,0,1,94,0.994891000,0.0000
144.75.218.237:14521,<->,8.222.218.204:domain,1,237,0,0,1,237,0.994657000,0.0000
33.233.141.29:50819,<->,111.20.172.70:domain,1,251,0,0,1,251,0.994587000,0.0000
132.217.25.155:53137,<->,100.197.98.222:domain,0,0,1,89,1,89,0.994547000,0.0000
21.15.226.126:55104,<->,20.193.57.129:netbios-ns,0,0,1,82,1,82,0.993973000,0.0000
108.134.108.77:59511,<->,106.157.38.242:53126,1,50,0,0,1,50,0.993801000,0.0000
33.233.141.29:44542,<->,111.20.172.70:domain,1,98,0,0,1,98,0.993786000,0.0000
53.187.62.98:41685,<->,39.15.169.14:domain,0,0,1,85,1,85,0.993474000,0.0000
101.70.97.189:27301,<->,53.239.1.154:domain,1,139,0,0,1,139,0.993349000,0.0000
33.233.141.25:34896,<->,111.20.172.70:domain,1,96,0,0,1,96,0.993346000,0.0000
33.233.141.229:58002,<->,111.20.172.70:domain,1,290,0,0,1,290,0.993274000,0.0000
144.75.218.233:29270,<->,8.222.218.196:domain,1,122,0,0,1,122,0.992924000,0.0000
111.20.168.156:63046,<->,111.20.172.70:domain,1,148,0,0,1,148,0.992877000,0.0000
33.233.141.51:20548,<->,111.20.172.70:domain,1,160,0,0,1,160,0.992600000,0.0000
33.233.141.29:46924,<->,111.20.172.70:domain,1,141,0,0,1,141,0.992570000,0.0000
109.1.51.39:45179,<->,193.46.99.244:itap-ddtp,1,129,0,0,1,129,0.992555000,0.0000
21.15.226.126:55104,<->,20.193.57.63:netbios-ns,0,0,1,82,1,82,0.992517000,0.0000
92.27.219.56:17123,<->,108.32.75.237:bacula-dir,1,340,0,0,1,340,0.992343000,0.0000
27.14.102.33:24743,<->,247.136.244.38:18983,0,0,1,181,1,181,0.992292000,0.0000
101.224.89.224:16378,<->,111.20.172.70:domain,1,98,0,0,1,98,0.992132000,0.0000
101.224.89.224:54101,<->,111.20.172.70:domain,1,254,0,0,1,254,0.991532000,0.0000
144.75.218.246:fcip-port,<->,8.222.218.204:domain,1,113,0,0,1,113,0.991524000,0.0000
101.224.89.224:23819,<->,111.20.172.70:domain,1,143,0,0,1,143,0.991406000,0.0000
192.67.181.112:45706,<->,42.80.251.187:8598,1,50,0,0,1,50,0.991268000,0.0000
104.242.139.65:10035,<->,39.219.79.13:audit,0,0,1,84,1,84,0.991151000,0.0000
27.188.163.162:i-net-2000-npr,<->,109.1.16.205:sip,0,0,1,445,1,445,0.991126000,0.0000
101.224.89.214:34444,<->,148.155.131.164:domain,1,172,0,0,1,172,0.990678000,0.0000
101.224.89.157:4465,<->,138.127.224.225:domain,1,233,0,0,1,233,0.990495000,0.0000
144.75.218.233:46936,<->,138.127.224.78:domain,1,365,0,0,1,365,0.990154000,0.0000
144.75.218.242:35672,<->,8.222.218.207:domain,1,122,0,0,1,122,0.989818000,0.0000
144.87.235.187:25615,<->,138.127.225.111:domain,1,261,0,0,1,261,0.989567000,0.0000
33.233.141.31:59020,<->,111.20.172.70:domain,1,85,0,0,1,85,0.989365000,0.0000
21.15.226.126:55104,<->,20.193.57.23:netbios-ns,0,0,1,82,1,82,0.988615000,0.0000
126.151.110.115:bts-appserver,<->,145.242.126.212:domain,0,0,1,78,1,78,0.988236000,0.0000
33.233.141.60:16233,<->,111.20.172.70:domain,1,115,0,0,1,115,0.988121000,0.0000
131.144.248.187:56079,<->,129.224.112.252:domain,0,0,1,75,1,75,0.988067000,0.0000
4.123.179.128:57185,<->,20.54.182.237:15457,0,0,1,52,1,52,0.987885000,0.0000
42.204.7.69:61972,<->,92.27.219.34:distinct,0,0,1,320,1,320,0.987774000,0.0000
21.15.226.126:55104,<->,20.193.57.60:netbios-ns,0,0,1,82,1,82,0.987559000,0.0000
123.163.186.237:41318,<->,39.15.169.14:domain,0,0,1,88,1,88,0.987304000,0.0000
193.87.147.104:49001,<->,89.183.104.146:20396,0,0,1,322,1,322,0.987285000,0.0000
144.75.218.241:44736,<->,120.155.84.97:domain,1,120,0,0,1,120,0.987062000,0.0000
92.170.27.61:30907,<->,64.144.33.216:23265,1,130,0,0,1,130,0.987041000,0.0000
33.233.141.29:4190,<->,111.20.172.70:domain,1,160,0,0,1,160,0.986838000,0.0000
144.76.43.242:58606,<->,159.137.138.173:domain,0,0,1,84,1,84,0.986487000,0.0000
43.6.133.220:51755,<->,109.222.246.3:domain,0,0,1,71,1,71,0.986457000,0.0000
215.158.238.137:41029,<->,80.56.76.30:domain,1,127,0,0,1,127,0.986455000,0.0000
139.241.115.2:40060,<->,29.211.214.254:domain,0,0,1,97,1,97,0.986447000,0.0000
89.183.104.231:54640,<->,78.49.139.79:fuscript,1,52,0,0,1,52,0.986413000,0.0000
126.204.106.102:38372,<->,89.183.104.188:entextlow,0,0,1,52,1,52,0.985981000,0.0000
144.75.218.246:31663,<->,8.222.218.197:domain,1,121,0,0,1,121,0.985952000,0.0000
144.75.218.246:25393,<->,8.222.218.204:domain,1,113,0,0,1,113,0.985793000,0.0000
139.241.115.2:49534,<->,29.211.214.254:domain,0,0,1,97,1,97,0.985761000,0.0000
20.59.67.2:53659,<->,197.158.73.222:domain,1,75,0,0,1,75,0.985679000,0.0000
136.25.188.105:51186,<->,128.243.151.35:domain,1,145,0,0,1,145,0.985611000,0.0000
144.75.218.233:57755,<->,8.222.218.196:domain,1,110,0,0,1,110,0.985467000,0.0000
144.75.218.241:37225,<->,139.252.1.219:domain,1,87,0,0,1,87,0.985387000,0.0000
144.75.218.235:25324,<->,8.222.218.204:domain,1,121,0,0,1,121,0.985134000,0.0000
144.76.42.205:15758,<->,144.64.138.25:domain,0,0,1,76,1,76,0.984986000,0.0000
206.16.207.74:49983,<->,192.67.162.92:10822,0,0,1,52,1,52,0.984793000,0.0000
33.233.141.31:42887,<->,111.20.172.70:domain,1,147,0,0,1,147,0.984571000,0.0000
111.20.168.139:46290,<->,111.20.172.70:domain,1,149,0,0,1,149,0.984271000,0.0000
107.245.169.4:58740,<->,97.126.116.15:domain,0,0,1,73,1,73,0.984268000,0.0000
120.187.147.183:49875,<->,6.75.156.217:29044,0,0,1,133,1,133,0.984220000,0.0000
144.75.218.242:41469,<->,8.222.218.196:domain,1,110,0,0,1,110,0.984060000,0.0000
39.166.59.155:43295,<->,223.137.189.161:domain,1,78,0,0,1,78,0.983858000,0.0000
144.75.218.242:58385,<->,8.222.218.207:domain,1,111,0,0,1,111,0.983731000,0.0000
144.108.80.163:8816,<->,159.69.187.1:domain,0,0,1,74,1,74,0.983277000,0.0000
109.1.16.21:59380,<->,125.23.154.213:53550,1,50,0,0,1,50,0.983179000,0.0000
8.176.8.69:53669,<->,192.171.13.190:domain,1,114,0,0,1,114,0.982715000,0.0000
101.224.89.214:12259,<->,138.127.224.104:domain,1,285,0,0,1,285,0.982576000,0.0000
92.27.219.49:32179,<->,124.69.199.94:8840,1,62,0,0,1,62,0.982147000,0.0000
53.164.37.149:20279,<->,246.253.248.211:domain,0,0,1,87,1,87,0.981965000,0.0000
144.75.218.242:15270,<->,8.222.218.204:domain,1,187,0,0,1,187,0.981956000,0.0000
144.75.218.242:59317,<->,8.222.218.199:domain,1,149,0,0,1,149,0.981756000,0.0000
144.75.218.235:12558,<->,97.110.148.11:domain,1,84,0,0,1,84,0.981705000,0.0000
144.75.218.235:58857,<->,8.222.218.204:domain,1,122,0,0,1,122,0.981593000,0.0000
111.20.168.139:43137,<->,111.20.172.70:domain,1,99,0,0,1,99,0.981531000,0.0000
92.27.219.237:36344,<->,33.36.35.205:19460,1,344,0,0,1,344,0.981416000,0.0000
144.75.218.241:35124,<->,138.127.230.170:domain,1,254,0,0,1,254,0.981339000,0.0000
111.20.168.139:44804,<->,111.20.172.70:domain,1,142,0,0,1,142,0.981186000,0.0000
144.75.218.242:31385,<->,8.222.218.199:domain,1,121,0,0,1,121,0.981161000,0.0000
39.133.32.7:12034,<->,130.143.130.253:domain,1,70,0,0,1,70,0.981142000,0.0000
33.233.141.31:50515,<->,111.20.172.70:domain,1,146,0,0,1,146,0.981099000,0.0000
111.146.212.68:57626,<->,193.46.99.113:21376,1,90,0,0,1,90,0.980478000,0.0000
111.20.168.156:28385,<->,111.20.172.70:domain,1,101,0,0,1,101,0.980353000,0.0000
136.25.188.105:49872,<->,141.204.123.255:domain,1,121,0,0,1,121,0.980260000,0.0000
0.197.90.160:52979,<->,136.181.47.74:25976,0,0,1,135,1,135,0.980098000,0.0000
111.20.168.139:13123,<->,111.20.172.70:domain,1,156,0,0,1,156,0.979436000,0.0000
33.233.141.86:27595,<->,111.20.172.70:domain,1,93,0,0,1,93,0.979061000,0.0000
20.6.146.190:41485,<->,195.12.132.138:domain,1,68,0,0,1,68,0.978445000,0.0000
148.241.122.20:63798,<->,89.183.104.172:42595,0,0,1,52,1,52,0.978200000,0.0000
111.20.168.156:28109,<->,111.20.172.70:domain,1,145,0,0,1,145,0.977964000,0.0000
144.75.218.235:63095,<->,99.168.7.150:domain,1,122,0,0,1,122,0.977383000,0.0000
192.64.250.118:64672,<->,122.126.97.27:49156,1,50,0,0,1,50,0.976665000,0.0000
100.95.247.23:61602,<->,105.102.103.207:boinc-client,1,135,0,0,1,135,0.976649000,0.0000
109.222.236.213:14810,<->,120.155.84.160:domain,1,119,0,0,1,119,0.976224000,0.0000
105.201.216.195:40597,<->,100.94.40.183:19845,0,0,1,330,1,330,0.975895000,0.0000
92.27.219.212:55334,<->,117.234.36.52:49818,1,52,0,0,1,52,0.975718000,0.0000
21.15.226.126:55104,<->,20.193.57.33:netbios-ns,0,0,1,82,1,82,0.975630000,0.0000
66.68.27.29:55230,<->,101.70.119.147:domain,0,0,1,73,1,73,0.975483000,0.0000
144.75.218.242:55583,<->,8.222.218.199:domain,1,110,0,0,1,110,0.974847000,0.0000
136.25.188.105:57325,<->,132.5.71.202:domain,1,232,0,0,1,232,0.974663000,0.0000
144.75.218.242:44904,<->,8.222.218.196:domain,1,110,0,0,1,110,0.974206000,0.0000
144.75.218.241:60799,<->,8.222.218.207:domain,1,122,0,0,1,122,0.972786000,0.0000
144.75.218.242:59563,<->,8.222.218.196:domain,1,122,0,0,1,122,0.972260000,0.0000
38.21.156.204:56633,<->,20.232.228.23:netbios-ns,0,0,1,82,1,82,0.972155000,0.0000
107.255.248.47:40710,<->,97.168.92.35:domain,0,0,1,74,1,74,0.971911000,0.0000
144.75.218.233:49483,<->,120.87.222.172:domain,1,133,0,0,1,133,0.971836000,0.0000
136.25.188.105:54484,<->,128.243.151.33:domain,1,234,0,0,1,234,0.971346000,0.0000
39.34.233.92:5809,<->,207.227.57.137:domain,1,78,0,0,1,78,0.971321000,0.0000
20.82.99.93:30831,<->,199.61.66.134:domain,1,72,0,0,1,72,0.971128000,0.0000
48.53.68.163:64777,<->,54.58.207.20:stun,1,136,0,0,1,136,0.970277000,0.0000
144.75.218.233:30186,<->,138.127.224.132:domain,1,249,0,0,1,249,0.970233000,0.0000
129.254.99.204:60077,<->,129.224.112.252:domain,0,0,1,64,1,64,0.970231000,0.0000
120.95.224.25:48701,<->,92.27.219.166:32681,0,0,1,135,1,135,0.970185000,0.0000
144.75.218.242:ums,<->,8.222.218.207:domain,1,125,0,0,1,125,0.970013000,0.0000
144.75.218.241:cluster-disc,<->,120.155.84.97:domain,1,216,0,0,1,216,0.969682000,0.0000
144.75.218.246:28258,<->,97.68.93.9:domain,1,707,0,0,1,707,0.969085000,0.0000
36.120.170.69:58218,<->,89.183.104.145:53555,0,0,1,349,1,349,0.968783000,0.0000
92.27.219.237:36344,<->,122.117.249.126:11601,1,330,0,0,1,330,0.968781000,0.0000
144.75.218.237:6437,<->,120.155.84.97:domain,1,236,0,0,1,236,0.968751000,0.0000
27.50.133.40:62858,<->,89.183.104.137:18312,0,0,1,52,1,52,0.968327000,0.0000
144.75.218.237:52794,<->,8.222.218.198:domain,1,114,0,0,1,114,0.967447000,0.0000
192.67.183.76:53009,<->,193.46.99.163:unicontrol,1,300,0,0,1,300,0.967225000,0.0000
33.156.177.142:37801,<->,98.129.96.103:6881,0,0,1,255,1,255,0.967063000,0.0000
108.134.108.77:35846,<->,106.157.38.242:33959,1,50,0,0,1,50,0.966844000,0.0000
192.64.194.95:35588,<->,148.145.88.210:6881,1,133,0,0,1,133,0.966456000,0.0000
144.75.218.233:62172,<->,8.222.218.197:domain,1,126,0,0,1,126,0.966409000,0.0000
144.75.218.237:10556,<->,8.222.218.204:domain,1,122,0,0,1,122,0.965987000,0.0000
198.107.161.237:36687,<->,102.51.181.240:25420,0,0,1,136,1,136,0.965596000,0.0000
144.75.218.233:18632,<->,145.62.238.247:domain,1,112,0,0,1,112,0.965575000,0.0000
8.188.179.8:59987,<->,80.56.78.128:domain,0,0,1,98,1,98,0.965543000,0.0000
144.75.218.246:60896,<->,8.222.218.199:domain,1,110,0,0,1,110,0.965272000,0.0000
144.75.218.242:31837,<->,8.222.218.199:domain,1,122,0,0,1,122,0.964882000,0.0000
77.147.19.155:58485,<->,92.27.219.161:6881,0,0,1,135,1,135,0.964232000,0.0000
144.75.218.242:50963,<->,141.192.67.251:domain,1,144,0,0,1,144,0.964193000,0.0000
33.57.74.181:32925,<->,220.55.75.166:domain,0,0,1,75,1,75,0.964125000,0.0000
136.25.188.105:61243,<->,141.204.123.255:domain,1,122,0,0,1,122,0.963864000,0.0000
53.233.145.111:32381,<->,80.38.36.164:domain,0,0,1,75,1,75,0.963831000,0.0000
78.44.34.243:26085,<->,89.183.104.166:6881,0,0,1,62,1,62,0.963677000,0.0000
144.76.42.211:officelink2000,<->,144.64.138.25:domain,0,0,1,76,1,76,0.962941000,0.0000
53.249.181.146:6079,<->,80.38.36.156:domain,0,0,1,75,1,75,0.962927000,0.0000
132.249.70.233:54103,<->,53.201.149.31:domain,1,81,0,0,1,81,0.962818000,0.0000
136.25.188.105:52072,<->,140.136.9.105:domain,1,232,0,0,1,232,0.962637000,0.0000
144.75.218.237:51276,<->,8.222.218.199:domain,1,154,0,0,1,154,0.962611000,0.0000
144.75.218.235:49697,<->,8.222.218.204:domain,1,113,0,0,1,113,0.962516000,0.0000
20.194.30.147:41624,<->,58.164.104.206:7238,1,133,0,0,1,133,0.962223000,0.0000
108.134.108.77:35200,<->,106.157.38.242:33959,1,50,0,0,1,50,0.962067000,0.0000
106.157.38.242:33959,<->,108.134.108.77:nqs,0,0,1,50,1,50,0.961919000,0.0000
104.217.65.191:35392,<->,80.41.42.158:28638,0,0,1,52,1,52,0.961826000,0.0000
66.87.55.243:24423,<->,145.208.190.219:6881,0,0,1,130,1,130,0.961633000,0.0000
144.75.218.237:55980,<->,8.222.218.198:domain,1,113,0,0,1,113,0.961584000,0.0000
159.67.88.187:45113,<->,89.183.104.249:32471,0,0,1,323,1,323,0.961362000,0.0000
118.67.109.18:52525,<->,92.27.219.234:15579,0,0,1,99,1,99,0.961222000,0.0000
144.75.218.246:33631,<->,97.94.181.63:domain,1,172,0,0,1,172,0.961143000,0.0000
106.157.38.242:33959,<->,108.134.108.77:27460,0,0,1,50,1,50,0.960006000,0.0000
97.242.126.200:57032,<->,98.236.193.132:domain,0,0,1,88,1,88,0.959972000,0.0000
53.212.138.208:60841,<->,246.253.248.211:domain,0,0,1,86,1,86,0.959596000,0.0000
106.157.38.242:33959,<->,108.134.108.77:28151,0,0,1,50,1,50,0.959334000,0.0000
144.75.218.237:58302,<->,120.155.84.97:domain,1,123,0,0,1,123,0.959297000,0.0000
132.168.197.226:5650,<->,132.208.68.222:domain,1,729,0,0,1,729,0.959009000,0.0000
144.75.218.235:29760,<->,8.222.218.197:domain,1,121,0,0,1,121,0.958609000,0.0000
39.13.192.98:49646,<->,121.85.84.62:domain,1,94,0,0,1,94,0.958410000,0.0000
144.75.218.246:47078,<->,8.222.218.197:domain,1,111,0,0,1,111,0.958186000,0.0000
75.70.20.154:22782,<->,100.214.121.114:domain,0,0,1,77,1,77,0.958030000,0.0000
92.27.52.56:43761,<->,92.27.26.203:snmp,0,0,1,83,1,83,0.957371000,0.0000
144.75.218.237:47054,<->,138.127.225.234:domain,1,281,0,0,1,281,0.957122000,0.0000
144.75.218.235:58694,<->,98.184.9.185:domain,1,97,0,0,1,97,0.956353000,0.0000
144.75.218.242:autopac,<->,8.222.218.199:domain,1,110,0,0,1,110,0.956091000,0.0000
99.73.150.56:52124,<->,118.42.3.133:12344,1,50,0,0,1,50,0.955985000,0.0000
144.75.218.233:38528,<->,8.222.218.196:domain,1,121,0,0,1,121,0.955927000,0.0000
144.75.218.235:13361,<->,8.222.218.204:domain,1,123,0,0,1,123,0.954957000,0.0000
144.75.218.235:41135,<->,8.222.218.204:domain,1,110,0,0,1,110,0.954779000,0.0000
144.75.218.233:25512,<->,138.127.225.46:domain,1,329,0,0,1,329,0.954735000,0.0000
144.75.218.246:37601,<->,8.222.218.197:domain,1,110,0,0,1,110,0.954576000,0.0000
136.25.188.105:61303,<->,128.243.151.35:domain,1,127,0,0,1,127,0.954382000,0.0000
144.75.218.241:13597,<->,8.222.218.196:domain,1,124,0,0,1,124,0.953619000,0.0000
132.20.222.234:41386,<->,129.224.112.221:domain,0,0,1,95,1,95,0.953607000,0.0000
92.27.219.237:36344,<->,143.89.238.210:24742,1,351,0,0,1,351,0.953446000,0.0000
0.200.50.50:34233,<->,20.13.109.166:domain,0,0,1,60,1,60,0.953178000,0.0000
8.252.223.38:33619,<->,111.151.107.247:domain,1,225,0,0,1,225,0.952755000,0.0000
124.64.83.37:50638,<->,89.183.104.164:37927,0,0,1,369,1,369,0.952467000,0.0000
89.183.104.135:31761,<->,159.58.54.98:10498,1,50,0,0,1,50,0.951904000,0.0000
144.75.218.237:27002,<->,8.222.218.199:domain,1,110,0,0,1,110,0.951823000,0.0000
144.75.218.233:43378,<->,138.127.224.104:domain,1,301,0,0,1,301,0.951304000,0.0000
92.27.219.230:56883,<->,134.160.147.115:49581,1,52,0,0,1,52,0.951127000,0.0000
144.75.218.246:54449,<->,138.127.225.188:domain,1,352,0,0,1,352,0.951022000,0.0000
40.153.136.228:13192,<->,97.168.64.50:6881,0,0,1,130,1,130,0.950961000,0.0000
21.15.226.126:55104,<->,20.193.58.37:netbios-ns,0,0,1,82,1,82,0.950959000,0.0000
92.27.27.179:59939,<->,101.106.122.69:37538,1,136,0,0,1,136,0.950509000,0.0000
215.158.103.206:50394,<->,138.127.231.113:domain,1,263,0,0,1,263,0.949718000,0.0000
8.252.223.38:59323,<->,111.151.107.247:domain,1,225,0,0,1,225,0.949625000,0.0000
92.27.219.187:34947,<->,112.38.250.104:27483,1,52,0,0,1,52,0.949431000,0.0000
97.242.126.176:14058,<->,129.224.112.252:domain,0,0,1,73,1,73,0.948988000,0.0000
20.208.96.223:22342,<->,123.165.45.181:domain,1,72,0,0,1,72,0.948767000,0.0000
131.1.235.233:34956,<->,133.178.227.10:domain,0,0,1,85,1,85,0.948500000,0.0000
81.108.138.135:52798,<->,192.67.129.253:domain,0,0,1,72,1,72,0.947936000,0.0000
59.146.67.216:51413,<->,92.27.27.180:9386,0,0,1,81,1,81,0.947925000,0.0000
144.75.218.242:50956,<->,8.222.218.199:domain,1,122,0,0,1,122,0.947715000,0.0000
144.75.218.242:8820,<->,8.222.218.207:domain,1,110,0,0,1,110,0.947298000,0.0000
215.158.30.23:49969,<->,29.211.214.254:domain,0,0,1,92,1,92,0.946799000,0.0000
80.38.4.56:11268,<->,128.243.145.254:domain,1,945,0,0,1,945,0.946562000,0.0000
8.252.222.246:42784,<->,192.171.13.190:domain,1,159,0,0,1,159,0.945940000,0.0000
144.75.218.246:59678,<->,8.222.218.199:domain,1,110,0,0,1,110,0.945838000,0.0000
102.51.41.126:56969,<->,196.24.193.173:49223,1,135,0,0,1,135,0.945680000,0.0000
20.79.105.212:41973,<->,149.182.161.13:domain,1,70,0,0,1,70,0.945624000,0.0000
144.75.218.241:33775,<->,8.222.218.207:domain,1,122,0,0,1,122,0.945389000,0.0000
20.111.132.186:22965,<->,127.25.104.19:domain,1,134,0,0,1,134,0.944885000,0.0000
247.136.136.51:48659,<->,40.192.85.12:25516,1,52,0,0,1,52,0.944859000,0.0000
92.27.219.231:64472,<->,123.154.23.86:6881,1,370,0,0,1,370,0.944776000,0.0000
113.189.202.235:64028,<->,129.224.112.252:domain,0,0,1,66,1,66,0.944679000,0.0000
91.247.40.69:63722,<->,133.178.226.181:12347,0,0,1,1064,1,1064,0.944636000,0.0000
99.168.30.209:50574,<->,144.69.82.139:domain,0,0,1,73,1,73,0.944301000,0.0000
144.75.218.246:27051,<->,8.222.218.199:domain,1,110,0,0,1,110,0.943862000,0.0000
122.158.51.62:58407,<->,215.158.239.74:domain,0,0,1,83,1,83,0.943834000,0.0000
21.15.226.126:55104,<->,20.193.58.44:netbios-ns,0,0,1,82,1,82,0.942772000,0.0000
133.73.8.230:54246,<->,136.25.189.86:domain,0,0,1,83,1,83,0.942507000,0.0000
131.233.225.105:45124,<->,246.254.97.149:domain,0,0,1,88,1,88,0.942326000,0.0000
206.147.242.252:50003,<->,80.41.39.119:sage-best-com2,0,0,1,321,1,321,0.941940000,0.0000
241.228.109.55:40403,<->,230.60.108.54:15144,1,181,0,0,1,181,0.941845000,0.0000
39.167.31.1:45135,<->,131.24.254.37:domain,1,91,0,0,1,91,0.941498000,0.0000
77.29.50.38:54040,<->,92.181.50.157:14801,0,0,1,140,1,140,0.941226000,0.0000
144.108.80.163:45271,<->,144.122.240.207:domain,0,0,1,64,1,64,0.940883000,0.0000
136.25.188.105:54044,<->,143.194.53.201:domain,1,250,0,0,1,250,0.940636000,0.0000
144.75.218.241:53964,<->,8.222.218.207:domain,1,110,0,0,1,110,0.940568000,0.0000
21.15.226.126:55104,<->,20.193.58.55:netbios-ns,0,0,1,82,1,82,0.940315000,0.0000
144.75.218.241:29947,<->,139.252.1.237:domain,1,163,0,0,1,163,0.940086000,0.0000
91.54.155.124:53741,<->,132.249.70.233:domain,0,0,1,83,1,83,0.939317000,0.0000
50.224.52.70:11910,<->,195.5.67.184:domain,1,80,0,0,1,80,0.939206000,0.0000
197.33.188.100:19859,<->,192.64.251.202:6881,0,0,1,135,1,135,0.939155000,0.0000
149.111.213.145:56738,<->,109.1.61.240:34074,0,0,1,351,1,351,0.939032000,0.0000
0.233.104.95:10752,<->,247.136.188.124:gnutella-svc,0,0,1,52,1,52,0.938956000,0.0000
144.76.43.242:28184,<->,80.56.78.128:domain,0,0,1,104,1,104,0.938892000,0.0000
144.54.95.244:65189,<->,192.67.167.244:25347,0,0,1,136,1,136,0.938745000,0.0000
144.75.218.242:16069,<->,8.222.218.199:domain,1,114,0,0,1,114,0.938385000,0.0000
50.162.21.37:26085,<->,64.151.30.204:17356,1,133,0,0,1,133,0.938350000,0.0000
144.75.218.235:57400,<->,8.222.218.197:domain,1,153,0,0,1,153,0.937337000,0.0000
132.10.25.131:60268,<->,132.43.156.54:domain,1,358,0,0,1,358,0.936609000,0.0000
92.27.219.21:57181,<->,203.212.95.67:13467,1,52,0,0,1,52,0.936256000,0.0000
143.252.64.235:33763,<->,129.224.112.252:domain,0,0,1,71,1,71,0.935974000,0.0000
144.75.218.246:52114,<->,138.127.224.230:domain,1,366,0,0,1,366,0.935474000,0.0000
33.61.126.211:41483,<->,80.42.168.43:17791,0,0,1,293,1,293,0.935053000,0.0000
93.223.122.242:10996,<->,132.168.199.163:6889,0,0,1,349,1,349,0.935012000,0.0000
144.75.218.235:esp-encap,<->,138.127.224.46:domain,1,253,0,0,1,253,0.934764000,0.0000
144.75.218.242:23556,<->,132.43.156.54:domain,1,135,0,0,1,135,0.934557000,0.0000
144.75.218.237:30341,<->,8.222.218.198:domain,1,110,0,0,1,110,0.934386000,0.0000
92.27.219.246:57815,<->,198.39.23.16:41838,1,100,0,0,1,100,0.934274000,0.0000
144.75.218.241:21481,<->,8.222.218.207:domain,1,122,0,0,1,122,0.932869000,0.0000
246.253.253.79:59413,<->,129.203.66.31:domain,1,633,0,0,1,633,0.932174000,0.0000
215.158.103.219:10489,<->,138.127.225.198:domain,1,355,0,0,1,355,0.932119000,0.0000
21.15.226.126:55104,<->,20.193.58.141:netbios-ns,0,0,1,82,1,82,0.931819000,0.0000
144.75.218.237:12477,<->,8.222.218.207:domain,1,110,0,0,1,110,0.930911000,0.0000
20.194.30.147:16237,<->,58.164.104.206:7238,1,133,0,0,1,133,0.930723000,0.0000
144.75.218.237:44106,<->,138.127.225.89:domain,1,366,0,0,1,366,0.930323000,0.0000
92.27.219.175:50907,<->,146.188.219.80:12450,1,52,0,0,1,52,0.930250000,0.0000
144.75.218.241:ip-provision,<->,138.127.224.169:domain,1,261,0,0,1,261,0.930210000,0.0000
144.75.218.242:13677,<->,138.127.230.199:domain,1,176,0,0,1,176,0.929846000,0.0000
144.75.218.235:6892,<->,8.222.218.197:domain,1,110,0,0,1,110,0.929156000,0.0000
33.233.141.49:35235,<->,75.36.65.235:domain,1,178,0,0,1,178,0.928963000,0.0000
145.213.37.27:13161,<->,136.129.94.107:domain,0,0,1,84,1,84,0.928633000,0.0000
144.75.218.237:36502,<->,8.222.218.198:domain,1,122,0,0,1,122,0.928520000,0.0000
89.183.104.150:30335,<->,122.142.5.111:25565,1,52,0,0,1,52,0.928273000,0.0000
144.75.218.233:59423,<->,8.222.218.204:domain,1,111,0,0,1,111,0.928081000,0.0000
8.252.222.11:33169,<->,192.171.13.190:domain,1,146,0,0,1,146,0.927780000,0.0000
144.76.42.201:64402,<->,101.224.183.152:domain,0,0,1,74,1,74,0.926753000,0.0000
144.75.218.242:17600,<->,8.222.218.199:domain,1,187,0,0,1,187,0.926266000,0.0000
144.75.218.242:17838,<->,119.94.225.50:domain,1,143,0,0,1,143,0.925908000,0.0000
144.82.14.49:21745,<->,145.110.55.59:domain,0,0,1,73,1,73,0.925886000,0.0000
93.208.12.164:54921,<->,109.222.214.116:filenet-nch,0,0,1,293,1,293,0.925588000,0.0000
8.176.8.201:39834,<->,111.150.207.83:domain,1,162,0,0,1,162,0.925537000,0.0000
215.158.103.206:60713,<->,132.43.156.56:domain,1,535,0,0,1,535,0.925206000,0.0000
144.75.218.237:38688,<->,8.222.218.204:domain,1,110,0,0,1,110,0.925155000,0.0000
144.75.218.233:34413,<->,138.127.224.80:domain,1,268,0,0,1,268,0.925114000,0.0000
144.75.218.246:45379,<->,8.222.218.204:domain,1,121,0,0,1,121,0.924422000,0.0000
8.176.8.83:48623,<->,126.219.197.183:domain,1,112,0,0,1,112,0.923794000,0.0000
48.110.179.206:24810,<->,159.194.91.13:6881,0,0,1,52,1,52,0.923789000,0.0000
144.75.218.241:23006,<->,8.222.218.196:domain,1,109,0,0,1,109,0.923306000,0.0000
144.75.218.242:60062,<->,138.127.230.2:domain,1,238,0,0,1,238,0.923256000,0.0000
68.91.45.69:50690,<->,109.222.255.59:domain,0,0,1,79,1,79,0.923231000,0.0000
144.93.125.49:50985,<->,144.93.121.86:10717,0,0,1,104,1,104,0.922776000,0.0000
144.75.218.242:62641,<->,97.68.93.11:domain,1,707,0,0,1,707,0.922535000,0.0000
215.158.103.206:44943,<->,129.220.171.193:domain,1,798,0,0,1,798,0.922308000,0.0000
50.49.60.53:24435,<->,101.70.119.102:domain,0,0,1,74,1,74,0.921928000,0.0000
144.75.218.235:37798,<->,138.127.230.242:domain,1,230,0,0,1,230,0.921438000,0.0000
92.27.219.54:56598,<->,196.233.128.246:26798,1,52,0,0,1,52,0.920237000,0.0000
192.65.58.253:43410,<->,230.87.31.198:cslistener,1,133,0,0,1,133,0.919357000,0.0000
132.249.70.233:50230,<->,53.201.149.31:domain,1,87,0,0,1,87,0.919336000,0.0000
122.78.204.6:50452,<->,247.136.251.232:41168,0,0,1,52,1,52,0.918842000,0.0000
20.198.105.222:61435,<->,4.129.137.231:52597,1,52,0,0,1,52,0.918663000,0.0000
108.134.108.77:55538,<->,106.157.38.242:33959,1,50,0,0,1,50,0.918554000,0.0000
144.75.218.237:49409,<->,120.155.84.97:domain,1,118,0,0,1,118,0.918548000,0.0000
89.183.104.253:64869,<->,114.228.208.175:56610,1,84,0,0,1,84,0.918537000,0.0000
215.158.103.206:27330,<->,124.55.106.24:domain,1,121,0,0,1,121,0.918502000,0.0000
89.183.104.224:36682,<->,119.186.32.127:12255,1,52,0,0,1,52,0.918353000,0.0000
112.90.30.190:62122,<->,109.1.8.71:11323,0,0,1,62,1,62,0.918143000,0.0000
141.92.221.59:44314,<->,129.224.112.252:domain,0,0,1,73,1,73,0.917984000,0.0000
106.157.38.242:33959,<->,108.134.108.77:16176,0,0,1,50,1,50,0.917917000,0.0000
83.96.53.127:49048,<->,109.222.199.132:domain,0,0,1,80,1,80,0.917886000,0.0000
106.157.38.242:33959,<->,108.134.108.77:22176,0,0,1,50,1,50,0.917678000,0.0000
:::65427,<->,:::domain,1,197,0,0,1,197,0.917348000,0.0000
144.75.218.246:11260,<->,8.222.218.197:domain,1,113,0,0,1,113,0.917078000,0.0000
144.108.80.170:61936,<->,159.69.187.25:domain,0,0,1,71,1,71,0.917062000,0.0000
114.186.133.56:65357,<->,129.224.112.252:domain,0,0,1,85,1,85,0.916639000,0.0000
106.157.38.242:33959,<->,108.134.108.77:26375,0,0,1,50,1,50,0.916213000,0.0000
108.134.108.77:34000,<->,106.157.38.242:33959,1,50,0,0,1,50,0.916171000,0.0000
106.157.38.242:33959,<->,108.134.108.77:5318,0,0,1,50,1,50,0.916054000,0.0000
247.136.165.38:57891,<->,119.77.92.156:15920,1,138,0,0,1,138,0.916031000,0.0000
106.157.38.242:33959,<->,108.134.108.77:21742,0,0,1,50,1,50,0.915894000,0.0000
106.157.38.242:33959,<->,108.134.108.77:25358,0,0,1,50,1,50,0.915872000,0.0000
144.75.218.235:5749,<->,8.222.218.198:domain,1,109,0,0,1,109,0.915767000,0.0000
106.157.38.242:33959,<->,108.134.108.77:32252,0,0,1,50,1,50,0.915677000,0.0000
144.75.218.235:7102,<->,8.222.218.198:domain,1,123,0,0,1,123,0.915604000,0.0000
108.134.108.77:34380,<->,106.157.38.242:33959,1,50,0,0,1,50,0.914610000,0.0000
144.75.218.241:43566,<->,8.222.218.207:domain,1,111,0,0,1,111,0.914287000,0.0000
108.134.108.77:40604,<->,106.157.38.242:33959,1,50,0,0,1,50,0.913886000,0.0000
106.157.38.242:33959,<->,108.134.108.77:21036,0,0,1,50,1,50,0.913310000,0.0000
20.135.180.25:51599,<->,38.227.130.5:domain,1,68,0,0,1,68,0.913118000,0.0000
108.134.108.77:44671,<->,106.157.38.242:33959,1,50,0,0,1,50,0.912888000,0.0000
108.134.108.77:61813,<->,106.157.38.242:33959,1,50,0,0,1,50,0.912865000,0.0000
106.157.38.242:33959,<->,108.134.108.77:29237,0,0,1,50,1,50,0.912841000,0.0000
144.93.121.10:57133,<->,144.93.125.49:45333,1,104,0,0,1,104,0.912777000,0.0000
144.75.218.233:cctv-port,<->,138.127.225.255:domain,1,553,0,0,1,553,0.912574000,0.0000
144.75.218.246:25636,<->,8.222.218.204:domain,1,110,0,0,1,110,0.912138000,0.0000
108.134.108.77:37817,<->,106.157.38.242:33959,1,50,0,0,1,50,0.912035000,0.0000
106.157.38.242:33959,<->,108.134.108.77:32663,0,0,1,50,1,50,0.912001000,0.0000
144.75.218.242:35591,<->,8.222.218.199:domain,1,110,0,0,1,110,0.911863000,0.0000
132.249.70.233:58480,<->,53.201.149.31:domain,1,86,0,0,1,86,0.911771000,0.0000
108.134.108.77:41679,<->,106.157.38.242:33959,1,50,0,0,1,50,0.911730000,0.0000
144.75.218.235:8314,<->,8.222.218.197:domain,1,110,0,0,1,110,0.911572000,0.0000
106.157.38.242:33959,<->,108.134.108.77:17055,0,0,1,50,1,50,0.911434000,0.0000
144.108.80.170:49985,<->,159.69.187.6:domain,0,0,1,67,1,67,0.910789000,0.0000
108.134.108.77:41247,<->,106.157.38.242:33959,1,50,0,0,1,50,0.910783000,0.0000
108.134.108.77:60139,<->,106.157.38.242:33959,1,50,0,0,1,50,0.910494000,0.0000
8.176.8.195:36011,<->,111.151.107.247:domain,1,109,0,0,1,109,0.910484000,0.0000
207.20.140.168:4285,<->,129.224.112.252:domain,0,0,1,74,1,74,0.910057000,0.0000
144.108.64.179:34345,<->,144.122.240.239:domain,0,0,1,71,1,71,0.909595000,0.0000
144.75.218.246:33251,<->,8.222.218.204:domain,1,155,0,0,1,155,0.909487000,0.0000
20.4.216.75:64924,<->,33.122.93.211:domain,1,70,0,0,1,70,0.909421000,0.0000
21.15.226.126:55104,<->,20.193.59.231:netbios-ns,0,0,1,82,1,82,0.907632000,0.0000
100.93.121.49:47905,<->,27.2.218.0:21519,1,141,0,0,1,141,0.907570000,0.0000
144.75.218.241:21330,<->,8.222.218.207:domain,1,110,0,0,1,110,0.907156000,0.0000
109.14.213.84:13308,<->,80.56.78.208:domain,0,0,1,76,1,76,0.906991000,0.0000
144.76.43.246:29935,<->,80.56.78.128:domain,0,0,1,96,1,96,0.906443000,0.0000
144.75.218.233:23496,<->,8.222.218.204:domain,1,109,0,0,1,109,0.906229000,0.0000
129.236.115.172:16737,<->,98.236.245.223:domain,0,0,1,81,1,81,0.906042000,0.0000
192.64.114.92:64059,<->,119.33.213.28:6886,1,74,0,0,1,74,0.905553000,0.0000
92.27.52.56:33512,<->,35.56.99.192:snmp,0,0,1,83,1,83,0.904921000,0.0000
21.15.226.126:55104,<->,20.193.59.225:netbios-ns,0,0,1,82,1,82,0.904832000,0.0000
144.75.218.242:40016,<->,8.222.218.199:domain,1,122,0,0,1,122,0.904220000,0.0000
144.75.218.242:42156,<->,138.127.225.198:domain,1,289,0,0,1,289,0.904043000,0.0000
100.93.18.30:srdp,<->,144.76.46.38:domain,1,130,0,0,1,130,0.903496000,0.0000
66.245.95.147:45246,<->,80.41.21.72:26956,0,0,1,135,1,135,0.903421000,0.0000
97.242.126.192:32098,<->,129.224.112.252:domain,0,0,1,79,1,79,0.902103000,0.0000
92.162.219.24:18023,<->,129.224.112.252:domain,0,0,1,75,1,75,0.901477000,0.0000
144.75.218.242:unisql,<->,8.222.218.196:domain,1,113,0,0,1,113,0.900682000,0.0000
80.42.173.192:64590,<->,121.235.141.249:teredo,1,141,0,0,1,141,0.900482000,0.0000
27.188.163.162:i-net-2000-npr,<->,109.1.16.221:sip,0,0,1,444,1,444,0.899235000,0.0000
66.26.4.171:19395,<->,222.76.103.168:domain,0,0,1,73,1,73,0.898710000,0.0000
221.95.55.203:45781,<->,77.16.192.127:16962,1,94,0,0,1,94,0.898429000,0.0000
215.158.103.206:33590,<->,129.223.93.3:domain,1,636,0,0,1,636,0.897997000,0.0000
215.158.103.206:9611,<->,119.159.23.44:domain,1,83,0,0,1,83,0.897983000,0.0000
106.248.210.12:56690,<->,101.224.186.79:25445,0,0,1,57,1,57,0.896800000,0.0000
223.138.247.86:63479,<->,92.27.219.165:62225,0,0,1,52,1,52,0.896663000,0.0000
144.75.218.242:7684,<->,138.57.179.198:domain,1,102,0,0,1,102,0.895987000,0.0000
215.158.239.103:55907,<->,8.50.118.106:domain,1,111,0,0,1,111,0.895749000,0.0000
144.76.43.242:micromuse-ncps,<->,80.56.78.128:domain,0,0,1,100,1,100,0.894808000,0.0000
144.75.218.242:19858,<->,8.222.218.204:domain,1,114,0,0,1,114,0.894626000,0.0000
19.249.77.2:55353,<->,144.93.134.237:domain,0,0,1,76,1,76,0.894619000,0.0000
104.77.185.182:6881,<->,109.222.243.255:vlsi-lm,0,0,1,97,1,97,0.894460000,0.0000
92.27.219.175:50646,<->,103.56.162.76:10459,1,52,0,0,1,52,0.894282000,0.0000
66.11.15.28:50155,<->,74.17.214.117:panagolin-ident,1,130,0,0,1,130,0.894141000,0.0000
144.75.218.246:46674,<->,8.222.218.197:domain,1,110,0,0,1,110,0.893963000,0.0000
144.75.218.237:46048,<->,8.222.218.204:domain,1,126,0,0,1,126,0.893592000,0.0000
21.15.226.126:55104,<->,20.193.59.219:netbios-ns,0,0,1,82,1,82,0.893506000,0.0000
144.75.218.246:49122,<->,8.222.218.199:domain,1,153,0,0,1,153,0.893448000,0.0000
144.75.218.246:39722,<->,8.222.218.199:domain,1,122,0,0,1,122,0.893287000,0.0000
122.111.197.164:52924,<->,192.67.138.66:51271,0,0,1,209,1,209,0.892620000,0.0000
131.144.248.196:41230,<->,129.224.112.252:domain,0,0,1,79,1,79,0.891865000,0.0000
144.75.218.246:39907,<->,8.222.218.197:domain,1,110,0,0,1,110,0.891727000,0.0000
99.160.127.69:6881,<->,92.27.219.138:6457,0,0,1,330,1,330,0.891294000,0.0000
144.75.218.246:43115,<->,8.222.218.197:domain,1,111,0,0,1,111,0.890667000,0.0000
144.75.218.242:44483,<->,8.4.159.141:domain,1,130,0,0,1,130,0.890621000,0.0000
144.75.218.246:22172,<->,8.222.218.204:domain,1,181,0,0,1,181,0.889925000,0.0000
144.108.64.179:50525,<->,159.69.187.8:domain,0,0,1,72,1,72,0.889592000,0.0000
133.73.8.230:61400,<->,215.158.239.74:domain,0,0,1,84,1,84,0.889573000,0.0000
137.194.170.5:56083,<->,129.78.116.244:domain,0,0,1,84,1,84,0.889505000,0.0000
144.75.218.237:46295,<->,8.222.218.199:domain,1,111,0,0,1,111,0.888821000,0.0000
129.34.149.207:56102,<->,145.242.126.212:domain,0,0,1,84,1,84,0.888094000,0.0000
144.75.218.242:21824,<->,8.222.218.204:domain,1,122,0,0,1,122,0.887276000,0.0000
144.75.218.235:22379,<->,212.118.0.79:domain,1,91,0,0,1,91,0.887099000,0.0000
111.73.148.160:24152,<->,80.40.57.96:17773,0,0,1,213,1,213,0.887030000,0.0000
20.212.190.189:50821,<->,120.178.130.146:domain,1,75,0,0,1,75,0.886787000,0.0000
144.75.218.246:41001,<->,8.222.218.204:domain,1,122,0,0,1,122,0.886679000,0.0000
144.75.218.235:5209,<->,8.222.218.204:domain,1,110,0,0,1,110,0.886676000,0.0000
144.75.218.242:6204,<->,8.222.218.199:domain,1,141,0,0,1,141,0.886394000,0.0000
53.250.138.165:20528,<->,39.15.169.14:domain,0,0,1,86,1,86,0.886182000,0.0000
130.196.240.215:24157,<->,89.183.104.135:6881,0,0,1,52,1,52,0.885049000,0.0000
144.75.218.241:32720,<->,66.90.38.226:domain,1,159,0,0,1,159,0.884526000,0.0000
143.252.64.224:57362,<->,129.224.112.252:domain,0,0,1,62,1,62,0.884524000,0.0000
88.13.7.38:63050,<->,247.136.150.11:3283,0,0,1,55,1,55,0.884247000,0.0000
39.35.177.63:34606,<->,145.129.253.82:domain,1,86,0,0,1,86,0.883979000,0.0000
125.16.223.239:34384,<->,192.64.217.166:14773,0,0,1,52,1,52,0.883752000,0.0000
144.75.218.235:34497,<->,138.127.225.146:domain,1,276,0,0,1,276,0.883449000,0.0000
6.228.6.58:53781,<->,215.158.132.144:domain,1,102,0,0,1,102,0.883296000,0.0000
144.75.218.235:64617,<->,139.252.1.253:domain,1,148,0,0,1,148,0.883014000,0.0000
21.15.226.126:55104,<->,20.193.59.83:netbios-ns,0,0,1,82,1,82,0.882785000,0.0000
248.225.26.243:62746,<->,100.185.121.91:domain,1,236,0,0,1,236,0.882702000,0.0000
144.75.218.241:37303,<->,6.73.13.34:domain,1,288,0,0,1,288,0.882326000,0.0000
144.75.218.233:must-backplane,<->,8.222.218.197:domain,1,125,0,0,1,125,0.882132000,0.0000
144.75.218.242:44936,<->,224.213.241.201:domain,1,336,0,0,1,336,0.881757000,0.0000
33.98.46.95:21508,<->,144.69.82.139:domain,0,0,1,73,1,73,0.881623000,0.0000
20.237.75.42:53615,<->,82.246.87.234:domain,1,91,0,0,1,91,0.881303000,0.0000
27.188.163.162:i-net-2000-npr,<->,109.1.17.6:sip,0,0,1,446,1,446,0.881130000,0.0000
136.25.188.105:38678,<->,98.114.18.76:domain,1,140,0,0,1,140,0.881104000,0.0000
136.41.13.4:56132,<->,251.122.146.57:ipsec-nat-t,1,116,0,0,1,116,0.880813000,0.0000
136.25.188.105:65261,<->,148.215.222.173:domain,1,143,0,0,1,143,0.880573000,0.0000
20.246.199.217:ncadg-ip-udp,<->,56.20.54.141:domain,1,91,0,0,1,91,0.880440000,0.0000
144.75.218.237:27640,<->,8.222.218.197:domain,1,110,0,0,1,110,0.879454000,0.0000
144.75.218.241:5143,<->,8.222.218.207:domain,1,123,0,0,1,123,0.879411000,0.0000
144.75.218.241:44395,<->,97.94.119.43:domain,1,72,0,0,1,72,0.879354000,0.0000
89.77.198.191:36769,<->,133.178.227.214:9043,0,0,1,156,1,156,0.879326000,0.0000
100.92.64.28:52104,<->,144.76.46.38:domain,1,168,0,0,1,168,0.879237000,0.0000
144.75.218.233:7729,<->,138.127.224.104:domain,1,307,0,0,1,307,0.878407000,0.0000
102.51.41.126:56969,<->,207.204.114.71:28302,1,135,0,0,1,135,0.878387000,0.0000
4.187.50.170:20258,<->,144.86.144.4:domain,0,0,1,80,1,80,0.877823000,0.0000
215.158.103.219:5316,<->,92.57.203.43:domain,1,154,0,0,1,154,0.877656000,0.0000
136.25.188.105:55742,<->,140.136.9.105:domain,1,231,0,0,1,231,0.877630000,0.0000
110.65.132.226:38109,<->,92.27.219.189:6881,0,0,1,325,1,325,0.877621000,0.0000
21.15.226.126:55104,<->,20.193.59.179:netbios-ns,0,0,1,82,1,82,0.877525000,0.0000
144.75.218.246:28915,<->,8.222.218.197:domain,1,158,0,0,1,158,0.876862000,0.0000
195.3.157.139:36561,<->,39.15.169.14:domain,0,0,1,86,1,86,0.876849000,0.0000
18.69.22.36:58700,<->,109.222.250.222:domain,0,0,1,74,1,74,0.876525000,0.0000
39.18.45.147:11191,<->,130.13.216.49:domain,1,80,0,0,1,80,0.876274000,0.0000
144.75.218.233:35031,<->,8.222.218.196:domain,1,124,0,0,1,124,0.875605000,0.0000
144.75.218.242:25520,<->,8.222.218.207:domain,1,113,0,0,1,113,0.875469000,0.0000
133.32.2.38:53156,<->,138.127.229.13:domain,1,240,0,0,1,240,0.875253000,0.0000
131.133.154.154:34680,<->,133.171.115.67:domain,0,0,1,84,1,84,0.875098000,0.0000
136.25.188.105:55449,<->,132.5.71.202:domain,1,244,0,0,1,244,0.874486000,0.0000
210.158.44.231:50207,<->,109.119.182.216:domain,1,119,0,0,1,119,0.873868000,0.0000
100.93.81.9:42009,<->,195.59.215.206:23186,1,130,0,0,1,130,0.873765000,0.0000
144.75.218.242:62720,<->,8.222.218.199:domain,1,138,0,0,1,138,0.873700000,0.0000
110.5.186.21:50867,<->,109.222.218.217:domain,0,0,1,80,1,80,0.873645000,0.0000
144.75.218.242:25928,<->,8.222.218.204:domain,1,125,0,0,1,125,0.872867000,0.0000
18.203.228.30:44963,<->,89.183.104.243:18078,0,0,1,1456,1,1456,0.872349000,0.0000
144.75.218.235:11326,<->,8.222.218.204:domain,1,110,0,0,1,110,0.872053000,0.0000
117.220.20.168:td-postman,<->,108.134.118.71:domain,0,0,1,60,1,60,0.871557000,0.0000
53.150.231.79:60526,<->,246.253.248.211:domain,0,0,1,89,1,89,0.871457000,0.0000
144.108.80.170:44853,<->,144.122.240.200:domain,0,0,1,74,1,74,0.870900000,0.0000
215.158.238.85:46640,<->,141.204.127.17:domain,1,772,0,0,1,772,0.869915000,0.0000
20.151.73.24:21436,<->,58.46.203.2:domain,1,76,0,0,1,76,0.869761000,0.0000
74.252.52.17:43450,<->,192.67.161.146:28715,0,0,1,77,1,77,0.869213000,0.0000
113.207.254.105:49233,<->,247.136.236.50:41611,0,0,1,280,1,280,0.868652000,0.0000
192.64.250.118:64672,<->,112.90.36.143:53658,1,279,0,0,1,279,0.868024000,0.0000
21.15.226.126:55104,<->,20.193.59.5:netbios-ns,0,0,1,82,1,82,0.867497000,0.0000
38.21.156.204:56633,<->,20.232.228.55:netbios-ns,0,0,1,82,1,82,0.866738000,0.0000
136.25.188.105:59791,<->,135.88.171.34:domain,1,286,0,0,1,286,0.866574000,0.0000
144.75.218.235:28048,<->,129.188.130.3:domain,1,80,0,0,1,80,0.866505000,0.0000
109.121.177.146:21215,<->,69.171.220.179:17961,1,133,0,0,1,133,0.866378000,0.0000
144.76.43.242:24885,<->,80.56.78.128:domain,0,0,1,104,1,104,0.865027000,0.0000
20.151.228.71:59686,<->,141.203.81.200:domain,1,75,0,0,1,75,0.864744000,0.0000
33.57.74.181:29942,<->,220.55.75.166:domain,0,0,1,75,1,75,0.864669000,0.0000
20.146.20.10:25273,<->,148.74.255.93:domain,1,70,0,0,1,70,0.864367000,0.0000
144.108.80.170:14311,<->,144.122.240.204:domain,0,0,1,72,1,72,0.863786000,0.0000
132.51.6.250:13464,<->,22.34.2.52:5199,1,186,0,0,1,186,0.863690000,0.0000
35.56.102.252:55101,<->,148.162.54.31:53609,1,138,0,0,1,138,0.863682000,0.0000
33.57.77.143:56041,<->,92.27.219.18:54884,0,0,1,52,1,52,0.863664000,0.0000
133.178.226.254:52807,<->,210.104.195.137:domain,1,90,0,0,1,90,0.863439000,0.0000
109.222.250.37:55574,<->,8.232.74.206:traceroute,1,296,0,0,1,296,0.863256000,0.0000
105.115.183.34:38173,<->,100.93.179.222:15416,0,0,1,106,1,106,0.863114000,0.0000
109.222.230.12:59385,<->,192.171.13.188:domain,1,98,0,0,1,98,0.863032000,0.0000
144.75.218.237:57597,<->,8.222.218.204:domain,1,123,0,0,1,123,0.862711000,0.0000
144.75.218.242:13765,<->,8.222.218.204:domain,1,123,0,0,1,123,0.862643000,0.0000
144.75.218.237:60992,<->,138.127.230.158:domain,1,202,0,0,1,202,0.862627000,0.0000
39.26.64.156:27878,<->,154.151.15.59:24953,1,52,0,0,1,52,0.862543000,0.0000
230.63.142.3:13074,<->,91.251.82.156:12859,0,0,1,130,1,130,0.862293000,0.0000
159.64.148.27:47178,<->,29.211.214.82:domain,0,0,1,89,1,89,0.861368000,0.0000
122.34.93.206:60475,<->,89.183.104.135:6881,0,0,1,52,1,52,0.861312000,0.0000
144.75.218.242:56614,<->,8.222.218.204:domain,1,110,0,0,1,110,0.860499000,0.0000
144.75.218.246:8933,<->,8.222.218.199:domain,1,110,0,0,1,110,0.860093000,0.0000
227.23.98.210:40011,<->,89.183.104.150:6906,0,0,1,52,1,52,0.860078000,0.0000
144.75.222.203:30349,<->,144.69.82.139:domain,0,0,1,74,1,74,0.860053000,0.0000
144.75.218.246:20917,<->,159.176.32.29:domain,1,76,0,0,1,76,0.859532000,0.0000
111.154.13.141:32894,<->,109.222.255.85:domain,0,0,1,78,1,78,0.859318000,0.0000
144.108.80.170:64252,<->,159.69.187.19:domain,0,0,1,73,1,73,0.859196000,0.0000
144.75.218.241:36847,<->,8.222.218.207:domain,1,111,0,0,1,111,0.859189000,0.0000
136.25.188.105:53311,<->,140.136.9.105:domain,1,140,0,0,1,140,0.858617000,0.0000
106.157.38.242:37294,<->,108.134.108.77:9420,0,0,1,50,1,50,0.858171000,0.0000
144.75.218.242:32862,<->,132.156.82.239:domain,1,156,0,0,1,156,0.857628000,0.0000
108.134.108.77:59891,<->,106.157.38.242:37294,1,50,0,0,1,50,0.857426000,0.0000
144.75.218.241:41587,<->,138.127.224.140:domain,1,365,0,0,1,365,0.857374000,0.0000
106.157.38.242:37294,<->,108.134.108.77:36950,0,0,1,50,1,50,0.857324000,0.0000
144.75.218.242:60721,<->,8.222.218.199:domain,1,110,0,0,1,110,0.857213000,0.0000
116.173.88.56:21610,<->,132.168.198.210:domain,0,0,1,72,1,72,0.856981000,0.0000
97.126.26.70:36597,<->,138.127.231.62:domain,1,282,0,0,1,282,0.856774000,0.0000
144.75.218.241:65102,<->,138.127.230.136:domain,1,366,0,0,1,366,0.856635000,0.0000
91.54.155.124:52988,<->,132.249.70.233:domain,0,0,1,78,1,78,0.856497000,0.0000
144.75.218.242:31387,<->,132.43.156.81:domain,1,154,0,0,1,154,0.856406000,0.0000
144.75.218.235:47523,<->,8.222.218.198:domain,1,181,0,0,1,181,0.856345000,0.0000
0.200.50.50:34233,<->,20.13.109.215:domain,0,0,1,60,1,60,0.856336000,0.0000
144.75.218.235:21056,<->,8.222.218.197:domain,1,111,0,0,1,111,0.856276000,0.0000
108.134.108.77:61499,<->,106.157.38.242:37294,1,50,0,0,1,50,0.856076000,0.0000
108.134.108.77:63154,<->,106.157.38.242:37294,1,50,0,0,1,50,0.856073000,0.0000
192.64.196.112:37099,<->,119.219.188.63:cdn,1,52,0,0,1,52,0.855985000,0.0000
144.75.218.237:28769,<->,53.245.2.193:domain,1,110,0,0,1,110,0.855571000,0.0000
144.75.218.233:41270,<->,138.127.230.12:domain,1,186,0,0,1,186,0.855276000,0.0000
106.157.38.242:37294,<->,108.134.108.77:27047,0,0,1,50,1,50,0.854973000,0.0000
106.157.38.242:37294,<->,108.134.108.77:rap-listen,0,0,1,50,1,50,0.854920000,0.0000
144.75.218.233:31110,<->,108.134.82.93:domain,1,206,0,0,1,206,0.854228000,0.0000
144.75.218.242:35500,<->,8.222.218.199:domain,1,110,0,0,1,110,0.854202000,0.0000
39.134.146.48:55212,<->,198.70.220.74:domain,1,72,0,0,1,72,0.854053000,0.0000
80.42.179.209:51413,<->,122.145.210.242:8621,1,133,0,0,1,133,0.853892000,0.0000
39.12.84.160:63074,<->,124.69.27.27:domain,1,74,0,0,1,74,0.853679000,0.0000
144.75.218.242:madcap,<->,8.222.218.199:domain,1,113,0,0,1,113,0.853552000,0.0000
114.187.51.237:20555,<->,129.224.112.252:domain,0,0,1,72,1,72,0.853364000,0.0000
108.134.108.77:54846,<->,106.157.38.242:37294,1,50,0,0,1,50,0.853317000,0.0000
247.136.154.209:57619,<->,38.173.226.37:39181,1,52,0,0,1,52,0.852862000,0.0000
222.62.219.94:61255,<->,48.53.227.245:28162,0,0,1,321,1,321,0.852850000,0.0000
144.75.218.242:24915,<->,8.222.218.199:domain,1,122,0,0,1,122,0.852450000,0.0000
136.25.188.105:50494,<->,135.88.171.34:domain,1,252,0,0,1,252,0.852074000,0.0000
144.75.218.241:9148,<->,8.222.218.204:domain,1,114,0,0,1,114,0.851931000,0.0000
144.75.218.237:13351,<->,8.222.218.198:domain,1,109,0,0,1,109,0.851587000,0.0000
92.27.219.33:55260,<->,235.231.66.42:29082,1,351,0,0,1,351,0.851488000,0.0000
106.157.38.242:37294,<->,108.134.108.77:11741,0,0,1,50,1,50,0.851347000,0.0000
108.134.108.77:59669,<->,106.157.38.242:37294,1,50,0,0,1,50,0.851346000,0.0000
108.134.108.77:54008,<->,106.157.38.242:37294,1,50,0,0,1,50,0.850997000,0.0000
106.157.38.242:37294,<->,108.134.108.77:17059,0,0,1,50,1,50,0.850952000,0.0000
144.75.218.237:26318,<->,8.222.218.207:domain,1,149,0,0,1,149,0.850298000,0.0000
144.75.218.233:jeol-nsddp-1,<->,222.254.150.132:domain,1,128,0,0,1,128,0.849924000,0.0000
144.75.218.246:10611,<->,136.144.124.253:domain,1,77,0,0,1,77,0.849681000,0.0000
21.15.226.126:55104,<->,20.193.59.46:netbios-ns,0,0,1,82,1,82,0.848657000,0.0000
144.75.218.237:21302,<->,102.45.225.190:domain,1,85,0,0,1,85,0.848203000,0.0000
144.75.218.241:20112,<->,120.155.84.97:domain,1,145,0,0,1,145,0.847973000,0.0000
144.75.218.233:23051,<->,141.37.226.86:domain,1,88,0,0,1,88,0.847126000,0.0000
93.90.89.141:19532,<->,80.40.45.77:6882,0,0,1,52,1,52,0.847058000,0.0000
112.75.196.109:23385,<->,92.27.219.43:18107,0,0,1,325,1,325,0.846815000,0.0000
144.75.218.242:57085,<->,8.222.218.207:domain,1,123,0,0,1,123,0.846554000,0.0000
144.75.218.241:35347,<->,8.222.218.196:domain,1,110,0,0,1,110,0.846271000,0.0000
144.75.218.241:11513,<->,8.222.218.207:domain,1,113,0,0,1,113,0.845946000,0.0000
144.75.218.241:16985,<->,8.222.218.207:domain,1,110,0,0,1,110,0.845796000,0.0000
144.75.218.233:intrepid-ssl,<->,138.127.230.53:domain,1,365,0,0,1,365,0.845649000,0.0000
121.36.34.191:22956,<->,92.27.219.171:10159,0,0,1,135,1,135,0.845173000,0.0000
136.25.188.105:55792,<->,140.136.9.105:domain,1,233,0,0,1,233,0.844964000,0.0000
138.23.113.45:12436,<->,78.128.203.59:domain,1,151,0,0,1,151,0.844349000,0.0000
144.75.218.237:37221,<->,8.222.218.197:domain,1,173,0,0,1,173,0.844217000,0.0000
115.85.241.227:39828,<->,0.195.210.15:stun,0,0,1,158,1,158,0.843955000,0.0000
136.25.188.105:56656,<->,132.5.71.202:domain,1,191,0,0,1,191,0.843844000,0.0000
:::43403,<->,:::domain,0,0,1,69,1,69,0.843730000,0.0000
97.126.26.71:22340,<->,138.127.231.249:domain,1,282,0,0,1,282,0.843000000,0.0000
144.108.64.179:40431,<->,144.122.240.213:domain,0,0,1,70,1,70,0.842923000,0.0000
108.134.108.77:55226,<->,106.157.38.242:37294,1,50,0,0,1,50,0.842640000,0.0000
144.75.218.246:49991,<->,8.222.218.204:domain,1,109,0,0,1,109,0.842623000,0.0000
215.158.103.206:41303,<->,138.127.230.24:domain,1,259,0,0,1,259,0.842225000,0.0000
104.140.75.204:45480,<->,136.181.53.35:6881,0,0,1,135,1,135,0.841924000,0.0000
144.75.218.241:itv-control,<->,132.43.156.56:domain,1,151,0,0,1,151,0.841628000,0.0000
144.75.218.233:7242,<->,8.222.218.196:domain,1,111,0,0,1,111,0.841268000,0.0000
91.206.247.51:52504,<->,56.121.46.220:domain,0,0,1,68,1,68,0.840941000,0.0000
98.128.233.83:36211,<->,64.146.18.101:20398,1,130,0,0,1,130,0.840794000,0.0000
192.67.152.0:62617,<->,38.170.162.131:22029,1,52,0,0,1,52,0.839716000,0.0000
109.222.250.219:26471,<->,99.237.92.17:18745,1,341,0,0,1,341,0.839545000,0.0000
215.158.103.206:48468,<->,138.127.230.221:domain,1,84,0,0,1,84,0.839394000,0.0000
144.75.221.206:28508,<->,145.242.126.85:domain,0,0,1,81,1,81,0.839181000,0.0000
144.75.218.246:38420,<->,8.222.218.204:domain,1,110,0,0,1,110,0.839059000,0.0000
220.55.101.100:52745,<->,128.203.247.101:domain,1,76,0,0,1,76,0.838751000,0.0000
97.243.223.84:33325,<->,6.75.250.3:27030,0,0,1,193,1,193,0.838502000,0.0000
113.129.159.40:27519,<->,89.183.104.132:16144,0,0,1,52,1,52,0.838310000,0.0000
144.75.218.241:41937,<->,8.222.218.204:domain,1,114,0,0,1,114,0.837883000,0.0000
80.38.56.151:45838,<->,132.43.156.54:domain,1,801,0,0,1,801,0.837425000,0.0000
144.108.64.183:omstopology,<->,144.122.240.201:domain,0,0,1,63,1,63,0.836541000,0.0000
144.108.80.170:56618,<->,144.122.240.197:domain,0,0,1,72,1,72,0.836109000,0.0000
144.75.218.233:38236,<->,8.222.218.204:domain,1,110,0,0,1,110,0.835801000,0.0000
144.75.218.246:27502,<->,8.222.218.197:domain,1,122,0,0,1,122,0.835612000,0.0000
144.75.218.233:6979,<->,8.222.218.196:domain,1,121,0,0,1,121,0.835582000,0.0000
144.75.218.237:29107,<->,138.127.224.104:domain,1,327,0,0,1,327,0.835580000,0.0000
99.227.90.140:43939,<->,92.27.27.161:4699,0,0,1,52,1,52,0.835578000,0.0000
144.108.64.179:sun-lm,<->,159.69.187.50:domain,0,0,1,77,1,77,0.835014000,0.0000
144.75.218.242:61876,<->,97.68.93.9:domain,1,707,0,0,1,707,0.834017000,0.0000
144.75.218.233:37581,<->,8.222.218.204:domain,1,109,0,0,1,109,0.833713000,0.0000
117.206.109.192:63629,<->,89.183.104.141:19370,0,0,1,62,1,62,0.832871000,0.0000
144.75.218.233:63770,<->,8.222.218.204:domain,1,175,0,0,1,175,0.832739000,0.0000
88.45.148.185:44822,<->,80.40.56.209:sunproxyadmin,0,0,1,135,1,135,0.832530000,0.0000
21.15.226.126:55104,<->,20.193.60.101:netbios-ns,0,0,1,82,1,82,0.832396000,0.0000
159.251.74.73:62728,<->,136.25.188.72:12347,0,0,1,1064,1,1064,0.832350000,0.0000
:::48690,<->,:::domain,1,717,0,0,1,717,0.831728000,0.0000
126.229.209.161:6569,<->,132.168.196.227:domain,0,0,1,77,1,77,0.831704000,0.0000
215.158.239.117:40347,<->,231.255.157.46:domain,1,100,0,0,1,100,0.831219000,0.0000
144.75.218.242:55989,<->,8.222.218.207:domain,1,124,0,0,1,124,0.830890000,0.0000
20.55.0.110:26991,<->,148.247.194.50:domain,1,135,0,0,1,135,0.830810000,0.0000
215.158.30.32:64835,<->,29.211.214.254:domain,0,0,1,94,1,94,0.830324000,0.0000
144.108.80.170:11101,<->,159.69.187.49:domain,0,0,1,78,1,78,0.830134000,0.0000
144.75.218.235:11374,<->,138.127.224.104:domain,1,305,0,0,1,305,0.829832000,0.0000
6.122.154.156:49793,<->,198.231.232.65:40091,1,52,0,0,1,52,0.829816000,0.0000
144.108.80.170:18853,<->,159.69.187.42:domain,0,0,1,71,1,71,0.829734000,0.0000
20.105.243.223:37704,<->,113.177.30.121:domain,1,78,0,0,1,78,0.829632000,0.0000
38.21.156.204:56633,<->,20.232.228.154:netbios-ns,0,0,1,82,1,82,0.829393000,0.0000
144.75.218.237:65357,<->,8.222.218.197:domain,1,122,0,0,1,122,0.828628000,0.0000
109.1.46.25:46701,<->,115.172.108.243:6881,1,97,0,0,1,97,0.828163000,0.0000
206.195.198.162:6881,<->,102.50.194.26:6881,0,0,1,309,1,309,0.828035000,0.0000
89.183.108.143:54319,<->,117.22.133.81:blackjack,1,133,0,0,1,133,0.827857000,0.0000
27.188.163.162:i-net-2000-npr,<->,109.1.17.10:sip,0,0,1,446,1,446,0.827695000,0.0000
159.194.43.140:62432,<->,48.54.33.224:49930,0,0,1,133,1,133,0.827650000,0.0000
80.12.152.248:50590,<->,109.222.249.16:domain,0,0,1,78,1,78,0.827593000,0.0000
217.11.189.9:7756,<->,35.32.8.129:authentx,0,0,1,439,1,439,0.827522000,0.0000
136.25.188.105:63062,<->,128.243.151.35:domain,1,128,0,0,1,128,0.827475000,0.0000
210.156.156.214:29784,<->,74.239.244.43:14760,1,130,0,0,1,130,0.826913000,0.0000
89.183.104.151:24338,<->,123.123.221.21:1024,1,52,0,0,1,52,0.826464000,0.0000
220.83.21.43:19170,<->,230.49.174.178:17864,1,130,0,0,1,130,0.826185000,0.0000
97.242.126.192:16941,<->,129.224.112.252:domain,0,0,1,89,1,89,0.825629000,0.0000
42.233.156.138:19362,<->,109.222.250.16:domain,0,0,1,70,1,70,0.824857000,0.0000
97.168.105.154:59929,<->,118.38.145.3:10501,1,1470,0,0,1,1470,0.824008000,0.0000
144.75.218.233:10026,<->,8.222.218.196:domain,1,110,0,0,1,110,0.823703000,0.0000
97.242.126.203:59742,<->,129.224.112.252:domain,0,0,1,83,1,83,0.823160000,0.0000
144.75.218.235:55289,<->,8.222.218.204:domain,1,113,0,0,1,113,0.822880000,0.0000
20.242.183.249:52297,<->,42.146.133.4:domain,1,76,0,0,1,76,0.822121000,0.0000
144.75.218.246:6310,<->,138.127.224.105:domain,1,366,0,0,1,366,0.822060000,0.0000
192.67.183.227:51216,<->,128.180.33.172:19928,1,52,0,0,1,52,0.821763000,0.0000
144.75.218.241:27997,<->,138.127.225.8:domain,1,366,0,0,1,366,0.821491000,0.0000
144.75.218.242:38795,<->,97.110.148.11:domain,1,138,0,0,1,138,0.821490000,0.0000
92.27.27.186:57102,<->,140.91.154.183:52155,1,135,0,0,1,135,0.820953000,0.0000
144.75.218.233:47291,<->,132.200.124.228:domain,1,165,0,0,1,165,0.820713000,0.0000
144.75.218.237:35964,<->,120.155.84.97:domain,1,140,0,0,1,140,0.820104000,0.0000
106.248.210.12:56690,<->,92.27.209.159:25455,0,0,1,57,1,57,0.819983000,0.0000
92.62.110.238:65276,<->,247.136.211.104:58589,0,0,1,84,1,84,0.818985000,0.0000
106.248.210.12:56690,<->,92.27.26.178:25445,0,0,1,57,1,57,0.818798000,0.0000
144.75.218.233:22623,<->,8.222.218.197:domain,1,122,0,0,1,122,0.818409000,0.0000
144.108.80.170:8325,<->,159.69.187.16:domain,0,0,1,68,1,68,0.816828000,0.0000
21.15.226.126:55104,<->,20.193.60.141:netbios-ns,0,0,1,82,1,82,0.816000000,0.0000
8.176.8.97:62448,<->,120.155.86.33:domain,1,111,0,0,1,111,0.815747000,0.0000
65.180.180.196:42155,<->,50.224.96.136:domain,0,0,1,76,1,76,0.815442000,0.0000
136.25.188.105:49749,<->,130.28.164.201:domain,1,139,0,0,1,139,0.814962000,0.0000
144.75.218.246:9703,<->,139.252.1.230:domain,1,90,0,0,1,90,0.814859000,0.0000
144.75.218.233:61002,<->,128.8.18.241:domain,1,298,0,0,1,298,0.814567000,0.0000
88.0.112.42:33261,<->,92.27.219.50:29468,0,0,1,52,1,52,0.813972000,0.0000
148.205.108.81:49393,<->,80.42.154.197:6881,0,0,1,79,1,79,0.813613000,0.0000
144.75.218.237:7464,<->,8.222.218.204:domain,1,126,0,0,1,126,0.813591000,0.0000
128.163.57.179:60907,<->,109.1.44.191:16465,0,0,1,50,1,50,0.813364000,0.0000
136.181.53.150:62348,<->,127.200.10.57:14163,1,149,0,0,1,149,0.812599000,0.0000
92.27.27.99:44737,<->,88.4.164.151:15164,1,52,0,0,1,52,0.812172000,0.0000
92.162.219.175:57405,<->,129.224.112.252:domain,0,0,1,73,1,73,0.812111000,0.0000
98.57.209.158:13236,<->,145.242.126.212:domain,0,0,1,78,1,78,0.811890000,0.0000
89.183.104.168:23853,<->,126.138.59.22:10994,1,263,0,0,1,263,0.811848000,0.0000
144.75.218.242:43806,<->,8.222.218.199:domain,1,110,0,0,1,110,0.811698000,0.0000
144.75.218.233:14697,<->,8.222.218.204:domain,1,111,0,0,1,111,0.811428000,0.0000
144.75.218.237:58555,<->,139.252.1.234:domain,1,87,0,0,1,87,0.810608000,0.0000
192.74.123.212:49037,<->,92.27.219.182:globmsgsvc,0,0,1,176,1,176,0.810286000,0.0000
144.75.218.242:14780,<->,8.222.218.199:domain,1,110,0,0,1,110,0.810264000,0.0000
144.75.218.237:27534,<->,138.127.225.67:domain,1,366,0,0,1,366,0.809982000,0.0000
242.121.18.213:60206,<->,138.98.134.1:domain,0,0,1,79,1,79,0.809695000,0.0000
92.27.27.165:16763,<->,78.51.214.152:wfremotertm,1,52,0,0,1,52,0.809514000,0.0000
116.143.80.64:51497,<->,92.27.219.230:http-alt,0,0,1,133,1,133,0.808348000,0.0000
144.75.218.246:30889,<->,8.222.218.204:domain,1,111,0,0,1,111,0.807582000,0.0000
144.75.218.241:39352,<->,8.222.218.196:domain,1,123,0,0,1,123,0.807545000,0.0000
93.163.135.26:28898,<->,132.168.196.227:domain,0,0,1,79,1,79,0.806860000,0.0000
27.188.163.162:i-net-2000-npr,<->,109.1.17.14:sip,0,0,1,444,1,444,0.805921000,0.0000
8.252.222.202:37348,<->,29.212.43.244:domain,1,105,0,0,1,105,0.805606000,0.0000
206.22.162.192:59099,<->,192.64.195.195:53101,0,0,1,52,1,52,0.804824000,0.0000
92.27.219.229:29820,<->,80.226.83.121:20402,1,80,0,0,1,80,0.804802000,0.0000
21.15.226.126:55104,<->,20.193.60.212:netbios-ns,0,0,1,82,1,82,0.804377000,0.0000
144.75.218.242:18646,<->,8.222.218.196:domain,1,110,0,0,1,110,0.803529000,0.0000
38.21.156.204:56633,<->,20.232.228.157:netbios-ns,0,0,1,82,1,82,0.803494000,0.0000
192.67.181.192:57537,<->,207.5.99.21:50903,1,98,0,0,1,98,0.803421000,0.0000
21.15.226.126:55104,<->,20.193.60.220:netbios-ns,0,0,1,82,1,82,0.803408000,0.0000
109.1.15.30:57225,<->,93.160.237.240:33978,1,152,0,0,1,152,0.802987000,0.0000
144.75.218.233:netcomm2,<->,8.222.218.196:domain,1,109,0,0,1,109,0.802896000,0.0000
144.75.218.242:62909,<->,8.222.218.199:domain,1,153,0,0,1,153,0.802774000,0.0000
92.27.219.50:15789,<->,197.132.142.28:12414,1,135,0,0,1,135,0.802707000,0.0000
79.134.27.76:51896,<->,35.56.103.56:ms-wbt-server,0,0,1,50,1,50,0.802442000,0.0000
48.105.172.255:19721,<->,92.27.219.186:commplex-main,0,0,1,52,1,52,0.802422000,0.0000
144.75.218.237:32166,<->,58.48.88.117:domain,1,93,0,0,1,93,0.802369000,0.0000
92.27.27.165:31297,<->,105.254.61.156:20972,1,52,0,0,1,52,0.802123000,0.0000
20.172.45.171:57596,<->,120.48.131.33:domain,1,78,0,0,1,78,0.801962000,0.0000
144.76.43.234:49751,<->,159.69.187.45:domain,0,0,1,75,1,75,0.801815000,0.0000
144.75.218.233:62295,<->,53.162.176.63:domain,1,137,0,0,1,137,0.801524000,0.0000
92.27.219.49:26279,<->,127.152.207.195:1024,1,52,0,0,1,52,0.801200000,0.0000
21.15.226.126:55104,<->,20.193.60.176:netbios-ns,0,0,1,82,1,82,0.801193000,0.0000
136.99.137.179:57850,<->,138.127.227.65:domain,1,243,0,0,1,243,0.801082000,0.0000
92.27.27.166:53367,<->,196.18.149.149:297,1,52,0,0,1,52,0.800993000,0.0000
234.182.169.148:5108,<->,133.32.2.37:domain,0,0,1,82,1,82,0.800710000,0.0000
132.200.62.147:65481,<->,208.186.230.2:domain,1,72,0,0,1,72,0.800695000,0.0000
131.95.192.187:41011,<->,215.158.238.163:domain,0,0,1,85,1,85,0.800665000,0.0000
144.75.218.246:32786,<->,139.114.208.35:domain,1,132,0,0,1,132,0.800361000,0.0000
89.183.104.152:45529,<->,66.13.115.56:25596,1,153,0,0,1,153,0.800157000,0.0000
92.27.219.231:63133,<->,227.23.98.223:40014,1,53,0,0,1,53,0.799893000,0.0000
109.1.40.226:43175,<->,29.239.233.207:1024,1,99,0,0,1,99,0.799467000,0.0000
92.27.219.46:40570,<->,114.207.42.114:bnetfile,1,52,0,0,1,52,0.799307000,0.0000
20.16.122.94:43687,<->,143.148.102.19:domain,1,72,0,0,1,72,0.799017000,0.0000
144.75.218.233:17009,<->,8.222.218.196:domain,1,123,0,0,1,123,0.798770000,0.0000
194.40.2.133:32525,<->,92.27.219.21:XmlIpcRegSvc,0,0,1,52,1,52,0.798751000,0.0000
:::22133,<->,:::domain,1,503,0,0,1,503,0.798539000,0.0000
144.75.218.241:63690,<->,8.222.218.207:domain,1,122,0,0,1,122,0.798466000,0.0000
144.75.218.233:51610,<->,8.222.218.196:domain,1,123,0,0,1,123,0.797619000,0.0000
144.75.218.241:44671,<->,8.222.218.204:domain,1,175,0,0,1,175,0.797432000,0.0000
247.136.226.75:40566,<->,104.99.156.136:6881,1,97,0,0,1,97,0.797223000,0.0000
144.75.218.235:20177,<->,8.222.218.198:domain,1,170,0,0,1,170,0.797018000,0.0000
80.41.16.207:20054,<->,105.121.173.108:16802,1,133,0,0,1,133,0.796299000,0.0000
92.27.219.238:62250,<->,114.28.148.5:11138,1,149,0,0,1,149,0.795890000,0.0000
20.181.69.66:51444,<->,112.5.12.77:domain,1,72,0,0,1,72,0.795517000,0.0000
102.45.16.209:18880,<->,78.45.210.42:10956,1,52,0,0,1,52,0.795166000,0.0000
21.15.226.126:55104,<->,20.193.60.211:netbios-ns,0,0,1,82,1,82,0.794879000,0.0000
144.108.80.170:42630,<->,144.122.240.218:domain,0,0,1,72,1,72,0.794731000,0.0000
144.75.218.246:23770,<->,8.222.218.199:domain,1,237,0,0,1,237,0.794576000,0.0000
144.75.218.241:19687,<->,8.222.218.207:domain,1,111,0,0,1,111,0.794112000,0.0000
92.162.219.96:23531,<->,129.224.112.252:domain,0,0,1,76,1,76,0.793258000,0.0000
144.75.218.233:35099,<->,17.197.194.60:domain,1,163,0,0,1,163,0.792437000,0.0000
109.1.65.112:56739,<->,226.162.38.40:domain,1,269,0,0,1,269,0.792431000,0.0000
8.176.8.83:55354,<->,120.155.86.33:domain,1,131,0,0,1,131,0.792261000,0.0000
136.25.188.105:52697,<->,141.204.123.255:domain,1,120,0,0,1,120,0.792103000,0.0000
144.75.218.233:63350,<->,8.222.218.204:domain,1,153,0,0,1,153,0.791873000,0.0000
92.27.219.42:64794,<->,29.11.138.97:8481,1,174,0,0,1,174,0.791521000,0.0000
92.27.219.140:58613,<->,206.198.190.233:19143,1,319,0,0,1,319,0.791293000,0.0000
122.135.83.219:6881,<->,89.183.104.160:ftsrv,0,0,1,332,1,332,0.791202000,0.0000
144.75.218.242:25016,<->,119.94.225.50:domain,1,143,0,0,1,143,0.791022000,0.0000
193.21.29.244:50650,<->,100.94.40.183:19845,0,0,1,335,1,335,0.790817000,0.0000
144.75.218.233:51993,<->,8.222.218.196:domain,1,124,0,0,1,124,0.790463000,0.0000
143.252.64.234:24654,<->,129.224.112.252:domain,0,0,1,66,1,66,0.790229000,0.0000
144.75.218.246:62219,<->,8.222.218.204:domain,1,110,0,0,1,110,0.790125000,0.0000
215.158.103.206:42143,<->,129.221.194.218:domain,1,801,0,0,1,801,0.789952000,0.0000
144.75.218.237:45312,<->,8.222.218.204:domain,1,121,0,0,1,121,0.789410000,0.0000
8.176.8.83:41470,<->,192.171.13.35:domain,1,102,0,0,1,102,0.789159000,0.0000
118.99.185.65:56310,<->,89.183.104.138:40266,0,0,1,213,1,213,0.789113000,0.0000
8.176.8.83:50685,<->,192.171.13.35:domain,1,213,0,0,1,213,0.788036000,0.0000
144.75.218.235:39290,<->,8.222.218.198:domain,1,121,0,0,1,121,0.788035000,0.0000
144.75.218.237:28446,<->,138.127.225.252:domain,1,356,0,0,1,356,0.787977000,0.0000
157.98.1.54:24141,<->,129.224.112.252:domain,0,0,1,82,1,82,0.787494000,0.0000
144.75.218.241:6844,<->,8.222.218.207:domain,1,150,0,0,1,150,0.787477000,0.0000
120.238.165.207:51299,<->,101.224.172.52:28016,0,0,1,57,1,57,0.786966000,0.0000
144.76.43.234:51024,<->,144.122.240.212:domain,0,0,1,77,1,77,0.786803000,0.0000
80.40.24.130:41652,<->,149.200.188.95:40006,1,490,0,0,1,490,0.786793000,0.0000
144.75.218.235:8885,<->,8.222.218.198:domain,1,124,0,0,1,124,0.786594000,0.0000
99.168.117.210:22016,<->,159.69.187.28:domain,0,0,1,72,1,72,0.786514000,0.0000
144.75.218.233:62825,<->,138.127.224.115:domain,1,348,0,0,1,348,0.786111000,0.0000
52.194.161.199:sdo-tls,<->,109.222.253.182:domain,0,0,1,70,1,70,0.785564000,0.0000
144.75.218.241:18929,<->,138.127.230.35:domain,1,356,0,0,1,356,0.785486000,0.0000
192.64.234.225:60418,<->,149.59.98.246:49152,1,50,0,0,1,50,0.785465000,0.0000
8.176.8.83:51915,<->,192.171.13.35:domain,1,102,0,0,1,102,0.785293000,0.0000
39.38.85.55:43832,<->,230.62.102.89:14148,1,710,0,0,1,710,0.785185000,0.0000
144.75.218.246:ip-provision,<->,138.127.225.148:domain,1,366,0,0,1,366,0.784830000,0.0000
:::56651,<->,:::domain,1,298,0,0,1,298,0.784419000,0.0000
144.75.218.246:47429,<->,139.252.1.230:domain,1,90,0,0,1,90,0.784360000,0.0000
144.75.218.237:plgproxy,<->,8.222.218.207:domain,1,110,0,0,1,110,0.783928000,0.0000
97.126.26.71:dsatp,<->,138.127.224.101:domain,1,84,0,0,1,84,0.783925000,0.0000
146.196.145.46:33780,<->,129.224.112.252:domain,0,0,1,75,1,75,0.783494000,0.0000
198.206.5.108:35075,<->,220.55.79.118:domain,0,0,1,81,1,81,0.782954000,0.0000
144.75.218.246:53945,<->,246.108.250.201:domain,1,72,0,0,1,72,0.782649000,0.0000
144.75.218.242:58530,<->,8.222.218.199:domain,1,112,0,0,1,112,0.781976000,0.0000
198.206.5.108:22767,<->,220.55.79.118:domain,0,0,1,77,1,77,0.781765000,0.0000
39.53.87.17:64891,<->,204.136.215.19:domain,1,72,0,0,1,72,0.781553000,0.0000
144.108.64.181:57151,<->,144.122.240.210:domain,0,0,1,69,1,69,0.781523000,0.0000
144.108.80.170:44611,<->,159.69.187.12:domain,0,0,1,71,1,71,0.781357000,0.0000
144.75.218.241:27134,<->,138.127.231.14:domain,1,254,0,0,1,254,0.781229000,0.0000
144.75.218.237:60224,<->,138.127.230.221:domain,1,84,0,0,1,84,0.780725000,0.0000
92.27.219.229:51413,<->,106.29.77.23:6901,1,334,0,0,1,334,0.780151000,0.0000
144.75.218.241:57163,<->,138.127.231.62:domain,1,280,0,0,1,280,0.779651000,0.0000
144.75.218.233:38566,<->,138.127.231.91:domain,1,238,0,0,1,238,0.779168000,0.0000
27.77.123.31:20195,<->,92.27.219.171:ezproxy-2,0,0,1,263,1,263,0.778993000,0.0000
205.63.215.229:35019,<->,92.27.219.217:21310,0,0,1,1398,1,1398,0.778574000,0.0000
144.75.218.237:19442,<->,8.222.218.199:domain,1,123,0,0,1,123,0.778067000,0.0000
218.31.254.210:17094,<->,129.224.112.252:domain,0,0,1,72,1,72,0.777945000,0.0000
20.255.131.77:38297,<->,119.49.204.222:domain,1,74,0,0,1,74,0.777830000,0.0000
198.182.188.35:15521,<->,80.41.12.171:12388,0,0,1,120,1,120,0.777827000,0.0000
132.180.212.246:42909,<->,129.224.112.252:domain,0,0,1,61,1,61,0.777701000,0.0000
144.75.218.235:61943,<->,8.222.218.198:domain,1,127,0,0,1,127,0.777505000,0.0000
144.75.218.242:27485,<->,138.127.224.101:domain,1,84,0,0,1,84,0.777296000,0.0000
92.27.219.231:63067,<->,159.36.245.188:57152,1,213,0,0,1,213,0.776920000,0.0000
144.75.218.235:9440,<->,8.222.218.204:domain,1,122,0,0,1,122,0.776626000,0.0000
139.81.45.38:13983,<->,138.98.246.1:domain,0,0,1,124,1,124,0.776557000,0.0000
144.69.101.196:54483,<->,159.69.187.12:domain,0,0,1,75,1,75,0.775436000,0.0000
136.25.188.105:61854,<->,128.243.151.33:domain,1,234,0,0,1,234,0.774855000,0.0000
39.220.231.11:14032,<->,141.183.33.233:domain,1,72,0,0,1,72,0.774852000,0.0000
144.75.218.242:41236,<->,8.222.218.196:domain,1,110,0,0,1,110,0.774741000,0.0000
8.35.106.83:39573,<->,246.254.97.149:domain,0,0,1,101,1,101,0.774046000,0.0000
103.178.26.56:61848,<->,98.67.130.21:domain,0,0,1,76,1,76,0.773807000,0.0000
92.27.219.160:60517,<->,198.212.18.67:45682,1,52,0,0,1,52,0.773649000,0.0000
136.25.188.105:59861,<->,133.9.254.177:domain,1,94,0,0,1,94,0.773566000,0.0000
92.27.52.56:43423,<->,92.27.26.203:snmp,0,0,1,83,1,83,0.773048000,0.0000
136.25.188.105:58209,<->,129.70.124.49:domain,1,143,0,0,1,143,0.772956000,0.0000
145.42.14.168:52011,<->,129.78.116.244:domain,0,0,1,84,1,84,0.772432000,0.0000
144.75.218.241:19559,<->,8.222.218.196:domain,1,110,0,0,1,110,0.772011000,0.0000
144.75.218.235:47012,<->,8.222.218.197:domain,1,127,0,0,1,127,0.770838000,0.0000
79.116.131.173:25719,<->,111.147.125.110:domain,0,0,1,72,1,72,0.770772000,0.0000
20.222.244.52:59833,<->,121.94.99.179:domain,1,84,0,0,1,84,0.769563000,0.0000
89.183.104.243:11841,<->,118.35.233.94:6881,1,98,0,0,1,98,0.769009000,0.0000
144.75.218.241:38887,<->,8.222.218.207:domain,1,122,0,0,1,122,0.768895000,0.0000
97.126.26.40:60930,<->,137.148.176.213:domain,1,83,0,0,1,83,0.767910000,0.0000
144.75.218.246:netclip,<->,138.127.224.42:domain,1,296,0,0,1,296,0.767701000,0.0000
210.220.219.153:53579,<->,138.127.231.62:domain,1,293,0,0,1,293,0.765985000,0.0000
38.84.5.250:30662,<->,92.27.219.253:4316,0,0,1,149,1,149,0.764622000,0.0000
144.75.218.235:63226,<->,8.222.218.198:domain,1,110,0,0,1,110,0.764503000,0.0000
144.75.218.235:mcs-messaging,<->,8.222.218.198:domain,1,151,0,0,1,151,0.764349000,0.0000
144.75.218.242:28533,<->,8.222.218.199:domain,1,110,0,0,1,110,0.763435000,0.0000
92.27.219.251:45690,<->,142.241.44.215:40368,1,52,0,0,1,52,0.762607000,0.0000
144.75.218.233:ill,<->,138.127.231.102:domain,1,263,0,0,1,263,0.762321000,0.0000
144.75.218.242:21035,<->,138.127.230.146:domain,1,253,0,0,1,253,0.762247000,0.0000
8.35.106.206:38974,<->,136.25.189.214:domain,0,0,1,90,1,90,0.762035000,0.0000
144.75.218.242:40448,<->,8.222.218.199:domain,1,110,0,0,1,110,0.761930000,0.0000
8.35.106.206:43030,<->,215.158.239.217:domain,0,0,1,90,1,90,0.761691000,0.0000
144.75.218.237:raventdm,<->,8.222.218.198:domain,1,110,0,0,1,110,0.761625000,0.0000
144.75.218.242:16504,<->,138.127.225.171:domain,1,354,0,0,1,354,0.761377000,0.0000
144.75.218.237:31033,<->,138.127.230.2:domain,1,398,0,0,1,398,0.761331000,0.0000
111.151.237.52:52796,<->,215.158.140.105:12347,0,0,1,1064,1,1064,0.761264000,0.0000
144.75.218.246:4540,<->,138.127.230.144:domain,1,242,0,0,1,242,0.761212000,0.0000
68.0.226.41:47663,<->,100.208.15.63:gnutella-svc,0,0,1,156,1,156,0.761017000,0.0000
94.254.2.109:60414,<->,101.122.132.105:domain,0,0,1,65,1,65,0.759911000,0.0000
144.76.43.245:11651,<->,80.56.78.128:domain,0,0,1,107,1,107,0.759615000,0.0000
139.81.45.38:46437,<->,138.98.246.1:domain,0,0,1,136,1,136,0.758964000,0.0000
144.75.218.241:39851,<->,8.222.218.204:domain,1,110,0,0,1,110,0.758606000,0.0000
53.89.213.104:5894,<->,98.236.95.13:domain,0,0,1,89,1,89,0.758257000,0.0000
144.75.218.242:24010,<->,143.204.138.237:domain,1,148,0,0,1,148,0.758118000,0.0000
144.75.218.233:27120,<->,8.222.218.197:domain,1,110,0,0,1,110,0.757953000,0.0000
8.228.214.59:62355,<->,33.155.155.153:57778,1,52,0,0,1,52,0.757327000,0.0000
21.15.226.126:55104,<->,20.193.61.72:netbios-ns,0,0,1,82,1,82,0.757270000,0.0000
132.7.32.230:61240,<->,192.67.167.86:55452,0,0,1,52,1,52,0.756826000,0.0000
89.127.177.200:38399,<->,29.211.214.82:domain,0,0,1,87,1,87,0.756680000,0.0000
106.167.226.231:26493,<->,139.163.5.140:http,0,0,1,62,1,62,0.756634000,0.0000
144.75.218.242:62071,<->,138.127.230.221:domain,1,84,0,0,1,84,0.756403000,0.0000
144.75.218.233:gtrack-ne,<->,8.222.218.204:domain,1,122,0,0,1,122,0.756324000,0.0000
144.75.218.242:23638,<->,8.222.218.207:domain,1,110,0,0,1,110,0.756210000,0.0000
144.75.218.233:7419,<->,138.127.230.209:domain,1,279,0,0,1,279,0.755140000,0.0000
105.197.17.184:jstel,<->,101.70.119.37:domain,0,0,1,67,1,67,0.755029000,0.0000
144.75.218.242:16939,<->,130.54.191.244:domain,1,75,0,0,1,75,0.754823000,0.0000
99.75.234.139:57266,<->,144.76.44.59:domain,1,125,0,0,1,125,0.754386000,0.0000
39.10.114.234:22771,<->,113.179.22.128:domain,1,78,0,0,1,78,0.753918000,0.0000
144.75.218.237:36901,<->,138.127.224.46:domain,1,258,0,0,1,258,0.753571000,0.0000
144.75.218.242:5928,<->,8.222.218.207:domain,1,113,0,0,1,113,0.752856000,0.0000
92.27.219.140:58513,<->,198.157.156.226:6881,1,307,0,0,1,307,0.752733000,0.0000
144.75.218.241:14996,<->,8.222.218.207:domain,1,123,0,0,1,123,0.752635000,0.0000
144.75.218.237:30383,<->,56.120.138.124:domain,1,143,0,0,1,143,0.752303000,0.0000
97.242.126.198:63698,<->,144.71.44.95:domain,0,0,1,84,1,84,0.751284000,0.0000
118.194.174.35:6881,<->,89.183.104.135:6881,0,0,1,324,1,324,0.751033000,0.0000
92.27.219.153:50425,<->,48.111.9.167:12514,1,273,0,0,1,273,0.750659000,0.0000
89.183.104.151:24338,<->,229.42.148.9:21873,1,52,0,0,1,52,0.750456000,0.0000
144.75.218.246:44100,<->,98.184.9.185:domain,1,126,0,0,1,126,0.750182000,0.0000
144.75.218.237:16280,<->,50.149.206.145:domain,1,280,0,0,1,280,0.750103000,0.0000
144.75.218.233:49933,<->,99.168.7.150:domain,1,124,0,0,1,124,0.750088000,0.0000
144.75.218.242:19626,<->,8.222.218.196:domain,1,110,0,0,1,110,0.750081000,0.0000
144.75.218.233:60425,<->,8.222.218.197:domain,1,107,0,0,1,107,0.749644000,0.0000
144.75.218.242:13064,<->,138.127.224.190:domain,1,242,0,0,1,242,0.749364000,0.0000
215.158.239.104:57773,<->,138.127.224.238:domain,1,232,0,0,1,232,0.749239000,0.0000
144.75.218.237:25786,<->,138.127.225.165:domain,1,254,0,0,1,254,0.748658000,0.0000
144.75.218.242:63923,<->,146.253.87.247:domain,1,123,0,0,1,123,0.748570000,0.0000
144.75.218.235:16234,<->,8.222.218.197:domain,1,110,0,0,1,110,0.748520000,0.0000
221.150.250.237:32634,<->,111.48.21.51:domain,1,106,0,0,1,106,0.748495000,0.0000
33.57.74.181:61724,<->,220.55.75.167:domain,0,0,1,75,1,75,0.748122000,0.0000
91.54.155.124:55318,<->,132.249.70.233:domain,0,0,1,74,1,74,0.747469000,0.0000
109.222.251.171:50321,<->,101.62.32.153:47313,1,136,0,0,1,136,0.747001000,0.0000
39.49.187.123:40387,<->,112.70.87.240:15252,1,296,0,0,1,296,0.746748000,0.0000
131.1.235.233:40852,<->,133.178.227.73:domain,0,0,1,85,1,85,0.746482000,0.0000
144.75.218.246:12900,<->,8.222.218.197:domain,1,111,0,0,1,111,0.746403000,0.0000
144.75.218.237:spearway,<->,8.222.218.198:domain,1,238,0,0,1,238,0.746253000,0.0000
144.75.218.235:44041,<->,8.222.218.204:domain,1,111,0,0,1,111,0.745787000,0.0000
8.251.185.161:29353,<->,109.222.217.93:domain,0,0,1,73,1,73,0.745635000,0.0000
78.151.182.244:56343,<->,20.40.147.118:teredo,0,0,1,78,1,78,0.745524000,0.0000
144.75.218.233:21039,<->,111.40.16.13:domain,1,87,0,0,1,87,0.745520000,0.0000
144.75.218.237:46086,<->,8.222.218.198:domain,1,239,0,0,1,239,0.745461000,0.0000
144.75.218.237:18713,<->,8.222.218.204:domain,1,110,0,0,1,110,0.745429000,0.0000
81.193.109.18:18742,<->,109.222.217.93:domain,0,0,1,73,1,73,0.745214000,0.0000
97.126.26.71:6733,<->,137.148.176.213:domain,1,83,0,0,1,83,0.745214000,0.0000
144.75.218.242:20367,<->,8.222.218.199:domain,1,110,0,0,1,110,0.745004000,0.0000
144.75.218.237:19603,<->,8.222.218.197:domain,1,127,0,0,1,127,0.744991000,0.0000
110.103.159.83:55436,<->,192.67.179.218:6881,0,0,1,105,1,105,0.744470000,0.0000
201.217.193.35:53835,<->,92.27.27.146:53772,0,0,1,132,1,132,0.743662000,0.0000
112.29.250.153:12074,<->,92.27.27.171:openvpn,0,0,1,62,1,62,0.743574000,0.0000
144.75.218.237:28951,<->,8.222.218.198:domain,1,110,0,0,1,110,0.743386000,0.0000
102.51.33.111:32941,<->,106.181.79.175:32709,1,135,0,0,1,135,0.743217000,0.0000
144.75.218.242:19271,<->,8.222.218.204:domain,1,110,0,0,1,110,0.743182000,0.0000
215.158.238.85:43266,<->,139.252.1.253:domain,1,135,0,0,1,135,0.742519000,0.0000
33.233.160.168:41972,<->,247.136.216.62:24682,0,0,1,123,1,123,0.741387000,0.0000
144.75.218.242:metatude-mds,<->,120.155.84.208:domain,1,152,0,0,1,152,0.741386000,0.0000
144.75.218.233:pxc-splr-ft,<->,132.200.124.228:domain,1,147,0,0,1,147,0.740292000,0.0000
239.66.184.247:33445,<->,100.92.119.180:33445,0,0,1,270,1,270,0.740140000,0.0000
101.229.93.43:56699,<->,132.249.70.213:domain,0,0,1,106,1,106,0.740042000,0.0000
220.80.188.18:63454,<->,93.177.118.32:6881,1,133,0,0,1,133,0.739614000,0.0000
92.27.27.144:51531,<->,101.71.60.7:51413,1,317,0,0,1,317,0.739394000,0.0000
100.255.17.187:30436,<->,97.126.116.84:domain,0,0,1,65,1,65,0.738563000,0.0000
61.93.34.188:61137,<->,220.84.205.112:50321,0,0,1,135,1,135,0.738290000,0.0000
136.25.189.5:64006,<->,33.209.218.54:domain,1,218,0,0,1,218,0.738149000,0.0000
89.183.104.136:58346,<->,104.147.228.66:37450,1,100,0,0,1,100,0.737339000,0.0000
144.75.218.233:32161,<->,138.127.224.105:domain,1,366,0,0,1,366,0.735222000,0.0000
144.75.218.242:neod2,<->,99.168.7.150:domain,1,128,0,0,1,128,0.733245000,0.0000
149.178.48.72:36800,<->,129.224.112.252:domain,0,0,1,69,1,69,0.733130000,0.0000
20.46.130.124:38940,<->,122.238.92.211:domain,1,75,0,0,1,75,0.732906000,0.0000
193.21.29.252:62010,<->,192.67.161.238:37391,0,0,1,136,1,136,0.732765000,0.0000
145.252.127.155:34476,<->,144.76.46.38:domain,1,90,0,0,1,90,0.732618000,0.0000
210.158.44.137:24859,<->,124.58.26.202:domain,1,119,0,0,1,119,0.732448000,0.0000
132.168.196.9:51162,<->,115.78.45.1:28490,1,52,0,0,1,52,0.731615000,0.0000
144.75.218.246:10504,<->,138.127.224.168:domain,1,314,0,0,1,314,0.731308000,0.0000
144.75.218.237:28985,<->,8.222.218.207:domain,1,122,0,0,1,122,0.731208000,0.0000
112.70.50.181:51427,<->,129.1.96.39:45267,0,0,1,149,1,149,0.731146000,0.0000
144.75.218.242:39506,<->,8.222.218.199:domain,1,110,0,0,1,110,0.731014000,0.0000
192.204.123.23:63994,<->,246.253.253.84:domain,0,0,1,83,1,83,0.730861000,0.0000
144.75.218.233:64743,<->,138.127.230.213:domain,1,286,0,0,1,286,0.730766000,0.0000
92.27.219.23:53043,<->,136.129.94.107:domain,1,123,0,0,1,123,0.730147000,0.0000
38.21.156.204:56633,<->,20.232.228.175:netbios-ns,0,0,1,82,1,82,0.729754000,0.0000
97.242.126.192:22461,<->,129.224.112.252:domain,0,0,1,75,1,75,0.729628000,0.0000
34.139.217.179:48493,<->,147.47.189.152:domain,1,134,0,0,1,134,0.729521000,0.0000
141.134.231.203:65121,<->,159.137.203.107:domain,0,0,1,72,1,72,0.729128000,0.0000
144.75.218.246:45023,<->,129.35.251.34:domain,1,140,0,0,1,140,0.728774000,0.0000
144.75.218.241:58721,<->,8.222.218.204:domain,1,127,0,0,1,127,0.728622000,0.0000
144.75.218.237:23474,<->,8.222.218.198:domain,1,122,0,0,1,122,0.728458000,0.0000
215.158.239.103:51952,<->,192.171.13.35:domain,1,102,0,0,1,102,0.728280000,0.0000
20.29.39.250:37187,<->,156.182.98.147:blackjack,1,120,0,0,1,120,0.727881000,0.0000
89.183.104.251:42149,<->,134.50.189.160:28192,1,62,0,0,1,62,0.727800000,0.0000
65.67.142.90:56733,<->,39.169.11.74:23933,0,0,1,52,1,52,0.726966000,0.0000
102.83.157.248:31262,<->,64.146.112.197:10587,1,169,0,0,1,169,0.726894000,0.0000
80.42.150.137:61724,<->,105.201.221.207:43976,1,326,0,0,1,326,0.726413000,0.0000
144.75.218.246:43277,<->,8.222.218.204:domain,1,181,0,0,1,181,0.726233000,0.0000
144.75.218.246:60377,<->,8.222.218.204:domain,1,113,0,0,1,113,0.726053000,0.0000
89.139.241.98:43691,<->,205.121.167.47:domain,1,151,0,0,1,151,0.725994000,0.0000
144.75.218.246:5480,<->,8.222.218.197:domain,1,111,0,0,1,111,0.725779000,0.0000
136.181.39.4:60502,<->,144.76.46.38:domain,1,112,0,0,1,112,0.725376000,0.0000
144.75.218.246:15911,<->,8.222.218.197:domain,1,122,0,0,1,122,0.724903000,0.0000
144.75.218.241:interwise,<->,8.47.122.178:domain,1,100,0,0,1,100,0.724632000,0.0000
:::59256,<->,:::domain,1,693,0,0,1,693,0.724022000,0.0000
144.75.218.246:18999,<->,8.222.218.199:domain,1,110,0,0,1,110,0.723943000,0.0000
127.73.18.187:51413,<->,97.126.35.236:42367,0,0,1,187,1,187,0.723367000,0.0000
89.139.241.98:19193,<->,143.117.247.30:domain,1,136,0,0,1,136,0.723298000,0.0000
22.50.105.63:13836,<->,132.249.70.213:domain,0,0,1,125,1,125,0.722941000,0.0000
81.18.77.118:62103,<->,109.222.255.151:domain,0,0,1,66,1,66,0.722650000,0.0000
39.193.150.67:51143,<->,104.158.163.210:49499,1,52,0,0,1,52,0.722541000,0.0000
144.75.218.242:46341,<->,8.222.218.199:domain,1,110,0,0,1,110,0.722342000,0.0000
144.75.218.241:15854,<->,8.222.218.196:domain,1,113,0,0,1,113,0.722028000,0.0000
89.183.104.135:6881,<->,122.253.118.127:cap,1,52,0,0,1,52,0.721887000,0.0000
144.75.218.242:21655,<->,8.222.218.196:domain,1,110,0,0,1,110,0.721321000,0.0000
144.75.218.241:55681,<->,138.127.231.54:domain,1,333,0,0,1,333,0.720550000,0.0000
102.47.130.213:ntp,<->,50.224.118.187:ntp,0,0,1,80,1,80,0.720044000,0.0000
144.108.64.185:17743,<->,144.122.240.222:domain,0,0,1,64,1,64,0.719940000,0.0000
109.122.86.55:57628,<->,109.222.228.12:domain,0,0,1,92,1,92,0.719908000,0.0000
144.75.218.241:4203,<->,139.252.1.253:domain,1,143,0,0,1,143,0.719560000,0.0000
144.108.64.183:61113,<->,159.69.187.28:domain,0,0,1,66,1,66,0.719330000,0.0000
144.75.218.246:41718,<->,8.222.218.197:domain,1,110,0,0,1,110,0.719320000,0.0000
144.75.221.204:29653,<->,97.198.100.142:domain,0,0,1,87,1,87,0.717849000,0.0000
200.226.80.179:42886,<->,129.92.113.143:chargen,0,0,1,50,1,50,0.717589000,0.0000
246.253.253.79:39475,<->,159.57.86.227:domain,1,198,0,0,1,198,0.717168000,0.0000
125.221.158.28:42713,<->,89.183.104.160:iclpv-nls,0,0,1,270,1,270,0.716839000,0.0000
20.36.214.32:vchat,<->,141.105.189.30:domain,1,72,0,0,1,72,0.716795000,0.0000
80.41.44.203:17519,<->,64.214.44.93:13175,1,52,0,0,1,52,0.716165000,0.0000
133.24.77.91:58061,<->,204.42.100.81:53691,1,60,0,0,1,60,0.716074000,0.0000
215.158.239.103:58133,<->,29.214.217.188:domain,1,336,0,0,1,336,0.715913000,0.0000
144.75.218.241:49280,<->,120.155.84.97:domain,1,149,0,0,1,149,0.715582000,0.0000
144.75.218.242:40590,<->,8.222.218.207:domain,1,125,0,0,1,125,0.714644000,0.0000
109.1.52.158:40989,<->,121.15.252.56:34239,1,99,0,0,1,99,0.714263000,0.0000
89.211.37.130:23812,<->,98.232.172.60:domain,0,0,1,84,1,84,0.714089000,0.0000
139.254.213.98:34825,<->,129.205.208.245:domain,1,614,0,0,1,614,0.714015000,0.0000
144.75.218.242:64056,<->,8.222.218.207:domain,1,122,0,0,1,122,0.713561000,0.0000
144.75.218.241:50614,<->,138.127.225.148:domain,1,366,0,0,1,366,0.713430000,0.0000
204.42.100.81:53691,<->,133.24.77.91:20247,0,0,1,60,1,60,0.713000000,0.0000
144.75.218.246:mmcal,<->,8.222.218.199:domain,1,122,0,0,1,122,0.712832000,0.0000
144.75.218.241:60112,<->,8.222.218.207:domain,1,124,0,0,1,124,0.712792000,0.0000
80.40.13.234:55558,<->,158.99.169.247:ping-pong,1,136,0,0,1,136,0.712177000,0.0000
99.75.41.170:37114,<->,226.162.38.40:domain,1,63,0,0,1,63,0.712104000,0.0000
20.9.89.19:48319,<->,113.14.32.243:domain,1,72,0,0,1,72,0.711842000,0.0000
144.75.218.233:54328,<->,8.222.218.204:domain,1,111,0,0,1,111,0.711736000,0.0000
220.80.18.212:15440,<->,158.93.155.23:11879,1,67,0,0,1,67,0.711719000,0.0000
210.235.163.211:30922,<->,22.34.2.52:5199,1,186,0,0,1,186,0.711587000,0.0000
200.226.80.179:53226,<->,129.92.113.143:chargen,0,0,1,50,1,50,0.711414000,0.0000
144.75.218.246:47616,<->,8.222.218.199:domain,1,239,0,0,1,239,0.711251000,0.0000
100.50.202.45:25605,<->,206.195.90.218:domain,1,70,0,0,1,70,0.709787000,0.0000
159.134.47.10:31894,<->,159.87.104.238:domain,0,0,1,76,1,76,0.709635000,0.0000
20.39.199.134:60783,<->,237.56.30.41:domain,1,78,0,0,1,78,0.709430000,0.0000
144.75.218.242:9266,<->,8.222.218.207:domain,1,122,0,0,1,122,0.708989000,0.0000
144.75.218.242:20190,<->,8.222.218.199:domain,1,122,0,0,1,122,0.708310000,0.0000
215.158.140.170:37696,<->,131.189.98.171:domain,1,211,0,0,1,211,0.707882000,0.0000
26.225.57.159:64740,<->,133.32.1.105:domain,0,0,1,69,1,69,0.707794000,0.0000
8.252.222.202:60349,<->,148.151.124.212:domain,1,135,0,0,1,135,0.707683000,0.0000
135.233.98.57:38553,<->,129.224.112.220:domain,0,0,1,54,1,54,0.706964000,0.0000
39.246.51.182:52609,<->,143.220.58.215:domain,1,75,0,0,1,75,0.706657000,0.0000
144.75.218.233:proshare1,<->,8.47.122.178:domain,1,100,0,0,1,100,0.706520000,0.0000
144.75.218.233:51477,<->,8.222.218.204:domain,1,111,0,0,1,111,0.706218000,0.0000
89.183.104.168:24013,<->,220.81.184.104:17433,1,80,0,0,1,80,0.705754000,0.0000
112.130.42.21:52710,<->,109.222.251.27:domain,0,0,1,77,1,77,0.705530000,0.0000
96.232.37.25:54841,<->,89.183.108.200:domain,0,0,1,78,1,78,0.705321000,0.0000
131.144.248.45:48248,<->,129.224.112.252:domain,0,0,1,83,1,83,0.705160000,0.0000
144.75.218.237:44034,<->,8.222.218.204:domain,1,141,0,0,1,141,0.705104000,0.0000
144.75.218.241:19675,<->,8.222.218.196:domain,1,111,0,0,1,111,0.704691000,0.0000
21.15.226.126:55104,<->,20.193.63.180:netbios-ns,0,0,1,82,1,82,0.704066000,0.0000
144.75.218.237:62166,<->,8.222.218.197:domain,1,110,0,0,1,110,0.703950000,0.0000
38.21.156.204:56633,<->,20.232.228.246:netbios-ns,0,0,1,82,1,82,0.703421000,0.0000
205.224.29.67:35181,<->,100.93.232.193:26085,0,0,1,326,1,326,0.703369000,0.0000
144.75.218.246:45572,<->,8.222.218.197:domain,1,110,0,0,1,110,0.702639000,0.0000
144.75.218.241:31304,<->,8.222.218.207:domain,1,237,0,0,1,237,0.701505000,0.0000
195.3.157.139:14078,<->,39.15.169.14:domain,0,0,1,86,1,86,0.701423000,0.0000
38.21.156.204:56633,<->,20.232.228.254:netbios-ns,0,0,1,82,1,82,0.701049000,0.0000
52.152.91.154:37608,<->,246.253.222.199:domain,0,0,1,79,1,79,0.700618000,0.0000
198.185.158.73:21609,<->,92.27.219.17:17272,0,0,1,130,1,130,0.700345000,0.0000
144.75.218.242:25071,<->,8.222.218.207:domain,1,114,0,0,1,114,0.700272000,0.0000
39.235.56.149:20275,<->,59.35.252.53:domain,1,76,0,0,1,76,0.700046000,0.0000
215.158.2.127:54477,<->,8.176.8.234:domain,0,0,1,90,1,90,0.699773000,0.0000
136.129.71.19:38235,<->,147.61.214.19:domain,1,146,0,0,1,146,0.699123000,0.0000
107.99.137.90:27445,<->,108.134.119.186:domain,0,0,1,89,1,89,0.698878000,0.0000
108.246.28.215:63360,<->,109.222.217.93:domain,0,0,1,77,1,77,0.698861000,0.0000
136.25.188.105:55132,<->,140.136.9.105:domain,1,131,0,0,1,131,0.698848000,0.0000
144.75.218.237:43138,<->,8.222.218.207:domain,1,127,0,0,1,127,0.698403000,0.0000
215.158.103.219:35368,<->,159.151.90.195:domain,1,137,0,0,1,137,0.697202000,0.0000
159.80.143.31:60005,<->,159.80.129.217:51609,0,0,1,128,1,128,0.696881000,0.0000
207.66.33.41:12367,<->,129.224.112.252:domain,0,0,1,79,1,79,0.696823000,0.0000
96.190.12.63:55825,<->,139.248.201.139:ntp,0,0,1,80,1,80,0.696729000,0.0000
144.75.218.246:51534,<->,8.222.218.197:domain,1,123,0,0,1,123,0.696584000,0.0000
39.23.51.74:16775,<->,122.228.238.242:domain,1,68,0,0,1,68,0.696538000,0.0000
144.75.218.237:60313,<->,8.222.218.204:domain,1,110,0,0,1,110,0.695947000,0.0000
208.197.102.102:52608,<->,98.232.172.60:domain,0,0,1,75,1,75,0.695580000,0.0000
34.230.150.26:56909,<->,147.54.67.205:domain,1,538,0,0,1,538,0.695340000,0.0000
144.75.218.241:45355,<->,120.155.84.97:domain,1,172,0,0,1,172,0.695299000,0.0000
215.158.103.206:56893,<->,53.222.171.58:domain,1,82,0,0,1,82,0.694978000,0.0000
20.247.123.14:43367,<->,206.144.195.198:domain,1,80,0,0,1,80,0.694927000,0.0000
144.75.218.246:30446,<->,8.222.218.199:domain,1,110,0,0,1,110,0.694214000,0.0000
114.128.248.198:35578,<->,109.1.3.222:29103,0,0,1,58,1,58,0.694017000,0.0000
144.75.218.235:62373,<->,138.127.231.201:domain,1,237,0,0,1,237,0.693723000,0.0000
152.37.100.190:6881,<->,99.162.73.8:5091,0,0,1,135,1,135,0.693229000,0.0000
144.75.218.233:52683,<->,8.222.218.197:domain,1,110,0,0,1,110,0.692656000,0.0000
144.75.218.235:13682,<->,8.222.218.204:domain,1,110,0,0,1,110,0.691917000,0.0000
192.105.127.33:50718,<->,133.178.226.77:12347,0,0,1,1064,1,1064,0.691881000,0.0000
144.75.218.233:27723,<->,8.222.218.197:domain,1,126,0,0,1,126,0.691724000,0.0000
144.75.218.235:11773,<->,8.222.218.204:domain,1,123,0,0,1,123,0.691380000,0.0000
144.75.218.237:50552,<->,120.155.84.97:domain,1,143,0,0,1,143,0.691158000,0.0000
144.75.218.246:18575,<->,138.127.230.221:domain,1,365,0,0,1,365,0.691157000,0.0000
144.75.218.237:46667,<->,8.222.218.197:domain,1,153,0,0,1,153,0.690428000,0.0000
79.255.218.236:14143,<->,192.67.161.171:6881,0,0,1,133,1,133,0.690352000,0.0000
144.75.218.235:37026,<->,149.228.97.44:domain,1,127,0,0,1,127,0.690117000,0.0000
89.211.37.130:24020,<->,101.224.204.141:domain,0,0,1,85,1,85,0.689931000,0.0000
92.27.219.32:58347,<->,29.135.115.226:40413,1,351,0,0,1,351,0.689357000,0.0000
126.198.202.12:51413,<->,247.136.139.153:45405,0,0,1,317,1,317,0.688883000,0.0000
97.36.109.42:55414,<->,109.222.214.26:domain,0,0,1,66,1,66,0.688847000,0.0000
144.75.218.237:49313,<->,138.127.224.241:domain,1,215,0,0,1,215,0.688790000,0.0000
38.52.7.49:53556,<->,89.183.104.191:ntp,0,0,1,52,1,52,0.688396000,0.0000
74.240.66.155:15080,<->,98.217.9.93:6881,0,0,1,130,1,130,0.687962000,0.0000
204.140.159.18:12249,<->,39.15.169.14:domain,0,0,1,83,1,83,0.687785000,0.0000
39.133.58.192:cartographerxmp,<->,119.50.12.116:domain,1,78,0,0,1,78,0.687530000,0.0000
144.75.218.235:44214,<->,8.222.218.204:domain,1,110,0,0,1,110,0.687383000,0.0000
144.123.49.227:29868,<->,120.155.84.161:domain,1,139,0,0,1,139,0.687017000,0.0000
133.178.227.23:ntp,<->,128.156.144.228:ntp,1,80,0,0,1,80,0.685017000,0.0000
80.42.134.4:56141,<->,57.218.111.137:32252,1,321,0,0,1,321,0.684875000,0.0000
92.27.219.185:50730,<->,205.165.37.182:pictrography,1,349,0,0,1,349,0.684837000,0.0000
144.75.218.237:41012,<->,8.222.218.199:domain,1,110,0,0,1,110,0.684762000,0.0000
21.15.226.126:55104,<->,20.193.63.140:netbios-ns,0,0,1,82,1,82,0.684550000,0.0000
144.75.218.235:4809,<->,138.127.224.239:domain,1,366,0,0,1,366,0.684474000,0.0000
215.158.103.219:55657,<->,120.155.86.176:domain,1,77,0,0,1,77,0.684432000,0.0000
99.73.184.38:51827,<->,142.235.87.114:avocent-proxy,1,100,0,0,1,100,0.684224000,0.0000
29.212.196.10:37788,<->,136.25.189.94:domain,0,0,1,83,1,83,0.683815000,0.0000
144.75.218.241:13739,<->,8.222.218.207:domain,1,113,0,0,1,113,0.683298000,0.0000
144.75.218.242:33887,<->,8.222.218.199:domain,1,121,0,0,1,121,0.681913000,0.0000
144.75.218.246:51634,<->,8.222.218.197:domain,1,121,0,0,1,121,0.681840000,0.0000
144.75.218.242:26318,<->,8.222.218.199:domain,1,110,0,0,1,110,0.681833000,0.0000
144.75.218.242:20858,<->,8.222.218.199:domain,1,111,0,0,1,111,0.681501000,0.0000
144.75.218.241:62264,<->,8.222.218.204:domain,1,113,0,0,1,113,0.681350000,0.0000
159.49.96.73:33732,<->,215.158.238.180:12347,0,0,1,1064,1,1064,0.681303000,0.0000
144.75.218.242:54588,<->,8.222.218.199:domain,1,113,0,0,1,113,0.680880000,0.0000
144.54.14.68:14609,<->,132.249.70.213:domain,0,0,1,141,1,141,0.680599000,0.0000
144.75.218.237:56695,<->,120.155.84.97:domain,1,169,0,0,1,169,0.680499000,0.0000
144.75.218.241:39736,<->,132.6.55.46:domain,1,147,0,0,1,147,0.679887000,0.0000
20.220.65.11:17468,<->,126.25.17.12:domain,1,147,0,0,1,147,0.679786000,0.0000
92.27.219.232:49824,<->,134.195.15.243:34330,1,66,0,0,1,66,0.679170000,0.0000
145.242.126.23:51235,<->,149.200.220.216:ntp,1,80,0,0,1,80,0.679157000,0.0000
100.211.114.205:7840,<->,101.224.183.152:domain,0,0,1,79,1,79,0.678995000,0.0000
144.75.218.237:55692,<->,8.222.218.198:domain,1,122,0,0,1,122,0.678573000,0.0000
144.75.218.233:prismiq-plugin,<->,8.222.218.204:domain,1,127,0,0,1,127,0.677683000,0.0000
144.75.218.246:51800,<->,8.222.218.204:domain,1,110,0,0,1,110,0.677435000,0.0000
72.43.45.118:54200,<->,92.27.27.143:50419,0,0,1,52,1,52,0.677132000,0.0000
39.146.97.79:53154,<->,194.196.213.236:domain,1,70,0,0,1,70,0.677009000,0.0000
39.160.63.11:20084,<->,149.201.60.62:13885,1,130,0,0,1,130,0.676870000,0.0000
144.75.218.246:54086,<->,8.222.218.197:domain,1,110,0,0,1,110,0.676747000,0.0000
144.75.218.246:30714,<->,148.111.30.85:domain,1,75,0,0,1,75,0.676393000,0.0000
144.75.218.246:21805,<->,140.142.131.1:domain,1,77,0,0,1,77,0.676241000,0.0000
144.75.218.235:53759,<->,139.252.1.242:domain,1,226,0,0,1,226,0.675332000,0.0000
144.79.8.89:27020,<->,89.183.110.30:21002,0,0,1,68,1,68,0.675309000,0.0000
144.86.148.228:39301,<->,27.11.52.246:24441,1,95,0,0,1,95,0.675197000,0.0000
215.158.239.103:62660,<->,139.252.1.233:domain,1,160,0,0,1,160,0.675133000,0.0000
144.75.218.246:33019,<->,8.222.218.199:domain,1,111,0,0,1,111,0.674994000,0.0000
102.50.47.32:51413,<->,42.90.92.235:6881,1,326,0,0,1,326,0.674808000,0.0000
144.75.218.242:61172,<->,8.222.218.199:domain,1,122,0,0,1,122,0.674734000,0.0000
6.130.73.133:41340,<->,48.53.240.104:20023,0,0,1,52,1,52,0.674405000,0.0000
21.15.226.126:55104,<->,20.193.63.27:netbios-ns,0,0,1,82,1,82,0.674161000,0.0000
215.158.103.219:47973,<->,157.110.115.195:domain,1,89,0,0,1,89,0.673997000,0.0000
74.1.12.192:30397,<->,129.224.112.252:domain,0,0,1,82,1,82,0.673372000,0.0000
92.22.181.95:35596,<->,98.67.140.202:domain,0,0,1,68,1,68,0.672178000,0.0000
39.224.180.235:35805,<->,127.29.150.181:domain,1,74,0,0,1,74,0.672128000,0.0000
144.75.218.235:19175,<->,8.222.218.204:domain,1,113,0,0,1,113,0.672047000,0.0000
199.29.88.191:32925,<->,92.27.27.151:29924,0,0,1,263,1,263,0.671847000,0.0000
144.75.218.237:21600,<->,8.222.218.204:domain,1,109,0,0,1,109,0.671830000,0.0000
229.59.1.44:15293,<->,220.55.79.118:domain,0,0,1,70,1,70,0.671723000,0.0000
6.147.69.18:36787,<->,159.69.187.4:domain,0,0,1,80,1,80,0.671556000,0.0000
144.75.218.241:9261,<->,8.222.218.207:domain,1,110,0,0,1,110,0.671114000,0.0000
126.103.58.218:10024,<->,92.27.219.237:ininmessaging,0,0,1,321,1,321,0.670894000,0.0000
89.183.104.157:47844,<->,129.245.206.220:domain,1,659,0,0,1,659,0.670866000,0.0000
134.254.243.178:28960,<->,101.224.191.148:28960,0,0,1,50,1,50,0.669580000,0.0000
122.158.179.74:38023,<->,215.158.239.66:domain,0,0,1,85,1,85,0.669564000,0.0000
210.220.219.153:52585,<->,111.20.47.86:domain,1,118,0,0,1,118,0.669563000,0.0000
97.126.116.180:60870,<->,129.229.242.60:domain,1,142,0,0,1,142,0.669358000,0.0000
144.75.218.233:40821,<->,8.222.218.204:domain,1,120,0,0,1,120,0.668988000,0.0000
127.250.7.59:51462,<->,98.67.136.238:domain,0,0,1,78,1,78,0.668923000,0.0000
69.221.65.158:49143,<->,34.92.85.203:nip,0,0,1,52,1,52,0.668501000,0.0000
130.37.102.18:9354,<->,39.214.55.177:domain,0,0,1,86,1,86,0.668142000,0.0000
8.176.8.215:33707,<->,120.154.172.95:domain,1,111,0,0,1,111,0.667983000,0.0000
144.95.255.201:54086,<->,246.254.97.149:domain,0,0,1,89,1,89,0.667745000,0.0000
80.40.48.220:28221,<->,118.103.74.218:16306,1,130,0,0,1,130,0.666981000,0.0000
205.209.170.212:20635,<->,80.40.24.193:6881,0,0,1,319,1,319,0.666842000,0.0000
136.25.188.105:56900,<->,129.70.124.49:domain,1,126,0,0,1,126,0.664556000,0.0000
144.75.218.246:45243,<->,138.127.231.82:domain,1,254,0,0,1,254,0.663885000,0.0000
144.75.218.237:39551,<->,8.222.218.198:domain,1,123,0,0,1,123,0.663882000,0.0000
144.75.218.246:facsys-router,<->,8.222.218.199:domain,1,111,0,0,1,111,0.663861000,0.0000
136.25.188.105:63804,<->,149.246.94.20:domain,1,180,0,0,1,180,0.663701000,0.0000
101.70.119.29:40200,<->,86.242.75.89:22217,1,135,0,0,1,135,0.663585000,0.0000
116.236.186.198:35332,<->,39.22.82.29:sxmp,0,0,1,667,1,667,0.663545000,0.0000
54.60.194.157:23653,<->,144.69.82.139:domain,0,0,1,75,1,75,0.663035000,0.0000
144.75.218.233:61315,<->,8.222.218.204:domain,1,113,0,0,1,113,0.662894000,0.0000
143.230.124.191:36705,<->,129.224.112.252:domain,0,0,1,83,1,83,0.662856000,0.0000
144.75.218.246:53232,<->,138.127.230.132:domain,1,275,0,0,1,275,0.662842000,0.0000
121.35.112.201:23023,<->,92.27.219.128:netview-aix-11,0,0,1,1446,1,1446,0.662720000,0.0000
247.136.254.97:57948,<->,221.196.94.56:25662,1,136,0,0,1,136,0.662714000,0.0000
144.75.218.246:55010,<->,8.222.218.197:domain,1,110,0,0,1,110,0.662613000,0.0000
195.77.22.79:58840,<->,159.137.212.194:11580,0,0,1,104,1,104,0.662542000,0.0000
8.219.186.181:58647,<->,29.211.214.80:domain,0,0,1,73,1,73,0.662307000,0.0000
97.126.26.70:18701,<->,138.127.224.103:domain,1,226,0,0,1,226,0.662143000,0.0000
76.72.246.226:14497,<->,249.101.103.55:6881,0,0,1,133,1,133,0.661758000,0.0000
:::36385,<->,:::domain,1,176,0,0,1,176,0.661744000,0.0000
105.234.75.198:40500,<->,109.222.195.53:11136,0,0,1,52,1,52,0.660944000,0.0000
144.75.218.241:36392,<->,8.222.218.204:domain,1,123,0,0,1,123,0.660880000,0.0000
144.75.218.246:42423,<->,138.127.230.132:domain,1,275,0,0,1,275,0.660121000,0.0000
144.75.218.241:23133,<->,8.222.218.207:domain,1,157,0,0,1,157,0.660073000,0.0000
144.75.218.246:14039,<->,8.222.218.199:domain,1,122,0,0,1,122,0.659966000,0.0000
144.75.218.242:dcs,<->,138.127.225.29:domain,1,365,0,0,1,365,0.659445000,0.0000
215.158.103.219:11550,<->,80.56.76.191:domain,1,77,0,0,1,77,0.659433000,0.0000
230.115.135.194:21818,<->,247.157.159.32:6881,0,0,1,133,1,133,0.659299000,0.0000
200.226.80.179:62331,<->,129.92.113.143:chargen,0,0,1,50,1,50,0.658768000,0.0000
89.139.241.98:30686,<->,138.127.224.238:domain,1,221,0,0,1,221,0.658566000,0.0000
144.75.218.242:43849,<->,8.222.218.196:domain,1,122,0,0,1,122,0.658493000,0.0000
8.238.59.156:57857,<->,156.30.10.180:11717,1,133,0,0,1,133,0.657790000,0.0000
192.65.80.104:53324,<->,112.70.38.65:27683,1,349,0,0,1,349,0.657324000,0.0000
20.176.48.109:31000,<->,121.13.86.14:orbix-config,1,50,0,0,1,50,0.657234000,0.0000
132.20.222.234:34791,<->,129.224.112.221:domain,0,0,1,72,1,72,0.656811000,0.0000
98.67.155.63:52286,<->,53.196.208.123:domain,1,162,0,0,1,162,0.656777000,0.0000
144.75.218.233:54445,<->,138.127.231.221:domain,1,310,0,0,1,310,0.656593000,0.0000
136.25.188.105:63505,<->,132.43.156.81:domain,1,139,0,0,1,139,0.654619000,0.0000
215.158.103.206:32945,<->,29.214.217.32:domain,1,146,0,0,1,146,0.654443000,0.0000
144.75.218.246:41370,<->,138.127.225.29:domain,1,365,0,0,1,365,0.654428000,0.0000
:::43601,<->,:::domain,1,125,0,0,1,125,0.654333000,0.0000
92.162.252.32:14440,<->,116.110.29.86:domain,1,119,0,0,1,119,0.654175000,0.0000
200.226.80.179:ldoms-mgmt,<->,129.92.113.143:chargen,0,0,1,50,1,50,0.654048000,0.0000
215.158.103.219:12131,<->,65.192.53.21:domain,1,135,0,0,1,135,0.653801000,0.0000
144.75.218.242:16314,<->,93.77.5.122:domain,1,77,0,0,1,77,0.653223000,0.0000
220.55.91.56:domain,<->,57.212.60.129:domain,1,122,0,0,1,122,0.652885000,0.0000
8.252.222.202:41334,<->,192.171.13.80:domain,1,225,0,0,1,225,0.652678000,0.0000
80.40.25.242:40500,<->,38.52.146.167:17892,1,52,0,0,1,52,0.652575000,0.0000
8.252.222.202:57376,<->,192.171.13.80:domain,1,163,0,0,1,163,0.652507000,0.0000
94.192.198.174:27607,<->,90.240.131.44:18739,0,0,1,319,1,319,0.651890000,0.0000
144.75.218.237:22301,<->,138.127.231.102:domain,1,263,0,0,1,263,0.651799000,0.0000
215.158.239.120:34060,<->,158.85.35.242:domain,1,141,0,0,1,141,0.651680000,0.0000
53.199.195.19:57508,<->,246.253.248.211:domain,0,0,1,86,1,86,0.651620000,0.0000
144.75.218.246:7158,<->,8.222.218.197:domain,1,110,0,0,1,110,0.650961000,0.0000
230.9.8.84:14038,<->,220.87.49.198:fiorano-rtrsvc,0,0,1,130,1,130,0.650783000,0.0000
206.54.196.41:17542,<->,247.136.231.91:6881,0,0,1,52,1,52,0.650079000,0.0000
144.75.218.241:64703,<->,8.222.218.207:domain,1,110,0,0,1,110,0.649723000,0.0000
0.200.50.50:34233,<->,20.13.109.47:domain,0,0,1,60,1,60,0.649360000,0.0000
144.75.218.237:51598,<->,8.222.218.207:domain,1,110,0,0,1,110,0.649229000,0.0000
243.117.125.15:6383,<->,129.224.112.252:domain,0,0,1,95,1,95,0.648202000,0.0000
92.27.219.178:15738,<->,57.208.126.68:boinc-client,1,52,0,0,1,52,0.647936000,0.0000
144.75.218.241:42951,<->,56.115.164.225:domain,1,175,0,0,1,175,0.647860000,0.0000
144.75.218.241:48647,<->,8.222.218.207:domain,1,111,0,0,1,111,0.647740000,0.0000
144.75.218.237:44160,<->,8.222.218.207:domain,1,219,0,0,1,219,0.646513000,0.0000
20.69.10.247:57662,<->,195.36.141.86:domain,1,74,0,0,1,74,0.645733000,0.0000
118.100.40.167:38715,<->,247.136.227.198:11867,0,0,1,321,1,321,0.645689000,0.0000
136.25.189.5:33808,<->,239.170.100.210:domain,1,165,0,0,1,165,0.645215000,0.0000
67.128.27.205:sms-chat,<->,145.252.126.61:domain,0,0,1,76,1,76,0.644271000,0.0000
93.73.95.165:bctp,<->,89.183.104.232:6881,0,0,1,52,1,52,0.644242000,0.0000
20.238.248.215:36150,<->,33.246.152.154:domain,1,72,0,0,1,72,0.644047000,0.0000
144.75.218.242:44654,<->,8.222.218.207:domain,1,109,0,0,1,109,0.644004000,0.0000
230.116.229.58:42289,<->,98.129.112.215:31874,0,0,1,149,1,149,0.643770000,0.0000
199.13.105.183:53760,<->,100.92.220.68:15749,0,0,1,52,1,52,0.642851000,0.0000
118.120.58.175:52656,<->,100.94.88.51:37189,0,0,1,149,1,149,0.641277000,0.0000
92.27.219.187:35061,<->,193.46.99.150:21430,1,90,0,0,1,90,0.641167000,0.0000
80.38.56.151:55916,<->,132.43.156.54:domain,1,774,0,0,1,774,0.640883000,0.0000
136.25.188.105:51841,<->,143.194.53.201:domain,1,251,0,0,1,251,0.640876000,0.0000
87.62.245.7:59613,<->,92.27.219.139:http-alt,0,0,1,101,1,101,0.640804000,0.0000
144.75.218.237:35102,<->,8.222.218.204:domain,1,123,0,0,1,123,0.640767000,0.0000
144.87.235.187:48118,<->,138.127.225.227:domain,1,252,0,0,1,252,0.640603000,0.0000
39.39.180.244:35682,<->,147.176.48.103:domain,1,140,0,0,1,140,0.640584000,0.0000
21.15.226.126:55104,<->,20.193.62.73:netbios-ns,0,0,1,82,1,82,0.640090000,0.0000
92.27.219.231:63146,<->,206.63.227.193:crestron-cip,1,1377,0,0,1,1377,0.640057000,0.0000
39.11.125.130:53445,<->,131.233.74.166:domain,1,76,0,0,1,76,0.638947000,0.0000
144.75.218.246:40912,<->,138.127.231.221:domain,1,326,0,0,1,326,0.638926000,0.0000
144.75.218.246:24579,<->,8.222.218.197:domain,1,119,0,0,1,119,0.638554000,0.0000
139.163.45.228:8371,<->,138.127.224.243:domain,1,245,0,0,1,245,0.638227000,0.0000
144.75.218.237:59131,<->,136.129.94.109:domain,1,90,0,0,1,90,0.637710000,0.0000
197.197.68.90:54064,<->,129.224.112.252:domain,0,0,1,73,1,73,0.637664000,0.0000
144.75.218.235:15560,<->,8.222.218.204:domain,1,113,0,0,1,113,0.637390000,0.0000
144.75.218.241:rhp-iibp,<->,8.222.218.207:domain,1,110,0,0,1,110,0.636903000,0.0000
8.252.222.119:36879,<->,192.171.13.80:domain,1,134,0,0,1,134,0.636062000,0.0000
97.242.126.180:34699,<->,129.224.112.252:domain,0,0,1,81,1,81,0.635871000,0.0000
144.75.218.241:31034,<->,8.222.218.207:domain,1,110,0,0,1,110,0.635715000,0.0000
72.145.48.171:vocaltec-gold,<->,98.67.130.23:domain,0,0,1,80,1,80,0.635642000,0.0000
133.202.60.104:32324,<->,192.64.217.166:1024,0,0,1,52,1,52,0.635575000,0.0000
38.254.212.90:60522,<->,247.136.186.159:35323,0,0,1,58,1,58,0.635119000,0.0000
80.41.55.98:26902,<->,69.95.118.50:14382,1,130,0,0,1,130,0.634948000,0.0000
20.167.131.155:12955,<->,68.154.104.122:domain,1,517,0,0,1,517,0.634333000,0.0000
33.57.74.181:17474,<->,220.55.75.167:domain,0,0,1,75,1,75,0.633817000,0.0000
144.75.218.246:49410,<->,8.222.218.197:domain,1,110,0,0,1,110,0.633652000,0.0000
210.158.44.208:52114,<->,120.155.84.161:domain,1,125,0,0,1,125,0.633640000,0.0000
144.75.218.237:44988,<->,8.222.218.207:domain,1,122,0,0,1,122,0.632609000,0.0000
92.27.219.171:46286,<->,93.237.78.161:15156,1,261,0,0,1,261,0.632481000,0.0000
205.77.98.134:30966,<->,92.27.27.142:15921,0,0,1,97,1,97,0.632389000,0.0000
124.152.54.18:21392,<->,144.64.139.146:domain,0,0,1,80,1,80,0.630083000,0.0000
39.40.129.5:20572,<->,127.178.109.106:domain,1,70,0,0,1,70,0.629752000,0.0000
194.105.236.216:13448,<->,129.224.112.252:domain,0,0,1,83,1,83,0.629622000,0.0000
33.110.84.133:26908,<->,129.224.112.253:domain,0,0,1,79,1,79,0.629282000,0.0000
129.175.139.97:52703,<->,29.211.214.32:domain,0,0,1,121,1,121,0.628768000,0.0000
144.75.218.241:58045,<->,8.222.218.207:domain,1,159,0,0,1,159,0.628678000,0.0000
8.181.148.191:56395,<->,133.178.226.246:domain,0,0,1,90,1,90,0.628531000,0.0000
111.4.160.48:12220,<->,109.222.246.201:domain,0,0,1,72,1,72,0.628036000,0.0000
144.75.218.241:rdlap,<->,8.222.218.207:domain,1,122,0,0,1,122,0.627167000,0.0000
144.75.218.246:25723,<->,138.127.224.134:domain,1,366,0,0,1,366,0.626837000,0.0000
105.69.92.96:65026,<->,129.224.112.252:domain,0,0,1,67,1,67,0.626372000,0.0000
21.15.226.126:55104,<->,20.193.62.180:netbios-ns,0,0,1,82,1,82,0.626027000,0.0000
64.76.59.13:27179,<->,139.163.1.182:domain,0,0,1,73,1,73,0.626023000,0.0000
105.67.198.52:23183,<->,129.224.112.252:domain,0,0,1,60,1,60,0.626020000,0.0000
91.54.155.124:48218,<->,132.249.70.233:domain,0,0,1,85,1,85,0.625609000,0.0000
144.75.218.242:oceansoft-lm,<->,8.222.218.207:domain,1,111,0,0,1,111,0.625356000,0.0000
193.47.198.199:60263,<->,8.53.8.151:bacnet,0,0,1,67,1,67,0.625149000,0.0000
144.75.218.242:21338,<->,8.222.218.204:domain,1,110,0,0,1,110,0.625034000,0.0000
144.75.218.233:12787,<->,8.222.218.197:domain,1,124,0,0,1,124,0.624926000,0.0000
144.75.218.235:12233,<->,138.127.225.15:domain,1,218,0,0,1,218,0.624718000,0.0000
196.31.80.207:53096,<->,89.183.104.254:12278,0,0,1,52,1,52,0.624656000,0.0000
215.158.239.226:41666,<->,53.85.130.165:domain,1,343,0,0,1,343,0.624425000,0.0000
144.75.218.237:31477,<->,8.222.218.207:domain,1,122,0,0,1,122,0.624329000,0.0000
144.75.218.237:17505,<->,8.222.218.207:domain,1,123,0,0,1,123,0.624224000,0.0000
95.5.80.232:34164,<->,144.85.74.147:domain,0,0,1,78,1,78,0.623823000,0.0000
106.157.38.242:53126,<->,108.134.108.77:sercomm-scadmin,0,0,1,50,1,50,0.623643000,0.0000
8.252.222.202:41374,<->,192.171.13.33:domain,1,445,0,0,1,445,0.623553000,0.0000
20.194.127.11:65157,<->,42.48.61.109:58771,1,84,0,0,1,84,0.623462000,0.0000
8.252.222.202:49424,<->,192.171.13.33:domain,1,97,0,0,1,97,0.623135000,0.0000
144.75.218.235:37836,<->,8.222.218.204:domain,1,125,0,0,1,125,0.622791000,0.0000
111.147.184.124:65317,<->,204.129.248.132:1031,1,50,0,0,1,50,0.622465000,0.0000
106.157.38.242:53126,<->,108.134.108.77:12797,0,0,1,50,1,50,0.622455000,0.0000
144.93.125.48:36893,<->,144.93.121.86:27281,0,0,1,104,1,104,0.622423000,0.0000
21.15.226.126:55104,<->,20.193.62.175:netbios-ns,0,0,1,82,1,82,0.622258000,0.0000
80.40.56.250:51413,<->,69.255.253.238:50183,1,62,0,0,1,62,0.622129000,0.0000
106.157.38.242:53126,<->,108.134.108.77:smar-se-port2,0,0,1,50,1,50,0.621480000,0.0000
92.181.30.186:22490,<->,202.198.184.100:19605,1,133,0,0,1,133,0.621141000,0.0000
106.157.38.242:53126,<->,108.134.108.77:25685,0,0,1,50,1,50,0.620981000,0.0000
144.75.218.235:53780,<->,138.127.231.127:domain,1,300,0,0,1,300,0.620637000,0.0000
144.75.218.233:34925,<->,8.222.218.196:domain,1,121,0,0,1,121,0.620413000,0.0000
91.231.118.234:9652,<->,101.224.183.152:domain,0,0,1,85,1,85,0.620307000,0.0000
108.134.108.77:58545,<->,106.157.38.242:53126,1,50,0,0,1,50,0.619944000,0.0000
126.219.102.216:53750,<->,215.158.238.162:domain,0,0,1,85,1,85,0.619886000,0.0000
144.75.218.237:48577,<->,8.222.218.199:domain,1,223,0,0,1,223,0.619708000,0.0000
:::37199,<->,:::domain,1,299,0,0,1,299,0.619640000,0.0000
210.150.233.86:60135,<->,50.224.103.163:domain,0,0,1,82,1,82,0.619626000,0.0000
8.35.106.225:51787,<->,136.25.189.245:domain,0,0,1,90,1,90,0.619623000,0.0000
205.186.197.249:60000,<->,92.27.219.224:46624,0,0,1,135,1,135,0.619153000,0.0000
144.75.218.233:22577,<->,8.47.123.78:domain,1,169,0,0,1,169,0.618865000,0.0000
115.146.247.141:10672,<->,92.27.219.221:bctp,0,0,1,52,1,52,0.618701000,0.0000
144.75.218.246:33032,<->,8.222.218.197:domain,1,110,0,0,1,110,0.618530000,0.0000
106.157.38.242:53126,<->,108.134.108.77:18132,0,0,1,50,1,50,0.618201000,0.0000
8.252.222.202:58286,<->,192.171.13.80:domain,1,214,0,0,1,214,0.618141000,0.0000
136.25.189.5:47963,<->,8.220.7.141:domain,1,163,0,0,1,163,0.617453000,0.0000
106.157.38.242:53126,<->,108.134.108.77:36421,0,0,1,50,1,50,0.616940000,0.0000
108.134.108.77:56378,<->,106.157.38.242:53126,1,50,0,0,1,50,0.616926000,0.0000
144.75.218.242:57072,<->,8.222.218.199:domain,1,110,0,0,1,110,0.616887000,0.0000
144.75.218.242:22078,<->,63.69.219.68:domain,1,151,0,0,1,151,0.616692000,0.0000
144.75.218.246:34541,<->,138.127.224.101:domain,1,83,0,0,1,83,0.616572000,0.0000
108.134.108.77:59645,<->,106.157.38.242:53126,1,50,0,0,1,50,0.616543000,0.0000
136.25.189.5:57336,<->,139.252.1.230:domain,1,150,0,0,1,150,0.616481000,0.0000
20.55.81.183:16197,<->,143.43.193.150:domain,1,80,0,0,1,80,0.616242000,0.0000
106.157.38.242:53126,<->,108.134.108.77:5865,0,0,1,50,1,50,0.615309000,0.0000
80.40.47.46:28339,<->,38.176.33.155:7623,1,130,0,0,1,130,0.614898000,0.0000
144.75.218.246:24084,<->,61.72.2.11:domain,1,184,0,0,1,184,0.614861000,0.0000
136.25.189.5:60404,<->,8.220.7.141:domain,1,225,0,0,1,225,0.614809000,0.0000
143.252.64.234:17258,<->,129.224.112.252:domain,0,0,1,77,1,77,0.614672000,0.0000
75.189.136.225:semaphore,<->,39.131.50.38:domain,0,0,1,73,1,73,0.614510000,0.0000
106.157.38.242:53126,<->,108.134.108.77:6759,0,0,1,50,1,50,0.614220000,0.0000
29.90.24.187:61519,<->,89.183.104.137:30132,0,0,1,52,1,52,0.613996000,0.0000
144.75.218.241:23750,<->,138.127.224.101:domain,1,83,0,0,1,83,0.613930000,0.0000
192.67.149.36:43409,<->,27.41.97.78:13665,1,135,0,0,1,135,0.613037000,0.0000
106.157.38.242:53126,<->,108.134.108.77:44414,0,0,1,50,1,50,0.613024000,0.0000
206.16.142.172:63933,<->,109.222.192.55:23898,0,0,1,98,1,98,0.612728000,0.0000
106.157.38.242:53126,<->,108.134.108.77:10405,0,0,1,50,1,50,0.611986000,0.0000
136.25.188.105:53481,<->,132.43.156.81:domain,1,278,0,0,1,278,0.611928000,0.0000
69.175.125.228:51413,<->,92.27.27.175:20715,0,0,1,55,1,55,0.611814000,0.0000
144.75.218.235:24477,<->,99.168.7.150:domain,1,154,0,0,1,154,0.611779000,0.0000
193.88.67.36:62919,<->,92.27.219.203:48306,0,0,1,133,1,133,0.611762000,0.0000
106.157.38.242:53126,<->,108.134.108.77:epmd,0,0,1,50,1,50,0.611625000,0.0000
106.157.38.242:53126,<->,108.134.108.77:50283,0,0,1,50,1,50,0.610955000,0.0000
144.75.218.237:10654,<->,138.127.230.221:domain,1,83,0,0,1,83,0.610477000,0.0000
101.122.133.46:62690,<->,17.3.209.41:https,1,1101,0,0,1,1101,0.609912000,0.0000
92.162.219.24:56699,<->,129.224.112.252:domain,0,0,1,83,1,83,0.609766000,0.0000
144.75.218.246:11032,<->,8.222.218.199:domain,1,113,0,0,1,113,0.609711000,0.0000
43.40.65.48:63614,<->,109.222.215.151:domain,0,0,1,66,1,66,0.609418000,0.0000
108.134.108.77:57273,<->,106.157.38.242:53126,1,50,0,0,1,50,0.609340000,0.0000
215.158.103.206:63218,<->,138.127.224.101:domain,1,84,0,0,1,84,0.609213000,0.0000
136.25.189.5:50443,<->,145.116.223.24:domain,1,105,0,0,1,105,0.608965000,0.0000
144.108.80.174:53393,<->,159.69.187.23:domain,0,0,1,63,1,63,0.608917000,0.0000
106.157.38.242:53126,<->,108.134.108.77:18996,0,0,1,50,1,50,0.608898000,0.0000
136.25.189.5:41651,<->,8.220.7.141:domain,1,117,0,0,1,117,0.608602000,0.0000
206.193.40.158:33446,<->,247.136.199.176:25745,0,0,1,133,1,133,0.608412000,0.0000
126.254.93.101:17512,<->,247.136.231.91:6881,0,0,1,151,1,151,0.608399000,0.0000
144.75.218.241:17534,<->,8.222.218.207:domain,1,110,0,0,1,110,0.608134000,0.0000
136.129.66.2:30321,<->,4.129.155.120:6881,1,98,0,0,1,98,0.604921000,0.0000
144.75.218.241:38342,<->,99.168.7.150:domain,1,154,0,0,1,154,0.604789000,0.0000
206.141.76.213:58911,<->,22.59.8.212:28016,0,0,1,57,1,57,0.604539000,0.0000
80.42.150.137:61724,<->,148.129.33.51:26799,1,319,0,0,1,319,0.604525000,0.0000
192.67.160.166:36591,<->,112.179.117.29:6881,1,309,0,0,1,309,0.604461000,0.0000
136.25.188.105:59933,<->,128.243.151.33:domain,1,222,0,0,1,222,0.604035000,0.0000
119.74.223.209:60189,<->,192.64.217.166:1024,0,0,1,52,1,52,0.603793000,0.0000
27.188.163.162:i-net-2000-npr,<->,109.1.17.59:sip,0,0,1,445,1,445,0.603255000,0.0000
136.25.188.105:58933,<->,140.136.9.105:domain,1,251,0,0,1,251,0.603150000,0.0000
215.158.239.120:52606,<->,158.85.35.245:domain,1,111,0,0,1,111,0.602742000,0.0000
74.1.12.192:40388,<->,129.224.112.252:domain,0,0,1,80,1,80,0.601739000,0.0000
97.203.79.109:60792,<->,129.224.112.252:domain,0,0,1,85,1,85,0.601739000,0.0000
144.75.218.242:56307,<->,8.222.218.199:domain,1,158,0,0,1,158,0.601533000,0.0000
38.30.142.248:36748,<->,215.158.238.161:domain,0,0,1,84,1,84,0.601153000,0.0000
92.27.27.167:41832,<->,111.71.7.41:23688,1,80,0,0,1,80,0.600881000,0.0000
20.10.108.125:33365,<->,146.200.130.17:domain,1,128,0,0,1,128,0.600272000,0.0000
78.129.196.251:33817,<->,39.15.169.14:domain,0,0,1,87,1,87,0.600239000,0.0000
39.29.190.79:32506,<->,197.19.51.22:domain,1,136,0,0,1,136,0.599836000,0.0000
92.27.219.184:62348,<->,104.133.149.237:61402,1,52,0,0,1,52,0.599831000,0.0000
13.13.239.177:61875,<->,102.224.161.182:domain,0,0,1,66,1,66,0.599660000,0.0000
8.176.8.215:48988,<->,8.33.227.3:domain,1,112,0,0,1,112,0.599028000,0.0000
8.252.222.171:42000,<->,192.171.13.33:domain,1,156,0,0,1,156,0.599010000,0.0000
8.176.8.211:42491,<->,96.228.67.219:domain,1,175,0,0,1,175,0.598349000,0.0000
33.43.48.64:12098,<->,102.224.161.182:domain,0,0,1,66,1,66,0.597942000,0.0000
144.75.218.233:27287,<->,8.222.218.197:domain,1,111,0,0,1,111,0.597242000,0.0000
144.75.218.242:15777,<->,138.127.231.255:domain,1,268,0,0,1,268,0.596870000,0.0000
144.75.218.246:46366,<->,8.222.218.199:domain,1,124,0,0,1,124,0.596593000,0.0000
144.75.218.233:mysql-im,<->,8.222.218.204:domain,1,149,0,0,1,149,0.596355000,0.0000
144.75.218.241:17329,<->,159.57.86.226:domain,1,200,0,0,1,200,0.596291000,0.0000
145.172.91.126:23067,<->,92.27.219.61:openvpn,0,0,1,197,1,197,0.596181000,0.0000
129.209.91.81:47459,<->,129.224.112.252:domain,0,0,1,67,1,67,0.595654000,0.0000
144.69.101.193:8314,<->,144.122.240.242:domain,0,0,1,87,1,87,0.595096000,0.0000
80.41.53.34:12242,<->,158.163.154.138:6881,1,323,0,0,1,323,0.594950000,0.0000
99.72.161.96:19102,<->,196.25.219.50:6881,1,321,0,0,1,321,0.594881000,0.0000
198.126.17.101:35691,<->,8.228.214.155:32022,0,0,1,135,1,135,0.594515000,0.0000
21.15.226.126:55104,<->,20.193.62.245:netbios-ns,0,0,1,82,1,82,0.594490000,0.0000
80.40.37.166:6881,<->,42.90.92.230:6881,1,88,0,0,1,88,0.594189000,0.0000
144.75.218.246:49969,<->,8.222.218.199:domain,1,110,0,0,1,110,0.593101000,0.0000
:::28475,<->,:::domain,0,0,1,112,1,112,0.592770000,0.0000
21.15.226.126:55104,<->,20.193.62.246:netbios-ns,0,0,1,82,1,82,0.592215000,0.0000
144.75.218.233:52472,<->,8.222.218.197:domain,1,121,0,0,1,121,0.591788000,0.0000
92.27.219.38:25521,<->,73.71.104.177:21278,1,52,0,0,1,52,0.591707000,0.0000
136.25.188.105:59128,<->,99.115.245.101:domain,1,338,0,0,1,338,0.591379000,0.0000
144.75.218.237:visicron-vs,<->,120.155.84.97:domain,1,174,0,0,1,174,0.590846000,0.0000
129.78.114.107:33769,<->,119.94.225.50:domain,1,145,0,0,1,145,0.590778000,0.0000
121.204.192.178:56831,<->,92.27.219.187:35093,0,0,1,77,1,77,0.590165000,0.0000
55.53.96.252:60235,<->,8.228.209.63:domain,0,0,1,77,1,77,0.589657000,0.0000
144.75.218.241:40352,<->,8.222.218.204:domain,1,125,0,0,1,125,0.589168000,0.0000
39.196.108.21:56443,<->,148.249.205.202:19749,1,75,0,0,1,75,0.588521000,0.0000
210.157.133.68:30053,<->,89.183.104.178:cdbroker,0,0,1,52,1,52,0.588500000,0.0000
107.255.237.151:43566,<->,109.222.250.168:domain,0,0,1,69,1,69,0.587519000,0.0000
144.75.218.246:14055,<->,138.127.224.101:domain,1,84,0,0,1,84,0.587240000,0.0000
92.27.219.210:57839,<->,149.76.140.130:21741,1,120,0,0,1,120,0.586843000,0.0000
92.27.219.224:46837,<->,254.75.90.114:19301,1,106,0,0,1,106,0.586381000,0.0000
144.75.218.233:63442,<->,8.222.218.197:domain,1,109,0,0,1,109,0.586220000,0.0000
144.75.218.242:27691,<->,8.222.218.196:domain,1,114,0,0,1,114,0.585569000,0.0000
21.15.226.126:55104,<->,20.193.55.141:netbios-ns,0,0,1,82,1,82,0.585226000,0.0000
129.78.114.107:52599,<->,119.94.225.50:domain,1,145,0,0,1,145,0.585221000,0.0000
129.78.114.107:40612,<->,119.94.225.50:domain,1,145,0,0,1,145,0.585146000,0.0000
117.228.237.160:63843,<->,92.27.209.236:27016,0,0,1,57,1,57,0.584698000,0.0000
144.75.218.235:39588,<->,138.127.230.228:domain,1,366,0,0,1,366,0.584238000,0.0000
127.210.82.224:20408,<->,247.136.133.19:17753,0,0,1,135,1,135,0.583859000,0.0000
144.75.218.237:57260,<->,8.222.218.198:domain,1,111,0,0,1,111,0.583559000,0.0000
144.75.218.246:28424,<->,8.222.218.197:domain,1,111,0,0,1,111,0.583526000,0.0000
127.112.186.151:52482,<->,92.27.219.43:51413,0,0,1,52,1,52,0.582717000,0.0000
220.83.18.46:38200,<->,156.142.17.231:16001,1,133,0,0,1,133,0.582700000,0.0000
144.75.218.242:29441,<->,8.222.218.207:domain,1,114,0,0,1,114,0.581907000,0.0000
144.75.218.246:10441,<->,138.127.224.10:domain,1,241,0,0,1,241,0.581486000,0.0000
144.75.218.237:53357,<->,120.155.84.97:domain,1,120,0,0,1,120,0.581367000,0.0000
142.175.13.70:40500,<->,99.75.234.175:cslistener,0,0,1,133,1,133,0.581051000,0.0000
144.75.218.246:15438,<->,8.222.218.197:domain,1,121,0,0,1,121,0.580958000,0.0000
148.158.222.19:46380,<->,129.224.112.252:domain,0,0,1,68,1,68,0.580088000,0.0000
129.78.114.107:58224,<->,119.94.225.50:domain,1,145,0,0,1,145,0.579967000,0.0000
144.75.218.242:20303,<->,8.222.218.196:domain,1,113,0,0,1,113,0.579686000,0.0000
39.62.136.53:59473,<->,112.6.187.180:domain,1,68,0,0,1,68,0.579279000,0.0000
144.75.218.246:58927,<->,8.222.218.204:domain,1,122,0,0,1,122,0.578558000,0.0000
144.75.218.246:15827,<->,8.222.218.199:domain,1,110,0,0,1,110,0.578304000,0.0000
50.163.36.233:33193,<->,92.27.219.191:vstat,0,0,1,52,1,52,0.578191000,0.0000
136.25.188.105:50995,<->,128.243.151.33:domain,1,179,0,0,1,179,0.578170000,0.0000
42.239.97.78:11421,<->,80.41.40.188:6881,0,0,1,298,1,298,0.577804000,0.0000
92.27.219.197:27193,<->,120.83.21.29:6881,1,309,0,0,1,309,0.577324000,0.0000
144.75.218.235:activesync,<->,89.154.144.66:domain,1,80,0,0,1,80,0.577014000,0.0000
57.100.247.124:31349,<->,56.121.37.92:domain,0,0,1,69,1,69,0.576255000,0.0000
215.158.140.13:65231,<->,138.127.230.203:domain,1,290,0,0,1,290,0.575571000,0.0000
21.15.226.126:55104,<->,20.193.55.123:netbios-ns,0,0,1,82,1,82,0.575498000,0.0000
97.126.26.39:17710,<->,102.45.225.190:domain,1,62,0,0,1,62,0.575271000,0.0000
8.252.222.171:59072,<->,192.171.13.33:domain,1,411,0,0,1,411,0.575163000,0.0000
144.75.218.242:38012,<->,8.222.218.199:domain,1,111,0,0,1,111,0.575024000,0.0000
112.103.134.95:38524,<->,215.158.239.237:domain,0,0,1,89,1,89,0.573774000,0.0000
64.214.61.236:51397,<->,89.183.104.246:30774,0,0,1,52,1,52,0.573635000,0.0000
139.47.239.142:57916,<->,129.187.19.186:10006,1,74,0,0,1,74,0.573550000,0.0000
144.75.218.242:63388,<->,8.222.218.196:domain,1,239,0,0,1,239,0.573182000,0.0000
106.157.38.242:33959,<->,108.134.108.77:rtnt-2,0,0,1,50,1,50,0.572734000,0.0000
129.78.114.107:14906,<->,119.94.225.50:domain,1,146,0,0,1,146,0.572544000,0.0000
144.75.218.235:26483,<->,8.222.218.197:domain,1,110,0,0,1,110,0.572292000,0.0000
80.42.175.248:61220,<->,118.141.40.138:mpc-lifenet,1,52,0,0,1,52,0.572103000,0.0000
110.155.32.46:21149,<->,109.1.59.159:domain,0,0,1,77,1,77,0.572062000,0.0000
199.20.74.163:38011,<->,109.222.241.65:25823,0,0,1,149,1,149,0.571283000,0.0000
144.75.218.246:35224,<->,128.203.247.101:domain,1,89,0,0,1,89,0.571116000,0.0000
97.242.126.180:30005,<->,129.224.112.252:domain,0,0,1,83,1,83,0.570958000,0.0000
108.134.108.77:36044,<->,106.157.38.242:33959,1,50,0,0,1,50,0.570948000,0.0000
106.157.38.242:33959,<->,108.134.108.77:17246,0,0,1,50,1,50,0.570029000,0.0000
101.122.134.124:54874,<->,103.17.11.235:51634,1,1496,0,0,1,1496,0.569971000,0.0000
132.249.70.233:64123,<->,149.147.3.128:domain,1,150,0,0,1,150,0.569840000,0.0000
144.75.218.241:23552,<->,8.222.218.204:domain,1,122,0,0,1,122,0.569802000,0.0000
106.157.38.242:33959,<->,108.134.108.77:950,0,0,1,50,1,50,0.569625000,0.0000
144.75.218.242:26216,<->,8.222.218.196:domain,1,113,0,0,1,113,0.569128000,0.0000
144.75.218.242:7939,<->,8.222.218.196:domain,1,125,0,0,1,125,0.567923000,0.0000
144.75.218.237:57454,<->,8.222.218.197:domain,1,157,0,0,1,157,0.567887000,0.0000
144.75.218.241:57006,<->,8.222.218.204:domain,1,110,0,0,1,110,0.567804000,0.0000
126.215.125.89:49778,<->,92.27.219.193:36960,0,0,1,373,1,373,0.567677000,0.0000
144.75.218.242:32648,<->,8.222.218.207:domain,1,179,0,0,1,179,0.567572000,0.0000
108.134.108.77:54779,<->,106.157.38.242:33959,1,50,0,0,1,50,0.567499000,0.0000
144.75.218.237:6137,<->,8.222.218.207:domain,1,126,0,0,1,126,0.567429000,0.0000
108.134.108.77:35075,<->,106.157.38.242:33959,1,50,0,0,1,50,0.567053000,0.0000
98.217.116.59:60829,<->,152.130.101.225:6881,1,135,0,0,1,135,0.566819000,0.0000
97.126.26.70:7587,<->,138.127.225.205:domain,1,277,0,0,1,277,0.566599000,0.0000
144.75.218.242:63082,<->,8.222.218.199:domain,1,123,0,0,1,123,0.565854000,0.0000
106.157.38.242:33959,<->,108.134.108.77:12503,0,0,1,50,1,50,0.565798000,0.0000
:::51411,<->,:::domain,1,119,0,0,1,119,0.564756000,0.0000
193.28.156.197:62000,<->,136.25.189.86:domain,0,0,1,84,1,84,0.564669000,0.0000
80.41.16.104:41197,<->,118.149.114.113:6881,1,133,0,0,1,133,0.564292000,0.0000
215.158.103.219:8596,<->,128.176.179.33:domain,1,260,0,0,1,260,0.564167000,0.0000
134.185.116.206:46372,<->,218.4.187.87:6881,0,0,1,99,1,99,0.563663000,0.0000
194.207.113.238:32783,<->,139.207.222.11:domain,0,0,1,91,1,91,0.563313000,0.0000
144.108.64.185:12063,<->,144.122.240.234:domain,0,0,1,74,1,74,0.563259000,0.0000
144.75.218.241:26004,<->,8.222.218.207:domain,1,123,0,0,1,123,0.563237000,0.0000
144.75.218.246:62324,<->,8.222.218.204:domain,1,110,0,0,1,110,0.563189000,0.0000
106.157.38.242:33959,<->,108.134.108.77:10817,0,0,1,50,1,50,0.562708000,0.0000
144.75.218.237:mxxrlogin,<->,8.222.218.199:domain,1,123,0,0,1,123,0.562513000,0.0000
144.75.218.246:53731,<->,8.222.218.197:domain,1,110,0,0,1,110,0.562348000,0.0000
101.224.204.193:50236,<->,105.120.253.39:domain,1,350,0,0,1,350,0.562187000,0.0000
99.30.53.247:48746,<->,132.168.198.94:domain,0,0,1,77,1,77,0.561452000,0.0000
144.75.218.246:19760,<->,8.222.218.204:domain,1,111,0,0,1,111,0.561225000,0.0000
144.75.218.237:25924,<->,120.155.84.97:domain,1,138,0,0,1,138,0.561125000,0.0000
106.157.38.242:33959,<->,108.134.108.77:24808,0,0,1,50,1,50,0.560918000,0.0000
56.121.49.77:58485,<->,199.15.114.33:18689,1,52,0,0,1,52,0.560719000,0.0000
34.100.96.54:39043,<->,66.90.102.244:domain,1,408,0,0,1,408,0.560695000,0.0000
144.75.218.242:42267,<->,100.117.27.56:domain,1,288,0,0,1,288,0.560328000,0.0000
215.158.239.120:58231,<->,131.4.236.16:domain,1,111,0,0,1,111,0.559968000,0.0000
141.92.219.216:49092,<->,129.224.112.252:domain,0,0,1,79,1,79,0.559918000,0.0000
215.158.239.120:37852,<->,131.4.236.16:domain,1,141,0,0,1,141,0.559152000,0.0000
144.75.218.246:49524,<->,8.222.218.197:domain,1,110,0,0,1,110,0.559137000,0.0000
65.60.169.114:15038,<->,89.183.104.191:ftp-data,0,0,1,52,1,52,0.559022000,0.0000
111.147.206.130:46608,<->,132.107.75.195:domain,1,764,0,0,1,764,0.558798000,0.0000
139.79.72.238:38059,<->,200.174.213.196:26177,0,0,1,52,1,52,0.557875000,0.0000
144.75.218.233:58805,<->,8.222.218.197:domain,1,110,0,0,1,110,0.557734000,0.0000
87.9.230.170:64842,<->,192.67.139.111:18844,0,0,1,136,1,136,0.557625000,0.0000
136.117.93.137:9543,<->,138.98.246.1:domain,0,0,1,120,1,120,0.556715000,0.0000
205.236.10.86:46133,<->,97.168.124.101:17118,0,0,1,135,1,135,0.556625000,0.0000
8.176.8.71:55644,<->,111.151.107.247:domain,1,119,0,0,1,119,0.556393000,0.0000
198.254.35.214:61337,<->,80.40.23.183:6881,0,0,1,130,1,130,0.556389000,0.0000
92.27.27.185:46429,<->,133.45.77.233:16626,1,80,0,0,1,80,0.556265000,0.0000
144.75.218.242:29648,<->,8.222.218.199:domain,1,143,0,0,1,143,0.556089000,0.0000
215.158.103.206:4961,<->,129.220.171.193:domain,1,634,0,0,1,634,0.555711000,0.0000
53.150.234.220:54683,<->,246.253.248.210:domain,0,0,1,88,1,88,0.555461000,0.0000
144.75.218.246:61631,<->,8.222.218.199:domain,1,110,0,0,1,110,0.555459000,0.0000
34.186.147.158:41273,<->,60.102.23.64:21052,1,52,0,0,1,52,0.555391000,0.0000
99.73.41.205:21277,<->,144.76.46.38:domain,1,158,0,0,1,158,0.555165000,0.0000
20.128.171.146:49633,<->,57.195.38.86:domain,1,140,0,0,1,140,0.554719000,0.0000
94.24.2.177:58011,<->,89.183.104.176:48229,0,0,1,52,1,52,0.554639000,0.0000
207.61.250.182:50321,<->,109.222.242.9:bacula-dir,0,0,1,133,1,133,0.554549000,0.0000
22.50.105.63:29773,<->,132.249.70.213:domain,0,0,1,141,1,141,0.553933000,0.0000
144.75.218.241:49005,<->,8.222.218.207:domain,1,110,0,0,1,110,0.553719000,0.0000
136.25.188.105:52289,<->,143.194.53.201:domain,1,233,0,0,1,233,0.553259000,0.0000
215.158.49.32:62079,<->,29.211.214.254:domain,0,0,1,93,1,93,0.553171000,0.0000
136.25.188.105:60368,<->,208.250.159.17:domain,1,247,0,0,1,247,0.553152000,0.0000
192.64.225.224:42673,<->,93.93.180.74:34236,1,59,0,0,1,59,0.553034000,0.0000
144.93.125.49:64501,<->,144.93.121.86:16913,0,0,1,104,1,104,0.552822000,0.0000
144.75.218.246:57478,<->,8.222.218.204:domain,1,110,0,0,1,110,0.552713000,0.0000
144.75.218.246:34067,<->,8.222.218.197:domain,1,113,0,0,1,113,0.552623000,0.0000
144.75.218.233:36935,<->,8.222.218.196:domain,1,125,0,0,1,125,0.552498000,0.0000
20.117.123.128:6993,<->,205.81.94.28:domain,1,531,0,0,1,531,0.552449000,0.0000
210.60.115.65:64708,<->,102.51.167.35:59759,0,0,1,136,1,136,0.552149000,0.0000
132.180.214.237:51308,<->,80.56.78.128:domain,0,0,1,90,1,90,0.552007000,0.0000
136.25.188.105:57844,<->,128.243.151.33:domain,1,251,0,0,1,251,0.551523000,0.0000
136.25.188.228:65011,<->,139.163.161.57:domain,1,106,0,0,1,106,0.550880000,0.0000
144.75.218.241:18835,<->,120.155.84.97:domain,1,145,0,0,1,145,0.550678000,0.0000
144.75.218.241:55906,<->,8.222.218.196:domain,1,125,0,0,1,125,0.550514000,0.0000
144.75.218.242:17526,<->,8.222.218.196:domain,1,123,0,0,1,123,0.550254000,0.0000
131.187.212.157:61188,<->,192.67.136.193:30393,0,0,1,52,1,52,0.549552000,0.0000
136.25.188.228:36831,<->,8.220.7.141:domain,1,129,0,0,1,129,0.549312000,0.0000
144.75.218.237:61631,<->,8.222.218.199:domain,1,113,0,0,1,113,0.548399000,0.0000
215.158.239.120:56779,<->,131.49.94.82:domain,1,199,0,0,1,199,0.548264000,0.0000
20.193.222.246:29752,<->,193.0.126.28:domain,1,76,0,0,1,76,0.546339000,0.0000
98.119.212.204:57905,<->,144.122.240.237:domain,0,0,1,75,1,75,0.546291000,0.0000
145.154.11.50:51291,<->,80.56.78.92:domain,0,0,1,94,1,94,0.545970000,0.0000
:::9679,<->,:::domain,1,156,0,0,1,156,0.545940000,0.0000
105.201.221.207:45184,<->,102.50.236.87:bacula-dir,0,0,1,342,1,342,0.545683000,0.0000
144.75.218.233:45423,<->,141.37.226.86:domain,1,86,0,0,1,86,0.545007000,0.0000
74.240.111.222:40619,<->,39.247.17.160:7514,0,0,1,52,1,52,0.544404000,0.0000
144.75.218.241:34870,<->,8.222.218.207:domain,1,127,0,0,1,127,0.544299000,0.0000
144.75.218.241:33262,<->,8.222.218.207:domain,1,111,0,0,1,111,0.542772000,0.0000
152.132.171.243:54886,<->,102.81.141.95:30111,0,0,1,135,1,135,0.542558000,0.0000
21.15.226.126:55104,<->,20.193.55.76:netbios-ns,0,0,1,82,1,82,0.542463000,0.0000
144.75.218.246:40913,<->,139.252.1.242:domain,1,135,0,0,1,135,0.542283000,0.0000
144.75.218.233:47912,<->,8.222.218.204:domain,1,113,0,0,1,113,0.542049000,0.0000
144.75.218.246:42847,<->,113.180.95.20:domain,1,87,0,0,1,87,0.542024000,0.0000
215.158.239.8:56428,<->,8.220.7.141:domain,1,151,0,0,1,151,0.541969000,0.0000
92.27.219.56:56031,<->,123.61.21.253:20025,1,52,0,0,1,52,0.541852000,0.0000
144.75.218.237:28010,<->,8.222.218.197:domain,1,123,0,0,1,123,0.541687000,0.0000
144.75.218.246:42030,<->,8.222.218.204:domain,1,153,0,0,1,153,0.541527000,0.0000
144.75.218.237:18366,<->,8.222.218.204:domain,1,237,0,0,1,237,0.541286000,0.0000
144.75.218.241:47910,<->,8.222.218.196:domain,1,121,0,0,1,121,0.541203000,0.0000
20.205.188.94:17841,<->,113.149.166.94:domain,1,82,0,0,1,82,0.541100000,0.0000
215.158.239.182:53086,<->,111.151.107.247:domain,1,109,0,0,1,109,0.541086000,0.0000
145.89.194.40:40247,<->,69.155.129.29:10109,1,133,0,0,1,133,0.541006000,0.0000
144.75.218.235:19089,<->,8.222.218.197:domain,1,110,0,0,1,110,0.540995000,0.0000
144.75.218.242:60528,<->,8.222.218.207:domain,1,121,0,0,1,121,0.540683000,0.0000
215.158.239.8:61698,<->,8.220.7.141:domain,1,101,0,0,1,101,0.539914000,0.0000
215.158.103.219:39277,<->,208.186.165.27:domain,1,176,0,0,1,176,0.539689000,0.0000
144.75.218.242:51166,<->,8.222.218.199:domain,1,121,0,0,1,121,0.539485000,0.0000
245.36.48.253:34006,<->,92.27.209.104:27016,0,0,1,57,1,57,0.539400000,0.0000
92.27.219.37:35995,<->,29.221.165.171:13057,1,293,0,0,1,293,0.539312000,0.0000
20.65.77.106:50538,<->,193.24.150.240:domain,1,74,0,0,1,74,0.538980000,0.0000
215.158.103.219:53054,<->,53.74.147.102:domain,1,84,0,0,1,84,0.538682000,0.0000
21.15.226.126:55104,<->,20.193.55.60:netbios-ns,0,0,1,82,1,82,0.537666000,0.0000
104.67.149.22:57693,<->,39.9.119.18:ldap,0,0,1,205,1,205,0.537330000,0.0000
92.27.219.186:52925,<->,158.236.199.232:domain,1,119,0,0,1,119,0.536641000,0.0000
20.215.28.95:29830,<->,80.28.127.235:domain,1,130,0,0,1,130,0.535957000,0.0000
199.6.230.219:22241,<->,99.73.7.110:6881,0,0,1,100,1,100,0.535825000,0.0000
77.57.4.146:62144,<->,20.162.52.126:19072,0,0,1,52,1,52,0.535605000,0.0000
80.42.138.177:28604,<->,125.0.210.158:12441,1,102,0,0,1,102,0.535392000,0.0000
215.158.239.120:44625,<->,33.209.211.2:domain,1,111,0,0,1,111,0.535353000,0.0000
159.13.155.136:52550,<->,53.245.2.193:domain,1,173,0,0,1,173,0.534752000,0.0000
80.41.19.144:55000,<->,206.69.124.84:37864,1,52,0,0,1,52,0.534604000,0.0000
144.75.218.242:5524,<->,8.222.218.207:domain,1,110,0,0,1,110,0.534285000,0.0000
144.75.218.246:24993,<->,8.222.218.199:domain,1,110,0,0,1,110,0.532871000,0.0000
88.152.22.110:54821,<->,192.67.160.161:29728,0,0,1,52,1,52,0.532815000,0.0000
144.75.218.241:11547,<->,17.136.21.99:domain,1,147,0,0,1,147,0.532613000,0.0000
121.252.146.7:37999,<->,100.92.34.81:10098,0,0,1,325,1,325,0.532469000,0.0000
136.25.188.105:57794,<->,140.136.9.105:domain,1,250,0,0,1,250,0.532099000,0.0000
144.76.43.242:27695,<->,80.56.78.128:domain,0,0,1,113,1,113,0.532063000,0.0000
118.131.209.62:37347,<->,101.70.127.0:domain,0,0,1,74,1,74,0.532008000,0.0000
20.164.129.62:42479,<->,205.36.103.208:domain,1,135,0,0,1,135,0.531956000,0.0000
144.75.218.237:42998,<->,120.155.84.97:domain,1,175,0,0,1,175,0.531365000,0.0000
144.75.218.246:54422,<->,65.95.70.36:domain,1,212,0,0,1,212,0.531350000,0.0000
144.75.218.237:16989,<->,8.222.218.198:domain,1,121,0,0,1,121,0.530062000,0.0000
144.75.218.233:13261,<->,8.222.218.204:domain,1,110,0,0,1,110,0.530007000,0.0000
144.75.218.241:64503,<->,8.222.218.207:domain,1,111,0,0,1,111,0.529627000,0.0000
144.75.218.237:29803,<->,120.155.84.97:domain,1,126,0,0,1,126,0.529294000,0.0000
113.178.109.84:50853,<->,144.93.121.83:22239,0,0,1,116,1,116,0.529189000,0.0000
144.75.218.237:43057,<->,8.222.218.199:domain,1,110,0,0,1,110,0.528451000,0.0000
215.158.140.163:39121,<->,120.155.87.47:domain,1,137,0,0,1,137,0.527880000,0.0000
56.121.49.50:56525,<->,139.252.0.243:domain,1,154,0,0,1,154,0.526674000,0.0000
21.15.226.126:55104,<->,20.193.54.71:netbios-ns,0,0,1,82,1,82,0.525810000,0.0000
192.64.215.135:55000,<->,201.7.56.152:11964,1,321,0,0,1,321,0.525556000,0.0000
48.53.6.253:48104,<->,132.230.26.160:6881,1,97,0,0,1,97,0.525445000,0.0000
144.75.218.237:52739,<->,120.155.84.97:domain,1,126,0,0,1,126,0.525075000,0.0000
18.80.190.251:55616,<->,210.226.164.31:domain,0,0,1,73,1,73,0.524867000,0.0000
144.75.218.241:35070,<->,138.127.230.27:domain,1,359,0,0,1,359,0.524845000,0.0000
54.42.135.102:osb-sd,<->,210.226.164.31:domain,0,0,1,65,1,65,0.524678000,0.0000
34.198.231.134:7731,<->,66.82.254.66:domain,1,129,0,0,1,129,0.524382000,0.0000
136.25.188.105:49937,<->,132.5.71.202:domain,1,230,0,0,1,230,0.524035000,0.0000
144.75.218.242:46855,<->,8.222.218.204:domain,1,122,0,0,1,122,0.524019000,0.0000
146.188.233.245:63647,<->,92.27.219.132:49390,0,0,1,213,1,213,0.523799000,0.0000
20.134.143.27:42520,<->,192.242.185.97:domain,1,80,0,0,1,80,0.523576000,0.0000
144.75.218.246:32128,<->,8.222.218.204:domain,1,109,0,0,1,109,0.523256000,0.0000
92.27.219.190:29943,<->,113.127.211.18:25343,1,52,0,0,1,52,0.523155000,0.0000
20.23.114.165:41109,<->,194.247.68.124:domain,1,78,0,0,1,78,0.523003000,0.0000
144.93.125.49:26997,<->,144.93.121.10:24119,0,0,1,104,1,104,0.522764000,0.0000
131.133.154.159:45599,<->,133.171.115.67:domain,0,0,1,84,1,84,0.522687000,0.0000
97.126.119.191:55706,<->,132.5.71.202:domain,1,435,0,0,1,435,0.522118000,0.0000
136.25.188.105:62635,<->,135.88.171.34:domain,1,205,0,0,1,205,0.521520000,0.0000
100.92.38.121:36285,<->,194.193.103.88:22882,1,66,0,0,1,66,0.518863000,0.0000
205.228.199.160:24231,<->,92.27.219.163:16881,0,0,1,52,1,52,0.518399000,0.0000
144.57.226.233:ntp,<->,139.248.201.139:ntp,0,0,1,80,1,80,0.518311000,0.0000
8.181.148.227:61804,<->,215.158.239.240:domain,0,0,1,90,1,90,0.518158000,0.0000
215.158.140.168:48780,<->,120.155.87.47:domain,1,137,0,0,1,137,0.518062000,0.0000
200.226.80.179:60690,<->,129.92.113.143:chargen,0,0,1,50,1,50,0.517792000,0.0000
192.64.195.195:53101,<->,206.17.164.193:25134,1,52,0,0,1,52,0.517763000,0.0000
30.192.53.215:53881,<->,92.27.219.159:35044,0,0,1,102,1,102,0.517649000,0.0000
159.64.148.13:18116,<->,144.122.240.196:domain,0,0,1,88,1,88,0.517567000,0.0000
144.75.218.241:36586,<->,33.238.69.117:domain,1,131,0,0,1,131,0.517392000,0.0000
79.58.237.62:59785,<->,98.67.158.136:domain,0,0,1,76,1,76,0.516615000,0.0000
144.75.218.242:43016,<->,8.222.218.199:domain,1,122,0,0,1,122,0.516553000,0.0000
247.136.223.75:31022,<->,124.243.26.28:6881,1,97,0,0,1,97,0.516391000,0.0000
144.75.218.235:35516,<->,8.222.218.204:domain,1,110,0,0,1,110,0.515832000,0.0000
144.75.218.242:22917,<->,8.222.218.204:domain,1,143,0,0,1,143,0.515143000,0.0000
255.133.223.252:ntp,<->,221.95.62.8:ntp,0,0,1,80,1,80,0.515072000,0.0000
215.158.102.78:6609,<->,129.224.112.252:domain,0,0,1,74,1,74,0.514767000,0.0000
92.27.27.185:46412,<->,57.59.47.200:18947,1,52,0,0,1,52,0.514377000,0.0000
92.27.219.205:64007,<->,136.246.92.113:56369,1,52,0,0,1,52,0.514283000,0.0000
109.222.205.45:27881,<->,127.18.252.200:domain,1,76,0,0,1,76,0.514283000,0.0000
39.44.61.15:35696,<->,143.34.37.188:domain,1,80,0,0,1,80,0.513561000,0.0000
134.98.5.37:59908,<->,109.222.243.81:6881,0,0,1,147,1,147,0.513412000,0.0000
57.156.213.42:18298,<->,80.41.25.41:domain,0,0,1,73,1,73,0.513351000,0.0000
210.158.44.220:17902,<->,128.156.80.162:domain,1,90,0,0,1,90,0.512850000,0.0000
136.25.188.105:52918,<->,129.70.124.49:domain,1,126,0,0,1,126,0.512304000,0.0000
144.75.218.246:45319,<->,8.222.218.197:domain,1,236,0,0,1,236,0.511283000,0.0000
144.75.218.241:36596,<->,8.222.218.196:domain,1,113,0,0,1,113,0.511014000,0.0000
141.245.151.199:caacws,<->,136.47.66.197:domain,1,87,0,0,1,87,0.510796000,0.0000
144.75.218.241:9171,<->,99.168.7.150:domain,1,154,0,0,1,154,0.510215000,0.0000
199.83.47.13:29582,<->,92.27.27.166:21072,0,0,1,135,1,135,0.510013000,0.0000
139.7.227.58:14915,<->,159.137.138.173:domain,0,0,1,82,1,82,0.509736000,0.0000
201.211.227.212:63913,<->,89.183.104.166:ipcs-command,0,0,1,61,1,61,0.509071000,0.0000
217.11.189.9:badm-pub,<->,20.192.130.71:5086,0,0,1,443,1,443,0.509004000,0.0000
144.75.218.246:dellwebadmin-1,<->,8.222.218.197:domain,1,113,0,0,1,113,0.508957000,0.0000
144.75.218.241:21197,<->,8.222.218.204:domain,1,110,0,0,1,110,0.508108000,0.0000
143.252.64.234:54642,<->,129.224.112.252:domain,0,0,1,58,1,58,0.507997000,0.0000
144.75.218.246:59049,<->,8.222.218.204:domain,1,113,0,0,1,113,0.507939000,0.0000
144.75.218.241:42705,<->,120.155.84.97:domain,1,176,0,0,1,176,0.507816000,0.0000
92.27.219.208:40737,<->,66.1.74.3:28058,1,52,0,0,1,52,0.507808000,0.0000
144.75.218.241:27811,<->,120.155.84.97:domain,1,151,0,0,1,151,0.507786000,0.0000
144.75.218.241:oracle-oms,<->,8.222.218.207:domain,1,122,0,0,1,122,0.507541000,0.0000
116.145.98.56:45410,<->,80.42.204.150:6881,0,0,1,138,1,138,0.506939000,0.0000
92.27.219.145:64654,<->,93.101.192.84:bctp,1,52,0,0,1,52,0.506533000,0.0000
83.95.154.244:ttc-ssl,<->,109.222.221.234:domain,0,0,1,76,1,76,0.505442000,0.0000
98.219.126.40:62912,<->,145.252.116.252:domain,0,0,1,78,1,78,0.503876000,0.0000
144.75.218.237:63381,<->,8.222.218.204:domain,1,110,0,0,1,110,0.503383000,0.0000
144.75.218.242:41513,<->,8.222.218.199:domain,1,120,0,0,1,120,0.503218000,0.0000
92.162.219.79:15026,<->,129.224.112.252:domain,0,0,1,104,1,104,0.502902000,0.0000
136.25.188.28:42999,<->,192.171.13.189:domain,1,157,0,0,1,157,0.502639000,0.0000
144.75.218.242:57678,<->,8.222.218.207:domain,1,111,0,0,1,111,0.502435000,0.0000
143.252.64.224:46558,<->,129.224.112.252:domain,0,0,1,71,1,71,0.502267000,0.0000
38.21.156.204:56633,<->,20.232.228.202:netbios-ns,0,0,1,82,1,82,0.501551000,0.0000
118.134.127.116:47232,<->,109.222.229.119:domain,0,0,1,76,1,76,0.501466000,0.0000
27.139.49.9:22475,<->,109.222.255.55:domain,0,0,1,79,1,79,0.501281000,0.0000
192.67.175.129:16881,<->,125.25.133.190:dbcontrol-oms,1,52,0,0,1,52,0.501244000,0.0000
144.75.218.237:25942,<->,8.222.218.197:domain,1,122,0,0,1,122,0.499875000,0.0000
144.75.218.246:38671,<->,139.252.1.242:domain,1,143,0,0,1,143,0.499818000,0.0000
102.51.89.173:29799,<->,122.173.165.4:23910,1,130,0,0,1,130,0.499634000,0.0000
144.108.64.185:65258,<->,159.69.187.2:domain,0,0,1,75,1,75,0.499466000,0.0000
207.206.173.251:25171,<->,102.50.164.175:tcpmux,0,0,1,52,1,52,0.499259000,0.0000
34.130.34.18:47367,<->,66.82.117.130:domain,1,80,0,0,1,80,0.499135000,0.0000
116.47.123.91:37637,<->,218.4.180.210:14999,0,0,1,52,1,52,0.499088000,0.0000
57.211.62.10:35197,<->,98.232.172.60:domain,0,0,1,81,1,81,0.498777000,0.0000
144.75.218.237:28894,<->,8.222.218.197:domain,1,111,0,0,1,111,0.498689000,0.0000
21.15.226.126:55104,<->,20.193.54.41:netbios-ns,0,0,1,82,1,82,0.498400000,0.0000
144.75.218.246:11674,<->,8.222.218.197:domain,1,127,0,0,1,127,0.498270000,0.0000
89.183.104.166:51413,<->,29.251.39.222:24759,1,52,0,0,1,52,0.497053000,0.0000
144.75.218.235:52641,<->,100.185.121.91:domain,1,128,0,0,1,128,0.496829000,0.0000
144.75.218.241:57206,<->,8.222.218.207:domain,1,110,0,0,1,110,0.496124000,0.0000
109.1.51.11:47495,<->,48.110.135.132:41528,1,93,0,0,1,93,0.496095000,0.0000
143.252.64.224:37688,<->,129.224.112.252:domain,0,0,1,68,1,68,0.495838000,0.0000
97.242.126.200:s-openmail,<->,129.224.112.252:domain,0,0,1,77,1,77,0.495801000,0.0000
60.99.169.229:62788,<->,136.25.189.92:domain,0,0,1,84,1,84,0.495762000,0.0000
21.15.226.126:55104,<->,20.193.54.200:netbios-ns,0,0,1,82,1,82,0.494163000,0.0000
20.10.111.145:34137,<->,194.209.186.154:domain,1,76,0,0,1,76,0.494031000,0.0000
192.67.149.88:38504,<->,38.180.36.123:22736,1,69,0,0,1,69,0.493900000,0.0000
17.188.67.212:19014,<->,97.126.114.69:domain,0,0,1,69,1,69,0.493592000,0.0000
39.150.16.215:24458,<->,142.164.244.12:domain,1,68,0,0,1,68,0.493031000,0.0000
109.222.250.107:24874,<->,204.124.37.148:cap,1,52,0,0,1,52,0.493007000,0.0000
144.75.218.235:25999,<->,8.222.218.204:domain,1,121,0,0,1,121,0.492725000,0.0000
144.75.218.246:21938,<->,8.222.218.199:domain,1,108,0,0,1,108,0.491723000,0.0000
144.75.218.233:asihpi,<->,8.222.218.197:domain,1,110,0,0,1,110,0.491580000,0.0000
144.75.218.233:17541,<->,8.222.218.196:domain,1,121,0,0,1,121,0.491180000,0.0000
144.75.218.242:20184,<->,8.222.218.196:domain,1,177,0,0,1,177,0.491032000,0.0000
39.202.190.137:proxy-gateway,<->,130.226.129.60:domain,1,74,0,0,1,74,0.490801000,0.0000
20.77.192.214:hsl-storm,<->,121.209.70.144:domain,1,72,0,0,1,72,0.490629000,0.0000
20.61.206.202:34406,<->,156.136.120.152:domain,1,74,0,0,1,74,0.490466000,0.0000
89.183.104.137:64858,<->,122.129.100.246:29914,1,52,0,0,1,52,0.490001000,0.0000
144.75.218.237:59979,<->,8.222.218.197:domain,1,113,0,0,1,113,0.489583000,0.0000
144.75.218.237:55187,<->,53.165.133.164:domain,1,85,0,0,1,85,0.489578000,0.0000
80.40.36.227:53491,<->,114.31.119.171:domain,1,132,0,0,1,132,0.489555000,0.0000
215.158.2.61:64234,<->,29.211.214.254:domain,0,0,1,90,1,90,0.489522000,0.0000
144.75.218.241:34211,<->,8.222.218.204:domain,1,121,0,0,1,121,0.489264000,0.0000
144.75.218.246:50479,<->,8.222.218.197:domain,1,121,0,0,1,121,0.488818000,0.0000
119.6.123.164:5260,<->,139.163.5.144:domain,0,0,1,74,1,74,0.488393000,0.0000
144.75.218.235:19679,<->,138.127.231.3:domain,1,194,0,0,1,194,0.488301000,0.0000
144.75.218.242:13917,<->,8.222.218.199:domain,1,127,0,0,1,127,0.487903000,0.0000
144.108.64.185:12447,<->,144.122.240.224:domain,0,0,1,76,1,76,0.487378000,0.0000
144.75.218.235:33672,<->,143.204.138.237:domain,1,153,0,0,1,153,0.487286000,0.0000
92.27.27.177:59686,<->,48.108.82.241:12957,1,52,0,0,1,52,0.486838000,0.0000
223.140.130.253:11230,<->,39.18.139.86:edb-server2,0,0,1,62,1,62,0.486836000,0.0000
144.75.218.233:14528,<->,8.222.218.204:domain,1,121,0,0,1,121,0.486660000,0.0000
20.253.65.221:50796,<->,126.224.150.56:domain,1,72,0,0,1,72,0.486619000,0.0000
74.51.75.47:24600,<->,82.237.232.145:domain,0,0,1,78,1,78,0.486206000,0.0000
92.27.219.173:20726,<->,116.126.69.169:domain,1,80,0,0,1,80,0.486120000,0.0000
48.53.137.25:48488,<->,80.15.251.30:bacula-dir,1,156,0,0,1,156,0.485947000,0.0000
192.67.136.165:64326,<->,204.45.238.246:40476,1,135,0,0,1,135,0.485557000,0.0000
215.158.239.120:61657,<->,97.4.79.164:domain,1,254,0,0,1,254,0.484949000,0.0000
8.176.8.215:64491,<->,111.151.107.247:domain,1,163,0,0,1,163,0.484810000,0.0000
20.249.228.251:12368,<->,136.99.57.75:domain,1,70,0,0,1,70,0.484119000,0.0000
38.21.156.204:56633,<->,20.232.229.121:netbios-ns,0,0,1,82,1,82,0.483333000,0.0000
144.75.218.237:29047,<->,8.222.218.199:domain,1,124,0,0,1,124,0.482859000,0.0000
106.188.198.187:23351,<->,132.51.6.188:domain,0,0,1,71,1,71,0.482731000,0.0000
144.76.43.245:22094,<->,80.56.78.128:domain,0,0,1,107,1,107,0.482413000,0.0000
108.134.108.77:53626,<->,106.157.38.242:37294,1,50,0,0,1,50,0.481980000,0.0000
116.106.38.41:52035,<->,8.252.221.166:domain,0,0,1,85,1,85,0.481076000,0.0000
100.52.156.101:60872,<->,92.27.27.160:http-alt,0,0,1,117,1,117,0.481054000,0.0000
144.75.218.242:17147,<->,8.222.218.199:domain,1,110,0,0,1,110,0.480274000,0.0000
106.157.38.242:37294,<->,108.134.108.77:21029,0,0,1,50,1,50,0.479826000,0.0000
106.157.38.242:37294,<->,108.134.108.77:14558,0,0,1,50,1,50,0.479817000,0.0000
145.108.46.93:62423,<->,215.158.2.47:domain,1,89,0,0,1,89,0.479206000,0.0000
144.75.218.242:27356,<->,8.222.218.199:domain,1,113,0,0,1,113,0.479032000,0.0000
144.75.218.237:27279,<->,8.222.218.197:domain,1,110,0,0,1,110,0.478903000,0.0000
230.72.210.85:paycash-wbp,<->,247.157.36.145:6881,0,0,1,109,1,109,0.478532000,0.0000
144.75.218.246:12503,<->,8.222.218.197:domain,1,159,0,0,1,159,0.478206000,0.0000
108.134.108.77:54823,<->,106.157.38.242:37294,1,50,0,0,1,50,0.477507000,0.0000
27.188.163.162:i-net-2000-npr,<->,109.1.17.114:sip,0,0,1,443,1,443,0.477424000,0.0000
80.40.11.228:57349,<->,122.117.43.241:40075,1,52,0,0,1,52,0.476942000,0.0000
33.0.223.69:mbus,<->,129.92.114.124:10230,0,0,1,138,1,138,0.475816000,0.0000
20.182.107.103:24832,<->,207.77.30.118:domain,1,75,0,0,1,75,0.475266000,0.0000
123.48.57.181:61697,<->,92.27.219.17:17313,0,0,1,52,1,52,0.475087000,0.0000
132.200.108.136:49440,<->,129.224.112.221:domain,0,0,1,86,1,86,0.475024000,0.0000
108.134.108.77:50005,<->,106.157.38.242:37294,1,50,0,0,1,50,0.475003000,0.0000
144.75.218.246:20650,<->,8.222.218.204:domain,1,110,0,0,1,110,0.474993000,0.0000
21.15.226.126:55104,<->,20.193.54.241:netbios-ns,0,0,1,82,1,82,0.474849000,0.0000
106.157.38.242:37294,<->,108.134.108.77:33165,0,0,1,50,1,50,0.474822000,0.0000
61.91.181.221:21311,<->,109.0.253.66:19343,0,0,1,130,1,130,0.474450000,0.0000
92.27.27.171:50142,<->,113.103.98.190:opsec-cvp,1,62,0,0,1,62,0.473876000,0.0000
144.75.218.246:36513,<->,8.222.218.197:domain,1,237,0,0,1,237,0.473667000,0.0000
112.107.203.81:49459,<->,89.183.104.175:39702,0,0,1,52,1,52,0.473542000,0.0000
108.134.108.77:37343,<->,106.157.38.242:37294,1,50,0,0,1,50,0.472285000,0.0000
106.157.38.242:37294,<->,108.134.108.77:29209,0,0,1,50,1,50,0.471674000,0.0000
136.25.188.105:64777,<->,132.43.156.54:domain,1,137,0,0,1,137,0.471595000,0.0000
114.232.65.138:silkmeter,<->,109.222.251.212:domain,0,0,1,70,1,70,0.471433000,0.0000
122.196.70.119:61072,<->,92.27.27.177:58981,0,0,1,135,1,135,0.471401000,0.0000
106.157.38.242:37294,<->,108.134.108.77:8046,0,0,1,50,1,50,0.471067000,0.0000
92.27.209.121:34120,<->,103.237.45.95:agentsease-db,1,80,0,0,1,80,0.469961000,0.0000
144.75.218.242:cimtrak,<->,8.222.218.199:domain,1,114,0,0,1,114,0.469268000,0.0000
106.157.38.242:37294,<->,108.134.108.77:36467,0,0,1,50,1,50,0.468923000,0.0000
111.147.111.98:34292,<->,119.127.4.87:18643,1,135,0,0,1,135,0.468756000,0.0000
108.134.108.77:48486,<->,106.157.38.242:37294,1,50,0,0,1,50,0.468327000,0.0000
132.249.70.233:53905,<->,53.201.149.31:domain,1,87,0,0,1,87,0.467821000,0.0000
125.22.35.22:25144,<->,80.41.44.203:17519,0,0,1,133,1,133,0.467508000,0.0000
106.157.38.242:37294,<->,108.134.108.77:8781,0,0,1,50,1,50,0.467456000,0.0000
134.36.81.173:21324,<->,92.27.219.141:21228,0,0,1,52,1,52,0.467239000,0.0000
105.168.127.133:39337,<->,139.163.13.6:domain,0,0,1,76,1,76,0.466305000,0.0000
215.158.239.120:41836,<->,80.57.208.241:domain,1,111,0,0,1,111,0.465903000,0.0000
144.75.218.246:61749,<->,8.222.218.204:domain,1,122,0,0,1,122,0.465883000,0.0000
144.75.218.237:17835,<->,8.222.218.197:domain,1,111,0,0,1,111,0.465182000,0.0000
215.158.239.120:55057,<->,97.4.79.164:domain,1,260,0,0,1,260,0.465139000,0.0000
144.75.218.237:34040,<->,159.176.32.29:domain,1,76,0,0,1,76,0.465053000,0.0000
144.75.218.235:38733,<->,8.222.218.204:domain,1,111,0,0,1,111,0.465048000,0.0000
215.158.239.120:44726,<->,159.137.139.217:domain,1,110,0,0,1,110,0.465004000,0.0000
:::28544,<->,:::domain,1,785,0,0,1,785,0.464625000,0.0000
102.50.242.234:59533,<->,27.14.169.221:38747,1,261,0,0,1,261,0.464563000,0.0000
144.75.218.233:59425,<->,8.222.218.197:domain,1,111,0,0,1,111,0.464525000,0.0000
79.253.14.215:19122,<->,34.83.130.169:895,0,0,1,52,1,52,0.464206000,0.0000
97.126.26.71:ivcollector,<->,120.155.84.163:domain,1,138,0,0,1,138,0.463952000,0.0000
0.200.50.50:34233,<->,20.13.112.44:domain,0,0,1,60,1,60,0.463475000,0.0000
144.75.218.233:32465,<->,8.222.218.197:domain,1,122,0,0,1,122,0.463287000,0.0000
21.15.226.126:55104,<->,20.193.53.248:netbios-ns,0,0,1,82,1,82,0.463194000,0.0000
144.75.218.237:10469,<->,8.222.218.199:domain,1,125,0,0,1,125,0.463060000,0.0000
20.119.101.62:39572,<->,116.107.67.119:domain,1,72,0,0,1,72,0.462745000,0.0000
144.75.221.206:64564,<->,138.98.246.1:domain,0,0,1,122,1,122,0.462673000,0.0000
144.75.218.242:30963,<->,8.222.218.196:domain,1,121,0,0,1,121,0.461976000,0.0000
99.75.63.38:34573,<->,144.76.46.36:domain,1,126,0,0,1,126,0.461134000,0.0000
144.75.218.235:spw-dialer,<->,132.208.122.193:domain,1,141,0,0,1,141,0.459453000,0.0000
39.232.168.43:31093,<->,126.9.199.3:domain,1,96,0,0,1,96,0.458348000,0.0000
56.24.164.8:8524,<->,97.168.80.204:domain,0,0,1,65,1,65,0.458204000,0.0000
218.4.190.253:7890,<->,116.244.100.27:6881,1,404,0,0,1,404,0.457870000,0.0000
98.166.239.25:44695,<->,129.224.112.252:domain,0,0,1,75,1,75,0.457579000,0.0000
144.75.218.242:geognosisman,<->,8.222.218.207:domain,1,121,0,0,1,121,0.457393000,0.0000
89.183.104.189:34505,<->,88.152.120.203:22458,1,52,0,0,1,52,0.457247000,0.0000
144.75.218.241:39640,<->,8.222.218.204:domain,1,124,0,0,1,124,0.456448000,0.0000
247.136.223.219:24607,<->,38.53.173.20:12884,1,129,0,0,1,129,0.456428000,0.0000
144.75.218.242:56571,<->,8.222.218.207:domain,1,123,0,0,1,123,0.456108000,0.0000
20.6.228.54:55971,<->,205.121.93.107:domain,1,78,0,0,1,78,0.456062000,0.0000
136.25.188.105:53566,<->,143.194.53.201:domain,1,185,0,0,1,185,0.455690000,0.0000
144.75.218.242:56937,<->,8.222.218.199:domain,1,111,0,0,1,111,0.454804000,0.0000
114.208.34.76:38721,<->,89.183.104.178:a14,0,0,1,321,1,321,0.454527000,0.0000
144.75.218.242:36286,<->,8.222.218.199:domain,1,110,0,0,1,110,0.453193000,0.0000
215.158.103.206:50072,<->,249.62.21.108:domain,1,103,0,0,1,103,0.452935000,0.0000
59.168.201.49:53695,<->,196.148.130.233:domain,0,0,1,65,1,65,0.452879000,0.0000
152.133.60.221:15410,<->,138.73.60.223:6881,0,0,1,130,1,130,0.452876000,0.0000
8.240.117.44:43473,<->,29.211.214.32:domain,0,0,1,115,1,115,0.452728000,0.0000
144.75.218.242:isrp-port,<->,8.222.218.207:domain,1,111,0,0,1,111,0.452629000,0.0000
215.158.239.105:49878,<->,149.201.135.194:domain,1,141,0,0,1,141,0.449947000,0.0000
215.158.239.105:42652,<->,120.154.177.88:domain,1,111,0,0,1,111,0.449751000,0.0000
132.180.212.246:9114,<->,129.224.112.252:domain,0,0,1,69,1,69,0.448272000,0.0000
115.62.40.21:sentlm-srv2srv,<->,97.126.115.22:domain,0,0,1,75,1,75,0.448098000,0.0000
103.127.138.3:pmip6-cntl,<->,101.70.126.246:domain,0,0,1,70,1,70,0.447885000,0.0000
89.183.104.231:48736,<->,235.225.213.208:17355,1,52,0,0,1,52,0.447184000,0.0000
144.75.218.242:59206,<->,8.222.218.199:domain,1,110,0,0,1,110,0.447143000,0.0000
144.75.218.242:11745,<->,8.222.218.204:domain,1,124,0,0,1,124,0.447059000,0.0000
97.126.26.70:infoexch,<->,132.66.49.212:domain,1,574,0,0,1,574,0.447056000,0.0000
144.75.218.237:23714,<->,8.222.218.198:domain,1,111,0,0,1,111,0.446982000,0.0000
78.129.196.247:46426,<->,39.15.169.14:domain,0,0,1,87,1,87,0.446978000,0.0000
21.15.226.126:55104,<->,20.193.53.218:netbios-ns,0,0,1,82,1,82,0.446907000,0.0000
19.215.46.158:19599,<->,109.222.244.46:domain,0,0,1,68,1,68,0.446799000,0.0000
20.170.191.9:34144,<->,120.158.207.179:domain,1,72,0,0,1,72,0.446372000,0.0000
18.200.87.230:57308,<->,101.224.186.192:27015,0,0,1,57,1,57,0.446237000,0.0000
27.178.41.11:44438,<->,136.25.189.5:domain,0,0,1,83,1,83,0.446213000,0.0000
144.75.218.246:31545,<->,8.222.218.204:domain,1,122,0,0,1,122,0.445827000,0.0000
144.75.218.242:48467,<->,8.222.218.207:domain,1,111,0,0,1,111,0.445652000,0.0000
144.75.218.233:50506,<->,138.127.225.217:domain,1,366,0,0,1,366,0.445011000,0.0000
98.86.101.56:56500,<->,80.41.32.151:domain,0,0,1,69,1,69,0.444607000,0.0000
144.75.218.241:39521,<->,8.222.218.196:domain,1,121,0,0,1,121,0.444411000,0.0000
98.231.239.31:18782,<->,109.1.9.205:6890,0,0,1,52,1,52,0.443784000,0.0000
144.75.218.242:8209,<->,8.222.218.207:domain,1,122,0,0,1,122,0.443220000,0.0000
39.14.127.159:60890,<->,194.254.157.54:domain,1,144,0,0,1,144,0.442893000,0.0000
247.136.181.26:59614,<->,118.191.203.243:6881,1,97,0,0,1,97,0.442744000,0.0000
200.226.80.179:53873,<->,129.92.113.143:chargen,0,0,1,50,1,50,0.442656000,0.0000
144.75.218.242:42013,<->,99.168.7.150:domain,1,125,0,0,1,125,0.442633000,0.0000
136.25.188.105:51894,<->,129.70.124.49:domain,1,368,0,0,1,368,0.442541000,0.0000
144.75.218.242:41606,<->,8.222.218.207:domain,1,110,0,0,1,110,0.442264000,0.0000
118.102.82.70:28047,<->,80.41.14.234:19343,0,0,1,321,1,321,0.442180000,0.0000
109.1.51.11:47495,<->,110.86.133.46:34866,1,325,0,0,1,325,0.441993000,0.0000
130.207.46.10:29668,<->,92.27.219.240:11765,0,0,1,88,1,88,0.441785000,0.0000
80.42.175.248:61220,<->,123.125.227.160:50022,1,61,0,0,1,61,0.441580000,0.0000
109.222.205.186:6881,<->,75.95.84.115:6881,1,97,0,0,1,97,0.440973000,0.0000
144.75.218.241:40572,<->,8.222.218.196:domain,1,110,0,0,1,110,0.440900000,0.0000
56.17.255.70:19616,<->,138.98.246.1:domain,0,0,1,120,1,120,0.440544000,0.0000
144.75.218.237:32143,<->,8.222.218.204:domain,1,125,0,0,1,125,0.439995000,0.0000
139.241.119.19:46366,<->,144.98.6.41:domain,1,76,0,0,1,76,0.439573000,0.0000
111.146.219.79:58999,<->,117.5.66.97:42981,1,158,0,0,1,158,0.439278000,0.0000
29.99.92.24:24602,<->,133.32.1.105:domain,0,0,1,69,1,69,0.439069000,0.0000
20.207.140.172:45409,<->,105.200.28.92:domain,1,74,0,0,1,74,0.439059000,0.0000
139.254.213.35:19727,<->,129.224.112.252:domain,0,0,1,76,1,76,0.439024000,0.0000
128.23.167.222:56524,<->,133.178.226.162:domain,0,0,1,90,1,90,0.439010000,0.0000
144.75.218.233:54775,<->,8.222.218.197:domain,1,110,0,0,1,110,0.438847000,0.0000
145.213.37.26:38961,<->,136.129.94.109:domain,0,0,1,84,1,84,0.438824000,0.0000
144.75.218.241:38042,<->,8.222.218.196:domain,1,153,0,0,1,153,0.438617000,0.0000
144.75.218.241:47332,<->,138.127.225.156:domain,1,298,0,0,1,298,0.438082000,0.0000
92.27.219.38:46838,<->,57.151.234.220:6881,1,97,0,0,1,97,0.438067000,0.0000
144.75.218.233:42993,<->,8.222.218.204:domain,1,110,0,0,1,110,0.437893000,0.0000
144.75.218.237:56901,<->,141.15.18.59:domain,1,229,0,0,1,229,0.437534000,0.0000
145.252.119.79:domain,<->,132.43.156.56:domain,1,752,0,0,1,752,0.437312000,0.0000
89.183.104.171:61707,<->,120.119.65.203:58453,1,52,0,0,1,52,0.437207000,0.0000
144.108.64.185:29196,<->,144.122.240.199:domain,0,0,1,63,1,63,0.437198000,0.0000
144.75.218.246:15034,<->,8.222.218.199:domain,1,122,0,0,1,122,0.436991000,0.0000
21.15.226.126:55104,<->,20.193.53.101:netbios-ns,0,0,1,82,1,82,0.436253000,0.0000
202.178.8.205:35664,<->,144.64.139.146:domain,0,0,1,67,1,67,0.435748000,0.0000
:::62556,<->,:::domain,0,0,1,96,1,96,0.435029000,0.0000
215.158.238.137:37006,<->,120.155.86.237:domain,1,117,0,0,1,117,0.434936000,0.0000
215.158.103.219:51550,<->,138.127.231.62:domain,1,387,0,0,1,387,0.434787000,0.0000
136.25.188.105:64058,<->,135.88.171.34:domain,1,232,0,0,1,232,0.434465000,0.0000
80.41.18.181:63060,<->,117.66.147.65:1024,1,1470,0,0,1,1470,0.434056000,0.0000
92.27.219.132:46482,<->,123.89.2.13:13195,1,213,0,0,1,213,0.433684000,0.0000
98.190.126.215:55079,<->,120.155.84.97:domain,1,141,0,0,1,141,0.433311000,0.0000
97.126.26.70:40692,<->,129.201.176.4:domain,1,840,0,0,1,840,0.433156000,0.0000
216.73.179.43:55629,<->,20.137.239.172:32950,0,0,1,52,1,52,0.432701000,0.0000
123.58.41.255:40184,<->,92.27.219.169:33326,0,0,1,52,1,52,0.431789000,0.0000
33.213.250.150:49001,<->,247.136.213.175:brvread,0,0,1,170,1,170,0.431433000,0.0000
144.75.218.246:5865,<->,132.200.124.228:domain,1,149,0,0,1,149,0.431368000,0.0000
:::50378,<->,:::domain,0,0,1,96,1,96,0.431309000,0.0000
243.117.125.15:56509,<->,129.224.112.252:domain,0,0,1,81,1,81,0.430715000,0.0000
254.199.70.131:46604,<->,109.222.246.242:domain,0,0,1,69,1,69,0.429348000,0.0000
144.75.218.246:59092,<->,8.222.218.204:domain,1,111,0,0,1,111,0.428757000,0.0000
56.61.99.23:52629,<->,97.68.226.205:domain,0,0,1,86,1,86,0.428296000,0.0000
131.144.248.44:enrp,<->,129.224.112.252:domain,0,0,1,80,1,80,0.427499000,0.0000
89.183.104.136:58267,<->,221.196.95.250:28035,1,136,0,0,1,136,0.427027000,0.0000
99.206.178.33:14255,<->,109.222.246.242:domain,0,0,1,69,1,69,0.426272000,0.0000
144.75.218.235:42086,<->,8.222.218.198:domain,1,110,0,0,1,110,0.425421000,0.0000
39.154.1.169:19939,<->,123.129.238.171:domain,1,72,0,0,1,72,0.425408000,0.0000
92.27.219.42:43767,<->,120.155.84.161:domain,1,133,0,0,1,133,0.425184000,0.0000
200.226.80.179:56296,<->,129.92.113.143:chargen,0,0,1,50,1,50,0.424997000,0.0000
144.75.218.233:7559,<->,138.127.225.213:domain,1,227,0,0,1,227,0.423984000,0.0000
144.75.218.241:36461,<->,8.222.218.207:domain,1,126,0,0,1,126,0.423657000,0.0000
144.75.218.246:client-wakeup,<->,8.222.218.204:domain,1,153,0,0,1,153,0.422677000,0.0000
144.75.218.241:47542,<->,8.222.218.204:domain,1,109,0,0,1,109,0.422471000,0.0000
215.158.140.163:46565,<->,130.61.219.1:domain,1,671,0,0,1,671,0.422033000,0.0000
108.180.89.175:63525,<->,192.67.167.86:58021,0,0,1,66,1,66,0.421469000,0.0000
92.27.27.166:53387,<->,27.64.145.201:6881,1,326,0,0,1,326,0.421368000,0.0000
101.87.248.103:27865,<->,132.249.70.213:domain,0,0,1,126,1,126,0.421066000,0.0000
144.75.218.237:22151,<->,120.155.84.97:domain,1,145,0,0,1,145,0.419909000,0.0000
27.188.163.162:i-net-2000-npr,<->,109.1.17.98:sip,0,0,1,445,1,445,0.419674000,0.0000
0.200.50.50:34233,<->,20.13.112.138:domain,0,0,1,60,1,60,0.419459000,0.0000
139.241.73.46:40060,<->,129.224.112.221:domain,0,0,1,84,1,84,0.419032000,0.0000
40.240.144.244:54284,<->,98.67.133.113:domain,0,0,1,74,1,74,0.418183000,0.0000
144.75.218.233:55592,<->,8.222.218.196:domain,1,122,0,0,1,122,0.417661000,0.0000
89.70.190.180:35967,<->,133.178.227.8:domain,0,0,1,85,1,85,0.417397000,0.0000
144.75.218.246:30659,<->,8.222.218.199:domain,1,111,0,0,1,111,0.416870000,0.0000
144.75.218.246:25144,<->,8.222.218.199:domain,1,111,0,0,1,111,0.416018000,0.0000
252.64.177.47:46786,<->,247.136.245.208:20056,0,0,1,321,1,321,0.415999000,0.0000
56.23.171.110:56909,<->,215.158.140.9:12347,0,0,1,1064,1,1064,0.415853000,0.0000
144.75.218.233:17957,<->,143.230.117.93:domain,1,248,0,0,1,248,0.415567000,0.0000
136.25.188.105:49211,<->,131.16.151.86:domain,1,135,0,0,1,135,0.415158000,0.0000
230.14.252.62:57375,<->,39.6.171.212:51641,0,0,1,52,1,52,0.414947000,0.0000
20.194.30.147:30407,<->,92.180.179.45:7136,1,130,0,0,1,130,0.414599000,0.0000
80.47.34.171:58686,<->,80.56.78.128:domain,0,0,1,101,1,101,0.414166000,0.0000
144.75.218.233:5338,<->,138.127.224.104:domain,1,303,0,0,1,303,0.413898000,0.0000
107.21.28.148:22928,<->,192.67.129.253:domain,0,0,1,76,1,76,0.413158000,0.0000
215.158.140.170:33477,<->,130.61.230.62:domain,1,678,0,0,1,678,0.412924000,0.0000
144.75.218.242:32840,<->,139.114.208.35:domain,1,131,0,0,1,131,0.412841000,0.0000
241.242.244.237:50140,<->,138.127.227.251:domain,1,233,0,0,1,233,0.412432000,0.0000
92.27.219.19:48211,<->,198.103.239.241:44223,1,52,0,0,1,52,0.412216000,0.0000
120.82.229.76:6881,<->,80.41.16.79:6881,0,0,1,97,1,97,0.412186000,0.0000
92.27.219.159:58115,<->,99.236.27.146:19947,1,62,0,0,1,62,0.411824000,0.0000
144.75.218.237:34040,<->,138.127.230.130:domain,1,253,0,0,1,253,0.411749000,0.0000
144.75.218.237:28181,<->,8.222.218.198:domain,1,109,0,0,1,109,0.411052000,0.0000
144.75.218.233:14302,<->,8.222.218.196:domain,1,113,0,0,1,113,0.411004000,0.0000
144.75.218.246:19367,<->,132.200.124.228:domain,1,463,0,0,1,463,0.410667000,0.0000
136.26.10.226:ipsec-nat-t,<->,8.228.217.101:ipsec-nat-t,0,0,1,120,1,120,0.410022000,0.0000
140.91.191.15:64857,<->,218.4.187.87:6881,0,0,1,99,1,99,0.409966000,0.0000
144.75.218.242:14764,<->,8.222.218.199:domain,1,113,0,0,1,113,0.408659000,0.0000
193.47.198.119:60369,<->,8.52.161.253:bacnet,0,0,1,67,1,67,0.407902000,0.0000
:::18696,<->,:::domain,1,665,0,0,1,665,0.407763000,0.0000
215.158.103.219:55459,<->,159.176.32.28:domain,1,76,0,0,1,76,0.407517000,0.0000
144.75.218.235:38529,<->,136.99.66.244:domain,1,174,0,0,1,174,0.406974000,0.0000
39.8.201.124:9867,<->,112.7.33.113:domain,1,66,0,0,1,66,0.405969000,0.0000
39.242.94.199:36863,<->,158.164.217.111:domain,1,78,0,0,1,78,0.405944000,0.0000
59.146.81.189:55626,<->,92.27.219.244:36529,0,0,1,52,1,52,0.405911000,0.0000
144.75.218.233:51848,<->,8.222.218.197:domain,1,113,0,0,1,113,0.405833000,0.0000
20.139.218.107:64739,<->,157.142.59.66:62580,1,52,0,0,1,52,0.405743000,0.0000
39.43.98.237:52853,<->,57.126.221.209:domain,1,88,0,0,1,88,0.405724000,0.0000
144.75.218.235:7702,<->,8.222.218.197:domain,1,109,0,0,1,109,0.405569000,0.0000
64.214.63.86:44384,<->,92.27.219.207:6881,0,0,1,62,1,62,0.403772000,0.0000
144.75.218.235:5392,<->,8.222.218.204:domain,1,113,0,0,1,113,0.403632000,0.0000
122.159.69.87:64265,<->,50.224.110.122:domain,0,0,1,86,1,86,0.402666000,0.0000
192.64.195.164:65324,<->,104.251.192.216:59342,1,50,0,0,1,50,0.402568000,0.0000
35.62.71.37:30642,<->,145.252.123.206:domain,0,0,1,68,1,68,0.402239000,0.0000
49.89.97.93:29172,<->,97.126.115.199:domain,0,0,1,78,1,78,0.402060000,0.0000
144.75.218.235:9076,<->,8.222.218.198:domain,1,110,0,0,1,110,0.401623000,0.0000
126.219.197.206:43294,<->,133.178.226.162:domain,0,0,1,90,1,90,0.401318000,0.0000
105.201.211.173:42408,<->,102.51.227.2:18210,0,0,1,330,1,330,0.401300000,0.0000
122.112.203.205:35886,<->,192.64.230.47:29668,0,0,1,52,1,52,0.400381000,0.0000
147.180.61.51:32946,<->,89.216.126.106:6881,0,0,1,97,1,97,0.400319000,0.0000
39.160.238.214:40773,<->,143.148.50.173:11692,1,75,0,0,1,75,0.399892000,0.0000
132.249.70.233:62778,<->,124.51.228.76:domain,1,159,0,0,1,159,0.399336000,0.0000
144.75.218.246:47863,<->,97.94.119.43:domain,1,75,0,0,1,75,0.398060000,0.0000
38.18.60.250:57049,<->,80.41.3.230:6881,0,0,1,135,1,135,0.397775000,0.0000
144.75.218.241:20405,<->,8.222.218.207:domain,1,191,0,0,1,191,0.397481000,0.0000
144.75.218.242:53625,<->,8.222.218.207:domain,1,111,0,0,1,111,0.396408000,0.0000
89.183.104.227:51249,<->,104.152.220.2:33361,1,52,0,0,1,52,0.396075000,0.0000
92.27.219.23:38844,<->,124.178.214.131:25616,1,149,0,0,1,149,0.395884000,0.0000
144.75.218.241:48315,<->,8.222.218.207:domain,1,125,0,0,1,125,0.395715000,0.0000
215.158.103.206:37888,<->,131.92.221.146:domain,1,105,0,0,1,105,0.395607000,0.0000
215.158.103.219:25116,<->,129.220.171.193:domain,1,782,0,0,1,782,0.395285000,0.0000
197.113.175.58:22707,<->,129.224.112.252:domain,0,0,1,93,1,93,0.395118000,0.0000
144.75.218.235:44367,<->,138.127.225.253:domain,1,291,0,0,1,291,0.394841000,0.0000
109.14.167.30:52838,<->,79.255.66.183:12694,1,130,0,0,1,130,0.394658000,0.0000
144.75.218.235:14736,<->,8.222.218.197:domain,1,181,0,0,1,181,0.394286000,0.0000
20.194.30.147:55352,<->,92.180.179.45:7136,1,130,0,0,1,130,0.394255000,0.0000
215.158.103.219:30536,<->,126.84.20.136:domain,1,166,0,0,1,166,0.394233000,0.0000
215.158.239.105:56250,<->,215.158.214.222:domain,1,141,0,0,1,141,0.394013000,0.0000
144.75.218.242:11406,<->,159.57.86.226:domain,1,141,0,0,1,141,0.393932000,0.0000
57.85.32.67:45146,<->,247.136.180.69:42479,0,0,1,149,1,149,0.393362000,0.0000
33.49.23.119:33686,<->,111.146.237.145:http,0,0,1,135,1,135,0.393110000,0.0000
92.27.219.33:53741,<->,38.94.255.65:36717,1,58,0,0,1,58,0.393034000,0.0000
92.27.219.242:50275,<->,207.78.70.240:28551,1,52,0,0,1,52,0.392499000,0.0000
144.75.218.241:52380,<->,8.222.218.207:domain,1,113,0,0,1,113,0.391753000,0.0000
89.183.104.138:14448,<->,197.44.22.113:11974,1,52,0,0,1,52,0.391338000,0.0000
144.75.218.241:62316,<->,8.222.218.196:domain,1,122,0,0,1,122,0.391199000,0.0000
144.75.218.242:37124,<->,8.222.218.199:domain,1,113,0,0,1,113,0.390770000,0.0000
144.75.218.246:46353,<->,132.200.124.228:domain,1,143,0,0,1,143,0.390717000,0.0000
144.75.218.235:46371,<->,129.35.251.34:domain,1,136,0,0,1,136,0.390564000,0.0000
144.75.218.241:45329,<->,120.155.84.97:domain,1,170,0,0,1,170,0.390297000,0.0000
130.13.151.57:64376,<->,92.27.219.63:15653,0,0,1,52,1,52,0.390256000,0.0000
121.71.65.35:27084,<->,92.27.219.182:apollo-cc,0,0,1,102,1,102,0.390152000,0.0000
18.200.206.47:51413,<->,92.27.27.164:11536,0,0,1,315,1,315,0.390072000,0.0000
132.249.70.233:52164,<->,222.20.200.135:domain,1,133,0,0,1,133,0.390009000,0.0000
117.154.63.56:39007,<->,100.94.16.235:14722,0,0,1,105,1,105,0.389715000,0.0000
126.82.210.35:58253,<->,92.27.219.19:45336,0,0,1,52,1,52,0.389601000,0.0000
210.158.44.231:32902,<->,8.220.7.206:domain,1,149,0,0,1,149,0.389422000,0.0000
220.55.97.182:60858,<->,27.11.68.126:domain,1,148,0,0,1,148,0.389339000,0.0000
136.25.188.105:62921,<->,132.5.71.202:domain,1,211,0,0,1,211,0.388972000,0.0000
39.140.92.107:61382,<->,118.125.182.41:domain,1,140,0,0,1,140,0.388618000,0.0000
127.87.219.139:39633,<->,80.42.165.24:11496,0,0,1,135,1,135,0.388597000,0.0000
144.75.218.246:50753,<->,146.1.155.25:domain,1,171,0,0,1,171,0.388051000,0.0000
89.183.104.234:36423,<->,33.95.62.155:12298,1,321,0,0,1,321,0.387842000,0.0000
141.21.245.250:54357,<->,129.224.112.252:domain,0,0,1,59,1,59,0.387039000,0.0000
144.75.218.246:55741,<->,138.127.230.151:domain,1,68,0,0,1,68,0.386380000,0.0000
34.248.11.46:21217,<->,77.19.64.23:domain,1,132,0,0,1,132,0.385715000,0.0000
117.38.167.80:49892,<->,89.183.104.177:33160,0,0,1,263,1,263,0.385433000,0.0000
141.245.151.215:27315,<->,136.47.66.197:domain,1,85,0,0,1,85,0.384108000,0.0000
144.75.218.237:43956,<->,8.222.218.197:domain,1,110,0,0,1,110,0.383989000,0.0000
144.75.218.237:58113,<->,120.155.84.97:domain,1,214,0,0,1,214,0.383359000,0.0000
144.75.218.237:5731,<->,8.222.218.198:domain,1,113,0,0,1,113,0.382945000,0.0000
215.158.239.105:63461,<->,111.151.107.247:domain,1,174,0,0,1,174,0.382295000,0.0000
21.15.226.126:55104,<->,20.193.52.72:netbios-ns,0,0,1,82,1,82,0.382120000,0.0000
218.5.92.23:57770,<->,159.133.63.103:domain,0,0,1,76,1,76,0.382028000,0.0000
144.75.218.233:5950,<->,8.222.218.197:domain,1,124,0,0,1,124,0.381724000,0.0000
123.251.189.247:60428,<->,109.222.250.174:domain,0,0,1,78,1,78,0.381655000,0.0000
144.75.218.235:6744,<->,139.252.1.242:domain,1,116,0,0,1,116,0.381655000,0.0000
144.75.218.242:45454,<->,8.222.218.207:domain,1,114,0,0,1,114,0.381654000,0.0000
105.201.221.207:44377,<->,139.163.8.52:12819,0,0,1,88,1,88,0.381557000,0.0000
78.128.203.22:47344,<->,39.15.169.14:domain,0,0,1,87,1,87,0.380452000,0.0000
33.78.13.33:38963,<->,129.224.112.252:domain,0,0,1,79,1,79,0.380333000,0.0000
114.187.168.248:45304,<->,129.224.112.252:domain,0,0,1,70,1,70,0.379901000,0.0000
34.16.125.126:62437,<->,156.132.134.164:domain,1,72,0,0,1,72,0.379630000,0.0000
102.50.117.189:54103,<->,92.27.27.181:19399,0,0,1,397,1,397,0.379094000,0.0000
8.252.222.10:63054,<->,192.171.13.189:domain,1,157,0,0,1,157,0.378159000,0.0000
192.205.38.247:64871,<->,29.211.214.254:domain,0,0,1,92,1,92,0.377648000,0.0000
217.9.139.9:31439,<->,132.249.70.213:domain,0,0,1,101,1,101,0.376518000,0.0000
198.59.252.179:62470,<->,89.183.104.231:estamp,0,0,1,52,1,52,0.376404000,0.0000
100.94.72.189:48530,<->,196.24.224.171:14194,1,130,0,0,1,130,0.376271000,0.0000
215.158.239.105:50076,<->,159.147.253.1:domain,1,220,0,0,1,220,0.376036000,0.0000
144.75.218.237:47460,<->,220.31.22.169:domain,1,248,0,0,1,248,0.375800000,0.0000
144.75.218.235:15384,<->,8.222.218.198:domain,1,123,0,0,1,123,0.375734000,0.0000
127.180.125.49:nsws,<->,97.168.91.134:domain,0,0,1,72,1,72,0.375667000,0.0000
52.220.244.34:24702,<->,102.232.177.73:domain,0,0,1,71,1,71,0.375463000,0.0000
100.93.238.68:52185,<->,144.76.46.38:domain,1,158,0,0,1,158,0.374887000,0.0000
38.21.156.204:56633,<->,20.232.229.96:netbios-ns,0,0,1,82,1,82,0.374621000,0.0000
136.25.188.105:56307,<->,128.243.151.37:domain,1,123,0,0,1,123,0.374456000,0.0000
8.176.8.71:51381,<->,192.171.13.189:domain,1,138,0,0,1,138,0.373573000,0.0000
144.75.218.237:20701,<->,8.222.218.198:domain,1,111,0,0,1,111,0.372616000,0.0000
39.249.24.116:6130,<->,148.162.217.87:domain,1,78,0,0,1,78,0.372338000,0.0000
210.221.111.210:6881,<->,155.17.159.75:6881,1,109,0,0,1,109,0.372263000,0.0000
144.75.218.246:27954,<->,8.222.218.204:domain,1,110,0,0,1,110,0.371795000,0.0000
144.75.218.241:34145,<->,120.155.84.97:domain,1,147,0,0,1,147,0.371660000,0.0000
113.63.153.121:62348,<->,89.183.104.243:11841,0,0,1,98,1,98,0.371618000,0.0000
39.43.170.225:30825,<->,147.54.117.181:domain,1,134,0,0,1,134,0.370986000,0.0000
99.160.105.66:43615,<->,146.198.38.34:27262,1,67,0,0,1,67,0.370985000,0.0000
144.75.218.237:34059,<->,8.222.218.204:domain,1,110,0,0,1,110,0.370691000,0.0000
98.67.155.63:56808,<->,53.196.208.123:domain,1,193,0,0,1,193,0.370642000,0.0000
26.81.16.237:30416,<->,109.222.253.48:domain,0,0,1,75,1,75,0.369966000,0.0000
144.75.218.242:42966,<->,8.222.218.199:domain,1,126,0,0,1,126,0.369607000,0.0000
136.25.188.105:64610,<->,128.243.151.35:domain,1,149,0,0,1,149,0.369315000,0.0000
215.158.103.219:20145,<->,138.127.231.62:domain,1,276,0,0,1,276,0.369286000,0.0000
215.158.239.105:59134,<->,210.104.195.8:domain,1,256,0,0,1,256,0.368905000,0.0000
144.75.218.246:56029,<->,8.222.218.199:domain,1,113,0,0,1,113,0.368625000,0.0000
80.42.160.210:21905,<->,125.10.150.102:1024,1,99,0,0,1,99,0.368372000,0.0000
144.75.218.242:35887,<->,8.222.218.199:domain,1,110,0,0,1,110,0.368245000,0.0000
80.41.16.226:29265,<->,216.132.55.74:13050,1,52,0,0,1,52,0.368137000,0.0000
144.75.218.237:57170,<->,50.149.206.150:domain,1,205,0,0,1,205,0.367131000,0.0000
:::15293,<->,:::domain,1,740,0,0,1,740,0.367129000,0.0000
144.108.80.170:38389,<->,144.122.240.194:domain,0,0,1,61,1,61,0.366859000,0.0000
103.147.216.59:60738,<->,192.67.167.86:60093,0,0,1,83,1,83,0.366237000,0.0000
50.62.255.14:26961,<->,192.67.174.62:6881,0,0,1,97,1,97,0.365972000,0.0000
92.27.219.34:61923,<->,95.169.150.140:45997,1,52,0,0,1,52,0.365856000,0.0000
144.75.218.242:38034,<->,8.222.218.196:domain,1,114,0,0,1,114,0.365758000,0.0000
93.170.103.133:65287,<->,109.1.47.253:58516,0,0,1,50,1,50,0.365375000,0.0000
144.75.218.246:14153,<->,8.222.218.204:domain,1,111,0,0,1,111,0.365358000,0.0000
144.75.218.242:60012,<->,8.222.218.207:domain,1,123,0,0,1,123,0.365176000,0.0000
144.75.218.242:42776,<->,8.222.218.199:domain,1,125,0,0,1,125,0.364845000,0.0000
97.242.126.187:22103,<->,108.134.117.140:domain,0,0,1,75,1,75,0.364754000,0.0000
21.15.226.126:55104,<->,20.193.52.152:netbios-ns,0,0,1,82,1,82,0.364549000,0.0000
144.75.218.242:39954,<->,146.253.87.247:domain,1,119,0,0,1,119,0.364297000,0.0000
39.58.191.75:65320,<->,146.199.195.194:domain,1,134,0,0,1,134,0.364142000,0.0000
215.158.103.206:9015,<->,120.155.87.47:domain,1,102,0,0,1,102,0.363568000,0.0000
39.53.120.116:54880,<->,156.148.151.114:domain,1,531,0,0,1,531,0.363452000,0.0000
215.158.239.105:52044,<->,111.151.107.247:domain,1,164,0,0,1,164,0.363021000,0.0000
144.75.218.242:5219,<->,138.127.224.235:domain,1,306,0,0,1,306,0.362951000,0.0000
215.158.239.105:57353,<->,111.151.107.247:domain,1,166,0,0,1,166,0.362580000,0.0000
21.15.226.126:55104,<->,20.193.52.158:netbios-ns,0,0,1,82,1,82,0.362462000,0.0000
144.75.218.242:19090,<->,8.222.218.204:domain,1,123,0,0,1,123,0.362360000,0.0000
133.178.226.161:55067,<->,111.150.207.83:domain,1,163,0,0,1,163,0.362350000,0.0000
215.158.239.105:61275,<->,192.226.44.43:domain,1,111,0,0,1,111,0.362152000,0.0000
144.76.43.234:53838,<->,138.98.141.131:domain,0,0,1,83,1,83,0.361924000,0.0000
8.252.222.19:36464,<->,192.171.13.80:domain,1,134,0,0,1,134,0.361773000,0.0000
144.75.218.242:13166,<->,138.127.225.21:domain,1,254,0,0,1,254,0.360981000,0.0000
144.75.218.237:4392,<->,132.208.122.193:domain,1,133,0,0,1,133,0.360917000,0.0000
127.162.227.139:57863,<->,247.136.216.15:56382,0,0,1,50,1,50,0.359592000,0.0000
144.75.218.235:jlicelmd,<->,8.222.218.204:domain,1,121,0,0,1,121,0.359234000,0.0000
80.42.150.137:61724,<->,193.46.99.114:21386,1,300,0,0,1,300,0.358518000,0.0000
192.64.224.151:45667,<->,206.115.123.105:20844,1,135,0,0,1,135,0.357273000,0.0000
192.64.217.166:14773,<->,112.238.34.98:13814,1,52,0,0,1,52,0.356696000,0.0000
144.75.218.242:52861,<->,8.222.218.199:domain,1,179,0,0,1,179,0.356616000,0.0000
144.75.218.237:13032,<->,8.222.218.207:domain,1,112,0,0,1,112,0.356443000,0.0000
133.81.199.205:12358,<->,215.158.2.59:domain,1,88,0,0,1,88,0.355910000,0.0000
100.50.96.76:52745,<->,136.129.83.88:domain,0,0,1,81,1,81,0.355694000,0.0000
21.15.226.126:55104,<->,20.193.52.171:netbios-ns,0,0,1,82,1,82,0.355423000,0.0000
144.75.218.241:7850,<->,8.222.218.204:domain,1,110,0,0,1,110,0.355104000,0.0000
107.99.228.94:29639,<->,137.81.65.54:domain,0,0,1,77,1,77,0.354507000,0.0000
21.15.226.126:55104,<->,20.193.52.175:netbios-ns,0,0,1,82,1,82,0.354450000,0.0000
92.162.252.175:57452,<->,128.156.80.162:domain,1,142,0,0,1,142,0.353842000,0.0000
136.25.188.105:50166,<->,128.243.151.37:domain,1,120,0,0,1,120,0.353809000,0.0000
144.75.218.237:16256,<->,8.222.218.204:domain,1,109,0,0,1,109,0.352719000,0.0000
131.144.248.40:50360,<->,129.224.112.252:domain,0,0,1,77,1,77,0.352585000,0.0000
68.206.114.172:16492,<->,132.149.113.27:6881,0,0,1,130,1,130,0.352408000,0.0000
98.128.84.189:62680,<->,105.170.125.212:microsan,1,906,0,0,1,906,0.352339000,0.0000
144.75.218.237:59747,<->,8.222.218.197:domain,1,110,0,0,1,110,0.351919000,0.0000
144.75.218.233:45926,<->,129.165.131.13:domain,1,189,0,0,1,189,0.351783000,0.0000
144.75.218.237:22149,<->,137.23.166.213:domain,1,279,0,0,1,279,0.351745000,0.0000
120.146.111.188:24354,<->,247.136.200.213:6690,0,0,1,319,1,319,0.351721000,0.0000
199.108.208.102:55510,<->,92.27.219.182:54036,0,0,1,1455,1,1455,0.351591000,0.0000
144.75.218.246:24729,<->,129.127.53.251:domain,1,141,0,0,1,141,0.351468000,0.0000
82.106.63.160:54112,<->,247.136.161.17:6881,0,0,1,52,1,52,0.351404000,0.0000
34.93.69.102:kv-agent,<->,98.8.84.242:domain,1,134,0,0,1,134,0.351028000,0.0000
144.75.218.246:28790,<->,8.222.218.197:domain,1,112,0,0,1,112,0.350809000,0.0000
144.75.218.246:53918,<->,8.222.218.197:domain,1,122,0,0,1,122,0.349840000,0.0000
159.123.32.28:28091,<->,215.158.2.46:domain,1,88,0,0,1,88,0.349590000,0.0000
92.27.219.46:40368,<->,198.70.237.101:37830,1,52,0,0,1,52,0.349445000,0.0000
8.252.222.11:60498,<->,192.171.13.189:domain,1,143,0,0,1,143,0.349068000,0.0000
144.75.218.241:37893,<->,8.222.218.204:domain,1,124,0,0,1,124,0.348413000,0.0000
144.75.218.246:41739,<->,8.222.218.197:domain,1,113,0,0,1,113,0.348207000,0.0000
215.158.140.163:47681,<->,126.219.102.124:domain,1,106,0,0,1,106,0.348171000,0.0000
144.75.218.241:40990,<->,8.222.218.196:domain,1,113,0,0,1,113,0.347679000,0.0000
58.202.16.67:35788,<->,34.9.89.117:18848,0,0,1,52,1,52,0.347519000,0.0000
58.132.245.34:50992,<->,20.182.55.13:14267,0,0,1,52,1,52,0.347222000,0.0000
100.230.144.109:11591,<->,132.159.118.94:domain,0,0,1,79,1,79,0.347022000,0.0000
159.154.230.134:46604,<->,67.103.130.54:13841,1,130,0,0,1,130,0.346265000,0.0000
141.92.221.24:54479,<->,241.231.183.50:domain,0,0,1,87,1,87,0.346219000,0.0000
114.253.132.49:56865,<->,80.40.25.242:40500,0,0,1,61,1,61,0.346037000,0.0000
144.75.218.246:26552,<->,8.222.218.204:domain,1,111,0,0,1,111,0.345837000,0.0000
216.184.0.236:35303,<->,246.253.248.211:domain,0,0,1,79,1,79,0.345421000,0.0000
144.75.218.235:57919,<->,8.47.122.178:domain,1,100,0,0,1,100,0.345412000,0.0000
144.75.218.242:55160,<->,8.222.218.199:domain,1,153,0,0,1,153,0.345330000,0.0000
144.75.218.233:6666,<->,53.162.176.63:domain,1,395,0,0,1,395,0.344741000,0.0000
21.15.226.126:55104,<->,20.193.51.231:netbios-ns,0,0,1,82,1,82,0.344345000,0.0000
144.75.218.242:41223,<->,8.222.218.207:domain,1,151,0,0,1,151,0.344166000,0.0000
144.75.218.233:47197,<->,138.127.230.49:domain,1,263,0,0,1,263,0.344100000,0.0000
144.75.218.237:12948,<->,8.222.218.207:domain,1,122,0,0,1,122,0.343422000,0.0000
195.3.157.138:47143,<->,129.224.112.252:domain,0,0,1,75,1,75,0.343206000,0.0000
20.138.181.255:51689,<->,149.50.109.18:domain,1,75,0,0,1,75,0.342018000,0.0000
80.40.50.197:63938,<->,103.18.240.78:53393,1,52,0,0,1,52,0.341754000,0.0000
144.75.218.246:21181,<->,8.222.218.199:domain,1,111,0,0,1,111,0.341635000,0.0000
104.34.67.250:33113,<->,92.27.219.194:31086,0,0,1,135,1,135,0.340789000,0.0000
136.25.188.105:58155,<->,129.70.124.49:domain,1,135,0,0,1,135,0.340735000,0.0000
89.181.189.56:64832,<->,230.95.236.34:17822,1,130,0,0,1,130,0.340420000,0.0000
39.8.88.74:30147,<->,158.3.202.66:domain,1,78,0,0,1,78,0.339838000,0.0000
144.75.218.233:ehs,<->,8.222.218.196:domain,1,127,0,0,1,127,0.339753000,0.0000
20.20.200.106:ms-la,<->,158.226.109.18:domain,1,80,0,0,1,80,0.339634000,0.0000
144.75.218.241:airs,<->,137.132.222.177:domain,1,110,0,0,1,110,0.339607000,0.0000
123.125.71.216:51413,<->,100.94.190.20:24632,0,0,1,52,1,52,0.339283000,0.0000
144.75.218.237:30209,<->,8.222.218.198:domain,1,113,0,0,1,113,0.339102000,0.0000
118.234.22.105:64828,<->,89.183.104.141:19370,0,0,1,52,1,52,0.338882000,0.0000
121.60.236.104:34440,<->,92.27.27.164:11536,0,0,1,349,1,349,0.338704000,0.0000
145.229.2.58:sip,<->,138.68.168.244:sip,0,0,1,347,1,347,0.338305000,0.0000
136.25.188.217:46525,<->,192.171.13.189:domain,1,138,0,0,1,138,0.338282000,0.0000
92.27.27.156:61094,<->,142.221.194.104:23786,1,351,0,0,1,351,0.338056000,0.0000
92.27.219.242:43547,<->,125.161.104.51:18571,1,52,0,0,1,52,0.337962000,0.0000
144.75.218.242:24555,<->,8.222.218.207:domain,1,153,0,0,1,153,0.337766000,0.0000
215.158.30.54:44601,<->,29.211.214.254:domain,0,0,1,87,1,87,0.336792000,0.0000
144.75.218.235:16035,<->,97.94.119.24:domain,1,77,0,0,1,77,0.336671000,0.0000
112.17.31.45:30868,<->,137.83.251.44:sip,0,0,1,50,1,50,0.335045000,0.0000
:::39969,<->,:::domain,1,161,0,0,1,161,0.334982000,0.0000
97.126.26.71:41472,<->,127.250.253.245:domain,1,82,0,0,1,82,0.334733000,0.0000
144.75.218.235:50777,<->,8.222.218.197:domain,1,114,0,0,1,114,0.334435000,0.0000
144.75.218.237:18790,<->,8.222.218.204:domain,1,121,0,0,1,121,0.332931000,0.0000
200.226.80.179:14355,<->,129.92.113.143:chargen,0,0,1,50,1,50,0.332836000,0.0000
144.75.218.246:24708,<->,53.200.173.149:domain,1,234,0,0,1,234,0.332330000,0.0000
144.75.218.241:14455,<->,8.222.218.207:domain,1,121,0,0,1,121,0.331795000,0.0000
144.75.218.246:40314,<->,8.222.218.199:domain,1,110,0,0,1,110,0.331729000,0.0000
144.75.218.237:43354,<->,8.222.218.204:domain,1,122,0,0,1,122,0.331606000,0.0000
122.0.180.69:41928,<->,80.41.41.240:31517,0,0,1,135,1,135,0.331422000,0.0000
192.64.91.148:62492,<->,230.95.83.187:21410,1,133,0,0,1,133,0.329939000,0.0000
123.163.186.237:17164,<->,39.15.169.14:domain,0,0,1,88,1,88,0.329713000,0.0000
144.108.80.174:31251,<->,159.69.187.28:domain,0,0,1,63,1,63,0.329405000,0.0000
144.75.218.242:58946,<->,8.222.218.196:domain,1,140,0,0,1,140,0.329400000,0.0000
21.15.226.126:55104,<->,20.193.51.183:netbios-ns,0,0,1,82,1,82,0.328871000,0.0000
144.75.218.246:17022,<->,102.45.225.190:domain,1,74,0,0,1,74,0.328537000,0.0000
143.252.64.224:34351,<->,129.224.112.252:domain,0,0,1,71,1,71,0.328182000,0.0000
76.75.85.195:16001,<->,109.222.242.9:bacula-dir,0,0,1,133,1,133,0.328056000,0.0000
99.75.217.171:43859,<->,118.125.238.242:domain,1,76,0,0,1,76,0.327906000,0.0000
136.181.50.197:51876,<->,158.186.230.206:22131,1,169,0,0,1,169,0.327896000,0.0000
144.75.218.235:29966,<->,8.222.218.204:domain,1,110,0,0,1,110,0.327817000,0.0000
136.25.188.105:63557,<->,140.136.9.105:domain,1,232,0,0,1,232,0.327570000,0.0000
113.92.168.222:51746,<->,133.178.226.161:domain,0,0,1,90,1,90,0.326954000,0.0000
98.150.107.161:35638,<->,97.126.24.188:33437,0,0,1,50,1,50,0.326855000,0.0000
129.19.247.27:42081,<->,144.69.82.139:domain,0,0,1,65,1,65,0.326498000,0.0000
136.25.188.105:52736,<->,128.243.151.33:domain,1,287,0,0,1,287,0.325982000,0.0000
192.67.152.0:62617,<->,125.5.241.52:60391,1,52,0,0,1,52,0.325874000,0.0000
39.247.154.221:25585,<->,109.222.253.150:domain,0,0,1,74,1,74,0.325799000,0.0000
144.75.218.246:43159,<->,53.200.173.149:domain,1,234,0,0,1,234,0.325410000,0.0000
116.94.248.161:42247,<->,109.222.246.241:domain,0,0,1,76,1,76,0.324744000,0.0000
118.51.58.214:28043,<->,192.67.159.167:6881,0,0,1,138,1,138,0.324384000,0.0000
134.103.233.204:63073,<->,192.67.133.6:51413,0,0,1,135,1,135,0.323937000,0.0000
144.75.218.237:48855,<->,8.222.218.207:domain,1,149,0,0,1,149,0.323861000,0.0000
144.75.218.233:35442,<->,8.222.218.197:domain,1,114,0,0,1,114,0.323537000,0.0000
89.183.104.175:49831,<->,27.41.82.122:15365,1,1431,0,0,1,1431,0.322820000,0.0000
195.3.157.138:36397,<->,129.224.112.252:domain,0,0,1,72,1,72,0.322146000,0.0000
200.226.80.179:51049,<->,129.92.113.143:chargen,0,0,1,50,1,50,0.322007000,0.0000
92.27.219.216:39482,<->,42.204.6.217:6881,1,309,0,0,1,309,0.321920000,0.0000
215.158.103.219:32172,<->,138.127.224.207:domain,1,299,0,0,1,299,0.321315000,0.0000
144.75.218.237:46882,<->,120.155.84.97:domain,1,184,0,0,1,184,0.320940000,0.0000
144.75.218.246:11985,<->,8.222.218.204:domain,1,110,0,0,1,110,0.320837000,0.0000
144.75.218.233:29752,<->,8.222.218.196:domain,1,206,0,0,1,206,0.320812000,0.0000
194.105.236.217:37294,<->,129.224.112.252:domain,0,0,1,82,1,82,0.320210000,0.0000
144.75.218.242:52820,<->,8.222.218.196:domain,1,151,0,0,1,151,0.319974000,0.0000
136.25.188.105:60288,<->,129.70.124.49:domain,1,123,0,0,1,123,0.319896000,0.0000
92.27.219.50:29468,<->,148.127.114.12:23854,1,52,0,0,1,52,0.318546000,0.0000
104.230.130.153:57983,<->,247.136.138.97:6881,0,0,1,97,1,97,0.318279000,0.0000
20.130.242.39:59132,<->,207.74.66.179:domain,1,66,0,0,1,66,0.318268000,0.0000
39.252.18.244:47367,<->,74.235.239.33:domain,1,72,0,0,1,72,0.318046000,0.0000
144.75.218.242:58529,<->,138.127.230.139:domain,1,366,0,0,1,366,0.317596000,0.0000
192.64.217.166:14773,<->,127.15.227.181:10814,1,135,0,0,1,135,0.317561000,0.0000
215.158.140.170:46566,<->,97.4.116.236:domain,1,103,0,0,1,103,0.317296000,0.0000
144.75.218.237:46046,<->,8.222.218.198:domain,1,122,0,0,1,122,0.317243000,0.0000
144.75.218.242:24055,<->,8.222.218.199:domain,1,111,0,0,1,111,0.315466000,0.0000
92.27.219.148:30829,<->,104.9.192.113:8441,1,130,0,0,1,130,0.315434000,0.0000
65.212.33.33:12491,<->,139.163.92.210:domain,0,0,1,78,1,78,0.315181000,0.0000
136.25.188.105:57529,<->,128.243.151.33:domain,1,139,0,0,1,139,0.314546000,0.0000
215.158.140.170:38277,<->,215.158.209.184:domain,1,106,0,0,1,106,0.314461000,0.0000
217.9.139.9:52113,<->,132.249.70.213:domain,0,0,1,101,1,101,0.314459000,0.0000
144.75.218.237:34140,<->,120.155.84.97:domain,1,121,0,0,1,121,0.314226000,0.0000
144.75.218.235:60648,<->,8.222.218.204:domain,1,122,0,0,1,122,0.313815000,0.0000
196.27.47.139:38076,<->,102.51.189.104:6881,0,0,1,262,1,262,0.313774000,0.0000
104.67.149.22:57691,<->,39.9.119.23:ldap,0,0,1,205,1,205,0.313365000,0.0000
59.33.166.136:50197,<->,98.129.80.71:6881,0,0,1,138,1,138,0.313273000,0.0000
89.183.104.138:6889,<->,112.79.207.61:1024,1,149,0,0,1,149,0.313230000,0.0000
144.75.218.246:7590,<->,8.222.218.199:domain,1,111,0,0,1,111,0.313020000,0.0000
21.15.226.126:55104,<->,20.193.51.161:netbios-ns,0,0,1,82,1,82,0.312944000,0.0000
33.58.164.61:49001,<->,80.42.146.108:47890,0,0,1,174,1,174,0.311216000,0.0000
75.92.184.28:51287,<->,109.222.244.209:12769,0,0,1,105,1,105,0.310060000,0.0000
39.213.127.191:53226,<->,197.156.165.4:domain,1,68,0,0,1,68,0.309910000,0.0000
144.75.218.233:21904,<->,8.222.218.204:domain,1,127,0,0,1,127,0.309689000,0.0000
117.2.252.55:35840,<->,92.27.219.250:dnap,0,0,1,321,1,321,0.309649000,0.0000
129.121.121.12:62116,<->,159.87.104.238:domain,0,0,1,72,1,72,0.309097000,0.0000
29.219.16.87:50308,<->,92.27.27.99:44636,0,0,1,293,1,293,0.308870000,0.0000
:::51882,<->,:::domain,0,0,1,112,1,112,0.308574000,0.0000
215.158.140.163:33030,<->,29.211.93.14:domain,1,105,0,0,1,105,0.308159000,0.0000
56.23.171.247:33927,<->,215.158.238.133:12347,0,0,1,1064,1,1064,0.308081000,0.0000
95.221.85.194:40021,<->,109.222.250.107:33409,0,0,1,877,1,877,0.307789000,0.0000
111.146.169.0:55294,<->,205.81.190.171:25064,1,138,0,0,1,138,0.307518000,0.0000
144.75.218.246:11434,<->,8.222.218.197:domain,1,123,0,0,1,123,0.307357000,0.0000
116.244.1.168:31313,<->,20.82.95.229:31313,0,0,1,65,1,65,0.307270000,0.0000
97.126.26.71:24749,<->,138.127.224.101:domain,1,84,0,0,1,84,0.307020000,0.0000
144.75.218.235:61346,<->,8.222.218.204:domain,1,124,0,0,1,124,0.306864000,0.0000
144.75.218.233:57026,<->,136.99.66.245:domain,1,174,0,0,1,174,0.306671000,0.0000
6.44.81.76:32216,<->,101.70.107.137:domain,0,0,1,66,1,66,0.306402000,0.0000
92.27.27.182:bctp,<->,140.168.161.68:6881,1,99,0,0,1,99,0.306073000,0.0000
215.158.140.163:33069,<->,113.24.0.152:domain,1,134,0,0,1,134,0.305351000,0.0000
100.230.7.112:34558,<->,92.162.252.191:33435,0,0,1,50,1,50,0.304878000,0.0000
105.192.129.57:6881,<->,98.67.140.11:6881,0,0,1,97,1,97,0.304457000,0.0000
131.230.134.171:44236,<->,246.253.248.210:domain,0,0,1,86,1,86,0.304348000,0.0000
144.75.218.242:33035,<->,8.222.218.199:domain,1,143,0,0,1,143,0.303957000,0.0000
144.75.218.233:38105,<->,132.200.124.228:domain,1,167,0,0,1,167,0.303775000,0.0000
48.107.168.216:64827,<->,89.183.104.252:27763,0,0,1,52,1,52,0.303701000,0.0000
20.56.131.162:39288,<->,196.114.35.219:domain,1,72,0,0,1,72,0.303552000,0.0000
144.75.218.237:25175,<->,138.127.225.249:domain,1,265,0,0,1,265,0.303387000,0.0000
149.178.48.81:52283,<->,129.224.112.252:domain,0,0,1,82,1,82,0.303296000,0.0000
20.28.157.87:12937,<->,149.15.111.138:domain,1,76,0,0,1,76,0.303202000,0.0000
144.75.218.242:x-bone-api,<->,8.222.218.207:domain,1,110,0,0,1,110,0.302708000,0.0000
113.171.246.29:32759,<->,144.93.121.10:25397,0,0,1,104,1,104,0.302591000,0.0000
144.75.218.241:49848,<->,111.20.61.182:domain,1,86,0,0,1,86,0.302051000,0.0000
92.27.218.64:31160,<->,193.46.99.193:wsicopy,1,129,0,0,1,129,0.301821000,0.0000
144.75.218.235:53450,<->,8.222.218.197:domain,1,143,0,0,1,143,0.301767000,0.0000
144.75.218.237:25146,<->,8.222.218.198:domain,1,181,0,0,1,181,0.301286000,0.0000
215.158.103.206:52708,<->,129.223.93.3:domain,1,649,0,0,1,649,0.300709000,0.0000
113.141.30.72:58505,<->,89.183.104.173:30667,0,0,1,357,1,357,0.300656000,0.0000
106.5.213.19:27132,<->,159.87.104.238:domain,0,0,1,83,1,83,0.300631000,0.0000
144.75.218.242:19555,<->,8.222.218.199:domain,1,113,0,0,1,113,0.300546000,0.0000
144.75.218.242:55370,<->,8.222.218.207:domain,1,110,0,0,1,110,0.300446000,0.0000
109.1.61.240:34074,<->,197.2.207.32:32037,1,61,0,0,1,61,0.299777000,0.0000
246.253.34.209:51122,<->,78.200.213.11:warmspotMgmt,1,52,0,0,1,52,0.299425000,0.0000
112.236.179.11:58606,<->,192.64.217.166:14773,0,0,1,52,1,52,0.299345000,0.0000
215.158.140.163:49042,<->,8.222.0.246:domain,1,134,0,0,1,134,0.298847000,0.0000
68.227.114.115:55362,<->,92.27.219.48:24874,0,0,1,52,1,52,0.297930000,0.0000
215.158.140.163:38852,<->,8.222.0.246:domain,1,105,0,0,1,105,0.297850000,0.0000
144.75.218.237:16755,<->,8.222.218.207:domain,1,110,0,0,1,110,0.297826000,0.0000
136.25.188.105:57711,<->,132.5.71.202:domain,1,251,0,0,1,251,0.297623000,0.0000
144.75.218.246:59542,<->,8.222.218.197:domain,1,123,0,0,1,123,0.297276000,0.0000
114.187.50.12:appliance-cfg,<->,129.224.112.252:domain,0,0,1,79,1,79,0.297256000,0.0000
144.75.218.235:33725,<->,138.127.224.103:domain,1,365,0,0,1,365,0.297148000,0.0000
89.183.104.238:26282,<->,122.245.179.149:asi,1,52,0,0,1,52,0.296929000,0.0000
92.27.219.58:64190,<->,193.89.192.220:menandmice-dns,1,50,0,0,1,50,0.296564000,0.0000
144.75.218.242:50676,<->,8.222.218.199:domain,1,127,0,0,1,127,0.296471000,0.0000
144.75.218.246:30211,<->,8.222.218.204:domain,1,190,0,0,1,190,0.296343000,0.0000
21.15.226.126:55104,<->,20.193.48.7:netbios-ns,0,0,1,82,1,82,0.296265000,0.0000
144.75.218.246:56331,<->,8.222.218.197:domain,1,125,0,0,1,125,0.296016000,0.0000
91.54.155.124:59359,<->,132.249.70.233:domain,0,0,1,70,1,70,0.295885000,0.0000
192.64.193.89:43194,<->,27.50.54.159:19769,1,135,0,0,1,135,0.295686000,0.0000
99.73.202.52:50321,<->,117.156.100.40:11485,1,138,0,0,1,138,0.295681000,0.0000
109.3.149.0:17148,<->,202.236.234.97:6881,1,319,0,0,1,319,0.295269000,0.0000
27.188.163.162:i-net-2000-npr,<->,109.1.17.76:sip,0,0,1,447,1,447,0.295121000,0.0000
200.226.80.179:10725,<->,129.92.113.143:chargen,0,0,1,50,1,50,0.294770000,0.0000
143.127.56.179:16174,<->,246.253.248.210:domain,0,0,1,87,1,87,0.294641000,0.0000
144.75.218.237:59794,<->,8.222.218.204:domain,1,121,0,0,1,121,0.294295000,0.0000
144.75.218.246:9127,<->,8.222.218.204:domain,1,110,0,0,1,110,0.293800000,0.0000
118.116.183.59:52976,<->,92.27.219.38:25521,0,0,1,52,1,52,0.293081000,0.0000
206.228.176.15:38673,<->,92.27.219.18:38219,0,0,1,133,1,133,0.293021000,0.0000
138.48.80.166:49171,<->,132.249.70.213:domain,0,0,1,116,1,116,0.293013000,0.0000
215.158.140.163:51501,<->,130.61.208.238:domain,1,671,0,0,1,671,0.292411000,0.0000
92.27.219.49:64509,<->,48.105.23.184:cognex-insight,1,52,0,0,1,52,0.292061000,0.0000
89.183.104.181:34054,<->,121.66.179.101:32962,1,52,0,0,1,52,0.291736000,0.0000
21.15.226.126:55104,<->,20.193.48.10:netbios-ns,0,0,1,82,1,82,0.291503000,0.0000
192.67.152.196:34505,<->,193.46.99.163:21346,1,129,0,0,1,129,0.291475000,0.0000
144.87.235.187:48977,<->,138.127.224.156:domain,1,292,0,0,1,292,0.291103000,0.0000
53.212.157.83:bintec-tapi,<->,138.31.199.102:domain,0,0,1,74,1,74,0.290337000,0.0000
127.255.88.114:40297,<->,109.222.195.135:netbios-ns,0,0,1,82,1,82,0.290331000,0.0000
122.215.15.158:32940,<->,92.27.209.222:xbox,0,0,1,64,1,64,0.289766000,0.0000
132.249.70.233:51899,<->,53.201.149.31:domain,1,87,0,0,1,87,0.288973000,0.0000
92.27.27.185:20307,<->,134.18.234.58:sunclustermgr,1,52,0,0,1,52,0.288407000,0.0000
144.75.218.233:57083,<->,8.222.218.197:domain,1,123,0,0,1,123,0.288330000,0.0000
136.25.188.105:41349,<->,73.45.221.12:domain,1,203,0,0,1,203,0.288284000,0.0000
246.253.253.12:isakmp,<->,106.187.78.231:isakmp,1,116,0,0,1,116,0.287867000,0.0000
215.158.103.219:41358,<->,159.151.89.197:domain,1,137,0,0,1,137,0.287851000,0.0000
215.158.102.78:9697,<->,29.211.214.82:domain,0,0,1,89,1,89,0.287784000,0.0000
21.15.226.126:55104,<->,20.193.48.72:netbios-ns,0,0,1,82,1,82,0.287704000,0.0000
34.255.14.181:64704,<->,152.111.180.244:6881,1,52,0,0,1,52,0.287079000,0.0000
122.128.183.218:18689,<->,218.4.163.23:16122,0,0,1,52,1,52,0.286739000,0.0000
39.157.97.41:53224,<->,195.120.218.250:domain,1,66,0,0,1,66,0.284638000,0.0000
97.199.155.37:62218,<->,147.132.245.136:domain,1,125,0,0,1,125,0.284625000,0.0000
143.104.30.210:28976,<->,92.27.219.229:19335,0,0,1,52,1,52,0.284603000,0.0000
109.222.220.52:6881,<->,203.142.62.61:rhp-iibp,1,135,0,0,1,135,0.284461000,0.0000
106.5.213.20:22605,<->,129.78.112.176:domain,0,0,1,70,1,70,0.284435000,0.0000
33.62.52.114:11064,<->,111.147.172.190:6881,0,0,1,307,1,307,0.283585000,0.0000
144.75.218.235:33136,<->,8.222.218.197:domain,1,110,0,0,1,110,0.283041000,0.0000
21.15.226.126:55104,<->,20.193.48.86:netbios-ns,0,0,1,82,1,82,0.282121000,0.0000
144.75.218.246:17255,<->,8.222.218.197:domain,1,125,0,0,1,125,0.281209000,0.0000
144.75.218.242:61263,<->,8.222.218.207:domain,1,123,0,0,1,123,0.281026000,0.0000
136.25.188.105:53674,<->,127.174.45.1:domain,1,117,0,0,1,117,0.280970000,0.0000
144.75.218.233:16988,<->,8.222.218.197:domain,1,111,0,0,1,111,0.280732000,0.0000
38.49.54.206:22795,<->,80.42.159.249:16093,0,0,1,105,1,105,0.280577000,0.0000
80.47.154.203:57910,<->,215.158.239.223:domain,0,0,1,90,1,90,0.280557000,0.0000
144.75.218.241:20166,<->,138.127.230.49:domain,1,324,0,0,1,324,0.280455000,0.0000
192.64.196.68:41620,<->,134.150.128.85:22659,1,52,0,0,1,52,0.279018000,0.0000
144.75.218.235:5296,<->,56.112.1.18:domain,1,297,0,0,1,297,0.278981000,0.0000
144.75.218.241:36855,<->,8.222.218.207:domain,1,122,0,0,1,122,0.278974000,0.0000
92.27.219.253:49485,<->,60.81.96.138:11256,1,135,0,0,1,135,0.277827000,0.0000
144.75.218.242:57784,<->,8.222.218.207:domain,1,111,0,0,1,111,0.277288000,0.0000
215.158.103.219:17328,<->,129.203.66.31:domain,1,799,0,0,1,799,0.277150000,0.0000
144.75.218.246:29432,<->,8.222.218.204:domain,1,111,0,0,1,111,0.277070000,0.0000
38.182.1.6:40563,<->,247.136.199.176:25745,0,0,1,52,1,52,0.276811000,0.0000
144.75.218.242:46864,<->,8.222.218.199:domain,1,110,0,0,1,110,0.276806000,0.0000
200.226.80.179:61117,<->,129.92.113.143:chargen,0,0,1,50,1,50,0.276439000,0.0000
144.75.218.237:36739,<->,138.127.231.211:domain,1,242,0,0,1,242,0.276389000,0.0000
33.233.141.29:38349,<->,141.179.51.33:domain,1,177,0,0,1,177,0.276313000,0.0000
8.191.10.185:65216,<->,133.178.226.163:12347,0,0,1,1064,1,1064,0.276109000,0.0000
144.75.218.235:44639,<->,139.252.1.252:domain,1,139,0,0,1,139,0.275806000,0.0000
8.50.118.32:37935,<->,215.158.238.162:domain,0,0,1,84,1,84,0.275571000,0.0000
144.75.218.237:12198,<->,8.222.218.197:domain,1,111,0,0,1,111,0.275558000,0.0000
92.27.219.205:64007,<->,120.179.18.5:50624,1,52,0,0,1,52,0.275240000,0.0000
215.158.103.219:52557,<->,139.252.1.248:domain,1,220,0,0,1,220,0.274970000,0.0000
88.1.14.140:44699,<->,92.27.27.148:csms,0,0,1,52,1,52,0.274815000,0.0000
136.25.188.105:64895,<->,135.88.171.34:domain,1,232,0,0,1,232,0.274813000,0.0000
144.75.218.233:20793,<->,138.127.230.221:domain,1,84,0,0,1,84,0.274533000,0.0000
131.144.248.59:63293,<->,129.224.112.252:domain,0,0,1,78,1,78,0.274415000,0.0000
122.3.36.157:48321,<->,210.221.110.77:6881,0,0,1,135,1,135,0.274164000,0.0000
144.75.218.235:29482,<->,97.94.119.24:domain,1,75,0,0,1,75,0.273519000,0.0000
144.75.218.233:34832,<->,8.222.218.204:domain,1,111,0,0,1,111,0.273274000,0.0000
29.154.35.223:orbix-config,<->,20.198.120.124:orbix-config,0,0,1,50,1,50,0.272895000,0.0000
144.75.218.235:38007,<->,8.222.218.204:domain,1,110,0,0,1,110,0.272849000,0.0000
144.75.218.237:26295,<->,8.222.218.204:domain,1,110,0,0,1,110,0.272755000,0.0000
56.121.35.12:xpl,<->,206.226.123.198:domain,1,111,0,0,1,111,0.272728000,0.0000
109.1.65.112:56721,<->,226.162.38.40:domain,1,166,0,0,1,166,0.272332000,0.0000
144.75.218.237:50624,<->,8.222.218.199:domain,1,110,0,0,1,110,0.271467000,0.0000
109.222.241.65:25823,<->,207.14.190.163:12688,1,138,0,0,1,138,0.271219000,0.0000
144.75.218.246:12821,<->,8.222.218.204:domain,1,124,0,0,1,124,0.271122000,0.0000
144.75.218.237:48458,<->,8.222.218.204:domain,1,122,0,0,1,122,0.270949000,0.0000
195.3.157.138:34154,<->,129.224.112.252:domain,0,0,1,75,1,75,0.270921000,0.0000
144.75.218.241:51019,<->,8.222.218.204:domain,1,111,0,0,1,111,0.270629000,0.0000
30.191.108.39:64278,<->,39.203.251.62:teredo,0,0,1,88,1,88,0.270279000,0.0000
136.25.188.29:54328,<->,8.220.7.141:domain,1,110,0,0,1,110,0.270171000,0.0000
220.55.64.223:domain,<->,132.43.156.54:domain,1,391,0,0,1,391,0.269060000,0.0000
144.75.218.233:62803,<->,138.127.224.167:domain,1,268,0,0,1,268,0.268830000,0.0000
89.183.104.227:51249,<->,104.233.32.3:45682,1,52,0,0,1,52,0.268562000,0.0000
39.237.134.65:50781,<->,76.184.54.224:domain,1,70,0,0,1,70,0.268217000,0.0000
76.228.54.2:23287,<->,109.222.241.33:domain,0,0,1,76,1,76,0.268059000,0.0000
119.214.7.55:59942,<->,137.137.75.72:domain,0,0,1,69,1,69,0.267242000,0.0000
207.198.136.208:46627,<->,109.222.242.9:bacula-dir,0,0,1,135,1,135,0.267106000,0.0000
144.75.218.237:57825,<->,8.222.218.207:domain,1,121,0,0,1,121,0.266491000,0.0000
89.183.104.185:62876,<->,144.70.164.222:27019,1,164,0,0,1,164,0.265969000,0.0000
215.158.66.194:53649,<->,29.211.214.254:domain,0,0,1,114,1,114,0.265537000,0.0000
54.59.43.180:6881,<->,48.53.158.62:6881,0,0,1,52,1,52,0.265521000,0.0000
20.165.246.40:35720,<->,112.44.56.227:domain,1,68,0,0,1,68,0.265479000,0.0000
132.249.71.227:amberon,<->,132.249.70.154:amberon,0,0,1,283,1,283,0.265427000,0.0000
100.93.133.50:63626,<->,144.76.44.59:domain,1,85,0,0,1,85,0.265372000,0.0000
144.108.80.170:21152,<->,159.69.187.13:domain,0,0,1,69,1,69,0.265322000,0.0000
39.254.135.162:13315,<->,61.87.95.241:6881,1,52,0,0,1,52,0.263594000,0.0000
136.25.188.105:58762,<->,132.43.156.81:domain,1,213,0,0,1,213,0.262428000,0.0000
122.158.179.118:49030,<->,8.252.221.175:domain,0,0,1,83,1,83,0.260607000,0.0000
144.75.218.241:31618,<->,138.127.225.151:domain,1,280,0,0,1,280,0.259529000,0.0000
215.158.239.195:39988,<->,8.220.7.141:domain,1,184,0,0,1,184,0.259493000,0.0000
72.204.156.37:33991,<->,144.70.196.25:domain,0,0,1,78,1,78,0.259399000,0.0000
249.95.65.178:60467,<->,246.253.248.210:domain,0,0,1,82,1,82,0.259137000,0.0000
247.136.199.131:55557,<->,121.245.128.167:10376,1,130,0,0,1,130,0.258647000,0.0000
89.183.104.233:48793,<->,127.223.55.31:16314,1,52,0,0,1,52,0.258646000,0.0000
57.1.228.46:54381,<->,145.242.126.150:domain,0,0,1,89,1,89,0.258350000,0.0000
196.115.29.51:23632,<->,39.15.169.14:domain,0,0,1,86,1,86,0.257831000,0.0000
144.75.218.241:49323,<->,8.222.218.207:domain,1,113,0,0,1,113,0.256723000,0.0000
80.40.25.242:40500,<->,127.200.190.122:21347,1,61,0,0,1,61,0.256257000,0.0000
199.28.91.46:56900,<->,102.51.182.178:51413,0,0,1,138,1,138,0.256253000,0.0000
192.67.167.86:60093,<->,50.109.250.60:50041,1,52,0,0,1,52,0.255583000,0.0000
132.200.51.119:47109,<->,129.224.112.221:domain,0,0,1,68,1,68,0.255422000,0.0000
34.146.103.93:61984,<->,77.16.86.124:12917,1,52,0,0,1,52,0.255265000,0.0000
144.75.218.233:45837,<->,8.222.218.197:domain,1,123,0,0,1,123,0.255183000,0.0000
144.75.218.233:49489,<->,8.222.218.197:domain,1,113,0,0,1,113,0.255099000,0.0000
98.231.199.23:7311,<->,246.44.63.17:domain,0,0,1,84,1,84,0.254859000,0.0000
122.106.32.33:63322,<->,92.27.27.178:powwow-server,0,0,1,102,1,102,0.254786000,0.0000
80.41.19.144:55000,<->,27.186.225.200:54447,1,149,0,0,1,149,0.254396000,0.0000
21.15.226.126:55104,<->,20.193.48.155:netbios-ns,0,0,1,82,1,82,0.254287000,0.0000
92.162.219.197:35136,<->,129.224.112.252:domain,0,0,1,86,1,86,0.254041000,0.0000
243.117.125.58:23338,<->,129.224.112.252:domain,0,0,1,78,1,78,0.253974000,0.0000
247.136.235.134:45271,<->,255.57.239.24:ntp,1,80,0,0,1,80,0.253624000,0.0000
144.76.43.238:24553,<->,80.56.78.31:domain,0,0,1,88,1,88,0.253596000,0.0000
205.167.137.144:25897,<->,92.27.219.170:ampr-inter,0,0,1,100,1,100,0.253562000,0.0000
144.75.218.246:12290,<->,148.111.30.85:domain,1,75,0,0,1,75,0.253092000,0.0000
20.163.148.110:45723,<->,107.3.232.230:domain,1,74,0,0,1,74,0.253057000,0.0000
39.48.99.38:44943,<->,116.228.36.60:domain,1,90,0,0,1,90,0.252839000,0.0000
53.163.249.141:28809,<->,144.69.82.139:domain,0,0,1,76,1,76,0.252831000,0.0000
136.25.188.105:50001,<->,128.243.151.33:domain,1,234,0,0,1,234,0.250612000,0.0000
97.126.26.70:45281,<->,129.229.242.60:domain,1,637,0,0,1,637,0.250590000,0.0000
144.75.218.237:31420,<->,8.222.218.197:domain,1,127,0,0,1,127,0.250224000,0.0000
215.158.140.163:62229,<->,111.151.107.247:domain,1,157,0,0,1,157,0.249472000,0.0000
113.184.255.140:38691,<->,8.228.209.32:domain,0,0,1,76,1,76,0.249462000,0.0000
57.46.23.242:54107,<->,247.136.152.186:53521,0,0,1,52,1,52,0.249199000,0.0000
39.155.51.81:17051,<->,131.229.28.177:domain,1,76,0,0,1,76,0.249177000,0.0000
:::41002,<->,:::domain,1,137,0,0,1,137,0.248432000,0.0000
144.75.218.241:50201,<->,120.155.84.97:domain,1,136,0,0,1,136,0.248230000,0.0000
144.75.218.237:10263,<->,227.56.190.69:domain,1,128,0,0,1,128,0.248117000,0.0000
141.54.113.244:52761,<->,92.27.27.143:51413,0,0,1,135,1,135,0.248029000,0.0000
89.183.104.142:51413,<->,204.125.111.48:40793,1,52,0,0,1,52,0.247502000,0.0000
100.185.124.124:51085,<->,145.110.55.59:domain,0,0,1,67,1,67,0.246910000,0.0000
6.147.69.18:28541,<->,159.69.187.4:domain,0,0,1,69,1,69,0.246326000,0.0000
247.136.240.215:64107,<->,0.47.150.192:14035,1,52,0,0,1,52,0.246309000,0.0000
205.37.92.12:64073,<->,100.93.234.54:55920,0,0,1,80,1,80,0.246218000,0.0000
136.25.188.105:57854,<->,141.204.123.255:domain,1,125,0,0,1,125,0.245650000,0.0000
215.158.103.219:11707,<->,158.235.98.75:domain,1,129,0,0,1,129,0.244999000,0.0000
106.157.38.242:53126,<->,108.134.108.77:23373,0,0,1,50,1,50,0.244589000,0.0000
144.75.218.237:42658,<->,120.155.84.97:domain,1,141,0,0,1,141,0.244539000,0.0000
106.157.38.242:53126,<->,108.134.108.77:8585,0,0,1,50,1,50,0.244517000,0.0000
144.75.218.235:39571,<->,124.57.86.149:domain,1,133,0,0,1,133,0.244495000,0.0000
106.157.38.242:53126,<->,108.134.108.77:6943,0,0,1,50,1,50,0.243986000,0.0000
39.241.209.211:32434,<->,156.159.3.122:domain,1,76,0,0,1,76,0.243741000,0.0000
21.15.226.126:55104,<->,20.193.49.243:netbios-ns,0,0,1,82,1,82,0.243638000,0.0000
144.75.218.246:53725,<->,8.222.218.204:domain,1,149,0,0,1,149,0.243432000,0.0000
144.75.218.233:51642,<->,102.45.225.190:domain,1,79,0,0,1,79,0.243311000,0.0000
20.225.145.108:32214,<->,106.213.68.182:domain,1,91,0,0,1,91,0.242156000,0.0000
144.75.218.237:38155,<->,8.222.218.207:domain,1,126,0,0,1,126,0.241543000,0.0000
20.15.48.254:5389,<->,145.10.90.235:domain,1,79,0,0,1,79,0.241397000,0.0000
144.75.218.246:62099,<->,8.222.218.197:domain,1,110,0,0,1,110,0.241360000,0.0000
144.75.218.242:46998,<->,8.222.218.199:domain,1,122,0,0,1,122,0.241215000,0.0000
74.11.146.36:32375,<->,97.126.117.77:domain,0,0,1,75,1,75,0.240998000,0.0000
254.242.186.223:50507,<->,193.58.6.142:50012,1,544,0,0,1,544,0.240907000,0.0000
33.233.141.43:netxms-sync,<->,57.176.114.210:domain,1,181,0,0,1,181,0.240460000,0.0000
143.230.117.31:dzdaemon,<->,129.224.112.252:domain,0,0,1,72,1,72,0.240457000,0.0000
102.50.89.64:58906,<->,207.78.145.120:52750,1,52,0,0,1,52,0.240215000,0.0000
80.38.62.78:health-trap,<->,132.43.156.54:domain,1,271,0,0,1,271,0.240032000,0.0000
192.67.158.69:64961,<->,125.178.10.70:6881,1,321,0,0,1,321,0.239765000,0.0000
230.114.137.29:51635,<->,34.56.142.22:44754,0,0,1,52,1,52,0.239657000,0.0000
42.210.179.82:36243,<->,92.27.219.159:18942,0,0,1,52,1,52,0.239430000,0.0000
144.75.218.242:idmaps,<->,8.222.218.204:domain,1,127,0,0,1,127,0.238871000,0.0000
114.233.163.117:48319,<->,92.27.219.203:5659,0,0,1,52,1,52,0.238871000,0.0000
97.126.26.71:60501,<->,138.127.230.2:domain,1,227,0,0,1,227,0.238725000,0.0000
144.75.218.237:s-openmail,<->,8.222.218.198:domain,1,110,0,0,1,110,0.238706000,0.0000
108.134.108.77:62827,<->,106.157.38.242:53126,1,50,0,0,1,50,0.238241000,0.0000
53.64.4.18:50731,<->,98.67.136.52:domain,0,0,1,75,1,75,0.238067000,0.0000
144.75.218.237:44684,<->,8.222.218.197:domain,1,114,0,0,1,114,0.237695000,0.0000
80.40.14.171:47364,<->,148.122.200.44:domain,1,68,0,0,1,68,0.237108000,0.0000
34.236.217.103:13456,<->,59.43.254.143:domain,1,132,0,0,1,132,0.235917000,0.0000
106.157.38.242:53126,<->,108.134.108.77:41823,0,0,1,50,1,50,0.235812000,0.0000
197.156.2.4:56724,<->,92.27.219.249:34901,0,0,1,52,1,52,0.235401000,0.0000
21.15.226.126:55104,<->,20.193.49.230:netbios-ns,0,0,1,82,1,82,0.234819000,0.0000
144.75.218.246:27223,<->,138.127.230.33:domain,1,366,0,0,1,366,0.234797000,0.0000
98.150.107.182:35663,<->,109.222.214.24:33442,0,0,1,50,1,50,0.234741000,0.0000
215.158.49.10:45851,<->,29.211.214.254:domain,0,0,1,80,1,80,0.234223000,0.0000
215.158.49.10:46371,<->,29.211.214.254:domain,0,0,1,80,1,80,0.233981000,0.0000
144.75.218.246:26507,<->,8.222.218.204:domain,1,125,0,0,1,125,0.233845000,0.0000
106.157.38.242:53126,<->,108.134.108.77:23724,0,0,1,50,1,50,0.233844000,0.0000
110.55.21.179:59485,<->,192.67.167.86:49620,0,0,1,52,1,52,0.233806000,0.0000
98.60.126.27:27639,<->,132.249.70.213:domain,0,0,1,126,1,126,0.233165000,0.0000
144.75.218.237:57561,<->,138.127.225.27:domain,1,366,0,0,1,366,0.232183000,0.0000
39.63.255.88:37338,<->,119.214.81.185:domain,1,66,0,0,1,66,0.231836000,0.0000
80.40.48.126:36706,<->,58.164.1.58:7603,1,133,0,0,1,133,0.231672000,0.0000
144.75.218.233:codasrv-se,<->,8.222.218.196:domain,1,122,0,0,1,122,0.231571000,0.0000
215.158.49.10:59464,<->,29.211.214.254:domain,0,0,1,80,1,80,0.231039000,0.0000
192.64.223.86:22641,<->,88.158.96.85:11081,1,52,0,0,1,52,0.230403000,0.0000
144.75.218.246:42666,<->,143.89.38.224:domain,1,174,0,0,1,174,0.230353000,0.0000
120.241.123.129:33441,<->,92.27.219.163:bctp,0,0,1,52,1,52,0.229909000,0.0000
92.27.219.165:62344,<->,112.40.30.109:40176,1,52,0,0,1,52,0.229809000,0.0000
20.188.210.191:57471,<->,65.67.142.90:56733,1,52,0,0,1,52,0.228801000,0.0000
21.15.226.126:55104,<->,20.193.49.216:netbios-ns,0,0,1,82,1,82,0.228489000,0.0000
92.27.219.38:44587,<->,107.97.115.181:29237,1,80,0,0,1,80,0.228386000,0.0000
215.158.140.163:65020,<->,120.155.87.47:domain,1,145,0,0,1,145,0.228350000,0.0000
39.132.89.30:46691,<->,195.61.230.12:domain,1,68,0,0,1,68,0.228254000,0.0000
215.158.140.111:45951,<->,141.204.127.17:domain,1,711,0,0,1,711,0.226989000,0.0000
103.13.74.78:55474,<->,192.67.154.172:54430,0,0,1,52,1,52,0.226485000,0.0000
159.123.17.187:33884,<->,144.81.143.55:domain,1,244,0,0,1,244,0.226190000,0.0000
132.249.70.233:60419,<->,132.43.156.54:domain,1,366,0,0,1,366,0.226137000,0.0000
109.222.204.142:34253,<->,53.190.154.67:rfe,1,91,0,0,1,91,0.225967000,0.0000
215.158.140.163:37751,<->,111.151.107.247:domain,1,163,0,0,1,163,0.224985000,0.0000
144.75.218.246:32705,<->,8.222.218.197:domain,1,109,0,0,1,109,0.224679000,0.0000
29.214.109.116:38797,<->,215.158.238.69:domain,0,0,1,85,1,85,0.224611000,0.0000
92.27.219.22:52689,<->,116.180.1.221:6889,1,329,0,0,1,329,0.224552000,0.0000
106.157.38.242:33959,<->,108.134.108.77:15112,0,0,1,50,1,50,0.224552000,0.0000
215.158.49.10:48669,<->,29.211.214.254:domain,0,0,1,80,1,80,0.224270000,0.0000
92.27.219.218:45832,<->,33.75.241.254:32109,1,52,0,0,1,52,0.224168000,0.0000
215.158.49.10:42293,<->,29.211.214.254:domain,0,0,1,80,1,80,0.223843000,0.0000
80.27.155.177:13285,<->,141.204.127.17:domain,1,770,0,0,1,770,0.223590000,0.0000
215.158.49.10:47966,<->,29.211.214.254:domain,0,0,1,80,1,80,0.223339000,0.0000
215.158.49.10:34543,<->,29.211.214.254:domain,0,0,1,80,1,80,0.223269000,0.0000
136.25.189.7:56635,<->,120.155.84.162:domain,1,145,0,0,1,145,0.223191000,0.0000
92.27.219.29:55455,<->,50.106.153.97:43613,1,213,0,0,1,213,0.223164000,0.0000
144.75.218.242:23209,<->,8.222.218.204:domain,1,110,0,0,1,110,0.223161000,0.0000
92.27.219.38:52282,<->,128.32.74.204:domain,1,171,0,0,1,171,0.223096000,0.0000
144.75.218.233:43623,<->,8.222.218.196:domain,1,122,0,0,1,122,0.223078000,0.0000
144.108.80.170:23067,<->,144.122.240.209:domain,0,0,1,72,1,72,0.222928000,0.0000
139.106.73.252:57302,<->,215.158.238.163:domain,0,0,1,85,1,85,0.222626000,0.0000
94.254.151.249:29159,<->,109.222.253.179:domain,0,0,1,68,1,68,0.222560000,0.0000
139.241.116.90:62055,<->,129.224.112.252:domain,0,0,1,81,1,81,0.222491000,0.0000
111.147.114.15:11050,<->,98.150.171.73:domain,1,120,0,0,1,120,0.221689000,0.0000
20.159.151.24:32740,<->,135.76.10.106:domain,1,70,0,0,1,70,0.221536000,0.0000
230.74.143.176:43555,<->,89.181.159.131:35881,0,0,1,138,1,138,0.221354000,0.0000
144.75.218.241:38172,<->,120.155.84.97:domain,1,119,0,0,1,119,0.221330000,0.0000
136.25.188.105:49767,<->,140.136.9.105:domain,1,230,0,0,1,230,0.221015000,0.0000
89.59.163.56:61248,<->,97.126.113.186:domain,0,0,1,65,1,65,0.220605000,0.0000
136.25.188.105:57019,<->,135.88.171.34:domain,1,130,0,0,1,130,0.220227000,0.0000
216.248.130.197:51413,<->,192.64.201.230:20479,0,0,1,317,1,317,0.220165000,0.0000
57.25.19.14:29924,<->,109.222.242.9:bacula-dir,0,0,1,135,1,135,0.220139000,0.0000
131.46.106.108:36539,<->,129.224.112.253:domain,0,0,1,79,1,79,0.219990000,0.0000
144.108.80.170:21425,<->,144.122.240.201:domain,0,0,1,69,1,69,0.219968000,0.0000
144.75.218.241:29006,<->,8.222.218.207:domain,1,114,0,0,1,114,0.219538000,0.0000
8.176.8.94:60729,<->,120.155.87.66:domain,1,142,0,0,1,142,0.219534000,0.0000
144.75.218.235:30214,<->,8.222.218.204:domain,1,110,0,0,1,110,0.219137000,0.0000
106.157.38.242:33959,<->,108.134.108.77:10988,0,0,1,50,1,50,0.218947000,0.0000
106.157.38.242:33959,<->,108.134.108.77:29247,0,0,1,50,1,50,0.218688000,0.0000
108.134.108.77:38934,<->,106.157.38.242:33959,1,50,0,0,1,50,0.218632000,0.0000
144.75.218.242:6091,<->,61.72.0.237:domain,1,182,0,0,1,182,0.218309000,0.0000
99.73.216.23:36245,<->,144.76.46.38:domain,1,130,0,0,1,130,0.218086000,0.0000
215.158.103.206:50714,<->,149.169.27.6:domain,1,113,0,0,1,113,0.217717000,0.0000
136.25.188.105:57869,<->,128.243.151.33:domain,1,234,0,0,1,234,0.217492000,0.0000
108.134.108.77:52263,<->,106.157.38.242:33959,1,50,0,0,1,50,0.217253000,0.0000
136.99.189.93:10157,<->,138.127.227.231:domain,1,231,0,0,1,231,0.217218000,0.0000
22.50.111.16:26636,<->,145.242.126.212:domain,0,0,1,84,1,84,0.216935000,0.0000
112.122.80.33:27254,<->,109.1.25.177:20417,0,0,1,135,1,135,0.216385000,0.0000
144.75.218.241:50248,<->,8.222.218.207:domain,1,113,0,0,1,113,0.215953000,0.0000
106.157.38.242:33959,<->,108.134.108.77:11690,0,0,1,50,1,50,0.215643000,0.0000
144.75.218.235:52016,<->,8.222.218.198:domain,1,125,0,0,1,125,0.215255000,0.0000
38.94.249.76:56134,<->,89.183.104.151:42257,0,0,1,52,1,52,0.214780000,0.0000
247.136.199.131:55557,<->,0.235.53.64:41003,1,135,0,0,1,135,0.214295000,0.0000
144.75.218.241:63863,<->,8.222.218.207:domain,1,122,0,0,1,122,0.214209000,0.0000
97.126.45.209:60338,<->,118.122.93.165:51413,1,62,0,0,1,62,0.213752000,0.0000
76.243.226.34:50747,<->,97.126.116.12:domain,0,0,1,70,1,70,0.213643000,0.0000
117.228.237.160:63843,<->,92.27.26.161:27017,0,0,1,57,1,57,0.213576000,0.0000
198.252.57.150:45991,<->,89.183.104.146:20396,0,0,1,102,1,102,0.213563000,0.0000
144.75.218.235:9774,<->,120.155.84.160:domain,1,160,0,0,1,160,0.213522000,0.0000
103.13.74.78:62430,<->,192.67.154.172:6881,0,0,1,52,1,52,0.213270000,0.0000
106.157.38.242:33959,<->,108.134.108.77:8879,0,0,1,50,1,50,0.213171000,0.0000
:::18411,<->,:::domain,1,668,0,0,1,668,0.213073000,0.0000
144.75.218.235:8575,<->,138.127.231.62:domain,1,287,0,0,1,287,0.212886000,0.0000
144.75.218.246:10041,<->,8.222.218.204:domain,1,122,0,0,1,122,0.212659000,0.0000
196.148.128.40:37182,<->,148.157.241.119:radius-acct,1,52,0,0,1,52,0.212140000,0.0000
144.75.218.246:49381,<->,8.222.218.204:domain,1,125,0,0,1,125,0.212134000,0.0000
144.75.218.241:42206,<->,8.222.218.207:domain,1,110,0,0,1,110,0.212097000,0.0000
79.126.130.209:31660,<->,8.228.216.133:domain,0,0,1,65,1,65,0.211964000,0.0000
108.134.108.77:62402,<->,106.157.38.242:33959,1,50,0,0,1,50,0.211434000,0.0000
145.213.37.25:54292,<->,159.69.187.44:domain,0,0,1,81,1,81,0.211130000,0.0000
142.115.117.86:19653,<->,39.53.4.98:5114,0,0,1,70,1,70,0.210590000,0.0000
106.157.38.242:33959,<->,108.134.108.77:iua,0,0,1,50,1,50,0.210546000,0.0000
106.183.227.126:58219,<->,144.69.82.139:domain,0,0,1,70,1,70,0.210359000,0.0000
247.136.139.26:48776,<->,235.229.248.237:48659,1,321,0,0,1,321,0.209634000,0.0000
144.75.218.237:52565,<->,8.222.218.197:domain,1,222,0,0,1,222,0.209506000,0.0000
21.15.226.126:55104,<->,20.193.49.126:netbios-ns,0,0,1,82,1,82,0.209226000,0.0000
144.108.80.170:32126,<->,159.69.187.81:domain,0,0,1,73,1,73,0.208875000,0.0000
100.93.226.244:39532,<->,207.76.252.185:domain,1,78,0,0,1,78,0.208817000,0.0000
144.75.218.237:19157,<->,8.222.218.204:domain,1,121,0,0,1,121,0.208584000,0.0000
6.74.105.34:12202,<->,144.232.206.81:altbsdp,1,52,0,0,1,52,0.207431000,0.0000
42.54.4.230:48437,<->,101.70.119.178:domain,0,0,1,73,1,73,0.207016000,0.0000
104.232.96.226:10004,<->,39.218.181.127:novation,0,0,1,92,1,92,0.207004000,0.0000
144.75.218.237:9463,<->,8.222.218.198:domain,1,110,0,0,1,110,0.206405000,0.0000
20.6.36.107:31411,<->,121.189.158.110:domain,1,80,0,0,1,80,0.205704000,0.0000
144.75.218.235:59029,<->,8.222.218.204:domain,1,110,0,0,1,110,0.204904000,0.0000
192.67.174.38:43388,<->,104.48.135.250:1024,1,52,0,0,1,52,0.204570000,0.0000
144.75.218.246:62697,<->,8.222.218.197:domain,1,110,0,0,1,110,0.204543000,0.0000
61.52.123.61:34527,<->,101.70.119.178:domain,0,0,1,73,1,73,0.204058000,0.0000
53.162.7.29:24067,<->,246.253.248.211:domain,0,0,1,88,1,88,0.203862000,0.0000
144.75.218.237:34720,<->,8.222.218.197:domain,1,239,0,0,1,239,0.203166000,0.0000
74.240.206.47:16417,<->,98.217.78.34:neod2,0,0,1,138,1,138,0.202958000,0.0000
144.75.218.242:menandmice-mon,<->,8.222.218.199:domain,1,113,0,0,1,113,0.202564000,0.0000
144.75.218.233:62722,<->,8.222.218.204:domain,1,124,0,0,1,124,0.202478000,0.0000
144.75.218.241:37669,<->,8.222.218.204:domain,1,111,0,0,1,111,0.202386000,0.0000
144.75.218.241:30826,<->,8.222.218.204:domain,1,153,0,0,1,153,0.201823000,0.0000
0.200.50.50:34233,<->,20.13.113.158:domain,0,0,1,60,1,60,0.201700000,0.0000
97.126.26.70:19584,<->,129.221.194.218:domain,1,764,0,0,1,764,0.201359000,0.0000
144.75.218.237:9981,<->,120.155.84.97:domain,1,159,0,0,1,159,0.201295000,0.0000
8.222.7.155:53790,<->,8.176.8.60:12347,0,0,1,1064,1,1064,0.200346000,0.0000
21.15.226.126:55104,<->,20.193.49.108:netbios-ns,0,0,1,82,1,82,0.200333000,0.0000
158.157.46.189:45682,<->,92.27.235.58:20245,0,0,1,138,1,138,0.200309000,0.0000
144.75.218.241:52623,<->,8.222.218.207:domain,1,113,0,0,1,113,0.200196000,0.0000
144.75.218.235:13599,<->,138.127.224.160:domain,1,233,0,0,1,233,0.200115000,0.0000
144.108.64.183:33680,<->,159.69.187.47:domain,0,0,1,65,1,65,0.200071000,0.0000
:::45353,<->,:::domain,1,134,0,0,1,134,0.200057000,0.0000
144.75.218.233:34925,<->,8.222.218.204:domain,1,122,0,0,1,122,0.200053000,0.0000
121.195.8.117:50321,<->,247.136.188.124:gnutella-svc,0,0,1,343,1,343,0.199667000,0.0000
:::53667,<->,:::domain,1,105,0,0,1,105,0.199392000,0.0000
21.15.226.126:55104,<->,20.193.49.110:netbios-ns,0,0,1,82,1,82,0.198817000,0.0000
95.77.81.114:43227,<->,34.182.191.36:11998,0,0,1,52,1,52,0.198569000,0.0000
34.69.154.140:48134,<->,156.148.228.171:domain,1,135,0,0,1,135,0.198211000,0.0000
119.131.30.232:59067,<->,100.92.32.36:6881,0,0,1,105,1,105,0.197951000,0.0000
56.121.54.98:8780,<->,97.94.229.155:sip,1,687,0,0,1,687,0.197194000,0.0000
101.70.97.189:45535,<->,53.239.1.154:domain,1,197,0,0,1,197,0.197034000,0.0000
144.75.218.237:29018,<->,120.155.84.97:domain,1,174,0,0,1,174,0.196742000,0.0000
144.75.218.241:16864,<->,53.162.176.63:domain,1,83,0,0,1,83,0.196033000,0.0000
144.108.64.184:37228,<->,159.69.187.23:domain,0,0,1,65,1,65,0.195385000,0.0000
144.75.218.233:22242,<->,8.222.218.196:domain,1,123,0,0,1,123,0.195374000,0.0000
122.158.176.232:33055,<->,215.158.239.245:confluent,0,0,1,1112,1,1112,0.195089000,0.0000
144.75.218.237:33260,<->,8.222.218.197:domain,1,110,0,0,1,110,0.194367000,0.0000
132.249.70.233:59372,<->,159.81.1.22:domain,1,355,0,0,1,355,0.194290000,0.0000
29.198.187.160:50650,<->,192.64.196.68:41620,0,0,1,135,1,135,0.194076000,0.0000
39.26.17.188:27898,<->,204.136.193.126:domain,1,80,0,0,1,80,0.194019000,0.0000
56.97.187.145:61663,<->,133.178.226.255:domain,0,0,1,89,1,89,0.193677000,0.0000
39.61.169.227:31890,<->,124.86.160.236:domain,1,80,0,0,1,80,0.193560000,0.0000
134.169.126.159:60588,<->,89.183.104.249:39821,0,0,1,193,1,193,0.193193000,0.0000
92.27.219.47:54383,<->,136.172.238.246:6881,1,331,0,0,1,331,0.192867000,0.0000
144.108.64.184:24431,<->,97.199.169.50:domain,0,0,1,70,1,70,0.191622000,0.0000
92.27.27.165:52810,<->,8.47.122.177:domain,1,126,0,0,1,126,0.191237000,0.0000
106.18.141.73:9849,<->,109.222.231.67:domain,0,0,1,69,1,69,0.191178000,0.0000
39.216.85.179:32105,<->,203.48.1.38:domain,1,70,0,0,1,70,0.191025000,0.0000
109.48.94.18:13059,<->,139.163.84.114:domain,0,0,1,73,1,73,0.190390000,0.0000
195.3.157.138:14359,<->,129.224.112.252:domain,0,0,1,78,1,78,0.190164000,0.0000
144.75.218.233:56703,<->,8.222.218.196:domain,1,123,0,0,1,123,0.189775000,0.0000
144.75.218.237:7995,<->,130.61.250.228:domain,1,140,0,0,1,140,0.188773000,0.0000
144.75.218.237:26566,<->,8.222.218.199:domain,1,110,0,0,1,110,0.188470000,0.0000
144.75.218.242:42423,<->,8.222.218.199:domain,1,114,0,0,1,114,0.188376000,0.0000
21.15.226.126:55104,<->,20.193.49.95:netbios-ns,0,0,1,82,1,82,0.188226000,0.0000
144.75.218.246:39083,<->,8.222.218.197:domain,1,110,0,0,1,110,0.187690000,0.0000
22.50.59.223:40997,<->,144.69.82.139:domain,0,0,1,72,1,72,0.187576000,0.0000
92.27.219.134:56350,<->,206.222.44.212:49928,1,147,0,0,1,147,0.186841000,0.0000
144.75.218.242:5089,<->,8.222.218.199:domain,1,111,0,0,1,111,0.186811000,0.0000
0.247.67.42:56844,<->,137.137.75.72:domain,0,0,1,62,1,62,0.186584000,0.0000
122.201.39.217:17554,<->,89.183.104.231:hsl-storm,0,0,1,62,1,62,0.186138000,0.0000
144.75.218.233:48590,<->,8.222.218.196:domain,1,113,0,0,1,113,0.185286000,0.0000
115.185.23.246:32976,<->,192.67.143.198:22464,0,0,1,319,1,319,0.184960000,0.0000
144.75.218.237:15672,<->,139.254.118.32:domain,1,163,0,0,1,163,0.184951000,0.0000
133.8.0.39:15664,<->,50.224.76.131:domain,0,0,1,79,1,79,0.184893000,0.0000
144.75.218.242:43481,<->,8.222.218.207:domain,1,111,0,0,1,111,0.183922000,0.0000
210.113.152.194:52777,<->,144.81.142.226:domain,1,102,0,0,1,102,0.183726000,0.0000
194.159.61.237:56736,<->,129.224.112.252:domain,0,0,1,76,1,76,0.183512000,0.0000
126.87.3.138:36653,<->,99.73.153.222:18025,0,0,1,62,1,62,0.183295000,0.0000
80.42.163.111:35797,<->,0.195.46.144:24930,1,135,0,0,1,135,0.182994000,0.0000
144.75.218.241:avocent-proxy,<->,8.222.218.204:domain,1,109,0,0,1,109,0.182701000,0.0000
144.75.218.246:14593,<->,8.222.218.204:domain,1,110,0,0,1,110,0.182556000,0.0000
134.47.233.28:50343,<->,92.27.219.19:48457,0,0,1,103,1,103,0.182489000,0.0000
144.108.80.170:27777,<->,144.122.240.201:domain,0,0,1,73,1,73,0.182197000,0.0000
39.225.125.120:40954,<->,74.133.208.61:39748,1,52,0,0,1,52,0.181764000,0.0000
118.219.171.125:55134,<->,89.183.104.246:30774,0,0,1,62,1,62,0.180444000,0.0000
91.54.155.124:10700,<->,132.249.70.233:domain,0,0,1,74,1,74,0.180024000,0.0000
34.136.235.105:24661,<->,152.134.175.21:domain,1,126,0,0,1,126,0.179827000,0.0000
86.113.249.211:53124,<->,109.222.239.143:domain,0,0,1,69,1,69,0.179243000,0.0000
202.218.28.35:49690,<->,100.182.162.67:46100,0,0,1,583,1,583,0.179085000,0.0000
144.75.218.237:61655,<->,8.222.218.198:domain,1,110,0,0,1,110,0.178956000,0.0000
39.236.54.14:50675,<->,124.22.63.79:domain,1,74,0,0,1,74,0.178821000,0.0000
27.188.163.162:i-net-2000-npr,<->,109.1.17.129:sip,0,0,1,444,1,444,0.178552000,0.0000
144.75.218.237:28241,<->,8.222.218.198:domain,1,110,0,0,1,110,0.178525000,0.0000
39.160.87.110:63532,<->,140.21.2.175:domain,1,70,0,0,1,70,0.178478000,0.0000
144.75.218.235:41918,<->,8.222.218.198:domain,1,112,0,0,1,112,0.177419000,0.0000
136.25.188.26:59198,<->,215.158.42.138:12347,1,1064,0,0,1,1064,0.177312000,0.0000
101.70.98.5:63562,<->,113.171.75.11:34840,1,135,0,0,1,135,0.177164000,0.0000
144.75.218.237:19716,<->,8.222.218.204:domain,1,122,0,0,1,122,0.177108000,0.0000
215.158.103.219:7082,<->,120.155.86.176:domain,1,77,0,0,1,77,0.177065000,0.0000
101.224.89.174:56042,<->,111.20.172.70:domain,1,78,0,0,1,78,0.175857000,0.0000
127.161.24.212:60564,<->,247.136.145.168:50431,0,0,1,52,1,52,0.175631000,0.0000
215.158.140.11:32911,<->,128.157.72.138:domain,1,117,0,0,1,117,0.175445000,0.0000
144.82.14.49:d2000webserver,<->,129.224.112.252:domain,0,0,1,84,1,84,0.174891000,0.0000
136.25.188.105:58735,<->,129.70.124.49:domain,1,135,0,0,1,135,0.174587000,0.0000
144.75.218.242:27927,<->,8.222.218.204:domain,1,122,0,0,1,122,0.174542000,0.0000
144.75.218.233:intersan,<->,8.222.218.196:domain,1,110,0,0,1,110,0.173399000,0.0000
144.75.218.237:43673,<->,8.222.218.207:domain,1,126,0,0,1,126,0.172298000,0.0000
8.176.8.97:60907,<->,111.151.107.247:domain,1,166,0,0,1,166,0.172175000,0.0000
6.73.247.150:35632,<->,111.150.187.57:domain,1,106,0,0,1,106,0.172119000,0.0000
109.222.246.240:35258,<->,144.95.255.201:domain,1,468,0,0,1,468,0.171993000,0.0000
144.87.235.187:21770,<->,138.127.225.69:domain,1,229,0,0,1,229,0.170490000,0.0000
144.75.218.246:28492,<->,8.222.218.199:domain,1,123,0,0,1,123,0.169676000,0.0000
144.75.218.237:47621,<->,8.222.218.198:domain,1,110,0,0,1,110,0.169348000,0.0000
95.221.82.237:40023,<->,248.225.27.2:10226,0,0,1,52,1,52,0.169057000,0.0000
144.75.218.237:funk-dialout,<->,8.222.218.198:domain,1,122,0,0,1,122,0.168993000,0.0000
144.75.218.242:unieng,<->,8.222.218.196:domain,1,110,0,0,1,110,0.168463000,0.0000
144.75.218.233:epnsdp,<->,8.222.218.204:domain,1,122,0,0,1,122,0.168065000,0.0000
144.75.218.235:19626,<->,8.222.218.204:domain,1,121,0,0,1,121,0.168023000,0.0000
144.75.218.242:hotu-chat,<->,8.222.218.199:domain,1,114,0,0,1,114,0.167682000,0.0000
52.102.236.155:22201,<->,132.168.197.16:domain,0,0,1,65,1,65,0.167276000,0.0000
215.158.30.56:54412,<->,29.211.214.254:domain,0,0,1,94,1,94,0.166421000,0.0000
215.158.238.180:52157,<->,132.58.23.96:domain,1,155,0,0,1,155,0.166238000,0.0000
133.8.0.39:42847,<->,159.137.138.173:domain,0,0,1,79,1,79,0.165978000,0.0000
144.75.218.233:30296,<->,8.222.218.197:domain,1,120,0,0,1,120,0.165774000,0.0000
136.25.188.105:56218,<->,132.5.71.202:domain,1,139,0,0,1,139,0.165635000,0.0000
144.75.218.237:36609,<->,120.155.84.97:domain,1,131,0,0,1,131,0.164977000,0.0000
92.27.219.244:57196,<->,131.145.83.75:10064,1,52,0,0,1,52,0.164799000,0.0000
136.25.188.105:52253,<->,140.136.9.105:domain,1,191,0,0,1,191,0.164620000,0.0000
144.75.218.235:6255,<->,8.222.218.204:domain,1,113,0,0,1,113,0.164281000,0.0000
134.21.38.250:58594,<->,92.27.219.43:51413,0,0,1,52,1,52,0.163627000,0.0000
144.85.74.113:61987,<->,148.3.52.53:domain,1,187,0,0,1,187,0.162778000,0.0000
27.188.163.162:i-net-2000-npr,<->,109.1.17.133:sip,0,0,1,446,1,446,0.162412000,0.0000
92.27.219.149:62842,<->,142.183.80.32:18330,1,1457,0,0,1,1457,0.161741000,0.0000
108.11.71.121:sdl-ets,<->,133.0.67.60:sip,0,0,1,395,1,395,0.161695000,0.0000
132.20.222.234:33626,<->,129.224.112.221:domain,0,0,1,76,1,76,0.161544000,0.0000
91.54.155.124:26227,<->,132.249.70.233:domain,0,0,1,91,1,91,0.161489000,0.0000
144.75.218.235:60740,<->,8.222.218.204:domain,1,121,0,0,1,121,0.161189000,0.0000
144.75.218.242:28877,<->,8.222.218.199:domain,1,110,0,0,1,110,0.159740000,0.0000
80.38.33.214:35010,<->,143.194.53.201:domain,1,519,0,0,1,519,0.159580000,0.0000
50.163.69.12:43015,<->,89.183.104.164:37553,0,0,1,52,1,52,0.159324000,0.0000
97.168.64.242:56049,<->,42.90.92.188:6881,1,88,0,0,1,88,0.159306000,0.0000
144.75.218.237:43147,<->,8.222.218.207:domain,1,120,0,0,1,120,0.159272000,0.0000
8.228.219.176:48434,<->,193.46.99.139:9665,1,129,0,0,1,129,0.159241000,0.0000
144.75.218.241:44228,<->,138.127.231.62:domain,1,343,0,0,1,343,0.159018000,0.0000
100.95.244.53:55098,<->,207.79.69.173:43611,1,62,0,0,1,62,0.158451000,0.0000
144.75.218.241:64481,<->,138.127.231.62:domain,1,224,0,0,1,224,0.157811000,0.0000
21.15.226.126:55104,<->,20.193.40.119:netbios-ns,0,0,1,82,1,82,0.157704000,0.0000
144.75.218.235:web2host,<->,8.222.218.204:domain,1,126,0,0,1,126,0.157331000,0.0000
145.252.122.164:37902,<->,132.43.156.54:domain,1,260,0,0,1,260,0.157196000,0.0000
144.75.218.233:43964,<->,138.127.225.221:domain,1,365,0,0,1,365,0.156633000,0.0000
144.75.218.242:15792,<->,8.222.218.207:domain,1,112,0,0,1,112,0.155754000,0.0000
41.137.22.107:51103,<->,129.224.112.252:domain,0,0,1,85,1,85,0.155672000,0.0000
8.219.184.149:33804,<->,136.25.189.93:domain,0,0,1,83,1,83,0.155627000,0.0000
148.145.80.227:36427,<->,145.252.123.97:domain,0,0,1,84,1,84,0.155593000,0.0000
144.75.218.237:58078,<->,8.222.218.207:domain,1,121,0,0,1,121,0.155469000,0.0000
144.75.218.246:29430,<->,146.226.226.225:domain,1,82,0,0,1,82,0.154780000,0.0000
102.103.77.216:15564,<->,109.222.239.143:domain,0,0,1,71,1,71,0.154611000,0.0000
218.4.180.233:40297,<->,137.64.13.252:openvpn,1,85,0,0,1,85,0.154407000,0.0000
129.254.99.2:12698,<->,129.224.112.252:domain,0,0,1,67,1,67,0.153953000,0.0000
215.158.140.13:48502,<->,145.234.87.73:12347,1,1064,0,0,1,1064,0.153923000,0.0000
136.25.188.105:61979,<->,135.88.171.34:domain,1,251,0,0,1,251,0.153839000,0.0000
56.115.253.42:63844,<->,132.249.70.213:domain,0,0,1,117,1,117,0.152375000,0.0000
92.27.219.226:12662,<->,118.221.39.205:12261,1,149,0,0,1,149,0.152113000,0.0000
144.108.64.183:55536,<->,159.69.187.21:domain,0,0,1,64,1,64,0.151514000,0.0000
136.25.188.105:63519,<->,93.12.2.192:domain,1,115,0,0,1,115,0.151339000,0.0000
144.75.218.242:5848,<->,8.222.218.199:domain,1,121,0,0,1,121,0.151306000,0.0000
144.75.218.235:22705,<->,138.127.231.117:domain,1,254,0,0,1,254,0.150425000,0.0000
215.158.140.19:64033,<->,139.252.1.230:domain,1,150,0,0,1,150,0.149575000,0.0000
144.75.218.237:53355,<->,138.127.224.104:domain,1,295,0,0,1,295,0.149357000,0.0000
144.75.218.242:62239,<->,8.222.218.199:domain,1,124,0,0,1,124,0.149271000,0.0000
109.1.23.143:59796,<->,93.174.65.127:54641,1,50,0,0,1,50,0.149228000,0.0000
93.167.142.44:38596,<->,109.222.244.209:12769,0,0,1,213,1,213,0.149225000,0.0000
144.75.218.237:43391,<->,8.222.218.198:domain,1,111,0,0,1,111,0.148967000,0.0000
8.252.223.245:35782,<->,111.151.107.247:domain,1,112,0,0,1,112,0.148938000,0.0000
132.249.70.233:51162,<->,109.203.229.64:domain,1,148,0,0,1,148,0.148732000,0.0000
229.59.1.46:50927,<->,144.86.151.120:domain,0,0,1,75,1,75,0.148492000,0.0000
92.27.219.145:43471,<->,114.64.216.52:10804,1,135,0,0,1,135,0.148315000,0.0000
215.158.140.111:54998,<->,139.252.33.121:domain,1,106,0,0,1,106,0.148013000,0.0000
92.27.219.187:48374,<->,93.181.153.134:39760,1,52,0,0,1,52,0.147762000,0.0000
21.15.226.126:55104,<->,20.193.40.97:netbios-ns,0,0,1,82,1,82,0.147471000,0.0000
144.75.218.242:37348,<->,8.222.218.204:domain,1,125,0,0,1,125,0.147105000,0.0000
144.75.218.233:altcp,<->,138.127.231.98:domain,1,355,0,0,1,355,0.146732000,0.0000
246.253.252.54:isakmp,<->,137.254.128.4:isakmp,1,116,0,0,1,116,0.146727000,0.0000
144.75.218.246:25252,<->,8.222.218.204:domain,1,113,0,0,1,113,0.146430000,0.0000
123.58.158.133:27687,<->,92.27.219.159:18942,0,0,1,52,1,52,0.146418000,0.0000
144.75.218.237:nitrogen,<->,8.222.218.199:domain,1,126,0,0,1,126,0.146211000,0.0000
80.41.32.232:11496,<->,116.129.34.166:8682,1,130,0,0,1,130,0.146166000,0.0000
89.183.104.151:20623,<->,8.47.122.95:domain,1,368,0,0,1,368,0.146034000,0.0000
77.21.127.1:58485,<->,210.156.204.25:38537,0,0,1,99,1,99,0.145313000,0.0000
91.54.155.124:55216,<->,132.249.70.233:domain,0,0,1,63,1,63,0.145156000,0.0000
136.25.188.105:62389,<->,132.5.71.202:domain,1,214,0,0,1,214,0.143995000,0.0000
194.50.141.12:14044,<->,129.224.112.252:domain,0,0,1,84,1,84,0.143934000,0.0000
21.15.226.126:55104,<->,20.193.40.72:netbios-ns,0,0,1,82,1,82,0.143837000,0.0000
50.162.22.58:31919,<->,59.43.228.12:10370,1,130,0,0,1,130,0.143701000,0.0000
92.27.219.212:49498,<->,119.19.115.29:12265,1,52,0,0,1,52,0.143247000,0.0000
144.75.218.237:65102,<->,8.222.218.197:domain,1,109,0,0,1,109,0.142655000,0.0000
144.75.218.246:14858,<->,8.222.218.197:domain,1,110,0,0,1,110,0.142392000,0.0000
144.108.80.170:17322,<->,159.69.187.20:domain,0,0,1,70,1,70,0.142232000,0.0000
144.108.80.170:30955,<->,159.69.187.6:domain,0,0,1,69,1,69,0.141380000,0.0000
144.75.218.235:16996,<->,8.222.218.204:domain,1,240,0,0,1,240,0.140744000,0.0000
252.253.21.235:50196,<->,139.207.222.11:domain,0,0,1,91,1,91,0.140683000,0.0000
144.75.218.246:28770,<->,132.200.124.228:domain,1,149,0,0,1,149,0.140683000,0.0000
210.156.155.20:41203,<->,66.222.188.102:7477,1,130,0,0,1,130,0.140653000,0.0000
89.216.125.35:52821,<->,138.127.225.201:domain,1,233,0,0,1,233,0.140153000,0.0000
144.75.218.242:11306,<->,8.222.218.207:domain,1,190,0,0,1,190,0.139920000,0.0000
144.75.218.242:37031,<->,8.222.218.199:domain,1,123,0,0,1,123,0.139230000,0.0000
33.233.141.22:19179,<->,111.20.172.70:domain,1,108,0,0,1,108,0.139033000,0.0000
39.192.133.218:27154,<->,130.7.224.243:domain,1,246,0,0,1,246,0.138726000,0.0000
39.37.194.165:35613,<->,64.151.7.177:domain,1,74,0,0,1,74,0.138436000,0.0000
33.70.117.88:49001,<->,80.40.51.106:42410,0,0,1,193,1,193,0.138399000,0.0000
94.39.161.169:52417,<->,39.129.254.142:6212,0,0,1,52,1,52,0.138157000,0.0000
192.67.152.0:62617,<->,127.85.120.31:14744,1,135,0,0,1,135,0.138027000,0.0000
20.106.150.158:12235,<->,195.69.119.68:domain,1,66,0,0,1,66,0.137901000,0.0000
202.178.8.66:22371,<->,144.69.82.139:domain,0,0,1,66,1,66,0.136854000,0.0000
77.38.63.32:44565,<->,159.31.207.156:24115,0,0,1,213,1,213,0.136806000,0.0000
144.75.218.242:41519,<->,138.127.230.15:domain,1,366,0,0,1,366,0.136693000,0.0000
144.75.218.237:57849,<->,120.155.84.97:domain,1,131,0,0,1,131,0.136481000,0.0000
89.183.104.246:36938,<->,123.158.42.91:rrifmm,1,135,0,0,1,135,0.136021000,0.0000
144.75.218.242:6331,<->,130.61.211.1:domain,1,91,0,0,1,91,0.136008000,0.0000
215.158.103.206:10206,<->,144.72.25.35:domain,1,208,0,0,1,208,0.135608000,0.0000
144.75.218.246:13852,<->,158.189.37.55:domain,1,88,0,0,1,88,0.135602000,0.0000
144.75.218.237:58506,<->,138.127.230.79:domain,1,262,0,0,1,262,0.135517000,0.0000
33.233.141.72:64056,<->,57.176.114.210:domain,1,181,0,0,1,181,0.134888000,0.0000
64.214.27.68:26085,<->,80.41.57.193:6881,0,0,1,62,1,62,0.134508000,0.0000
144.75.218.237:11980,<->,8.222.218.198:domain,1,110,0,0,1,110,0.133695000,0.0000
123.86.222.193:39125,<->,109.222.213.94:32435,0,0,1,321,1,321,0.133169000,0.0000
139.36.120.222:51356,<->,6.73.247.72:12347,0,0,1,1064,1,1064,0.133088000,0.0000
210.220.219.152:48146,<->,138.127.224.90:domain,1,250,0,0,1,250,0.132157000,0.0000
144.75.218.242:60730,<->,8.222.218.207:domain,1,122,0,0,1,122,0.131721000,0.0000
92.27.219.181:42516,<->,29.170.244.6:24389,1,351,0,0,1,351,0.131551000,0.0000
80.42.189.6:22438,<->,149.113.167.89:zen-pawn,1,373,0,0,1,373,0.130911000,0.0000
21.15.226.126:55104,<->,20.193.40.232:netbios-ns,0,0,1,82,1,82,0.130762000,0.0000
144.75.218.242:58700,<->,8.222.218.207:domain,1,110,0,0,1,110,0.130368000,0.0000
144.75.218.242:55044,<->,8.222.218.207:domain,1,110,0,0,1,110,0.130134000,0.0000
27.188.163.162:i-net-2000-npr,<->,109.1.17.136:sip,0,0,1,447,1,447,0.129726000,0.0000
247.136.161.187:50611,<->,74.253.156.4:25983,1,130,0,0,1,130,0.129680000,0.0000
33.233.141.0:12205,<->,111.20.172.70:domain,1,284,0,0,1,284,0.129671000,0.0000
39.135.171.205:64432,<->,65.57.89.237:10620,1,80,0,0,1,80,0.129663000,0.0000
144.75.218.233:16929,<->,99.168.7.150:domain,1,140,0,0,1,140,0.129456000,0.0000
144.75.218.233:38468,<->,138.127.230.98:domain,1,366,0,0,1,366,0.129171000,0.0000
100.95.30.204:33871,<->,144.76.44.59:domain,1,104,0,0,1,104,0.129157000,0.0000
111.20.168.4:60028,<->,111.20.172.70:domain,1,98,0,0,1,98,0.128162000,0.0000
215.158.3.42:65151,<->,29.211.214.32:domain,0,0,1,95,1,95,0.128118000,0.0000
115.159.174.25:36215,<->,89.183.104.179:20089,0,0,1,102,1,102,0.127979000,0.0000
33.233.141.49:49046,<->,111.20.172.70:domain,1,150,0,0,1,150,0.127586000,0.0000
144.75.218.241:14408,<->,8.222.218.207:domain,1,114,0,0,1,114,0.127424000,0.0000
101.224.89.134:62029,<->,111.20.172.70:domain,1,97,0,0,1,97,0.127029000,0.0000
195.56.196.75:40872,<->,92.27.219.175:29830,0,0,1,132,1,132,0.126828000,0.0000
103.102.107.103:62183,<->,247.136.143.180:50071,0,0,1,138,1,138,0.126581000,0.0000
33.233.141.80:31892,<->,111.20.172.70:domain,1,93,0,0,1,93,0.126436000,0.0000
8.252.222.153:53767,<->,192.171.13.33:domain,1,407,0,0,1,407,0.126340000,0.0000
91.54.155.124:58794,<->,132.249.70.233:domain,0,0,1,85,1,85,0.126306000,0.0000
33.233.141.94:10283,<->,111.20.172.70:domain,1,106,0,0,1,106,0.126261000,0.0000
111.20.168.4:coauthor,<->,111.20.172.70:domain,1,182,0,0,1,182,0.126250000,0.0000
101.106.122.69:40563,<->,92.27.219.157:12157,0,0,1,135,1,135,0.125920000,0.0000
8.252.222.153:55991,<->,192.171.13.33:domain,1,407,0,0,1,407,0.125830000,0.0000
33.233.141.80:13867,<->,111.20.172.70:domain,1,145,0,0,1,145,0.125419000,0.0000
80.157.173.15:59448,<->,109.222.253.134:domain,0,0,1,80,1,80,0.125352000,0.0000
33.156.47.131:34734,<->,92.27.219.228:24058,0,0,1,135,1,135,0.125340000,0.0000
33.233.141.28:13125,<->,111.20.172.70:domain,1,100,0,0,1,100,0.124820000,0.0000
129.236.100.135:54005,<->,129.224.112.252:domain,0,0,1,80,1,80,0.124818000,0.0000
101.224.89.134:32220,<->,111.20.172.70:domain,1,148,0,0,1,148,0.124814000,0.0000
39.35.72.49:bpmd,<->,197.68.217.227:domain,1,78,0,0,1,78,0.124752000,0.0000
33.233.141.94:45186,<->,111.20.172.70:domain,1,97,0,0,1,97,0.124360000,0.0000
144.75.218.246:29129,<->,8.222.218.204:domain,1,153,0,0,1,153,0.124289000,0.0000
33.233.141.90:5132,<->,111.20.172.70:domain,1,96,0,0,1,96,0.124220000,0.0000
136.25.188.105:62565,<->,143.194.53.201:domain,1,230,0,0,1,230,0.123620000,0.0000
33.233.141.96:44327,<->,111.20.172.70:domain,1,158,0,0,1,158,0.123447000,0.0000
144.75.218.242:53826,<->,8.222.218.207:domain,1,110,0,0,1,110,0.123404000,0.0000
105.170.21.183:47571,<->,129.1.109.243:42205,0,0,1,258,1,258,0.123315000,0.0000
33.233.141.94:fcip-port,<->,111.20.172.70:domain,1,111,0,0,1,111,0.123153000,0.0000
111.20.168.13:51165,<->,111.20.172.70:domain,1,99,0,0,1,99,0.123099000,0.0000
111.20.168.154:5884,<->,111.20.172.70:domain,1,146,0,0,1,146,0.122618000,0.0000
33.233.141.82:62598,<->,111.20.172.70:domain,1,109,0,0,1,109,0.122484000,0.0000
8.252.222.153:41837,<->,192.171.13.33:domain,1,407,0,0,1,407,0.122399000,0.0000
33.233.141.19:panagolin-ident,<->,111.20.172.70:domain,1,171,0,0,1,171,0.122385000,0.0000
33.233.141.8:39429,<->,111.20.172.70:domain,1,295,0,0,1,295,0.122380000,0.0000
8.252.222.153:49274,<->,192.171.13.33:domain,1,97,0,0,1,97,0.122333000,0.0000
33.233.141.90:39501,<->,111.20.172.70:domain,1,107,0,0,1,107,0.122279000,0.0000
101.224.89.128:8823,<->,111.20.172.70:domain,1,162,0,0,1,162,0.122025000,0.0000
109.1.25.177:20417,<->,119.203.29.53:6881,1,97,0,0,1,97,0.122017000,0.0000
129.236.64.94:32175,<->,129.224.112.252:domain,0,0,1,85,1,85,0.121793000,0.0000
33.233.141.96:28178,<->,111.20.172.70:domain,1,95,0,0,1,95,0.121564000,0.0000
33.233.141.26:31448,<->,111.20.172.70:domain,1,143,0,0,1,143,0.121362000,0.0000
144.75.218.235:15990,<->,8.222.218.198:domain,1,126,0,0,1,126,0.121351000,0.0000
33.233.141.49:7709,<->,111.20.172.70:domain,1,84,0,0,1,84,0.121288000,0.0000
101.224.89.134:25156,<->,111.20.172.70:domain,1,106,0,0,1,106,0.121183000,0.0000
111.20.168.157:56273,<->,111.20.172.70:domain,1,164,0,0,1,164,0.121146000,0.0000
111.20.168.3:11767,<->,111.20.172.70:domain,1,103,0,0,1,103,0.120876000,0.0000
33.233.141.58:35599,<->,111.20.172.70:domain,1,170,0,0,1,170,0.120698000,0.0000
111.20.168.3:worldwire,<->,111.20.172.70:domain,1,164,0,0,1,164,0.120657000,0.0000
33.233.141.26:53690,<->,111.20.172.70:domain,1,146,0,0,1,146,0.120563000,0.0000
101.224.89.247:13507,<->,111.20.172.70:domain,1,142,0,0,1,142,0.120471000,0.0000
92.27.219.62:37906,<->,132.208.68.222:domain,1,612,0,0,1,612,0.120415000,0.0000
33.233.141.26:63503,<->,111.20.172.70:domain,1,160,0,0,1,160,0.120115000,0.0000
111.20.168.4:65318,<->,111.20.172.70:domain,1,183,0,0,1,183,0.120081000,0.0000
99.75.116.169:38541,<->,196.30.93.119:9360,1,133,0,0,1,133,0.119884000,0.0000
111.20.168.4:45553,<->,111.20.172.70:domain,1,97,0,0,1,97,0.119833000,0.0000
144.108.80.170:65274,<->,144.122.240.204:domain,0,0,1,73,1,73,0.119826000,0.0000
144.108.80.170:5925,<->,159.69.187.29:domain,0,0,1,74,1,74,0.119667000,0.0000
33.233.141.120:resource-mgr,<->,111.20.172.70:domain,1,152,0,0,1,152,0.119657000,0.0000
144.75.218.233:44433,<->,8.222.218.196:domain,1,126,0,0,1,126,0.119651000,0.0000
20.193.13.103:iclpv-nlc,<->,121.77.89.131:domain,1,66,0,0,1,66,0.119535000,0.0000
111.20.168.3:17702,<->,111.20.172.70:domain,1,201,0,0,1,201,0.119531000,0.0000
33.233.141.19:6478,<->,111.20.172.70:domain,1,151,0,0,1,151,0.119476000,0.0000
33.233.141.58:36362,<->,111.20.172.70:domain,1,160,0,0,1,160,0.119413000,0.0000
111.20.168.4:41659,<->,111.20.172.70:domain,1,167,0,0,1,167,0.119155000,0.0000
33.233.141.49:50333,<->,111.20.172.70:domain,1,94,0,0,1,94,0.119114000,0.0000
246.253.253.79:17627,<->,138.127.231.3:domain,1,274,0,0,1,274,0.118943000,0.0000
111.20.168.3:42185,<->,111.20.172.70:domain,1,104,0,0,1,104,0.118932000,0.0000
42.119.57.109:37552,<->,129.224.112.252:domain,0,0,1,81,1,81,0.118874000,0.0000
33.233.141.94:25131,<->,111.20.172.70:domain,1,150,0,0,1,150,0.118809000,0.0000
111.20.168.4:53219,<->,111.20.172.70:domain,1,172,0,0,1,172,0.118804000,0.0000
132.249.70.233:52531,<->,148.198.183.187:domain,1,80,0,0,1,80,0.118681000,0.0000
136.25.188.105:50734,<->,128.243.151.37:domain,1,136,0,0,1,136,0.118671000,0.0000
215.158.103.206:21480,<->,138.127.230.247:domain,1,332,0,0,1,332,0.118666000,0.0000
8.252.222.153:64411,<->,111.151.107.247:domain,1,96,0,0,1,96,0.118616000,0.0000
144.75.218.246:16768,<->,8.222.218.204:domain,1,122,0,0,1,122,0.118281000,0.0000
33.233.141.28:38769,<->,111.20.172.70:domain,1,113,0,0,1,113,0.118256000,0.0000
33.233.141.80:22196,<->,111.20.172.70:domain,1,104,0,0,1,104,0.118198000,0.0000
92.27.27.148:28159,<->,78.48.155.49:ttc-etap-ds,1,136,0,0,1,136,0.118124000,0.0000
101.224.89.134:8590,<->,111.20.172.70:domain,1,96,0,0,1,96,0.117913000,0.0000
111.20.168.142:43278,<->,111.20.172.70:domain,1,148,0,0,1,148,0.117887000,0.0000
33.233.141.58:19711,<->,111.20.172.70:domain,1,149,0,0,1,149,0.117829000,0.0000
99.75.116.59:38451,<->,206.195.154.29:6881,1,324,0,0,1,324,0.117793000,0.0000
33.233.141.93:10364,<->,111.20.172.70:domain,1,157,0,0,1,157,0.117661000,0.0000
33.233.141.93:17606,<->,111.20.172.70:domain,1,99,0,0,1,99,0.117640000,0.0000
33.233.141.71:9764,<->,111.20.172.70:domain,1,82,0,0,1,82,0.117599000,0.0000
33.233.141.90:51664,<->,111.20.172.70:domain,1,149,0,0,1,149,0.117336000,0.0000
33.233.141.71:45257,<->,111.20.172.70:domain,1,82,0,0,1,82,0.117221000,0.0000
144.75.218.242:61623,<->,99.168.7.150:domain,1,135,0,0,1,135,0.117048000,0.0000
33.233.141.90:41483,<->,111.20.172.70:domain,1,93,0,0,1,93,0.116839000,0.0000
89.127.177.200:37640,<->,29.211.214.82:domain,0,0,1,87,1,87,0.116816000,0.0000
33.233.141.123:50881,<->,111.20.172.70:domain,1,107,0,0,1,107,0.116753000,0.0000
33.233.141.84:55272,<->,111.20.172.70:domain,1,165,0,0,1,165,0.116729000,0.0000
8.252.222.153:40905,<->,111.151.107.247:domain,1,146,0,0,1,146,0.116682000,0.0000
144.75.218.237:37139,<->,8.222.218.197:domain,1,113,0,0,1,113,0.116618000,0.0000
144.75.218.242:35759,<->,8.222.218.196:domain,1,110,0,0,1,110,0.116567000,0.0000
106.157.38.242:37294,<->,108.134.108.77:16081,0,0,1,50,1,50,0.116556000,0.0000
111.20.168.4:41300,<->,111.20.172.70:domain,1,145,0,0,1,145,0.116496000,0.0000
101.224.89.131:54421,<->,111.20.172.70:domain,1,255,0,0,1,255,0.116477000,0.0000
159.115.105.190:42311,<->,64.214.44.95:12083,1,77,0,0,1,77,0.116432000,0.0000
33.233.141.87:16915,<->,111.20.172.70:domain,1,103,0,0,1,103,0.116310000,0.0000
33.233.141.99:22058,<->,111.20.172.70:domain,1,111,0,0,1,111,0.116275000,0.0000
144.75.218.242:28470,<->,8.222.218.207:domain,1,113,0,0,1,113,0.116231000,0.0000
144.75.218.241:47004,<->,8.222.218.207:domain,1,122,0,0,1,122,0.116217000,0.0000
129.236.64.94:30204,<->,129.224.112.252:domain,0,0,1,79,1,79,0.116168000,0.0000
33.233.141.28:dsmeter-iatc,<->,111.20.172.70:domain,1,108,0,0,1,108,0.116155000,0.0000
33.233.141.93:20987,<->,111.20.172.70:domain,1,173,0,0,1,173,0.116113000,0.0000
33.233.141.103:15722,<->,111.20.172.70:domain,1,146,0,0,1,146,0.116096000,0.0000
101.224.89.129:26841,<->,111.20.172.70:domain,1,101,0,0,1,101,0.116068000,0.0000
33.233.141.28:57490,<->,111.20.172.70:domain,1,104,0,0,1,104,0.116066000,0.0000
144.75.218.235:64528,<->,139.254.119.192:domain,1,163,0,0,1,163,0.116014000,0.0000
33.233.141.80:60902,<->,111.20.172.70:domain,1,145,0,0,1,145,0.115960000,0.0000
33.233.141.49:ecmport,<->,111.20.172.70:domain,1,105,0,0,1,105,0.115944000,0.0000
144.75.218.242:57249,<->,8.222.218.207:domain,1,110,0,0,1,110,0.115930000,0.0000
33.233.141.82:60983,<->,111.20.172.70:domain,1,151,0,0,1,151,0.115919000,0.0000
33.233.141.123:31269,<->,111.20.172.70:domain,1,103,0,0,1,103,0.115877000,0.0000
33.233.141.49:csms2,<->,111.20.172.70:domain,1,112,0,0,1,112,0.115871000,0.0000
145.213.46.36:44262,<->,215.158.238.12:12347,0,0,1,1064,1,1064,0.115764000,0.0000
33.233.141.19:5882,<->,111.20.172.70:domain,1,106,0,0,1,106,0.115686000,0.0000
8.252.222.153:47184,<->,111.151.107.247:domain,1,146,0,0,1,146,0.115619000,0.0000
33.233.141.26:21324,<->,111.20.172.70:domain,1,101,0,0,1,101,0.115612000,0.0000
101.224.89.225:25350,<->,111.20.172.70:domain,1,145,0,0,1,145,0.115578000,0.0000
144.108.80.170:smaclmgr,<->,159.69.187.12:domain,0,0,1,70,1,70,0.115563000,0.0000
33.233.141.28:48896,<->,111.20.172.70:domain,1,151,0,0,1,151,0.115550000,0.0000
33.233.141.96:24282,<->,111.20.172.70:domain,1,131,0,0,1,131,0.115506000,0.0000
100.176.233.172:55050,<->,109.1.9.216:51670,0,0,1,94,1,94,0.115501000,0.0000
33.233.141.28:31424,<->,111.20.172.70:domain,1,108,0,0,1,108,0.115491000,0.0000
33.233.141.71:54065,<->,111.20.172.70:domain,1,114,0,0,1,114,0.115477000,0.0000
129.236.64.94:31865,<->,129.224.112.252:domain,0,0,1,81,1,81,0.115391000,0.0000
106.255.129.196:lonworks,<->,109.222.203.124:domain,0,0,1,70,1,70,0.115385000,0.0000
111.20.168.21:61795,<->,111.20.172.70:domain,1,150,0,0,1,150,0.115381000,0.0000
230.126.45.98:51529,<->,34.146.122.74:14650,0,0,1,52,1,52,0.115355000,0.0000
33.233.141.62:13725,<->,111.20.172.70:domain,1,96,0,0,1,96,0.115290000,0.0000
111.20.168.154:53245,<->,111.20.172.70:domain,1,96,0,0,1,96,0.115276000,0.0000
33.233.141.94:24291,<->,111.20.172.70:domain,1,140,0,0,1,140,0.115257000,0.0000
144.75.218.237:22303,<->,8.222.218.197:domain,1,181,0,0,1,181,0.115209000,0.0000
33.233.141.96:52665,<->,111.20.172.70:domain,1,140,0,0,1,140,0.115068000,0.0000
33.233.141.59:33743,<->,111.20.172.70:domain,1,169,0,0,1,169,0.114988000,0.0000
144.75.218.246:pro-ed,<->,149.164.189.49:domain,1,87,0,0,1,87,0.114832000,0.0000
33.233.141.27:30171,<->,111.20.172.70:domain,1,108,0,0,1,108,0.114708000,0.0000
33.233.141.28:32221,<->,111.20.172.70:domain,1,172,0,0,1,172,0.114617000,0.0000
33.233.141.87:33837,<->,111.20.172.70:domain,1,160,0,0,1,160,0.114402000,0.0000
8.228.208.18:61233,<->,93.64.108.3:26525,1,94,0,0,1,94,0.114259000,0.0000
33.233.141.61:41870,<->,111.20.172.70:domain,1,171,0,0,1,171,0.114258000,0.0000
111.20.168.12:59048,<->,111.20.172.70:domain,1,110,0,0,1,110,0.114220000,0.0000
106.157.38.242:37294,<->,108.134.108.77:25129,0,0,1,50,1,50,0.114196000,0.0000
8.252.222.153:61548,<->,111.151.107.247:domain,1,96,0,0,1,96,0.114185000,0.0000
101.224.89.247:12219,<->,111.20.172.70:domain,1,145,0,0,1,145,0.114184000,0.0000
111.20.168.154:62612,<->,111.20.172.70:domain,1,155,0,0,1,155,0.113913000,0.0000
33.233.141.96:44228,<->,111.20.172.70:domain,1,144,0,0,1,144,0.113889000,0.0000
101.224.89.153:39212,<->,111.20.172.70:domain,1,283,0,0,1,283,0.113867000,0.0000
108.134.108.77:64104,<->,106.157.38.242:37294,1,50,0,0,1,50,0.113724000,0.0000
106.157.38.242:37294,<->,108.134.108.77:12734,0,0,1,50,1,50,0.113660000,0.0000
33.233.141.57:7265,<->,111.20.172.70:domain,1,106,0,0,1,106,0.113464000,0.0000
210.221.107.50:53767,<->,8.220.7.141:domain,1,114,0,0,1,114,0.113346000,0.0000
144.75.218.233:49420,<->,8.222.218.196:domain,1,122,0,0,1,122,0.113311000,0.0000
58.49.163.215:59534,<->,215.158.140.64:domain,0,0,1,85,1,85,0.113287000,0.0000
106.157.38.242:37294,<->,108.134.108.77:8780,0,0,1,50,1,50,0.113256000,0.0000
144.75.218.237:29051,<->,138.127.231.221:domain,1,246,0,0,1,246,0.113243000,0.0000
33.233.141.19:52918,<->,111.20.172.70:domain,1,146,0,0,1,146,0.113239000,0.0000
34.223.219.192:7206,<->,157.210.206.227:domain,1,80,0,0,1,80,0.113236000,0.0000
111.20.168.21:27468,<->,111.20.172.70:domain,1,253,0,0,1,253,0.113168000,0.0000
106.157.38.242:37294,<->,108.134.108.77:21230,0,0,1,50,1,50,0.113058000,0.0000
33.233.141.62:51460,<->,111.20.172.70:domain,1,160,0,0,1,160,0.112953000,0.0000
33.233.141.24:29096,<->,111.20.172.70:domain,1,143,0,0,1,143,0.112852000,0.0000
106.157.38.242:37294,<->,108.134.108.77:23748,0,0,1,50,1,50,0.112838000,0.0000
101.224.89.247:10298,<->,111.20.172.70:domain,1,147,0,0,1,147,0.112813000,0.0000
33.233.141.10:60859,<->,111.20.172.70:domain,1,284,0,0,1,284,0.112736000,0.0000
111.20.168.9:45702,<->,111.20.172.70:domain,1,153,0,0,1,153,0.112699000,0.0000
33.233.141.99:48906,<->,111.20.172.70:domain,1,101,0,0,1,101,0.112591000,0.0000
144.75.218.237:5507,<->,8.222.218.199:domain,1,122,0,0,1,122,0.112456000,0.0000
108.134.108.77:44001,<->,106.157.38.242:37294,1,50,0,0,1,50,0.112446000,0.0000
144.75.218.242:17867,<->,8.222.218.204:domain,1,114,0,0,1,114,0.112416000,0.0000
33.233.141.103:15620,<->,111.20.172.70:domain,1,147,0,0,1,147,0.112362000,0.0000
144.75.218.237:53121,<->,138.127.230.75:domain,1,259,0,0,1,259,0.112293000,0.0000
144.75.218.233:27376,<->,8.222.218.197:domain,1,114,0,0,1,114,0.112289000,0.0000
129.236.100.135:12227,<->,129.224.112.252:domain,0,0,1,82,1,82,0.112238000,0.0000
111.20.168.13:31089,<->,111.20.172.70:domain,1,103,0,0,1,103,0.112079000,0.0000
53.199.195.19:63462,<->,39.15.169.14:domain,0,0,1,87,1,87,0.111882000,0.0000
33.233.141.19:50686,<->,111.20.172.70:domain,1,143,0,0,1,143,0.111801000,0.0000
33.233.141.57:18337,<->,111.20.172.70:domain,1,106,0,0,1,106,0.111792000,0.0000
108.134.108.77:47462,<->,106.157.38.242:37294,1,50,0,0,1,50,0.111698000,0.0000
109.1.51.39:56204,<->,29.219.94.61:15248,1,321,0,0,1,321,0.111686000,0.0000
33.233.141.19:65470,<->,111.20.172.70:domain,1,154,0,0,1,154,0.111631000,0.0000
111.20.168.10:43952,<->,111.20.172.70:domain,1,106,0,0,1,106,0.111595000,0.0000
33.233.141.123:10944,<->,111.20.172.70:domain,1,154,0,0,1,154,0.111588000,0.0000
101.224.89.130:25699,<->,111.20.172.70:domain,1,143,0,0,1,143,0.111582000,0.0000
129.236.100.135:46350,<->,129.224.112.252:domain,0,0,1,75,1,75,0.111530000,0.0000
33.233.141.62:51404,<->,111.20.172.70:domain,1,106,0,0,1,106,0.111489000,0.0000
33.233.141.26:15769,<->,111.20.172.70:domain,1,152,0,0,1,152,0.111477000,0.0000
33.233.141.27:26370,<->,111.20.172.70:domain,1,148,0,0,1,148,0.111407000,0.0000
111.20.168.8:64194,<->,111.20.172.70:domain,1,143,0,0,1,143,0.111406000,0.0000
101.224.89.144:18652,<->,111.20.172.70:domain,1,159,0,0,1,159,0.111383000,0.0000
101.224.89.178:11976,<->,111.20.172.70:domain,1,289,0,0,1,289,0.111379000,0.0000
129.236.64.94:29704,<->,129.224.112.252:domain,0,0,1,78,1,78,0.111350000,0.0000
33.233.141.99:29491,<->,111.20.172.70:domain,1,102,0,0,1,102,0.111338000,0.0000
33.233.141.123:15934,<->,111.20.172.70:domain,1,149,0,0,1,149,0.111285000,0.0000
33.233.141.71:24460,<->,111.20.172.70:domain,1,96,0,0,1,96,0.111221000,0.0000
111.20.168.12:19764,<->,111.20.172.70:domain,1,147,0,0,1,147,0.111186000,0.0000
101.224.89.130:28285,<->,111.20.172.70:domain,1,112,0,0,1,112,0.111172000,0.0000
111.20.168.8:canditv,<->,111.20.172.70:domain,1,106,0,0,1,106,0.111169000,0.0000
144.75.218.242:26250,<->,8.222.218.199:domain,1,121,0,0,1,121,0.111096000,0.0000
111.20.168.3:59146,<->,111.20.172.70:domain,1,160,0,0,1,160,0.111088000,0.0000
21.15.226.126:55104,<->,20.193.41.142:netbios-ns,0,0,1,82,1,82,0.111067000,0.0000
145.242.126.41:ntp,<->,53.177.245.183:ntp,1,80,0,0,1,80,0.111054000,0.0000
101.224.89.225:sflm,<->,89.155.8.207:domain,1,165,0,0,1,165,0.110895000,0.0000
33.233.141.59:7234,<->,111.20.172.70:domain,1,171,0,0,1,171,0.110889000,0.0000
125.202.240.38:50321,<->,192.64.211.17:11887,0,0,1,331,1,331,0.110862000,0.0000
33.233.141.97:30606,<->,111.20.172.70:domain,1,146,0,0,1,146,0.110506000,0.0000
108.134.108.77:58205,<->,106.157.38.242:37294,1,50,0,0,1,50,0.110449000,0.0000
101.224.89.129:40793,<->,111.20.172.70:domain,1,273,0,0,1,273,0.110365000,0.0000
139.36.120.222:51356,<->,215.158.238.33:12347,0,0,1,1064,1,1064,0.110339000,0.0000
224.148.203.58:lnvmaps,<->,89.204.254.169:domain,1,238,0,0,1,238,0.110312000,0.0000
33.233.141.71:28620,<->,111.20.172.70:domain,1,105,0,0,1,105,0.110258000,0.0000
101.224.89.129:7300,<->,111.20.172.70:domain,1,147,0,0,1,147,0.109984000,0.0000
33.233.141.63:16313,<->,111.20.172.70:domain,1,145,0,0,1,145,0.109819000,0.0000
106.157.38.242:37294,<->,108.134.108.77:27464,0,0,1,50,1,50,0.109630000,0.0000
215.158.140.111:38353,<->,192.171.13.80:domain,1,163,0,0,1,163,0.109528000,0.0000
33.233.141.59:28097,<->,111.20.172.70:domain,1,149,0,0,1,149,0.109366000,0.0000
119.225.116.131:53615,<->,92.27.27.172:16881,0,0,1,52,1,52,0.109302000,0.0000
111.20.168.142:24926,<->,111.20.172.70:domain,1,144,0,0,1,144,0.109202000,0.0000
33.233.141.71:18094,<->,111.20.172.70:domain,1,149,0,0,1,149,0.109198000,0.0000
33.233.141.27:32933,<->,111.20.172.70:domain,1,93,0,0,1,93,0.109156000,0.0000
33.233.141.71:20814,<->,111.20.172.70:domain,1,104,0,0,1,104,0.109059000,0.0000
111.20.168.3:22034,<->,111.20.172.70:domain,1,107,0,0,1,107,0.108949000,0.0000
:::19630,<->,:::domain,1,125,0,0,1,125,0.108893000,0.0000
20.15.122.79:39518,<->,115.172.202.133:domain,1,80,0,0,1,80,0.108866000,0.0000
33.233.141.57:45554,<->,111.20.172.70:domain,1,140,0,0,1,140,0.108862000,0.0000
144.75.218.246:52863,<->,138.127.224.171:domain,1,254,0,0,1,254,0.108739000,0.0000
106.157.38.242:37294,<->,108.134.108.77:fiorano-rtrsvc,0,0,1,50,1,50,0.108733000,0.0000
101.224.89.144:16988,<->,111.20.172.70:domain,1,99,0,0,1,99,0.108675000,0.0000
106.157.38.242:37294,<->,108.134.108.77:36775,0,0,1,50,1,50,0.108673000,0.0000
:::11953,<->,:::domain,1,113,0,0,1,113,0.108517000,0.0000
33.233.141.59:57188,<->,111.20.172.70:domain,1,171,0,0,1,171,0.108362000,0.0000
33.233.141.123:11048,<->,111.20.172.70:domain,1,107,0,0,1,107,0.108335000,0.0000
97.126.31.65:41041,<->,138.127.224.104:domain,1,273,0,0,1,273,0.108198000,0.0000
106.157.38.242:37294,<->,108.134.108.77:gridgen-elmd,0,0,1,50,1,50,0.108186000,0.0000
111.20.168.58:60081,<->,111.20.172.70:domain,1,99,0,0,1,99,0.108094000,0.0000
20.207.104.118:8203,<->,207.201.28.147:domain,1,78,0,0,1,78,0.108006000,0.0000
33.233.141.84:38432,<->,111.20.172.70:domain,1,171,0,0,1,171,0.107831000,0.0000
111.20.168.3:fcp-srvr-inst1,<->,111.20.172.70:domain,1,102,0,0,1,102,0.107747000,0.0000
33.233.141.61:32293,<->,111.20.172.70:domain,1,117,0,0,1,117,0.107716000,0.0000
33.233.141.123:14736,<->,111.20.172.70:domain,1,155,0,0,1,155,0.107616000,0.0000
92.160.15.151:64975,<->,129.224.112.252:domain,0,0,1,74,1,74,0.107598000,0.0000
6.147.99.23:33317,<->,200.174.210.184:25344,0,0,1,135,1,135,0.107567000,0.0000
111.20.168.157:49376,<->,111.20.172.70:domain,1,152,0,0,1,152,0.107541000,0.0000
33.233.141.87:50383,<->,111.20.172.70:domain,1,96,0,0,1,96,0.107429000,0.0000
33.233.141.63:50697,<->,111.20.172.70:domain,1,102,0,0,1,102,0.107297000,0.0000
20.21.245.186:8868,<->,106.177.44.73:domain,1,80,0,0,1,80,0.107172000,0.0000
106.157.38.242:37294,<->,108.134.108.77:18334,0,0,1,50,1,50,0.107112000,0.0000
33.233.141.71:29884,<->,111.20.172.70:domain,1,124,0,0,1,124,0.107015000,0.0000
92.27.27.150:51929,<->,193.10.105.251:rtnt-1,1,52,0,0,1,52,0.106981000,0.0000
111.20.168.142:61914,<->,111.20.172.70:domain,1,146,0,0,1,146,0.106959000,0.0000
33.233.141.57:51188,<->,111.20.172.70:domain,1,103,0,0,1,103,0.106875000,0.0000
33.233.141.24:fortisphere-vm,<->,111.20.172.70:domain,1,96,0,0,1,96,0.106815000,0.0000
33.233.141.24:62803,<->,111.20.172.70:domain,1,102,0,0,1,102,0.106753000,0.0000
33.233.141.99:20120,<->,111.20.172.70:domain,1,140,0,0,1,140,0.106537000,0.0000
33.233.141.59:45164,<->,111.20.172.70:domain,1,177,0,0,1,177,0.106453000,0.0000
215.158.140.111:63331,<->,192.171.13.80:domain,1,168,0,0,1,168,0.106417000,0.0000
111.20.168.141:29690,<->,111.20.172.70:domain,1,94,0,0,1,94,0.106355000,0.0000
101.224.89.161:62575,<->,111.20.172.70:domain,1,99,0,0,1,99,0.106323000,0.0000
33.233.141.62:38745,<->,111.20.172.70:domain,1,142,0,0,1,142,0.106270000,0.0000
108.134.108.77:49025,<->,106.157.38.242:37294,1,50,0,0,1,50,0.106231000,0.0000
101.224.89.129:43675,<->,111.20.172.70:domain,1,151,0,0,1,151,0.106184000,0.0000
33.233.141.116:gnunet,<->,111.20.172.70:domain,1,284,0,0,1,284,0.106082000,0.0000
111.20.168.3:35126,<->,111.20.172.70:domain,1,140,0,0,1,140,0.106048000,0.0000
148.27.67.32:55620,<->,109.222.214.116:45929,0,0,1,334,1,334,0.106022000,0.0000
27.188.163.162:i-net-2000-npr,<->,109.1.17.143:sip,0,0,1,446,1,446,0.105919000,0.0000
33.233.141.103:14857,<->,111.20.172.70:domain,1,146,0,0,1,146,0.105906000,0.0000
33.233.141.52:12767,<->,111.20.172.70:domain,1,112,0,0,1,112,0.105886000,0.0000
96.114.3.72:35295,<->,97.68.226.205:domain,0,0,1,84,1,84,0.105816000,0.0000
33.233.141.57:28681,<->,111.20.172.70:domain,1,107,0,0,1,107,0.105740000,0.0000
33.233.141.88:35185,<->,111.20.172.70:domain,1,158,0,0,1,158,0.105585000,0.0000
111.20.168.157:21487,<->,111.20.172.70:domain,1,143,0,0,1,143,0.105558000,0.0000
111.20.168.3:msnp,<->,111.20.172.70:domain,1,114,0,0,1,114,0.105557000,0.0000
129.236.100.135:36602,<->,129.224.112.252:domain,0,0,1,75,1,75,0.105386000,0.0000
144.75.218.241:65278,<->,8.222.218.207:domain,1,157,0,0,1,157,0.105277000,0.0000
111.20.168.3:14086,<->,111.20.172.70:domain,1,98,0,0,1,98,0.105196000,0.0000
108.134.108.77:43894,<->,106.157.38.242:37294,1,50,0,0,1,50,0.105196000,0.0000
111.20.168.27:49474,<->,111.20.172.70:domain,1,147,0,0,1,147,0.105082000,0.0000
108.134.108.77:40827,<->,106.157.38.242:37294,1,50,0,0,1,50,0.104891000,0.0000
80.40.38.153:38864,<->,121.242.114.74:24874,1,317,0,0,1,317,0.104867000,0.0000
33.233.141.57:journee,<->,111.20.172.70:domain,1,94,0,0,1,94,0.104782000,0.0000
33.233.141.59:53189,<->,111.20.172.70:domain,1,103,0,0,1,103,0.104717000,0.0000
111.20.168.157:18362,<->,111.20.172.70:domain,1,100,0,0,1,100,0.104625000,0.0000
106.157.38.242:37294,<->,108.134.108.77:31149,0,0,1,50,1,50,0.104505000,0.0000
33.233.141.59:26311,<->,111.20.172.70:domain,1,157,0,0,1,157,0.104369000,0.0000
20.248.239.41:9079,<->,104.209.8.29:domain,1,90,0,0,1,90,0.104182000,0.0000
33.233.141.61:6642,<->,111.20.172.70:domain,1,107,0,0,1,107,0.104088000,0.0000
129.236.100.161:49312,<->,129.224.112.252:domain,0,0,1,79,1,79,0.104054000,0.0000
:::40412,<->,:::domain,1,304,0,0,1,304,0.103947000,0.0000
111.20.168.58:47086,<->,111.20.172.70:domain,1,140,0,0,1,140,0.103880000,0.0000
111.20.168.21:22408,<->,111.20.172.70:domain,1,107,0,0,1,107,0.103646000,0.0000
148.145.2.123:44597,<->,101.224.204.141:domain,0,0,1,80,1,80,0.103589000,0.0000
143.230.124.191:43957,<->,129.224.112.252:domain,0,0,1,92,1,92,0.103543000,0.0000
38.21.156.204:56633,<->,20.232.229.47:netbios-ns,0,0,1,82,1,82,0.103529000,0.0000
111.20.168.157:37098,<->,111.20.172.70:domain,1,114,0,0,1,114,0.103376000,0.0000
101.224.89.244:55775,<->,111.20.172.70:domain,1,103,0,0,1,103,0.103357000,0.0000
108.134.108.77:47822,<->,106.157.38.242:37294,1,50,0,0,1,50,0.103324000,0.0000
33.233.141.122:5123,<->,111.20.172.70:domain,1,124,0,0,1,124,0.103315000,0.0000
33.233.141.35:32383,<->,111.20.172.70:domain,1,296,0,0,1,296,0.103111000,0.0000
33.233.141.122:30922,<->,111.20.172.70:domain,1,171,0,0,1,171,0.103107000,0.0000
144.75.218.233:jboss-iiop,<->,8.222.218.204:domain,1,110,0,0,1,110,0.103083000,0.0000
101.224.89.161:18142,<->,111.20.172.70:domain,1,152,0,0,1,152,0.102990000,0.0000
106.157.38.242:37294,<->,108.134.108.77:23309,0,0,1,50,1,50,0.102965000,0.0000
33.233.141.62:32630,<->,111.20.172.70:domain,1,145,0,0,1,145,0.102877000,0.0000
106.157.38.242:37294,<->,108.134.108.77:25068,0,0,1,50,1,50,0.102749000,0.0000
136.25.188.105:50281,<->,132.5.71.202:domain,1,251,0,0,1,251,0.102432000,0.0000
101.224.89.161:48995,<->,111.20.172.70:domain,1,108,0,0,1,108,0.102257000,0.0000
101.224.89.145:12078,<->,111.20.172.70:domain,1,103,0,0,1,103,0.102097000,0.0000
105.201.211.173:39648,<->,100.95.179.115:12573,0,0,1,330,1,330,0.102071000,0.0000
33.233.141.50:26375,<->,111.20.172.70:domain,1,160,0,0,1,160,0.102034000,0.0000
33.233.141.50:34540,<->,111.20.172.70:domain,1,168,0,0,1,168,0.101946000,0.0000
33.233.141.88:45057,<->,111.20.172.70:domain,1,179,0,0,1,179,0.101943000,0.0000
144.86.148.0:49642,<->,97.4.79.164:domain,1,328,0,0,1,328,0.101873000,0.0000
111.20.168.27:48731,<->,111.20.172.70:domain,1,148,0,0,1,148,0.101806000,0.0000
235.231.70.149:50651,<->,89.183.104.182:10643,0,0,1,52,1,52,0.101389000,0.0000
33.233.141.97:63579,<->,111.20.172.70:domain,1,142,0,0,1,142,0.101264000,0.0000
101.224.89.222:22600,<->,111.20.172.70:domain,1,297,0,0,1,297,0.101231000,0.0000
101.224.89.244:34694,<->,111.20.172.70:domain,1,148,0,0,1,148,0.101191000,0.0000
33.233.141.61:14728,<->,111.20.172.70:domain,1,250,0,0,1,250,0.101170000,0.0000
66.244.13.112:34748,<->,92.27.27.154:16668,0,0,1,102,1,102,0.101054000,0.0000
144.76.43.238:48629,<->,159.69.187.5:domain,0,0,1,75,1,75,0.100994000,0.0000
144.75.218.242:26834,<->,8.222.218.199:domain,1,114,0,0,1,114,0.100832000,0.0000
33.233.141.97:16942,<->,111.20.172.70:domain,1,98,0,0,1,98,0.100757000,0.0000
20.240.46.64:25390,<->,97.125.2.62:domain,1,66,0,0,1,66,0.100596000,0.0000
111.20.168.58:talon-webserver,<->,111.20.172.70:domain,1,148,0,0,1,148,0.100594000,0.0000
33.233.141.50:med-ci,<->,111.20.172.70:domain,1,124,0,0,1,124,0.100111000,0.0000
101.224.89.245:idware-router,<->,111.20.172.70:domain,1,117,0,0,1,117,0.100052000,0.0000
215.158.140.111:37019,<->,192.171.13.80:domain,1,230,0,0,1,230,0.100052000,0.0000
33.233.141.102:49073,<->,111.20.172.70:domain,1,150,0,0,1,150,0.099915000,0.0000
33.233.141.102:35831,<->,111.20.172.70:domain,1,145,0,0,1,145,0.099730000,0.0000
111.20.168.141:23879,<->,111.20.172.70:domain,1,160,0,0,1,160,0.099712000,0.0000
101.224.89.155:57372,<->,111.20.172.70:domain,1,103,0,0,1,103,0.099530000,0.0000
33.233.141.50:56312,<->,111.20.172.70:domain,1,154,0,0,1,154,0.098940000,0.0000
111.20.168.157:42962,<->,111.20.172.70:domain,1,160,0,0,1,160,0.098826000,0.0000
101.229.93.37:44764,<->,132.249.70.213:domain,0,0,1,106,1,106,0.098190000,0.0000
33.233.141.41:sabarsd,<->,111.20.172.70:domain,1,284,0,0,1,284,0.098084000,0.0000
33.233.141.102:18633,<->,111.20.172.70:domain,1,112,0,0,1,112,0.098061000,0.0000
33.233.141.102:15461,<->,111.20.172.70:domain,1,97,0,0,1,97,0.097945000,0.0000
92.27.5.225:65382,<->,6.74.81.60:41236,0,0,1,237,1,237,0.097447000,0.0000
129.236.64.228:57207,<->,129.224.112.252:domain,0,0,1,84,1,84,0.097131000,0.0000
129.236.64.94:60051,<->,129.224.112.252:domain,0,0,1,77,1,77,0.097103000,0.0000
144.108.80.170:54966,<->,159.69.187.28:domain,0,0,1,78,1,78,0.096971000,0.0000
89.183.104.236:61199,<->,57.98.252.180:11807,1,147,0,0,1,147,0.096930000,0.0000
89.183.104.186:46883,<->,101.81.167.0:6881,1,52,0,0,1,52,0.096930000,0.0000
111.20.168.141:31250,<->,111.20.172.70:domain,1,157,0,0,1,157,0.096861000,0.0000
46.223.205.111:opentable,<->,97.126.115.69:domain,0,0,1,71,1,71,0.096596000,0.0000
92.27.27.177:60300,<->,118.213.163.32:43211,1,309,0,0,1,309,0.096585000,0.0000
144.75.218.241:62096,<->,132.200.124.228:domain,1,189,0,0,1,189,0.096325000,0.0000
33.233.141.101:53884,<->,111.20.172.70:domain,1,124,0,0,1,124,0.096321000,0.0000
144.108.80.170:45925,<->,144.122.240.201:domain,0,0,1,61,1,61,0.096151000,0.0000
33.233.141.102:24966,<->,111.20.172.70:domain,1,154,0,0,1,154,0.095885000,0.0000
101.224.89.245:48993,<->,111.20.172.70:domain,1,124,0,0,1,124,0.095545000,0.0000
144.75.218.237:38444,<->,8.222.218.198:domain,1,114,0,0,1,114,0.095536000,0.0000
136.25.188.105:49621,<->,135.88.171.34:domain,1,250,0,0,1,250,0.095116000,0.0000
77.68.220.47:50522,<->,109.222.203.196:domain,0,0,1,74,1,74,0.095012000,0.0000
84.218.178.97:31971,<->,109.222.244.223:domain,0,0,1,66,1,66,0.094983000,0.0000
144.75.218.246:46505,<->,8.222.218.197:domain,1,110,0,0,1,110,0.094764000,0.0000
133.178.226.200:41815,<->,8.220.7.141:domain,1,163,0,0,1,163,0.094526000,0.0000
39.164.72.145:51353,<->,193.26.139.230:domain,1,70,0,0,1,70,0.094277000,0.0000
20.206.36.216:14648,<->,132.234.110.226:domain,1,70,0,0,1,70,0.093891000,0.0000
75.144.222.194:53023,<->,132.168.199.107:domain,0,0,1,75,1,75,0.093717000,0.0000
101.224.89.245:62188,<->,111.20.172.70:domain,1,124,0,0,1,124,0.093516000,0.0000
67.240.107.172:52299,<->,92.27.219.244:36529,0,0,1,52,1,52,0.093319000,0.0000
111.20.168.20:50381,<->,111.20.172.70:domain,1,146,0,0,1,146,0.093164000,0.0000
111.20.168.141:63189,<->,111.20.172.70:domain,1,148,0,0,1,148,0.093066000,0.0000
38.70.90.237:47881,<->,101.70.105.2:traceroute,0,0,1,96,1,96,0.093023000,0.0000
144.75.218.237:32441,<->,8.222.218.197:domain,1,122,0,0,1,122,0.092605000,0.0000
38.64.182.46:34017,<->,89.183.104.229:4647,0,0,1,52,1,52,0.092500000,0.0000
132.249.70.233:50431,<->,139.114.208.34:domain,1,132,0,0,1,132,0.092258000,0.0000
80.42.134.4:56141,<->,121.2.160.45:23309,1,130,0,0,1,130,0.092237000,0.0000
136.129.54.117:56552,<->,77.11.199.239:9493,1,133,0,0,1,133,0.092190000,0.0000
139.69.162.91:53227,<->,80.56.78.208:domain,0,0,1,82,1,82,0.092168000,0.0000
101.224.89.155:14042,<->,111.20.172.70:domain,1,160,0,0,1,160,0.092166000,0.0000
109.121.30.241:60585,<->,20.218.116.168:snmp,0,0,1,89,1,89,0.092151000,0.0000
101.224.89.136:50136,<->,111.20.172.70:domain,1,150,0,0,1,150,0.092104000,0.0000
144.75.218.237:33858,<->,120.155.84.97:domain,1,113,0,0,1,113,0.091727000,0.0000
144.75.218.237:14171,<->,8.222.218.198:domain,1,114,0,0,1,114,0.091549000,0.0000
144.93.125.49:62757,<->,144.93.121.86:34347,0,0,1,56,1,56,0.091408000,0.0000
101.224.89.136:10163,<->,111.20.172.70:domain,1,105,0,0,1,105,0.091376000,0.0000
111.20.168.141:51142,<->,111.20.172.70:domain,1,103,0,0,1,103,0.091194000,0.0000
129.236.100.161:61963,<->,129.224.112.252:domain,0,0,1,74,1,74,0.091070000,0.0000
97.126.26.70:50053,<->,138.127.230.65:domain,1,261,0,0,1,261,0.091055000,0.0000
111.20.168.10:16395,<->,111.20.172.70:domain,1,98,0,0,1,98,0.091042000,0.0000
144.75.218.233:messageservice,<->,8.222.218.197:domain,1,111,0,0,1,111,0.090917000,0.0000
33.233.141.104:20891,<->,111.20.172.70:domain,1,96,0,0,1,96,0.090799000,0.0000
33.233.141.47:22988,<->,111.20.172.70:domain,1,102,0,0,1,102,0.090772000,0.0000
101.224.89.228:50928,<->,111.20.172.70:domain,1,303,0,0,1,303,0.090696000,0.0000
111.20.168.20:48009,<->,111.20.172.70:domain,1,146,0,0,1,146,0.090531000,0.0000
33.233.141.47:6987,<->,111.20.172.70:domain,1,96,0,0,1,96,0.090463000,0.0000
144.75.218.235:interintelli,<->,8.222.218.197:domain,1,109,0,0,1,109,0.090393000,0.0000
253.180.78.131:46997,<->,80.40.3.132:28462,0,0,1,321,1,321,0.090376000,0.0000
129.236.100.161:14380,<->,129.224.112.252:domain,0,0,1,75,1,75,0.090330000,0.0000
33.233.141.121:39200,<->,111.20.172.70:domain,1,148,0,0,1,148,0.090321000,0.0000
198.11.20.6:54786,<->,92.27.219.40:17444,0,0,1,52,1,52,0.090145000,0.0000
197.172.92.167:36361,<->,101.70.105.2:traceroute,0,0,1,96,1,96,0.090118000,0.0000
215.158.140.13:48502,<->,8.218.118.27:12347,1,1064,0,0,1,1064,0.089981000,0.0000
144.75.218.241:21458,<->,8.222.218.207:domain,1,237,0,0,1,237,0.089935000,0.0000
92.27.27.156:61094,<->,101.106.122.69:18206,1,138,0,0,1,138,0.089807000,0.0000
129.236.64.99:40985,<->,129.224.112.252:domain,0,0,1,78,1,78,0.089600000,0.0000
144.75.218.246:62101,<->,8.222.218.197:domain,1,111,0,0,1,111,0.089559000,0.0000
33.233.141.81:28981,<->,111.20.172.70:domain,1,97,0,0,1,97,0.089545000,0.0000
33.233.141.81:55918,<->,111.20.172.70:domain,1,100,0,0,1,100,0.088920000,0.0000
111.20.168.143:22554,<->,111.20.172.70:domain,1,140,0,0,1,140,0.088906000,0.0000
111.20.168.14:34578,<->,111.20.172.70:domain,1,141,0,0,1,141,0.088906000,0.0000
33.233.141.70:faximum,<->,111.20.172.70:domain,1,183,0,0,1,183,0.088816000,0.0000
144.75.218.237:22810,<->,120.155.84.97:domain,1,154,0,0,1,154,0.088603000,0.0000
109.222.253.89:61210,<->,144.70.164.217:27019,1,68,0,0,1,68,0.088434000,0.0000
33.233.141.121:43149,<->,111.20.172.70:domain,1,156,0,0,1,156,0.087809000,0.0000
215.158.3.213:38506,<->,80.56.78.94:domain,0,0,1,87,1,87,0.087726000,0.0000
27.187.59.205:51842,<->,92.27.219.17:17198,0,0,1,138,1,138,0.087665000,0.0000
92.162.219.32:47363,<->,129.224.112.252:domain,0,0,1,73,1,73,0.087646000,0.0000
111.20.168.143:60294,<->,111.20.172.70:domain,1,150,0,0,1,150,0.087604000,0.0000
33.233.141.76:20194,<->,111.20.172.70:domain,1,307,0,0,1,307,0.087567000,0.0000
120.95.205.61:37492,<->,89.183.104.146:20396,0,0,1,102,1,102,0.087524000,0.0000
144.75.218.246:64038,<->,8.222.218.199:domain,1,110,0,0,1,110,0.087294000,0.0000
144.75.218.246:24377,<->,8.222.218.197:domain,1,126,0,0,1,126,0.087253000,0.0000
129.236.100.161:29689,<->,129.224.112.252:domain,0,0,1,76,1,76,0.087028000,0.0000
101.224.89.159:45687,<->,148.155.131.220:domain,1,161,0,0,1,161,0.086594000,0.0000
33.233.141.101:7817,<->,111.20.172.70:domain,1,148,0,0,1,148,0.086552000,0.0000
113.24.138.85:51339,<->,129.224.112.252:domain,0,0,1,83,1,83,0.086548000,0.0000
33.233.141.32:19715,<->,111.20.172.70:domain,1,85,0,0,1,85,0.086366000,0.0000
144.75.218.242:35918,<->,8.222.218.196:domain,1,113,0,0,1,113,0.086276000,0.0000
39.255.143.133:57845,<->,132.58.234.78:domain,1,66,0,0,1,66,0.085964000,0.0000
33.233.141.121:13888,<->,111.20.172.70:domain,1,97,0,0,1,97,0.085958000,0.0000
144.75.218.246:31661,<->,8.222.218.199:domain,1,113,0,0,1,113,0.085807000,0.0000
33.233.141.104:56040,<->,111.20.172.70:domain,1,140,0,0,1,140,0.085591000,0.0000
33.233.141.104:30598,<->,111.20.172.70:domain,1,140,0,0,1,140,0.085303000,0.0000
111.20.168.14:35719,<->,111.20.172.70:domain,1,147,0,0,1,147,0.085263000,0.0000
101.224.89.243:33459,<->,111.20.172.70:domain,1,110,0,0,1,110,0.085079000,0.0000
195.1.224.116:17815,<->,102.51.8.102:6881,0,0,1,138,1,138,0.084481000,0.0000
215.158.239.231:39096,<->,192.171.13.190:domain,1,120,0,0,1,120,0.084395000,0.0000
101.224.89.136:22271,<->,111.20.172.70:domain,1,99,0,0,1,99,0.084342000,0.0000
92.27.219.160:55160,<->,29.27.248.15:17591,1,52,0,0,1,52,0.083898000,0.0000
129.236.100.161:15072,<->,129.224.112.252:domain,0,0,1,74,1,74,0.083453000,0.0000
33.233.141.121:37349,<->,111.20.172.70:domain,1,156,0,0,1,156,0.083176000,0.0000
101.224.89.136:51743,<->,111.20.172.70:domain,1,103,0,0,1,103,0.083157000,0.0000
33.233.141.101:41331,<->,111.20.172.70:domain,1,96,0,0,1,96,0.082950000,0.0000
101.224.89.139:secure-ts,<->,111.20.172.70:domain,1,140,0,0,1,140,0.082931000,0.0000
144.75.218.241:23850,<->,8.222.218.207:domain,1,110,0,0,1,110,0.082908000,0.0000
100.225.82.253:13526,<->,246.253.253.230:domain,0,0,1,91,1,91,0.082691000,0.0000
33.233.141.89:44662,<->,111.20.172.70:domain,1,99,0,0,1,99,0.082659000,0.0000
41.241.188.79:31795,<->,109.222.255.7:domain,0,0,1,78,1,78,0.082529000,0.0000
192.67.182.164:6881,<->,230.126.147.103:5700,1,133,0,0,1,133,0.082362000,0.0000
16.139.9.35:57781,<->,140.55.246.203:26827,1,52,0,0,1,52,0.081789000,0.0000
89.183.104.181:21744,<->,42.204.53.59:6881,1,326,0,0,1,326,0.081645000,0.0000
101.224.89.137:48758,<->,111.20.172.70:domain,1,160,0,0,1,160,0.081587000,0.0000
111.20.168.144:21943,<->,111.20.172.70:domain,1,143,0,0,1,143,0.081541000,0.0000
101.224.89.137:61359,<->,111.20.172.70:domain,1,113,0,0,1,113,0.081489000,0.0000
33.233.141.21:48104,<->,111.20.172.70:domain,1,96,0,0,1,96,0.081399000,0.0000
101.224.89.243:64562,<->,111.20.172.70:domain,1,108,0,0,1,108,0.081394000,0.0000
33.233.141.119:5869,<->,111.20.172.70:domain,1,293,0,0,1,293,0.081371000,0.0000
101.224.89.243:12218,<->,111.20.172.70:domain,1,150,0,0,1,150,0.080921000,0.0000
101.224.89.243:39139,<->,111.20.172.70:domain,1,96,0,0,1,96,0.080919000,0.0000
8.228.219.4:27795,<->,99.247.176.88:9367,1,147,0,0,1,147,0.080876000,0.0000
229.42.57.91:31535,<->,89.183.104.182:10643,0,0,1,52,1,52,0.079936000,0.0000
33.233.141.21:58713,<->,111.20.172.70:domain,1,100,0,0,1,100,0.079187000,0.0000
144.75.218.242:26984,<->,8.222.218.207:domain,1,122,0,0,1,122,0.078741000,0.0000
111.20.168.144:21133,<->,111.20.172.70:domain,1,143,0,0,1,143,0.078704000,0.0000
192.229.40.101:51386,<->,133.178.226.95:domain,0,0,1,84,1,84,0.078651000,0.0000
33.233.141.89:54779,<->,111.20.172.70:domain,1,148,0,0,1,148,0.077928000,0.0000
131.224.216.95:42775,<->,89.183.104.135:6881,0,0,1,52,1,52,0.077883000,0.0000
144.75.218.242:37853,<->,8.222.218.207:domain,1,113,0,0,1,113,0.077302000,0.0000
144.75.218.242:36214,<->,8.222.218.204:domain,1,111,0,0,1,111,0.077244000,0.0000
111.20.168.144:50795,<->,111.20.172.70:domain,1,148,0,0,1,148,0.076798000,0.0000
33.233.141.21:32439,<->,111.20.172.70:domain,1,145,0,0,1,145,0.076618000,0.0000
88.122.137.238:53680,<->,0.195.210.46:33000,0,0,1,1373,1,1373,0.076615000,0.0000
144.75.218.242:vnetd,<->,99.168.7.150:domain,1,128,0,0,1,128,0.076605000,0.0000
39.32.114.93:39598,<->,131.226.206.47:domain,1,70,0,0,1,70,0.076548000,0.0000
144.75.218.237:19557,<->,138.127.224.171:domain,1,254,0,0,1,254,0.076493000,0.0000
101.224.89.252:26333,<->,138.127.224.104:domain,1,293,0,0,1,293,0.076285000,0.0000
111.20.168.23:8778,<->,111.20.172.70:domain,1,99,0,0,1,99,0.076198000,0.0000
144.75.218.235:10984,<->,8.222.218.204:domain,1,111,0,0,1,111,0.076145000,0.0000
144.75.218.235:44356,<->,138.127.231.148:domain,1,358,0,0,1,358,0.075986000,0.0000
111.20.168.6:33790,<->,111.20.172.70:domain,1,97,0,0,1,97,0.075687000,0.0000
101.224.89.133:37632,<->,111.20.172.70:domain,1,149,0,0,1,149,0.075630000,0.0000
33.233.141.70:40478,<->,111.20.172.70:domain,1,152,0,0,1,152,0.075567000,0.0000
192.67.149.158:50321,<->,105.185.224.18:13687,1,130,0,0,1,130,0.075250000,0.0000
144.75.218.242:netx-agent,<->,138.127.231.72:domain,1,168,0,0,1,168,0.075128000,0.0000
111.20.168.2:5907,<->,111.20.172.70:domain,1,102,0,0,1,102,0.075077000,0.0000
111.20.168.144:43799,<->,111.20.172.70:domain,1,160,0,0,1,160,0.074827000,0.0000
101.224.89.133:4889,<->,111.20.172.70:domain,1,107,0,0,1,107,0.074765000,0.0000
33.233.141.15:39690,<->,111.20.172.70:domain,1,105,0,0,1,105,0.074764000,0.0000
111.20.168.1:42160,<->,111.20.172.70:domain,1,98,0,0,1,98,0.074633000,0.0000
111.20.168.28:29348,<->,111.20.172.70:domain,1,116,0,0,1,116,0.074344000,0.0000
92.27.27.153:45682,<->,201.223.146.32:27480,1,52,0,0,1,52,0.074335000,0.0000
8.228.214.59:62355,<->,201.8.175.76:34571,1,120,0,0,1,120,0.074160000,0.0000
111.20.168.13:32278,<->,138.127.225.208:domain,1,232,0,0,1,232,0.073824000,0.0000
111.20.168.6:49557,<->,111.20.172.70:domain,1,140,0,0,1,140,0.073413000,0.0000
129.236.111.48:31691,<->,129.224.112.252:domain,0,0,1,75,1,75,0.072827000,0.0000
33.233.141.21:32661,<->,111.20.172.70:domain,1,101,0,0,1,101,0.072745000,0.0000
97.126.26.70:39453,<->,80.56.76.30:domain,1,114,0,0,1,114,0.072685000,0.0000
144.75.218.246:18652,<->,8.222.218.204:domain,1,122,0,0,1,122,0.072655000,0.0000
33.233.141.21:64867,<->,111.20.172.70:domain,1,140,0,0,1,140,0.072621000,0.0000
101.224.89.208:11142,<->,138.127.224.104:domain,1,301,0,0,1,301,0.072489000,0.0000
80.41.53.160:43684,<->,57.123.246.235:39609,1,135,0,0,1,135,0.072383000,0.0000
33.233.141.21:20938,<->,111.20.172.70:domain,1,152,0,0,1,152,0.072202000,0.0000
4.9.45.56:8394,<->,101.73.153.37:domain,0,0,1,68,1,68,0.072196000,0.0000
111.20.168.6:25139,<->,111.20.172.70:domain,1,167,0,0,1,167,0.072114000,0.0000
8.52.165.247:21288,<->,105.67.124.147:domain,1,75,0,0,1,75,0.071906000,0.0000
33.233.141.15:62038,<->,111.20.172.70:domain,1,111,0,0,1,111,0.071885000,0.0000
21.15.226.126:55104,<->,20.193.41.106:netbios-ns,0,0,1,82,1,82,0.071531000,0.0000
144.75.218.246:27452,<->,138.127.224.113:domain,1,365,0,0,1,365,0.071463000,0.0000
129.236.100.150:48246,<->,129.224.112.252:domain,0,0,1,77,1,77,0.071433000,0.0000
144.75.218.237:45702,<->,8.222.218.204:domain,1,114,0,0,1,114,0.071142000,0.0000
101.224.89.133:62932,<->,111.20.172.70:domain,1,170,0,0,1,170,0.071131000,0.0000
8.252.222.19:41281,<->,192.171.13.80:domain,1,132,0,0,1,132,0.071127000,0.0000
111.20.168.1:59131,<->,111.20.172.70:domain,1,156,0,0,1,156,0.071124000,0.0000
129.236.111.55:58602,<->,129.224.112.252:domain,0,0,1,73,1,73,0.071087000,0.0000
29.214.109.249:42412,<->,136.25.189.86:domain,0,0,1,84,1,84,0.071007000,0.0000
111.20.168.6:33183,<->,111.20.172.70:domain,1,93,0,0,1,93,0.070465000,0.0000
144.108.80.170:10141,<->,144.122.240.221:domain,0,0,1,69,1,69,0.070315000,0.0000
144.75.218.241:63018,<->,8.222.218.207:domain,1,110,0,0,1,110,0.070007000,0.0000
33.233.141.21:dlms-cosem,<->,111.20.172.70:domain,1,107,0,0,1,107,0.069996000,0.0000
129.236.111.48:52367,<->,129.224.112.252:domain,0,0,1,77,1,77,0.069903000,0.0000
33.233.141.91:43498,<->,111.20.172.70:domain,1,99,0,0,1,99,0.069892000,0.0000
144.75.218.242:36679,<->,8.222.218.199:domain,1,110,0,0,1,110,0.069720000,0.0000
144.75.218.241:26544,<->,8.222.218.207:domain,1,113,0,0,1,113,0.069398000,0.0000
111.20.168.11:21874,<->,111.20.172.70:domain,1,273,0,0,1,273,0.069353000,0.0000
144.75.218.233:63954,<->,99.187.128.217:domain,1,203,0,0,1,203,0.069175000,0.0000
80.42.160.210:46469,<->,117.83.36.110:6881,1,52,0,0,1,52,0.069048000,0.0000
111.20.168.1:54006,<->,111.20.172.70:domain,1,140,0,0,1,140,0.069045000,0.0000
111.20.168.11:17193,<->,111.20.172.70:domain,1,154,0,0,1,154,0.068949000,0.0000
136.25.188.105:52349,<->,132.5.71.202:domain,1,288,0,0,1,288,0.068567000,0.0000
33.233.141.15:59651,<->,111.20.172.70:domain,1,98,0,0,1,98,0.068420000,0.0000
129.236.64.99:14523,<->,129.224.112.252:domain,0,0,1,78,1,78,0.068365000,0.0000
109.1.34.223:9797,<->,27.150.244.150:6889,1,334,0,0,1,334,0.068127000,0.0000
101.224.89.180:26848,<->,138.127.225.202:domain,1,282,0,0,1,282,0.068027000,0.0000
:::56862,<->,:::domain,0,0,1,91,1,91,0.067878000,0.0000
144.75.218.237:31340,<->,8.222.218.204:domain,1,121,0,0,1,121,0.067562000,0.0000
101.224.89.132:11410,<->,111.20.172.70:domain,1,111,0,0,1,111,0.067488000,0.0000
196.28.164.84:43611,<->,99.72.132.173:4433,0,0,1,62,1,62,0.067486000,0.0000
108.242.8.175:realsecure,<->,109.222.251.123:domain,0,0,1,73,1,73,0.067410000,0.0000
20.121.29.24:59240,<->,197.57.227.125:domain,1,74,0,0,1,74,0.067369000,0.0000
129.236.111.48:24362,<->,129.224.112.252:domain,0,0,1,75,1,75,0.067351000,0.0000
144.75.218.246:20778,<->,8.222.218.199:domain,1,124,0,0,1,124,0.067210000,0.0000
129.236.64.99:19417,<->,129.224.112.252:domain,0,0,1,79,1,79,0.067048000,0.0000
111.20.168.154:61871,<->,138.127.224.104:domain,1,276,0,0,1,276,0.066946000,0.0000
99.75.159.71:52765,<->,144.76.46.38:domain,1,129,0,0,1,129,0.066082000,0.0000
215.158.103.206:43813,<->,158.225.58.19:domain,1,126,0,0,1,126,0.066011000,0.0000
111.20.168.23:clariion-evr01,<->,111.20.172.70:domain,1,104,0,0,1,104,0.065859000,0.0000
90.150.165.141:30841,<->,109.222.213.122:domain,0,0,1,65,1,65,0.065666000,0.0000
79.202.246.0:49292,<->,109.222.251.123:domain,0,0,1,73,1,73,0.065467000,0.0000
27.127.251.102:48768,<->,129.224.112.252:domain,0,0,1,88,1,88,0.065404000,0.0000
141.95.30.9:31461,<->,129.224.112.252:domain,0,0,1,74,1,74,0.065295000,0.0000
33.233.141.39:63336,<->,138.127.224.225:domain,1,234,0,0,1,234,0.065286000,0.0000
33.233.141.89:20492,<->,111.20.172.70:domain,1,99,0,0,1,99,0.065259000,0.0000
111.20.168.28:22129,<->,111.20.172.70:domain,1,107,0,0,1,107,0.065236000,0.0000
:::16661,<->,:::domain,1,322,0,0,1,322,0.064900000,0.0000
144.75.218.246:62568,<->,8.222.218.204:domain,1,122,0,0,1,122,0.064896000,0.0000
145.242.126.223:ntp,<->,6.94.58.6:ntp,1,80,0,0,1,80,0.064703000,0.0000
144.75.218.241:48649,<->,120.155.84.97:domain,1,232,0,0,1,232,0.064528000,0.0000
27.122.135.142:30945,<->,89.183.104.178:res-sap,0,0,1,52,1,52,0.064436000,0.0000
129.236.100.68:65118,<->,129.224.112.252:domain,0,0,1,70,1,70,0.064417000,0.0000
144.75.218.242:35311,<->,138.127.230.104:domain,1,257,0,0,1,257,0.064398000,0.0000
33.233.141.75:55097,<->,111.20.172.70:domain,1,292,0,0,1,292,0.064163000,0.0000
101.224.89.159:13138,<->,138.127.225.117:domain,1,167,0,0,1,167,0.064071000,0.0000
136.25.188.105:61324,<->,143.194.53.201:domain,1,252,0,0,1,252,0.063677000,0.0000
198.180.230.241:53036,<->,92.27.219.193:37103,0,0,1,106,1,106,0.063408000,0.0000
111.20.168.215:16423,<->,138.127.224.225:domain,1,241,0,0,1,241,0.063201000,0.0000
30.58.151.59:48319,<->,89.183.104.153:36105,0,0,1,100,1,100,0.063128000,0.0000
33.233.141.15:14268,<->,111.20.172.70:domain,1,160,0,0,1,160,0.063100000,0.0000
111.20.168.11:18437,<->,111.20.172.70:domain,1,166,0,0,1,166,0.063087000,0.0000
129.236.111.48:33371,<->,129.224.112.252:domain,0,0,1,75,1,75,0.063075000,0.0000
129.236.64.99:54557,<->,129.224.112.221:domain,0,0,1,76,1,76,0.062762000,0.0000
102.50.202.136:54907,<->,139.114.178.207:domain,1,116,0,0,1,116,0.062739000,0.0000
206.96.224.104:46257,<->,89.183.104.151:24338,0,0,1,135,1,135,0.062672000,0.0000
129.236.111.48:34530,<->,129.224.112.252:domain,0,0,1,79,1,79,0.062570000,0.0000
144.108.64.183:58893,<->,144.122.240.202:domain,0,0,1,64,1,64,0.061969000,0.0000
33.233.141.10:54742,<->,138.127.224.225:domain,1,240,0,0,1,240,0.061958000,0.0000
247.136.226.75:40566,<->,198.251.121.255:18487,1,135,0,0,1,135,0.061834000,0.0000
111.20.168.215:28744,<->,138.127.224.225:domain,1,235,0,0,1,235,0.061704000,0.0000
27.127.251.102:62194,<->,129.224.112.252:domain,0,0,1,75,1,75,0.061674000,0.0000
6.74.208.29:15730,<->,66.222.225.226:13882,1,130,0,0,1,130,0.061459000,0.0000
144.75.218.242:33175,<->,8.222.218.207:domain,1,127,0,0,1,127,0.061382000,0.0000
111.20.168.23:37193,<->,111.20.172.70:domain,1,110,0,0,1,110,0.060734000,0.0000
129.236.111.48:23949,<->,129.224.112.252:domain,0,0,1,76,1,76,0.060681000,0.0000
111.20.168.6:60238,<->,111.20.172.70:domain,1,142,0,0,1,142,0.060557000,0.0000
27.127.251.23:11386,<->,129.224.112.252:domain,0,0,1,75,1,75,0.060518000,0.0000
33.233.141.30:39251,<->,111.20.172.70:domain,1,99,0,0,1,99,0.060314000,0.0000
101.224.89.208:57575,<->,148.155.129.25:domain,1,161,0,0,1,161,0.060302000,0.0000
27.127.251.23:16724,<->,129.224.112.252:domain,0,0,1,75,1,75,0.060243000,0.0000
132.249.70.233:57648,<->,53.201.149.31:domain,1,87,0,0,1,87,0.059860000,0.0000
111.20.168.215:59334,<->,138.127.224.225:domain,1,243,0,0,1,243,0.059645000,0.0000
129.236.111.48:18136,<->,129.224.112.252:domain,0,0,1,78,1,78,0.059411000,0.0000
:::39284,<->,:::domain,1,807,0,0,1,807,0.059406000,0.0000
215.158.103.206:5811,<->,131.92.221.146:domain,1,103,0,0,1,103,0.059383000,0.0000
20.105.217.52:23426,<->,149.96.34.220:domain,1,118,0,0,1,118,0.059156000,0.0000
33.233.141.83:65425,<->,111.20.172.70:domain,1,164,0,0,1,164,0.059141000,0.0000
111.20.168.215:8218,<->,138.127.224.225:domain,1,237,0,0,1,237,0.059003000,0.0000
27.127.251.23:7828,<->,129.224.112.252:domain,0,0,1,75,1,75,0.058822000,0.0000
129.236.111.55:20841,<->,129.224.112.252:domain,0,0,1,70,1,70,0.058818000,0.0000
129.236.64.112:50006,<->,129.224.112.252:domain,0,0,1,76,1,76,0.058789000,0.0000
129.236.100.31:xprtld,<->,129.224.112.252:domain,0,0,1,79,1,79,0.058441000,0.0000
33.233.141.91:36766,<->,111.20.172.70:domain,1,100,0,0,1,100,0.058438000,0.0000
33.233.141.16:17018,<->,138.127.224.225:domain,1,245,0,0,1,245,0.058285000,0.0000
144.75.218.242:53391,<->,8.222.218.204:domain,1,110,0,0,1,110,0.058270000,0.0000
111.20.168.23:41730,<->,111.20.172.70:domain,1,107,0,0,1,107,0.057990000,0.0000
33.233.141.10:6151,<->,138.127.224.225:domain,1,242,0,0,1,242,0.057933000,0.0000
33.233.141.10:61436,<->,138.127.224.225:domain,1,241,0,0,1,241,0.057477000,0.0000
129.236.64.99:21255,<->,129.224.112.252:domain,0,0,1,77,1,77,0.057202000,0.0000
27.127.251.38:14350,<->,129.224.112.252:domain,0,0,1,79,1,79,0.056936000,0.0000
33.233.141.15:44265,<->,111.20.172.70:domain,1,107,0,0,1,107,0.056932000,0.0000
27.127.251.23:36733,<->,129.224.112.252:domain,0,0,1,75,1,75,0.056570000,0.0000
144.75.218.235:45295,<->,99.197.78.193:domain,1,76,0,0,1,76,0.056451000,0.0000
144.75.218.246:49228,<->,8.222.218.197:domain,1,126,0,0,1,126,0.056337000,0.0000
144.75.218.235:20843,<->,8.222.218.204:domain,1,111,0,0,1,111,0.056269000,0.0000
144.75.218.246:17099,<->,8.222.218.197:domain,1,113,0,0,1,113,0.056185000,0.0000
144.75.218.235:49595,<->,132.234.109.230:domain,1,150,0,0,1,150,0.056129000,0.0000
27.127.251.38:41748,<->,129.224.112.252:domain,0,0,1,81,1,81,0.055962000,0.0000
144.108.64.184:5759,<->,159.69.187.47:domain,0,0,1,62,1,62,0.055763000,0.0000
33.250.131.215:6881,<->,247.136.188.124:gnutella-svc,0,0,1,373,1,373,0.055752000,0.0000
247.136.178.211:50321,<->,61.58.39.197:6881,1,317,0,0,1,317,0.055699000,0.0000
27.127.251.38:64650,<->,129.224.112.252:domain,0,0,1,83,1,83,0.055587000,0.0000
33.233.141.40:42861,<->,111.20.172.70:domain,1,146,0,0,1,146,0.055538000,0.0000
110.55.186.175:41873,<->,92.27.219.129:30701,0,0,1,79,1,79,0.055352000,0.0000
101.224.89.208:48781,<->,148.155.131.234:domain,1,166,0,0,1,166,0.054612000,0.0000
33.233.141.16:6311,<->,138.127.224.225:domain,1,233,0,0,1,233,0.054546000,0.0000
33.233.141.51:26762,<->,111.20.172.70:domain,1,98,0,0,1,98,0.054004000,0.0000
39.14.27.228:11502,<->,137.33.165.19:domain,1,238,0,0,1,238,0.053543000,0.0000
144.75.218.242:60345,<->,8.222.218.199:domain,1,122,0,0,1,122,0.053354000,0.0000
92.27.219.246:58262,<->,27.67.139.81:25565,1,110,0,0,1,110,0.052915000,0.0000
97.94.179.54:38347,<->,192.67.190.59:33444,0,0,1,50,1,50,0.052844000,0.0000
33.233.141.25:40004,<->,111.20.172.70:domain,1,148,0,0,1,148,0.052817000,0.0000
33.209.217.191:41843,<->,215.158.239.223:domain,0,0,1,78,1,78,0.052775000,0.0000
144.75.218.235:23426,<->,8.222.218.198:domain,1,177,0,0,1,177,0.052125000,0.0000
111.20.168.215:58815,<->,138.127.224.225:domain,1,244,0,0,1,244,0.051636000,0.0000
27.127.251.38:54753,<->,129.224.112.252:domain,0,0,1,74,1,74,0.051388000,0.0000
192.67.146.217:61348,<->,115.222.251.133:6881,1,97,0,0,1,97,0.051329000,0.0000
111.150.206.32:64160,<->,80.56.78.92:domain,0,0,1,86,1,86,0.051131000,0.0000
33.233.141.43:52408,<->,138.127.224.225:domain,1,238,0,0,1,238,0.050531000,0.0000
144.75.218.235:20467,<->,138.127.231.148:domain,1,373,0,0,1,373,0.050299000,0.0000
101.224.89.132:8146,<->,111.20.172.70:domain,1,98,0,0,1,98,0.050237000,0.0000
197.120.231.194:46492,<->,129.224.112.252:domain,0,0,1,83,1,83,0.050202000,0.0000
33.233.141.24:ping-pong,<->,215.207.149.203:domain,1,66,0,0,1,66,0.050180000,0.0000
129.236.64.99:54746,<->,129.224.112.252:domain,0,0,1,74,1,74,0.050127000,0.0000
144.75.218.242:23833,<->,138.127.225.48:domain,1,168,0,0,1,168,0.050091000,0.0000
101.224.89.208:29208,<->,138.127.224.104:domain,1,279,0,0,1,279,0.050012000,0.0000
33.233.141.12:etftp,<->,111.20.172.70:domain,1,286,0,0,1,286,0.049993000,0.0000
20.20.217.100:64663,<->,57.94.149.86:domain,1,78,0,0,1,78,0.049851000,0.0000
129.236.111.95:35464,<->,129.224.112.252:domain,0,0,1,88,1,88,0.049469000,0.0000
101.224.89.208:41516,<->,138.127.225.156:domain,1,341,0,0,1,341,0.049428000,0.0000
8.228.218.69:6881,<->,126.213.42.171:nim,1,133,0,0,1,133,0.049063000,0.0000
129.236.100.63:12405,<->,129.224.112.252:domain,0,0,1,101,1,101,0.048720000,0.0000
93.224.24.248:45388,<->,89.183.104.189:36069,0,0,1,52,1,52,0.048469000,0.0000
38.21.156.204:56633,<->,20.232.229.18:netbios-ns,0,0,1,82,1,82,0.048049000,0.0000
21.15.226.126:55104,<->,20.193.41.28:netbios-ns,0,0,1,82,1,82,0.047804000,0.0000
129.236.64.50:45646,<->,129.224.112.252:domain,0,0,1,75,1,75,0.047789000,0.0000
119.219.97.10:50643,<->,101.224.204.141:domain,0,0,1,80,1,80,0.047395000,0.0000
136.25.188.105:57687,<->,141.204.123.255:domain,1,138,0,0,1,138,0.047390000,0.0000
101.224.89.158:57134,<->,111.20.172.70:domain,1,148,0,0,1,148,0.047388000,0.0000
50.224.111.129:banyan-vip,<->,105.251.93.143:domain,1,66,0,0,1,66,0.047332000,0.0000
101.224.89.132:21149,<->,111.20.172.70:domain,1,107,0,0,1,107,0.047128000,0.0000
144.75.218.246:56878,<->,8.222.218.204:domain,1,191,0,0,1,191,0.046830000,0.0000
144.75.218.246:hp-webqosdb,<->,8.222.218.197:domain,1,123,0,0,1,123,0.046384000,0.0000
132.249.70.233:52377,<->,148.198.183.187:domain,1,82,0,0,1,82,0.046223000,0.0000
33.233.141.43:28585,<->,138.127.224.225:domain,1,242,0,0,1,242,0.046153000,0.0000
144.108.64.184:9063,<->,159.69.187.19:domain,0,0,1,66,1,66,0.045900000,0.0000
33.233.141.43:53872,<->,138.127.224.225:domain,1,239,0,0,1,239,0.045797000,0.0000
20.98.98.52:30779,<->,194.244.97.62:domain,1,80,0,0,1,80,0.045710000,0.0000
144.75.218.237:35682,<->,8.222.218.198:domain,1,124,0,0,1,124,0.045709000,0.0000
136.25.188.105:57129,<->,132.43.156.81:domain,1,288,0,0,1,288,0.045652000,0.0000
203.118.37.242:35667,<->,92.27.219.243:24615,0,0,1,52,1,52,0.045414000,0.0000
115.81.129.57:51413,<->,89.183.104.252:31848,0,0,1,62,1,62,0.044953000,0.0000
129.236.111.81:19548,<->,129.224.112.252:domain,0,0,1,75,1,75,0.044884000,0.0000
101.224.89.251:39312,<->,148.155.130.96:domain,1,174,0,0,1,174,0.044262000,0.0000
144.75.218.241:48463,<->,8.222.218.204:domain,1,121,0,0,1,121,0.044132000,0.0000
144.75.218.235:34280,<->,8.47.122.178:domain,1,100,0,0,1,100,0.043943000,0.0000
144.75.218.233:40879,<->,8.222.218.204:domain,1,122,0,0,1,122,0.043574000,0.0000
33.233.141.97:55568,<->,138.127.225.152:domain,1,246,0,0,1,246,0.043202000,0.0000
144.75.218.242:22414,<->,8.222.218.199:domain,1,111,0,0,1,111,0.043182000,0.0000
144.75.218.235:23723,<->,158.55.120.187:domain,1,150,0,0,1,150,0.043020000,0.0000
144.75.218.246:13118,<->,100.185.121.91:domain,1,85,0,0,1,85,0.042710000,0.0000
144.75.218.246:18706,<->,8.222.218.197:domain,1,123,0,0,1,123,0.042682000,0.0000
89.183.104.252:32642,<->,122.212.65.37:25749,1,52,0,0,1,52,0.042442000,0.0000
230.91.134.56:16001,<->,109.3.162.222:6881,0,0,1,133,1,133,0.042042000,0.0000
105.227.214.36:45682,<->,192.64.199.47:14606,0,0,1,52,1,52,0.042021000,0.0000
136.25.188.105:53130,<->,143.204.138.236:domain,1,125,0,0,1,125,0.041687000,0.0000
33.233.141.88:leoip,<->,138.127.224.59:domain,1,249,0,0,1,249,0.041619000,0.0000
129.236.100.31:23329,<->,129.224.112.252:domain,0,0,1,77,1,77,0.041475000,0.0000
247.136.151.26:50108,<->,64.214.35.158:sslp,1,135,0,0,1,135,0.041176000,0.0000
34.154.0.26:12883,<->,66.193.249.94:domain,1,66,0,0,1,66,0.041145000,0.0000
144.75.218.235:27605,<->,8.222.218.198:domain,1,110,0,0,1,110,0.041029000,0.0000
144.75.218.235:30389,<->,8.222.218.197:domain,1,122,0,0,1,122,0.040374000,0.0000
142.232.107.172:43903,<->,246.253.253.209:https,0,0,1,221,1,221,0.039768000,0.0000
101.224.89.225:fairview,<->,111.20.172.70:domain,1,98,0,0,1,98,0.039697000,0.0000
129.236.100.63:50985,<->,129.224.112.252:domain,0,0,1,81,1,81,0.039656000,0.0000
144.75.218.241:56284,<->,8.222.218.204:domain,1,113,0,0,1,113,0.039643000,0.0000
:::55934,<->,:::domain,1,130,0,0,1,130,0.038971000,0.0000
111.20.168.21:40319,<->,138.127.224.176:domain,1,265,0,0,1,265,0.038839000,0.0000
144.75.218.241:32071,<->,138.127.225.194:domain,1,238,0,0,1,238,0.038823000,0.0000
20.142.137.62:35744,<->,120.224.238.228:domain,1,126,0,0,1,126,0.038808000,0.0000
101.224.89.130:13286,<->,138.127.224.104:domain,1,289,0,0,1,289,0.038714000,0.0000
144.75.218.246:22394,<->,8.222.218.199:domain,1,110,0,0,1,110,0.038621000,0.0000
111.20.168.21:6938,<->,138.127.224.176:domain,1,261,0,0,1,261,0.038294000,0.0000
33.233.141.35:8803,<->,138.127.224.225:domain,1,236,0,0,1,236,0.038221000,0.0000
33.233.141.35:44015,<->,138.127.224.225:domain,1,236,0,0,1,236,0.038191000,0.0000
8.238.222.86:62858,<->,95.245.91.32:43612,1,135,0,0,1,135,0.038078000,0.0000
101.224.89.251:62617,<->,138.127.224.44:domain,1,234,0,0,1,234,0.037988000,0.0000
33.233.141.67:61691,<->,138.127.224.225:domain,1,245,0,0,1,245,0.037943000,0.0000
33.233.141.35:56920,<->,138.127.224.225:domain,1,240,0,0,1,240,0.037412000,0.0000
92.27.219.132:36165,<->,64.214.44.95:30943,1,105,0,0,1,105,0.037266000,0.0000
27.14.150.165:57966,<->,100.92.86.131:11473,0,0,1,169,1,169,0.037240000,0.0000
27.127.251.41:14622,<->,129.224.112.252:domain,0,0,1,76,1,76,0.037073000,0.0000
101.224.89.244:57534,<->,138.127.224.44:domain,1,234,0,0,1,234,0.036997000,0.0000
94.39.154.13:55925,<->,92.27.27.144:38547,0,0,1,52,1,52,0.036842000,0.0000
92.27.219.221:51973,<->,114.28.246.175:37540,1,52,0,0,1,52,0.036618000,0.0000
33.233.141.67:53834,<->,138.127.224.225:domain,1,241,0,0,1,241,0.036215000,0.0000
144.108.64.183:20353,<->,144.122.240.238:domain,0,0,1,64,1,64,0.035851000,0.0000
144.75.218.237:33774,<->,8.222.218.198:domain,1,179,0,0,1,179,0.035515000,0.0000
33.233.141.41:57263,<->,138.127.224.225:domain,1,243,0,0,1,243,0.035408000,0.0000
38.21.156.204:56633,<->,20.232.229.4:netbios-ns,0,0,1,82,1,82,0.035012000,0.0000
194.154.60.221:52677,<->,129.224.112.252:domain,0,0,1,63,1,63,0.034979000,0.0000
27.127.251.41:21924,<->,129.224.112.252:domain,0,0,1,75,1,75,0.034581000,0.0000
101.224.89.158:44779,<->,111.20.172.70:domain,1,101,0,0,1,101,0.034050000,0.0000
144.108.64.184:39554,<->,159.69.187.46:domain,0,0,1,73,1,73,0.033322000,0.0000
144.75.218.233:32201,<->,8.222.218.197:domain,1,111,0,0,1,111,0.033138000,0.0000
144.75.218.241:16809,<->,8.222.218.196:domain,1,110,0,0,1,110,0.033101000,0.0000
33.233.141.34:29725,<->,138.127.225.73:domain,1,86,0,0,1,86,0.033089000,0.0000
101.224.89.175:65509,<->,148.155.131.220:domain,1,172,0,0,1,172,0.032803000,0.0000
21.15.226.126:55104,<->,20.193.43.244:netbios-ns,0,0,1,82,1,82,0.032762000,0.0000
33.233.141.41:47443,<->,138.127.224.225:domain,1,242,0,0,1,242,0.032395000,0.0000
33.233.141.67:42684,<->,138.127.224.225:domain,1,245,0,0,1,245,0.032296000,0.0000
60.170.105.150:47057,<->,20.66.59.200:39157,0,0,1,52,1,52,0.031930000,0.0000
144.75.218.237:56404,<->,8.222.218.198:domain,1,111,0,0,1,111,0.031651000,0.0000
33.233.141.35:44392,<->,138.127.224.225:domain,1,238,0,0,1,238,0.031367000,0.0000
144.108.64.184:51772,<->,144.122.240.240:domain,0,0,1,93,1,93,0.030800000,0.0000
89.139.241.98:11203,<->,193.30.240.160:domain,1,152,0,0,1,152,0.030736000,0.0000
111.20.168.22:50750,<->,111.20.172.70:domain,1,87,0,0,1,87,0.030485000,0.0000
89.183.104.177:33155,<->,102.50.23.191:19699,1,393,0,0,1,393,0.030412000,0.0000
27.127.251.41:43274,<->,129.224.112.252:domain,0,0,1,75,1,75,0.029777000,0.0000
140.20.42.168:50011,<->,111.146.188.194:bacula-sd,0,0,1,50,1,50,0.029527000,0.0000
20.128.169.18:50049,<->,123.87.27.159:12772,1,184,0,0,1,184,0.029377000,0.0000
144.93.121.10:62867,<->,144.93.125.37:30369,1,104,0,0,1,104,0.029187000,0.0000
:::49100,<->,:::domain,1,785,0,0,1,785,0.029186000,0.0000
33.233.141.41:56491,<->,138.127.224.225:domain,1,241,0,0,1,241,0.029155000,0.0000
33.233.141.41:57825,<->,138.127.224.225:domain,1,233,0,0,1,233,0.029067000,0.0000
33.233.141.41:56956,<->,138.127.224.225:domain,1,240,0,0,1,240,0.028981000,0.0000
198.206.5.108:45263,<->,220.55.79.118:domain,0,0,1,81,1,81,0.028942000,0.0000
33.233.141.74:57506,<->,138.127.224.158:domain,1,290,0,0,1,290,0.028808000,0.0000
144.75.218.233:31797,<->,8.47.123.77:domain,1,111,0,0,1,111,0.028253000,0.0000
91.54.155.124:60477,<->,132.249.70.233:domain,0,0,1,98,1,98,0.027734000,0.0000
101.224.89.222:47428,<->,138.127.225.156:domain,1,284,0,0,1,284,0.027261000,0.0000
101.224.89.225:14135,<->,111.20.172.70:domain,1,173,0,0,1,173,0.027214000,0.0000
33.233.141.73:42968,<->,138.127.225.202:domain,1,280,0,0,1,280,0.026843000,0.0000
33.233.141.114:ttc-etap-ds,<->,138.127.224.104:domain,1,276,0,0,1,276,0.026754000,0.0000
247.157.92.140:56684,<->,154.149.9.215:8419,1,130,0,0,1,130,0.026713000,0.0000
20.212.200.7:5158,<->,128.152.250.4:domain,1,72,0,0,1,72,0.026703000,0.0000
144.75.218.233:sns-agent,<->,8.222.218.197:domain,1,110,0,0,1,110,0.026686000,0.0000
53.249.253.120:47180,<->,39.15.169.14:domain,0,0,1,88,1,88,0.026654000,0.0000
105.102.187.17:21331,<->,196.148.133.194:6881,0,0,1,103,1,103,0.026621000,0.0000
21.15.226.126:55104,<->,20.193.43.228:netbios-ns,0,0,1,82,1,82,0.026550000,0.0000
92.160.15.190:64987,<->,129.224.112.252:domain,0,0,1,69,1,69,0.025814000,0.0000
91.54.155.124:47900,<->,132.249.70.233:domain,0,0,1,88,1,88,0.025713000,0.0000
144.108.80.163:63282,<->,144.122.240.202:domain,0,0,1,65,1,65,0.025693000,0.0000
33.233.141.53:57497,<->,111.20.172.70:domain,1,97,0,0,1,97,0.025591000,0.0000
144.108.64.184:38841,<->,144.122.240.235:domain,0,0,1,67,1,67,0.025453000,0.0000
89.183.104.236:64606,<->,120.246.11.222:15012,1,52,0,0,1,52,0.025405000,0.0000
92.27.27.189:63906,<->,236.160.232.38:domain,1,260,0,0,1,260,0.025388000,0.0000
144.75.218.233:55920,<->,8.222.218.197:domain,1,190,0,0,1,190,0.025189000,0.0000
33.233.141.73:7480,<->,138.127.224.187:domain,1,235,0,0,1,235,0.024610000,0.0000
215.158.103.206:23755,<->,159.118.210.230:domain,1,84,0,0,1,84,0.023869000,0.0000
136.25.188.105:61295,<->,132.5.71.202:domain,1,251,0,0,1,251,0.023821000,0.0000
33.233.141.73:64534,<->,138.127.225.202:domain,1,280,0,0,1,280,0.023532000,0.0000
21.15.226.126:55104,<->,20.193.43.239:netbios-ns,0,0,1,82,1,82,0.023517000,0.0000
0.247.66.228:icl-twobase7,<->,145.252.126.188:domain,0,0,1,71,1,71,0.022629000,0.0000
144.75.218.235:55016,<->,8.222.218.198:domain,1,114,0,0,1,114,0.022601000,0.0000
92.160.15.190:22610,<->,129.224.112.252:domain,0,0,1,81,1,81,0.022321000,0.0000
144.75.218.233:amt-redir-tls,<->,8.222.218.204:domain,1,109,0,0,1,109,0.022204000,0.0000
144.75.218.242:16960,<->,8.222.218.207:domain,1,109,0,0,1,109,0.022196000,0.0000
144.75.218.246:55112,<->,8.222.218.199:domain,1,188,0,0,1,188,0.021688000,0.0000
141.105.247.20:61966,<->,136.129.94.107:domain,0,0,1,84,1,84,0.021625000,0.0000
144.75.218.237:34720,<->,8.222.218.204:domain,1,122,0,0,1,122,0.020962000,0.0000
144.75.218.237:46478,<->,8.222.218.204:domain,1,122,0,0,1,122,0.020818000,0.0000
111.20.168.143:31981,<->,81.96.106.185:domain,1,175,0,0,1,175,0.020771000,0.0000
33.233.141.231:38129,<->,138.127.224.225:domain,1,242,0,0,1,242,0.020677000,0.0000
144.75.218.246:32735,<->,8.222.218.197:domain,1,110,0,0,1,110,0.020424000,0.0000
215.158.239.8:37148,<->,144.90.109.23:domain,1,122,0,0,1,122,0.020087000,0.0000
129.254.101.3:owserver,<->,129.224.112.252:domain,0,0,1,63,1,63,0.019899000,0.0000
144.75.218.241:57376,<->,120.155.84.97:domain,1,145,0,0,1,145,0.019852000,0.0000
144.75.218.233:5956,<->,8.222.218.196:domain,1,123,0,0,1,123,0.019775000,0.0000
144.75.218.237:59280,<->,120.155.84.97:domain,1,138,0,0,1,138,0.019641000,0.0000
144.75.218.237:13865,<->,8.222.218.207:domain,1,121,0,0,1,121,0.019323000,0.0000
124.125.130.197:58642,<->,80.38.49.144:domain,0,0,1,82,1,82,0.019218000,0.0000
39.0.118.174:55527,<->,207.42.247.171:domain,1,68,0,0,1,68,0.018886000,0.0000
144.75.218.237:58319,<->,8.222.218.207:domain,1,125,0,0,1,125,0.018862000,0.0000
132.10.25.131:63928,<->,132.3.191.238:domain,1,638,0,0,1,638,0.018480000,0.0000
144.84.228.247:29472,<->,144.122.240.220:domain,0,0,1,79,1,79,0.018442000,0.0000
122.142.196.174:58969,<->,92.27.219.148:16474,0,0,1,105,1,105,0.018272000,0.0000
254.126.164.43:58878,<->,129.224.112.252:domain,0,0,1,77,1,77,0.018084000,0.0000
136.25.188.105:60504,<->,135.88.171.34:domain,1,141,0,0,1,141,0.017994000,0.0000
220.20.206.207:63046,<->,129.224.112.252:domain,0,0,1,81,1,81,0.017983000,0.0000
144.75.218.241:50255,<->,8.222.218.204:domain,1,123,0,0,1,123,0.017776000,0.0000
33.233.141.32:cmtp-av,<->,138.127.224.148:domain,1,289,0,0,1,289,0.017735000,0.0000
144.108.64.184:17722,<->,144.122.240.212:domain,0,0,1,69,1,69,0.017514000,0.0000
144.108.64.184:50403,<->,144.122.240.239:domain,0,0,1,63,1,63,0.017274000,0.0000
144.75.218.242:26632,<->,8.222.218.196:domain,1,123,0,0,1,123,0.017012000,0.0000
144.108.64.184:27532,<->,144.122.240.212:domain,0,0,1,69,1,69,0.016967000,0.0000
101.224.89.168:33384,<->,138.127.224.225:domain,1,243,0,0,1,243,0.016439000,0.0000
33.233.141.231:23201,<->,138.127.224.225:domain,1,236,0,0,1,236,0.016334000,0.0000
33.233.141.68:52999,<->,138.127.224.44:domain,1,234,0,0,1,234,0.016285000,0.0000
33.233.141.231:8287,<->,138.127.224.225:domain,1,238,0,0,1,238,0.016276000,0.0000
33.233.141.113:37600,<->,138.127.224.138:domain,1,264,0,0,1,264,0.016273000,0.0000
20.119.116.167:43570,<->,207.63.14.214:domain,1,70,0,0,1,70,0.015686000,0.0000
210.158.44.63:47995,<->,33.229.58.179:domain,1,638,0,0,1,638,0.014887000,0.0000
92.27.27.169:43422,<->,27.11.106.159:6881,1,52,0,0,1,52,0.014659000,0.0000
33.233.141.30:60580,<->,97.110.148.13:domain,1,98,0,0,1,98,0.014202000,0.0000
38.239.76.149:35791,<->,109.1.62.236:domain,0,0,1,72,1,72,0.013555000,0.0000
144.108.64.184:fjitsuappmgr,<->,144.122.240.196:domain,0,0,1,70,1,70,0.013494000,0.0000
56.61.99.23:32786,<->,97.68.226.205:domain,0,0,1,86,1,86,0.013396000,0.0000
114.211.225.166:50944,<->,92.27.27.144:30828,0,0,1,52,1,52,0.012952000,0.0000
144.108.64.183:29278,<->,159.69.187.8:domain,0,0,1,72,1,72,0.012936000,0.0000
144.75.218.237:6183,<->,120.155.84.97:domain,1,235,0,0,1,235,0.012610000,0.0000
144.75.218.246:53151,<->,139.252.1.244:domain,1,244,0,0,1,244,0.012595000,0.0000
111.20.168.6:41557,<->,222.243.101.254:domain,1,147,0,0,1,147,0.012557000,0.0000
127.236.62.242:61426,<->,109.222.217.93:domain,0,0,1,69,1,69,0.012328000,0.0000
111.20.168.6:54664,<->,222.243.101.254:domain,1,150,0,0,1,150,0.011399000,0.0000
101.224.89.152:24628,<->,148.155.129.25:domain,1,172,0,0,1,172,0.011384000,0.0000
101.224.89.225:4712,<->,111.20.172.70:domain,1,104,0,0,1,104,0.010975000,0.0000
132.249.70.233:60795,<->,53.201.149.31:domain,1,89,0,0,1,89,0.010478000,0.0000
198.182.215.243:25446,<->,109.1.34.223:9797,0,0,1,325,1,325,0.010231000,0.0000
246.254.97.80:30904,<->,50.145.195.49:domain,1,92,0,0,1,92,0.009974000,0.0000
144.75.218.246:51300,<->,99.168.7.150:domain,1,156,0,0,1,156,0.009720000,0.0000
111.20.168.22:62257,<->,111.20.172.70:domain,1,100,0,0,1,100,0.008912000,0.0000
20.67.179.246:50491,<->,207.74.108.169:domain,1,72,0,0,1,72,0.008220000,0.0000
99.74.26.144:40040,<->,111.151.107.247:domain,1,217,0,0,1,217,0.008219000,0.0000
33.200.176.52:21321,<->,192.64.245.111:17169,0,0,1,135,1,135,0.008107000,0.0000
35.122.9.250:52965,<->,101.70.126.35:domain,0,0,1,80,1,80,0.008012000,0.0000
215.158.239.192:38844,<->,138.127.225.15:domain,1,191,0,0,1,191,0.007670000,0.0000
158.200.200.182:53428,<->,20.207.97.201:snmp,0,0,1,110,1,110,0.007662000,0.0000
89.183.104.157:42985,<->,18.201.152.85:6881,1,325,0,0,1,325,0.006474000,0.0000
144.108.64.184:13975,<->,144.122.240.212:domain,0,0,1,69,1,69,0.006316000,0.0000
215.158.103.206:52688,<->,138.127.231.160:domain,1,153,0,0,1,153,0.005819000,0.0000
144.108.64.184:13414,<->,159.69.187.22:domain,0,0,1,65,1,65,0.005737000,0.0000
144.75.218.237:54912,<->,8.222.218.204:domain,1,187,0,0,1,187,0.005727000,0.0000
120.48.82.204:28177,<->,80.38.25.142:domain,0,0,1,78,1,78,0.005616000,0.0000
89.183.104.189:51413,<->,148.110.20.29:22286,1,135,0,0,1,135,0.005609000,0.0000
97.126.113.29:16768,<->,97.19.107.13:domain,1,152,0,0,1,152,0.005375000,0.0000
136.25.188.105:51762,<->,143.29.129.15:domain,1,159,0,0,1,159,0.004890000,0.0000
33.233.141.75:15900,<->,138.127.224.225:domain,1,236,0,0,1,236,0.003940000,0.0000
120.231.123.174:18095,<->,139.163.5.140:http,0,0,1,62,1,62,0.003773000,0.0000
:::59719,<->,:::domain,1,296,0,0,1,296,0.003411000,0.0000
144.75.218.241:37118,<->,8.222.218.207:domain,1,113,0,0,1,113,0.002320000,0.0000
144.75.218.241:39112,<->,138.127.224.135:domain,1,238,0,0,1,238,0.002178000,0.0000
33.233.141.75:46331,<->,138.127.224.225:domain,1,238,0,0,1,238,0.002086000,0.0000
59.130.179.247:11100,<->,144.70.196.18:domain,0,0,1,65,1,65,0.001983000,0.0000
21.15.226.126:55104,<->,20.193.43.25:netbios-ns,0,0,1,82,1,82,0.001582000,0.0000
192.67.172.77:46324,<->,75.148.75.193:27075,1,133,0,0,1,133,0.001538000,0.0000
33.233.141.53:56061,<->,111.20.172.70:domain,1,154,0,0,1,154,0.001231000,0.0000
111.20.168.22:43761,<->,138.127.224.104:domain,1,197,0,0,1,197,0.000749000,0.0000
239.227.117.41:53325,<->,230.94.217.98:13907,1,61,0,0,1,61,0.000329000,0.0000
33.233.141.83:61774,<->,111.20.172.70:domain,1,160,0,0,1,160,0.000282000,0.0000
27.188.163.162:i-net-2000-npr,<->,109.1.17.167:sip,0,0,1,445,1,445,0.000116000,0.0000
