src,<->,dest,in_frames,in_bytes,out_frames,out_bytes,total_frames,total_bytes,rel_start,duration
220.20.200.164,<->,84.236.193.94,21112,31747024,0,0,21112,31747024,0.000003000,1.9944
109.97.67.71,<->,92.27.27.185,0,0,7760,6072145,7760,6072145,0.004502000,1.9954
247.136.134.84,<->,22.249.49.193,5769,8676576,0,0,5769,8676576,0.003426000,1.9944
220.28.73.211,<->,215.158.140.162,0,0,4008,5811949,4008,5811949,0.277408000,1.6792
121.23.5.158,<->,89.183.104.248,0,0,3799,4718748,3799,4718748,0.002621000,1.9953
144.93.121.86,<->,144.93.120.177,3414,696456,0,0,3414,696456,0.001075000,1.9987
215.158.238.110,<->,56.20.122.75,3346,5026059,0,0,3346,5026059,0.000020000,1.9117
145.19.13.114,<->,14.27.112.65,3258,4900032,0,0,3258,4900032,0.010939000,1.9877
133.178.226.214,<->,100.224.243.106,3137,4515913,0,0,3137,4515913,1.033264000,0.9531
192.228.188.15,<->,133.178.227.105,0,0,2986,4362558,2986,4362558,0.574513000,0.6483
136.25.189.94,<->,8.188.181.66,2954,4360876,0,0,2954,4360876,0.092315000,1.2373
144.93.121.48,<->,144.93.120.177,2928,597312,0,0,2928,597312,0.000797000,1.9992
144.93.121.10,<->,144.93.120.177,2820,575280,0,0,2820,575280,0.000132000,1.9988
218.4.183.196,<->,111.151.238.110,2771,332480,0,0,2771,332480,0.038964000,1.9473
215.158.33.13,<->,133.178.226.55,0,0,2763,3961571,2763,3961571,0.296391000,1.6101
215.158.33.13,<->,133.178.226.33,0,0,2740,4059325,2740,4059325,0.030492000,1.8141
133.178.226.196,<->,100.224.243.115,2574,3510389,0,0,2574,3510389,0.003746000,1.9859
215.158.140.181,<->,100.224.243.91,2549,3573025,0,0,2549,3573025,1.416525000,0.5755
133.32.39.44,<->,100.206.63.40,2418,136488,0,0,2418,136488,0.027257000,1.9498
215.158.58.243,<->,8.252.222.232,0,0,2316,3471188,2316,3471188,0.248523000,0.3427
129.92.113.183,<->,53.231.158.13,2104,107304,0,0,2104,107304,0.008143000,1.9916
220.28.104.193,<->,215.158.238.40,0,0,2102,3055083,2102,3055083,0.014459000,0.8616
252.98.181.203,<->,139.254.110.36,2080,2830768,0,0,2080,2830768,0.001749000,1.9975
123.153.228.196,<->,92.162.253.159,0,0,2079,2799068,2079,2799068,0.009082000,0.8144
102.83.246.39,<->,8.240.117.69,2047,3076724,0,0,2047,3076724,0.258857000,1.4763
215.158.197.12,<->,8.252.222.153,0,0,1866,2718861,1866,2718861,0.027553000,0.3526
80.41.49.252,<->,22.250.210.0,1829,2720408,0,0,1829,2720408,0.001847000,1.9943
124.55.166.157,<->,80.41.39.76,0,0,1817,2732768,1817,2732768,0.001309000,1.9944
80.42.151.30,<->,22.250.173.71,1781,2678624,0,0,1781,2678624,0.017751000,1.9763
215.158.23.56,<->,8.255.92.213,1710,2551331,0,0,1710,2551331,0.010606000,1.9800
215.158.140.171,<->,98.219.126.140,1709,2482603,0,0,1709,2482603,0.665909000,0.5442
220.28.85.14,<->,215.158.238.194,0,0,1695,2417653,1695,2417653,0.017027000,1.9805
101.70.121.77,<->,91.250.62.235,1580,2249920,0,0,1580,2249920,0.013681000,1.9860
136.25.189.55,<->,80.56.246.217,1540,2185375,0,0,1540,2185375,0.858638000,0.1864
133.178.227.28,<->,8.255.87.80,1503,2191653,0,0,1503,2191653,0.805956000,0.2763
215.158.140.180,<->,131.31.145.204,1486,2184415,0,0,1486,2184415,0.881909000,0.8821
192.170.254.72,<->,136.25.189.10,0,0,1477,2180435,1477,2180435,0.082417000,0.1751
144.93.121.50,<->,144.93.120.177,1468,299472,0,0,1468,299472,0.000327000,1.9983
220.28.115.46,<->,215.158.238.254,0,0,1467,2116252,1467,2116252,0.018645000,1.8879
215.158.195.23,<->,53.231.141.142,1452,2161517,0,0,1452,2161517,1.487050000,0.3331
220.38.163.255,<->,215.158.140.216,0,0,1444,2170372,1444,2170372,0.470145000,0.4970
215.158.195.21,<->,53.231.227.65,1443,2161104,0,0,1443,2161104,0.050094000,0.4209
133.178.226.22,<->,100.120.38.6,1409,1992558,0,0,1409,1992558,0.038646000,1.9189
133.135.214.225,<->,129.6.83.5,0,0,1401,2012668,1401,2012668,0.929419000,0.9748
215.158.33.1,<->,133.178.226.43,0,0,1383,1945677,1383,1945677,0.003684000,1.1988
111.147.177.227,<->,53.230.16.127,1220,1833662,0,0,1220,1833662,0.052185000,0.9899
215.158.140.214,<->,113.23.83.164,1153,1733894,0,0,1153,1733894,1.541067000,0.1990
109.222.254.120,<->,53.231.147.157,1137,56850,0,0,1137,56850,0.001718000,1.9806
17.23.199.45,<->,8.220.239.104,0,0,1136,60413,1136,60413,0.058273000,1.8127
215.158.140.201,<->,100.224.132.154,1117,1602384,0,0,1117,1602384,0.276582000,0.1635
109.1.19.72,<->,22.249.49.193,1046,1573184,0,0,1046,1573184,0.009216000,1.9662
144.93.125.49,<->,144.93.121.10,0,0,1046,213084,1046,213084,0.000556000,1.9940
215.158.197.18,<->,8.252.222.234,0,0,1024,1502560,1024,1502560,1.817487000,0.1749
144.93.125.49,<->,144.93.121.86,0,0,1010,205492,1010,205492,0.000513000,1.9981
152.105.191.57,<->,8.252.221.205,0,0,1003,78432,1003,78432,0.026989000,1.9289
61.125.88.44,<->,8.252.222.69,0,0,998,78732,998,78732,0.007919000,1.9794
215.158.238.246,<->,215.158.132.243,956,1364643,0,0,956,1364643,1.929394000,0.0628
144.232.205.250,<->,6.228.9.53,0,0,933,1281230,933,1281230,0.912278000,1.0859
215.158.49.48,<->,136.116.28.230,0,0,926,1389701,926,1389701,1.260715000,0.1239
92.27.27.161,<->,0.48.226.240,926,1287312,0,0,926,1287312,0.048547000,1.9494
209.91.237.87,<->,8.52.154.11,0,0,925,47168,925,47168,0.216783000,1.4727
252.98.149.218,<->,144.85.169.244,915,1373252,0,0,915,1373252,0.579779000,1.4193
215.158.238.118,<->,159.218.248.240,911,1367361,0,0,911,1367361,1.714055000,0.0450
144.93.121.86,<->,113.171.246.29,901,119656,0,0,901,119656,0.000263000,1.9988
215.158.49.51,<->,136.116.28.231,0,0,896,1339544,896,1339544,0.009736000,0.2048
80.41.48.44,<->,0.38.147.27,894,1343977,0,0,894,1343977,0.000011000,1.9783
193.22.56.246,<->,80.41.51.42,0,0,892,1281260,892,1281260,0.009867000,1.9041
192.64.229.30,<->,132.165.165.5,890,1338560,0,0,890,1338560,0.103923000,1.8904
247.136.153.191,<->,22.249.49.193,888,1335552,0,0,888,1335552,0.005314000,1.9843
53.231.66.9,<->,33.233.141.61,0,0,875,1284748,875,1284748,0.463416000,1.5301
94.193.204.108,<->,8.252.222.93,0,0,867,71984,867,71984,0.037230000,1.9022
220.28.115.46,<->,215.158.238.144,0,0,860,1127467,860,1127467,0.052936000,1.8844
215.158.238.104,<->,33.239.214.176,849,47544,0,0,849,47544,0.040329000,1.8828
215.158.49.22,<->,136.116.28.228,0,0,836,1254909,836,1254909,1.139105000,0.0613
148.214.83.199,<->,92.27.27.179,0,0,826,1203482,826,1203482,0.020736000,1.9750
132.168.196.224,<->,8.232.107.145,818,45808,0,0,818,45808,0.000562000,1.0695
218.4.182.130,<->,132.216.20.244,810,1204673,0,0,810,1204673,0.047278000,0.7044
215.158.195.25,<->,53.231.144.135,810,1192427,0,0,810,1192427,0.006975000,1.9783
220.28.109.52,<->,136.25.188.165,0,0,795,1129703,795,1129703,0.021676000,1.5388
220.28.108.254,<->,215.158.238.129,0,0,774,1026156,774,1026156,0.054889000,1.9371
131.148.66.172,<->,20.206.10.26,0,0,762,62484,762,62484,0.220441000,1.6019
215.158.238.201,<->,139.241.115.236,756,1123027,0,0,756,1123027,1.563196000,0.0813
192.228.25.249,<->,133.178.226.213,0,0,742,1108573,742,1108573,0.122806000,1.7574
133.178.226.55,<->,100.120.38.6,742,1025506,0,0,742,1025506,0.048217000,1.8978
215.158.49.76,<->,136.116.28.231,0,0,741,1099436,741,1099436,0.382935000,1.5863
75.137.133.162,<->,8.252.221.223,0,0,741,44400,741,44400,0.004117000,1.9929
230.102.130.22,<->,133.178.227.222,0,0,733,624403,733,624403,0.000236000,1.9995
210.220.218.45,<->,14.27.112.67,732,1051554,0,0,732,1051554,0.043235000,1.5361
119.131.135.20,<->,92.168.217.252,0,0,719,40264,719,40264,0.030908000,1.9666
105.113.53.185,<->,92.27.219.43,0,0,718,378164,718,378164,0.022238000,1.9750
60.101.121.79,<->,8.252.221.220,0,0,717,53000,717,53000,0.007542000,1.9784
133.8.10.152,<->,33.233.141.28,0,0,715,1070337,715,1070337,0.140087000,1.6552
192.64.194.99,<->,127.161.158.33,707,1027988,0,0,707,1027988,0.005265000,1.9927
144.93.125.48,<->,144.93.121.86,0,0,703,143112,703,143112,0.007305000,1.9899
58.242.207.11,<->,8.252.222.241,0,0,702,57544,702,57544,0.010929000,1.9869
215.158.140.202,<->,98.219.126.140,682,990371,0,0,682,990371,0.037861000,0.2101
215.158.238.130,<->,145.116.206.214,672,40296,0,0,672,40296,0.001090000,1.9976
53.231.94.20,<->,33.233.141.47,0,0,667,981819,667,981819,0.032316000,1.3037
53.231.94.186,<->,33.233.141.19,0,0,665,987326,665,987326,0.968435000,0.9829
58.51.8.74,<->,8.252.221.230,0,0,662,40527,662,40527,0.000893000,1.9893
111.20.168.11,<->,72.210.211.251,660,992435,0,0,660,992435,1.736969000,0.1305
58.203.253.82,<->,8.252.221.197,0,0,656,49110,656,49110,0.044049000,1.9209
220.20.200.40,<->,113.173.246.17,653,981542,0,0,653,981542,0.100253000,1.2779
108.39.231.205,<->,50.224.105.35,0,0,651,42312,651,42312,0.014376000,1.9573
101.235.68.176,<->,8.20.81.65,645,954833,0,0,645,954833,1.233136000,0.4406
220.28.65.9,<->,215.158.140.234,0,0,645,932039,645,932039,0.323144000,1.2135
69.243.203.69,<->,8.252.222.126,0,0,632,47556,632,47556,0.066980000,1.7872
246.253.169.93,<->,8.35.106.89,619,31409,0,0,619,31409,0.234783000,1.7477
74.142.203.248,<->,8.252.221.204,0,0,613,42850,613,42850,0.134216000,1.7244
145.19.11.136,<->,109.219.195.59,609,183304,0,0,609,183304,0.002305000,1.9888
144.85.170.254,<->,80.30.20.95,605,40223,0,0,605,40223,0.844567000,1.1421
133.178.226.23,<->,100.120.38.6,590,792344,0,0,590,792344,0.065578000,1.8644
67.14.100.67,<->,8.252.222.225,0,0,588,48328,588,48328,0.122532000,1.8719
215.158.238.99,<->,148.72.94.212,588,33060,0,0,588,33060,0.004896000,1.9852
129.78.117.76,<->,50.200.168.165,578,30948,0,0,578,30948,0.004005000,1.9828
215.158.238.194,<->,215.158.43.2,575,857281,0,0,575,857281,0.653723000,0.3133
215.158.61.192,<->,99.74.26.134,0,0,566,816524,566,816524,0.905419000,1.0805
215.158.52.230,<->,144.95.104.75,564,28239,0,0,564,28239,0.009859000,1.9299
204.95.110.72,<->,8.20.87.187,0,0,564,28200,564,28200,0.006911000,1.4495
220.28.114.28,<->,215.158.140.199,0,0,560,811644,560,811644,1.642442000,0.3022
215.158.34.85,<->,8.176.8.81,0,0,543,767080,543,767080,1.273839000,0.6882
144.85.170.246,<->,144.54.7.171,541,30954,0,0,541,30954,0.069633000,1.7698
92.168.217.129,<->,75.95.153.184,541,30296,0,0,541,30296,0.023200000,1.9677
215.158.238.144,<->,100.216.78.145,515,679364,0,0,515,679364,0.029687000,1.9690
146.235.109.66,<->,8.252.221.195,0,0,504,749232,504,749232,0.129954000,1.8699
220.28.109.52,<->,136.25.188.168,0,0,504,697556,504,697556,0.016453000,1.9210
144.93.121.86,<->,144.93.120.28,500,102000,0,0,500,102000,0.003369000,1.9961
144.93.121.48,<->,144.93.120.28,500,102000,0,0,500,102000,0.003336000,1.9935
17.198.244.92,<->,8.220.206.230,0,0,491,24769,491,24769,0.083157000,1.7468
86.135.81.65,<->,8.252.222.68,0,0,490,28173,490,28173,0.097300000,1.8976
48.19.57.168,<->,8.252.222.224,0,0,489,38160,489,38160,0.023362000,1.8932
144.253.73.231,<->,133.178.227.234,0,0,485,27292,485,27292,0.933170000,0.9393
144.253.55.140,<->,133.178.227.200,0,0,482,504454,482,504454,0.018361000,1.9751
76.179.97.77,<->,8.252.222.96,0,0,478,36232,478,36232,0.080480000,1.7373
133.54.43.75,<->,117.6.238.227,463,29192,0,0,463,29192,1.257319000,0.7420
144.85.170.244,<->,17.42.178.222,459,26495,0,0,459,26495,0.819862000,1.1764
111.147.255.174,<->,53.232.227.250,453,678977,0,0,453,678977,0.865276000,0.9666
215.158.238.244,<->,100.216.78.145,452,607857,0,0,452,607857,0.014012000,1.9221
220.28.104.193,<->,215.158.238.146,0,0,450,588612,450,588612,0.021499000,1.9016
193.21.28.216,<->,100.94.41.247,0,0,446,657438,446,657438,0.004379000,1.6553
215.158.238.153,<->,100.120.38.6,444,605056,0,0,444,605056,0.060116000,1.8733
20.194.70.45,<->,20.194.65.207,444,24864,0,0,444,24864,0.014748000,1.8699
220.28.114.28,<->,215.158.238.88,0,0,443,591576,443,591576,0.217211000,1.7007
247.136.132.126,<->,93.181.154.100,442,23640,0,0,442,23640,0.010717000,1.9287
220.28.104.193,<->,215.158.238.147,0,0,438,588800,438,588800,0.119988000,1.8059
158.14.109.76,<->,145.16.41.83,0,0,436,628455,436,628455,0.044556000,1.9465
152.12.153.239,<->,89.183.104.135,0,0,435,358975,435,358975,0.102488000,1.8477
215.158.239.20,<->,96.135.154.114,433,471034,0,0,433,471034,0.557901000,1.3132
220.28.104.193,<->,215.158.238.77,0,0,432,586038,432,586038,0.051513000,1.9301
247.136.176.67,<->,138.0.22.132,432,616424,0,0,432,616424,0.030822000,1.9644
220.211.201.206,<->,133.178.227.152,0,0,432,129034,432,129034,0.004044000,1.9924
215.158.23.50,<->,192.204.123.10,431,640108,0,0,431,640108,0.004003000,1.9881
145.182.137.223,<->,136.25.188.41,0,0,428,602293,428,602293,0.142301000,0.3329
97.19.3.156,<->,8.252.223.233,0,0,425,21250,425,21250,0.002228000,0.7664
58.143.178.4,<->,8.252.221.230,0,0,421,31330,421,31330,0.062143000,1.9327
215.158.238.69,<->,98.219.126.140,418,548437,0,0,418,548437,0.013658000,1.9726
48.18.237.212,<->,8.252.221.197,0,0,415,31812,415,31812,0.012841000,1.9678
215.158.238.68,<->,98.219.126.175,410,548089,0,0,410,548089,0.154256000,1.7783
222.31.15.60,<->,215.158.238.210,0,0,407,24346,407,24346,0.124844000,1.8750
124.59.106.210,<->,109.222.212.23,0,0,405,589680,405,589680,0.003362000,1.9962
133.178.227.207,<->,69.31.239.50,405,84372,0,0,405,84372,0.000599000,1.9952
127.128.216.186,<->,92.168.217.252,0,0,404,22884,404,22884,0.080382000,1.9159
232.111.67.19,<->,192.67.146.96,0,0,401,350228,401,350228,0.017747000,1.9592
220.28.115.46,<->,215.158.238.252,0,0,399,548474,399,548474,0.233827000,1.6972
220.28.85.14,<->,215.158.238.153,0,0,399,517133,399,517133,0.080558000,1.8632
215.158.2.80,<->,8.238.204.1,0,0,399,92238,399,92238,0.002284000,1.9911
144.93.121.10,<->,144.93.120.28,399,81396,0,0,399,81396,0.001919000,1.9910
120.85.4.6,<->,109.1.58.185,0,0,398,598592,398,598592,0.004235000,1.8505
144.85.170.244,<->,98.87.145.30,397,23140,0,0,397,23140,0.667867000,1.3289
254.177.165.75,<->,215.158.238.94,0,0,395,30160,395,30160,1.061356000,0.4886
133.178.226.226,<->,8.254.21.53,390,584292,0,0,390,584292,0.293889000,1.6720
215.158.238.145,<->,98.219.126.140,388,529666,0,0,388,529666,0.251988000,1.6940
133.54.43.41,<->,93.208.41.137,386,24774,0,0,386,24774,0.681152000,1.3152
220.28.104.193,<->,215.158.238.109,0,0,386,524913,386,524913,0.031008000,1.9165
139.163.0.99,<->,82.162.150.21,382,21739,0,0,382,21739,0.619653000,0.8138
220.28.73.211,<->,215.158.140.84,0,0,382,524658,382,524658,0.026633000,1.9603
133.178.226.174,<->,100.120.38.6,379,519406,0,0,379,519406,0.345915000,1.6229
146.200.179.97,<->,0.195.210.33,0,0,378,18900,378,18900,0.008897000,1.9841
215.158.238.76,<->,100.120.38.6,378,519819,0,0,378,519819,0.000068000,1.9813
133.178.227.44,<->,100.224.133.155,375,561683,0,0,375,561683,0.469648000,0.0263
215.158.238.69,<->,100.120.38.6,375,474654,0,0,375,474654,0.052455000,1.8708
220.28.73.211,<->,215.158.238.79,0,0,374,497228,374,497228,0.022154000,1.9241
101.224.182.5,<->,92.162.253.239,0,0,372,554153,372,554153,1.157328000,0.3243
215.158.140.199,<->,29.211.120.86,371,553648,0,0,371,553648,1.334397000,0.6417
133.178.226.41,<->,100.120.38.6,370,484837,0,0,370,484837,0.025228000,1.9669
93.73.247.21,<->,92.168.217.245,0,0,369,18941,369,18941,0.748542000,0.6068
198.230.143.36,<->,82.252.43.154,0,0,368,360343,368,360343,0.000165000,1.9998
133.244.31.120,<->,80.27.154.173,366,512575,0,0,366,512575,0.918608000,0.3340
254.242.184.13,<->,110.27.228.146,366,20496,0,0,366,20496,0.030894000,1.9669
215.158.238.110,<->,100.216.78.145,366,487665,0,0,366,487665,0.000601000,1.9699
235.42.35.226,<->,215.158.23.59,0,0,357,529280,357,529280,0.031519000,1.9606
215.158.238.231,<->,215.158.34.90,356,533959,0,0,356,533959,1.201960000,0.0217
133.178.227.145,<->,83.232.206.116,355,104074,0,0,355,104074,0.000051000,1.9917
215.158.140.193,<->,98.34.212.76,352,17600,0,0,352,17600,0.000882000,1.8061
192.224.146.178,<->,133.178.226.55,0,0,348,513616,348,513616,0.894363000,0.1081
220.28.73.211,<->,136.25.188.213,0,0,346,487826,346,487826,0.114364000,1.3751
110.63.236.92,<->,92.27.219.40,0,0,345,502896,345,502896,0.003593000,1.9846
17.15.182.172,<->,8.220.239.104,0,0,340,18856,340,18856,0.141131000,1.8532
215.158.140.179,<->,100.162.203.46,340,17000,0,0,340,17000,0.003330000,1.9862
215.158.238.45,<->,102.90.204.214,337,18872,0,0,337,18872,0.000999000,1.9976
133.178.227.238,<->,111.52.90.173,336,18984,0,0,336,18984,0.019582000,1.9694
215.158.238.146,<->,100.120.38.6,334,423358,0,0,334,423358,0.084543000,1.8991
120.83.116.209,<->,89.183.104.156,0,0,333,463522,333,463522,0.006011000,1.9931
58.143.226.209,<->,8.252.221.237,0,0,331,16550,331,16550,0.124910000,0.7048
127.225.105.100,<->,100.92.156.116,0,0,327,484893,327,484893,0.625082000,1.3046
210.137.136.58,<->,144.85.170.246,0,0,326,18256,326,18256,0.105159000,1.8839
227.229.196.216,<->,92.168.217.196,0,0,326,18256,326,18256,0.072186000,1.2633
130.6.43.35,<->,92.27.27.150,0,0,326,455096,326,455096,0.051621000,1.8502
156.151.244.73,<->,8.252.221.220,0,0,324,18144,324,18144,0.174422000,0.3481
220.28.73.211,<->,215.158.238.201,0,0,324,435522,324,435522,0.030717000,1.8252
215.158.238.145,<->,100.216.78.145,322,408374,0,0,322,408374,0.005085000,1.9477
92.168.217.197,<->,74.253.54.147,321,16050,0,0,321,16050,0.014932000,1.9833
22.36.17.171,<->,8.182.227.71,0,0,320,18800,320,18800,1.574187000,0.4211
215.158.238.152,<->,100.120.38.6,320,401558,0,0,320,401558,0.010216000,1.9351
235.4.166.141,<->,8.43.213.64,0,0,320,16000,320,16000,0.001024000,1.3958
252.98.139.157,<->,137.39.55.59,318,457238,0,0,318,457238,1.006802000,0.9830
68.73.42.160,<->,8.252.221.221,0,0,315,23774,315,23774,0.590492000,1.3312
211.184.151.86,<->,8.252.221.230,0,0,310,18160,310,18160,0.113644000,1.7849
215.158.238.197,<->,154.183.124.180,309,21660,0,0,309,21660,0.102024000,1.7886
220.28.114.28,<->,133.178.227.29,0,0,309,427042,309,427042,0.011103000,1.3106
215.158.23.60,<->,94.110.153.218,308,457478,0,0,308,457478,0.021950000,1.9684
152.44.249.112,<->,133.54.43.53,0,0,308,18208,308,18208,0.015562000,1.9752
66.63.105.121,<->,8.252.221.222,0,0,308,17248,308,17248,0.003423000,0.5797
129.236.114.39,<->,33.233.141.10,0,0,307,435262,307,435262,0.124070000,0.0470
92.168.217.229,<->,29.219.3.90,307,17718,0,0,307,17718,0.122445000,1.8245
215.158.23.28,<->,111.150.185.79,304,450503,0,0,304,450503,0.015959000,1.9476
220.28.85.14,<->,215.158.140.245,0,0,303,422282,303,422282,0.002046000,1.6776
133.178.227.52,<->,100.216.78.145,302,425622,0,0,302,425622,0.098917000,1.1637
144.93.125.48,<->,144.93.121.10,0,0,302,61408,302,61408,0.000280000,1.9890
127.128.203.248,<->,92.168.217.198,0,0,301,15705,301,15705,0.042312000,0.6979
220.28.73.211,<->,133.178.227.36,0,0,301,399140,301,399140,0.019740000,1.9080
99.72.97.154,<->,89.155.205.212,300,443210,0,0,300,443210,0.165153000,1.8179
144.93.121.50,<->,144.93.120.28,300,61200,0,0,300,61200,0.010245000,1.9865
126.236.92.152,<->,8.9.165.184,0,0,300,16800,300,16800,0.001551000,1.9958
144.93.125.38,<->,144.93.121.86,0,0,300,61200,300,61200,0.001312000,1.9960
220.28.85.14,<->,215.158.238.129,0,0,298,380386,298,380386,0.000352000,1.9339
92.168.217.204,<->,68.0.157.121,297,17113,0,0,297,17113,0.759063000,1.2330
100.174.4.83,<->,8.182.227.71,0,0,297,20041,297,20041,0.193238000,1.8040
43.52.217.38,<->,8.252.221.230,0,0,297,22219,297,22219,0.041191000,1.8376
215.158.23.54,<->,120.154.225.199,297,436137,0,0,297,436137,0.018984000,1.9514
144.85.170.246,<->,98.87.146.231,295,17359,0,0,295,17359,0.540963000,1.4532
204.95.15.104,<->,50.223.3.228,0,0,293,14650,293,14650,0.000352000,1.9936
215.158.23.52,<->,126.219.102.69,290,430463,0,0,290,430463,0.037452000,1.9196
139.163.161.50,<->,136.25.188.201,0,0,287,402700,287,402700,0.607590000,1.2082
220.28.109.52,<->,136.25.188.166,0,0,285,398582,285,398582,0.204810000,1.7862
195.88.168.52,<->,80.40.19.83,0,0,284,14786,284,14786,0.037265000,1.9559
126.108.237.91,<->,92.168.217.253,0,0,283,17934,283,17934,0.316406000,1.6755
215.158.238.128,<->,98.219.126.175,282,389024,0,0,282,389024,0.096098000,1.8045
220.28.115.46,<->,133.178.227.45,0,0,282,368672,282,368672,0.013004000,1.8836
215.158.197.71,<->,133.178.226.214,0,0,281,17354,281,17354,0.715069000,1.0282
220.28.85.14,<->,215.158.238.101,0,0,281,375110,281,375110,0.050235000,1.9202
215.158.238.91,<->,100.216.78.145,280,401682,0,0,280,401682,0.441137000,0.4817
215.158.140.185,<->,56.51.205.138,280,16829,0,0,280,16829,0.285926000,0.4186
220.28.115.46,<->,215.158.238.246,0,0,280,375211,280,375211,0.196235000,1.8027
193.45.87.23,<->,192.67.144.51,0,0,280,14560,280,14560,0.008529000,1.9801
220.28.115.46,<->,215.158.238.145,0,0,277,373281,277,373281,0.035082000,1.9557
215.158.23.26,<->,113.23.111.152,276,410805,0,0,276,410805,0.013622000,1.9828
105.94.46.174,<->,92.168.217.225,0,0,275,16999,275,16999,0.040639000,1.8975
210.156.69.212,<->,202.227.161.108,274,375654,0,0,274,375654,0.085133000,1.8814
220.28.108.254,<->,215.158.238.70,0,0,274,363723,274,363723,0.059256000,1.8632
92.168.217.229,<->,50.136.164.18,274,15356,0,0,274,15356,0.002566000,1.6430
215.158.238.226,<->,69.31.238.155,272,15516,0,0,272,15516,0.211644000,1.4543
75.31.150.18,<->,8.252.223.106,0,0,271,15176,271,15176,0.017313000,1.9736
220.28.73.211,<->,215.158.238.147,0,0,270,343342,270,343342,0.017699000,1.9736
215.158.238.71,<->,98.219.126.140,269,354533,0,0,269,354533,0.235359000,1.7333
60.101.63.113,<->,8.252.221.197,0,0,269,19340,269,19340,0.021010000,1.9725
215.158.33.1,<->,133.178.226.95,0,0,266,391587,266,391587,0.949787000,0.9447
215.158.238.121,<->,93.156.41.103,266,16641,0,0,266,16641,0.855323000,1.1197
215.158.239.8,<->,68.231.18.93,266,399185,0,0,266,399185,0.043494000,0.2880
132.211.124.62,<->,92.26.149.204,264,14784,0,0,264,14784,0.839686000,1.0408
215.158.239.2,<->,96.135.154.146,264,362761,0,0,264,362761,0.076228000,1.1092
192.67.183.27,<->,148.54.19.75,264,13728,0,0,264,13728,0.000340000,1.6919
112.28.164.193,<->,92.168.217.181,0,0,263,15504,263,15504,0.919420000,0.6133
216.184.1.126,<->,136.25.188.245,0,0,263,354125,263,354125,0.336064000,1.6469
220.28.65.9,<->,133.178.227.8,0,0,262,339728,262,339728,0.041341000,1.9148
215.158.238.153,<->,98.219.126.140,257,334970,0,0,257,334970,0.017894000,1.9478
220.28.85.14,<->,215.158.140.81,0,0,256,341443,256,341443,0.417360000,1.5362
215.158.238.193,<->,56.100.165.51,255,378034,0,0,255,378034,0.052521000,1.7824
215.158.238.177,<->,29.211.6.106,254,16526,0,0,254,16526,0.213494000,1.7616
92.27.219.165,<->,67.240.216.233,254,124054,0,0,254,124054,0.008929000,1.9788
133.178.226.244,<->,97.28.132.56,253,196247,0,0,253,196247,0.585354000,0.0579
215.158.238.219,<->,56.100.165.44,253,379585,0,0,253,379585,0.436055000,0.0031
50.136.151.223,<->,8.20.87.246,0,0,253,14458,253,14458,0.360310000,1.6349
192.228.25.244,<->,133.178.226.196,0,0,252,374822,252,374822,0.143578000,1.7923
215.158.238.153,<->,98.219.126.175,252,333334,0,0,252,333334,0.097034000,1.8444
133.54.43.65,<->,117.21.132.72,252,12600,0,0,252,12600,0.000778000,0.5869
215.158.239.1,<->,215.158.127.140,251,369647,0,0,251,369647,0.907900000,0.9853
215.158.238.152,<->,98.219.126.175,251,339407,0,0,251,339407,0.087074000,1.8341
220.28.108.254,<->,215.158.238.85,0,0,251,327881,251,327881,0.029399000,1.9601
133.178.227.223,<->,80.47.152.63,251,258007,0,0,251,258007,0.000119000,1.9993
133.178.226.235,<->,8.47.189.87,250,373294,0,0,250,373294,0.248914000,1.3713
215.158.238.100,<->,98.219.126.175,250,324096,0,0,250,324096,0.034123000,1.8957
215.158.239.27,<->,96.135.154.115,249,351802,0,0,249,351802,0.741652000,1.1423
133.32.39.42,<->,97.120.97.20,249,13944,0,0,249,13944,0.039807000,1.9580
215.158.238.139,<->,98.219.126.175,248,327018,0,0,248,327018,0.073079000,1.7257
100.122.40.206,<->,8.182.227.71,0,0,248,12604,248,12604,0.013890000,1.9806
215.158.239.3,<->,215.158.58.200,247,355220,0,0,247,355220,0.097305000,1.4567
141.97.5.136,<->,133.54.43.55,0,0,246,14294,246,14294,0.141746000,1.8566
215.158.61.222,<->,99.74.26.216,0,0,246,358738,246,358738,0.103785000,1.8928
144.85.170.244,<->,98.87.146.40,246,17504,0,0,246,17504,0.078742000,1.9000
117.20.112.178,<->,89.183.104.229,0,0,246,192495,246,192495,0.008152000,1.9885
215.158.238.220,<->,113.207.62.36,244,14712,0,0,244,14712,1.141040000,0.6680
76.179.112.245,<->,8.252.221.204,0,0,244,14120,244,14120,0.117935000,1.7328
230.78.131.242,<->,8.9.165.191,0,0,243,14388,243,14388,0.276090000,1.6961
215.158.238.238,<->,112.235.18.28,242,18309,0,0,242,18309,0.348391000,0.5684
215.158.238.111,<->,100.120.38.6,242,315704,0,0,242,315704,0.032686000,1.4447
204.138.175.253,<->,8.252.222.178,0,0,242,13914,242,13914,0.030223000,1.9637
192.228.25.162,<->,133.178.226.201,0,0,240,358339,240,358339,0.429640000,1.5001
127.107.246.132,<->,92.168.217.173,0,0,240,13701,240,13701,0.224047000,1.7739
215.158.238.243,<->,35.17.217.34,240,13748,0,0,240,13748,0.069885000,1.7980
132.165.186.130,<->,92.162.253.47,0,0,240,338240,240,338240,0.026344000,1.9645
8.252.221.198,<->,4.133.79.158,240,16918,0,0,240,16918,0.008399000,1.9853
108.134.108.77,<->,106.157.38.242,239,11950,0,0,239,11950,0.102749000,1.7773
109.50.90.98,<->,8.182.248.147,0,0,239,11950,239,11950,0.002658000,0.3932
220.28.115.46,<->,215.158.238.71,0,0,238,316100,238,316100,0.015095000,1.7679
53.167.66.5,<->,48.53.202.113,0,0,238,15128,238,15128,0.002619000,1.9929
220.80.135.121,<->,124.58.170.224,236,354944,0,0,236,354944,0.028361000,1.9005
43.54.163.41,<->,8.252.221.222,0,0,235,16133,235,16133,0.426208000,1.4938
215.158.238.217,<->,98.219.126.140,235,312846,0,0,235,312846,0.033454000,1.9636
133.178.226.255,<->,17.128.69.208,233,183901,0,0,233,183901,1.057927000,0.9287
113.123.98.95,<->,92.168.217.244,0,0,233,13309,233,13309,0.082457000,0.8865
249.101.194.110,<->,122.228.233.173,233,12116,0,0,233,12116,0.034969000,1.9233
129.236.114.40,<->,111.20.168.12,0,0,231,346273,231,346273,0.273923000,0.0016
215.158.238.236,<->,29.211.4.150,231,12948,0,0,231,12948,0.036964000,0.8654
92.162.253.147,<->,42.105.214.217,230,345920,0,0,230,345920,0.069467000,1.7977
249.101.217.108,<->,193.34.14.177,230,337800,0,0,230,337800,0.069245000,1.7999
193.34.14.255,<->,111.147.113.114,0,0,230,337800,230,337800,0.048918000,1.9506
215.158.238.128,<->,98.219.126.140,230,311962,0,0,230,311962,0.041474000,1.7910
193.34.14.170,<->,80.40.56.251,0,0,230,340560,230,340560,0.013673000,1.8025
111.147.74.255,<->,53.232.229.106,229,342330,0,0,229,342330,0.006666000,1.9843
132.165.186.130,<->,92.162.252.174,0,0,228,321328,228,321328,0.083098000,1.8680
215.158.238.70,<->,98.219.126.140,228,299151,0,0,228,299151,0.074447000,1.9246
215.158.238.192,<->,100.216.78.145,228,316887,0,0,228,316887,0.025681000,0.7443
215.158.238.236,<->,33.209.210.244,227,13181,0,0,227,13181,1.035282000,0.4151
220.28.65.9,<->,133.178.227.52,0,0,227,292747,227,292747,0.067970000,1.8698
133.178.227.37,<->,100.216.78.145,225,294202,0,0,225,294202,0.053511000,1.8826
136.25.188.192,<->,98.219.126.140,224,302948,0,0,224,302948,0.123433000,1.3836
229.42.55.249,<->,92.27.219.203,0,0,224,312704,224,312704,0.018495000,1.9340
139.163.0.99,<->,110.198.96.234,223,12632,0,0,223,12632,0.284175000,1.7082
215.158.238.79,<->,98.219.126.175,223,301208,0,0,223,301208,0.031272000,1.9028
215.158.2.83,<->,108.39.227.100,0,0,223,127613,223,127613,0.007995000,1.9805
112.81.1.224,<->,92.168.217.209,0,0,223,12488,223,12488,0.003721000,1.0080
111.20.172.119,<->,111.20.168.156,0,0,221,329791,221,329791,1.007122000,0.8261
111.20.172.119,<->,33.233.141.95,0,0,221,329730,221,329730,0.310814000,0.9216
220.28.73.211,<->,133.178.227.63,0,0,220,304856,220,304856,0.199415000,1.7653
112.24.223.71,<->,92.168.217.229,0,0,219,12264,219,12264,0.058864000,1.8688
215.158.238.146,<->,0.195.237.14,218,312727,0,0,218,312727,0.392164000,0.6861
133.54.43.75,<->,106.219.64.22,216,12424,0,0,216,12424,0.015026000,1.6576
133.54.43.38,<->,112.15.4.244,215,11017,0,0,215,11017,0.002376000,1.9933
220.55.102.139,<->,220.28.109.110,214,10977,0,0,214,10977,0.429948000,0.3484
220.28.108.254,<->,215.158.238.137,0,0,214,277944,214,277944,0.041313000,1.9545
215.158.238.107,<->,126.219.246.74,213,11928,0,0,213,11928,0.273917000,0.8960
220.28.85.14,<->,215.158.238.152,0,0,213,283298,213,283298,0.069196000,1.6022
221.102.53.122,<->,109.0.210.141,0,0,210,314203,210,314203,0.216404000,1.7682
92.168.217.229,<->,37.110.59.199,210,12468,0,0,210,12468,0.004889000,1.9302
215.158.238.229,<->,98.219.126.140,209,288527,0,0,209,288527,0.003481000,1.4303
215.158.238.98,<->,98.249.65.10,207,11851,0,0,207,11851,0.573920000,0.6773
89.220.215.61,<->,80.42.213.194,0,0,207,19216,207,19216,0.007531000,1.9911
133.54.43.61,<->,117.23.147.95,207,12448,0,0,207,12448,0.005204000,1.9817
192.228.25.194,<->,133.178.226.212,0,0,206,308333,206,308333,0.290072000,1.5024
156.152.185.227,<->,8.252.222.110,0,0,206,15912,206,15912,0.098760000,1.8929
246.253.253.207,<->,204.42.61.33,206,60326,0,0,206,60326,0.007781000,1.8655
158.157.1.198,<->,133.54.43.80,0,0,205,10834,205,10834,1.088585000,0.8922
215.158.238.110,<->,98.219.126.140,205,274360,0,0,205,274360,0.289719000,1.3180
108.32.18.191,<->,89.183.104.136,0,0,205,28513,205,28513,0.010844000,1.9848
111.147.141.67,<->,76.72.21.156,204,13868,0,0,204,13868,0.012287000,1.4502
223.115.64.120,<->,8.252.221.230,0,0,203,12272,203,12272,0.068706000,1.8794
215.158.140.78,<->,215.158.58.202,202,275038,0,0,202,275038,0.896176000,0.8766
144.85.170.246,<->,98.87.124.55,202,12106,0,0,202,12106,0.602006000,0.2103
220.28.73.211,<->,215.158.238.109,0,0,202,261387,202,261387,0.011288000,1.9071
144.93.121.10,<->,113.171.246.29,202,25008,0,0,202,25008,0.001568000,1.9900
220.28.104.193,<->,215.158.238.117,0,0,201,271785,201,271785,0.297153000,1.6953
61.125.123.245,<->,8.252.221.198,0,0,201,12030,201,12030,0.021921000,0.8732
215.158.238.217,<->,215.158.58.203,201,298239,0,0,201,298239,0.021894000,0.2429
216.144.228.180,<->,215.158.140.179,0,0,201,10612,201,10612,0.015798000,1.4527
144.93.125.37,<->,144.93.121.10,0,0,201,40904,201,40904,0.009032000,1.9800
159.213.211.219,<->,144.95.104.75,201,10050,0,0,201,10050,0.007791000,1.9810
113.128.235.10,<->,92.168.217.228,0,0,200,11888,200,11888,0.025168000,1.9656
220.14.74.198,<->,35.56.98.184,0,0,200,40800,200,40800,0.002321000,1.9879
119.255.203.35,<->,89.183.104.172,0,0,200,11143,200,11143,0.000684000,1.9114
218.4.164.231,<->,97.110.90.219,199,244694,0,0,199,244694,0.835139000,0.6760
123.119.26.157,<->,89.183.104.168,0,0,199,12328,199,12328,0.047764000,1.8839
215.158.238.71,<->,100.120.38.6,199,267510,0,0,199,267510,0.018670000,1.8189
111.147.195.158,<->,97.110.90.234,198,260494,0,0,198,260494,0.431169000,1.5620
117.18.226.85,<->,92.27.219.151,0,0,198,288684,198,288684,0.099355000,1.8940
220.28.115.46,<->,215.158.238.124,0,0,198,255926,198,255926,0.034181000,1.7649
133.32.39.42,<->,50.53.153.255,197,9850,0,0,197,9850,0.039719000,1.9023
136.25.188.246,<->,100.224.202.187,197,268987,0,0,197,268987,0.030584000,1.6098
220.28.85.14,<->,215.158.238.128,0,0,196,263696,196,263696,0.044348000,1.9243
133.178.226.72,<->,98.219.126.140,194,265604,0,0,194,265604,0.783018000,0.7064
6.227.42.237,<->,0.195.210.33,0,0,194,9700,194,9700,0.319034000,1.5138
216.184.2.32,<->,8.252.222.169,0,0,194,257724,194,257724,0.167891000,1.7962
215.158.61.221,<->,8.252.221.166,0,0,194,288566,194,288566,0.097557000,0.1191
220.28.108.254,<->,215.158.238.146,0,0,193,258004,193,258004,0.190133000,1.6746
149.229.108.170,<->,0.195.210.33,0,0,193,12298,193,12298,0.040829000,1.4357
220.28.85.14,<->,215.158.238.137,0,0,192,249542,192,249542,0.173736000,1.8063
133.178.226.80,<->,8.191.14.26,192,13771,0,0,192,13771,0.002376000,1.9521
230.102.130.12,<->,133.178.227.215,0,0,191,108620,191,108620,0.002217000,1.9738
220.28.73.211,<->,215.158.140.249,0,0,190,244384,190,244384,0.007356000,1.9854
139.69.162.20,<->,8.252.222.168,0,0,189,250389,189,250389,0.045756000,1.9489
123.129.29.204,<->,33.233.141.46,0,0,189,225676,189,225676,0.028642000,1.8128
215.158.238.129,<->,100.120.38.6,188,242187,0,0,188,242187,0.372050000,1.5732
111.147.65.245,<->,76.15.3.35,188,97500,0,0,188,97500,0.057234000,1.9394
111.151.237.12,<->,50.224.105.38,0,0,187,276663,187,276663,0.041263000,0.2758
215.158.140.225,<->,100.216.78.145,187,243900,0,0,187,243900,0.039180000,1.9143
145.176.194.189,<->,0.195.210.33,0,0,187,9350,187,9350,0.024405000,1.8946
215.158.23.33,<->,69.132.194.106,187,278848,0,0,187,278848,0.004608000,1.9674
136.138.112.192,<->,136.25.189.57,0,0,186,12070,186,12070,1.501338000,0.4979
159.237.225.83,<->,103.150.193.74,186,244238,0,0,186,244238,0.485048000,1.3053
89.183.104.231,<->,33.57.74.172,186,199817,0,0,186,199817,0.003270000,1.9929
215.158.30.165,<->,8.252.222.145,0,0,185,244664,185,244664,0.195668000,1.6181
100.214.108.163,<->,8.222.6.141,185,278240,0,0,185,278240,0.100860000,1.8786
138.126.75.69,<->,133.178.226.212,0,0,185,10360,185,10360,0.012640000,0.2389
144.87.238.89,<->,8.182.253.100,0,0,185,19322,185,19322,0.012496000,1.9855
136.25.188.170,<->,80.57.208.108,184,243527,0,0,184,243527,0.215827000,1.7380
220.28.114.28,<->,215.158.238.253,0,0,183,255567,183,255567,0.240597000,1.0446
43.53.54.219,<->,8.252.222.199,0,0,183,13804,183,13804,0.095153000,1.8460
215.158.238.68,<->,100.120.38.6,183,230980,0,0,183,230980,0.045609000,1.9521
215.158.238.40,<->,100.120.38.6,183,253965,0,0,183,253965,0.040152000,1.9597
99.75.168.172,<->,33.250.123.50,183,273416,0,0,183,273416,0.025785000,1.9365
220.28.108.254,<->,133.178.227.6,0,0,182,255097,182,255097,0.118927000,1.5970
144.85.170.246,<->,98.87.145.167,182,10192,0,0,182,10192,0.035239000,1.0201
112.178.178.127,<->,80.41.20.85,0,0,182,84657,182,84657,0.006908000,1.8736
215.158.239.21,<->,84.200.126.146,181,268300,0,0,181,268300,0.295185000,1.5726
247.136.236.16,<->,22.249.199.122,181,241588,0,0,181,241588,0.078195000,0.8250
111.20.172.119,<->,111.20.168.9,0,0,181,269505,181,269505,0.075804000,1.7853
133.178.227.145,<->,50.51.22.133,180,35192,0,0,180,35192,0.153834000,0.8538
215.158.238.144,<->,98.219.126.140,180,235009,0,0,180,235009,0.058986000,1.6033
123.129.29.205,<->,33.233.141.106,0,0,179,198306,179,198306,0.124120000,1.8120
111.150.207.183,<->,99.74.26.147,0,0,178,9968,178,9968,0.547309000,0.7902
215.158.238.146,<->,98.219.126.140,178,233741,0,0,178,233741,0.079754000,1.9022
220.28.115.46,<->,215.158.140.246,0,0,178,237437,178,237437,0.019494000,1.7592
199.15.215.35,<->,136.25.188.252,0,0,178,9782,178,9782,0.008452000,0.7650
215.158.238.153,<->,100.216.78.145,177,236804,0,0,177,236804,0.462145000,1.4956
133.178.226.84,<->,98.219.126.140,177,246093,0,0,177,246093,0.145842000,1.8085
207.218.169.109,<->,50.223.3.228,0,0,177,9912,177,9912,0.019179000,1.9782
123.34.158.243,<->,35.56.96.143,0,0,177,51866,177,51866,0.016799000,1.9411
210.220.219.182,<->,53.200.149.3,176,242783,0,0,176,242783,0.494848000,1.0142
192.64.222.153,<->,22.249.18.74,176,259499,0,0,176,259499,0.408390000,1.5204
199.6.231.137,<->,50.223.3.228,0,0,175,8750,175,8750,0.007571000,1.9871
215.158.238.102,<->,100.216.78.145,174,222177,0,0,174,222177,0.143580000,1.8033
8.252.223.64,<->,8.40.22.175,174,9744,0,0,174,9744,0.014173000,1.9584
220.28.114.28,<->,215.158.238.103,0,0,173,229307,173,229307,0.099879000,1.8824
215.158.140.179,<->,130.101.149.241,173,9688,0,0,173,9688,0.019781000,1.9587
198.43.254.51,<->,100.95.198.6,0,0,172,247964,172,247964,0.817795000,1.1670
212.118.51.50,<->,8.52.185.118,0,0,172,10837,172,10837,0.780021000,0.8849
215.158.238.97,<->,113.23.66.212,172,11205,0,0,172,11205,0.416209000,0.4688
114.74.11.114,<->,56.121.49.236,0,0,172,222592,172,222592,0.030899000,1.9665
220.28.115.46,<->,133.178.227.60,0,0,171,238330,171,238330,0.658684000,0.8600
123.129.29.200,<->,33.233.141.46,0,0,171,196563,171,196563,0.051071000,1.8998
220.28.109.52,<->,136.25.188.214,0,0,171,227612,171,227612,0.008352000,1.5252
227.229.33.126,<->,92.168.217.141,0,0,171,9882,171,9882,0.000695000,1.9982
246.253.198.51,<->,113.56.138.223,170,8500,0,0,170,8500,0.025603000,1.9722
114.193.59.188,<->,92.27.27.187,0,0,170,33042,170,33042,0.004065000,1.9924
215.158.140.172,<->,131.36.66.69,169,10690,0,0,169,10690,0.094484000,1.7297
139.161.104.139,<->,133.178.226.200,0,0,169,10170,169,10170,0.087638000,0.1412
195.0.161.140,<->,50.223.3.228,0,0,169,9464,169,9464,0.008629000,1.9904
220.28.73.211,<->,133.178.226.67,0,0,168,230308,168,230308,0.038975000,1.7521
242.6.91.85,<->,136.25.189.34,0,0,167,10875,167,10875,0.623266000,0.2556
127.128.173.13,<->,92.168.217.245,0,0,167,9352,167,9352,0.087385000,0.7502
215.158.238.79,<->,100.120.38.6,166,201022,0,0,166,201022,0.224892000,1.6930
220.28.109.52,<->,136.25.188.212,0,0,166,217758,166,217758,0.114384000,1.8403
136.25.189.41,<->,96.156.169.219,165,221129,0,0,165,221129,0.153153000,1.6113
215.158.238.68,<->,100.216.78.145,165,218556,0,0,165,218556,0.109633000,1.8261
243.156.114.200,<->,92.27.27.151,0,0,165,8580,165,8580,0.002802000,1.8734
250.108.31.20,<->,8.252.222.115,0,0,164,10288,164,10288,0.056494000,1.6913
249.101.104.134,<->,139.165.148.255,164,37716,0,0,164,37716,0.013507000,1.9798
133.178.227.229,<->,100.224.132.152,163,9166,0,0,163,9166,0.337035000,0.4593
220.28.65.9,<->,215.158.238.215,0,0,163,221680,163,221680,0.080333000,1.8221
123.129.29.200,<->,33.233.141.118,0,0,163,188748,163,188748,0.068363000,1.9211
215.158.140.57,<->,100.216.78.145,163,218010,0,0,163,218010,0.002616000,1.9299
220.55.105.19,<->,105.84.90.160,163,8518,0,0,163,8518,0.001032000,1.9678
215.158.140.177,<->,113.207.62.36,162,10409,0,0,162,10409,1.152228000,0.5285
246.253.234.255,<->,33.209.218.84,162,15806,0,0,162,15806,0.205413000,1.7235
220.28.65.9,<->,215.158.238.130,0,0,162,212606,162,212606,0.050776000,1.8944
117.43.152.165,<->,8.9.165.165,0,0,161,11116,161,11116,0.928732000,1.0636
133.178.227.66,<->,8.3.103.112,161,10088,0,0,161,10088,0.002146000,0.3492
215.158.238.77,<->,100.120.38.6,160,208389,0,0,160,208389,0.154241000,1.6825
192.67.131.111,<->,8.55.143.211,160,202802,0,0,160,202802,0.050546000,1.9475
215.158.238.199,<->,29.214.73.193,159,9629,0,0,159,9629,1.313180000,0.6605
126.235.111.179,<->,92.168.217.240,0,0,159,8904,159,8904,0.084272000,1.8984
215.158.238.212,<->,129.80.130.60,158,218874,0,0,158,218874,0.918877000,0.0566
215.158.239.3,<->,215.158.127.155,158,195726,0,0,158,195726,0.084141000,1.7697
215.158.238.131,<->,100.216.78.145,157,206252,0,0,157,206252,0.058252000,1.4044
144.94.162.244,<->,0.195.210.33,0,0,157,9065,157,9065,0.008552000,1.9435
133.54.43.82,<->,122.129.6.152,156,8453,0,0,156,8453,0.353716000,0.7958
215.158.238.147,<->,100.120.38.6,156,186102,0,0,156,186102,0.099794000,1.7028
215.158.238.117,<->,100.120.38.6,156,185970,0,0,156,185970,0.031098000,1.6779
93.181.154.90,<->,92.27.27.171,0,0,156,74856,156,74856,0.025135000,1.9734
192.64.197.124,<->,8.55.143.211,155,209760,0,0,155,209760,1.469217000,0.5131
133.54.43.53,<->,33.15.205.222,155,8419,0,0,155,8419,0.433027000,1.0839
220.28.114.28,<->,215.158.238.152,0,0,155,199289,155,199289,0.116307000,1.8314
215.158.238.87,<->,100.216.78.145,155,210152,0,0,155,210152,0.043793000,1.4408
144.71.47.61,<->,57.212.47.28,155,7750,0,0,155,7750,0.036957000,0.7187
133.178.227.10,<->,131.141.219.100,154,117739,0,0,154,117739,0.579012000,1.2828
215.158.140.207,<->,6.228.239.25,154,10194,0,0,154,10194,0.031124000,1.9653
117.0.107.131,<->,92.168.217.228,0,0,153,9048,153,9048,1.213661000,0.7860
215.158.140.206,<->,99.74.26.217,153,10458,0,0,153,10458,0.046052000,1.6533
139.163.96.127,<->,105.97.132.175,153,8328,0,0,153,8328,0.016001000,1.9656
144.75.218.242,<->,8.222.218.199,152,18484,0,0,152,18484,0.043182000,1.9548
221.196.123.21,<->,136.25.188.209,0,0,151,8690,151,8690,0.572910000,1.2688
136.25.188.166,<->,100.224.202.176,151,194993,0,0,151,194993,0.439879000,1.5182
245.244.217.253,<->,8.252.222.199,0,0,151,7550,151,7550,0.005066000,1.9816
215.158.239.205,<->,113.23.83.65,150,212624,0,0,150,212624,1.362969000,0.3564
129.236.114.39,<->,101.224.89.156,0,0,150,154322,150,154322,0.180542000,1.1188
215.158.239.61,<->,8.222.48.115,150,190685,0,0,150,190685,0.025240000,1.5807
215.158.30.187,<->,8.252.222.57,0,0,149,205579,149,205579,0.480856000,0.9924
215.158.238.220,<->,58.169.54.154,148,12705,0,0,148,12705,0.590030000,1.3800
129.236.73.9,<->,33.233.141.32,0,0,148,93081,148,93081,0.306119000,1.6914
93.149.28.231,<->,92.27.27.177,0,0,147,203932,147,203932,0.036154000,1.9344
219.248.162.7,<->,8.252.222.223,0,0,146,7300,146,7300,0.147247000,1.8316
220.28.115.46,<->,215.158.238.68,0,0,146,189502,146,189502,0.062966000,1.0858
220.28.73.211,<->,215.158.238.117,0,0,146,188953,146,188953,0.008919000,1.4837
145.189.24.252,<->,8.52.185.143,0,0,145,8434,145,8434,0.011250000,1.8178
98.101.92.196,<->,8.182.248.147,0,0,145,8120,145,8120,0.001483000,0.1614
133.178.226.199,<->,8.47.189.28,144,213970,0,0,144,213970,0.248310000,1.6899
220.28.73.211,<->,215.158.238.131,0,0,144,183866,144,183866,0.053968000,1.9443
133.178.226.84,<->,100.120.38.6,144,189687,0,0,144,189687,0.044520000,1.7472
220.28.114.28,<->,215.158.238.186,0,0,144,194624,144,194624,0.020455000,1.9162
223.136.228.181,<->,89.183.104.157,0,0,144,8390,144,8390,0.014046000,1.7526
136.18.9.244,<->,8.182.248.147,0,0,144,7200,144,7200,0.000226000,1.4856
92.168.217.253,<->,50.136.172.227,143,9801,0,0,143,9801,0.375587000,1.6068
215.158.239.25,<->,96.135.154.105,143,181209,0,0,143,181209,0.301377000,1.4231
220.28.85.14,<->,215.158.238.110,0,0,143,182046,143,182046,0.075720000,1.9125
133.54.43.51,<->,93.135.97.57,143,8610,0,0,143,8610,0.018958000,1.9741
139.163.34.3,<->,103.0.70.163,143,8510,0,0,143,8510,0.014289000,1.8652
98.129.85.115,<->,57.62.248.124,143,7972,0,0,143,7972,0.004746000,1.8248
220.28.104.193,<->,133.178.227.39,0,0,142,199799,142,199799,1.143848000,0.5925
159.108.77.35,<->,139.249.88.21,0,0,142,53094,142,53094,0.281171000,1.7030
201.194.181.151,<->,89.183.104.144,0,0,142,197777,142,197777,0.135769000,1.7476
239.66.241.243,<->,97.126.113.29,0,0,142,50909,142,50909,0.046834000,1.9250
102.83.132.100,<->,89.183.104.231,0,0,142,196880,142,196880,0.036616000,1.9511
200.175.199.11,<->,53.167.3.63,142,9377,0,0,142,9377,0.023079000,1.4638
104.81.132.140,<->,92.27.219.195,0,0,142,8161,142,8161,0.015562000,1.9696
89.183.104.184,<->,48.108.92.249,142,7472,0,0,142,7472,0.004887000,1.9779
215.158.239.92,<->,196.95.49.18,141,8664,0,0,141,8664,0.092229000,1.8879
58.51.3.105,<->,8.252.222.4,0,0,141,8692,141,8692,0.043826000,1.8945
136.25.189.130,<->,99.127.114.35,141,7901,0,0,141,7901,0.001758000,0.1893
100.230.43.160,<->,50.224.72.162,0,0,140,17668,140,17668,0.658485000,1.3318
61.125.128.243,<->,8.252.222.71,0,0,140,9080,140,9080,0.078642000,1.9106
215.158.238.188,<->,131.36.105.41,140,9488,0,0,140,9488,0.048436000,0.2965
133.178.226.21,<->,100.120.38.6,140,177616,0,0,140,177616,0.038599000,1.8300
215.158.238.200,<->,215.158.33.123,139,207913,0,0,139,207913,0.764720000,0.0181
216.184.2.64,<->,8.252.222.137,0,0,139,196718,139,196718,0.095786000,0.8170
133.178.226.43,<->,100.120.38.6,139,168975,0,0,139,168975,0.054589000,1.9173
139.163.96.93,<->,57.0.121.217,139,7253,0,0,139,7253,0.048646000,1.5667
215.158.238.117,<->,98.219.126.175,139,175978,0,0,139,175978,0.045300000,1.9056
93.181.154.21,<->,92.27.219.193,0,0,139,9390,139,9390,0.003023000,1.9002
99.181.53.171,<->,8.52.240.121,0,0,138,41474,138,41474,0.329295000,1.3208
133.54.43.82,<->,117.13.88.12,138,8301,0,0,138,8301,0.272852000,1.6069
215.158.238.123,<->,99.192.168.162,138,13016,0,0,138,13016,0.270980000,1.3207
66.35.133.188,<->,8.252.221.220,0,0,138,6900,138,6900,0.053035000,1.8848
196.119.218.167,<->,50.223.3.228,0,0,138,6900,138,6900,0.022678000,1.8845
92.168.217.254,<->,50.136.154.212,138,8563,0,0,138,8563,0.011909000,1.9420
215.158.238.87,<->,98.219.126.140,138,189867,0,0,138,189867,0.011244000,1.8425
204.200.19.110,<->,0.195.210.8,0,0,137,7672,137,7672,0.397683000,0.8582
139.114.131.88,<->,8.182.239.159,0,0,137,11925,137,11925,0.175441000,1.8197
159.215.65.184,<->,136.25.188.202,0,0,137,172752,137,172752,0.090848000,1.8730
111.147.200.132,<->,53.231.73.49,137,178648,0,0,137,178648,0.030617000,1.9155
215.158.238.95,<->,212.70.75.121,137,11532,0,0,137,11532,0.013912000,1.7993
215.158.66.194,<->,133.178.227.207,0,0,137,54590,137,54590,0.007284000,1.9913
200.175.245.4,<->,53.167.66.5,137,8772,0,0,137,8772,0.001719000,1.8915
159.137.189.229,<->,27.150.102.249,136,8013,0,0,136,8013,0.512428000,0.6888
61.61.149.222,<->,8.252.221.198,0,0,136,6800,136,6800,0.048586000,1.9274
79.62.71.170,<->,17.120.104.223,0,0,136,70912,136,70912,0.030368000,1.9528
159.23.224.190,<->,73.80.222.209,136,192084,0,0,136,192084,0.023352000,1.2104
116.95.238.231,<->,80.40.57.96,0,0,136,169992,136,169992,0.010243000,1.9735
215.158.238.130,<->,98.219.126.175,136,180362,0,0,136,180362,0.007599000,1.9304
220.28.85.14,<->,215.158.238.76,0,0,135,178867,135,178867,0.407805000,1.4958
138.98.230.76,<->,110.27.240.153,135,7560,0,0,135,7560,0.229764000,1.6182
215.158.239.96,<->,195.80.39.73,135,9309,0,0,135,9309,0.132805000,1.4094
76.179.97.77,<->,8.252.222.109,0,0,135,8340,135,8340,0.008797000,1.8293
223.138.187.12,<->,89.183.104.242,0,0,135,168076,135,168076,0.005395000,1.9921
92.168.217.215,<->,88.4.240.85,135,7560,0,0,135,7560,0.004709000,1.0369
136.25.188.169,<->,96.155.61.28,135,173612,0,0,135,173612,0.003619000,1.7903
92.168.217.248,<->,88.2.69.116,135,7560,0,0,135,7560,0.001704000,1.8798
144.87.238.89,<->,8.182.241.94,0,0,134,7800,134,7800,1.146203000,0.8219
215.158.238.113,<->,131.36.105.37,134,9294,0,0,134,9294,0.823874000,1.1740
215.158.239.75,<->,111.52.91.196,134,185304,0,0,134,185304,0.340677000,1.6305
220.28.73.211,<->,215.158.238.86,0,0,134,174432,134,174432,0.011069000,1.7601
215.158.238.109,<->,98.219.126.140,134,181259,0,0,134,181259,0.007412000,1.6247
80.38.62.184,<->,37.48.133.102,133,7679,0,0,133,7679,0.575227000,1.0569
139.69.162.56,<->,8.252.222.43,0,0,133,178296,133,178296,0.441087000,1.4926
215.158.30.229,<->,8.252.222.59,0,0,133,148268,133,148268,0.166711000,1.7804
215.158.239.19,<->,139.1.221.230,133,7448,0,0,133,7448,0.007512000,1.9877
124.46.191.127,<->,92.162.252.81,0,0,133,196350,133,196350,0.001673000,0.5889
215.158.238.219,<->,98.219.126.140,132,171190,0,0,132,171190,0.054210000,1.8064
199.21.165.238,<->,8.182.248.147,0,0,132,6842,132,6842,0.022084000,1.9750
220.28.85.14,<->,133.178.226.72,0,0,131,172545,131,172545,0.405486000,1.5859
220.55.109.168,<->,220.28.110.136,131,7624,0,0,131,7624,0.237801000,0.3327
133.178.227.73,<->,98.219.126.175,131,187574,0,0,131,187574,0.049388000,1.8296
136.25.188.230,<->,80.57.141.163,131,166164,0,0,131,166164,0.012423000,1.9858
111.151.139.139,<->,8.252.221.89,0,0,131,128147,131,128147,0.009239000,1.9664
215.158.238.108,<->,100.120.38.6,131,168452,0,0,131,168452,0.006765000,1.7545
92.168.217.253,<->,50.136.181.51,131,7624,0,0,131,7624,0.006103000,1.9657
139.69.162.39,<->,136.25.188.170,0,0,130,180171,130,180171,0.327187000,1.2614
215.158.238.247,<->,98.219.126.140,130,176655,0,0,130,176655,0.275491000,1.6739
220.28.73.211,<->,215.158.238.217,0,0,130,173489,130,173489,0.120892000,1.7944
215.158.238.136,<->,98.219.126.175,130,176494,0,0,130,176494,0.053355000,1.9435
216.184.1.115,<->,136.25.188.164,0,0,130,160111,130,160111,0.028162000,1.9129
220.28.85.14,<->,215.158.238.138,0,0,129,168787,129,168787,0.285520000,1.3513
139.163.161.19,<->,136.25.188.219,0,0,129,167510,129,167510,0.018393000,1.9673
92.168.217.253,<->,50.136.128.47,129,7995,0,0,129,7995,0.012880000,1.9817
248.225.27.2,<->,53.231.73.29,129,190404,0,0,129,190404,0.011708000,1.9325
220.28.115.46,<->,133.178.227.22,0,0,129,169333,129,169333,0.003989000,1.8222
138.37.223.61,<->,8.182.227.5,0,0,128,8003,128,8003,0.772173000,0.9968
215.188.8.186,<->,215.158.239.194,0,0,128,149189,128,149189,0.513679000,1.3687
214.237.183.201,<->,0.195.210.46,0,0,128,182128,128,182128,0.408060000,1.4844
220.28.73.211,<->,215.158.140.251,0,0,128,173067,128,173067,0.111969000,1.0625
101.87.213.152,<->,100.228.42.117,0,0,128,26082,128,26082,0.012227000,1.9182
109.222.219.127,<->,50.182.187.249,128,6704,0,0,128,6704,0.010013000,1.9703
220.28.85.14,<->,133.178.227.7,0,0,128,153686,128,153686,0.003676000,1.8528
133.178.227.51,<->,56.1.237.37,127,10312,0,0,127,10312,0.725361000,0.8038
216.184.1.112,<->,8.252.222.169,0,0,127,138178,127,138178,0.200406000,1.7772
215.158.238.122,<->,116.99.180.181,127,7112,0,0,127,7112,0.099154000,0.4398
215.158.239.21,<->,215.158.127.147,127,181022,0,0,127,181022,0.082730000,0.7126
133.178.227.14,<->,8.241.237.161,127,9594,0,0,127,9594,0.059291000,1.9010
141.37.44.96,<->,89.183.104.251,0,0,127,186690,127,186690,0.007375000,1.9632
144.85.170.254,<->,111.2.132.128,126,7284,0,0,126,7284,1.640007000,0.3565
139.5.114.123,<->,136.25.188.195,0,0,126,163676,126,163676,0.846660000,1.0826
215.158.238.188,<->,122.158.245.43,126,10535,0,0,126,10535,0.637843000,1.1729
220.28.104.193,<->,215.158.238.70,0,0,126,175788,126,175788,0.403700000,1.4745
220.28.108.254,<->,215.158.238.233,0,0,126,174192,126,174192,0.247255000,1.3325
199.86.122.136,<->,108.134.106.92,0,0,126,150671,126,150671,0.109976000,1.8674
215.158.238.103,<->,100.216.78.145,126,163744,0,0,126,163744,0.042643000,1.1531
127.255.92.200,<->,80.41.42.142,0,0,126,176904,126,176904,0.004637000,1.9936
192.64.200.221,<->,35.56.30.5,125,12558,0,0,125,12558,0.001173000,1.9918
120.46.145.208,<->,8.9.165.184,0,0,125,6394,125,6394,0.000261000,1.9949
48.18.147.158,<->,8.252.221.197,0,0,124,9818,124,9818,0.898416000,1.0556
215.158.140.247,<->,98.219.126.175,124,174085,0,0,124,174085,0.293277000,0.9940
215.158.239.204,<->,192.224.146.69,124,176631,0,0,124,176631,0.279234000,0.1715
220.28.85.14,<->,215.158.238.108,0,0,124,166630,124,166630,0.056807000,1.1913
215.158.239.50,<->,199.121.96.211,124,6206,0,0,124,6206,0.032426000,1.8447
8.252.222.68,<->,4.122.55.105,124,7868,0,0,124,7868,0.002361000,1.9846
136.25.188.41,<->,112.105.203.101,123,166168,0,0,123,166168,1.533709000,0.4268
215.158.140.172,<->,8.190.216.244,123,8664,0,0,123,8664,0.882187000,0.5981
111.20.172.118,<->,101.224.89.228,0,0,123,175212,123,175212,0.469406000,1.5149
133.178.226.173,<->,84.18.223.130,123,179211,0,0,123,179211,0.019485000,1.9333
220.28.114.28,<->,215.158.238.137,0,0,123,160579,123,160579,0.012553000,1.7185
133.178.227.28,<->,133.56.180.94,123,142691,0,0,123,142691,0.005134000,1.8475
215.158.238.125,<->,0.195.253.228,123,167848,0,0,123,167848,0.002498000,1.8185
58.202.119.87,<->,8.252.221.198,0,0,122,8312,122,8312,0.870176000,1.0480
215.158.30.187,<->,8.252.222.131,0,0,122,147744,122,147744,0.270361000,1.6139
220.28.114.28,<->,215.158.238.41,0,0,122,159364,122,159364,0.173735000,1.7179
136.114.101.11,<->,136.25.188.202,0,0,122,151071,122,151071,0.124184000,1.8649
159.215.65.180,<->,136.25.188.202,0,0,122,157077,122,157077,0.051936000,1.9065
143.76.129.219,<->,8.182.248.147,0,0,122,6316,122,6316,0.007023000,1.9871
136.25.188.233,<->,100.224.202.187,121,152329,0,0,121,152329,0.744418000,1.2237
220.28.108.254,<->,215.158.238.139,0,0,121,155491,121,155491,0.279384000,1.6996
210.137.205.233,<->,144.85.170.246,0,0,121,6776,121,6776,0.201018000,0.1305
231.142.143.107,<->,215.158.239.48,0,0,121,7631,121,7631,0.076426000,1.6659
255.17.29.136,<->,8.220.205.146,0,0,121,42265,121,42265,0.052906000,1.9087
215.158.239.88,<->,8.222.48.140,120,159168,0,0,120,159168,0.132557000,1.8403
206.248.77.125,<->,109.222.209.181,0,0,120,171520,120,171520,0.107554000,1.7583
92.27.27.165,<->,8.229.117.238,120,93889,0,0,120,93889,0.081566000,1.8529
247.136.242.29,<->,221.102.56.46,120,170116,0,0,120,170116,0.071348000,1.7131
133.54.43.63,<->,0.244.152.178,120,6000,0,0,120,6000,0.065534000,1.8696
136.25.188.247,<->,97.174.232.226,120,153271,0,0,120,153271,0.064595000,1.7755
136.25.188.167,<->,100.224.166.161,120,152400,0,0,120,152400,0.055451000,1.6136
215.158.238.139,<->,100.120.38.6,120,159660,0,0,120,159660,0.022396000,1.9338
148.141.174.148,<->,35.56.97.156,0,0,120,10560,120,10560,0.012461000,1.9820
112.151.85.120,<->,35.56.97.124,0,0,120,7110,120,7110,0.009325000,1.9808
246.253.253.97,<->,8.20.81.30,120,159268,0,0,120,159268,0.006849000,1.4201
220.28.73.211,<->,215.158.238.76,0,0,119,153086,119,153086,1.165266000,0.7724
136.25.188.202,<->,56.97.186.151,119,157293,0,0,119,157293,0.164190000,1.6105
89.183.110.45,<->,0.97.210.184,119,13916,0,0,119,13916,0.161798000,1.8315
207.200.195.226,<->,8.252.222.223,0,0,119,6064,119,6064,0.139042000,1.7837
220.28.108.254,<->,215.158.238.108,0,0,119,154712,119,154712,0.071212000,1.8336
157.142.173.165,<->,8.252.222.127,0,0,119,7300,119,7300,0.038330000,1.9331
159.215.65.139,<->,136.25.188.58,0,0,119,154141,119,154141,0.028685000,1.9651
220.28.65.9,<->,215.158.238.233,0,0,119,156691,119,156691,0.011696000,1.6317
220.28.73.211,<->,215.158.238.146,0,0,118,153590,118,153590,0.224199000,1.6115
146.224.48.149,<->,8.252.222.126,0,0,118,7720,118,7720,0.160080000,1.8156
220.28.108.254,<->,215.158.238.71,0,0,118,152310,118,152310,0.126464000,1.8397
215.158.238.209,<->,8.57.163.138,118,9324,0,0,118,9324,0.110998000,1.7433
92.161.83.172,<->,92.27.219.166,0,0,118,164492,118,164492,0.064254000,1.6119
98.11.192.230,<->,8.220.206.230,0,0,118,6348,118,6348,0.042241000,1.9550
220.28.85.14,<->,215.158.238.71,0,0,117,149129,117,149129,0.270844000,1.7250
121.215.68.28,<->,89.183.104.246,0,0,117,162064,117,162064,0.149739000,1.8262
210.221.107.50,<->,8.37.222.100,117,131653,0,0,117,131653,0.088906000,1.8069
136.25.188.56,<->,96.155.61.44,117,153112,0,0,117,153112,0.054932000,1.8530
220.28.114.28,<->,215.158.238.79,0,0,117,151294,117,151294,0.033198000,1.8084
48.19.203.141,<->,8.252.221.238,0,0,117,6624,117,6624,0.003079000,1.9789
136.25.188.235,<->,98.219.126.140,116,156380,0,0,116,156380,0.695252000,1.2941
215.158.238.109,<->,100.120.38.6,116,146576,0,0,116,146576,0.526522000,1.2047
139.161.104.215,<->,133.178.226.180,0,0,116,149403,116,149403,0.354612000,1.2577
118.215.113.160,<->,89.183.104.246,0,0,116,170520,116,170520,0.221087000,1.7345
215.158.238.145,<->,100.120.38.6,116,142211,0,0,116,142211,0.109465000,1.8730
220.28.115.46,<->,215.158.238.79,0,0,116,151388,116,151388,0.091005000,1.6436
215.158.239.8,<->,96.135.154.143,116,160085,0,0,116,160085,0.088333000,1.5850
92.27.219.203,<->,29.222.157.238,116,160947,0,0,116,160947,0.083376000,1.8886
215.158.140.79,<->,100.216.78.145,116,146726,0,0,116,146726,0.005193000,1.9037
192.64.192.90,<->,144.107.18.77,116,174000,0,0,116,174000,0.002181000,1.9942
230.102.130.25,<->,133.178.227.207,0,0,116,31102,116,31102,0.001072000,1.9597
215.158.238.138,<->,100.120.38.6,115,132630,0,0,115,132630,0.154783000,1.7913
195.89.52.197,<->,8.252.222.220,0,0,115,7163,115,7163,0.028634000,1.9431
254.210.93.43,<->,50.224.49.195,0,0,115,93124,115,93124,0.027318000,1.9025
226.68.196.217,<->,82.252.33.45,0,0,115,36396,115,36396,0.003846000,1.9796
89.183.104.141,<->,76.178.78.215,115,54959,0,0,115,54959,0.002944000,1.9715
220.28.73.211,<->,136.25.188.235,0,0,114,159948,114,159948,0.548212000,0.9770
92.168.217.206,<->,74.235.118.235,114,6384,0,0,114,6384,0.117126000,1.8106
246.108.106.235,<->,111.147.92.14,0,0,114,87589,114,87589,0.040416000,1.9480
215.158.238.118,<->,98.219.126.140,114,152181,0,0,114,152181,0.025679000,1.8936
48.106.42.75,<->,8.9.165.171,0,0,114,7833,114,7833,0.013209000,1.8765
105.104.5.199,<->,39.48.2.224,0,0,114,7036,114,7036,0.010138000,0.9405
92.168.217.222,<->,50.136.185.76,114,6904,0,0,114,6904,0.005109000,1.7597
133.32.39.45,<->,100.190.199.37,113,6458,0,0,113,6458,0.672454000,1.3252
133.178.227.21,<->,133.56.180.18,113,151730,0,0,113,151730,0.432756000,1.5595
220.28.115.46,<->,215.158.238.187,0,0,113,153805,113,153805,0.242858000,1.6956
8.252.222.109,<->,4.133.72.116,113,6952,0,0,113,6952,0.116553000,1.8145
136.25.189.42,<->,96.156.169.251,113,149015,0,0,113,149015,0.062798000,1.8887
92.27.219.139,<->,8.163.119.245,113,92614,0,0,113,92614,0.053491000,1.9401
133.178.227.30,<->,133.56.180.44,113,163410,0,0,113,163410,0.051918000,0.5918
215.158.238.100,<->,100.120.38.6,113,152400,0,0,113,152400,0.004729000,0.5387
215.158.239.89,<->,139.163.161.48,113,156201,0,0,113,156201,0.000580000,0.9317
142.227.61.239,<->,136.25.188.241,0,0,112,5887,112,5887,0.696650000,1.0502
220.28.114.28,<->,215.158.238.70,0,0,112,145532,112,145532,0.151145000,1.7542
159.215.65.169,<->,136.25.188.247,0,0,112,153025,112,153025,0.046331000,0.5559
76.75.132.217,<->,8.9.165.188,0,0,112,6968,112,6968,0.018488000,1.8598
246.45.208.172,<->,132.119.137.223,112,7236,0,0,112,7236,0.008554000,1.4989
220.28.104.193,<->,133.178.227.4,0,0,111,154914,111,154914,0.337519000,1.6320
133.178.226.33,<->,100.120.38.6,111,153962,0,0,111,153962,0.198975000,1.6206
215.158.239.63,<->,97.174.232.234,111,142835,0,0,111,142835,0.120651000,1.6611
196.113.48.219,<->,0.195.210.14,0,0,111,6516,111,6516,0.038298000,1.9367
75.31.150.242,<->,8.252.221.198,0,0,111,5562,111,5562,0.007504000,0.5154
192.64.252.158,<->,27.116.207.55,111,155890,0,0,111,155890,0.003753000,1.6503
144.75.218.241,<->,8.222.218.207,111,13689,0,0,111,13689,0.002320000,1.9861
111.20.172.119,<->,33.233.141.27,0,0,110,164870,110,164870,1.578925000,0.0005
111.20.172.119,<->,33.233.141.62,0,0,110,164809,110,164809,0.320229000,0.0009
60.101.171.11,<->,8.252.222.176,0,0,110,7833,110,7833,0.258261000,1.6374
133.178.226.196,<->,80.47.33.58,110,163336,0,0,110,163336,0.198967000,1.5135
136.25.188.57,<->,100.216.78.145,110,141547,0,0,110,141547,0.185917000,1.6327
215.158.239.76,<->,196.105.29.157,110,6757,0,0,110,6757,0.088568000,1.9110
220.28.73.211,<->,215.158.238.254,0,0,110,140428,110,140428,0.033439000,1.8032
246.253.253.210,<->,194.220.68.39,110,17142,0,0,110,17142,0.015170000,1.9712
231.193.31.131,<->,102.231.187.128,0,0,110,86075,110,86075,0.007892000,1.6581
136.25.189.77,<->,94.110.153.255,109,7555,0,0,109,7555,0.852149000,1.0807
111.20.172.118,<->,33.233.141.41,0,0,109,134550,109,134550,0.495681000,0.3877
215.158.61.238,<->,8.252.222.2,0,0,109,147447,109,147447,0.471134000,1.0339
133.178.226.84,<->,98.219.126.175,109,147208,0,0,109,147208,0.350162000,1.6036
139.205.240.199,<->,0.195.210.33,0,0,109,5450,109,5450,0.192472000,1.6045
136.25.188.56,<->,96.155.61.54,109,130332,0,0,109,130332,0.158934000,1.8349
215.158.238.70,<->,100.120.38.6,109,136271,0,0,109,136271,0.095460000,1.4697
215.158.239.38,<->,215.158.127.140,109,128645,0,0,109,128645,0.092033000,1.7645
100.188.51.6,<->,89.183.104.159,0,0,109,121099,109,121099,0.020284000,1.9651
210.236.92.115,<->,133.54.43.46,0,0,108,6668,108,6668,1.175631000,0.8192
136.25.188.39,<->,111.150.207.173,108,6048,0,0,108,6048,0.396928000,0.8364
140.68.9.127,<->,8.252.222.97,0,0,108,6338,108,6338,0.082583000,1.3525
215.158.238.138,<->,0.195.253.228,108,146851,0,0,108,146851,0.043784000,1.8370
220.28.85.14,<->,133.178.227.54,0,0,108,143230,108,143230,0.030557000,1.8346
136.25.188.230,<->,96.155.60.243,108,141777,0,0,108,141777,0.020791000,1.9551
220.28.115.46,<->,133.178.226.74,0,0,108,147478,108,147478,0.015312000,0.9915
133.178.226.67,<->,98.219.126.175,107,150635,0,0,107,150635,0.747453000,0.5199
133.8.10.153,<->,101.224.89.150,0,0,107,110438,107,110438,0.589298000,1.0165
220.28.64.202,<->,50.224.80.75,0,0,106,48144,106,48144,0.333650000,1.6288
220.28.73.211,<->,215.158.238.88,0,0,106,135384,106,135384,0.147199000,1.1758
215.158.6.147,<->,8.252.222.212,0,0,106,151437,106,151437,0.123502000,1.5717
215.158.239.60,<->,8.222.48.41,106,136144,0,0,106,136144,0.108258000,1.4183
139.163.161.48,<->,136.25.188.219,0,0,106,137462,106,137462,0.065545000,1.7149
89.183.104.234,<->,42.64.170.221,106,84363,0,0,106,84363,0.064467000,1.9151
144.75.218.246,<->,8.222.218.197,106,12919,0,0,106,12919,0.020424000,1.9572
220.39.202.203,<->,215.158.238.105,0,0,105,7421,105,7421,1.105653000,0.7236
149.110.19.113,<->,89.183.104.148,0,0,105,151580,105,151580,0.525680000,1.2333
139.5.114.82,<->,136.25.188.213,0,0,105,138729,105,138729,0.308223000,1.6497
50.224.110.86,<->,39.188.171.31,105,5922,0,0,105,5922,0.262180000,1.5970
220.28.109.52,<->,136.25.188.248,0,0,105,143125,105,143125,0.055731000,0.9217
53.231.66.30,<->,48.54.107.188,0,0,105,154980,105,154980,0.032670000,1.8579
192.228.25.203,<->,133.178.226.213,0,0,105,154834,105,154834,0.020324000,1.4989
215.158.30.184,<->,136.25.188.193,0,0,105,136892,105,136892,0.015407000,1.8056
246.253.253.210,<->,204.43.169.138,105,16565,0,0,105,16565,0.013499000,1.9775
101.87.173.115,<->,100.228.42.97,0,0,105,46046,105,46046,0.007905000,1.8592
92.168.217.252,<->,50.136.138.82,105,6839,0,0,105,6839,0.000221000,1.8791
215.158.238.86,<->,98.219.126.175,104,133132,0,0,104,133132,0.574478000,1.3816
215.158.238.89,<->,100.216.78.145,104,131997,0,0,104,131997,0.464186000,1.4651
215.158.238.102,<->,100.120.38.6,104,128707,0,0,104,128707,0.349623000,1.6239
138.45.90.226,<->,136.25.188.232,0,0,104,131802,104,131802,0.112435000,1.8802
136.25.188.212,<->,56.51.205.162,104,131424,0,0,104,131424,0.093258000,1.7122
60.81.170.92,<->,0.195.210.14,0,0,104,6412,104,6412,0.075346000,1.8862
136.25.189.84,<->,96.156.169.173,104,145015,0,0,104,145015,0.056108000,1.8446
149.193.32.35,<->,102.51.78.239,0,0,104,131456,104,131456,0.023613000,1.9108
215.158.238.215,<->,100.216.78.145,104,131296,0,0,104,131296,0.022007000,1.9481
108.46.25.1,<->,8.220.206.230,0,0,104,5200,104,5200,0.018947000,1.9608
200.174.209.33,<->,102.72.16.148,104,150432,0,0,104,150432,0.008944000,1.9721
159.215.65.159,<->,136.25.188.212,0,0,103,138238,103,138238,0.752382000,1.0251
215.158.239.62,<->,192.205.36.221,103,131592,0,0,103,131592,0.726956000,0.6937
215.158.238.86,<->,0.195.237.14,103,139424,0,0,103,139424,0.059076000,1.7619
196.251.78.134,<->,8.252.222.187,0,0,103,5522,103,5522,0.016592000,1.9732
246.253.253.208,<->,204.42.246.7,103,16315,0,0,103,16315,0.011226000,1.9804
192.64.235.125,<->,127.161.224.79,103,14960,0,0,103,14960,0.003200000,1.9962
99.167.132.172,<->,99.167.61.227,102,6300,0,0,102,6300,0.385245000,1.5942
159.127.185.253,<->,92.27.219.16,0,0,102,49182,102,49182,0.082940000,1.4473
75.214.219.139,<->,8.252.221.220,0,0,102,7548,102,7548,0.072071000,1.8134
136.25.188.200,<->,111.52.91.255,102,129895,0,0,102,129895,0.061363000,1.8587
139.69.162.189,<->,50.128.200.204,0,0,102,13908,102,13908,0.015260000,1.9801
220.14.74.249,<->,35.56.98.184,0,0,102,22234,102,22234,0.010615000,1.9800
144.93.125.38,<->,144.93.121.10,0,0,102,20608,102,20608,0.010250000,1.9800
209.91.187.192,<->,8.53.6.89,0,0,101,5408,101,5408,1.862777000,0.1275
215.158.239.88,<->,98.219.126.140,101,144644,0,0,101,144644,0.254903000,1.2811
127.178.169.123,<->,92.168.217.244,0,0,101,5656,101,5656,0.140733000,1.6723
136.25.188.166,<->,111.52.91.115,101,131544,0,0,101,131544,0.096791000,1.8445
195.121.224.243,<->,8.182.234.113,0,0,101,7037,101,7037,0.047073000,0.8043
76.179.85.192,<->,8.252.222.93,0,0,101,6608,101,6608,0.041592000,1.9362
133.178.226.197,<->,80.47.33.125,101,148604,0,0,101,148604,0.034381000,1.6170
144.93.121.83,<->,113.178.109.84,101,20516,0,0,101,20516,0.010880000,1.9800
196.251.73.5,<->,8.252.222.187,0,0,101,5794,101,5794,0.004479000,1.9921
246.253.253.210,<->,204.42.167.55,101,15857,0,0,101,15857,0.002039000,1.9954
132.227.248.61,<->,111.146.189.146,0,0,101,16017,101,16017,0.000883000,1.9856
159.46.201.24,<->,144.93.121.10,0,0,101,20604,101,20604,0.000312000,1.9979
92.168.217.193,<->,75.95.132.23,100,6968,0,0,100,6968,1.011594000,0.9578
220.28.73.211,<->,215.158.238.108,0,0,100,135966,100,135966,0.868203000,0.5036
216.184.2.83,<->,8.252.222.155,0,0,100,126021,100,126021,0.097668000,1.6933
220.28.108.254,<->,215.158.238.110,0,0,100,135768,100,135768,0.031892000,1.9190
159.46.201.109,<->,144.93.121.83,0,0,100,20400,100,20400,0.019046000,1.9800
144.93.121.83,<->,98.198.84.28,100,20400,0,0,100,20400,0.018886000,1.9800
144.93.125.32,<->,144.93.121.50,0,0,100,20400,100,20400,0.016079000,1.9800
61.125.101.112,<->,8.252.221.220,0,0,100,5000,100,5000,0.014912000,1.9626
159.46.201.28,<->,144.93.121.86,0,0,100,20400,100,20400,0.014532000,1.9799
145.2.46.169,<->,144.93.121.10,0,0,100,20400,100,20400,0.013898000,1.9800
144.93.121.83,<->,101.71.113.171,100,20400,0,0,100,20400,0.013602000,1.9800
137.83.230.7,<->,50.23.57.66,100,20400,0,0,100,20400,0.011853000,1.9821
210.213.21.66,<->,92.26.144.99,0,0,100,20400,100,20400,0.009868000,1.9799
198.11.192.232,<->,144.93.121.10,0,0,100,20400,100,20400,0.007386000,1.9799
236.90.17.75,<->,144.93.121.10,0,0,100,20400,100,20400,0.005421000,1.9800
144.93.121.10,<->,101.71.113.171,100,20400,0,0,100,20400,0.004641000,1.9800
145.2.46.74,<->,144.93.121.10,0,0,100,20400,100,20400,0.004305000,1.9800
144.93.125.32,<->,144.93.121.10,0,0,100,20400,100,20400,0.003085000,1.9800
145.2.46.75,<->,144.93.121.10,0,0,100,20400,100,20400,0.001381000,1.9800
144.93.121.83,<->,98.198.84.11,100,20400,0,0,100,20400,0.000715000,1.9800
144.93.125.32,<->,144.93.121.43,0,0,100,20400,100,20400,0.000031000,1.9800
215.158.32.49,<->,8.252.222.234,0,0,99,137060,99,137060,1.751616000,0.1804
249.229.129.171,<->,215.158.140.87,0,0,99,6604,99,6604,0.615819000,0.8228
136.25.188.170,<->,56.97.186.28,99,129929,0,0,99,129929,0.281870000,1.5162
130.239.147.103,<->,92.168.217.241,0,0,99,6520,99,6520,0.278661000,1.4211
136.25.188.167,<->,100.224.166.122,99,132968,0,0,99,132968,0.182926000,1.6107
136.25.188.244,<->,97.174.232.235,99,119372,0,0,99,119372,0.141308000,1.8450
207.62.152.200,<->,136.25.188.225,0,0,99,5257,99,5257,0.115391000,1.7246
194.253.80.60,<->,8.252.222.206,0,0,99,7127,99,7127,0.088954000,1.9045
133.178.226.212,<->,8.254.21.27,99,144770,0,0,99,144770,0.087517000,1.6612
212.164.245.218,<->,8.52.188.75,0,0,99,6525,99,6525,0.047735000,0.3980
139.105.162.25,<->,100.188.174.22,99,5052,0,0,99,5052,0.019783000,1.9409
200.175.88.132,<->,53.167.66.5,99,5832,0,0,99,5832,0.011235000,1.9869
133.54.43.38,<->,117.24.150.38,98,5627,0,0,98,5627,1.103925000,0.4775
215.158.238.130,<->,100.120.38.6,98,130713,0,0,98,130713,0.387152000,1.5294
136.25.188.166,<->,100.224.202.184,98,130998,0,0,98,130998,0.204055000,1.4352
215.158.140.168,<->,215.158.58.202,98,139042,0,0,98,139042,0.125025000,1.3789
226.36.250.224,<->,92.27.27.178,0,0,98,5120,98,5120,0.044841000,1.9455
8.252.222.222,<->,4.120.82.173,98,6020,0,0,98,6020,0.022781000,1.9360
118.114.202.17,<->,92.168.217.130,0,0,98,6458,98,6458,0.019887000,1.8769
76.179.100.221,<->,8.252.221.206,0,0,98,5198,98,5198,0.001232000,1.9103
220.28.114.28,<->,133.178.226.74,0,0,97,133774,97,133774,0.659614000,1.3018
145.116.209.71,<->,136.25.188.51,0,0,97,115095,97,115095,0.083900000,1.5647
53.167.66.5,<->,48.55.35.47,0,0,97,5916,97,5916,0.075849000,1.9042
58.247.154.97,<->,8.252.222.95,0,0,97,6372,97,6372,0.061456000,1.8982
136.25.189.10,<->,96.156.169.224,97,129385,0,0,97,129385,0.054945000,1.8204
215.158.238.119,<->,98.219.126.175,97,128970,0,0,97,128970,0.020784000,1.8914
145.116.209.71,<->,136.25.188.58,0,0,97,122598,97,122598,0.018624000,1.2569
199.68.101.24,<->,136.25.188.220,0,0,97,4850,97,4850,0.015912000,0.8061
136.25.189.24,<->,96.156.169.196,97,101710,0,0,97,101710,0.015428000,1.9105
144.85.170.246,<->,17.61.5.126,97,4850,0,0,97,4850,0.010913000,1.9749
136.25.189.37,<->,96.156.169.236,96,122891,0,0,96,122891,0.319350000,1.4438
136.114.101.19,<->,136.25.188.200,0,0,96,131761,96,131761,0.205123000,1.7145
198.206.21.236,<->,100.93.217.200,0,0,96,36739,96,36739,0.149543000,1.8501
121.212.70.115,<->,92.27.27.182,0,0,96,141120,96,141120,0.109522000,1.8810
246.253.134.201,<->,148.99.224.201,96,23700,0,0,96,23700,0.108347000,1.8613
207.0.146.135,<->,50.223.3.228,0,0,96,4800,96,4800,0.097771000,1.8049
215.158.239.115,<->,89.7.157.66,96,141187,0,0,96,141187,0.076006000,1.8702
220.28.73.211,<->,133.178.226.72,0,0,96,135240,96,135240,0.070342000,1.8964
221.196.123.180,<->,136.25.188.226,0,0,96,5852,96,5852,0.044075000,1.9534
215.158.140.175,<->,8.222.0.235,96,5376,0,0,96,5376,0.034329000,0.4369
215.158.238.94,<->,33.209.217.237,96,30369,0,0,96,30369,0.024510000,1.9741
126.152.82.108,<->,80.41.53.34,0,0,96,6073,96,6073,0.013429000,1.9484
80.41.7.76,<->,8.55.208.173,96,126819,0,0,96,126819,0.012698000,0.6170
215.158.2.89,<->,92.170.244.173,0,0,96,12321,96,12321,0.008123000,1.9006
133.178.227.26,<->,69.246.42.54,95,6477,0,0,95,6477,0.653504000,0.5364
215.158.238.83,<->,29.211.6.10,95,15292,0,0,95,15292,0.155455000,1.8315
215.158.238.128,<->,100.216.78.145,95,118453,0,0,95,118453,0.088995000,1.3667
215.158.239.55,<->,192.205.36.215,95,129674,0,0,95,129674,0.082359000,1.2039
36.116.46.197,<->,8.252.222.115,0,0,95,6388,95,6388,0.061508000,1.7907
215.158.61.225,<->,8.252.222.64,0,0,95,126868,95,126868,0.026769000,0.5910
145.116.209.93,<->,136.25.188.231,0,0,95,111040,95,111040,0.021210000,1.3631
108.128.237.16,<->,101.224.167.233,0,0,95,9610,95,9610,0.016295000,1.9481
138.89.205.200,<->,56.121.51.247,0,0,95,43123,95,43123,0.010432000,1.9824
133.178.226.199,<->,8.47.189.8,94,139863,0,0,94,139863,0.383501000,1.0806
215.158.239.74,<->,56.97.186.30,94,126844,0,0,94,126844,0.278290000,1.5437
220.28.104.193,<->,215.158.238.119,0,0,94,123850,94,123850,0.155459000,1.7435
136.25.188.165,<->,100.224.166.146,94,119374,0,0,94,119374,0.109229000,1.7691
215.158.238.101,<->,100.120.38.6,94,117020,0,0,94,117020,0.052436000,1.8705
58.143.230.90,<->,8.252.221.223,0,0,94,12190,94,12190,0.003916000,1.8895
246.253.253.97,<->,111.151.239.191,93,137782,0,0,93,137782,1.517927000,0.0260
215.158.6.143,<->,8.252.222.212,0,0,93,127508,93,127508,0.477840000,1.4144
136.25.188.166,<->,111.52.91.239,93,126973,0,0,93,126973,0.472981000,1.4573
97.198.117.226,<->,50.106.134.239,93,134406,0,0,93,134406,0.332059000,0.5821
139.69.162.38,<->,8.252.222.169,0,0,93,116334,93,116334,0.206273000,1.7567
196.148.99.61,<->,53.243.94.134,93,124558,0,0,93,124558,0.148934000,1.4254
215.158.238.194,<->,98.219.126.175,93,126347,0,0,93,126347,0.140632000,1.8215
136.114.101.30,<->,136.25.188.214,0,0,93,120089,93,120089,0.125554000,1.7495
58.202.108.164,<->,8.252.222.81,0,0,93,6064,93,6064,0.096993000,1.8194
136.18.96.155,<->,8.182.235.164,0,0,93,5106,93,5106,0.020350000,1.9526
207.207.66.130,<->,138.98.231.29,0,0,93,4650,93,4650,0.015518000,1.5392
220.55.98.90,<->,125.153.51.18,93,4938,0,0,93,4938,0.008310000,1.9790
215.158.238.131,<->,100.120.38.6,92,123039,0,0,92,123039,0.542323000,0.9029
215.158.238.131,<->,0.195.253.228,92,123022,0,0,92,123022,0.285993000,1.6063
215.158.239.65,<->,96.155.60.206,92,130797,0,0,92,130797,0.274644000,1.3885
215.158.238.90,<->,0.195.253.228,92,122736,0,0,92,122736,0.243928000,1.1901
220.28.115.46,<->,215.158.238.76,0,0,92,117991,92,117991,0.125758000,1.8183
139.36.120.125,<->,99.74.26.158,0,0,92,115847,92,115847,0.105997000,1.8306
215.158.140.207,<->,8.222.7.171,92,5176,0,0,92,5176,0.067381000,1.8520
94.192.104.158,<->,8.252.222.115,0,0,92,5864,92,5864,0.049169000,1.9323
149.57.170.237,<->,92.168.217.222,0,0,92,5981,92,5981,0.013406000,1.8682
133.54.43.30,<->,113.39.42.69,92,5152,0,0,92,5152,0.005556000,1.6869
215.158.238.139,<->,0.195.253.228,91,125730,0,0,91,125730,1.278799000,0.4847
220.28.85.14,<->,133.178.227.30,0,0,91,126715,91,126715,0.698909000,1.2500
215.158.140.204,<->,109.184.4.80,91,6324,0,0,91,6324,0.157698000,1.7760
207.88.82.50,<->,0.195.210.42,0,0,91,6185,91,6185,0.149458000,1.6227
139.69.162.57,<->,136.25.188.219,0,0,91,111795,91,111795,0.070545000,1.8814
144.75.218.246,<->,8.222.218.204,91,11305,0,0,91,11305,0.046830000,1.9434
215.158.238.118,<->,100.120.38.6,91,117253,0,0,91,117253,0.028084000,1.8515
144.75.218.242,<->,8.222.218.207,91,10983,0,0,91,10983,0.022196000,1.9668
207.62.191.87,<->,136.25.188.163,0,0,91,7222,91,7222,0.011407000,1.8748
133.178.227.4,<->,98.219.126.175,90,125949,0,0,90,125949,0.720045000,0.3708
215.158.239.205,<->,139.117.36.103,90,130597,0,0,90,130597,0.682979000,0.1070
129.236.114.39,<->,101.224.89.175,0,0,90,129252,90,129252,0.496077000,1.3182
97.203.33.78,<->,8.183.24.211,0,0,90,6199,90,6199,0.175682000,1.7850
204.114.166.12,<->,92.27.219.133,0,0,90,4746,90,4746,0.121285000,1.8013
220.28.109.52,<->,136.25.188.219,0,0,90,118076,90,118076,0.028400000,1.8334
215.158.238.189,<->,131.36.66.82,90,6130,0,0,90,6130,0.024153000,0.3108
220.28.109.52,<->,136.25.188.164,0,0,90,115328,90,115328,0.009591000,1.9046
136.25.188.194,<->,111.52.91.227,89,117443,0,0,89,117443,0.744237000,1.0724
142.241.122.128,<->,136.25.188.175,0,0,89,4450,89,4450,0.544757000,0.5940
215.158.239.73,<->,192.205.36.205,89,116388,0,0,89,116388,0.179462000,1.7505
159.215.65.153,<->,136.25.188.233,0,0,89,111070,89,111070,0.043710000,1.9464
133.178.227.143,<->,89.207.131.9,89,56889,0,0,89,56889,0.005498000,1.9627
192.224.20.42,<->,133.178.227.245,0,0,88,44191,88,44191,0.706463000,1.2726
215.158.238.189,<->,33.209.210.176,88,5963,0,0,88,5963,0.526129000,0.5926
215.158.239.24,<->,215.158.127.166,88,118389,0,0,88,118389,0.293998000,1.4370
159.137.134.76,<->,8.52.187.74,0,0,88,4436,88,4436,0.255513000,1.5132
133.178.227.29,<->,100.216.78.145,88,109998,0,0,88,109998,0.236886000,1.7212
133.178.226.20,<->,100.120.38.6,88,105685,0,0,88,105685,0.203448000,1.4397
207.20.191.116,<->,8.252.222.176,0,0,88,6540,88,6540,0.153103000,1.6601
220.28.114.28,<->,215.158.238.136,0,0,88,116316,88,116316,0.088934000,1.3903
133.54.43.80,<->,127.110.85.4,88,4400,0,0,88,4400,0.074605000,1.5363
92.27.219.165,<->,6.211.193.169,88,36560,0,0,88,36560,0.048729000,1.9480
199.83.9.109,<->,136.25.188.220,0,0,88,5090,88,5090,0.043014000,1.7451
200.174.219.90,<->,53.68.64.193,88,5264,0,0,88,5264,0.025268000,1.9728
58.60.206.94,<->,8.252.222.13,0,0,88,5564,88,5564,0.015787000,1.9387
141.37.255.242,<->,8.228.214.124,0,0,88,128304,88,128304,0.001026000,1.9978
220.28.108.254,<->,215.158.238.152,0,0,87,117099,87,117099,0.558716000,1.0171
210.221.110.77,<->,114.186.59.195,87,119382,0,0,87,119382,0.376816000,1.5877
215.158.239.45,<->,98.219.126.140,87,117997,0,0,87,117997,0.097620000,1.8765
220.28.85.14,<->,215.158.238.116,0,0,87,109782,87,109782,0.087931000,1.5582
215.158.239.85,<->,207.63.198.183,87,5782,0,0,87,5782,0.066713000,1.9304
120.221.207.133,<->,92.27.27.164,0,0,87,111304,87,111304,0.033640000,1.7968
80.40.17.181,<->,50.248.186.141,87,130848,0,0,87,130848,0.015101000,1.9622
133.178.226.67,<->,133.56.180.18,87,107512,0,0,87,107512,0.000834000,1.7710
139.36.119.84,<->,136.25.189.209,0,0,86,74316,86,74316,0.431915000,0.8261
215.158.238.78,<->,98.219.126.175,86,116386,0,0,86,116386,0.396544000,1.1471
103.164.140.56,<->,92.27.219.220,0,0,86,11310,86,11310,0.342100000,1.5562
215.158.6.147,<->,8.252.222.249,0,0,86,117728,86,117728,0.175340000,1.5249
195.15.131.184,<->,136.25.188.176,0,0,86,7511,86,7511,0.046815000,0.5632
215.158.238.221,<->,18.203.159.187,86,5563,0,0,86,5563,0.035294000,0.5496
139.205.255.19,<->,0.195.210.33,0,0,86,4334,86,4334,0.034303000,1.7312
139.163.68.51,<->,97.182.39.8,86,4300,0,0,86,4300,0.018572000,1.9719
212.105.232.45,<->,97.126.114.4,0,0,86,4763,86,4763,0.007927000,1.9841
215.158.239.56,<->,199.20.31.74,86,5079,0,0,86,5079,0.006771000,1.6918
138.45.90.177,<->,136.25.188.212,0,0,86,111094,86,111094,0.002453000,1.8119
133.8.10.153,<->,33.233.141.0,0,0,86,92251,86,92251,0.002194000,0.1387
136.25.188.56,<->,100.224.202.187,85,109336,0,0,85,109336,0.843412000,0.8449
113.108.161.158,<->,92.27.27.142,0,0,85,123845,85,123845,0.263029000,1.7168
144.85.170.246,<->,17.230.247.68,85,4760,0,0,85,4760,0.250887000,0.8981
215.158.239.89,<->,98.219.126.140,85,113659,0,0,85,113659,0.201338000,0.7494
246.253.146.225,<->,143.120.91.175,85,6739,0,0,85,6739,0.186551000,1.8074
133.178.226.8,<->,100.120.38.6,85,99772,0,0,85,99772,0.131435000,1.7570
111.161.94.38,<->,92.27.219.226,0,0,85,67077,85,67077,0.086605000,1.8823
136.25.189.7,<->,96.156.169.209,85,93910,0,0,85,93910,0.046336000,1.7931
215.158.239.84,<->,194.250.220.170,85,5034,0,0,85,5034,0.017083000,0.2760
107.11.228.91,<->,0.195.210.33,0,0,84,5469,84,5469,1.399002000,0.5521
215.158.239.63,<->,159.215.65.152,84,114098,0,0,84,114098,1.288106000,0.6731
129.236.114.39,<->,33.233.141.34,0,0,84,117901,84,117901,0.758726000,1.0728
159.162.33.63,<->,8.182.227.71,0,0,84,6181,84,6181,0.657396000,1.3283
133.178.226.167,<->,100.120.38.6,84,115424,0,0,84,115424,0.443852000,0.3489
136.158.73.56,<->,133.178.227.227,0,0,84,4742,84,4742,0.355821000,1.0718
123.191.161.64,<->,92.27.219.184,0,0,84,4983,84,4983,0.296816000,1.4825
215.158.238.137,<->,0.195.237.14,84,111418,0,0,84,111418,0.221691000,1.1998
215.158.61.255,<->,8.252.222.75,0,0,84,102009,84,102009,0.035719000,1.1620
220.28.109.52,<->,136.25.188.59,0,0,84,108715,84,108715,0.027934000,1.8144
138.45.90.192,<->,136.25.188.168,0,0,84,107595,84,107595,0.020974000,1.7182
122.108.105.69,<->,80.40.37.199,0,0,84,4945,84,4945,0.009012000,1.9792
220.28.104.193,<->,215.158.238.79,0,0,84,109642,84,109642,0.005978000,1.9019
8.182.136.169,<->,6.133.233.121,83,5586,0,0,83,5586,1.190574000,0.7880
216.184.1.126,<->,8.252.222.164,0,0,83,100318,83,100318,0.454431000,1.5374
215.158.238.126,<->,100.120.38.6,83,103454,0,0,83,103454,0.246398000,1.5805
136.25.189.22,<->,96.156.169.238,83,109886,0,0,83,109886,0.160532000,1.7504
69.243.120.180,<->,8.252.222.13,0,0,83,5376,83,5376,0.116919000,1.8578
215.158.239.36,<->,96.135.154.122,83,114974,0,0,83,114974,0.056837000,1.9400
220.28.104.193,<->,215.158.238.145,0,0,83,110301,83,110301,0.027142000,1.9603
207.60.231.199,<->,136.25.188.163,0,0,83,4150,83,4150,0.014184000,1.9781
158.215.83.215,<->,133.54.22.11,0,0,83,4665,83,4665,0.007729000,1.8271
205.127.108.115,<->,101.224.89.252,0,0,83,17058,83,17058,0.006786000,1.9815
121.249.250.115,<->,92.27.219.18,0,0,82,110588,82,110588,1.502806000,0.4684
133.178.226.202,<->,6.73.247.4,82,5905,0,0,82,5905,0.841557000,0.2107
133.178.227.22,<->,133.56.180.44,82,105532,0,0,82,105532,0.291606000,1.6849
95.245.75.254,<->,8.252.222.160,0,0,82,8218,82,8218,0.162203000,1.7413
119.219.154.242,<->,92.168.217.245,0,0,82,5112,82,5112,0.076501000,1.9213
95.246.206.43,<->,8.252.222.4,0,0,82,5348,82,5348,0.025533000,1.9440
243.156.59.16,<->,92.27.219.225,0,0,82,5332,82,5332,0.006822000,1.9498
133.54.43.38,<->,33.251.97.17,82,4944,0,0,82,4944,0.006813000,1.9761
133.178.227.23,<->,100.224.133.166,81,116411,0,0,81,116411,0.823451000,0.6852
215.158.238.68,<->,0.195.237.14,81,109676,0,0,81,109676,0.407361000,1.3484
215.158.238.33,<->,131.36.105.43,81,5714,0,0,81,5714,0.202482000,0.8823
215.158.239.83,<->,139.163.161.50,81,98899,0,0,81,98899,0.148644000,1.8136
58.50.227.54,<->,8.252.222.21,0,0,81,5112,81,5112,0.070067000,1.8276
230.102.130.52,<->,133.178.227.192,0,0,81,30635,81,30635,0.053179000,1.9424
204.56.199.158,<->,136.25.188.220,0,0,81,4612,81,4612,0.038504000,0.5290
60.101.203.189,<->,8.252.222.211,0,0,81,4920,81,4920,0.037068000,1.9516
136.25.189.93,<->,96.156.169.210,80,94639,0,0,80,94639,0.651216000,1.2840
139.163.161.48,<->,136.25.188.57,0,0,80,101985,80,101985,0.522173000,1.3213
138.121.99.24,<->,8.220.179.126,0,0,80,4567,80,4567,0.381899000,0.1786
215.158.239.11,<->,215.158.127.166,80,100513,0,0,80,100513,0.281884000,1.6455
139.36.120.116,<->,99.74.87.236,0,0,80,105715,80,105715,0.194010000,0.3731
139.163.161.33,<->,136.25.188.58,0,0,80,94064,80,94064,0.170938000,1.2867
136.25.189.21,<->,96.156.169.165,80,100693,0,0,80,100693,0.099348000,1.8542
130.239.149.154,<->,92.168.217.241,0,0,80,4952,80,4952,0.075296000,1.8842
136.25.188.233,<->,56.97.186.28,80,99441,0,0,80,99441,0.070865000,1.8128
215.158.140.178,<->,140.173.227.85,80,4234,0,0,80,4234,0.035612000,0.2137
230.102.130.22,<->,133.178.227.200,0,0,80,61882,80,61882,0.029645000,1.9503
204.200.18.212,<->,0.195.210.33,0,0,80,5040,80,5040,0.028711000,1.9359
139.248.30.199,<->,100.228.42.154,0,0,80,22360,80,22360,0.028695000,1.9414
215.158.140.178,<->,8.240.116.237,79,5583,0,0,79,5583,1.652553000,0.2359
215.158.238.236,<->,145.48.251.0,79,6418,0,0,79,6418,1.610217000,0.2560
132.249.70.93,<->,8.37.218.73,79,112713,0,0,79,112713,1.165223000,0.2666
220.28.73.211,<->,215.158.238.70,0,0,79,104305,79,104305,1.106769000,0.8361
215.158.238.79,<->,0.195.253.228,79,107277,0,0,79,107277,0.709787000,0.4064
17.18.69.246,<->,8.220.176.253,0,0,79,8100,79,8100,0.533126000,1.4297
220.28.104.193,<->,133.178.226.43,0,0,79,101810,79,101810,0.415989000,1.4856
192.228.25.251,<->,133.178.226.213,0,0,79,118291,79,118291,0.287673000,1.5020
200.174.97.45,<->,53.231.93.91,79,99939,0,0,79,99939,0.256000000,1.7320
89.183.111.147,<->,66.0.153.135,79,3950,0,0,79,3950,0.174546000,0.8513
215.158.238.193,<->,100.216.78.145,79,103318,0,0,79,103318,0.154539000,1.0325
69.243.194.223,<->,8.252.221.205,0,0,79,4220,79,4220,0.116335000,1.8475
215.158.30.165,<->,8.252.222.137,0,0,79,96078,79,96078,0.082712000,1.7802
204.131.179.159,<->,39.15.146.228,0,0,79,9596,79,9596,0.074676000,1.7273
145.182.137.222,<->,136.25.188.41,0,0,79,102176,79,102176,0.068698000,1.8595
215.158.239.45,<->,192.205.36.214,79,102415,0,0,79,102415,0.062497000,1.8964
92.27.219.134,<->,33.57.74.161,79,99560,0,0,79,99560,0.051801000,1.9251
192.205.36.194,<->,136.25.188.58,0,0,79,96505,79,96505,0.049259000,1.6886
215.158.6.190,<->,8.252.222.19,0,0,79,111973,79,111973,0.005581000,1.7513
223.114.195.4,<->,8.252.222.115,0,0,79,5672,79,5672,0.000333000,1.9886
220.28.115.46,<->,215.158.140.247,0,0,78,108715,78,108715,1.803772000,0.1090
220.28.108.254,<->,215.158.238.193,0,0,78,107070,78,107070,0.811469000,1.0862
215.158.238.129,<->,0.195.253.228,78,105226,0,0,78,105226,0.535598000,0.6991
215.158.238.148,<->,65.27.228.248,78,5784,0,0,78,5784,0.249754000,1.0315
220.28.104.193,<->,215.158.238.88,0,0,78,105576,78,105576,0.228137000,1.1992
223.143.15.189,<->,92.27.27.165,0,0,78,114660,78,114660,0.212845000,1.3017
223.138.87.163,<->,89.183.104.175,0,0,78,4170,78,4170,0.185415000,1.6680
17.143.152.196,<->,8.220.206.230,0,0,78,3900,78,3900,0.172055000,1.8255
69.243.90.125,<->,8.252.221.236,0,0,78,5306,78,5306,0.067699000,1.7271
93.181.153.151,<->,89.183.104.181,0,0,78,102991,78,102991,0.013519000,1.9115
136.25.189.208,<->,111.42.25.227,78,88807,0,0,78,88807,0.013116000,1.4068
139.69.162.39,<->,8.252.222.43,0,0,78,96027,78,96027,0.008641000,1.7848
93.209.140.167,<->,92.168.217.252,0,0,78,4368,78,4368,0.008623000,1.9351
144.85.170.244,<->,97.173.65.99,78,4572,0,0,78,4572,0.003474000,1.9805
8.182.248.147,<->,6.33.8.29,78,3900,0,0,78,3900,0.000274000,0.6441
129.236.115.220,<->,111.20.168.122,0,0,77,6430,77,6430,1.205587000,0.7868
215.158.140.164,<->,141.199.67.10,77,5407,0,0,77,5407,0.593679000,0.3077
215.158.239.67,<->,136.114.101.86,77,99034,0,0,77,99034,0.164781000,1.7462
136.25.188.217,<->,98.219.126.175,77,98736,0,0,77,98736,0.124456000,1.7545
113.123.137.156,<->,92.168.217.228,0,0,77,4348,77,4348,0.082379000,1.4982
215.158.238.71,<->,98.219.126.175,77,99351,0,0,77,99351,0.040600000,1.8321
220.28.65.9,<->,215.158.140.250,0,0,77,99578,77,99578,0.036259000,1.9106
95.244.76.64,<->,8.252.222.115,0,0,77,4888,77,4888,0.035270000,1.8932
89.183.104.243,<->,42.27.151.57,77,4799,0,0,77,4799,0.028416000,1.9570
144.75.218.246,<->,8.222.218.199,77,9701,0,0,77,9701,0.021688000,1.9199
133.54.43.35,<->,117.14.68.209,77,4312,0,0,77,4312,0.013119000,1.7110
220.28.115.46,<->,215.158.238.253,0,0,76,107067,76,107067,1.647369000,0.3075
215.158.238.69,<->,0.195.253.228,76,104155,0,0,76,104155,1.119909000,0.7678
220.28.85.14,<->,215.158.238.229,0,0,76,95221,76,95221,1.021365000,0.8699
215.158.238.85,<->,98.219.126.140,76,99605,0,0,76,99605,0.841044000,1.1402
220.28.115.46,<->,215.158.239.82,0,0,76,101625,76,101625,0.689855000,1.1380
207.188.255.22,<->,136.25.188.55,0,0,76,6002,76,6002,0.622493000,1.2334
133.178.227.62,<->,133.56.180.36,76,104840,0,0,76,104840,0.391878000,0.7656
215.158.238.72,<->,41.157.109.76,76,3800,0,0,76,3800,0.096071000,1.7949
99.169.247.245,<->,8.20.87.254,0,0,76,5720,76,5720,0.062819000,1.9048
207.60.69.185,<->,136.25.188.253,0,0,76,4256,76,4256,0.051332000,0.5499
223.115.254.178,<->,8.252.222.185,0,0,76,4972,76,4972,0.042572000,1.8381
215.158.238.144,<->,100.120.38.6,76,90286,0,0,76,90286,0.027902000,1.8983
220.39.233.182,<->,215.158.238.134,0,0,76,19112,76,19112,0.018415000,1.8629
98.67.130.136,<->,53.231.179.206,76,3884,0,0,76,3884,0.011932000,1.9799
220.28.115.46,<->,215.158.238.192,0,0,76,105953,76,105953,0.009543000,1.9353
215.158.195.54,<->,80.46.112.244,75,104483,0,0,75,104483,1.762393000,0.1491
133.178.227.61,<->,100.216.78.145,75,108003,0,0,75,108003,0.792287000,0.0475
220.28.104.193,<->,215.158.140.249,0,0,75,104136,75,104136,0.589384000,0.9102
136.25.188.244,<->,96.156.169.204,75,102997,0,0,75,102997,0.329658000,1.3209
215.158.239.24,<->,215.158.127.173,75,90218,0,0,75,90218,0.286922000,1.7002
215.158.239.73,<->,133.56.180.78,75,95732,0,0,75,95732,0.204532000,1.6756
216.184.2.61,<->,8.252.222.42,0,0,75,94212,75,94212,0.141401000,1.6657
133.178.227.19,<->,133.56.180.33,75,14443,0,0,75,14443,0.120934000,1.8183
142.205.209.177,<->,92.168.217.208,0,0,75,4512,75,4512,0.096531000,1.8221
220.28.73.211,<->,133.178.226.75,0,0,75,87954,75,87954,0.059762000,1.5395
220.28.65.9,<->,136.25.188.217,0,0,75,97045,75,97045,0.022785000,1.5740
220.28.115.46,<->,215.158.238.78,0,0,75,88571,75,88571,0.021701000,1.8702
136.25.189.63,<->,96.156.169.239,75,87848,0,0,75,87848,0.016232000,1.7558
133.54.43.46,<->,93.218.133.202,75,4200,0,0,75,4200,0.002674000,0.4796
92.168.217.209,<->,50.136.144.96,74,4667,0,0,74,4667,0.832438000,1.0683
102.50.198.152,<->,27.11.57.104,74,109272,0,0,74,109272,0.747808000,1.0954
133.178.226.23,<->,98.219.126.140,74,98548,0,0,74,98548,0.425247000,1.5592
192.228.30.49,<->,100.94.61.134,0,0,74,108186,74,108186,0.295065000,1.1371
133.178.227.10,<->,133.56.180.43,74,101694,0,0,74,101694,0.127032000,1.8610
201.67.203.4,<->,109.112.164.42,0,0,74,9400,74,9400,0.104665000,1.8627
133.178.227.9,<->,133.56.180.25,74,101427,0,0,74,101427,0.089478000,1.7575
215.158.239.45,<->,56.97.186.4,74,91292,0,0,74,91292,0.069419000,1.1468
133.54.43.79,<->,121.215.112.255,74,3700,0,0,74,3700,0.068171000,0.9521
136.25.188.229,<->,96.155.60.196,74,97031,0,0,74,97031,0.062203000,1.7671
193.21.28.227,<->,92.27.219.243,0,0,74,111000,74,111000,0.056902000,1.8599
109.51.73.125,<->,8.182.224.87,0,0,74,8965,74,8965,0.024523000,0.3294
215.158.238.197,<->,8.50.118.65,74,5332,0,0,74,5332,0.023950000,0.7873
133.178.227.76,<->,133.56.180.15,74,31682,0,0,74,31682,0.018173000,1.9438
215.158.140.187,<->,6.15.196.136,74,5250,0,0,74,5250,0.013661000,0.2870
220.55.105.19,<->,126.240.172.142,73,3650,0,0,73,3650,1.232217000,0.7653
111.151.109.41,<->,8.252.222.195,0,0,73,4088,73,4088,0.730681000,0.4693
215.158.238.76,<->,98.219.126.175,73,94518,0,0,73,94518,0.614884000,1.3183
216.184.1.90,<->,8.252.222.169,0,0,73,78001,73,78001,0.280605000,1.3534
220.28.115.46,<->,215.158.238.108,0,0,73,94242,73,94242,0.199217000,0.6514
194.253.243.34,<->,8.252.222.208,0,0,73,3947,73,3947,0.167653000,1.8082
215.158.140.204,<->,133.20.250.202,73,4224,0,0,73,4224,0.104448000,1.0574
136.25.188.253,<->,8.252.230.233,73,4088,0,0,73,4088,0.090656000,0.7017
220.20.200.50,<->,35.107.149.134,73,106498,0,0,73,106498,0.088908000,0.5799
136.25.188.230,<->,96.155.60.252,73,91727,0,0,73,91727,0.083336000,1.9024
215.158.238.138,<->,98.219.126.140,73,93572,0,0,73,93572,0.056868000,1.8411
215.158.61.191,<->,8.176.8.247,0,0,73,101567,73,101567,0.046008000,1.2471
216.184.1.103,<->,8.252.222.128,0,0,73,82981,73,82981,0.042125000,1.2818
58.202.122.59,<->,8.252.222.115,0,0,73,4660,73,4660,0.040964000,1.9219
136.25.188.57,<->,96.155.61.30,73,96714,0,0,73,96714,0.019259000,1.6825
194.253.94.195,<->,8.252.222.221,0,0,73,4964,73,4964,0.001919000,1.9692
215.158.140.253,<->,145.48.251.0,72,5022,0,0,72,5022,1.791762000,0.0884
220.28.85.14,<->,133.178.227.39,0,0,72,94907,72,94907,1.081284000,0.8749
101.224.182.5,<->,8.252.222.215,0,0,72,102600,72,102600,0.792228000,0.1332
215.158.238.203,<->,98.219.126.175,72,97240,0,0,72,97240,0.737840000,1.2215
139.163.167.27,<->,133.178.227.242,0,0,72,9205,72,9205,0.705751000,0.1088
215.158.30.229,<->,136.25.188.244,0,0,72,90395,72,90395,0.555409000,0.6818
246.253.253.99,<->,8.20.81.65,72,84974,0,0,72,84974,0.393060000,1.5752
8.252.221.236,<->,4.123.188.153,72,5464,0,0,72,5464,0.301742000,1.5976
215.158.238.41,<->,98.219.126.140,72,97061,0,0,72,97061,0.251999000,1.5961
215.158.239.61,<->,56.97.186.28,72,90524,0,0,72,90524,0.151570000,1.6826
199.51.86.248,<->,136.25.188.237,0,0,72,7566,72,7566,0.124308000,1.8697
194.253.94.50,<->,8.252.222.241,0,0,72,4224,72,4224,0.107940000,1.8336
133.178.227.6,<->,133.56.180.8,72,94017,0,0,72,94017,0.103660000,1.4459
215.158.238.144,<->,0.195.253.228,72,93524,0,0,72,93524,0.100333000,1.7302
215.158.239.76,<->,195.55.36.24,72,7965,0,0,72,7965,0.088727000,1.8064
58.202.122.182,<->,8.252.222.125,0,0,72,4424,72,4424,0.083016000,1.9166
146.15.20.243,<->,80.27.158.181,0,0,72,28322,72,28322,0.045504000,1.9541
136.25.188.228,<->,0.195.253.228,72,99789,0,0,72,99789,0.022045000,1.2728
58.203.176.255,<->,8.252.221.198,0,0,72,4320,72,4320,0.019467000,1.9528
94.192.4.230,<->,8.252.222.125,0,0,72,4540,72,4540,0.013409000,1.4751
133.178.227.27,<->,133.56.180.11,71,5465,0,0,71,5465,1.074942000,0.0947
215.158.238.133,<->,128.110.138.182,71,5245,0,0,71,5245,1.014226000,0.3934
136.25.188.232,<->,100.224.166.158,71,95673,0,0,71,95673,0.588624000,0.8942
112.15.22.111,<->,92.168.217.171,0,0,71,3550,71,3550,0.427034000,1.5710
144.93.121.10,<->,130.42.61.8,71,14484,0,0,71,14484,0.304881000,1.6782
215.158.239.7,<->,8.222.7.160,71,4012,0,0,71,4012,0.185719000,1.4517
215.158.239.75,<->,138.45.90.195,71,92586,0,0,71,92586,0.152240000,1.5113
223.114.168.191,<->,8.252.222.205,0,0,71,4628,71,4628,0.141540000,1.8180
136.25.189.42,<->,96.156.169.207,71,94785,0,0,71,94785,0.096854000,1.6773
215.158.239.97,<->,199.82.192.73,71,6927,0,0,71,6927,0.094932000,1.8441
136.25.188.169,<->,96.155.61.44,71,92266,0,0,71,92266,0.086908000,1.8388
136.25.189.61,<->,96.156.169.216,71,81325,0,0,71,81325,0.080111000,1.8821
215.158.238.246,<->,98.219.126.140,71,98313,0,0,71,98313,0.057442000,1.4674
221.102.143.189,<->,220.83.124.90,0,0,71,81966,71,81966,0.055855000,1.8265
129.175.139.42,<->,8.252.222.241,0,0,71,9193,71,9193,0.035153000,1.5737
223.114.3.231,<->,8.252.222.109,0,0,71,4480,71,4480,0.031649000,1.8809
69.243.95.16,<->,8.252.222.93,0,0,71,3976,71,3976,0.019945000,1.9743
237.71.136.90,<->,92.168.217.245,0,0,71,3550,71,3550,0.009492000,0.9528
35.61.123.189,<->,8.252.223.146,0,0,71,4547,71,4547,0.005706000,1.9049
138.45.90.244,<->,136.25.188.202,0,0,70,89578,70,89578,1.005611000,0.8260
141.172.209.250,<->,8.252.221.230,0,0,70,5128,70,5128,0.973914000,0.9826
92.27.219.241,<->,8.44.19.122,70,97501,0,0,70,97501,0.836793000,0.2280
231.140.140.223,<->,215.158.239.48,0,0,70,5242,70,5242,0.727754000,1.1156
136.114.101.44,<->,136.25.188.58,0,0,70,91805,70,91805,0.509863000,1.3098
220.28.73.211,<->,215.158.238.202,0,0,70,97590,70,97590,0.490562000,0.6070
192.228.25.170,<->,133.178.226.213,0,0,70,102694,70,102694,0.327993000,1.5540
192.205.47.20,<->,133.178.226.234,0,0,70,102405,70,102405,0.265278000,1.6970
220.28.109.52,<->,136.25.188.58,0,0,70,91863,70,91863,0.198169000,1.3563
127.225.105.102,<->,99.75.239.37,0,0,70,104720,70,104720,0.185408000,1.7219
220.28.73.211,<->,215.158.238.68,0,0,70,88532,70,88532,0.170285000,0.8933
215.158.133.55,<->,98.128.150.163,0,0,70,14504,70,14504,0.169776000,1.7282
204.2.215.122,<->,136.25.188.176,0,0,70,4342,70,4342,0.138983000,1.8426
213.186.52.38,<->,50.224.105.37,0,0,70,3920,70,3920,0.075772000,1.0983
43.52.16.142,<->,8.252.222.96,0,0,70,4576,70,4576,0.063978000,1.8381
215.158.30.165,<->,8.252.222.155,0,0,70,92653,70,92653,0.055870000,1.5743
215.158.238.176,<->,8.191.7.104,70,21245,0,0,70,21245,0.048246000,1.9425
146.249.227.17,<->,8.252.222.209,0,0,70,4408,70,4408,0.028590000,1.9599
215.158.239.99,<->,199.20.30.23,70,3500,0,0,70,3500,0.012270000,0.5200
220.28.85.14,<->,136.25.188.57,0,0,69,93629,69,93629,1.330109000,0.2576
108.150.35.124,<->,8.52.188.25,0,0,69,3943,69,3943,0.388288000,0.9269
133.178.226.201,<->,96.114.3.86,69,81466,0,0,69,81466,0.084060000,1.5603
136.25.189.38,<->,96.156.169.216,69,83014,0,0,69,83014,0.041753000,1.7562
207.61.121.39,<->,136.25.188.236,0,0,69,3450,69,3450,0.037407000,0.9459
159.162.41.250,<->,8.182.251.42,0,0,69,7128,69,7128,0.029732000,1.9137
133.54.16.199,<->,121.213.100.244,69,4158,0,0,69,4158,0.001992000,0.8160
220.28.73.211,<->,215.158.238.200,0,0,68,96914,68,96914,1.567257000,0.2150
215.158.140.167,<->,8.191.6.69,68,4940,0,0,68,4940,0.772878000,0.1845
159.215.65.177,<->,136.25.188.212,0,0,68,94467,68,94467,0.652831000,0.8652
136.25.189.36,<->,96.156.169.204,68,79841,0,0,68,79841,0.359794000,1.3837
215.158.238.101,<->,0.195.237.14,68,92203,0,0,68,92203,0.303229000,0.8471
210.212.142.117,<->,80.27.158.215,0,0,68,6368,68,6368,0.088590000,1.1780
216.184.1.125,<->,8.252.222.170,0,0,68,82051,68,82051,0.056041000,1.5400
94.192.177.144,<->,8.252.222.4,0,0,68,4308,68,4308,0.035138000,1.8982
215.158.30.229,<->,8.252.222.32,0,0,68,81182,68,81182,0.034364000,1.5002
92.27.27.146,<->,48.110.5.37,68,94674,0,0,68,94674,0.015524000,1.9696
100.202.202.53,<->,8.183.18.70,0,0,68,4553,68,4553,0.013576000,0.7025
147.47.62.86,<->,8.252.221.236,0,0,68,5246,68,5246,0.012274000,1.9746
105.143.21.220,<->,0.195.210.42,0,0,68,3762,68,3762,0.008584000,1.3329
239.227.67.235,<->,221.102.56.29,68,93952,0,0,68,93952,0.007349000,1.9180
159.137.189.229,<->,19.195.138.181,68,3808,0,0,68,3808,0.003400000,1.5285
136.114.101.94,<->,136.25.188.194,0,0,67,91195,67,91195,0.942220000,0.6461
192.205.36.216,<->,136.25.188.164,0,0,67,88784,67,88784,0.474223000,1.5009
215.158.238.147,<->,98.219.126.140,67,87598,0,0,67,87598,0.232711000,1.2185
200.175.32.151,<->,53.68.64.193,67,4616,0,0,67,4616,0.181322000,1.8133
215.158.239.73,<->,100.224.166.120,67,91234,0,0,67,91234,0.097045000,1.5898
138.45.90.179,<->,136.25.188.235,0,0,67,87082,67,87082,0.074922000,1.4835
215.158.6.140,<->,8.252.222.249,0,0,67,82884,67,82884,0.054757000,1.7603
215.158.238.64,<->,29.211.6.17,67,14765,0,0,67,14765,0.050484000,1.9478
104.158.109.20,<->,92.168.217.245,0,0,67,3752,67,3752,0.038119000,1.3940
230.156.245.179,<->,8.252.222.240,0,0,67,4184,67,4184,0.030063000,1.9547
133.178.226.94,<->,100.120.38.6,67,78976,0,0,67,78976,0.029889000,1.5315
48.18.247.140,<->,8.252.221.198,0,0,67,4437,67,4437,0.021611000,1.0001
109.1.45.197,<->,99.167.41.210,67,11936,0,0,67,11936,0.016779000,1.9793
43.52.5.200,<->,8.252.222.115,0,0,67,4444,67,4444,0.014689000,1.9837
194.245.233.250,<->,8.252.222.227,0,0,67,3350,67,3350,0.011876000,1.9729
230.102.130.14,<->,133.178.227.198,0,0,67,20592,67,20592,0.000400000,1.9991
146.188.124.240,<->,39.23.131.210,0,0,66,4030,66,4030,1.944340000,0.0517
220.28.85.14,<->,136.25.188.229,0,0,66,89057,66,89057,0.934708000,1.0148
58.164.238.72,<->,0.195.210.33,0,0,66,4543,66,4543,0.919498000,1.0078
136.25.189.24,<->,100.216.78.145,66,78627,0,0,66,78627,0.403740000,1.4212
207.21.165.50,<->,8.252.222.176,0,0,66,4888,66,4888,0.239032000,1.0371
111.42.21.99,<->,8.176.8.69,0,0,66,25337,66,25337,0.144214000,1.7912
58.50.168.100,<->,8.252.222.110,0,0,66,4556,66,4556,0.110867000,1.8574
92.27.27.185,<->,27.233.131.196,66,3943,0,0,66,3943,0.078802000,1.6807
144.85.73.77,<->,53.75.173.116,66,3312,0,0,66,3312,0.059518000,1.8963
133.178.227.6,<->,100.216.78.145,66,71600,0,0,66,71600,0.056837000,1.5648
215.158.239.25,<->,215.158.127.166,66,77245,0,0,66,77245,0.055780000,1.8787
66.56.15.159,<->,8.252.221.207,0,0,66,3460,66,3460,0.055672000,1.8373
8.252.222.206,<->,4.122.181.134,66,4248,0,0,66,4248,0.022356000,1.9684
221.102.56.46,<->,192.64.90.213,0,0,66,93730,66,93730,0.007132000,0.1739
195.37.10.216,<->,50.223.3.228,0,0,66,3396,66,3396,0.003155000,1.9948
207.61.112.76,<->,136.25.188.178,0,0,66,4164,66,4164,0.003002000,0.9673
108.134.109.74,<->,8.37.200.100,65,90394,0,0,65,90394,1.424966000,0.4273
215.158.30.184,<->,8.252.222.57,0,0,65,81713,65,81713,1.080429000,0.5571
220.28.65.9,<->,215.158.238.111,0,0,65,83966,65,83966,0.429554000,0.8114
215.158.238.79,<->,98.219.126.140,65,82658,0,0,65,82658,0.388057000,1.5645
215.158.238.100,<->,0.195.253.228,65,90664,0,0,65,90664,0.339319000,0.8344
215.158.238.201,<->,98.219.126.140,65,85724,0,0,65,85724,0.165390000,1.4697
194.253.228.176,<->,8.252.222.197,0,0,65,3364,65,3364,0.127215000,1.8534
53.231.73.23,<->,48.54.81.68,0,0,65,95940,65,95940,0.064899000,1.7931
220.28.109.52,<->,136.25.188.235,0,0,65,84198,65,84198,0.053690000,1.1939
215.158.239.97,<->,199.122.59.17,65,5499,0,0,65,5499,0.037437000,1.9497
146.193.53.31,<->,8.252.222.240,0,0,65,3856,65,3856,0.036556000,1.9348
136.25.189.22,<->,96.156.169.210,65,69697,0,0,65,69697,0.035633000,1.7146
215.158.238.82,<->,29.211.6.62,65,10918,0,0,65,10918,0.028939000,1.8174
53.231.85.213,<->,48.54.81.68,0,0,65,95940,65,95940,0.022418000,1.8397
8.252.222.197,<->,4.123.58.139,65,4656,0,0,65,4656,0.017460000,1.4856
76.179.22.32,<->,8.252.222.77,0,0,65,3940,65,3940,0.016955000,1.8929
220.28.114.28,<->,215.158.140.95,0,0,65,78528,65,78528,0.014885000,1.4753
144.85.170.246,<->,17.96.105.115,65,3640,0,0,65,3640,0.012727000,1.9384
136.25.188.174,<->,126.219.194.182,65,18784,0,0,65,18784,0.009094000,1.9549
43.52.38.161,<->,8.252.222.125,0,0,65,4000,65,4000,0.004571000,1.9903
215.158.238.115,<->,215.158.42.151,65,5133,0,0,65,5133,0.002553000,0.9793
215.158.239.5,<->,119.116.213.29,64,3330,0,0,64,3330,0.189547000,1.7927
204.60.234.12,<->,136.25.188.173,0,0,64,13825,64,13825,0.186547000,1.7595
139.163.161.17,<->,136.25.188.58,0,0,64,72795,64,72795,0.124750000,1.7509
136.25.188.160,<->,8.222.212.59,64,9413,0,0,64,9413,0.084786000,1.7010
136.25.188.38,<->,56.19.241.69,64,81133,0,0,64,81133,0.078394000,1.5969
98.3.249.220,<->,92.27.219.207,0,0,64,89344,64,89344,0.064302000,1.9074
136.25.188.249,<->,80.57.208.50,64,85341,0,0,64,85341,0.044731000,0.6223
48.16.77.152,<->,8.252.222.125,0,0,64,4200,64,4200,0.025652000,1.9694
224.250.33.165,<->,109.222.230.140,0,0,64,18634,64,18634,0.014003000,1.9515
217.48.45.61,<->,109.222.212.23,0,0,64,67028,64,67028,0.013661000,1.9801
194.222.45.226,<->,99.72.129.28,0,0,64,3430,64,3430,0.012550000,1.9522
136.25.189.193,<->,53.231.140.159,63,88888,0,0,63,88888,1.497153000,0.4715
215.158.30.240,<->,8.252.222.189,0,0,63,81511,63,81511,1.430235000,0.4512
8.182.230.134,<->,6.133.233.121,63,5059,0,0,63,5059,1.300557000,0.6480
220.28.109.52,<->,136.25.188.167,0,0,63,81949,63,81949,0.791651000,0.8343
159.215.65.128,<->,136.25.188.201,0,0,63,76196,63,76196,0.584302000,1.2165
215.158.238.91,<->,100.120.38.6,63,75929,0,0,63,75929,0.531243000,0.9641
89.183.104.233,<->,42.145.216.142,63,88981,0,0,63,88981,0.275654000,1.7000
215.158.239.46,<->,100.224.202.145,63,77700,0,0,63,77700,0.261789000,1.3691
215.158.239.84,<->,195.6.27.157,63,7704,0,0,63,7704,0.181188000,1.7436
136.25.188.201,<->,96.155.60.255,63,84709,0,0,63,84709,0.175013000,1.6290
220.28.65.9,<->,215.158.239.81,0,0,63,86381,63,86381,0.064991000,1.4204
215.158.238.126,<->,100.216.78.145,63,85284,0,0,63,85284,0.047868000,1.4371
152.40.76.34,<->,8.252.222.176,0,0,63,3772,63,3772,0.046373000,1.8401
220.28.109.52,<->,136.25.188.233,0,0,63,80646,63,80646,0.044676000,1.8471
222.244.167.142,<->,8.52.188.77,0,0,63,5193,63,5193,0.039625000,1.5130
121.209.129.56,<->,97.126.89.196,0,0,63,91192,63,91192,0.022373000,1.9384
133.54.43.74,<->,118.118.68.253,63,3528,0,0,63,3528,0.000396000,0.4220
220.28.114.28,<->,136.25.189.21,0,0,62,84565,62,84565,1.347970000,0.3502
220.28.65.9,<->,215.158.238.131,0,0,62,77072,62,77072,1.145131000,0.7671
192.205.47.11,<->,133.178.226.198,0,0,62,91880,62,91880,0.903562000,1.0364
192.204.170.244,<->,133.178.226.80,0,0,62,6121,62,6121,0.687791000,0.4842
133.178.227.14,<->,8.53.216.63,62,5914,0,0,62,5914,0.641470000,1.3567
215.158.34.7,<->,8.252.222.42,0,0,62,60972,62,60972,0.598625000,1.1581
133.178.227.60,<->,133.56.180.1,62,83491,0,0,62,83491,0.467633000,1.3858
247.136.153.249,<->,126.198.78.25,62,3118,0,0,62,3118,0.335691000,1.5954
207.102.130.131,<->,8.252.222.187,0,0,62,4849,62,4849,0.272494000,1.5003
136.25.188.220,<->,131.1.195.247,62,15827,0,0,62,15827,0.248613000,1.7501
192.67.175.129,<->,117.85.5.33,62,92752,0,0,62,92752,0.133900000,1.7680
159.137.255.155,<->,38.225.228.13,62,3100,0,0,62,3100,0.099259000,1.8852
192.229.43.48,<->,133.178.227.242,0,0,62,20235,62,20235,0.061128000,1.7896
158.156.107.86,<->,92.27.219.150,0,0,62,19062,62,19062,0.050543000,1.8605
220.28.114.28,<->,136.25.189.25,0,0,62,63394,62,63394,0.045452000,1.8626
144.70.194.19,<->,107.127.56.45,62,12632,0,0,62,12632,0.038739000,1.9464
144.75.218.237,<->,8.222.218.198,62,7585,0,0,62,7585,0.031651000,1.9457
210.235.164.125,<->,97.4.43.222,62,78206,0,0,62,78206,0.025903000,0.9094
92.28.243.121,<->,80.41.50.144,0,0,62,72447,62,72447,0.022882000,1.9101
207.62.191.87,<->,136.25.188.177,0,0,62,5378,62,5378,0.022193000,1.8453
76.179.57.173,<->,8.252.222.110,0,0,62,3892,62,3892,0.020949000,1.9242
220.28.109.52,<->,136.25.188.192,0,0,62,81314,62,81314,0.019686000,1.4256
92.168.217.228,<->,50.136.174.70,62,3556,0,0,62,3556,0.015983000,1.9771
207.178.235.42,<->,102.50.97.18,0,0,62,62341,62,62341,0.008476000,1.9907
133.178.227.16,<->,133.56.180.83,62,22353,0,0,62,22353,0.002879000,1.9600
218.113.73.124,<->,109.222.221.183,0,0,62,3100,62,3100,0.001178000,1.9714
215.158.140.95,<->,98.219.126.140,61,85268,0,0,61,85268,1.651277000,0.0882
220.55.111.131,<->,8.222.6.110,61,87133,0,0,61,87133,1.487791000,0.3707
215.158.238.209,<->,131.36.105.41,61,4894,0,0,61,4894,1.295515000,0.6603
220.28.114.28,<->,215.158.239.88,0,0,61,82237,61,82237,1.130127000,0.3507
136.114.101.93,<->,136.25.188.48,0,0,61,85677,61,85677,1.060796000,0.1934
136.25.188.169,<->,98.219.126.175,61,84031,0,0,61,84031,0.763759000,0.8317
207.59.30.197,<->,136.25.188.225,0,0,61,3687,61,3687,0.729551000,0.8459
60.101.163.146,<->,8.252.222.222,0,0,61,4388,61,4388,0.561307000,1.3880
192.205.36.215,<->,136.25.188.164,0,0,61,77242,61,77242,0.399805000,1.4767
145.252.121.82,<->,117.35.156.71,61,3413,0,0,61,3413,0.386731000,0.6810
215.158.239.44,<->,8.222.48.156,61,71716,0,0,61,71716,0.155667000,1.6254
50.21.108.202,<->,8.228.212.91,0,0,61,13156,61,13156,0.130416000,1.6362
136.25.189.5,<->,96.156.169.239,61,68869,0,0,61,68869,0.116525000,1.6111
215.158.132.255,<->,8.252.223.67,0,0,61,78981,61,78981,0.113732000,1.1649
223.120.57.123,<->,8.252.222.93,0,0,61,3776,61,3776,0.081101000,1.8563
215.158.239.99,<->,196.89.201.121,61,4520,0,0,61,4520,0.066858000,1.9095
43.53.48.244,<->,8.252.222.4,0,0,61,4012,61,4012,0.046189000,1.8433
215.158.239.73,<->,97.174.232.166,61,73551,0,0,61,73551,0.044557000,1.9374
215.158.140.248,<->,100.216.78.145,61,71928,0,0,61,71928,0.041811000,1.9178
251.24.86.2,<->,8.252.222.179,0,0,61,5055,61,5055,0.040631000,1.3442
136.25.188.198,<->,29.214.108.150,61,28517,0,0,61,28517,0.036420000,1.8676
220.80.135.121,<->,124.58.171.117,61,91744,0,0,61,91744,0.029296000,1.9644
136.25.189.4,<->,96.156.169.178,61,71830,0,0,61,71830,0.025177000,1.5809
95.246.67.39,<->,8.252.221.223,0,0,61,3242,61,3242,0.021143000,1.9739
98.128.99.20,<->,92.27.209.220,0,0,61,7967,61,7967,0.018947000,1.9524
139.163.81.178,<->,17.71.161.34,61,10991,0,0,61,10991,0.016290000,1.9171
144.75.218.237,<->,8.222.218.204,61,7497,0,0,61,7497,0.005727000,1.9794
210.220.219.150,<->,53.231.195.207,61,84955,0,0,61,84955,0.005013000,0.1994
136.25.189.24,<->,96.156.169.209,61,68866,0,0,61,68866,0.002902000,1.5712
230.91.28.191,<->,192.64.218.144,0,0,61,3050,61,3050,0.001643000,1.9942
220.28.104.193,<->,133.178.227.61,0,0,60,79309,60,79309,0.848497000,1.0159
215.158.239.50,<->,204.3.178.49,60,4835,0,0,60,4835,0.707253000,1.0954
139.144.241.233,<->,98.67.154.32,0,0,60,30280,60,30280,0.592254000,1.2138
212.70.75.25,<->,133.178.226.19,0,0,60,5450,60,5450,0.582732000,1.3992
221.196.122.73,<->,136.25.188.226,0,0,60,3360,60,3360,0.471397000,1.2392
215.158.238.103,<->,98.219.126.140,60,78769,0,0,60,78769,0.407830000,1.5214
136.25.188.219,<->,96.155.61.30,60,71085,0,0,60,71085,0.344187000,1.6272
192.64.208.5,<->,99.169.47.255,60,26126,0,0,60,26126,0.291774000,1.6965
215.158.140.231,<->,33.209.217.8,60,9547,0,0,60,9547,0.280854000,1.6040
158.10.218.189,<->,92.27.219.33,0,0,60,15230,60,15230,0.225141000,1.6779
143.135.13.170,<->,136.25.188.46,0,0,60,3506,60,3506,0.138292000,1.2453
136.25.189.8,<->,96.156.169.238,60,72370,0,0,60,72370,0.128065000,1.3570
200.175.197.249,<->,53.167.66.5,60,3836,0,0,60,3836,0.119424000,1.7566
192.64.227.200,<->,0.239.41.218,60,3414,0,0,60,3414,0.113670000,1.8328
156.152.195.35,<->,8.252.221.198,0,0,60,3334,60,3334,0.111695000,1.7309
136.25.188.245,<->,56.97.186.148,60,78414,0,0,60,78414,0.110883000,0.7638
247.136.136.4,<->,109.110.71.152,60,85040,0,0,60,85040,0.077890000,1.8656
43.52.205.17,<->,8.252.222.149,0,0,60,5693,60,5693,0.071667000,1.1214
220.28.109.52,<->,136.25.188.232,0,0,60,69511,60,69511,0.053422000,1.6253
144.79.8.124,<->,92.27.219.243,0,0,60,40355,60,40355,0.022155000,1.9696
92.27.27.188,<->,42.94.211.47,60,83760,0,0,60,83760,0.021592000,1.9296
246.108.106.71,<->,111.147.76.11,0,0,60,90240,60,90240,0.016651000,1.9485
215.158.238.251,<->,8.191.7.104,60,14317,0,0,60,14317,0.014570000,1.9394
76.179.55.94,<->,8.252.222.127,0,0,60,3648,60,3648,0.012488000,1.8658
8.252.222.68,<->,4.120.142.77,60,3940,0,0,60,3940,0.009170000,1.8963
143.22.102.185,<->,8.182.248.147,0,0,59,3367,59,3367,1.175527000,0.7987
202.232.100.249,<->,92.168.217.252,0,0,59,3804,59,3804,0.577654000,1.3483
246.254.97.112,<->,132.105.33.215,59,84979,0,0,59,84979,0.457506000,0.1593
144.87.238.91,<->,8.182.224.87,0,0,59,6112,59,6112,0.176754000,1.1483
116.92.246.189,<->,92.27.219.207,0,0,59,3068,59,3068,0.110482000,1.4687
220.28.114.28,<->,215.158.239.90,0,0,59,77110,59,77110,0.096807000,1.8703
220.50.242.213,<->,215.158.239.104,0,0,59,64960,59,64960,0.085011000,1.8402
136.25.188.160,<->,8.222.7.23,59,20954,0,0,59,20954,0.072463000,1.8666
220.39.233.182,<->,215.158.238.66,0,0,59,17311,59,17311,0.047582000,1.9223
223.120.123.74,<->,8.252.222.6,0,0,59,3676,59,3676,0.047425000,1.9451
195.42.83.49,<->,136.25.188.177,0,0,59,3446,59,3446,0.032928000,1.7990
215.158.238.95,<->,131.1.195.229,59,14578,0,0,59,14578,0.029028000,1.8524
207.22.224.140,<->,0.195.210.14,0,0,59,3396,59,3396,0.025271000,1.8545
144.75.218.233,<->,8.222.218.204,59,7342,0,0,59,7342,0.022204000,1.9678
215.158.239.79,<->,204.21.59.9,59,3136,0,0,59,3136,0.017395000,1.9599
220.28.108.254,<->,133.178.227.45,0,0,59,80997,59,80997,0.015392000,1.3653
66.63.229.89,<->,8.252.221.198,0,0,59,3320,59,3320,0.013330000,1.8974
117.73.204.10,<->,80.41.58.244,0,0,59,7112,59,7112,0.013080000,1.9523
215.158.238.153,<->,122.158.69.69,59,25826,0,0,59,25826,0.012355000,1.9834
136.25.188.195,<->,97.174.232.254,59,71471,0,0,59,71471,0.008430000,1.2708
127.101.167.95,<->,89.183.104.147,0,0,59,83472,59,83472,0.007190000,1.9813
215.158.140.173,<->,8.222.7.183,58,5287,0,0,58,5287,1.455629000,0.3741
215.158.30.252,<->,136.25.188.234,0,0,58,77375,58,77375,0.934094000,0.4937
215.158.238.240,<->,122.158.245.22,58,4327,0,0,58,4327,0.628968000,0.8464
97.22.56.160,<->,8.183.24.211,0,0,58,8612,58,8612,0.564512000,0.9950
92.27.219.175,<->,36.108.153.8,58,77524,0,0,58,77524,0.491906000,1.4443
215.158.238.128,<->,100.120.38.6,58,72531,0,0,58,72531,0.272835000,1.6831
144.64.138.107,<->,129.254.101.205,58,3043,0,0,58,3043,0.190908000,0.1678
215.158.238.124,<->,100.120.38.6,58,74504,0,0,58,74504,0.143226000,1.7570
136.25.189.37,<->,96.156.169.239,58,66024,0,0,58,66024,0.125647000,1.8660
122.140.135.247,<->,89.183.104.135,0,0,58,3058,58,3058,0.099621000,1.7454
199.54.17.239,<->,8.182.224.87,0,0,58,3843,58,3843,0.098026000,0.7302
246.253.253.211,<->,143.120.91.175,58,8738,0,0,58,8738,0.086423000,1.9019
133.178.227.36,<->,133.56.180.46,58,57744,0,0,58,57744,0.040233000,1.9571
215.188.8.186,<->,136.25.189.215,0,0,58,66449,58,66449,0.038655000,0.5974
136.25.189.4,<->,96.156.169.196,58,66991,0,0,58,66991,0.027490000,1.8416
133.178.227.27,<->,133.56.180.83,58,27430,0,0,58,27430,0.016377000,1.9632
103.248.168.73,<->,92.27.209.222,0,0,58,7532,58,7532,0.009390000,1.9875
223.115.8.166,<->,8.252.222.224,0,0,58,3600,58,3600,0.006490000,1.9753
136.25.188.251,<->,97.174.232.234,57,76603,0,0,57,76603,1.547593000,0.3720
215.158.239.48,<->,143.42.77.148,57,4892,0,0,57,4892,0.904651000,1.0700
136.114.101.37,<->,136.25.188.51,0,0,57,67338,57,67338,0.765576000,1.2046
139.163.167.27,<->,133.178.227.245,0,0,57,13899,57,13899,0.705410000,0.2916
215.158.239.83,<->,98.219.126.140,57,65111,0,0,57,65111,0.528686000,1.4600
100.230.43.160,<->,50.224.72.12,0,0,57,6719,57,6719,0.379242000,1.0164
220.28.114.28,<->,215.158.238.252,0,0,57,82129,57,82129,0.378238000,0.1213
215.158.61.209,<->,97.126.31.89,0,0,57,83122,57,83122,0.372263000,0.0011
220.28.104.193,<->,136.25.188.228,0,0,57,71806,57,71806,0.335564000,1.4747
136.25.188.231,<->,56.28.207.204,57,72565,0,0,57,72565,0.320021000,1.1931
195.127.73.197,<->,136.25.188.238,0,0,57,3084,57,3084,0.225502000,0.7971
207.56.138.208,<->,136.25.188.253,0,0,57,5547,57,5547,0.218735000,1.6800
215.158.239.92,<->,194.232.182.203,57,4935,0,0,57,4935,0.194494000,1.5858
215.158.61.253,<->,99.74.26.170,0,0,57,83092,57,83092,0.185198000,0.3726
43.52.5.200,<->,8.252.222.226,0,0,57,3532,57,3532,0.120311000,1.8228
207.82.158.203,<->,50.223.3.228,0,0,57,2850,57,2850,0.116256000,1.5487
245.161.124.43,<->,8.252.222.211,0,0,57,3375,57,3375,0.109705000,0.6584
207.72.122.121,<->,8.252.222.236,0,0,57,2850,57,2850,0.086934000,1.8230
215.158.140.216,<->,215.158.58.162,57,83043,0,0,57,83043,0.082204000,0.0013
112.8.13.194,<->,50.224.49.213,0,0,57,3288,57,3288,0.075039000,1.8224
48.16.225.173,<->,8.252.222.96,0,0,57,3636,57,3636,0.063079000,1.9323
94.192.240.66,<->,8.252.222.93,0,0,57,3504,57,3504,0.051508000,1.8630
197.125.126.250,<->,136.25.188.210,0,0,57,8252,57,8252,0.049554000,1.8633
102.249.242.199,<->,8.228.218.233,0,0,57,47251,57,47251,0.046141000,1.4708
118.209.218.71,<->,89.183.104.141,0,0,57,75784,57,75784,0.034736000,1.8283
223.114.235.77,<->,8.252.222.4,0,0,57,3912,57,3912,0.034539000,1.9335
220.18.60.199,<->,92.27.209.213,0,0,57,7061,57,7061,0.033653000,1.9470
112.11.52.77,<->,50.224.49.213,0,0,57,3464,57,3464,0.016601000,1.8762
92.27.27.149,<->,14.27.123.221,57,80484,0,0,57,80484,0.010502000,1.9085
192.67.175.129,<->,117.93.12.57,57,84926,0,0,57,84926,0.006497000,1.9811
199.80.178.34,<->,136.25.188.222,0,0,57,4229,57,4229,0.003819000,1.9942
210.221.109.12,<->,60.100.96.242,57,10392,0,0,57,10392,0.003766000,1.9676
215.158.239.93,<->,207.61.73.223,56,5592,0,0,56,5592,1.366668000,0.6193
159.248.57.134,<->,136.25.188.209,0,0,56,3536,56,3536,1.016365000,0.4191
117.33.13.193,<->,92.168.217.228,0,0,56,3420,56,3420,0.829220000,1.1411
133.178.227.242,<->,80.57.208.190,56,8244,0,0,56,8244,0.771437000,0.7546
216.184.2.48,<->,136.25.188.213,0,0,56,71320,56,71320,0.730289000,1.2155
66.47.141.130,<->,8.252.222.150,0,0,56,5162,56,5162,0.662403000,1.2956
246.253.235.153,<->,33.209.218.85,56,4722,0,0,56,4722,0.574669000,1.4019
140.68.8.29,<->,92.168.217.228,0,0,56,3280,56,3280,0.412154000,1.5726
136.25.189.43,<->,96.156.169.209,56,74867,0,0,56,74867,0.394122000,1.5932
215.158.239.51,<->,199.121.171.59,56,5453,0,0,56,5453,0.289250000,1.4327
133.178.227.134,<->,8.191.15.133,56,3160,0,0,56,3160,0.281284000,0.1542
215.158.238.236,<->,126.219.246.252,56,6335,0,0,56,6335,0.261412000,1.3866
246.108.107.182,<->,80.40.4.150,0,0,56,31137,56,31137,0.159746000,1.7888
207.58.236.23,<->,136.25.188.255,0,0,56,4991,56,4991,0.138649000,1.5532
136.25.188.169,<->,56.97.186.164,56,79633,0,0,56,79633,0.135586000,1.7456
133.178.226.66,<->,98.219.126.140,56,59584,0,0,56,59584,0.134393000,1.3187
133.178.226.61,<->,112.220.206.18,56,20406,0,0,56,20406,0.109813000,1.7307
220.28.114.28,<->,133.178.226.67,0,0,56,61989,56,61989,0.096888000,1.8392
220.28.85.14,<->,215.158.238.216,0,0,56,75001,56,75001,0.055077000,0.0293
216.184.1.203,<->,99.74.26.99,0,0,56,34319,56,34319,0.046330000,1.9480
204.60.76.43,<->,136.25.188.238,0,0,56,5554,56,5554,0.041247000,1.9586
197.125.126.244,<->,136.25.188.160,0,0,56,7796,56,7796,0.032438000,1.8202
136.25.189.36,<->,96.156.169.209,56,58933,0,0,56,58933,0.031243000,1.7605
204.130.124.99,<->,8.252.222.177,0,0,56,4923,56,4923,0.023565000,1.9680
205.127.108.115,<->,33.233.141.107,0,0,56,57880,56,57880,0.023497000,1.9637
58.203.221.215,<->,8.252.221.222,0,0,56,3516,56,3516,0.015091000,1.8251
202.124.191.178,<->,8.252.222.227,0,0,56,3632,56,3632,0.013955000,1.9349
144.75.218.237,<->,120.155.84.97,56,8591,0,0,56,8591,0.012610000,1.9771
92.42.46.202,<->,92.27.209.220,0,0,56,7436,56,7436,0.009826000,1.9837
97.120.1.114,<->,92.27.209.212,0,0,56,6633,56,6633,0.009033000,1.9863
213.186.59.159,<->,144.85.170.246,0,0,56,3136,56,3136,0.008261000,0.7354
148.157.186.140,<->,80.40.40.164,0,0,56,3082,56,3082,0.007118000,1.9926
194.195.226.234,<->,100.92.202.0,0,0,56,82336,56,82336,0.006609000,1.8975
215.158.238.96,<->,192.204.170.244,56,3724,0,0,56,3724,0.001719000,0.5115
144.85.170.246,<->,17.151.209.221,56,3888,0,0,56,3888,0.001392000,1.9152
109.222.221.90,<->,53.231.66.9,56,2800,0,0,56,2800,0.001062000,1.8180
220.28.104.193,<->,215.158.238.131,0,0,55,70163,55,70163,1.268968000,0.6990
251.122.143.50,<->,8.220.186.82,0,0,55,2940,55,2940,0.862955000,0.7566
136.114.101.87,<->,136.25.188.194,0,0,55,71040,55,71040,0.808319000,1.0654
75.31.153.171,<->,8.252.221.222,0,0,55,3089,55,3089,0.623753000,0.3598
220.28.85.14,<->,215.158.140.80,0,0,55,69705,55,69705,0.464475000,1.4226
215.158.239.123,<->,111.151.142.182,55,3080,0,0,55,3080,0.446124000,0.1950
133.178.226.56,<->,100.120.38.6,55,63077,0,0,55,63077,0.278205000,1.6046
138.74.30.197,<->,89.90.107.236,55,19621,0,0,55,19621,0.153135000,1.8320
222.65.22.130,<->,215.158.33.122,55,79662,0,0,55,79662,0.145006000,1.2820
101.67.162.237,<->,8.52.187.74,0,0,55,3136,55,3136,0.131877000,1.8076
215.158.238.128,<->,0.195.237.14,55,74361,0,0,55,74361,0.131356000,1.6196
220.28.85.14,<->,215.158.239.53,0,0,55,73106,55,73106,0.111273000,1.8807
197.113.99.242,<->,136.25.188.243,0,0,55,5503,55,5503,0.098743000,1.8804
144.71.47.61,<->,130.206.82.106,55,3778,0,0,55,3778,0.090353000,1.8813
136.25.189.37,<->,96.156.169.207,55,52563,0,0,55,52563,0.079654000,1.5931
60.101.77.172,<->,8.252.222.110,0,0,55,3716,55,3716,0.078560000,1.6645
146.193.21.244,<->,8.252.222.125,0,0,55,3392,55,3392,0.075485000,1.8211
215.158.140.93,<->,8.53.216.233,55,9452,0,0,55,9452,0.073174000,1.8778
100.228.42.147,<->,100.168.37.238,55,20554,0,0,55,20554,0.048038000,1.9489
215.158.238.130,<->,0.195.237.14,55,73177,0,0,55,73177,0.043392000,1.8252
133.178.227.76,<->,133.56.180.89,55,14800,0,0,55,14800,0.043076000,1.3501
223.114.121.9,<->,8.252.222.211,0,0,55,3448,55,3448,0.036562000,1.9252
207.51.228.54,<->,8.252.222.225,0,0,55,4023,55,4023,0.030132000,1.9511
215.158.239.87,<->,29.211.228.203,55,11610,0,0,55,11610,0.028812000,1.9454
92.27.209.173,<->,82.155.227.130,55,8112,0,0,55,8112,0.024845000,1.9703
222.12.110.202,<->,92.27.209.213,0,0,55,6246,55,6246,0.023981000,1.9509
230.102.130.22,<->,133.178.227.216,0,0,55,16191,55,16191,0.019502000,1.9601
144.75.218.237,<->,8.222.218.207,55,6981,0,0,55,6981,0.018862000,1.9730
153.111.185.57,<->,8.252.223.34,0,0,55,3448,55,3448,0.017669000,1.8893
142.248.24.89,<->,136.25.188.253,0,0,55,3080,55,3080,0.015675000,0.2833
230.102.130.20,<->,133.178.227.200,0,0,55,36324,55,36324,0.013446000,1.9480
215.158.239.66,<->,100.224.166.158,55,72854,0,0,55,72854,0.011817000,1.9418
103.6.186.36,<->,92.27.209.217,0,0,55,6404,55,6404,0.009975000,1.9500
195.5.40.209,<->,136.25.188.242,0,0,55,2750,55,2750,0.007886000,1.7812
133.178.226.85,<->,96.155.60.211,55,45264,0,0,55,45264,0.005334000,1.8922
195.108.176.204,<->,50.223.3.228,0,0,55,2750,55,2750,0.002022000,1.9712
232.31.177.109,<->,92.27.8.136,0,0,54,78215,54,78215,1.278980000,0.7030
247.136.187.136,<->,110.85.114.41,54,2808,0,0,54,2808,0.958450000,1.0177
123.153.228.199,<->,92.162.252.74,0,0,54,80334,54,80334,0.574756000,0.2081
215.158.34.33,<->,8.252.222.42,0,0,54,58783,54,58783,0.561584000,0.4473
54.69.58.221,<->,8.176.8.238,0,0,54,73842,54,73842,0.502948000,1.3589
220.20.200.97,<->,35.107.149.134,54,78110,0,0,54,78110,0.485882000,0.7683
215.158.239.74,<->,8.222.48.156,54,63634,0,0,54,63634,0.428469000,1.4087
136.25.189.52,<->,96.156.169.210,54,57574,0,0,54,57574,0.417245000,1.4822
136.25.189.40,<->,96.156.169.199,54,64445,0,0,54,64445,0.339672000,1.5024
69.243.197.158,<->,8.252.221.236,0,0,54,3282,54,3282,0.330125000,1.3594
117.0.224.112,<->,92.27.27.166,0,0,54,30024,54,30024,0.321268000,1.4763
133.178.226.38,<->,69.132.194.168,54,7968,0,0,54,7968,0.274263000,1.5998
200.174.154.235,<->,54.38.214.95,54,73574,0,0,54,73574,0.263739000,1.5213
192.205.36.227,<->,136.25.188.166,0,0,54,66573,54,66573,0.243964000,1.3891
215.158.239.44,<->,100.224.167.70,54,65023,0,0,54,65023,0.196738000,1.7166
116.74.122.224,<->,92.27.27.175,0,0,54,2958,54,2958,0.196163000,1.6581
136.25.188.46,<->,126.219.247.24,54,7668,0,0,54,7668,0.190410000,1.5359
220.28.108.254,<->,133.178.227.21,0,0,54,63070,54,63070,0.174576000,1.7966
215.158.239.89,<->,139.69.162.50,54,69080,0,0,54,69080,0.160064000,1.6046
94.195.108.236,<->,92.168.217.229,0,0,54,3548,54,3548,0.158747000,1.7935
215.158.239.217,<->,56.19.241.86,54,67220,0,0,54,67220,0.133644000,1.4970
220.28.114.28,<->,133.178.226.8,0,0,54,70081,54,70081,0.060425000,1.3011
215.158.239.56,<->,142.244.89.142,54,3741,0,0,54,3741,0.047390000,1.7974
43.52.162.153,<->,8.252.221.206,0,0,54,7351,54,7351,0.046840000,1.9258
145.158.254.247,<->,133.178.227.227,0,0,54,3074,54,3074,0.046326000,1.8812
92.27.209.115,<->,92.2.166.138,54,6048,0,0,54,6048,0.025765000,1.9520
144.85.170.246,<->,98.87.147.28,54,3024,0,0,54,3024,0.016731000,1.9800
110.88.88.65,<->,92.27.209.213,0,0,54,8701,54,8701,0.010973000,1.9580
246.253.253.107,<->,109.203.238.95,54,42898,0,0,54,42898,0.007809000,0.0042
215.158.238.92,<->,145.213.62.41,53,4185,0,0,53,4185,1.558708000,0.2143
215.158.239.55,<->,100.224.202.145,53,70102,0,0,53,70102,0.779438000,0.8859
224.213.229.201,<->,109.222.200.21,0,0,53,45897,53,45897,0.625723000,1.0862
94.192.74.64,<->,8.252.222.227,0,0,53,3448,53,3448,0.615620000,1.3843
204.200.38.213,<->,136.25.188.162,0,0,53,4614,53,4614,0.561087000,1.0816
220.28.115.46,<->,215.158.238.131,0,0,53,69172,53,69172,0.450954000,0.4684
136.25.188.234,<->,106.188.183.102,53,62175,0,0,53,62175,0.282470000,0.8350
136.25.188.223,<->,131.1.232.163,53,8412,0,0,53,8412,0.268984000,1.4252
140.81.105.230,<->,80.38.12.219,0,0,53,9384,53,9384,0.176290000,1.7392
139.69.162.56,<->,8.252.222.169,0,0,53,57385,53,57385,0.167700000,1.6420
136.25.189.25,<->,96.156.169.239,53,58372,0,0,53,58372,0.150564000,1.5929
36.116.252.155,<->,8.252.222.21,0,0,53,3404,53,3404,0.084781000,1.7865
48.16.229.134,<->,8.252.222.204,0,0,53,3304,53,3304,0.083786000,1.8504
136.25.188.208,<->,126.219.247.70,53,8881,0,0,53,8881,0.058676000,1.9407
95.246.196.134,<->,8.252.222.44,0,0,53,4052,53,4052,0.054513000,0.8646
220.28.114.28,<->,215.158.238.234,0,0,53,69238,53,69238,0.040148000,1.2836
215.158.239.232,<->,100.244.13.12,53,14652,0,0,53,14652,0.035680000,1.9587
8.252.222.79,<->,4.133.101.161,53,3232,0,0,53,3232,0.034168000,1.8437
136.25.188.211,<->,106.188.236.151,53,9197,0,0,53,9197,0.031049000,1.8741
108.38.132.20,<->,92.27.209.140,0,0,53,7088,53,7088,0.029269000,1.9654
226.61.137.133,<->,92.27.209.217,0,0,53,6861,53,6861,0.026502000,1.9480
69.242.154.60,<->,8.252.222.98,0,0,53,3256,53,3256,0.022318000,1.9374
152.105.138.44,<->,8.252.222.197,0,0,53,3352,53,3352,0.016258000,1.8826
95.169.4.16,<->,8.252.221.206,0,0,53,2742,53,2742,0.015657000,1.8877
120.175.132.220,<->,80.41.8.194,0,0,53,20542,53,20542,0.004926000,1.9114
76.184.164.153,<->,8.252.222.210,0,0,53,2650,53,2650,0.002221000,1.9727
195.15.219.41,<->,136.25.188.226,0,0,53,5311,53,5311,0.001691000,0.6662
146.193.10.139,<->,8.252.222.77,0,0,53,3520,53,3520,0.000283000,1.9137
159.162.41.223,<->,8.182.244.237,0,0,52,4335,52,4335,1.274518000,0.4420
220.28.108.254,<->,215.158.238.90,0,0,52,65547,52,65547,1.227927000,0.7618
199.121.240.240,<->,136.25.188.163,0,0,52,3621,52,3621,0.921251000,1.0778
235.42.34.23,<->,133.178.226.37,0,0,52,5402,52,5402,0.760148000,0.8313
215.158.238.201,<->,98.219.126.175,52,64324,0,0,52,64324,0.561670000,1.3831
215.158.140.187,<->,99.124.166.199,52,3049,0,0,52,3049,0.532321000,0.3586
136.25.188.229,<->,100.224.166.158,52,68740,0,0,52,68740,0.489940000,0.7662
215.158.239.70,<->,207.213.95.31,52,6142,0,0,52,6142,0.470497000,1.4801
206.243.235.195,<->,92.27.8.96,0,0,52,54471,52,54471,0.306649000,1.3362
215.158.239.75,<->,8.222.48.162,52,61362,0,0,52,61362,0.236868000,1.6786
220.28.108.254,<->,136.25.188.195,0,0,52,70337,52,70337,0.226243000,1.3157
215.158.239.97,<->,199.51.155.93,52,2935,0,0,52,2935,0.189199000,1.8048
220.28.85.14,<->,136.25.188.202,0,0,52,67727,52,67727,0.154593000,1.8337
223.120.25.52,<->,8.252.222.220,0,0,52,3312,52,3312,0.128698000,1.7016
136.25.188.233,<->,56.97.186.17,52,65299,0,0,52,65299,0.116953000,1.7206
53.231.73.173,<->,48.54.81.68,0,0,52,76752,52,76752,0.098885000,1.7847
80.40.59.129,<->,42.189.76.202,52,67942,0,0,52,67942,0.093338000,1.7391
43.52.125.64,<->,8.252.222.125,0,0,52,3224,52,3224,0.069872000,1.9181
95.245.148.135,<->,8.252.221.198,0,0,52,3320,52,3320,0.061000000,1.7949
200.10.139.145,<->,8.252.221.221,0,0,52,4078,52,4078,0.059026000,1.9399
144.75.218.235,<->,8.222.218.204,52,6314,0,0,52,6314,0.056269000,1.7796
113.38.210.86,<->,50.224.49.219,0,0,52,2912,52,2912,0.052766000,1.9280
121.14.135.231,<->,109.1.15.193,0,0,52,73604,52,73604,0.034397000,1.9550
136.25.189.62,<->,96.156.169.251,52,65970,0,0,52,65970,0.019388000,1.9365
110.50.143.159,<->,92.27.209.140,0,0,52,7584,52,7584,0.016999000,1.9505
215.158.239.95,<->,207.236.96.161,52,5455,0,0,52,5455,0.016369000,1.4236
133.178.227.16,<->,133.56.180.22,52,14989,0,0,52,14989,0.011074000,1.9545
247.157.15.209,<->,215.158.215.54,52,20270,0,0,52,20270,0.008978000,1.9899
117.58.118.162,<->,92.168.217.229,0,0,52,2912,52,2912,0.001520000,1.9356
215.158.238.66,<->,61.34.184.199,51,4125,0,0,51,4125,1.682518000,0.2957
220.183.137.190,<->,92.27.219.191,0,0,51,67844,51,67844,1.123685000,0.0640
136.25.188.203,<->,56.23.171.36,51,65533,0,0,51,65533,0.730239000,1.0553
215.158.239.69,<->,207.188.63.169,51,3743,0,0,51,3743,0.679811000,1.1117
140.138.86.221,<->,136.25.188.253,0,0,51,4045,51,4045,0.672095000,0.3373
220.38.84.250,<->,215.158.238.107,0,0,51,4677,51,4677,0.642991000,0.2598
136.25.188.194,<->,80.57.141.205,51,63177,0,0,51,63177,0.482282000,1.2161
220.28.115.46,<->,215.158.238.103,0,0,51,54194,51,54194,0.283594000,1.1266
136.138.112.246,<->,136.25.188.175,0,0,51,11239,51,11239,0.267878000,1.7116
133.178.226.66,<->,133.56.180.44,51,70473,0,0,51,70473,0.189793000,0.7973
215.158.239.94,<->,199.20.4.42,51,6864,0,0,51,6864,0.184047000,1.6695
215.158.238.70,<->,98.219.126.175,51,67906,0,0,51,67906,0.102798000,0.8812
204.61.243.184,<->,136.25.188.239,0,0,51,2856,51,2856,0.098761000,0.8199
144.75.218.237,<->,8.222.218.197,51,6488,0,0,51,6488,0.092605000,1.8364
43.52.158.41,<->,8.252.222.109,0,0,51,3132,51,3132,0.088796000,1.8675
194.253.92.242,<->,8.252.222.197,0,0,51,3745,51,3745,0.087774000,1.8944
94.192.0.164,<->,8.252.221.223,0,0,51,6866,51,6866,0.066449000,1.8012
223.115.87.241,<->,8.252.223.0,0,0,51,3440,51,3440,0.057204000,1.9301
92.168.217.215,<->,50.136.155.56,51,2976,0,0,51,2976,0.044595000,1.9534
192.67.152.25,<->,98.23.121.94,51,18639,0,0,51,18639,0.041236000,1.9466
215.158.238.177,<->,8.240.116.180,51,9974,0,0,51,9974,0.028776000,1.2918
220.28.65.9,<->,215.158.140.232,0,0,51,72735,51,72735,0.027809000,1.9232
200.10.139.4,<->,8.252.222.210,0,0,51,3120,51,3120,0.025149000,1.9509
220.28.85.14,<->,215.158.140.233,0,0,51,70031,51,70031,0.022273000,0.2375
136.25.188.177,<->,29.214.108.150,51,20676,0,0,51,20676,0.020055000,1.9721
201.139.229.136,<->,8.252.222.7,0,0,51,3176,51,3176,0.019266000,1.9743
220.28.115.46,<->,133.178.227.61,0,0,51,67967,51,67967,0.015972000,1.9307
136.25.188.57,<->,133.56.180.45,51,63088,0,0,51,63088,0.013054000,1.7622
246.254.97.107,<->,143.54.7.114,51,72624,0,0,51,72624,0.009810000,1.9363
199.70.21.14,<->,136.25.188.209,0,0,51,2550,51,2550,0.008853000,1.8881
203.214.74.80,<->,8.37.252.35,51,66818,0,0,51,66818,0.000244000,1.9013
220.28.115.46,<->,215.158.238.244,0,0,50,70599,50,70599,1.585642000,0.0667
215.158.61.208,<->,8.252.221.246,0,0,50,71763,50,71763,1.290333000,0.0291
136.25.188.238,<->,17.143.215.251,50,4751,0,0,50,4751,1.247482000,0.7522
136.25.189.62,<->,98.219.126.175,50,59813,0,0,50,59813,0.746293000,1.2305
220.28.109.52,<->,136.25.188.50,0,0,50,60009,50,60009,0.693029000,1.2027
136.25.188.49,<->,96.156.169.176,50,67966,0,0,50,67966,0.283815000,1.3626
137.137.105.184,<->,98.87.187.248,50,29549,0,0,50,29549,0.247715000,1.4265
194.232.178.85,<->,136.25.188.163,0,0,50,4213,50,4213,0.238621000,1.7264
215.158.238.196,<->,215.158.6.215,50,7925,0,0,50,7925,0.201366000,1.6567
220.28.85.14,<->,215.158.140.95,0,0,50,60590,50,60590,0.192972000,1.8007
220.28.114.28,<->,215.158.238.187,0,0,50,59301,50,59301,0.127723000,1.8605
60.100.19.114,<->,8.252.222.125,0,0,50,3368,50,3368,0.103287000,1.7992
144.86.150.152,<->,0.61.61.17,50,3203,0,0,50,3203,0.098963000,1.6087
207.56.48.141,<->,136.25.188.242,0,0,50,2812,50,2812,0.089376000,1.7345
133.54.17.104,<->,27.134.250.208,50,70078,0,0,50,70078,0.056760000,1.9369
199.32.229.83,<->,136.25.188.46,0,0,50,4520,50,4520,0.040404000,1.3943
92.168.217.183,<->,50.136.181.207,50,3057,0,0,50,3057,0.039878000,1.9444
133.178.227.61,<->,133.56.180.46,50,57600,0,0,50,57600,0.035196000,1.8055
204.185.76.235,<->,136.25.188.45,0,0,50,2934,50,2934,0.024939000,0.6119
194.232.127.157,<->,136.25.188.236,0,0,50,3025,50,3025,0.022294000,0.4911
221.102.123.31,<->,207.193.113.140,50,3000,0,0,50,3000,0.018415000,1.7153
101.70.117.204,<->,53.180.145.146,50,12410,0,0,50,12410,0.011157000,1.9311
199.72.89.13,<->,136.25.188.46,0,0,50,2578,50,2578,0.009728000,1.9715
220.55.175.209,<->,159.46.22.47,50,6688,0,0,50,6688,0.002166000,1.9744
159.137.222.214,<->,50.62.237.14,49,12092,0,0,49,12092,1.607904000,0.3196
144.75.218.248,<->,53.231.66.30,49,62113,0,0,49,62113,1.491135000,0.5060
43.52.205.49,<->,8.252.221.239,0,0,49,3596,49,3596,1.361613000,0.5997
216.184.1.82,<->,136.25.188.201,0,0,49,61175,49,61175,1.314784000,0.6433
138.0.9.133,<->,80.42.166.226,0,0,49,67806,49,67806,1.127005000,0.2982
75.214.101.131,<->,8.252.221.199,0,0,49,4314,49,4314,1.123293000,0.7797
215.158.239.45,<->,145.116.209.76,49,63322,0,0,49,63322,1.097525000,0.8045
215.158.239.35,<->,50.248.187.107,49,4023,0,0,49,4023,1.074213000,0.7477
136.114.101.65,<->,136.25.188.228,0,0,49,65371,49,65371,1.072459000,0.7007
129.236.115.197,<->,111.20.168.123,0,0,49,2777,49,2777,0.882502000,0.0201
215.158.238.41,<->,100.120.38.6,49,60806,0,0,49,60806,0.854404000,0.9381
199.50.209.190,<->,136.25.188.241,0,0,49,2993,49,2993,0.592792000,0.4649
220.28.73.211,<->,136.25.188.215,0,0,49,69436,49,69436,0.463484000,0.1418
215.201.235.99,<->,8.183.24.179,0,0,49,13192,49,13192,0.429738000,0.9448
136.25.188.200,<->,100.224.202.146,49,70490,0,0,49,70490,0.420328000,0.1898
246.253.134.201,<->,148.113.197.188,49,4435,0,0,49,4435,0.347827000,1.1721
133.178.227.37,<->,133.56.180.93,49,61974,0,0,49,61974,0.263298000,1.6953
136.25.189.40,<->,96.156.169.207,49,52142,0,0,49,52142,0.221633000,1.5594
215.158.239.75,<->,100.216.78.145,49,59613,0,0,49,59613,0.219505000,1.3456
92.168.217.252,<->,48.110.96.131,49,2744,0,0,49,2744,0.210717000,1.7775
215.158.239.25,<->,215.158.127.164,49,61000,0,0,49,61000,0.183892000,1.3731
215.158.239.93,<->,199.20.30.55,49,3555,0,0,49,3555,0.183584000,1.6202
136.25.188.254,<->,131.1.232.169,49,8721,0,0,49,8721,0.166618000,1.7918
230.156.218.57,<->,8.252.222.243,0,0,49,3156,49,3156,0.156745000,1.6205
215.158.238.92,<->,57.226.180.45,49,2756,0,0,49,2756,0.156037000,0.2033
133.178.226.41,<->,96.155.60.252,49,52914,0,0,49,52914,0.146832000,1.7921
215.158.239.17,<->,80.47.111.170,49,3722,0,0,49,3722,0.108470000,0.7291
136.25.189.54,<->,96.156.169.207,49,50985,0,0,49,50985,0.099692000,1.6849
215.158.239.78,<->,199.69.32.130,49,2936,0,0,49,2936,0.098969000,1.7302
133.178.226.57,<->,98.219.126.175,49,64202,0,0,49,64202,0.070815000,1.7721
113.249.249.208,<->,50.224.49.213,0,0,49,2960,49,2960,0.069226000,1.9282
60.101.165.77,<->,8.252.222.13,0,0,49,3044,49,3044,0.060781000,1.8427
207.8.14.35,<->,8.252.222.222,0,0,49,3797,49,3797,0.049769000,1.8295
220.28.108.254,<->,215.158.238.118,0,0,49,67167,49,67167,0.046269000,0.3075
145.252.121.82,<->,116.141.159.189,49,2450,0,0,49,2450,0.045057000,0.3900
95.246.100.215,<->,8.252.222.220,0,0,49,3124,49,3124,0.042731000,1.9377
144.75.218.233,<->,8.222.218.197,49,6149,0,0,49,6149,0.025189000,1.9699
133.54.43.69,<->,77.24.17.181,49,3506,0,0,49,3506,0.021568000,1.9725
129.236.114.39,<->,33.233.141.74,0,0,49,66018,49,66018,0.014479000,1.9755
194.233.159.170,<->,136.25.188.239,0,0,49,2936,49,2936,0.013169000,1.2199
143.24.201.19,<->,92.27.27.170,0,0,49,2744,49,2744,0.013146000,1.9753
108.180.193.84,<->,8.52.147.123,0,0,49,2516,49,2516,0.005471000,1.9763
215.158.239.94,<->,199.20.63.99,49,7030,0,0,49,7030,0.004896000,1.9525
212.164.140.187,<->,205.41.237.246,49,2744,0,0,49,2744,0.004125000,1.8593
94.195.252.214,<->,8.252.222.110,0,0,49,3480,49,3480,0.000505000,1.8926
220.55.96.42,<->,8.222.6.181,48,66129,0,0,48,66129,1.228776000,0.1449
97.28.31.82,<->,8.176.53.29,0,0,48,5040,48,5040,1.201746000,0.7423
215.158.239.227,<->,192.229.43.21,48,67625,0,0,48,67625,1.098276000,0.0208
43.54.162.40,<->,8.252.221.238,0,0,48,4490,48,4490,1.064794000,0.7860
215.158.238.215,<->,215.158.132.240,48,69676,0,0,48,69676,0.998100000,0.0776
133.244.31.121,<->,80.27.154.175,48,3619,0,0,48,3619,0.970449000,0.7818
137.69.224.129,<->,8.182.243.141,0,0,48,3512,48,3512,0.916110000,0.9377
215.158.30.252,<->,8.252.222.42,0,0,48,55764,48,55764,0.900634000,0.9069
216.184.2.64,<->,215.158.239.45,0,0,48,63027,48,63027,0.886903000,0.2477
136.25.189.22,<->,98.219.126.140,48,61241,0,0,48,61241,0.781108000,1.1925
215.158.49.86,<->,136.116.28.234,0,0,48,63740,48,63740,0.495372000,1.3345
220.28.115.46,<->,136.25.188.245,0,0,48,65626,48,65626,0.461003000,0.9618
113.172.47.6,<->,92.27.219.203,0,0,48,2730,48,2730,0.339407000,1.4879
215.158.239.75,<->,159.215.65.143,48,61267,0,0,48,61267,0.331226000,1.5900
92.168.217.229,<->,50.136.175.234,48,3468,0,0,48,3468,0.205466000,1.7939
111.150.187.184,<->,8.252.223.131,0,0,48,9024,48,9024,0.167615000,1.7105
144.85.170.244,<->,98.87.144.37,48,2892,0,0,48,2892,0.150287000,1.8272
136.25.189.36,<->,96.156.169.218,48,47867,0,0,48,47867,0.113345000,1.8514
152.12.3.191,<->,92.27.219.165,0,0,48,2496,48,2496,0.110922000,1.7280
215.158.238.40,<->,0.195.237.14,48,62449,0,0,48,62449,0.109657000,1.0451
139.36.119.72,<->,8.176.8.80,0,0,48,59239,48,59239,0.107841000,0.5828
94.192.174.134,<->,8.252.222.210,0,0,48,2932,48,2932,0.101308000,1.8949
152.105.54.242,<->,8.252.222.210,0,0,48,2932,48,2932,0.096606000,1.8999
139.241.56.102,<->,109.0.247.120,0,0,48,34888,48,34888,0.087101000,1.9040
215.158.239.96,<->,199.15.213.31,48,6362,0,0,48,6362,0.081197000,1.8074
8.252.222.68,<->,4.120.149.7,48,2888,0,0,48,2888,0.075202000,1.7692
111.150.74.19,<->,99.74.26.99,0,0,48,36657,48,36657,0.072269000,1.9062
215.158.43.154,<->,133.178.227.119,0,0,48,15723,48,15723,0.070817000,1.7821
215.158.140.60,<->,139.8.186.137,48,10024,0,0,48,10024,0.070415000,1.6236
194.253.240.131,<->,8.252.222.225,0,0,48,2544,48,2544,0.058535000,1.9401
139.241.56.102,<->,80.41.244.122,0,0,48,34888,48,34888,0.056864000,1.9041
152.105.22.55,<->,8.252.222.185,0,0,48,3180,48,3180,0.056359000,1.9136
109.1.15.193,<->,33.57.74.137,48,70560,0,0,48,70560,0.044918000,1.9455
8.252.222.82,<->,4.122.171.17,48,3156,0,0,48,3156,0.040646000,1.8769
223.114.63.246,<->,8.252.222.238,0,0,48,3104,48,3104,0.038514000,1.8994
201.139.255.133,<->,8.252.223.2,0,0,48,3272,48,3272,0.038011000,1.9537
215.158.239.56,<->,195.83.227.71,48,3902,0,0,48,3902,0.036479000,1.5429
58.242.242.40,<->,8.252.222.7,0,0,48,3116,48,3116,0.034957000,1.9000
95.246.189.150,<->,8.252.222.185,0,0,48,3088,48,3088,0.033522000,1.9659
215.158.238.45,<->,113.190.46.8,48,3685,0,0,48,3685,0.029804000,1.1175
252.98.138.44,<->,89.153.118.184,48,6705,0,0,48,6705,0.023483000,1.9734
138.45.90.152,<->,136.25.188.201,0,0,48,60861,48,60861,0.016980000,1.7765
148.88.101.5,<->,139.193.141.194,0,0,48,6138,48,6138,0.016015000,1.7389
66.47.57.68,<->,8.252.222.108,0,0,48,3140,48,3140,0.012096000,1.8700
242.6.57.233,<->,139.163.17.164,0,0,48,5999,48,5999,0.009236000,1.9779
136.25.188.255,<->,100.224.202.188,48,28375,0,0,48,28375,0.009095000,1.9817
220.28.85.14,<->,133.178.226.66,0,0,48,53965,48,53965,0.006774000,1.6494
220.55.171.232,<->,124.224.212.254,48,4728,0,0,48,4728,0.002313000,1.9650
86.135.85.27,<->,8.252.222.163,0,0,47,4990,47,4990,1.286357000,0.6265
220.28.114.28,<->,215.158.239.63,0,0,47,64095,47,64095,1.144377000,0.4717
215.158.238.177,<->,130.165.253.8,47,4851,0,0,47,4851,0.890387000,0.3423
220.28.104.193,<->,133.178.227.29,0,0,47,66101,47,66101,0.816631000,0.1590
215.158.238.248,<->,8.253.128.36,47,3809,0,0,47,3809,0.720248000,1.2222
215.158.239.81,<->,159.215.65.177,47,58411,0,0,47,58411,0.594430000,0.9821
133.178.227.246,<->,56.23.170.190,47,9954,0,0,47,9954,0.337023000,1.1238
221.102.56.46,<->,80.41.223.64,0,0,47,47430,47,47430,0.294764000,0.6723
136.25.188.233,<->,100.224.202.157,47,38197,0,0,47,38197,0.260213000,1.4374
138.98.198.136,<->,88.203.53.253,47,2350,0,0,47,2350,0.228134000,1.6111
76.101.228.85,<->,8.252.222.38,0,0,47,2783,47,2783,0.209102000,0.7645
199.38.102.159,<->,136.25.188.198,0,0,47,4167,47,4167,0.199626000,1.4371
133.178.227.94,<->,98.191.25.53,47,15520,0,0,47,15520,0.190927000,1.7707
215.158.140.88,<->,98.219.126.140,47,56113,0,0,47,56113,0.186873000,1.7377
207.60.124.42,<->,136.25.188.255,0,0,47,2350,47,2350,0.183990000,0.4799
199.121.54.163,<->,136.25.188.162,0,0,47,4268,47,4268,0.157816000,1.2679
215.158.239.115,<->,145.182.137.222,47,38381,0,0,47,38381,0.151596000,1.5210
215.158.238.83,<->,8.255.92.246,47,10939,0,0,47,10939,0.132548000,1.6668
143.134.162.186,<->,136.25.188.242,0,0,47,3425,47,3425,0.111120000,1.2260
8.252.222.109,<->,4.123.53.21,47,3032,0,0,47,3032,0.096871000,1.8049
58.242.138.198,<->,8.252.222.241,0,0,47,2932,47,2932,0.093039000,1.7646
220.28.114.28,<->,215.158.238.130,0,0,47,61092,47,61092,0.079599000,1.4001
220.39.233.187,<->,133.178.226.90,0,0,47,14762,47,14762,0.078018000,1.8711
133.178.226.25,<->,96.155.60.205,47,53701,0,0,47,53701,0.065430000,1.4713
66.47.79.125,<->,8.252.222.7,0,0,47,3084,47,3084,0.053557000,1.8740
94.185.5.84,<->,8.252.222.68,0,0,47,2936,47,2936,0.044128000,1.9300
136.114.101.19,<->,136.25.188.249,0,0,47,58544,47,58544,0.042744000,1.8088
133.178.227.76,<->,133.56.180.0,47,12786,0,0,47,12786,0.036671000,1.3544
43.52.83.8,<->,8.252.222.208,0,0,47,2976,47,2976,0.035317000,1.9643
215.158.239.79,<->,207.228.202.14,47,4178,0,0,47,4178,0.035215000,1.4615
230.156.218.105,<->,8.252.222.209,0,0,47,2872,47,2872,0.033301000,1.9494
215.158.238.66,<->,57.4.201.250,47,4061,0,0,47,4061,0.028232000,0.3255
194.252.68.50,<->,0.195.210.33,0,0,47,3169,47,3169,0.018122000,1.8800
93.95.34.144,<->,92.168.217.253,0,0,47,2924,47,2924,0.017990000,1.5658
144.75.218.242,<->,8.222.218.196,47,5734,0,0,47,5734,0.017012000,1.9162
215.158.238.86,<->,59.158.157.234,47,19521,0,0,47,19521,0.013114000,1.9467
69.103.229.24,<->,8.252.222.204,0,0,47,2996,47,2996,0.012259000,1.8300
192.67.130.85,<->,136.152.86.129,47,55052,0,0,47,55052,0.012243000,0.5431
133.244.28.235,<->,42.197.145.216,47,2376,0,0,47,2376,0.007380000,0.5645
139.36.120.120,<->,8.176.8.80,0,0,47,60053,47,60053,0.005251000,1.3547
144.87.238.89,<->,8.182.244.19,0,0,47,3244,47,3244,0.002730000,0.9137
6.9.213.201,<->,0.195.210.46,0,0,47,4745,47,4745,0.000453000,1.8913
136.181.43.39,<->,111.151.239.68,46,64768,0,0,46,64768,1.880054000,0.0654
145.72.38.32,<->,136.25.188.252,0,0,46,4702,46,4702,1.699792000,0.2381
215.158.103.203,<->,41.137.75.125,46,59946,0,0,46,59946,1.468292000,0.3116
102.224.161.117,<->,89.90.112.31,46,57570,0,0,46,57570,1.406094000,0.3842
215.158.140.147,<->,6.73.247.5,46,3417,0,0,46,3417,1.330638000,0.2844
199.15.175.78,<->,136.25.188.220,0,0,46,3550,46,3550,1.329420000,0.5258
136.25.189.19,<->,8.252.214.230,46,3697,0,0,46,3697,1.125720000,0.2428
159.109.242.246,<->,53.148.157.117,46,66082,0,0,46,66082,0.988222000,0.6301
215.158.239.73,<->,111.52.91.112,46,58317,0,0,46,58317,0.891547000,1.0053
220.28.85.14,<->,215.158.238.84,0,0,46,59511,46,59511,0.857309000,1.0650
99.151.84.213,<->,8.182.224.180,0,0,46,3646,46,3646,0.692222000,0.6180
215.158.239.99,<->,207.239.54.9,46,3909,0,0,46,3909,0.676624000,1.2716
215.158.238.135,<->,111.151.70.62,46,7428,0,0,46,7428,0.584293000,1.3991
215.158.239.62,<->,100.216.78.145,46,57152,0,0,46,57152,0.405137000,0.8940
215.158.239.87,<->,204.56.187.168,46,3280,0,0,46,3280,0.403229000,0.9897
220.28.115.46,<->,215.158.238.87,0,0,46,58188,46,58188,0.364312000,1.3067
133.178.226.200,<->,133.146.0.147,46,3410,0,0,46,3410,0.245072000,1.2754
215.158.238.92,<->,131.1.195.220,46,9368,0,0,46,9368,0.228847000,1.6631
136.25.189.29,<->,133.56.180.22,46,16984,0,0,46,16984,0.194238000,1.5539
243.117.93.2,<->,35.56.96.75,0,0,46,3954,46,3954,0.189570000,0.4710
215.158.238.101,<->,100.216.78.145,46,60855,0,0,46,60855,0.181031000,1.7805
215.158.140.167,<->,131.36.66.75,46,3881,0,0,46,3881,0.158814000,0.8563
249.101.104.224,<->,53.231.92.51,46,2438,0,0,46,2438,0.152347000,1.6861
215.158.238.87,<->,100.120.38.6,46,58416,0,0,46,58416,0.145569000,1.1292
215.158.238.148,<->,131.1.195.222,46,7865,0,0,46,7865,0.144887000,1.8417
146.224.12.94,<->,8.252.221.236,0,0,46,2876,46,2876,0.135950000,1.7677
215.158.239.48,<->,199.20.28.93,46,3856,0,0,46,3856,0.125752000,1.8499
196.246.204.77,<->,136.25.188.178,0,0,46,5020,46,5020,0.110631000,1.2501
139.241.56.117,<->,99.75.228.122,0,0,46,34222,46,34222,0.091467000,1.9006
139.241.56.102,<->,129.1.86.108,0,0,46,33376,46,33376,0.089111000,1.8289
139.241.56.117,<->,100.182.137.34,0,0,46,34222,46,34222,0.088176000,1.9019
8.252.221.223,<->,4.122.228.83,46,2390,0,0,46,2390,0.083167000,1.8285
136.25.188.56,<->,100.224.202.145,46,57731,0,0,46,57731,0.074130000,1.8449
133.178.227.27,<->,8.191.7.88,46,15048,0,0,46,15048,0.068076000,1.9129
58.50.250.207,<->,8.252.222.82,0,0,46,2892,46,2892,0.067171000,1.8645
215.158.239.32,<->,215.158.127.181,46,10465,0,0,46,10465,0.063429000,1.8873
105.122.175.61,<->,6.122.200.225,0,0,46,64016,46,64016,0.055278000,1.9289
48.16.230.148,<->,8.252.222.173,0,0,46,3060,46,3060,0.038858000,1.9206
247.136.131.28,<->,205.8.173.220,46,6375,0,0,46,6375,0.036277000,1.9380
192.64.251.234,<->,142.202.168.22,46,33236,0,0,46,33236,0.035137000,1.8803
249.101.236.137,<->,99.216.103.248,46,21484,0,0,46,21484,0.029148000,1.9400
144.75.218.235,<->,8.222.218.198,46,5971,0,0,46,5971,0.022601000,1.9656
144.75.218.233,<->,8.222.218.196,46,5772,0,0,46,5772,0.019775000,1.9375
152.105.241.91,<->,8.252.222.115,0,0,46,2928,46,2928,0.018111000,1.8639
144.75.218.241,<->,8.222.218.204,46,5624,0,0,46,5624,0.017776000,1.9726
133.178.227.14,<->,133.56.180.22,46,11608,0,0,46,11608,0.010284000,1.9283
247.136.133.229,<->,116.249.165.54,46,2470,0,0,46,2470,0.008993000,1.9454
139.163.46.192,<->,130.136.17.42,46,2384,0,0,46,2384,0.001683000,1.8849
79.213.62.186,<->,8.252.222.115,0,0,46,2828,46,2828,0.001444000,1.9618
215.158.140.167,<->,6.25.170.27,45,3679,0,0,45,3679,1.442711000,0.2359
132.216.20.78,<->,102.224.168.174,0,0,45,64718,45,64718,1.384090000,0.1281
215.158.61.211,<->,8.252.222.105,0,0,45,65211,45,65211,1.308770000,0.0852
144.85.170.208,<->,98.87.145.170,45,3186,0,0,45,3186,0.973455000,0.3917
143.134.6.217,<->,136.25.188.177,0,0,45,3382,45,3382,0.776401000,1.1415
195.55.141.42,<->,136.25.188.45,0,0,45,2842,45,2842,0.616867000,0.6442
215.158.238.78,<->,100.120.38.6,45,53656,0,0,45,53656,0.557292000,1.2309
136.25.189.39,<->,96.156.169.196,45,51994,0,0,45,51994,0.521056000,1.2480
192.205.47.22,<->,133.178.226.198,0,0,45,65992,45,65992,0.465264000,1.1012
192.65.40.50,<->,8.55.224.156,45,52589,0,0,45,52589,0.377525000,0.5826
215.158.239.84,<->,199.68.27.118,45,3500,0,0,45,3500,0.355255000,1.5195
159.223.99.62,<->,8.52.185.129,0,0,45,4792,45,4792,0.254127000,1.5030
215.158.239.3,<->,215.158.127.154,45,51238,0,0,45,51238,0.224373000,1.2500
192.67.159.55,<->,118.69.159.68,45,3630,0,0,45,3630,0.146766000,1.7931
247.136.250.58,<->,117.130.91.228,45,65520,0,0,45,65520,0.128981000,1.5018
144.46.53.11,<->,133.178.227.119,0,0,45,11456,45,11456,0.128611000,1.8009
215.158.239.61,<->,56.97.186.150,45,55044,0,0,45,55044,0.114218000,1.4942
215.158.238.95,<->,33.209.217.213,45,20080,0,0,45,20080,0.105808000,1.8138
58.203.214.60,<->,8.252.222.77,0,0,45,2916,45,2916,0.105190000,1.7915
133.178.227.95,<->,98.191.25.53,45,14943,0,0,45,14943,0.102310000,1.5353
133.178.227.41,<->,133.56.180.40,45,9859,0,0,45,9859,0.089437000,1.5986
136.25.189.36,<->,96.156.169.210,45,56827,0,0,45,56827,0.081695000,1.8456
66.47.43.224,<->,8.252.222.115,0,0,45,3004,45,3004,0.076639000,1.9197
220.28.114.28,<->,215.158.238.111,0,0,45,56223,45,56223,0.071771000,1.9208
133.178.226.31,<->,57.160.181.228,45,14938,0,0,45,14938,0.063154000,1.8620
220.28.65.9,<->,215.158.238.40,0,0,45,60016,45,60016,0.059931000,0.2869
144.75.218.242,<->,8.222.218.204,45,5779,0,0,45,5779,0.058270000,1.8966
102.50.232.104,<->,57.110.204.222,45,57975,0,0,45,57975,0.057891000,1.4962
215.158.30.219,<->,136.25.188.51,0,0,45,50676,45,50676,0.049566000,1.5395
220.28.85.14,<->,133.178.227.6,0,0,45,53231,45,53231,0.044451000,1.7098
218.4.191.217,<->,111.151.239.7,45,63089,0,0,45,63089,0.040931000,0.1800
220.50.242.203,<->,136.25.189.195,0,0,45,20411,45,20411,0.039797000,1.6335
133.178.226.74,<->,133.56.180.75,45,61668,0,0,45,61668,0.033900000,1.6898
133.178.227.27,<->,133.56.180.33,45,17295,0,0,45,17295,0.033642000,1.1816
8.252.222.115,<->,4.120.230.124,45,2676,0,0,45,2676,0.020785000,1.9458
204.200.19.3,<->,0.195.210.33,0,0,45,3650,45,3650,0.012262000,1.9262
200.10.137.222,<->,8.252.222.241,0,0,45,3048,45,3048,0.009239000,1.8337
220.28.108.254,<->,133.178.227.4,0,0,44,60024,44,60024,1.668131000,0.1012
144.83.60.137,<->,92.162.253.95,0,0,44,53815,44,53815,1.559674000,0.3515
239.66.156.251,<->,138.98.204.211,0,0,44,63270,44,63270,1.478385000,0.5162
220.28.108.254,<->,215.158.238.253,0,0,44,54566,44,54566,0.990388000,0.7304
142.190.247.74,<->,136.25.188.225,0,0,44,6986,44,6986,0.932899000,0.8569
197.106.105.34,<->,133.32.39.45,0,0,44,2476,44,2476,0.879420000,0.7230
199.33.112.95,<->,136.25.188.162,0,0,44,3049,44,3049,0.806315000,0.2464
215.158.238.188,<->,131.1.195.22,44,5709,0,0,44,5709,0.773020000,1.1477
221.102.143.189,<->,213.38.214.143,0,0,44,52634,44,52634,0.628703000,0.4194
195.41.86.34,<->,136.25.188.209,0,0,44,2200,44,2200,0.514288000,1.1692
80.40.205.101,<->,8.55.224.156,44,51591,0,0,44,51591,0.479731000,1.0226
58.242.235.137,<->,8.252.222.208,0,0,44,2808,44,2808,0.398608000,1.5730
220.28.73.211,<->,215.158.140.88,0,0,44,50542,44,50542,0.364068000,1.6256
136.25.188.226,<->,29.211.6.85,44,11139,0,0,44,11139,0.341198000,1.6193
215.158.239.92,<->,195.55.126.241,44,4825,0,0,44,4825,0.328822000,1.0836
215.158.238.236,<->,29.211.122.151,44,6224,0,0,44,6224,0.327122000,1.3369
143.134.29.192,<->,136.25.188.53,0,0,44,3525,44,3525,0.319153000,1.2551
210.158.44.0,<->,111.151.238.96,44,59977,0,0,44,59977,0.300132000,0.0549
215.158.238.134,<->,113.23.20.233,44,6095,0,0,44,6095,0.285071000,1.1646
133.178.226.77,<->,126.219.194.143,44,14698,0,0,44,14698,0.233301000,1.5400
129.175.139.42,<->,8.252.222.226,0,0,44,11148,44,11148,0.218747000,1.7483
230.156.193.17,<->,8.252.222.240,0,0,44,3616,44,3616,0.173833000,1.2395
143.132.89.138,<->,136.25.188.208,0,0,44,3267,44,3267,0.168516000,1.0025
215.158.239.79,<->,142.207.250.149,44,4705,0,0,44,4705,0.167936000,1.1439
215.158.238.68,<->,98.219.126.140,44,56460,0,0,44,56460,0.146530000,1.0264
133.178.227.27,<->,8.240.116.196,44,8623,0,0,44,8623,0.135268000,1.7224
215.158.238.133,<->,197.125.126.182,44,13501,0,0,44,13501,0.126486000,1.7434
133.178.227.76,<->,100.50.96.236,44,10394,0,0,44,10394,0.124025000,1.7012
144.75.218.237,<->,8.222.218.199,44,5534,0,0,44,5534,0.112456000,1.7620
76.179.170.213,<->,8.252.221.223,0,0,44,2754,44,2754,0.111716000,1.8625
215.158.238.123,<->,114.150.180.157,44,3589,0,0,44,3589,0.102647000,0.4133
139.241.56.117,<->,6.138.251.242,0,0,44,33264,44,33264,0.095748000,1.8243
199.83.1.136,<->,136.25.188.46,0,0,44,3747,44,3747,0.091773000,1.0379
142.255.231.1,<->,136.25.188.236,0,0,44,3237,44,3237,0.075455000,1.7741
43.52.68.128,<->,8.252.222.237,0,0,44,2920,44,2920,0.060038000,1.8853
247.136.147.198,<->,127.162.74.46,44,64680,0,0,44,64680,0.058562000,1.6511
109.222.249.211,<->,56.140.239.139,44,38972,0,0,44,38972,0.057213000,1.9105
215.158.238.130,<->,98.219.126.140,44,57793,0,0,44,57793,0.051946000,1.5062
94.194.109.113,<->,8.252.222.79,0,0,44,2856,44,2856,0.045203000,1.9146
215.158.239.177,<->,192.224.20.69,44,31847,0,0,44,31847,0.034980000,1.8924
221.102.143.189,<->,109.3.187.34,0,0,44,62702,44,62702,0.027211000,0.4365
136.25.188.242,<->,8.222.7.25,44,14554,0,0,44,14554,0.014242000,1.8656
220.87.124.222,<->,215.158.2.89,44,10752,0,0,44,10752,0.013697000,1.9198
220.28.109.52,<->,136.25.188.234,0,0,44,58410,44,58410,0.012277000,0.9084
221.102.121.224,<->,207.102.128.115,44,2200,0,0,44,2200,0.006918000,1.9922
93.181.154.83,<->,92.27.219.249,0,0,44,2384,44,2384,0.001880000,1.9822
215.158.239.219,<->,215.62.250.163,43,23854,0,0,43,23854,1.606670000,0.1410
246.108.106.71,<->,100.95.221.235,0,0,43,59906,43,59906,1.213696000,0.5478
221.196.123.29,<->,136.25.188.226,0,0,43,3119,43,3119,1.117105000,0.7297
143.119.40.233,<->,8.182.241.177,0,0,43,6758,43,6758,1.101634000,0.8464
204.63.248.181,<->,136.25.188.243,0,0,43,3337,43,3337,0.681957000,1.3076
220.28.115.46,<->,133.178.226.43,0,0,43,55079,43,55079,0.465530000,1.2115
215.158.239.66,<->,96.155.60.207,43,56630,0,0,43,56630,0.448259000,0.9954
215.158.238.147,<->,0.195.253.228,43,54724,0,0,43,54724,0.349823000,1.6004
136.25.188.254,<->,112.220.206.22,43,4770,0,0,43,4770,0.329523000,1.0905
215.158.238.196,<->,106.188.228.58,43,5479,0,0,43,5479,0.281673000,1.5891
215.158.239.44,<->,8.222.48.144,43,51072,0,0,43,51072,0.273319000,1.5874
220.28.115.46,<->,133.178.227.37,0,0,43,58672,43,58672,0.207785000,0.4496
159.224.11.110,<->,111.146.157.33,0,0,43,14508,43,14508,0.198541000,1.7775
247.136.241.135,<->,215.158.133.30,43,11873,0,0,43,11873,0.169456000,1.7517
139.193.141.200,<->,122.128.87.20,43,2150,0,0,43,2150,0.154613000,1.8323
136.25.188.160,<->,8.42.43.23,43,16055,0,0,43,16055,0.124616000,1.8750
69.243.244.123,<->,8.252.221.239,0,0,43,2204,43,2204,0.107130000,1.8272
215.158.140.241,<->,131.1.195.58,43,5561,0,0,43,5561,0.106842000,1.4399
144.46.53.11,<->,133.178.227.97,0,0,43,10764,43,10764,0.106151000,1.7695
220.28.115.46,<->,136.25.188.194,0,0,43,55458,43,55458,0.086702000,1.8481
76.179.30.25,<->,8.252.221.198,0,0,43,2220,43,2220,0.083648000,1.8748
136.25.188.254,<->,8.42.43.66,43,11191,0,0,43,11191,0.082849000,1.8989
136.25.188.226,<->,8.222.212.42,43,11047,0,0,43,11047,0.076893000,1.8761
143.129.164.35,<->,136.25.188.239,0,0,43,3046,43,3046,0.073971000,1.1729
215.158.238.83,<->,8.42.43.86,43,16315,0,0,43,16315,0.071698000,1.8654
133.178.226.7,<->,126.219.194.116,43,11335,0,0,43,11335,0.065339000,1.8844
8.252.222.210,<->,4.122.183.48,43,2604,0,0,43,2604,0.064429000,1.9122
94.195.123.55,<->,8.252.223.1,0,0,43,2648,43,2648,0.059079000,1.8988
133.244.30.133,<->,57.211.63.49,43,2670,0,0,43,2670,0.050912000,1.1790
204.141.228.248,<->,8.252.222.220,0,0,43,2723,43,2723,0.042659000,1.9396
215.158.239.66,<->,56.97.186.7,43,48629,0,0,43,48629,0.030962000,1.4456
108.39.7.100,<->,77.28.69.25,43,4767,0,0,43,4767,0.027568000,1.9432
205.127.108.115,<->,101.224.89.170,0,0,43,20388,43,20388,0.022256000,1.9523
80.42.185.73,<->,53.223.254.146,43,2408,0,0,43,2408,0.017259000,1.9602
159.194.2.95,<->,138.98.233.218,0,0,43,50676,43,50676,0.013030000,1.9847
136.25.188.227,<->,72.52.200.51,43,3267,0,0,43,3267,0.012645000,1.7718
215.158.238.81,<->,56.161.218.20,43,9846,0,0,43,9846,0.011131000,1.9429
133.178.227.24,<->,131.22.233.139,43,9806,0,0,43,9806,0.008475000,1.9177
215.158.239.70,<->,143.72.203.225,43,2612,0,0,43,2612,0.007849000,1.8823
36.116.67.29,<->,8.252.222.209,0,0,43,2712,43,2712,0.000162000,1.9478
215.158.239.24,<->,215.158.127.152,42,59125,0,0,42,59125,0.929112000,0.2981
144.85.170.244,<->,111.38.251.144,42,3052,0,0,42,3052,0.718144000,1.2390
215.158.239.11,<->,215.158.127.152,42,56610,0,0,42,56610,0.669872000,1.0921
207.61.88.169,<->,136.25.188.177,0,0,42,4753,42,4753,0.609643000,1.2522
215.158.239.57,<->,207.56.174.124,42,4099,0,0,42,4099,0.584678000,1.3548
136.25.189.21,<->,96.156.169.204,42,44204,0,0,42,44204,0.578648000,1.4078
213.186.52.58,<->,144.85.170.246,0,0,42,3192,42,3192,0.570348000,0.8405
136.25.188.244,<->,56.97.186.149,42,55010,0,0,42,55010,0.513475000,0.4771
133.178.226.74,<->,98.219.126.140,42,58491,0,0,42,58491,0.484306000,0.1344
231.142.17.21,<->,136.25.188.199,0,0,42,3502,42,3502,0.478803000,1.4931
136.25.188.244,<->,100.224.138.230,42,50493,0,0,42,50493,0.469227000,1.4790
215.158.61.224,<->,8.252.222.66,0,0,42,46987,42,46987,0.379257000,0.9056
197.16.50.50,<->,8.20.87.206,0,0,42,2412,42,2412,0.356291000,1.2174
215.158.238.97,<->,80.47.111.25,42,16003,0,0,42,16003,0.318032000,1.5914
215.158.239.91,<->,8.222.48.142,42,47597,0,0,42,47597,0.239733000,1.7218
220.39.233.196,<->,215.158.238.75,0,0,42,11055,42,11055,0.195307000,1.7941
215.158.239.33,<->,96.135.154.101,42,4590,0,0,42,4590,0.159125000,0.9493
136.25.188.210,<->,29.214.108.183,42,8473,0,0,42,8473,0.144322000,1.7958
133.178.227.86,<->,17.41.77.103,42,2352,0,0,42,2352,0.124582000,1.6909
215.158.238.110,<->,100.224.166.115,42,50078,0,0,42,50078,0.119278000,1.1734
100.110.50.212,<->,92.27.209.217,0,0,42,5202,42,5202,0.110862000,1.8383
223.115.155.54,<->,8.252.222.4,0,0,42,2560,42,2560,0.110221000,1.7861
157.127.235.37,<->,8.252.223.2,0,0,42,2660,42,2660,0.089499000,1.8095
76.179.39.231,<->,8.252.221.238,0,0,42,2696,42,2696,0.087882000,1.8669
136.25.188.221,<->,8.42.43.37,42,12144,0,0,42,12144,0.067230000,1.5301
132.151.133.132,<->,53.75.173.116,42,8816,0,0,42,8816,0.062944000,1.9109
215.158.30.219,<->,8.252.222.42,0,0,42,38872,42,38872,0.059403000,0.9659
215.158.140.93,<->,29.211.228.179,42,3558,0,0,42,3558,0.057799000,0.9411
139.36.120.223,<->,133.178.227.244,0,0,42,7898,42,7898,0.048727000,1.3149
215.158.239.26,<->,215.158.127.173,42,50861,0,0,42,50861,0.047482000,1.3550
220.28.65.9,<->,215.158.238.125,0,0,42,58411,42,58411,0.043571000,1.6292
215.158.239.51,<->,195.5.170.96,42,3317,0,0,42,3317,0.040954000,1.8446
142.247.242.34,<->,136.25.188.53,0,0,42,3295,42,3295,0.039195000,1.3817
119.250.57.185,<->,92.27.219.154,0,0,42,61740,42,61740,0.033998000,1.9197
144.75.218.241,<->,8.222.218.196,42,5328,0,0,42,5328,0.033101000,1.8938
142.234.196.200,<->,133.178.226.7,0,0,42,5983,42,5983,0.031603000,1.6734
220.39.233.200,<->,136.25.188.208,0,0,42,15266,42,15266,0.029570000,1.9139
204.187.27.93,<->,136.25.188.178,0,0,42,4751,42,4751,0.027243000,1.9706
133.178.227.79,<->,133.56.180.11,42,16756,0,0,42,16756,0.024793000,1.9462
215.158.238.83,<->,29.211.6.45,42,11059,0,0,42,11059,0.020646000,1.8809
144.75.218.241,<->,120.155.84.97,42,6595,0,0,42,6595,0.019852000,1.9697
216.184.1.198,<->,99.74.26.99,0,0,42,46461,42,46461,0.018577000,1.5958
92.27.219.230,<->,48.107.117.28,42,2100,0,0,42,2100,0.015682000,1.9487
94.195.143.54,<->,8.252.222.208,0,0,42,2572,42,2572,0.014878000,1.8936
192.64.41.116,<->,92.27.27.142,0,0,42,18569,42,18569,0.014372000,1.9583
205.127.108.113,<->,101.224.89.159,0,0,42,39865,42,39865,0.013890000,1.4845
230.102.130.54,<->,133.178.227.207,0,0,42,8722,42,8722,0.012647000,1.9398
223.114.234.222,<->,8.252.222.208,0,0,42,2628,42,2628,0.005740000,1.9871
66.47.102.155,<->,8.252.222.92,0,0,42,2956,42,2956,0.005708000,1.9777
92.27.219.142,<->,0.240.189.235,42,32508,0,0,42,32508,0.003850000,1.9755
198.249.136.154,<->,92.27.219.19,0,0,42,39632,42,39632,0.003629000,1.5169
215.158.140.245,<->,0.195.253.228,41,57408,0,0,41,57408,1.438270000,0.1350
133.135.214.222,<->,101.76.17.252,0,0,41,2676,41,2676,1.395592000,0.1480
132.216.20.179,<->,109.1.50.82,0,0,41,59212,41,59212,1.347724000,0.0485
215.158.239.230,<->,208.34.52.202,41,58157,0,0,41,58157,1.152706000,0.3816
144.87.238.89,<->,8.182.224.87,0,0,41,4268,41,4268,1.144489000,0.8151
215.158.32.171,<->,6.73.247.87,0,0,41,58433,41,58433,0.916144000,0.1353
136.25.189.27,<->,96.156.169.165,41,56556,0,0,41,56556,0.746958000,0.0137
215.158.238.105,<->,68.124.221.43,41,3325,0,0,41,3325,0.556600000,0.2460
142.240.9.194,<->,136.25.188.222,0,0,41,2338,41,2338,0.524434000,1.2696
133.178.227.27,<->,126.219.132.35,41,4352,0,0,41,4352,0.414724000,1.2030
144.85.170.208,<->,98.87.146.141,41,2643,0,0,41,2643,0.374960000,0.4432
215.158.238.221,<->,156.165.37.108,41,3200,0,0,41,3200,0.335895000,0.2256
193.21.28.197,<->,89.183.104.191,0,0,41,53810,41,53810,0.297789000,1.7009
133.178.227.247,<->,8.42.64.172,41,6339,0,0,41,6339,0.293651000,1.1916
215.158.238.196,<->,8.50.170.174,41,5460,0,0,41,5460,0.257567000,1.6493
220.28.85.14,<->,133.178.226.23,0,0,41,55288,41,55288,0.236783000,1.7118
136.25.188.44,<->,112.235.95.74,41,9622,0,0,41,9622,0.215734000,1.6992
220.20.200.83,<->,149.19.161.148,41,57876,0,0,41,57876,0.211824000,0.3592
215.158.239.196,<->,8.33.227.54,41,59454,0,0,41,59454,0.208001000,0.0772
159.137.139.0,<->,133.178.227.16,0,0,41,6183,41,6183,0.182730000,1.5760
224.229.14.103,<->,97.198.108.252,0,0,41,33151,41,33151,0.169460000,1.8133
215.158.239.58,<->,195.83.204.122,41,2788,0,0,41,2788,0.142326000,1.8399
192.64.218.107,<->,8.255.92.38,41,13248,0,0,41,13248,0.128935000,1.7802
133.178.226.28,<->,33.209.217.238,41,13303,0,0,41,13303,0.119761000,1.6927
136.25.188.177,<->,33.209.217.213,41,14401,0,0,41,14401,0.101450000,1.8649
152.105.133.57,<->,8.252.222.240,0,0,41,2572,41,2572,0.082809000,1.8220
133.178.226.30,<->,106.188.251.218,41,6628,0,0,41,6628,0.076387000,0.6111
136.25.188.232,<->,97.174.232.253,41,47136,0,0,41,47136,0.073458000,1.5544
69.242.131.148,<->,8.252.222.125,0,0,41,2492,41,2492,0.068844000,1.7634
133.178.227.41,<->,8.190.216.223,41,6303,0,0,41,6303,0.063533000,1.0743
192.67.168.13,<->,57.41.114.237,41,2472,0,0,41,2472,0.060691000,1.8744
215.158.239.95,<->,207.213.231.184,41,4676,0,0,41,4676,0.060551000,1.6096
95.245.243.87,<->,8.252.222.185,0,0,41,2716,41,2716,0.057671000,1.9367
194.233.8.142,<->,136.25.188.177,0,0,41,4687,41,4687,0.037246000,1.1299
207.56.138.208,<->,136.25.188.199,0,0,41,4576,41,4576,0.037230000,1.5921
207.21.165.166,<->,8.252.222.225,0,0,41,2147,41,2147,0.035012000,1.9361
220.28.109.52,<->,136.25.188.49,0,0,41,51730,41,51730,0.034523000,1.8091
215.158.61.189,<->,8.176.8.196,0,0,41,32812,41,32812,0.034074000,1.9223
92.168.217.252,<->,88.122.23.158,41,2086,0,0,41,2086,0.033188000,1.9195
133.178.226.30,<->,29.214.108.158,41,22509,0,0,41,22509,0.026689000,1.9652
221.102.56.46,<->,98.129.37.28,0,0,41,57354,41,57354,0.025183000,0.5122
94.192.233.108,<->,8.252.222.196,0,0,41,2556,41,2556,0.024904000,1.9541
215.158.239.92,<->,199.15.90.43,41,4138,0,0,41,4138,0.023156000,1.8976
237.70.233.208,<->,133.54.43.46,0,0,41,2296,41,2296,0.022578000,0.2265
247.136.212.186,<->,92.16.228.173,41,60210,0,0,41,60210,0.018949000,1.8698
215.158.238.73,<->,8.42.43.24,41,10971,0,0,41,10971,0.016975000,1.8081
133.178.227.16,<->,133.56.180.55,41,24129,0,0,41,24129,0.004332000,1.9826
159.178.67.213,<->,8.52.183.27,0,0,41,3054,41,3054,0.003990000,1.9901
53.231.66.3,<->,48.54.81.68,0,0,41,60516,41,60516,0.002053000,1.8646
92.168.217.148,<->,46.41.167.113,41,2296,0,0,41,2296,0.001702000,0.7647
8.252.222.113,<->,4.122.48.54,41,2708,0,0,41,2708,0.001303000,1.9115
215.158.239.76,<->,194.251.125.222,40,9395,0,0,40,9395,1.558492000,0.4360
223.114.90.164,<->,8.252.221.221,0,0,40,3509,40,3509,1.403688000,0.5605
215.158.140.164,<->,8.222.7.160,40,3002,0,0,40,3002,1.375496000,0.5561
198.249.85.113,<->,133.178.227.105,0,0,40,2245,40,2245,1.129151000,0.8394
137.39.55.81,<->,100.228.42.205,0,0,40,55590,40,55590,0.985450000,0.0439
215.158.239.92,<->,204.226.3.45,40,4613,0,0,40,4613,0.850916000,1.1453
215.158.238.140,<->,148.23.229.9,40,2240,0,0,40,2240,0.794635000,0.4842
215.158.239.57,<->,199.20.30.241,40,2662,0,0,40,2662,0.783640000,1.1096
215.158.238.45,<->,68.124.221.43,40,3301,0,0,40,3301,0.476153000,0.2450
220.28.104.193,<->,215.158.238.78,0,0,40,48620,40,48620,0.409278000,0.9912
204.2.103.102,<->,136.25.188.196,0,0,40,3876,40,3876,0.322023000,1.6473
215.158.238.74,<->,112.220.206.22,40,5471,0,0,40,5471,0.321920000,1.2072
215.158.239.56,<->,204.226.93.164,40,4768,0,0,40,4768,0.304838000,0.6115
129.31.141.155,<->,109.222.253.222,0,0,40,21834,40,21834,0.276580000,0.2414
215.158.239.62,<->,139.5.114.133,40,49918,0,0,40,49918,0.235886000,0.7940
57.203.86.245,<->,0.195.210.12,0,0,40,19943,40,19943,0.194542000,1.7379
215.158.239.51,<->,207.188.186.39,40,2375,0,0,40,2375,0.184190000,0.3565
195.124.211.97,<->,136.25.188.163,0,0,40,4573,40,4573,0.183088000,1.3600
220.28.73.211,<->,215.158.238.90,0,0,40,41284,40,41284,0.163611000,1.6991
223.114.203.219,<->,8.252.222.174,0,0,40,5896,40,5896,0.134097000,1.8533
215.158.238.144,<->,98.219.126.175,40,53111,0,0,40,53111,0.128940000,1.8096
136.25.188.167,<->,100.224.202.143,40,52483,0,0,40,52483,0.102041000,0.9965
48.19.237.85,<->,8.252.222.79,0,0,40,2544,40,2544,0.098630000,1.7801
215.158.239.92,<->,199.51.234.58,40,3329,0,0,40,3329,0.097287000,1.1999
139.241.56.102,<->,6.75.247.82,0,0,40,29864,40,29864,0.091876000,1.9079
254.242.184.252,<->,117.46.38.254,40,3584,0,0,40,3584,0.089755000,1.7825
245.61.110.28,<->,136.25.188.220,0,0,40,2912,40,2912,0.077551000,1.5698
142.249.53.75,<->,136.25.188.252,0,0,40,2000,40,2000,0.073387000,1.7690
156.152.163.10,<->,8.252.222.70,0,0,40,2831,40,2831,0.070931000,1.3357
136.25.188.254,<->,27.178.41.9,40,7296,0,0,40,7296,0.064211000,1.8841
139.163.0.100,<->,91.69.181.211,40,2240,0,0,40,2240,0.051724000,1.9122
136.25.188.163,<->,29.214.108.159,40,14669,0,0,40,14669,0.047619000,1.8888
95.246.77.217,<->,8.252.222.197,0,0,40,2552,40,2552,0.038486000,1.9484
223.115.8.239,<->,8.252.222.80,0,0,40,2608,40,2608,0.038100000,1.9351
94.195.214.62,<->,8.252.222.92,0,0,40,2460,40,2460,0.036369000,1.8790
133.178.227.76,<->,29.211.228.232,40,6752,0,0,40,6752,0.032695000,1.8579
215.158.238.83,<->,91.57.173.21,40,11816,0,0,40,11816,0.031239000,1.9424
215.158.239.76,<->,199.15.31.20,40,3473,0,0,40,3473,0.024472000,1.7720
99.74.156.58,<->,97.201.68.104,40,4744,0,0,40,4744,0.020944000,1.9662
207.200.202.92,<->,8.252.222.242,0,0,40,2435,40,2435,0.015623000,1.9734
223.115.225.55,<->,8.252.222.238,0,0,40,2548,40,2548,0.009296000,1.9682
215.158.239.97,<->,199.52.29.67,40,3554,0,0,40,3554,0.003664000,1.9611
192.64.225.34,<->,57.47.25.7,40,2000,0,0,40,2000,0.000363000,1.7385
111.20.168.122,<->,101.224.91.158,39,2853,0,0,39,2853,1.694539000,0.0513
142.221.251.142,<->,136.25.188.220,0,0,39,2397,39,2397,1.258262000,0.6952
93.181.154.66,<->,92.27.219.140,0,0,39,31145,39,31145,1.127028000,0.6184
144.87.238.91,<->,8.182.245.110,0,0,39,6706,39,6706,0.818630000,1.0898
129.78.116.160,<->,92.162.219.10,39,2513,0,0,39,2513,0.749171000,0.4311
133.178.227.16,<->,8.252.253.232,39,4482,0,0,39,4482,0.737501000,0.9283
92.175.125.211,<->,8.220.184.39,0,0,39,3159,39,3159,0.725452000,0.9618
215.158.239.76,<->,199.50.158.131,39,1950,0,0,39,1950,0.645892000,0.5080
221.196.123.253,<->,136.25.188.226,0,0,39,2184,39,2184,0.627566000,1.2755
136.25.188.174,<->,41.157.125.174,39,4498,0,0,39,4498,0.585880000,0.2629
142.241.140.174,<->,136.25.188.238,0,0,39,3118,39,3118,0.582930000,1.1721
136.25.189.63,<->,96.156.169.209,39,37497,0,0,39,37497,0.571717000,1.3748
146.240.17.87,<->,50.224.76.229,0,0,39,48573,39,48573,0.570779000,1.3479
220.28.108.254,<->,215.158.140.246,0,0,39,47603,39,47603,0.568313000,1.1634
199.55.44.192,<->,8.182.243.141,0,0,39,2760,39,2760,0.522009000,1.0983
129.236.114.39,<->,111.20.168.155,0,0,39,47607,39,47607,0.440072000,1.1801
216.184.1.109,<->,136.25.188.201,0,0,39,39113,39,39113,0.431199000,0.3505
192.224.146.176,<->,133.178.226.95,0,0,39,53353,39,53353,0.402134000,0.3272
136.25.189.7,<->,96.156.169.204,39,40815,0,0,39,40815,0.394056000,1.5957
136.25.188.175,<->,126.219.194.181,39,10294,0,0,39,10294,0.231063000,1.6912
136.25.188.27,<->,98.191.25.119,39,54159,0,0,39,54159,0.226153000,1.5620
215.158.239.93,<->,196.93.0.180,39,6162,0,0,39,6162,0.216710000,1.6794
68.208.141.19,<->,8.220.186.82,0,0,39,2062,39,2062,0.178752000,1.7842
215.158.238.133,<->,33.209.217.212,39,10380,0,0,39,10380,0.175965000,1.4860
136.25.189.77,<->,111.151.239.138,39,2184,0,0,39,2184,0.143150000,1.5086
137.83.182.31,<->,50.224.76.242,0,0,39,2184,39,2184,0.139529000,1.0993
215.158.238.243,<->,139.163.163.208,39,4434,0,0,39,4434,0.116953000,0.7610
133.178.226.54,<->,100.120.38.6,39,45394,0,0,39,45394,0.116878000,1.7795
111.150.187.250,<->,8.252.223.160,0,0,39,11536,39,11536,0.105484000,1.8542
136.114.101.39,<->,136.25.188.169,0,0,39,49472,39,49472,0.103104000,1.0364
215.158.238.176,<->,100.50.96.223,39,9032,0,0,39,9032,0.102449000,1.8829
115.85.99.120,<->,109.222.212.23,0,0,39,55752,39,55752,0.099191000,1.8207
136.25.188.254,<->,8.190.216.202,39,9866,0,0,39,9866,0.097505000,1.6925
215.158.238.108,<->,98.219.126.140,39,53924,0,0,39,53924,0.088713000,1.7105
215.158.239.76,<->,199.20.30.150,39,6076,0,0,39,6076,0.084278000,1.1794
95.245.200.217,<->,8.252.222.4,0,0,39,2364,39,2364,0.073537000,1.7731
215.158.238.189,<->,8.219.186.185,39,13685,0,0,39,13685,0.064579000,1.0143
215.158.238.221,<->,158.85.50.151,39,10459,0,0,39,10459,0.057526000,1.9101
95.244.104.107,<->,8.252.222.210,0,0,39,2472,39,2472,0.057112000,1.9422
199.39.232.201,<->,136.25.188.238,0,0,39,2442,39,2442,0.048427000,1.1648
194.245.224.227,<->,8.252.222.208,0,0,39,1950,39,1950,0.044179000,1.9522
207.162.175.71,<->,0.195.210.46,0,0,39,10008,39,10008,0.041863000,1.9432
204.19.149.79,<->,102.50.97.18,0,0,39,34109,39,34109,0.041394000,1.7306
210.224.219.234,<->,100.94.222.87,0,0,39,8872,39,8872,0.035931000,1.9357
215.158.238.95,<->,145.116.209.86,39,23159,0,0,39,23159,0.035366000,1.8729
159.137.218.90,<->,102.231.187.175,0,0,39,34712,39,34712,0.030994000,1.9274
215.158.239.77,<->,8.50.171.223,39,17988,0,0,39,17988,0.028864000,1.9509
53.167.165.55,<->,48.52.167.131,0,0,39,2762,39,2762,0.028040000,1.8396
215.171.65.110,<->,133.32.39.44,0,0,39,2411,39,2411,0.025296000,1.9605
143.140.184.16,<->,8.20.87.254,0,0,39,2076,39,2076,0.019587000,1.9720
215.158.238.73,<->,8.42.43.91,39,10727,0,0,39,10727,0.014151000,1.7398
133.178.226.74,<->,133.56.180.25,39,47005,0,0,39,47005,0.013556000,1.8904
215.158.239.58,<->,196.88.32.12,39,3787,0,0,39,3787,0.009241000,0.9884
215.158.238.99,<->,136.138.112.226,39,10519,0,0,39,10519,0.009178000,1.9002
95.246.76.155,<->,8.252.222.80,0,0,39,2564,39,2564,0.005238000,1.9913
223.120.75.97,<->,8.252.222.185,0,0,39,2588,39,2588,0.004317000,1.9136
207.86.243.25,<->,8.252.222.220,0,0,39,2454,39,2454,0.002930000,1.9912
207.57.96.133,<->,136.25.188.253,0,0,39,2040,39,2040,0.002887000,1.4995
136.25.188.253,<->,102.16.221.171,39,1974,0,0,39,1974,0.000744000,0.1552
95.247.133.160,<->,8.252.221.222,0,0,39,2400,39,2400,0.000488000,1.9219
144.253.54.6,<->,136.25.189.95,0,0,38,53416,38,53416,1.315903000,0.1491
105.205.123.121,<->,92.168.217.245,0,0,38,2760,38,2760,1.158162000,0.7387
207.61.126.116,<->,136.25.188.55,0,0,38,2443,38,2443,1.128288000,0.7516
17.116.39.130,<->,8.20.87.144,0,0,38,4454,38,4454,0.999591000,0.3982
136.25.189.24,<->,56.28.207.191,38,53050,0,0,38,53050,0.941625000,0.2574
215.158.238.141,<->,120.155.14.163,38,3501,0,0,38,3501,0.799072000,0.3873
220.28.65.9,<->,215.158.239.83,0,0,38,52536,38,52536,0.771622000,1.0804
207.11.121.137,<->,8.252.222.63,0,0,38,2484,38,2484,0.756367000,0.7629
74.143.144.234,<->,8.252.221.222,0,0,38,2704,38,2704,0.724313000,1.2179
149.163.129.150,<->,133.178.227.16,0,0,38,4426,38,4426,0.703978000,1.2704
94.192.95.233,<->,8.252.221.238,0,0,38,3256,38,3256,0.659547000,0.7643
133.178.226.0,<->,100.120.38.6,38,52158,0,0,38,52158,0.622592000,0.0007
111.146.212.59,<->,89.204.9.34,38,20733,0,0,38,20733,0.546414000,0.8984
195.102.51.30,<->,8.20.87.206,0,0,38,2308,38,2308,0.520133000,0.9450
220.28.73.211,<->,133.178.227.4,0,0,38,45412,38,45412,0.510923000,1.4668
136.25.188.237,<->,122.158.245.88,38,8121,0,0,38,8121,0.397825000,1.5034
136.25.188.192,<->,100.224.138.208,38,46814,0,0,38,46814,0.389247000,1.2115
133.178.227.242,<->,111.151.237.171,38,22932,0,0,38,22932,0.371778000,1.5452
142.209.126.75,<->,136.25.188.254,0,0,38,3250,38,3250,0.350394000,1.5024
215.158.140.93,<->,215.158.6.200,38,7288,0,0,38,7288,0.300420000,1.6584
136.25.188.253,<->,94.27.184.101,38,2688,0,0,38,2688,0.236390000,1.5521
133.178.227.28,<->,133.56.180.44,38,45569,0,0,38,45569,0.191871000,1.6396
17.224.231.224,<->,8.20.87.94,0,0,38,2440,38,2440,0.191822000,0.0312
133.178.227.19,<->,131.1.194.205,38,5580,0,0,38,5580,0.159896000,1.0552
245.161.124.40,<->,8.252.222.30,0,0,38,1900,38,1900,0.158381000,0.2508
221.101.9.15,<->,144.87.238.89,38,16741,0,0,38,16741,0.153902000,1.4338
204.58.176.221,<->,136.25.188.198,0,0,38,4273,38,4273,0.126310000,1.6097
143.52.171.63,<->,136.25.188.176,0,0,38,3363,38,3363,0.124833000,1.2792
142.182.58.160,<->,136.25.188.178,0,0,38,2438,38,2438,0.115586000,0.4945
94.195.237.196,<->,8.252.222.109,0,0,38,2480,38,2480,0.109451000,1.8759
215.158.238.64,<->,126.219.194.148,38,14082,0,0,38,14082,0.106145000,1.8100
146.224.77.94,<->,8.252.221.206,0,0,38,1996,38,1996,0.102891000,1.8637
138.98.247.40,<->,0.195.210.42,0,0,38,2260,38,2260,0.096351000,1.0404
215.158.30.229,<->,8.252.222.55,0,0,38,50121,38,50121,0.095592000,0.2752
133.178.227.24,<->,133.56.180.22,38,15970,0,0,38,15970,0.095467000,1.8457
246.253.134.201,<->,128.188.245.102,38,2128,0,0,38,2128,0.087251000,1.0597
133.178.226.29,<->,111.151.239.8,38,16840,0,0,38,16840,0.085759000,1.7985
136.25.188.44,<->,111.151.239.52,38,10831,0,0,38,10831,0.085460000,1.7068
195.127.107.104,<->,136.25.188.209,0,0,38,4321,38,4321,0.082973000,1.8824
94.192.7.219,<->,8.252.222.227,0,0,38,2468,38,2468,0.080516000,1.8064
48.19.218.42,<->,8.252.222.113,0,0,38,2404,38,2404,0.078819000,1.8258
139.163.17.163,<->,57.191.209.23,38,2128,0,0,38,2128,0.078656000,1.9136
89.181.225.9,<->,58.128.248.29,38,54439,0,0,38,54439,0.073806000,1.7164
231.143.119.44,<->,136.25.188.177,0,0,38,4589,38,4589,0.071900000,1.4978
215.158.239.205,<->,50.239.8.3,38,50012,0,0,38,50012,0.071506000,0.9508
8.252.222.197,<->,4.123.63.192,38,2260,0,0,38,2260,0.065921000,1.9146
215.158.238.190,<->,106.188.244.254,38,7441,0,0,38,7441,0.058618000,1.7079
215.158.238.226,<->,140.190.46.212,38,3111,0,0,38,3111,0.057807000,1.0235
133.178.226.61,<->,29.214.108.106,38,9610,0,0,38,9610,0.055824000,1.8893
143.206.94.255,<->,0.195.210.33,0,0,38,2464,38,2464,0.049420000,1.7092
215.158.238.103,<->,100.120.38.6,38,45184,0,0,38,45184,0.044126000,1.6765
144.75.218.235,<->,8.222.218.197,38,4611,0,0,38,4611,0.040374000,1.8502
201.139.220.84,<->,8.252.222.7,0,0,38,2472,38,2472,0.038375000,1.9198
146.224.127.37,<->,8.252.221.223,0,0,38,2002,38,2002,0.037842000,1.9480
199.53.215.39,<->,136.25.188.236,0,0,38,4062,38,4062,0.035421000,1.7352
136.138.112.226,<->,136.25.188.160,0,0,38,10831,38,10831,0.031841000,1.9267
215.158.58.168,<->,6.73.247.121,0,0,38,30709,38,30709,0.031196000,1.9470
95.245.13.166,<->,8.252.222.220,0,0,38,2948,38,2948,0.029375000,1.8563
196.119.218.150,<->,50.223.3.228,0,0,38,1900,38,1900,0.023923000,1.9500
69.243.104.90,<->,8.252.221.220,0,0,38,2296,38,2296,0.022075000,1.8704
94.192.237.69,<->,8.252.222.80,0,0,38,2296,38,2296,0.020345000,1.9642
215.158.239.76,<->,196.94.224.209,38,3118,0,0,38,3118,0.019436000,0.8696
216.184.1.124,<->,8.252.222.27,0,0,38,43176,38,43176,0.019230000,1.0069
146.224.6.193,<->,8.252.222.4,0,0,38,2464,38,2464,0.017267000,1.9746
75.214.114.93,<->,8.252.222.95,0,0,38,2436,38,2436,0.015317000,1.8516
252.98.149.196,<->,198.8.144.150,38,9222,0,0,38,9222,0.013297000,1.9799
195.13.207.241,<->,136.25.188.198,0,0,38,2821,38,2821,0.012066000,1.6498
133.178.227.6,<->,133.56.180.93,38,39809,0,0,38,39809,0.008794000,1.9421
215.158.239.84,<->,204.3.50.238,38,4093,0,0,38,4093,0.008691000,1.7739
139.205.240.222,<->,136.129.57.93,0,0,38,3900,38,3900,0.004781000,0.9189
139.163.17.139,<->,102.240.121.162,38,16646,0,0,38,16646,0.002472000,1.9824
210.221.107.50,<->,111.151.237.50,37,49340,0,0,37,49340,1.743862000,0.2346
148.55.210.212,<->,133.178.227.16,0,0,37,3050,37,3050,1.601376000,0.3980
124.58.171.28,<->,97.126.68.98,0,0,37,55648,37,55648,1.596469000,0.2876
215.158.140.81,<->,98.219.126.175,37,49755,0,0,37,49755,1.508364000,0.0851
159.36.244.13,<->,8.52.183.207,0,0,37,5587,37,5587,1.276477000,0.2240
223.120.87.179,<->,8.252.222.159,0,0,37,4262,37,4262,1.228572000,0.6918
60.101.122.126,<->,8.252.222.143,0,0,37,4130,37,4130,1.157007000,0.7989
144.85.170.246,<->,98.87.146.190,37,3742,0,0,37,3742,1.152194000,0.8393
136.25.189.41,<->,96.156.169.207,37,52027,0,0,37,52027,1.053672000,0.1348
148.184.118.184,<->,0.195.210.42,0,0,37,13337,37,13337,1.030081000,0.9450
215.158.238.73,<->,33.209.217.245,37,9061,0,0,37,9061,0.864688000,1.0126
199.68.160.136,<->,136.25.188.209,0,0,37,2412,37,2412,0.833001000,1.1599
216.184.1.112,<->,8.252.222.170,0,0,37,37668,37,37668,0.805961000,0.7293
195.124.240.74,<->,136.25.188.198,0,0,37,3077,37,3077,0.709502000,1.2580
215.158.238.134,<->,29.214.71.118,37,3085,0,0,37,3085,0.613776000,0.3041
218.111.223.222,<->,8.220.176.253,0,0,37,4356,37,4356,0.609023000,1.3775
204.61.111.1,<->,136.25.188.55,0,0,37,2356,37,2356,0.594622000,0.5182
136.25.188.192,<->,100.224.138.218,37,41040,0,0,37,41040,0.547867000,1.1135
199.32.175.7,<->,136.25.188.226,0,0,37,2765,37,2765,0.465364000,1.2047
215.158.238.217,<->,98.219.126.175,37,46810,0,0,37,46810,0.455020000,1.0749
133.178.226.71,<->,56.1.237.36,37,3229,0,0,37,3229,0.369226000,0.1327
136.25.188.192,<->,100.216.78.145,37,49581,0,0,37,49581,0.352136000,1.4135
136.25.188.172,<->,27.178.41.56,37,5815,0,0,37,5815,0.331993000,1.1385
195.70.205.92,<->,136.25.188.226,0,0,37,3258,37,3258,0.328253000,0.8929
220.55.100.127,<->,220.20.202.66,37,1850,0,0,37,1850,0.297187000,0.3080
133.178.227.19,<->,29.211.122.148,37,5158,0,0,37,5158,0.234104000,1.5479
136.25.188.175,<->,131.1.253.244,37,8894,0,0,37,8894,0.230497000,1.7432
143.10.82.126,<->,136.25.188.175,0,0,37,3044,37,3044,0.200521000,0.8705
207.188.247.218,<->,136.25.188.238,0,0,37,3047,37,3047,0.194010000,1.0823
241.75.192.120,<->,221.101.180.140,0,0,37,3187,37,3187,0.192949000,0.4102
48.129.133.40,<->,8.252.222.196,0,0,37,4610,37,4610,0.191261000,1.6021
215.158.238.91,<->,0.195.253.228,37,49215,0,0,37,49215,0.186997000,0.5244
220.28.65.9,<->,136.25.188.59,0,0,37,46466,37,46466,0.180876000,1.1962
92.27.65.36,<->,8.252.222.36,0,0,37,3374,37,3374,0.169440000,1.5165
207.86.9.133,<->,136.25.188.209,0,0,37,3536,37,3536,0.151457000,1.7011
215.158.239.93,<->,142.253.111.140,37,3618,0,0,37,3618,0.140790000,1.4935
133.178.226.61,<->,57.210.107.43,37,10635,0,0,37,10635,0.138022000,1.8059
230.86.172.107,<->,133.54.43.35,0,0,37,2180,37,2180,0.136616000,1.5406
140.138.86.235,<->,139.163.34.116,0,0,37,1850,37,1850,0.136553000,1.8304
95.245.116.73,<->,8.252.222.178,0,0,37,2300,37,2300,0.134991000,1.8115
215.158.239.57,<->,207.191.213.206,37,3654,0,0,37,3654,0.125505000,1.6145
215.158.239.93,<->,142.237.129.145,37,3692,0,0,37,3692,0.113294000,1.0569
215.158.238.47,<->,119.196.23.41,37,6988,0,0,37,6988,0.113145000,1.7295
94.185.224.70,<->,8.252.223.76,0,0,37,2276,37,2276,0.106984000,1.8801
58.203.185.53,<->,8.252.222.20,0,0,37,2176,37,2176,0.105914000,1.8280
223.115.181.200,<->,8.252.222.238,0,0,37,2504,37,2504,0.105664000,1.8680
215.158.239.56,<->,199.121.109.137,37,2117,0,0,37,2117,0.097409000,0.6495
146.149.82.34,<->,8.252.222.206,0,0,37,2368,37,2368,0.093619000,1.9035
199.58.157.228,<->,50.223.3.228,0,0,37,1850,37,1850,0.089472000,0.9641
195.15.40.214,<->,136.25.188.225,0,0,37,2178,37,2178,0.085213000,0.4945
141.172.220.242,<->,8.252.222.23,0,0,37,2787,37,2787,0.075665000,1.4984
92.27.51.116,<->,80.40.41.53,0,0,37,34969,37,34969,0.071935000,1.8947
215.158.239.84,<->,215.158.44.228,37,11776,0,0,37,11776,0.068350000,1.8606
215.158.58.209,<->,6.73.247.102,0,0,37,45871,37,45871,0.056692000,1.5515
215.158.238.65,<->,112.220.206.100,37,10875,0,0,37,10875,0.053361000,1.8441
43.52.0.114,<->,8.252.222.227,0,0,37,2340,37,2340,0.050305000,1.9394
58.242.234.195,<->,8.252.222.77,0,0,37,2320,37,2320,0.049318000,1.8544
136.25.189.39,<->,98.219.126.175,37,42148,0,0,37,42148,0.048669000,1.8973
133.178.226.67,<->,133.56.180.2,37,46186,0,0,37,46186,0.045088000,1.7690
230.102.130.22,<->,133.178.227.192,0,0,37,10951,37,10951,0.044820000,1.9288
215.158.238.89,<->,100.120.38.6,37,45448,0,0,37,45448,0.044337000,1.0792
58.242.182.114,<->,8.252.221.223,0,0,37,1944,37,1944,0.043446000,1.8494
215.158.140.62,<->,98.219.126.175,37,50651,0,0,37,50651,0.041948000,0.0914
74.142.127.211,<->,8.252.222.80,0,0,37,2096,37,2096,0.040221000,1.8245
204.123.155.57,<->,50.223.3.228,0,0,37,1886,37,1886,0.037583000,1.8141
95.246.38.20,<->,8.252.222.221,0,0,37,3092,37,3092,0.035038000,1.8030
194.253.83.56,<->,8.252.222.177,0,0,37,1906,37,1906,0.033342000,1.9380
215.158.239.95,<->,207.114.160.1,37,3538,0,0,37,3538,0.029083000,1.7099
220.20.200.26,<->,193.32.107.107,37,45634,0,0,37,45634,0.024166000,1.3919
133.178.226.37,<->,8.222.212.26,37,10855,0,0,37,10855,0.023520000,1.9557
139.163.83.153,<->,98.150.54.68,37,10405,0,0,37,10405,0.021749000,0.7555
215.158.238.190,<->,139.8.186.137,37,8268,0,0,37,8268,0.013231000,1.4280
95.247.185.201,<->,8.252.221.230,0,0,37,2204,37,2204,0.011620000,1.9576
215.158.239.79,<->,199.20.5.129,37,5463,0,0,37,5463,0.007539000,1.9902
207.60.79.224,<->,136.25.188.238,0,0,37,2252,37,2252,0.005459000,0.5179
215.158.140.228,<->,137.206.182.219,37,3637,0,0,37,3637,0.002254000,0.2684
92.168.217.227,<->,42.71.215.135,37,2072,0,0,37,2072,0.002014000,1.9967
215.158.238.80,<->,119.196.23.9,37,5895,0,0,37,5895,0.001542000,1.9202
146.224.112.13,<->,8.252.222.125,0,0,37,2532,37,2532,0.001484000,1.9815
144.85.170.245,<->,6.242.52.30,36,2575,0,0,36,2575,1.758015000,0.2220
142.228.90.12,<->,136.25.188.253,0,0,36,5888,36,5888,1.313854000,0.6590
215.158.239.79,<->,199.68.63.106,36,3963,0,0,36,3963,1.226924000,0.4361
136.25.189.86,<->,96.156.169.226,36,41517,0,0,36,41517,1.079089000,0.8636
199.68.121.14,<->,136.25.188.174,0,0,36,4684,36,4684,1.056816000,0.7752
194.237.181.162,<->,136.25.188.52,0,0,36,2934,36,2934,1.054541000,0.6344
133.178.227.41,<->,80.57.141.43,36,3189,0,0,36,3189,1.041508000,0.2022
133.178.226.95,<->,0.195.253.228,36,50061,0,0,36,50061,1.034805000,0.5914
215.158.239.51,<->,142.227.29.246,36,3816,0,0,36,3816,0.980684000,0.9695
215.158.239.56,<->,194.237.186.85,36,2880,0,0,36,2880,0.890922000,0.9038
118.215.223.33,<->,92.27.219.198,0,0,36,45881,36,45881,0.687611000,1.2672
136.25.189.84,<->,56.28.207.191,36,37463,0,0,36,37463,0.501775000,1.4351
215.158.30.254,<->,8.252.222.55,0,0,36,43352,36,43352,0.416305000,0.2226
144.71.44.67,<->,143.73.157.209,36,2584,0,0,36,2584,0.410891000,0.7775
136.25.189.38,<->,96.156.169.167,36,40194,0,0,36,40194,0.379447000,1.3873
136.25.188.246,<->,0.195.253.228,36,49441,0,0,36,49441,0.366252000,0.3383
199.38.163.163,<->,136.25.188.237,0,0,36,2875,36,2875,0.348488000,1.2717
215.158.239.58,<->,142.247.209.45,36,3046,0,0,36,3046,0.319358000,1.5287
215.158.239.72,<->,111.52.91.115,36,46208,0,0,36,46208,0.308777000,1.3636
100.235.216.111,<->,50.224.88.92,0,0,36,2016,36,2016,0.303969000,1.6144
215.158.238.75,<->,112.220.206.8,36,10195,0,0,36,10195,0.263740000,1.5956
215.158.140.207,<->,124.43.95.12,36,6989,0,0,36,6989,0.255491000,1.7291
137.39.55.11,<->,100.228.42.205,0,0,36,20059,36,20059,0.248898000,1.3845
220.28.114.28,<->,136.25.189.5,0,0,36,46459,36,46459,0.237070000,1.6539
133.178.226.14,<->,96.155.60.202,36,13914,0,0,36,13914,0.214625000,0.8398
129.225.132.224,<->,129.225.131.136,36,5370,0,0,36,5370,0.189788000,1.7870
142.229.148.211,<->,136.25.188.224,0,0,36,3795,36,3795,0.175292000,0.5630
136.25.188.45,<->,126.219.247.24,36,5663,0,0,36,5663,0.168439000,1.5751
215.158.239.97,<->,199.20.30.196,36,2143,0,0,36,2143,0.163606000,1.7200
133.178.227.16,<->,8.191.7.221,36,11378,0,0,36,11378,0.160623000,1.8154
145.90.158.253,<->,133.178.227.82,0,0,36,1884,36,1884,0.157102000,1.7993
95.247.189.16,<->,8.252.222.221,0,0,36,2260,36,2260,0.142946000,1.8147
102.254.20.36,<->,97.198.122.218,0,0,36,2707,36,2707,0.119810000,1.8664
133.178.227.2,<->,100.50.96.229,36,4093,0,0,36,4093,0.112856000,1.7177
136.25.188.165,<->,100.224.166.120,36,48266,0,0,36,48266,0.106644000,1.3122
133.178.227.37,<->,133.56.180.44,36,32902,0,0,36,32902,0.100113000,1.8245
109.1.58.175,<->,92.27.102.178,36,33785,0,0,36,33785,0.099941000,1.8916
192.64.227.158,<->,92.27.51.117,36,33276,0,0,36,33276,0.093599000,1.8919
215.158.239.166,<->,8.222.213.141,36,10858,0,0,36,10858,0.092236000,1.5838
140.165.140.201,<->,8.252.221.236,0,0,36,3355,36,3355,0.091261000,1.8066
152.105.69.54,<->,8.252.222.223,0,0,36,2232,36,2232,0.087040000,1.8768
127.111.242.149,<->,8.9.165.187,0,0,36,2016,36,2016,0.086079000,1.8309
215.158.140.241,<->,89.76.109.233,36,2172,0,0,36,2172,0.085387000,1.7756
215.158.238.98,<->,131.1.195.249,36,15290,0,0,36,15290,0.072649000,1.9075
114.48.32.71,<->,101.70.183.44,0,0,36,5488,36,5488,0.072078000,1.9273
8.252.222.197,<->,4.123.173.51,36,2234,0,0,36,2234,0.067021000,1.8439
118.234.178.113,<->,89.183.104.227,0,0,36,50190,36,50190,0.065872000,1.7933
107.19.40.128,<->,92.27.219.197,0,0,36,16324,36,16324,0.065685000,1.9203
92.27.51.127,<->,6.228.36.29,0,0,36,33276,36,33276,0.058201000,1.8913
136.25.189.24,<->,96.156.169.218,36,39122,0,0,36,39122,0.048902000,1.0958
215.158.238.142,<->,33.209.217.230,36,14552,0,0,36,14552,0.048055000,1.8919
215.158.238.143,<->,8.42.43.9,36,9470,0,0,36,9470,0.046295000,1.9302
139.163.33.77,<->,120.19.65.67,36,2016,0,0,36,2016,0.045839000,1.8924
133.178.227.40,<->,133.56.180.95,36,12019,0,0,36,12019,0.044468000,1.4183
220.248.81.33,<->,136.25.188.220,0,0,36,3966,36,3966,0.034988000,0.4280
138.98.174.211,<->,99.167.15.52,36,17808,0,0,36,17808,0.025383000,1.9467
199.70.28.203,<->,136.25.188.255,0,0,36,3230,36,3230,0.025267000,1.3731
133.178.227.7,<->,133.56.180.78,36,32841,0,0,36,32841,0.023985000,1.7555
215.158.239.17,<->,96.135.154.155,36,8484,0,0,36,8484,0.023428000,1.4526
95.244.99.111,<->,8.252.221.204,0,0,36,1926,36,1926,0.021970000,1.9131
133.178.226.61,<->,106.188.236.164,36,9806,0,0,36,9806,0.019805000,1.9774
8.252.221.223,<->,4.122.51.161,36,1902,0,0,36,1902,0.016825000,1.8526
117.156.242.240,<->,100.94.188.95,0,0,36,6415,36,6415,0.016437000,1.9776
215.158.238.82,<->,80.47.111.89,36,10947,0,0,36,10947,0.011209000,1.5274
215.158.239.57,<->,145.13.164.192,36,23109,0,0,36,23109,0.010935000,1.2100
102.28.84.233,<->,22.59.8.111,0,0,36,3835,36,3835,0.009681000,1.4859
199.33.29.229,<->,136.25.188.177,0,0,36,3588,36,3588,0.008127000,1.2873
8.252.221.204,<->,4.122.255.186,36,2208,0,0,36,2208,0.007532000,1.8584
207.97.111.190,<->,8.20.87.206,0,0,36,2016,36,2016,0.004516000,1.7745
215.158.239.38,<->,215.158.127.142,36,46460,0,0,36,46460,0.004213000,1.9290
48.16.74.157,<->,8.252.221.198,0,0,36,1894,36,1894,0.003296000,1.8399
36.116.147.153,<->,8.252.222.127,0,0,36,2360,36,2360,0.001124000,1.9471
36.116.65.38,<->,8.252.222.227,0,0,36,2380,36,2380,0.000550000,1.9642
215.158.238.64,<->,126.219.194.151,36,11400,0,0,36,11400,0.000163000,1.9260
215.158.239.70,<->,195.54.93.62,35,1966,0,0,35,1966,1.333340000,0.6638
144.81.101.239,<->,144.71.42.15,0,0,35,39035,35,39035,1.239568000,0.3141
133.178.227.78,<->,96.155.60.130,35,2941,0,0,35,2941,1.223940000,0.1439
133.178.226.29,<->,106.188.252.212,35,3149,0,0,35,3149,1.217082000,0.2229
215.158.239.216,<->,54.55.19.94,35,50469,0,0,35,50469,1.194616000,0.0501
215.158.140.241,<->,69.31.238.156,35,4560,0,0,35,4560,1.021892000,0.7215
133.178.227.138,<->,80.47.104.32,35,3066,0,0,35,3066,0.985426000,0.8751
220.28.114.28,<->,133.178.227.10,0,0,35,42732,35,42732,0.971278000,0.9609
215.158.239.80,<->,145.116.209.76,35,35223,0,0,35,35223,0.963035000,0.2494
202.33.225.34,<->,136.25.188.225,0,0,35,4434,35,4434,0.848742000,1.1199
215.158.239.58,<->,142.247.210.117,35,2405,0,0,35,2405,0.838873000,0.7681
215.158.239.69,<->,207.213.204.99,35,3519,0,0,35,3519,0.766083000,0.9505
215.158.239.49,<->,142.227.68.157,35,3134,0,0,35,3134,0.692134000,0.6458
133.178.227.70,<->,133.56.180.23,35,9473,0,0,35,9473,0.642642000,1.3492
215.158.238.59,<->,131.1.235.145,35,4772,0,0,35,4772,0.609412000,1.2325
215.158.239.90,<->,145.116.209.92,35,36471,0,0,35,36471,0.552116000,0.6842
231.138.132.252,<->,136.25.188.199,0,0,35,2735,35,2735,0.519176000,0.8921
133.178.227.19,<->,68.231.10.139,35,4530,0,0,35,4530,0.518164000,1.3588
215.158.239.237,<->,120.49.159.72,35,15201,0,0,35,15201,0.494909000,1.4748
215.158.238.220,<->,139.163.163.176,35,3266,0,0,35,3266,0.443995000,0.2124
156.152.163.10,<->,8.252.222.21,0,0,35,2258,35,2258,0.441031000,0.2253
215.158.238.82,<->,38.104.11.107,35,3037,0,0,35,3037,0.410183000,1.5565
142.208.125.122,<->,136.25.188.45,0,0,35,4954,35,4954,0.378727000,0.8428
215.158.239.76,<->,196.0.158.60,35,2050,0,0,35,2050,0.372685000,1.0098
143.44.252.34,<->,136.25.188.198,0,0,35,3527,35,3527,0.362237000,1.2775
220.28.104.193,<->,215.158.238.254,0,0,35,44142,35,44142,0.312080000,1.0500
87.13.216.134,<->,8.220.191.154,0,0,35,3948,35,3948,0.285876000,0.3187
215.158.238.251,<->,120.154.179.8,35,6018,0,0,35,6018,0.256592000,1.7350
204.3.38.137,<->,136.25.188.255,0,0,35,4329,35,4329,0.253126000,1.7037
213.186.52.14,<->,144.85.170.246,0,0,35,2991,35,2991,0.245200000,1.2565
143.23.101.189,<->,136.25.188.236,0,0,35,1756,35,1756,0.242361000,0.5969
207.61.57.220,<->,136.25.188.173,0,0,35,4389,35,4389,0.239281000,1.5502
142.221.98.201,<->,136.25.188.243,0,0,35,2235,35,2235,0.232363000,0.9062
136.25.188.163,<->,57.160.181.181,35,8593,0,0,35,8593,0.221239000,1.7739
215.158.239.58,<->,195.49.238.178,35,4328,0,0,35,4328,0.218306000,1.7299
206.69.16.143,<->,89.183.104.165,0,0,35,49590,35,49590,0.217881000,1.7736
192.204.123.52,<->,136.25.189.83,0,0,35,18761,35,18761,0.207450000,1.7892
133.178.226.200,<->,133.146.0.83,35,1960,0,0,35,1960,0.205114000,1.5031
192.67.171.3,<->,125.20.13.179,35,1750,0,0,35,1750,0.202862000,1.3928
215.158.238.67,<->,8.188.227.41,35,5623,0,0,35,5623,0.185616000,1.4764
215.158.239.79,<->,199.15.16.24,35,3528,0,0,35,3528,0.165137000,1.0513
136.25.189.9,<->,96.156.169.208,35,45115,0,0,35,45115,0.160587000,1.6647
215.158.239.92,<->,199.20.5.74,35,2095,0,0,35,2095,0.158234000,1.1700
215.158.238.90,<->,100.216.78.145,35,45200,0,0,35,45200,0.151213000,0.5056
159.137.139.27,<->,133.178.226.70,0,0,35,4482,35,4482,0.136543000,1.5262
136.25.188.160,<->,27.178.41.51,35,8017,0,0,35,8017,0.134273000,1.6210
8.252.222.4,<->,4.120.148.232,35,2140,0,0,35,2140,0.132659000,1.8327
147.58.211.37,<->,8.252.221.200,0,0,35,12965,35,12965,0.128877000,1.7411
144.81.195.144,<->,136.25.188.37,0,0,35,43582,35,43582,0.124802000,0.9347
195.43.156.127,<->,136.25.188.209,0,0,35,3821,35,3821,0.124200000,1.7562
204.38.90.213,<->,50.223.3.228,0,0,35,1750,35,1750,0.124125000,1.7279
142.240.54.193,<->,136.25.188.175,0,0,35,2033,35,2033,0.116699000,0.5307
92.27.219.225,<->,27.79.198.231,35,2347,0,0,35,2347,0.107910000,1.8518
195.13.68.8,<->,136.25.188.253,0,0,35,3848,35,3848,0.098899000,0.4504
133.54.43.46,<->,115.81.79.69,35,1960,0,0,35,1960,0.079736000,0.7930
95.246.210.147,<->,8.252.222.223,0,0,35,2232,35,2232,0.070652000,1.9233
197.108.9.58,<->,109.1.0.79,0,0,35,1820,35,1820,0.063395000,1.8930
43.55.226.134,<->,8.252.222.81,0,0,35,2324,35,2324,0.063353000,1.7739
133.178.227.19,<->,8.50.170.249,35,5136,0,0,35,5136,0.060922000,1.3973
215.158.238.133,<->,113.23.21.215,35,4306,0,0,35,4306,0.057258000,1.3273
136.25.188.44,<->,8.222.7.55,35,9286,0,0,35,9286,0.055518000,1.7068
215.158.238.177,<->,122.158.245.24,35,3121,0,0,35,3121,0.055469000,0.7313
68.74.199.8,<->,8.252.221.204,0,0,35,2088,35,2088,0.052605000,1.8572
106.209.215.4,<->,80.42.159.46,0,0,35,1922,35,1922,0.048031000,1.8955
204.3.186.15,<->,136.25.188.46,0,0,35,4495,35,4495,0.047917000,1.7106
143.42.108.80,<->,136.25.188.44,0,0,35,3505,35,3505,0.045362000,1.7825
220.28.85.14,<->,215.158.239.46,0,0,35,49855,35,49855,0.040239000,0.0433
205.127.108.114,<->,33.233.141.33,0,0,35,17263,35,17263,0.039754000,1.9450
220.55.119.112,<->,158.92.178.127,35,3078,0,0,35,3078,0.036606000,1.9608
215.158.238.143,<->,131.1.195.220,35,7341,0,0,35,7341,0.034255000,1.8547
69.93.67.175,<->,0.195.210.15,0,0,35,6762,35,6762,0.033132000,1.9299
204.39.197.90,<->,35.56.97.193,0,0,35,2338,35,2338,0.024462000,1.9517
215.158.238.83,<->,104.3.163.38,35,12849,0,0,35,12849,0.024369000,1.9551
215.158.238.123,<->,145.116.209.86,35,24781,0,0,35,24781,0.022583000,1.9284
93.181.154.111,<->,92.27.219.161,0,0,35,47604,35,47604,0.021155000,1.9297
215.158.238.134,<->,91.57.173.61,35,10311,0,0,35,10311,0.020625000,1.9340
146.188.27.11,<->,0.195.210.15,0,0,35,6140,35,6140,0.018878000,1.8646
215.158.239.49,<->,199.20.28.47,35,1960,0,0,35,1960,0.011785000,1.0598
95.247.215.93,<->,8.252.223.0,0,0,35,2268,35,2268,0.009564000,1.8433
133.178.226.90,<->,80.47.111.5,35,10315,0,0,35,10315,0.007404000,1.8800
215.158.238.250,<->,120.154.179.31,35,6140,0,0,35,6140,0.006882000,1.9753
133.178.227.255,<->,126.219.54.44,35,6536,0,0,35,6536,0.006027000,1.4193
204.130.125.84,<->,8.252.222.225,0,0,35,1804,35,1804,0.002916000,1.9090
213.186.59.241,<->,144.85.170.246,0,0,35,2762,35,2762,0.001060000,1.9120
143.129.109.145,<->,136.25.188.252,0,0,35,2247,35,2247,0.000827000,0.7123
199.81.208.250,<->,136.25.188.209,0,0,34,2556,34,2556,1.631766000,0.2116
139.148.158.59,<->,8.182.224.87,0,0,34,2638,34,2638,1.617731000,0.3534
136.25.189.10,<->,96.156.169.218,34,45586,0,0,34,45586,1.407048000,0.5174
133.178.226.61,<->,38.51.98.246,34,3089,0,0,34,3089,1.332383000,0.2967
231.142.117.120,<->,215.158.239.99,0,0,34,4293,34,4293,1.155155000,0.8431
207.236.205.138,<->,136.25.188.209,0,0,34,2720,34,2720,1.128755000,0.7327
207.62.135.29,<->,136.25.188.198,0,0,34,2897,34,2897,1.113330000,0.8097
142.244.203.221,<->,136.25.188.225,0,0,34,2492,34,2492,0.971462000,0.7928
92.168.217.147,<->,0.47.218.84,34,2403,0,0,34,2403,0.832414000,1.1010
249.101.209.167,<->,246.108.107.164,34,1706,0,0,34,1706,0.624597000,1.3507
215.158.239.87,<->,207.213.143.199,34,6127,0,0,34,6127,0.617565000,1.1192
215.158.238.148,<->,128.62.135.152,34,3037,0,0,34,3037,0.498640000,0.7201
204.47.12.101,<->,100.93.156.90,0,0,34,2078,34,2078,0.487461000,1.3344
220.28.85.14,<->,133.178.227.52,0,0,34,47889,34,47889,0.439277000,0.1210
133.178.227.59,<->,133.56.180.79,34,3095,0,0,34,3095,0.378723000,0.0534
136.25.188.175,<->,57.160.181.238,34,9984,0,0,34,9984,0.281391000,1.6581
109.222.223.113,<->,53.218.54.83,34,41302,0,0,34,41302,0.271593000,1.6769
133.178.226.37,<->,104.3.163.55,34,7204,0,0,34,7204,0.258453000,1.6530
133.178.227.57,<->,104.3.168.149,34,7822,0,0,34,7822,0.253153000,1.7189
136.25.188.49,<->,100.224.202.157,34,36825,0,0,34,36825,0.238120000,1.6074
136.25.189.25,<->,96.156.169.167,34,36706,0,0,34,36706,0.236723000,1.4957
215.158.239.55,<->,129.175.139.25,34,43012,0,0,34,43012,0.232723000,1.5749
199.68.77.60,<->,136.25.188.242,0,0,34,2215,34,2215,0.220353000,0.9229
136.25.189.21,<->,96.156.169.239,34,42857,0,0,34,42857,0.212655000,1.7800
221.102.56.46,<->,91.251.114.196,0,0,34,42333,34,42333,0.192280000,0.5449
220.39.233.164,<->,215.158.238.64,0,0,34,9386,34,9386,0.183264000,1.7943
95.245.112.109,<->,8.252.222.115,0,0,34,2148,34,2148,0.177726000,1.7709
215.158.239.56,<->,196.108.80.66,34,3220,0,0,34,3220,0.151808000,1.6320
94.194.201.39,<->,8.252.221.204,0,0,34,2770,34,2770,0.148923000,1.1953
89.183.104.136,<->,59.145.64.89,34,30282,0,0,34,30282,0.148757000,1.8385
215.158.239.113,<->,129.222.39.134,34,19162,0,0,34,19162,0.137986000,1.7827
75.214.133.199,<->,8.252.221.236,0,0,34,2072,34,2072,0.137010000,1.7257
110.65.7.153,<->,89.183.104.131,0,0,34,19196,34,19196,0.131457000,1.7814
215.158.140.75,<->,8.240.116.171,34,8061,0,0,34,8061,0.129791000,1.6664
133.178.227.76,<->,130.165.253.13,34,4280,0,0,34,4280,0.121022000,1.8578
215.158.140.76,<->,8.190.217.55,34,9486,0,0,34,9486,0.116146000,1.8629
215.158.239.95,<->,204.226.109.183,34,5295,0,0,34,5295,0.114423000,0.6433
50.138.145.160,<->,8.20.87.94,0,0,34,2222,34,2222,0.112652000,0.2430
110.3.31.65,<->,92.27.219.230,0,0,34,1768,34,1768,0.106923000,1.6766
194.237.116.255,<->,136.25.188.55,0,0,34,3636,34,3636,0.106338000,0.5051
74.19.187.52,<->,0.195.210.42,0,0,34,1700,34,1700,0.104987000,0.5522
61.125.102.105,<->,8.252.221.239,0,0,34,2024,34,2024,0.102735000,1.8248
253.220.179.237,<->,136.25.188.173,0,0,34,3185,34,3185,0.086490000,0.1356
92.27.27.189,<->,18.202.25.173,34,1722,0,0,34,1722,0.069785000,1.7691
136.25.188.173,<->,106.188.236.186,34,7609,0,0,34,7609,0.066486000,1.5924
132.192.226.82,<->,96.134.25.120,34,2304,0,0,34,2304,0.061508000,1.7013
133.178.227.86,<->,133.55.11.211,34,4918,0,0,34,4918,0.056478000,1.9099
220.28.65.9,<->,215.158.239.66,0,0,34,38160,34,38160,0.055442000,1.7561
136.25.189.5,<->,96.156.169.197,34,37885,0,0,34,37885,0.052278000,1.4459
97.126.8.58,<->,54.51.136.137,34,1904,0,0,34,1904,0.048583000,1.9380
133.178.227.16,<->,131.1.195.25,34,7534,0,0,34,7534,0.046138000,0.8762
215.158.239.95,<->,196.0.240.73,34,3534,0,0,34,3534,0.043928000,1.9291
142.253.203.77,<->,136.25.188.198,0,0,34,3804,34,3804,0.043216000,0.7207
102.15.93.79,<->,97.198.108.247,0,0,34,1904,34,1904,0.035765000,1.9602
195.84.18.201,<->,0.195.210.33,0,0,34,3203,34,3203,0.035491000,1.9400
136.25.189.34,<->,133.56.180.32,34,20459,0,0,34,20459,0.030055000,1.9427
132.222.168.221,<->,97.91.14.64,34,50164,0,0,34,50164,0.029670000,1.5176
215.158.239.87,<->,142.255.130.247,34,2926,0,0,34,2926,0.023571000,0.6324
95.246.100.215,<->,8.252.223.0,0,0,34,2132,34,2132,0.016899000,1.9343
197.199.10.134,<->,196.148.128.241,0,0,34,3426,34,3426,0.014096000,1.7155
249.129.136.212,<->,111.151.139.247,34,15166,0,0,34,15166,0.013941000,1.9505
136.25.189.0,<->,96.135.155.4,34,18745,0,0,34,18745,0.013657000,1.9502
158.85.62.215,<->,133.178.227.201,0,0,34,12606,34,12606,0.012222000,1.9828
137.170.13.105,<->,101.123.188.42,0,0,34,7898,34,7898,0.011923000,1.9836
8.252.222.222,<->,4.123.47.63,34,2188,0,0,34,2188,0.011753000,1.9735
247.136.146.184,<->,112.99.239.91,34,1802,0,0,34,1802,0.010335000,1.9365
215.158.238.190,<->,8.57.163.151,34,3973,0,0,34,3973,0.010216000,1.9850
207.61.246.212,<->,136.25.188.253,0,0,34,5084,34,5084,0.009407000,1.6375
247.136.212.186,<->,42.255.83.31,34,19273,0,0,34,19273,0.009300000,1.8826
8.182.248.147,<->,6.242.1.99,34,1700,0,0,34,1700,0.009064000,1.9582
94.195.230.11,<->,8.252.222.177,0,0,34,2132,34,2132,0.006964000,1.8839
133.178.226.19,<->,29.212.182.225,34,3185,0,0,34,3185,0.006669000,0.2745
215.158.238.73,<->,33.209.217.201,34,13818,0,0,34,13818,0.003603000,1.8715
133.54.43.36,<->,88.8.214.224,34,1904,0,0,34,1904,0.003233000,0.2952
136.25.188.47,<->,122.159.245.149,34,17052,0,0,34,17052,0.003211000,1.9202
111.14.33.189,<->,92.162.253.158,0,0,33,45730,33,45730,1.707047000,0.0809
142.244.59.48,<->,136.25.188.237,0,0,33,2775,33,2775,1.616102000,0.3234
213.186.52.10,<->,144.85.170.246,0,0,33,2691,33,2691,1.419976000,0.5669
221.102.56.34,<->,100.182.141.178,0,0,33,41409,33,41409,1.396143000,0.2014
215.158.238.92,<->,158.192.5.136,33,3117,0,0,33,3117,1.385246000,0.1039
136.25.188.48,<->,80.57.141.130,33,34175,0,0,33,34175,1.265947000,0.2084
215.158.238.227,<->,120.155.8.88,33,3386,0,0,33,3386,1.198561000,0.1333
195.71.163.209,<->,136.25.188.162,0,0,33,3103,33,3103,1.187963000,0.6244
136.25.188.33,<->,91.42.112.172,33,44861,0,0,33,44861,1.123652000,0.8293
208.68.192.15,<->,8.182.224.87,0,0,33,2800,33,2800,1.112200000,0.1510
215.158.239.56,<->,142.236.54.27,33,3407,0,0,33,3407,1.013734000,0.9561
194.253.228.176,<->,8.252.222.187,0,0,33,2707,33,2707,1.013255000,0.9674
213.186.52.93,<->,144.85.170.244,0,0,33,2688,33,2688,1.012534000,0.6643
209.171.148.225,<->,8.52.178.124,0,0,33,2477,33,2477,0.975284000,0.1600
215.158.239.58,<->,199.20.31.247,33,2764,0,0,33,2764,0.961110000,0.9898
196.148.174.227,<->,53.243.94.129,33,41947,0,0,33,41947,0.899338000,0.4515
204.184.0.138,<->,136.25.188.175,0,0,33,2190,33,2190,0.871847000,1.1200
199.33.113.5,<->,136.25.188.197,0,0,33,2533,33,2533,0.660815000,0.3217
215.158.238.70,<->,97.174.232.172,33,38476,0,0,33,38476,0.646180000,1.2416
195.71.148.54,<->,136.25.188.174,0,0,33,2801,33,2801,0.641258000,1.0808
139.163.161.50,<->,136.25.188.234,0,0,33,46889,33,46889,0.537646000,0.2020
215.158.238.81,<->,112.220.206.24,33,4190,0,0,33,4190,0.536739000,1.0138
223.115.228.192,<->,8.252.222.160,0,0,33,3539,33,3539,0.527522000,1.3857
215.158.239.56,<->,207.62.181.205,33,3423,0,0,33,3423,0.524358000,1.1750
133.178.227.19,<->,133.56.180.89,33,11862,0,0,33,11862,0.506412000,1.4557
89.152.249.246,<->,8.182.239.159,0,0,33,2634,33,2634,0.458088000,0.3142
197.113.64.150,<->,136.25.188.52,0,0,33,3371,33,3371,0.455148000,1.5319
215.158.239.68,<->,194.234.173.124,33,3453,0,0,33,3453,0.452019000,0.9338
136.25.188.235,<->,0.195.237.14,33,45386,0,0,33,45386,0.426643000,0.0214
158.192.3.218,<->,136.25.188.221,0,0,33,6792,33,6792,0.416238000,1.4843
136.25.188.237,<->,29.214.64.198,33,5543,0,0,33,5543,0.410376000,1.3583
207.236.205.138,<->,136.25.188.242,0,0,33,2853,33,2853,0.393905000,0.9451
136.25.188.175,<->,97.178.252.120,33,4292,0,0,33,4292,0.390282000,0.4077
199.73.64.238,<->,136.25.188.174,0,0,33,3437,33,3437,0.382687000,0.6680
215.158.239.68,<->,194.237.122.233,33,3496,0,0,33,3496,0.378881000,1.0718
215.158.238.190,<->,106.188.252.184,33,3954,0,0,33,3954,0.336123000,1.5173
215.158.239.196,<->,113.23.17.205,33,47592,0,0,33,47592,0.333608000,0.1691
221.102.143.189,<->,220.80.186.56,0,0,33,45318,33,45318,0.291809000,0.6778
133.178.227.24,<->,29.211.228.245,33,6374,0,0,33,6374,0.289166000,1.4123
136.25.188.211,<->,120.154.221.214,33,5511,0,0,33,5511,0.287063000,1.1063
97.126.113.29,<->,0.195.202.28,33,4394,0,0,33,4394,0.273925000,1.7006
215.158.239.76,<->,196.91.143.41,33,2126,0,0,33,2126,0.266010000,0.8001
133.178.227.76,<->,133.56.180.95,33,13168,0,0,33,13168,0.256566000,1.7362
215.158.239.85,<->,199.33.244.90,33,2417,0,0,33,2417,0.253361000,1.3389
136.25.188.254,<->,29.214.108.74,33,8113,0,0,33,8113,0.213505000,1.7603
215.158.239.76,<->,204.61.240.183,33,2084,0,0,33,2084,0.191643000,0.3242
207.62.95.124,<->,136.25.188.220,0,0,33,2858,33,2858,0.187699000,0.8185
220.39.233.198,<->,136.25.188.254,0,0,33,8449,33,8449,0.184457000,1.6671
223.136.71.18,<->,8.52.180.169,0,0,33,2008,33,2008,0.178471000,1.7502
215.158.238.80,<->,8.42.43.36,33,10279,0,0,33,10279,0.176288000,1.6458
215.158.238.133,<->,122.158.49.136,33,8140,0,0,33,8140,0.166630000,1.7520
143.13.124.187,<->,136.25.188.199,0,0,33,2028,33,2028,0.162260000,1.6554
204.184.118.17,<->,136.25.188.173,0,0,33,2795,33,2795,0.157458000,0.7277
215.158.238.221,<->,131.1.195.59,33,4013,0,0,33,4013,0.127219000,1.5669
198.196.107.83,<->,92.27.219.172,0,0,33,48510,33,48510,0.127089000,1.8713
94.192.3.190,<->,8.252.221.230,0,0,33,1668,33,1668,0.126591000,1.8725
136.25.188.220,<->,27.178.41.57,33,6876,0,0,33,6876,0.123376000,1.5971
133.178.226.61,<->,69.150.168.247,33,9366,0,0,33,9366,0.122850000,1.7854
133.178.227.16,<->,106.188.245.195,33,4923,0,0,33,4923,0.120470000,1.1104
142.206.167.252,<->,136.25.188.46,0,0,33,3894,33,3894,0.119191000,1.2069
195.69.252.157,<->,136.25.188.242,0,0,33,1921,33,1921,0.114719000,1.3603
215.158.238.149,<->,131.1.232.169,33,9298,0,0,33,9298,0.110689000,1.7516
136.25.189.26,<->,96.156.169.218,33,28687,0,0,33,28687,0.110594000,1.8422
136.25.188.221,<->,8.222.212.20,33,13914,0,0,33,13914,0.108684000,1.5586
215.158.238.32,<->,80.47.111.67,33,9206,0,0,33,9206,0.107786000,1.8740
215.158.238.238,<->,131.36.105.63,33,3023,0,0,33,3023,0.107414000,0.5081
215.158.239.70,<->,126.219.194.40,33,15592,0,0,33,15592,0.106434000,1.7003
215.158.238.190,<->,29.214.108.217,33,4819,0,0,33,4819,0.098782000,1.8858
215.158.239.47,<->,56.97.186.37,33,41259,0,0,33,41259,0.091721000,1.7124
50.224.89.243,<->,42.83.15.123,33,14237,0,0,33,14237,0.090229000,1.7864
133.178.227.57,<->,126.219.132.44,33,5940,0,0,33,5940,0.089935000,1.6497
215.158.238.65,<->,8.188.227.36,33,6604,0,0,33,6604,0.086496000,1.8188
215.158.239.58,<->,199.80.28.204,33,3182,0,0,33,3182,0.085903000,1.8237
142.248.13.235,<->,136.25.188.196,0,0,33,2275,33,2275,0.084295000,0.8584
100.93.185.72,<->,8.55.239.156,33,43927,0,0,33,43927,0.072925000,0.1689
136.25.188.179,<->,106.188.236.250,33,6876,0,0,33,6876,0.071632000,1.5807
48.16.199.59,<->,8.252.222.71,0,0,33,2028,33,2028,0.070683000,1.7504
89.183.104.148,<->,48.111.159.80,33,45674,0,0,33,45674,0.068648000,1.8009
142.191.9.219,<->,136.25.188.241,0,0,33,2908,33,2908,0.066456000,1.2034
133.178.227.16,<->,8.40.51.213,33,5890,0,0,33,5890,0.065003000,1.8983
139.105.162.25,<->,6.28.164.237,33,1650,0,0,33,1650,0.064687000,1.8632
133.178.227.37,<->,133.56.180.35,33,35440,0,0,33,35440,0.064286000,1.3890
144.94.162.244,<->,0.195.210.42,0,0,33,2565,33,2565,0.062670000,1.9068
94.192.42.180,<->,8.252.222.186,0,0,33,2117,33,2117,0.061562000,0.5659
215.158.239.110,<->,133.101.98.175,33,36786,0,0,33,36786,0.053987000,0.6687
158.85.62.216,<->,133.178.227.200,0,0,33,10423,33,10423,0.053552000,1.9200
137.46.170.80,<->,8.43.222.54,0,0,33,1848,33,1848,0.053397000,1.9053
99.167.15.52,<->,97.198.98.222,0,0,33,7224,33,7224,0.053013000,1.8865
95.246.111.107,<->,8.252.222.93,0,0,33,2100,33,2100,0.043415000,1.8007
129.92.112.242,<->,109.92.190.87,33,13365,0,0,33,13365,0.042691000,1.9223
202.178.8.218,<->,139.163.26.238,0,0,33,1945,33,1945,0.039013000,0.5217
221.102.143.189,<->,213.38.199.25,0,0,33,39642,33,39642,0.035998000,0.7224
210.220.219.177,<->,54.53.118.167,33,4848,0,0,33,4848,0.034992000,1.9414
215.158.238.133,<->,111.151.70.38,33,7697,0,0,33,7697,0.031414000,1.8727
201.192.40.105,<->,139.163.96.94,0,0,33,1704,33,1704,0.030844000,1.9247
89.183.104.232,<->,27.75.29.116,33,24899,0,0,33,24899,0.025874000,1.9720
212.241.174.245,<->,80.27.157.20,0,0,33,30184,33,30184,0.024884000,1.8529
100.78.225.198,<->,97.198.98.32,0,0,33,1860,33,1860,0.021770000,1.9704
94.195.19.129,<->,8.252.222.227,0,0,33,2188,33,2188,0.021441000,1.9724
142.255.169.41,<->,136.25.188.178,0,0,33,4389,33,4389,0.020246000,1.3487
133.178.226.18,<->,8.222.7.15,33,13121,0,0,33,13121,0.016045000,1.9411
252.132.50.7,<->,8.252.222.208,0,0,33,1765,33,1765,0.015645000,1.9623
109.48.48.57,<->,8.182.244.19,0,0,33,3868,33,3868,0.014600000,0.1758
95.247.134.1,<->,8.252.222.240,0,0,33,2368,33,2368,0.012127000,1.9675
136.25.189.93,<->,98.219.126.140,33,25435,0,0,33,25435,0.011970000,1.8955
207.92.8.226,<->,8.182.248.147,0,0,33,1650,33,1650,0.007859000,1.8369
215.158.238.223,<->,38.104.11.117,33,4370,0,0,33,4370,0.005761000,0.8482
111.20.168.123,<->,92.160.6.96,33,1977,0,0,33,1977,0.005188000,0.2770
132.149.178.11,<->,8.182.235.164,0,0,33,1698,33,1698,0.003226000,1.8767
108.39.75.243,<->,0.195.194.241,33,8660,0,0,33,8660,0.002603000,1.9824
95.247.17.138,<->,8.252.222.79,0,0,33,2096,33,2096,0.002196000,1.8573
8.252.221.230,<->,4.122.26.223,33,2004,0,0,33,2004,0.002070000,1.9855
133.178.227.235,<->,100.224.132.154,32,1792,0,0,32,1792,1.666095000,0.3136
215.158.238.24,<->,137.254.204.253,32,4215,0,0,32,4215,1.592563000,0.3867
221.102.56.69,<->,6.74.201.88,0,0,32,3760,32,3760,1.575568000,0.3327
220.28.65.9,<->,136.25.188.200,0,0,32,41979,32,41979,1.495437000,0.2237
199.122.248.143,<->,136.25.188.222,0,0,32,2689,32,2689,1.489575000,0.5055
142.190.143.50,<->,136.25.188.174,0,0,32,2709,32,2709,1.485665000,0.4692
215.158.239.92,<->,199.20.30.144,32,3662,0,0,32,3662,1.411582000,0.5880
142.190.168.226,<->,136.25.188.209,0,0,32,2725,32,2725,1.353981000,0.6037
143.10.117.183,<->,136.25.188.255,0,0,32,3592,32,3592,1.226909000,0.7728
213.186.59.253,<->,144.85.170.244,0,0,32,2620,32,2620,1.176184000,0.8150
196.148.166.194,<->,53.195.174.8,32,40202,0,0,32,40202,1.001083000,0.9714
195.6.251.116,<->,136.25.188.175,0,0,32,3302,32,3302,0.998600000,0.8392
133.178.226.223,<->,100.224.141.92,32,43702,0,0,32,43702,0.985014000,0.1744
215.158.66.187,<->,133.178.227.201,0,0,32,20023,32,20023,0.970227000,0.4228
56.148.119.166,<->,8.20.87.95,0,0,32,3532,32,3532,0.959799000,0.1127
8.182.224.150,<->,6.20.46.236,32,7760,0,0,32,7760,0.952222000,1.0320
220.28.114.28,<->,133.178.226.55,0,0,32,44192,32,44192,0.822614000,0.0633
215.158.239.42,<->,29.209.59.196,32,1792,0,0,32,1792,0.798043000,0.0638
195.41.122.40,<->,136.25.188.52,0,0,32,3177,32,3177,0.686610000,1.2811
141.89.192.194,<->,0.195.210.42,0,0,32,2157,32,2157,0.567003000,1.2348
215.158.239.93,<->,196.88.103.114,32,4273,0,0,32,4273,0.547264000,0.6170
202.33.252.215,<->,136.25.188.252,0,0,32,1927,32,1927,0.491017000,1.1998
195.41.194.229,<->,136.25.188.163,0,0,32,2485,32,2485,0.475856000,0.5876
132.254.240.246,<->,8.182.245.152,0,0,32,2360,32,2360,0.431900000,1.5315
215.158.239.57,<->,199.15.121.146,32,3516,0,0,32,3516,0.431546000,1.3133
215.158.239.94,<->,29.212.198.190,32,5215,0,0,32,5215,0.420773000,1.2830
136.25.188.221,<->,8.222.212.42,32,9294,0,0,32,9294,0.406888000,1.5869
195.70.205.92,<->,136.25.188.238,0,0,32,2763,32,2763,0.397068000,1.0119
136.25.188.57,<->,100.224.166.158,32,38798,0,0,32,38798,0.370992000,1.3844
195.13.87.15,<->,136.25.188.253,0,0,32,2901,32,2901,0.324409000,1.6019
220.28.114.28,<->,215.158.239.60,0,0,32,41267,32,41267,0.270571000,0.1679
215.158.238.41,<->,0.195.253.228,32,42840,0,0,32,42840,0.261362000,1.1332
215.158.238.113,<->,136.139.59.103,32,6676,0,0,32,6676,0.258810000,1.6654
133.178.227.57,<->,133.56.180.50,32,6079,0,0,32,6079,0.249461000,1.0909
220.28.115.46,<->,215.158.238.69,0,0,32,41208,32,41208,0.223668000,1.7347
215.158.239.50,<->,192.204.123.54,32,6596,0,0,32,6596,0.210232000,1.6206
195.40.208.207,<->,136.25.188.236,0,0,32,4071,32,4071,0.204442000,1.7801
146.249.226.127,<->,8.252.222.150,0,0,32,5117,32,5117,0.195544000,1.7883
215.158.238.190,<->,89.86.110.227,32,7035,0,0,32,7035,0.191424000,1.4315
215.158.239.199,<->,192.229.43.21,32,9294,0,0,32,9294,0.166240000,1.6526
133.178.226.29,<->,29.211.6.86,32,6804,0,0,32,6804,0.166161000,1.7818
197.113.99.201,<->,136.25.188.175,0,0,32,3695,32,3695,0.161571000,1.8305
94.193.36.130,<->,8.252.221.220,0,0,32,1660,32,1660,0.159609000,1.8391
215.158.239.93,<->,207.236.228.141,32,2801,0,0,32,2801,0.155646000,0.7041
133.178.227.14,<->,133.56.180.23,32,14680,0,0,32,14680,0.153560000,1.7292
215.158.239.95,<->,142.255.142.6,32,1600,0,0,32,1600,0.138764000,0.8931
69.103.234.233,<->,8.252.222.28,0,0,32,3285,32,3285,0.121858000,0.9990
133.178.227.1,<->,126.219.101.143,32,5899,0,0,32,5899,0.121113000,1.8102
192.64.227.64,<->,115.48.155.17,32,1712,0,0,32,1712,0.118303000,1.6632
92.168.217.245,<->,50.136.187.180,32,2665,0,0,32,2665,0.115152000,1.8528
136.25.189.60,<->,100.216.78.145,32,40327,0,0,32,40327,0.113464000,1.6767
136.138.112.219,<->,136.25.188.211,0,0,32,10163,32,10163,0.106471000,1.8455
58.242.230.191,<->,8.252.222.127,0,0,32,2132,32,2132,0.105399000,1.8765
215.158.140.83,<->,139.8.186.137,32,7754,0,0,32,7754,0.086204000,1.7566
205.127.108.115,<->,101.224.89.214,0,0,32,15461,32,15461,0.078622000,1.7595
136.25.188.227,<->,126.219.247.70,32,10307,0,0,32,10307,0.078413000,1.8033
8.252.221.220,<->,4.121.206.182,32,1722,0,0,32,1722,0.076423000,1.8071
226.184.23.83,<->,50.224.49.197,0,0,32,1960,32,1960,0.074853000,1.8674
75.214.96.43,<->,8.252.222.225,0,0,32,2136,32,2136,0.071771000,1.8681
215.158.238.223,<->,8.40.50.51,32,6060,0,0,32,6060,0.067579000,1.3105
8.252.222.109,<->,4.122.166.120,32,2012,0,0,32,2012,0.064950000,1.9238
215.158.239.70,<->,204.3.9.234,32,2405,0,0,32,2405,0.064530000,0.7038
159.137.139.2,<->,133.178.227.1,0,0,32,5599,32,5599,0.064432000,1.3810
215.158.238.118,<->,100.216.78.145,32,33878,0,0,32,33878,0.064295000,0.3304
215.158.238.243,<->,106.188.251.41,32,5846,0,0,32,5846,0.063353000,1.8322
215.158.238.236,<->,148.190.126.45,32,3829,0,0,32,3829,0.057255000,1.8492
215.158.238.72,<->,57.210.107.42,32,10499,0,0,32,10499,0.053847000,1.9353
48.18.250.117,<->,8.252.222.38,0,0,32,2385,32,2385,0.052641000,1.4989
136.25.188.226,<->,126.219.194.116,32,7865,0,0,32,7865,0.051683000,1.8075
58.51.2.187,<->,8.252.221.205,0,0,32,1642,32,1642,0.049914000,1.8688
215.158.239.79,<->,199.20.31.127,32,1927,0,0,32,1927,0.046566000,1.6698
133.178.226.7,<->,8.222.7.23,32,14306,0,0,32,14306,0.042813000,1.8733
69.103.134.116,<->,8.252.221.223,0,0,32,1678,32,1678,0.040177000,1.8581
122.202.156.172,<->,92.27.219.184,0,0,32,2079,32,2079,0.039954000,1.8593
215.158.140.76,<->,113.23.66.229,32,5919,0,0,32,5919,0.039936000,1.9474
133.178.226.25,<->,100.120.38.6,32,41421,0,0,32,41421,0.036548000,1.6482
199.72.29.46,<->,136.25.188.238,0,0,32,1708,32,1708,0.033836000,1.3753
215.158.239.56,<->,195.49.84.18,32,2646,0,0,32,2646,0.033025000,0.6491
156.135.167.110,<->,8.252.221.237,0,0,32,1688,32,1688,0.032116000,1.8451
111.151.139.254,<->,8.176.8.218,0,0,32,14642,32,14642,0.031381000,1.8292
215.158.238.114,<->,136.139.59.127,32,7689,0,0,32,7689,0.029781000,1.6452
199.39.63.93,<->,136.25.188.255,0,0,32,2791,32,2791,0.027117000,1.0411
48.16.21.21,<->,8.252.222.199,0,0,32,2568,32,2568,0.024515000,1.9439
221.102.103.73,<->,199.12.102.145,32,2149,0,0,32,2149,0.023737000,1.7835
215.158.140.232,<->,100.216.78.145,32,37340,0,0,32,37340,0.023733000,0.6485
215.158.239.92,<->,204.227.215.7,32,2498,0,0,32,2498,0.023464000,1.5491
252.98.138.44,<->,106.176.217.83,32,2752,0,0,32,2752,0.023321000,1.8628
97.198.98.50,<->,46.47.109.103,32,1792,0,0,32,1792,0.021441000,1.9568
220.28.73.211,<->,133.178.227.62,0,0,32,36430,32,36430,0.021067000,0.8858
133.178.227.16,<->,8.240.116.213,32,8124,0,0,32,8124,0.020942000,1.7152
133.178.226.7,<->,126.219.194.105,32,9274,0,0,32,9274,0.010463000,1.7436
133.178.227.1,<->,111.150.187.198,32,6132,0,0,32,6132,0.010019000,1.8579
54.92.61.160,<->,48.53.32.49,0,0,32,1639,32,1639,0.008352000,0.7868
117.9.179.125,<->,89.183.104.186,0,0,32,1820,32,1820,0.007750000,1.8656
215.158.238.33,<->,65.27.220.196,32,4530,0,0,32,4530,0.003147000,1.9029
136.25.188.53,<->,122.158.245.144,32,3677,0,0,32,3677,0.002495000,1.5956
92.168.217.252,<->,88.122.34.13,32,2051,0,0,32,2051,0.002376000,1.8100
195.89.62.158,<->,8.252.222.225,0,0,32,1655,32,1655,0.000534000,1.9101
216.184.2.48,<->,136.25.188.212,0,0,32,40745,32,40745,0.000346000,0.6235
221.102.56.46,<->,80.40.10.88,0,0,31,26280,31,26280,1.608865000,0.3649
145.170.224.41,<->,8.182.230.134,0,0,31,1957,31,1957,1.595746000,0.3984
215.158.140.185,<->,131.36.66.75,31,2911,0,0,31,2911,1.558051000,0.4286
207.239.35.185,<->,136.25.188.196,0,0,31,2093,31,2093,1.299302000,0.2764
136.25.188.165,<->,133.56.180.94,31,41089,0,0,31,41089,1.229678000,0.7682
199.121.171.120,<->,136.25.188.241,0,0,31,2173,31,2173,1.126487000,0.3316
215.158.239.68,<->,204.58.217.55,31,2333,0,0,31,2333,1.114867000,0.7650
142.228.14.111,<->,136.25.188.162,0,0,31,2093,31,2093,1.109603000,0.6013
251.24.42.145,<->,8.182.224.87,0,0,31,2694,31,2694,1.093131000,0.8939
148.99.76.44,<->,0.195.210.8,0,0,31,2248,31,2248,1.074023000,0.7063
195.7.107.175,<->,136.25.188.252,0,0,31,4244,31,4244,1.066925000,0.6717
145.116.209.71,<->,136.25.188.59,0,0,31,37062,31,37062,1.036922000,0.5337
207.92.55.136,<->,8.252.222.39,0,0,31,5464,31,5464,1.027859000,0.8417
215.158.30.165,<->,8.252.222.41,0,0,31,38649,31,38649,1.011697000,0.9591
215.158.238.190,<->,8.220.54.215,31,3757,0,0,31,3757,0.991638000,0.8359
215.158.140.76,<->,68.231.10.151,31,3708,0,0,31,3708,0.978413000,0.8357
207.59.28.235,<->,136.25.188.52,0,0,31,3381,31,3381,0.890815000,0.8583
195.109.248.194,<->,99.72.8.232,0,0,31,4506,31,4506,0.874077000,1.1082
195.41.79.175,<->,136.25.188.55,0,0,31,2391,31,2391,0.765213000,1.0469
215.158.239.85,<->,196.6.59.44,31,2664,0,0,31,2664,0.757080000,0.8629
204.21.184.43,<->,136.25.188.236,0,0,31,2381,31,2381,0.753042000,0.3540
146.149.76.73,<->,8.252.222.197,0,0,31,2268,31,2268,0.738816000,1.1802
207.58.233.27,<->,136.25.188.209,0,0,31,3604,31,3604,0.648718000,1.2634
224.76.11.202,<->,8.182.136.152,0,0,31,3903,31,3903,0.606458000,0.4721
220.20.200.127,<->,35.107.149.134,31,45564,0,0,31,45564,0.561186000,0.0391
159.137.139.85,<->,133.178.227.14,0,0,31,4739,31,4739,0.519400000,0.7966
231.140.140.223,<->,136.25.188.176,0,0,31,3051,31,3051,0.487458000,1.1784
194.232.206.196,<->,136.25.188.198,0,0,31,3568,31,3568,0.479228000,1.1412
136.25.189.43,<->,96.156.169.165,31,31348,0,0,31,31348,0.447963000,1.5002
215.158.133.55,<->,6.228.16.194,0,0,31,10440,31,10440,0.445125000,1.2553
192.227.190.20,<->,8.252.223.141,0,0,31,4274,31,4274,0.429015000,1.4648
143.89.63.84,<->,136.25.188.253,0,0,31,3464,31,3464,0.399183000,1.5977
139.69.162.59,<->,136.25.188.58,0,0,31,41249,31,41249,0.376640000,1.3693
136.25.189.46,<->,98.28.95.68,31,6712,0,0,31,6712,0.359621000,1.3311
210.225.35.246,<->,92.27.27.142,0,0,31,43276,31,43276,0.352253000,1.6456
215.158.239.78,<->,207.228.203.207,31,2646,0,0,31,2646,0.305885000,1.3278
133.178.226.90,<->,120.154.221.245,31,8033,0,0,31,8033,0.298532000,1.4789
195.68.190.76,<->,136.25.188.238,0,0,31,1820,31,1820,0.294132000,0.7525
136.25.188.173,<->,69.150.168.200,31,7873,0,0,31,7873,0.273357000,1.7126
215.158.238.134,<->,65.27.220.210,31,7989,0,0,31,7989,0.249320000,1.7425
215.158.238.21,<->,8.222.109.83,31,3605,0,0,31,3605,0.238261000,1.6737
80.40.23.244,<->,14.30.152.114,31,9659,0,0,31,9659,0.230465000,1.6565
136.25.188.226,<->,91.57.173.62,31,10183,0,0,31,10183,0.214741000,1.7653
215.158.238.188,<->,33.221.186.171,31,4839,0,0,31,4839,0.201214000,1.3037
199.80.3.28,<->,136.25.188.163,0,0,31,6784,31,6784,0.195876000,1.2414
133.178.226.80,<->,126.219.247.87,31,5539,0,0,31,5539,0.194573000,1.2919
142.206.138.88,<->,136.25.188.174,0,0,31,1736,31,1736,0.186951000,0.3139
215.158.238.47,<->,145.116.209.88,31,17848,0,0,31,17848,0.184876000,1.8137
133.178.226.29,<->,126.219.194.151,31,9206,0,0,31,9206,0.181705000,1.7272
155.24.161.232,<->,50.224.49.197,0,0,31,1872,31,1872,0.179352000,1.7099
220.55.69.95,<->,35.56.3.196,31,4987,0,0,31,4987,0.154241000,1.6150
136.139.59.118,<->,136.25.188.174,0,0,31,6476,31,6476,0.150484000,1.7927
195.13.82.22,<->,136.25.188.54,0,0,31,3062,31,3062,0.144748000,1.6789
92.27.219.158,<->,33.57.77.138,31,34164,0,0,31,34164,0.144657000,1.1336
215.158.238.83,<->,131.1.253.233,31,7093,0,0,31,7093,0.137463000,1.8270
95.247.29.69,<->,8.252.222.227,0,0,31,1964,31,1964,0.117339000,1.5584
80.42.169.15,<->,57.203.184.17,31,40643,0,0,31,40643,0.117213000,1.8748
252.98.149.193,<->,212.249.34.46,31,31890,0,0,31,31890,0.117178000,0.1138
215.158.30.238,<->,8.252.222.57,0,0,31,22793,31,22793,0.106815000,1.8523
94.193.184.33,<->,8.252.221.206,0,0,31,1634,31,1634,0.104618000,1.7416
95.246.179.69,<->,8.252.221.206,0,0,31,1598,31,1598,0.096826000,1.7845
215.158.239.95,<->,199.20.29.161,31,3675,0,0,31,3675,0.095634000,1.8798
94.193.219.149,<->,8.252.223.175,0,0,31,1856,31,1856,0.095251000,1.8818
215.158.239.49,<->,204.226.90.203,31,2901,0,0,31,2901,0.093683000,0.3242
214.168.209.245,<->,50.223.3.228,0,0,31,1592,31,1592,0.087910000,1.8391
223.115.127.40,<->,8.252.222.176,0,0,31,2044,31,2044,0.072332000,1.8207
229.96.182.37,<->,53.195.174.8,31,40881,0,0,31,40881,0.072331000,0.5075
215.158.238.212,<->,215.158.43.0,31,26718,0,0,31,26718,0.071136000,1.6071
195.7.9.231,<->,136.25.188.238,0,0,31,1556,31,1556,0.062925000,0.6529
136.25.188.210,<->,56.161.218.62,31,8077,0,0,31,8077,0.056960000,1.7876
223.114.180.4,<->,8.252.221.196,0,0,31,1956,31,1956,0.055532000,1.8642
136.25.189.39,<->,96.156.169.208,31,30837,0,0,31,30837,0.054635000,1.7010
142.184.37.108,<->,0.195.210.46,0,0,31,2616,31,2616,0.053996000,1.5040
223.114.148.141,<->,8.252.222.93,0,0,31,1904,31,1904,0.050608000,1.9410
136.25.188.211,<->,29.211.6.61,31,5319,0,0,31,5319,0.047271000,1.9131
58.51.36.178,<->,8.252.222.77,0,0,31,1916,31,1916,0.047245000,1.9435
142.249.138.140,<->,136.25.188.220,0,0,31,2824,31,2824,0.043110000,0.6918
215.158.239.37,<->,215.158.127.143,31,37438,0,0,31,37438,0.041864000,1.8873
114.51.67.67,<->,89.183.104.158,0,0,31,45167,31,45167,0.038503000,1.9315
136.25.189.41,<->,96.156.169.208,31,37818,0,0,31,37818,0.037257000,1.9251
112.176.7.240,<->,56.121.40.204,0,0,31,45570,31,45570,0.036012000,1.9404
136.25.189.62,<->,96.156.169.164,31,38945,0,0,31,38945,0.028861000,0.7829
215.158.239.35,<->,120.155.14.139,31,4654,0,0,31,4654,0.028840000,1.8830
215.158.238.81,<->,8.42.43.86,31,15711,0,0,31,15711,0.023066000,1.9157
136.25.188.254,<->,29.214.108.128,31,9166,0,0,31,9166,0.021427000,1.9419
75.214.238.0,<->,8.252.221.223,0,0,31,2643,31,2643,0.020113000,0.8235
136.25.188.160,<->,132.123.119.101,31,2727,0,0,31,2727,0.018840000,0.6723
231.140.25.119,<->,136.25.188.255,0,0,31,3268,31,3268,0.011135000,1.6465
215.158.239.11,<->,215.158.127.153,31,35348,0,0,31,35348,0.009036000,1.5160
215.158.239.78,<->,207.60.194.62,31,1550,0,0,31,1550,0.006193000,1.1281
215.158.238.190,<->,38.104.11.126,31,4767,0,0,31,4767,0.004090000,1.4594
139.163.123.163,<->,50.137.25.155,31,1550,0,0,31,1550,0.003449000,1.8129
220.28.104.193,<->,215.158.238.144,0,0,31,38325,31,38325,0.003353000,1.9264
195.7.196.49,<->,136.25.188.174,0,0,31,1556,31,1556,0.002946000,1.3233
152.105.182.182,<->,8.252.222.221,0,0,31,1892,31,1892,0.000409000,1.8622
136.25.188.225,<->,26.253.227.124,30,3070,0,0,30,3070,1.791435000,0.1747
133.178.226.41,<->,0.195.253.228,30,40835,0,0,30,40835,1.519604000,0.0267
192.65.124.121,<->,8.45.173.68,30,40088,0,0,30,40088,1.329253000,0.4839
215.158.127.19,<->,8.176.8.110,0,0,30,24108,30,24108,1.107158000,0.8437
197.113.99.181,<->,136.25.188.243,0,0,30,2389,30,2389,1.037938000,0.7897
192.229.216.117,<->,149.181.231.91,30,2046,0,0,30,2046,0.946621000,0.8195
195.55.64.153,<->,136.25.188.222,0,0,30,2405,30,2405,0.897367000,0.6032
133.178.227.2,<->,8.191.7.250,30,7897,0,0,30,7897,0.820787000,1.0967
69.243.89.2,<->,8.252.222.149,0,0,30,3698,30,3698,0.798076000,1.0530
204.3.189.5,<->,136.25.188.175,0,0,30,3973,30,3973,0.777273000,1.0053
195.14.101.133,<->,136.25.188.198,0,0,30,2625,30,2625,0.772539000,1.2063
207.59.30.197,<->,136.25.188.211,0,0,30,1965,30,1965,0.759437000,1.1658
136.25.189.2,<->,96.156.169.246,30,5999,0,0,30,5999,0.700549000,1.1830
215.158.239.81,<->,133.56.180.17,30,40052,0,0,30,40052,0.639006000,0.1254
207.58.193.117,<->,136.25.188.255,0,0,30,2212,30,2212,0.625196000,0.6644
97.157.225.68,<->,8.252.222.204,0,0,30,3234,30,3234,0.607515000,0.6585
133.178.227.70,<->,133.56.180.50,30,9033,0,0,30,9033,0.587299000,1.3998
109.222.205.151,<->,53.231.158.103,30,37354,0,0,30,37354,0.552718000,1.3555
207.191.183.159,<->,136.25.188.178,0,0,30,1800,30,1800,0.526425000,0.7381
220.28.104.193,<->,215.158.238.84,0,0,30,28555,30,28555,0.511117000,0.4735
215.158.239.84,<->,204.226.110.13,30,2866,0,0,30,2866,0.471566000,1.0340
58.60.45.22,<->,8.252.221.223,0,0,30,2392,30,2392,0.424039000,0.5530
215.158.239.17,<->,114.223.238.144,30,2376,0,0,30,2376,0.423269000,1.2294
106.188.184.108,<->,56.121.54.220,0,0,30,29072,30,29072,0.420590000,0.1134
215.158.140.93,<->,156.165.33.3,30,3797,0,0,30,3797,0.406194000,0.8643
215.158.239.95,<->,199.121.31.89,30,4045,0,0,30,4045,0.398851000,0.7990
136.25.189.34,<->,126.219.194.91,30,9468,0,0,30,9468,0.375351000,1.6018
215.158.239.94,<->,199.20.29.9,30,2595,0,0,30,2595,0.371892000,1.4399
136.25.188.173,<->,126.219.132.205,30,6996,0,0,30,6996,0.348530000,1.4367
195.42.161.86,<->,136.25.188.198,0,0,30,2941,30,2941,0.314640000,1.5534
133.178.227.24,<->,133.56.180.57,30,18838,0,0,30,18838,0.294216000,1.3182
111.147.248.174,<->,97.110.90.232,30,3518,0,0,30,3518,0.276444000,0.8246
220.28.85.14,<->,136.25.189.55,0,0,30,33862,30,33862,0.271631000,1.5103
136.25.189.23,<->,56.28.207.205,30,22059,0,0,30,22059,0.261309000,1.2779
199.32.179.123,<->,136.25.188.252,0,0,30,2661,30,2661,0.259768000,0.4784
197.125.117.164,<->,133.178.227.24,0,0,30,4346,30,4346,0.246625000,1.0312
215.158.239.99,<->,199.73.139.11,30,4105,0,0,30,4105,0.229244000,1.2105
133.178.226.74,<->,133.56.180.36,30,34630,0,0,30,34630,0.221726000,1.5914
196.246.217.59,<->,136.25.188.243,0,0,30,2448,30,2448,0.205660000,1.0295
215.158.238.152,<->,139.163.161.50,30,35087,0,0,30,35087,0.183650000,1.4663
133.178.227.21,<->,133.56.180.45,30,35094,0,0,30,35094,0.176217000,1.7980
136.25.189.30,<->,133.56.180.57,30,15907,0,0,30,15907,0.164383000,1.5583
215.158.238.241,<->,8.240.116.237,30,10933,0,0,30,10933,0.146243000,1.7679
136.25.188.211,<->,8.222.7.58,30,10559,0,0,30,10559,0.145937000,1.5315
8.252.223.176,<->,8.240.116.198,30,7065,0,0,30,7065,0.141537000,1.8547
136.25.188.211,<->,100.224.202.188,30,15079,0,0,30,15079,0.130771000,1.8118
60.101.19.177,<->,8.252.222.4,0,0,30,1912,30,1912,0.130174000,1.7827
133.178.226.61,<->,8.222.212.1,30,12893,0,0,30,12893,0.121119000,1.8408
145.76.225.248,<->,80.27.157.216,0,0,30,9902,30,9902,0.120998000,1.7872
215.158.238.104,<->,8.190.216.193,30,6660,0,0,30,6660,0.113300000,1.6310
133.178.226.7,<->,122.158.49.128,30,9449,0,0,30,9449,0.105807000,1.8399
215.158.238.142,<->,131.1.195.249,30,8750,0,0,30,8750,0.104946000,1.6897
215.158.239.50,<->,195.43.1.212,30,1992,0,0,30,1992,0.102272000,0.4287
207.219.56.31,<->,50.223.3.228,0,0,30,1752,30,1752,0.100682000,1.8421
215.158.239.220,<->,159.61.250.241,30,40156,0,0,30,40156,0.094132000,1.5057
215.158.238.65,<->,56.161.218.53,30,4022,0,0,30,4022,0.093792000,1.6807
223.120.29.225,<->,8.252.221.239,0,0,30,1848,30,1848,0.093621000,1.7335
76.179.71.28,<->,8.252.221.207,0,0,30,4928,30,4928,0.093264000,1.0911
69.103.239.165,<->,8.252.222.15,0,0,30,1996,30,1996,0.087869000,1.8659
136.25.188.233,<->,56.23.171.47,30,39652,0,0,30,39652,0.087632000,0.9923
136.25.188.253,<->,111.151.239.53,30,9038,0,0,30,9038,0.087410000,1.7522
136.25.188.252,<->,8.42.43.58,30,9246,0,0,30,9246,0.087032000,1.8975
136.25.188.226,<->,91.57.173.63,30,11848,0,0,30,11848,0.081663000,1.8340
95.247.153.38,<->,8.252.221.199,0,0,30,1828,30,1828,0.081529000,1.7970
76.179.30.33,<->,8.252.221.221,0,0,30,1598,30,1598,0.074387000,1.8606
136.25.188.199,<->,8.255.92.251,30,9326,0,0,30,9326,0.070555000,1.6043
111.20.168.122,<->,101.224.91.254,30,1680,0,0,30,1680,0.069260000,0.1248
215.158.238.82,<->,112.220.206.8,30,10291,0,0,30,10291,0.063925000,1.1758
136.25.188.175,<->,131.1.195.231,30,16748,0,0,30,16748,0.063540000,1.7792
133.178.226.77,<->,29.214.108.120,30,13068,0,0,30,13068,0.059809000,1.7750
133.178.226.84,<->,96.155.60.211,30,27700,0,0,30,27700,0.055708000,1.1295
139.163.96.101,<->,29.128.255.1,30,3018,0,0,30,3018,0.054359000,1.8631
215.158.238.135,<->,112.235.95.21,30,6708,0,0,30,6708,0.053542000,1.7207
215.158.140.75,<->,8.240.116.198,30,6472,0,0,30,6472,0.049211000,1.6557
111.150.74.72,<->,99.74.26.99,0,0,30,17517,30,17517,0.037965000,1.9459
195.55.229.202,<->,136.25.188.236,0,0,30,3249,30,3249,0.035600000,1.0595
215.158.239.93,<->,195.70.19.228,30,1770,0,0,30,1770,0.034365000,0.3392
215.158.140.79,<->,98.219.126.175,30,34853,0,0,30,34853,0.034229000,1.3705
145.89.157.16,<->,66.47.246.227,30,3932,0,0,30,3932,0.024428000,1.9705
205.127.108.115,<->,33.233.141.116,0,0,30,20145,30,20145,0.023471000,1.9667
94.194.19.196,<->,8.252.222.243,0,0,30,1752,30,1752,0.023039000,1.9764
232.31.254.204,<->,132.249.70.157,0,0,30,1680,30,1680,0.022273000,1.9589
207.236.49.110,<->,136.25.188.225,0,0,30,2779,30,2779,0.022104000,1.8180
58.242.228.112,<->,8.252.222.133,0,0,30,3433,30,3433,0.021252000,1.8362
102.51.166.249,<->,27.13.158.158,30,1645,0,0,30,1645,0.019718000,1.9021
80.40.4.150,<->,0.195.202.28,30,6715,0,0,30,6715,0.018326000,1.7804
248.64.123.76,<->,98.236.235.32,0,0,30,1680,30,1680,0.018138000,1.9209
136.25.188.224,<->,29.211.228.69,30,3053,0,0,30,3053,0.018100000,0.9625
8.252.221.205,<->,4.120.214.30,30,1584,0,0,30,1584,0.017643000,1.9432
216.184.2.192,<->,136.25.189.28,0,0,30,8242,30,8242,0.016077000,1.7037
215.158.239.58,<->,196.109.125.225,30,2043,0,0,30,2043,0.013972000,1.6300
101.224.206.44,<->,57.211.62.2,30,2017,0,0,30,2017,0.013113000,1.4420
92.168.217.198,<->,42.107.6.165,30,1680,0,0,30,1680,0.012378000,0.2737
142.227.29.180,<->,136.25.188.226,0,0,30,3223,30,3223,0.008404000,1.1055
97.126.23.133,<->,92.161.83.172,30,32040,0,0,30,32040,0.007197000,1.9788
133.178.227.16,<->,133.56.180.47,30,13773,0,0,30,13773,0.006453000,1.8106
113.97.200.242,<->,98.67.154.28,0,0,30,4006,30,4006,0.005186000,1.8519
194.194.156.183,<->,50.223.3.228,0,0,30,1596,30,1596,0.002857000,0.2799
215.158.238.193,<->,98.219.126.140,30,39751,0,0,30,39751,0.002554000,1.9070
210.220.219.182,<->,54.51.230.10,30,5216,0,0,30,5216,0.002168000,1.9348
133.178.226.80,<->,91.57.173.10,30,10131,0,0,30,10131,0.001712000,1.8943
97.20.14.218,<->,8.182.253.233,0,0,29,2092,29,2092,1.828340000,0.0999
133.178.226.8,<->,0.195.253.228,29,42069,0,0,29,42069,1.798477000,0.0001
220.28.65.9,<->,215.158.238.217,0,0,29,40243,29,40243,1.667683000,0.0980
220.28.65.9,<->,215.158.238.76,0,0,29,38518,29,38518,1.635064000,0.1044
215.158.238.142,<->,29.211.6.46,29,2537,0,0,29,2537,1.567068000,0.3957
143.135.207.170,<->,136.25.188.178,0,0,29,2317,29,2317,1.518336000,0.2133
215.158.239.92,<->,196.0.151.223,29,3242,0,0,29,3242,1.427483000,0.4170
215.158.238.104,<->,8.191.10.87,29,3181,0,0,29,3181,1.288657000,0.0384
221.102.143.189,<->,80.41.25.56,0,0,29,29664,29,29664,1.223863000,0.3256
17.255.114.134,<->,8.220.188.158,0,0,29,2389,29,2389,1.086316000,0.5238
133.178.227.37,<->,133.56.180.46,29,40332,0,0,29,40332,1.037765000,0.0605
228.205.242.55,<->,159.137.247.157,0,0,29,41340,29,41340,1.012089000,0.7237
124.46.191.127,<->,92.162.253.144,0,0,29,35613,29,35613,1.001873000,0.9456
8.182.244.19,<->,6.21.254.254,29,5471,0,0,29,5471,0.965150000,0.4594
142.223.114.231,<->,136.25.188.238,0,0,29,3136,29,3136,0.880197000,1.0315
215.158.238.147,<->,0.195.237.14,29,38666,0,0,29,38666,0.862147000,1.0756
136.138.112.210,<->,136.25.188.252,0,0,29,7773,29,7773,0.808861000,1.1510
207.63.93.14,<->,136.25.188.253,0,0,29,2691,29,2691,0.724378000,1.2186
8.182.224.87,<->,6.20.48.254,29,2297,0,0,29,2297,0.693390000,1.1556
215.158.238.99,<->,99.192.168.183,29,1624,0,0,29,1624,0.693191000,0.3413
136.25.188.220,<->,41.153.59.35,29,4266,0,0,29,4266,0.626402000,1.3614
207.160.220.252,<->,0.195.210.46,0,0,29,4914,29,4914,0.586760000,1.1433
133.178.226.180,<->,111.150.206.27,29,34871,0,0,29,34871,0.579984000,1.3211
204.200.45.224,<->,136.25.188.253,0,0,29,1991,29,1991,0.525372000,0.8398
195.14.126.59,<->,136.25.188.46,0,0,29,2157,29,2157,0.481326000,1.4682
213.155.77.129,<->,98.236.252.215,0,0,29,2766,29,2766,0.453747000,1.5097
92.27.219.148,<->,6.10.112.30,29,1670,0,0,29,1670,0.447779000,1.4434
136.25.189.22,<->,96.156.169.196,29,35867,0,0,29,35867,0.441961000,1.3878
215.158.140.241,<->,131.144.116.221,29,4215,0,0,29,4215,0.343880000,0.7895
215.158.238.40,<->,145.158.254.254,29,41378,0,0,29,41378,0.342133000,1.1649
215.158.61.237,<->,8.252.222.251,0,0,29,37614,29,37614,0.316332000,0.9609
133.178.227.2,<->,8.240.116.180,29,8821,0,0,29,8821,0.288592000,1.6733
133.178.227.18,<->,8.219.187.244,29,2993,0,0,29,2993,0.275408000,0.1640
215.158.239.197,<->,212.249.34.46,29,27241,0,0,29,27241,0.273032000,0.0737
219.250.188.94,<->,8.252.222.173,0,0,29,3190,29,3190,0.258413000,1.5490
215.158.239.92,<->,199.20.29.12,29,1697,0,0,29,1697,0.256630000,0.8200
220.28.85.14,<->,136.25.188.171,0,0,29,34181,29,34181,0.250270000,0.8534
159.220.151.125,<->,80.40.3.11,0,0,29,36306,29,36306,0.245717000,1.7046
159.6.238.19,<->,136.25.188.242,0,0,29,1937,29,1937,0.239241000,0.3355
215.158.140.75,<->,100.50.96.239,29,3867,0,0,29,3867,0.238686000,1.6650
207.188.103.167,<->,136.25.188.252,0,0,29,2457,29,2457,0.229339000,0.6226
8.252.222.224,<->,4.122.50.77,29,1780,0,0,29,1780,0.225159000,1.6392
215.158.238.75,<->,29.211.6.85,29,6460,0,0,29,6460,0.217709000,1.5231
136.25.188.221,<->,106.188.236.230,29,7901,0,0,29,7901,0.217484000,1.1541
133.178.227.16,<->,29.214.108.32,29,3630,0,0,29,3630,0.216831000,0.5967
133.178.227.19,<->,131.144.116.194,29,4747,0,0,29,4747,0.188032000,1.4027
215.158.140.195,<->,126.132.18.200,29,3080,0,0,29,3080,0.179091000,0.8837
215.158.239.57,<->,199.20.29.9,29,1685,0,0,29,1685,0.178778000,0.8189
207.92.34.215,<->,8.252.222.63,0,0,29,2664,29,2664,0.175639000,0.7441
136.25.189.1,<->,29.211.228.197,29,13405,0,0,29,13405,0.175120000,1.1580
215.158.238.243,<->,149.163.129.234,29,2877,0,0,29,2877,0.163384000,0.5341
215.158.238.107,<->,42.189.53.24,29,2669,0,0,29,2669,0.162464000,0.5905
136.114.101.18,<->,136.25.188.48,0,0,29,32227,29,32227,0.149173000,0.4082
215.158.238.120,<->,113.23.20.249,29,7857,0,0,29,7857,0.137804000,1.7484
207.59.172.221,<->,136.25.188.236,0,0,29,3942,29,3942,0.131389000,0.8200
8.252.222.115,<->,4.122.229.160,29,1836,0,0,29,1836,0.130374000,1.7097
215.158.238.72,<->,57.210.107.36,29,6492,0,0,29,6492,0.129951000,1.7988
136.25.188.211,<->,126.219.247.38,29,7853,0,0,29,7853,0.128622000,1.7628
215.158.239.96,<->,199.20.6.41,29,4225,0,0,29,4225,0.128227000,0.7962
207.61.111.165,<->,136.25.188.252,0,0,29,2449,29,2449,0.126027000,1.7211
235.42.34.23,<->,136.25.188.254,0,0,29,5271,29,5271,0.125691000,1.7431
136.25.188.47,<->,112.220.206.126,29,8822,0,0,29,8822,0.125191000,1.8093
141.175.156.208,<->,8.252.222.36,0,0,29,3615,29,3615,0.112430000,0.6849
136.25.189.78,<->,96.135.155.12,29,15659,0,0,29,15659,0.110921000,1.8013
199.38.214.113,<->,136.25.188.227,0,0,29,3970,29,3970,0.110598000,1.1323
133.178.226.28,<->,114.150.180.157,29,3906,0,0,29,3906,0.108522000,1.5847
113.22.2.221,<->,100.228.42.100,0,0,29,21240,29,21240,0.107534000,1.8406
136.25.189.7,<->,96.156.169.207,29,22591,0,0,29,22591,0.097159000,1.8258
133.178.227.24,<->,61.35.22.228,29,4178,0,0,29,4178,0.092420000,1.8049
207.4.234.197,<->,8.252.222.226,0,0,29,1516,29,1516,0.091865000,1.8842
139.241.56.116,<->,100.93.227.11,0,0,29,42221,29,42221,0.090819000,1.8880
124.145.25.255,<->,92.27.27.173,0,0,29,1522,29,1522,0.089860000,1.5087
215.158.238.135,<->,113.23.20.105,29,10187,0,0,29,10187,0.087558000,1.7548
215.158.238.82,<->,136.138.112.217,29,7821,0,0,29,7821,0.080770000,1.4865
143.42.110.16,<->,136.25.188.253,0,0,29,2812,29,2812,0.075237000,0.5619
121.64.198.129,<->,92.27.219.228,0,0,29,1508,29,1508,0.073173000,1.6707
207.236.131.57,<->,136.25.188.199,0,0,29,2143,29,2143,0.072982000,1.7301
111.147.116.176,<->,92.27.51.117,29,36630,0,0,29,36630,0.072772000,1.9043
136.25.189.55,<->,56.28.207.196,29,29989,0,0,29,29989,0.072742000,1.7238
125.194.228.63,<->,92.27.27.175,0,0,29,1508,29,1508,0.071841000,1.9016
223.115.176.123,<->,8.252.222.226,0,0,29,1836,29,1836,0.070179000,1.6835
133.178.227.57,<->,133.56.180.79,29,10396,0,0,29,10396,0.063110000,1.9343
197.113.64.134,<->,136.25.188.175,0,0,29,2523,29,2523,0.063049000,0.5189
136.25.189.15,<->,126.219.194.11,29,18696,0,0,29,18696,0.059472000,1.8861
199.18.9.104,<->,136.25.188.211,0,0,29,2893,29,2893,0.051952000,0.3842
204.92.39.211,<->,100.95.177.132,0,0,29,35540,29,35540,0.050302000,1.9307
215.158.239.216,<->,111.151.237.67,29,33208,0,0,29,33208,0.049876000,1.1136
152.19.57.29,<->,0.195.210.14,0,0,29,1494,29,1494,0.047799000,1.9215
124.46.191.127,<->,92.162.253.137,0,0,29,35812,29,35812,0.039094000,0.8383
140.19.166.244,<->,133.178.227.16,0,0,29,3489,29,3489,0.032647000,0.9912
53.231.66.21,<->,48.54.81.68,0,0,29,42804,29,42804,0.032634000,1.8249
215.158.239.32,<->,8.222.7.154,29,2768,0,0,29,2768,0.031386000,0.0777
223.115.155.226,<->,8.252.221.196,0,0,29,1780,29,1780,0.028224000,1.8775
8.252.222.222,<->,4.120.144.114,29,1948,0,0,29,1948,0.027220000,1.8567
136.25.189.17,<->,96.135.155.20,29,17957,0,0,29,17957,0.027193000,1.7015
204.200.52.179,<->,136.25.188.54,0,0,29,3363,29,3363,0.025090000,1.2836
207.61.23.103,<->,136.25.188.255,0,0,29,1456,29,1456,0.015823000,0.5944
207.190.92.240,<->,136.25.188.45,0,0,29,3469,29,3469,0.009204000,1.7689
117.231.99.104,<->,92.27.219.128,0,0,29,40948,29,40948,0.007010000,1.8263
136.25.188.178,<->,33.209.217.228,29,10727,0,0,29,10727,0.006895000,1.8198
192.70.19.52,<->,97.198.98.33,0,0,29,1624,29,1624,0.006394000,1.8621
142.166.40.166,<->,136.25.188.199,0,0,29,2323,29,2323,0.003897000,1.9953
129.92.115.88,<->,33.239.63.145,29,3177,0,0,29,3177,0.002379000,1.9570
215.158.238.129,<->,98.219.126.175,29,37178,0,0,29,37178,0.000184000,1.6172
215.158.238.198,<->,126.219.246.252,28,2693,0,0,28,2693,1.649153000,0.3082
215.158.238.105,<->,139.161.104.130,28,3125,0,0,28,3125,1.602143000,0.0529
112.164.79.122,<->,8.252.223.140,0,0,28,2565,28,2565,1.587596000,0.2057
215.158.238.83,<->,111.150.186.251,28,5583,0,0,28,5583,1.563099000,0.4125
114.68.69.205,<->,80.42.149.110,0,0,28,42112,28,42112,1.495617000,0.4942
243.123.125.57,<->,92.162.253.10,0,0,28,40209,28,40209,1.452074000,0.3207
247.136.205.104,<->,136.152.86.129,28,31710,0,0,28,31710,1.447204000,0.2080
101.87.213.136,<->,100.228.42.117,0,0,28,22749,28,22749,1.235189000,0.6876
215.158.239.70,<->,194.250.221.100,28,3925,0,0,28,3925,1.187722000,0.7217
133.54.43.16,<->,33.248.16.128,28,2088,0,0,28,2088,1.156630000,0.8381
136.25.188.197,<->,118.20.87.63,28,4058,0,0,28,4058,1.063408000,0.7061
215.158.239.78,<->,195.15.42.1,28,4635,0,0,28,4635,0.942272000,0.8030
215.158.30.240,<->,8.252.222.32,0,0,28,33408,28,33408,0.926087000,0.5127
195.15.186.62,<->,136.25.188.177,0,0,28,2498,28,2498,0.912716000,0.6341
136.25.188.246,<->,56.23.171.47,28,32286,0,0,28,32286,0.907879000,1.0647
220.28.115.46,<->,215.158.238.234,0,0,28,32674,28,32674,0.890642000,1.1032
136.25.188.255,<->,100.224.202.155,28,17531,0,0,28,17531,0.832475000,1.1600
215.158.239.55,<->,111.52.91.101,28,32181,0,0,28,32181,0.826291000,1.0829
203.117.85.169,<->,0.195.210.42,0,0,28,1885,28,1885,0.812909000,0.7349
215.202.175.22,<->,136.25.188.161,0,0,28,2677,28,2677,0.811315000,0.8081
69.243.32.83,<->,8.252.221.197,0,0,28,1958,28,1958,0.800799000,0.5212
231.140.127.145,<->,215.158.239.49,0,0,28,2458,28,2458,0.796119000,0.8043
133.178.226.77,<->,96.155.60.247,28,15910,0,0,28,15910,0.786776000,1.1445
215.158.238.177,<->,33.209.217.12,28,3946,0,0,28,3946,0.762345000,0.8782
215.158.239.93,<->,199.20.5.208,28,4282,0,0,28,4282,0.713810000,1.2699
215.158.238.221,<->,61.35.124.166,28,3361,0,0,28,3361,0.712385000,0.5364
215.158.239.225,<->,212.249.34.46,28,26031,0,0,28,26031,0.655504000,0.0953
129.225.132.224,<->,129.225.131.153,28,3842,0,0,28,3842,0.633729000,1.0223
215.158.239.30,<->,80.47.111.154,28,1568,0,0,28,1568,0.617122000,0.0844
195.14.102.199,<->,136.25.188.255,0,0,28,3224,28,3224,0.600715000,1.2086
98.156.168.196,<->,8.20.87.94,0,0,28,1717,28,1717,0.580706000,1.1507
136.25.188.255,<->,126.219.132.205,28,5071,0,0,28,5071,0.564743000,1.0267
207.61.217.114,<->,136.25.188.209,0,0,28,1656,28,1656,0.564133000,1.3528
215.158.239.71,<->,145.13.164.229,28,11476,0,0,28,11476,0.542168000,1.3538
195.124.60.10,<->,136.25.188.176,0,0,28,2393,28,2393,0.502248000,1.3796
207.6.70.5,<->,8.182.224.248,0,0,28,2570,28,2570,0.464940000,0.7996
156.150.126.238,<->,8.252.222.36,0,0,28,3823,28,3823,0.464192000,1.4591
133.178.227.52,<->,133.56.180.25,28,27899,0,0,28,27899,0.418755000,1.5588
215.158.238.140,<->,33.209.217.213,28,8284,0,0,28,8284,0.393205000,1.4214
133.178.226.77,<->,27.178.41.18,28,7881,0,0,28,7881,0.383648000,1.2587
133.178.226.41,<->,98.219.126.140,28,39270,0,0,28,39270,0.371256000,0.5989
142.228.169.90,<->,136.25.188.239,0,0,28,1922,28,1922,0.334409000,1.5512
215.158.44.193,<->,136.25.189.13,0,0,28,14306,28,14306,0.321097000,1.5972
220.28.73.211,<->,215.158.238.91,0,0,28,34056,28,34056,0.308999000,1.2752
136.25.189.12,<->,96.156.169.162,28,7188,0,0,28,7188,0.299435000,1.5802
133.178.226.31,<->,8.42.43.59,28,8862,0,0,28,8862,0.297585000,1.5731
136.25.189.92,<->,96.156.169.216,28,30776,0,0,28,30776,0.293995000,1.3597
215.158.239.48,<->,199.20.30.101,28,2464,0,0,28,2464,0.241180000,0.7800
215.158.239.58,<->,196.108.212.249,28,4630,0,0,28,4630,0.234044000,1.4801
136.25.188.242,<->,29.211.6.37,28,6620,0,0,28,6620,0.229839000,1.7376
220.39.233.203,<->,215.158.238.82,0,0,28,5323,28,5323,0.228110000,1.1934
215.158.238.133,<->,126.219.132.160,28,8153,0,0,28,8153,0.226683000,1.6433
215.158.238.69,<->,97.174.232.194,28,31607,0,0,28,31607,0.213547000,1.7419
215.158.239.50,<->,142.227.72.209,28,1400,0,0,28,1400,0.209364000,1.1129
207.21.161.177,<->,8.252.222.177,0,0,28,1400,28,1400,0.202047000,1.7224
104.136.21.135,<->,99.73.221.249,0,0,28,2895,28,2895,0.192580000,1.7810
220.28.85.14,<->,215.158.140.234,0,0,28,21228,28,21228,0.186643000,1.7656
136.25.188.52,<->,8.255.92.231,28,6420,0,0,28,6420,0.186549000,1.5204
215.158.238.238,<->,33.209.219.13,28,5560,0,0,28,5560,0.184740000,1.7685
215.158.238.140,<->,131.1.195.223,28,5738,0,0,28,5738,0.183859000,1.6857
142.227.70.185,<->,136.25.188.55,0,0,28,3304,28,3304,0.169893000,1.6423
207.21.3.48,<->,8.252.222.23,0,0,28,3231,28,3231,0.168831000,1.3585
215.158.238.94,<->,112.220.206.18,28,8830,0,0,28,8830,0.166206000,1.7811
220.28.85.14,<->,215.158.239.55,0,0,28,27974,28,27974,0.162553000,1.7483
95.245.154.253,<->,8.252.221.205,0,0,28,1478,28,1478,0.157513000,1.8272
192.227.190.20,<->,133.178.227.41,0,0,28,4106,28,4106,0.155257000,0.8672
221.196.123.219,<->,136.25.188.226,0,0,28,1400,28,1400,0.155224000,0.2596
195.13.147.141,<->,136.25.188.55,0,0,28,3145,28,3145,0.151913000,0.9579
136.25.188.226,<->,131.1.232.184,28,6996,0,0,28,6996,0.149877000,1.6799
142.209.175.125,<->,136.25.188.236,0,0,28,2782,28,2782,0.146767000,1.6020
19.195.169.123,<->,8.20.87.144,0,0,28,5480,28,5480,0.145493000,1.2267
133.178.226.31,<->,91.57.173.37,28,8762,0,0,28,8762,0.145487000,1.8536
136.25.188.239,<->,8.222.7.23,28,12269,0,0,28,12269,0.145061000,1.7571
54.36.13.173,<->,48.55.54.73,0,0,28,39268,28,39268,0.142238000,0.6584
199.68.195.104,<->,136.25.188.174,0,0,28,2654,28,2654,0.138919000,1.2077
215.158.238.72,<->,91.57.173.10,28,11352,0,0,28,11352,0.135033000,1.5314
133.178.227.57,<->,133.56.180.83,28,8809,0,0,28,8809,0.133490000,0.8713
133.178.227.138,<->,80.47.111.38,28,6517,0,0,28,6517,0.133480000,1.4448
215.158.238.116,<->,100.120.38.6,28,24784,0,0,28,24784,0.131278000,1.2701
215.158.238.148,<->,131.144.113.163,28,7817,0,0,28,7817,0.126055000,1.7411
159.57.90.68,<->,145.208.190.226,0,0,28,35143,28,35143,0.122909000,0.2182
235.138.15.215,<->,8.182.253.209,0,0,28,2259,28,2259,0.114131000,0.3370
136.25.189.20,<->,96.156.169.239,28,28341,0,0,28,28341,0.112570000,1.3719
215.158.238.98,<->,27.178.41.16,28,7961,0,0,28,7961,0.110259000,1.8359
136.25.188.211,<->,8.222.7.56,28,10179,0,0,28,10179,0.109175000,1.8511
75.214.113.12,<->,8.252.222.112,0,0,28,1928,28,1928,0.106043000,1.8416
136.25.188.252,<->,8.222.7.47,28,9054,0,0,28,9054,0.104474000,1.7787
136.25.188.199,<->,122.158.245.86,28,6804,0,0,28,6804,0.104200000,1.0841
215.158.238.67,<->,65.27.228.187,28,8061,0,0,28,8061,0.095649000,1.6790
133.178.226.61,<->,8.42.43.75,28,9034,0,0,28,9034,0.092431000,1.7787
133.201.2.177,<->,100.228.42.83,0,0,28,18089,28,18089,0.092372000,1.2627
133.178.227.40,<->,133.56.180.34,28,16255,0,0,28,16255,0.091229000,1.8930
133.178.226.90,<->,122.158.245.145,28,12669,0,0,28,12669,0.084774000,1.6987
139.241.56.116,<->,99.75.36.216,0,0,28,21166,28,21166,0.084657000,1.6725
215.158.238.75,<->,91.57.173.63,28,9272,0,0,28,9272,0.079884000,1.9184
204.184.56.37,<->,136.25.188.242,0,0,28,2315,28,2315,0.077936000,1.0702
215.158.238.120,<->,192.224.20.17,28,4010,0,0,28,4010,0.077414000,0.8210
215.158.239.76,<->,199.20.31.1,28,2815,0,0,28,2815,0.076204000,0.9601
136.25.189.59,<->,96.156.169.252,28,9706,0,0,28,9706,0.073740000,1.8993
199.111.153.254,<->,8.182.241.177,0,0,28,2945,28,2945,0.073321000,0.5300
136.25.188.197,<->,8.222.7.55,28,11488,0,0,28,11488,0.067258000,1.8220
133.178.226.90,<->,57.160.181.197,28,6724,0,0,28,6724,0.066261000,1.8664
136.25.188.220,<->,8.222.212.25,28,11668,0,0,28,11668,0.064903000,1.8295
139.163.96.101,<->,50.129.35.163,28,2877,0,0,28,2877,0.055153000,1.9350
215.158.239.16,<->,215.158.127.181,28,3719,0,0,28,3719,0.049103000,1.3546
136.25.189.76,<->,8.222.109.82,28,1788,0,0,28,1788,0.042874000,1.9198
143.23.111.212,<->,136.25.188.52,0,0,28,1683,28,1683,0.040725000,0.5262
251.24.170.25,<->,0.195.210.14,0,0,28,1960,28,1960,0.034940000,1.6944
215.158.239.93,<->,196.107.122.156,28,2280,0,0,28,2280,0.034376000,0.9033
36.116.165.235,<->,8.252.221.206,0,0,28,1476,28,1476,0.032400000,1.8676
136.25.188.237,<->,29.214.108.158,28,8682,0,0,28,8682,0.025517000,1.8353
80.38.62.154,<->,35.56.3.196,28,3925,0,0,28,3925,0.024969000,1.4816
142.43.186.121,<->,8.182.224.87,0,0,28,1504,28,1504,0.024573000,0.5044
136.25.188.236,<->,131.1.232.85,28,9566,0,0,28,9566,0.023581000,1.9298
215.158.238.75,<->,131.1.195.220,28,9774,0,0,28,9774,0.021819000,1.8707
143.13.34.41,<->,136.25.188.242,0,0,28,3065,28,3065,0.018930000,1.3063
222.39.240.170,<->,50.224.49.212,0,0,28,1568,28,1568,0.017424000,1.7106
136.25.189.38,<->,96.156.169.249,28,31960,0,0,28,31960,0.014580000,1.4727
215.158.239.69,<->,96.156.169.223,28,16023,0,0,28,16023,0.013398000,1.9128
58.168.81.132,<->,8.252.222.114,0,0,28,1772,28,1772,0.013163000,1.9630
146.193.4.6,<->,8.252.221.220,0,0,28,1688,28,1688,0.012794000,1.8947
111.150.74.14,<->,99.74.26.99,0,0,28,13154,28,13154,0.010762000,1.9440
66.47.172.91,<->,8.252.221.205,0,0,28,1460,28,1460,0.010271000,1.9050
142.228.5.217,<->,136.25.188.52,0,0,28,3302,28,3302,0.008200000,1.9836
109.222.249.182,<->,96.232.2.179,28,4928,0,0,28,4928,0.007324000,1.9276
228.23.111.151,<->,50.224.88.96,0,0,28,1568,28,1568,0.004996000,1.9776
207.236.47.30,<->,136.25.188.236,0,0,28,3121,28,3121,0.003266000,1.0870
136.25.189.78,<->,8.215.68.89,28,10451,0,0,28,10451,0.000491000,1.9710
215.158.140.229,<->,8.240.116.246,28,4684,0,0,28,4684,0.000021000,1.9947
8.228.216.50,<->,8.191.6.213,27,33170,0,0,27,33170,1.853787000,0.0711
128.135.233.211,<->,8.220.191.251,0,0,27,1818,27,1818,1.705484000,0.1837
220.28.115.46,<->,133.178.226.0,0,0,27,36010,27,36010,1.687646000,0.2254
204.200.51.85,<->,136.25.188.255,0,0,27,2221,27,2221,1.602416000,0.3073
137.47.36.43,<->,100.228.42.118,0,0,27,35532,27,35532,1.577269000,0.0973
195.4.195.204,<->,136.25.188.225,0,0,27,1512,27,1512,1.465079000,0.5090
133.178.227.43,<->,8.191.14.88,27,2656,0,0,27,2656,1.424265000,0.0503
215.158.238.107,<->,149.99.92.67,27,2461,0,0,27,2461,1.370795000,0.1553
247.136.237.194,<->,221.102.143.189,27,29605,0,0,27,29605,1.311968000,0.4021
207.60.111.65,<->,136.25.188.177,0,0,27,2604,27,2604,1.150443000,0.5372
60.101.197.67,<->,8.252.221.207,0,0,27,4471,27,4471,0.956140000,0.9043
142.252.215.125,<->,136.25.188.177,0,0,27,2415,27,2415,0.896686000,0.8871
195.71.188.163,<->,136.25.188.162,0,0,27,2547,27,2547,0.738920000,1.0391
194.233.78.49,<->,136.25.188.242,0,0,27,2930,27,2930,0.737204000,1.2604
215.158.239.56,<->,199.79.72.116,27,3059,0,0,27,3059,0.728505000,1.1700
195.5.232.177,<->,136.25.188.252,0,0,27,3673,27,3673,0.718635000,1.2713
215.158.239.95,<->,199.20.29.141,27,1585,0,0,27,1585,0.694517000,1.0600
111.151.109.39,<->,67.174.33.237,0,0,27,1556,27,1556,0.653598000,1.2021
215.158.239.70,<->,204.0.138.38,27,1692,0,0,27,1692,0.641730000,1.3404
221.102.122.193,<->,111.15.220.197,27,4436,0,0,27,4436,0.603494000,0.9244
220.28.109.52,<->,136.25.188.218,0,0,27,31600,27,31600,0.602797000,0.9779
136.25.188.238,<->,108.130.46.151,27,2318,0,0,27,2318,0.596573000,0.2627
199.38.106.248,<->,136.25.188.237,0,0,27,2638,27,2638,0.593489000,1.3190
133.178.227.41,<->,8.240.116.180,27,7597,0,0,27,7597,0.586301000,1.2046
215.158.239.99,<->,199.20.29.150,27,2563,0,0,27,2563,0.584408000,1.2429
215.158.239.83,<->,136.114.101.87,27,30577,0,0,27,30577,0.575779000,1.3655
207.61.68.151,<->,136.25.188.253,0,0,27,3082,27,3082,0.558419000,1.3248
196.240.181.129,<->,136.25.188.198,0,0,27,2930,27,2930,0.544985000,1.1780
215.201.227.68,<->,8.183.24.179,0,0,27,2699,27,2699,0.540577000,1.0606
136.25.188.236,<->,56.161.218.40,27,5223,0,0,27,5223,0.528943000,1.2716
215.158.238.66,<->,29.211.186.57,27,2557,0,0,27,2557,0.524620000,0.1923
133.178.227.2,<->,8.192.205.0,27,4574,0,0,27,4574,0.493796000,1.4272
136.25.188.199,<->,27.178.41.51,27,7489,0,0,27,7489,0.460202000,1.4021
136.25.188.236,<->,8.222.212.10,27,7649,0,0,27,7649,0.438960000,1.5492
141.163.50.125,<->,8.252.222.28,0,0,27,3968,27,3968,0.432254000,1.5581
8.55.209.213,<->,6.138.226.138,0,0,27,32962,27,32962,0.430551000,1.5576
100.95.89.103,<->,89.86.110.174,27,40360,0,0,27,40360,0.429262000,0.0003
215.158.30.253,<->,8.252.222.57,0,0,27,27000,27,27000,0.408466000,0.9867
215.158.239.56,<->,207.228.178.11,27,3016,0,0,27,3016,0.379373000,1.4194
133.178.227.76,<->,133.56.180.82,27,8881,0,0,27,8881,0.349663000,1.1829
136.25.188.47,<->,111.151.239.87,27,8918,0,0,27,8918,0.344284000,1.5640
215.158.238.66,<->,33.209.217.212,27,7078,0,0,27,7078,0.337909000,1.3865
222.79.69.11,<->,215.158.239.35,0,0,27,6967,27,6967,0.331098000,1.6511
215.158.238.126,<->,0.195.237.14,27,35898,0,0,27,35898,0.323814000,1.3793
136.25.188.209,<->,69.217.32.85,27,1512,0,0,27,1512,0.323650000,0.3722
221.102.143.189,<->,220.82.1.242,0,0,27,29929,27,29929,0.313650000,0.3634
215.158.239.19,<->,73.69.62.207,27,3100,0,0,27,3100,0.311300000,1.3476
59.142.198.227,<->,8.252.221.238,0,0,27,1711,27,1711,0.303471000,1.6464
215.158.44.182,<->,136.25.189.83,0,0,27,15892,27,15892,0.272446000,1.7044
199.73.218.199,<->,136.25.188.174,0,0,27,4064,27,4064,0.267349000,1.5212
136.25.188.45,<->,80.47.111.74,27,4839,0,0,27,4839,0.262268000,1.0600
142.249.59.70,<->,136.25.188.176,0,0,27,1422,27,1422,0.260715000,0.7377
215.158.239.56,<->,199.20.31.123,27,2639,0,0,27,2639,0.259918000,1.6882
220.28.115.46,<->,215.158.238.146,0,0,27,30906,27,30906,0.252925000,1.6387
215.158.238.177,<->,131.22.233.155,27,5791,0,0,27,5791,0.227622000,1.4982
133.178.226.38,<->,69.150.169.181,27,6636,0,0,27,6636,0.218440000,1.7282
204.56.130.90,<->,136.25.188.237,0,0,27,2897,27,2897,0.210930000,1.6121
136.25.188.220,<->,8.222.212.21,27,11872,0,0,27,11872,0.208294000,1.7183
142.221.196.250,<->,136.25.188.198,0,0,27,3074,27,3074,0.190005000,1.3703
115.186.21.39,<->,80.41.29.32,0,0,27,1350,27,1350,0.182225000,1.7535
215.158.238.133,<->,112.220.206.126,27,8690,0,0,27,8690,0.181979000,1.7254
136.25.188.47,<->,29.214.64.198,27,5111,0,0,27,5111,0.181197000,1.5665
133.178.226.67,<->,100.216.78.145,27,33774,0,0,27,33774,0.180967000,1.5884
215.158.238.106,<->,119.196.23.3,27,5195,0,0,27,5195,0.179293000,1.5607
136.62.206.172,<->,136.25.188.177,0,0,27,2781,27,2781,0.177462000,0.2144
199.80.150.159,<->,136.25.188.224,0,0,27,1422,27,1422,0.175429000,0.7597
243.156.1.4,<->,192.67.172.129,0,0,27,1404,27,1404,0.173895000,1.7360
58.51.8.239,<->,8.252.222.21,0,0,27,2289,27,2289,0.165185000,1.8239
204.21.1.112,<->,136.25.188.160,0,0,27,2470,27,2470,0.156378000,0.9660
136.25.189.8,<->,96.156.169.166,27,35868,0,0,27,35868,0.153222000,1.0379
137.170.13.110,<->,109.222.196.120,0,0,27,18479,27,18479,0.152987000,1.8096
133.178.226.77,<->,29.214.108.151,27,8902,0,0,27,8902,0.142831000,1.7629
143.132.56.155,<->,136.25.188.55,0,0,27,2912,27,2912,0.140411000,0.9895
199.82.50.188,<->,136.25.188.225,0,0,27,1905,27,1905,0.140102000,1.2828
215.158.238.143,<->,131.1.232.185,27,8813,0,0,27,8813,0.136811000,1.8226
149.110.222.182,<->,22.59.8.111,0,0,27,3011,27,3011,0.131743000,1.8676
197.113.99.17,<->,136.25.188.253,0,0,27,2370,27,2370,0.124530000,1.8696
215.158.239.49,<->,199.20.29.232,27,2367,0,0,27,2367,0.119811000,0.8600
136.25.188.161,<->,8.222.7.38,27,11344,0,0,27,11344,0.119485000,1.8304
136.138.112.200,<->,136.25.188.221,0,0,27,8466,27,8466,0.114246000,1.8784
246.253.253.170,<->,159.220.151.123,27,30768,0,0,27,30768,0.113718000,1.6726
220.28.73.211,<->,215.158.238.139,0,0,27,36980,27,36980,0.112349000,0.6389
75.214.96.189,<->,8.252.221.230,0,0,27,1410,27,1410,0.109810000,1.8806
136.25.188.223,<->,69.150.168.234,27,9963,0,0,27,9963,0.105507000,1.7073
235.65.148.186,<->,92.27.219.23,0,0,27,15954,27,15954,0.103135000,1.8272
215.158.239.49,<->,194.232.186.93,27,1350,0,0,27,1350,0.100768000,0.5640
221.102.143.189,<->,192.64.238.192,0,0,27,32940,27,32940,0.099032000,0.2958
147.47.195.52,<->,8.252.221.206,0,0,27,1392,27,1392,0.097346000,1.7874
94.193.151.71,<->,8.252.222.204,0,0,27,1700,27,1700,0.092884000,1.8705
215.158.239.68,<->,204.61.205.154,27,2504,0,0,27,2504,0.085305000,1.8001
133.178.227.24,<->,69.150.168.233,27,2877,0,0,27,2877,0.081691000,1.9178
247.136.147.198,<->,57.46.197.86,27,39528,0,0,27,39528,0.080244000,1.7272
101.81.253.199,<->,97.198.108.246,0,0,27,1512,27,1512,0.079990000,1.9193
215.158.238.134,<->,8.255.92.247,27,11200,0,0,27,11200,0.079623000,1.8064
139.163.34.3,<->,98.87.178.216,27,1512,0,0,27,1512,0.075501000,1.7617
95.245.192.140,<->,8.252.222.241,0,0,27,1804,27,1804,0.072306000,1.8868
195.4.148.171,<->,136.25.188.199,0,0,27,1557,27,1557,0.070318000,0.7478
136.25.188.227,<->,8.222.212.25,27,6812,0,0,27,6812,0.070275000,0.8202
210.229.230.18,<->,205.187.74.148,27,11303,0,0,27,11303,0.067826000,1.8885
215.158.239.67,<->,133.56.180.38,27,34140,0,0,27,34140,0.066294000,1.2375
136.25.188.173,<->,29.214.64.170,27,6504,0,0,27,6504,0.065379000,1.4920
197.113.99.176,<->,136.25.188.44,0,0,27,2549,27,2549,0.063370000,1.8009
217.237.202.203,<->,97.198.108.246,0,0,27,1512,27,1512,0.056859000,1.9043
215.158.238.95,<->,122.158.49.230,27,1512,0,0,27,1512,0.053597000,1.8932
92.27.219.20,<->,75.92.56.156,27,37692,0,0,27,37692,0.051116000,1.9251
215.158.238.83,<->,149.250.115.27,27,6552,0,0,27,6552,0.049753000,1.9089
94.194.23.106,<->,8.252.222.13,0,0,27,1776,27,1776,0.048063000,1.9401
69.103.230.192,<->,8.252.222.114,0,0,27,1724,27,1724,0.046149000,1.8303
195.13.151.25,<->,136.25.188.222,0,0,27,2221,27,2221,0.038319000,0.3587
60.101.107.92,<->,8.252.222.176,0,0,27,1772,27,1772,0.037927000,1.8242
92.27.219.171,<->,92.16.211.154,27,34012,0,0,27,34012,0.036550000,1.8657
144.34.64.236,<->,139.163.34.3,0,0,27,33588,27,33588,0.035764000,1.9436
230.8.189.30,<->,8.9.165.188,0,0,27,1692,27,1692,0.033255000,1.8804
133.178.227.76,<->,133.56.180.90,27,20998,0,0,27,20998,0.028555000,1.9538
204.143.51.129,<->,50.223.3.228,0,0,27,1416,27,1416,0.028340000,1.9400
146.193.79.201,<->,8.252.222.82,0,0,27,1708,27,1708,0.027931000,1.9033
220.28.73.211,<->,215.158.238.247,0,0,27,31346,27,31346,0.024763000,1.3760
220.20.200.137,<->,124.46.191.127,27,35687,0,0,27,35687,0.023435000,0.3297
136.25.188.197,<->,8.222.7.56,27,11296,0,0,27,11296,0.023107000,1.8797
215.158.239.79,<->,207.239.64.55,27,2305,0,0,27,2305,0.022459000,0.5672
216.184.1.90,<->,136.25.188.170,0,0,27,33566,27,33566,0.021662000,0.0811
121.79.59.152,<->,92.162.253.163,0,0,27,34486,27,34486,0.021205000,0.2527
132.119.137.71,<->,80.27.158.183,0,0,27,2427,27,2427,0.020741000,1.0021
136.25.188.203,<->,80.57.208.31,27,34652,0,0,27,34652,0.015201000,0.1133
221.102.56.69,<->,109.1.60.236,0,0,27,3226,27,3226,0.014804000,0.7236
22.61.14.243,<->,8.220.189.63,0,0,27,1990,27,1990,0.014367000,0.4271
220.39.233.209,<->,133.178.226.77,0,0,27,10171,27,10171,0.011703000,1.9013
133.178.227.40,<->,133.56.180.89,27,5671,0,0,27,5671,0.009861000,1.4554
215.158.140.229,<->,111.150.187.223,27,6843,0,0,27,6843,0.009442000,1.9686
133.178.226.37,<->,29.214.64.189,27,7649,0,0,27,7649,0.009339000,1.9698
199.80.29.19,<->,136.25.188.176,0,0,27,1647,27,1647,0.008256000,0.4890
215.158.239.99,<->,207.16.240.201,27,2237,0,0,27,2237,0.007374000,1.0598
133.178.227.1,<->,133.56.180.11,27,11609,0,0,27,11609,0.005571000,1.9784
215.158.238.82,<->,131.1.253.217,27,8320,0,0,27,8320,0.005268000,1.9499
136.25.188.42,<->,122.158.176.131,27,12663,0,0,27,12663,0.003186000,1.9887
133.178.226.21,<->,98.219.126.140,27,32629,0,0,27,32629,0.002630000,1.8733
194.124.22.48,<->,145.252.126.80,0,0,27,3454,27,3454,0.001525000,0.8771
139.163.96.101,<->,82.239.157.195,27,2869,0,0,27,2869,0.000661000,1.8063
220.20.200.53,<->,144.83.60.153,26,34919,0,0,26,34919,1.765864000,0.2245
215.158.140.171,<->,8.176.10.255,26,38024,0,0,26,38024,1.668381000,0.0117
221.102.56.46,<->,98.128.228.57,0,0,26,4090,26,4090,1.501489000,0.4100
220.39.233.187,<->,133.178.226.37,0,0,26,5711,26,5711,1.497161000,0.3169
126.219.197.186,<->,99.74.87.231,0,0,26,4349,26,4349,1.446175000,0.5434
8.252.221.221,<->,4.121.204.128,26,2448,0,0,26,2448,1.423657000,0.5264
210.221.107.50,<->,8.37.245.94,26,21772,0,0,26,21772,1.380370000,0.4615
192.171.32.186,<->,133.178.227.1,0,0,26,2741,26,2741,1.364287000,0.2660
221.102.143.189,<->,80.41.44.252,0,0,26,29713,26,29713,1.245061000,0.7531
136.138.112.219,<->,133.178.226.18,0,0,26,4971,26,4971,1.231089000,0.7631
136.25.188.238,<->,41.60.116.4,26,3121,0,0,26,3121,1.219297000,0.1725
68.78.3.146,<->,8.252.221.237,0,0,26,2608,26,2608,1.208859000,0.6552
221.102.143.189,<->,102.81.176.170,0,0,26,29281,26,29281,1.145509000,0.3799
159.137.249.250,<->,27.11.125.44,26,2131,0,0,26,2131,1.137604000,0.8052
143.53.50.46,<->,136.25.188.163,0,0,26,3007,26,3007,1.108302000,0.8074
199.51.122.249,<->,136.25.188.238,0,0,26,2602,26,2602,1.040995000,0.9507
142.206.20.244,<->,136.25.188.53,0,0,26,2833,26,2833,1.022330000,0.6238
215.158.140.75,<->,113.23.7.238,26,2430,0,0,26,2430,1.011705000,0.1383
215.158.238.102,<->,145.116.209.93,26,33631,0,0,26,33631,0.992635000,0.9112
215.158.239.84,<->,204.226.116.98,26,3996,0,0,26,3996,0.990885000,0.8200
215.158.239.76,<->,196.106.13.2,26,2395,0,0,26,2395,0.985170000,0.7599
215.158.239.76,<->,199.20.28.15,26,3205,0,0,26,3205,0.960184000,0.7719
199.82.145.50,<->,136.25.188.199,0,0,26,2391,26,2391,0.943423000,0.5208
215.158.140.231,<->,113.23.14.200,26,4578,0,0,26,4578,0.940124000,1.0175
215.158.140.74,<->,114.75.170.84,26,4234,0,0,26,4234,0.901989000,0.6934
101.106.122.69,<->,92.27.219.49,0,0,26,7230,26,7230,0.890714000,0.9753
220.28.104.193,<->,215.158.238.100,0,0,26,32424,26,32424,0.880810000,1.0588
215.158.239.8,<->,96.135.154.156,26,36566,0,0,26,36566,0.804921000,0.9068
207.173.234.116,<->,136.25.188.198,0,0,26,2995,26,2995,0.792662000,0.8694
136.25.188.249,<->,0.195.237.14,26,35196,0,0,26,35196,0.757665000,0.0222
136.25.188.229,<->,80.57.141.173,26,29392,0,0,26,29392,0.733828000,0.1616
215.158.239.58,<->,142.241.246.1,26,2347,0,0,26,2347,0.678318000,0.6231
215.158.239.56,<->,199.72.57.71,26,2487,0,0,26,2487,0.661795000,0.9025
199.82.209.42,<->,136.25.188.236,0,0,26,5516,26,5516,0.652536000,1.2320
215.158.239.56,<->,194.237.78.238,26,2501,0,0,26,2501,0.619766000,0.9461
215.158.238.140,<->,148.55.210.231,26,2677,0,0,26,2677,0.616248000,0.4908
143.79.117.250,<->,136.25.188.255,0,0,26,2555,26,2555,0.594945000,0.4888
197.113.64.201,<->,136.25.188.177,0,0,26,3199,26,3199,0.592666000,1.1702
215.158.239.93,<->,204.58.17.171,26,2475,0,0,26,2475,0.575677000,1.3923
142.228.82.251,<->,136.25.188.173,0,0,26,4620,26,4620,0.570458000,1.4169
220.28.108.254,<->,215.158.239.46,0,0,26,29554,26,29554,0.564269000,1.2810
204.3.189.5,<->,136.25.188.222,0,0,26,3044,26,3044,0.524835000,0.4082
48.16.206.213,<->,8.252.221.221,0,0,26,2501,26,2501,0.499884000,1.3913
136.25.188.34,<->,96.234.103.82,26,35288,0,0,26,35288,0.493069000,1.4105
215.158.239.93,<->,199.20.30.186,26,1468,0,0,26,1468,0.457218000,0.8003
215.158.239.50,<->,196.109.12.46,26,2400,0,0,26,2400,0.443016000,1.1492
136.25.188.211,<->,100.224.202.151,26,13152,0,0,26,13152,0.435506000,1.5530
111.48.212.5,<->,8.182.228.189,0,0,26,3002,26,3002,0.435190000,0.5775
89.183.104.171,<->,27.75.124.50,26,1612,0,0,26,1612,0.429495000,1.5625
215.158.140.17,<->,215.158.127.31,26,38630,0,0,26,38630,0.403308000,0.0015
199.38.125.90,<->,136.25.188.175,0,0,26,3308,26,3308,0.400793000,1.2359
92.27.219.32,<->,6.248.112.247,26,34043,0,0,26,34043,0.396720000,1.5308
199.81.30.247,<->,136.25.188.252,0,0,26,1576,26,1576,0.387352000,1.0464
215.158.239.56,<->,204.61.60.38,26,3084,0,0,26,3084,0.382479000,1.3012
8.252.222.150,<->,4.122.101.62,26,2540,0,0,26,2540,0.357091000,1.6202
139.248.30.198,<->,100.228.42.154,0,0,26,18174,26,18174,0.353227000,1.6260
136.25.188.45,<->,126.219.247.59,26,8922,0,0,26,8922,0.351686000,1.6235
215.158.140.205,<->,8.222.7.155,26,2578,0,0,26,2578,0.334656000,0.1354
215.158.238.190,<->,126.219.246.238,26,5471,0,0,26,5471,0.334087000,1.4098
215.158.239.52,<->,138.45.90.210,26,29310,0,0,26,29310,0.333761000,1.0372
53.231.92.195,<->,48.54.81.68,0,0,26,39104,26,39104,0.332825000,1.1989
215.158.239.49,<->,145.13.164.183,26,15251,0,0,26,15251,0.316085000,1.6347
215.158.239.84,<->,199.20.28.11,26,3013,0,0,26,3013,0.315773000,1.5699
231.142.194.212,<->,136.25.188.220,0,0,26,2165,26,2165,0.293821000,0.2426
215.158.239.49,<->,195.49.84.18,26,1525,0,0,26,1525,0.293549000,0.3300
207.61.92.202,<->,136.25.188.54,0,0,26,1932,26,1932,0.274355000,1.0520
215.158.239.48,<->,207.115.22.94,26,3583,0,0,26,3583,0.272400000,0.6490
215.158.239.79,<->,199.20.28.164,26,2969,0,0,26,2969,0.269625000,1.2405
200.174.28.185,<->,53.161.98.43,26,17215,0,0,26,17215,0.259923000,0.7268
132.249.70.11,<->,53.208.241.220,26,33527,0,0,26,33527,0.256267000,0.7917
133.178.226.28,<->,29.214.108.120,26,10998,0,0,26,10998,0.243816000,1.5930
111.151.237.32,<->,97.183.197.231,0,0,26,34479,26,34479,0.234498000,0.0008
114.41.29.88,<->,99.74.26.152,0,0,26,28680,26,28680,0.231065000,0.5625
205.127.108.114,<->,33.233.141.117,0,0,26,23669,26,23669,0.226253000,1.7703
133.178.226.28,<->,131.1.253.224,26,8166,0,0,26,8166,0.218460000,1.4516
133.178.226.7,<->,8.42.43.40,26,8810,0,0,26,8810,0.214805000,1.4030
215.158.239.84,<->,204.0.168.219,26,1603,0,0,26,1603,0.211112000,1.2865
215.158.238.236,<->,8.219.185.50,26,4591,0,0,26,4591,0.200788000,1.7932
89.129.154.158,<->,8.182.136.20,0,0,26,4570,26,4570,0.200503000,1.1872
202.33.212.240,<->,136.25.188.177,0,0,26,2987,26,2987,0.200034000,1.5281
133.178.226.77,<->,33.209.217.221,26,5563,0,0,26,5563,0.197242000,1.4954
133.178.227.19,<->,38.104.11.116,26,3462,0,0,26,3462,0.194587000,0.6137
215.158.239.76,<->,199.14.131.242,26,2250,0,0,26,2250,0.190666000,0.5881
8.252.223.153,<->,8.219.185.37,26,2432,0,0,26,2432,0.188571000,0.1761
142.254.36.120,<->,136.25.188.224,0,0,26,3416,26,3416,0.183756000,1.2977
136.25.188.223,<->,8.222.212.59,26,7529,0,0,26,7529,0.183141000,1.6745
199.69.47.42,<->,136.25.188.160,0,0,26,3362,26,3362,0.179654000,0.6344
220.28.104.193,<->,136.25.189.55,0,0,26,31581,26,31581,0.176574000,0.7236
192.64.193.89,<->,122.120.143.25,26,1414,0,0,26,1414,0.171125000,1.6670
136.25.188.45,<->,122.158.245.146,26,8990,0,0,26,8990,0.164642000,1.7997
115.170.189.64,<->,80.42.175.248,0,0,26,26885,26,26885,0.163557000,1.7903
215.158.238.67,<->,126.219.194.106,26,9388,0,0,26,9388,0.157915000,1.8105
94.195.14.76,<->,8.252.221.206,0,0,26,1342,26,1342,0.156847000,1.8055
215.158.140.231,<->,68.231.26.217,26,3616,0,0,26,3616,0.150959000,1.7396
215.158.140.231,<->,131.1.194.192,26,7309,0,0,26,7309,0.147083000,1.4929
195.43.56.179,<->,136.25.188.54,0,0,26,2865,26,2865,0.145241000,1.3458
194.237.98.164,<->,136.25.188.238,0,0,26,1970,26,1970,0.141019000,1.2632
215.158.238.82,<->,8.42.43.88,26,11688,0,0,26,11688,0.135409000,1.8524
215.158.239.99,<->,143.44.139.212,26,3822,0,0,26,3822,0.128407000,1.5835
133.178.227.14,<->,133.56.180.24,26,12595,0,0,26,12595,0.127624000,1.7990
215.158.238.82,<->,57.210.107.42,26,10499,0,0,26,10499,0.124914000,1.7635
58.48.134.100,<->,8.252.222.97,0,0,26,1828,26,1828,0.124401000,1.8747
207.231.197.31,<->,8.252.222.178,0,0,26,1687,26,1687,0.123390000,1.6929
156.142.159.13,<->,0.195.210.33,0,0,26,1645,26,1645,0.121919000,1.8084
133.178.226.18,<->,111.151.239.8,26,11092,0,0,26,11092,0.121679000,1.8093
144.85.170.246,<->,139.128.71.98,26,1456,0,0,26,1456,0.118076000,1.8698
146.249.226.33,<->,8.252.222.110,0,0,26,1632,26,1632,0.117965000,1.8003
156.148.224.195,<->,8.252.222.109,0,0,26,1680,26,1680,0.117131000,1.6778
207.81.165.219,<->,50.223.3.228,0,0,26,1354,26,1354,0.116774000,1.7761
153.111.177.167,<->,8.252.221.221,0,0,26,1817,26,1817,0.114980000,1.8448
139.241.73.46,<->,129.224.112.221,0,0,26,1723,26,1723,0.113903000,1.6335
137.44.153.226,<->,80.38.59.60,0,0,26,1300,26,1300,0.102627000,0.3930
215.158.239.94,<->,204.2.105.75,26,1677,0,0,26,1677,0.099703000,1.8980
136.25.189.6,<->,96.156.169.209,26,23853,0,0,26,23853,0.099152000,1.8347
215.158.239.93,<->,199.20.28.62,26,1501,0,0,26,1501,0.098861000,0.3900
132.149.179.209,<->,8.182.253.104,0,0,26,1540,26,1540,0.095990000,1.1397
192.204.170.214,<->,133.178.226.7,0,0,26,5263,26,5263,0.095271000,1.7522
136.25.188.160,<->,131.144.113.212,26,9054,0,0,26,9054,0.092035000,1.8300
215.158.140.83,<->,126.219.132.66,26,4523,0,0,26,4523,0.088532000,1.3255
136.25.188.254,<->,91.57.173.26,26,8766,0,0,26,8766,0.087987000,1.8088
215.158.239.56,<->,199.20.6.61,26,2395,0,0,26,2395,0.087080000,0.4987
139.241.56.102,<->,109.2.42.159,0,0,26,35056,26,35056,0.086103000,1.9040
133.178.226.30,<->,96.155.60.216,26,14069,0,0,26,14069,0.084586000,1.1097
207.206.117.29,<->,50.223.3.228,0,0,26,1336,26,1336,0.081396000,1.7939
60.101.83.31,<->,8.252.221.223,0,0,26,2064,26,2064,0.077399000,1.8980
215.158.239.99,<->,142.166.122.161,26,3217,0,0,26,3217,0.074187000,1.4491
142.240.20.148,<->,136.25.188.220,0,0,26,2263,26,2263,0.072616000,1.1660
139.163.20.253,<->,99.215.130.242,26,1300,0,0,26,1300,0.067128000,1.8178
101.70.123.195,<->,53.149.26.42,26,15498,0,0,26,15498,0.057987000,1.7138
65.26.114.146,<->,8.252.221.79,0,0,26,6298,26,6298,0.053302000,1.9377
92.168.217.228,<->,78.151.34.195,26,1456,0,0,26,1456,0.053297000,0.5155
193.21.28.201,<->,92.27.219.253,0,0,26,34284,26,34284,0.048815000,0.8569
215.158.239.78,<->,195.49.155.114,26,2347,0,0,26,2347,0.047699000,1.9195
215.158.140.231,<->,131.144.116.23,26,4505,0,0,26,4505,0.046232000,1.7197
215.158.239.94,<->,142.236.221.137,26,2019,0,0,26,2019,0.045446000,0.5629
195.126.190.87,<->,136.25.188.163,0,0,26,2228,26,2228,0.045171000,1.6322
143.61.25.162,<->,50.223.3.228,0,0,26,1348,26,1348,0.040887000,1.7538
215.158.239.73,<->,56.97.186.37,26,29417,0,0,26,29417,0.039859000,1.8840
133.178.227.79,<->,104.3.168.53,26,5539,0,0,26,5539,0.035556000,1.8242
207.221.197.178,<->,92.27.219.54,0,0,26,1368,26,1368,0.027869000,1.9486
141.191.219.75,<->,8.252.222.210,0,0,26,1572,26,1572,0.026152000,1.9010
220.28.104.193,<->,133.178.227.44,0,0,26,30209,26,30209,0.025979000,0.2968
215.158.238.220,<->,111.150.187.125,26,4831,0,0,26,4831,0.025103000,1.3053
43.53.56.207,<->,8.252.222.109,0,0,26,1588,26,1588,0.021369000,1.9218
205.127.108.114,<->,33.233.141.34,0,0,26,19827,26,19827,0.018712000,1.9462
195.6.101.83,<->,136.25.188.176,0,0,26,2245,26,2245,0.017666000,1.0246
215.158.239.92,<->,145.13.164.209,26,14110,0,0,26,14110,0.017515000,1.8523
215.158.238.115,<->,80.47.111.106,26,12349,0,0,26,12349,0.013755000,1.8346
136.25.188.178,<->,33.209.217.201,26,8241,0,0,26,8241,0.012972000,1.7968
133.178.226.31,<->,122.158.245.121,26,7621,0,0,26,7621,0.010322000,1.8239
215.158.238.177,<->,56.51.205.196,26,1456,0,0,26,1456,0.009760000,0.0049
50.224.82.19,<->,50.31.80.4,26,1456,0,0,26,1456,0.008188000,1.9399
212.241.174.245,<->,80.27.152.99,0,0,26,11991,26,11991,0.007765000,1.9105
220.39.233.203,<->,136.25.188.252,0,0,26,7705,26,7705,0.006836000,1.8734
215.158.239.94,<->,145.13.164.216,26,11796,0,0,26,11796,0.004672000,1.6702
215.158.239.19,<->,105.51.161.75,26,1657,0,0,26,1657,0.004185000,0.4092
247.136.245.5,<->,125.34.158.127,26,14509,0,0,26,14509,0.003959000,1.8930
215.158.239.79,<->,199.72.91.233,26,2454,0,0,26,2454,0.003695000,1.9093
212.105.159.2,<->,8.20.87.144,0,0,26,1300,26,1300,0.002431000,0.0480
8.252.223.140,<->,8.240.116.229,26,8738,0,0,26,8738,0.001814000,1.8570
215.158.140.214,<->,122.158.69.2,26,10931,0,0,26,10931,0.001027000,1.9560
215.158.238.233,<->,215.158.33.113,25,35234,0,0,25,35234,1.843582000,0.0005
215.158.140.221,<->,8.222.7.180,25,2455,0,0,25,2455,1.733342000,0.1399
8.183.25.20,<->,6.167.232.246,25,2297,0,0,25,2297,1.732979000,0.2554
215.158.238.102,<->,98.219.126.140,25,31350,0,0,25,31350,1.707167000,0.2876
89.152.249.182,<->,8.182.239.159,0,0,25,2380,25,2380,1.641211000,0.2573
99.187.125.122,<->,8.20.87.2,0,0,25,21063,25,21063,1.560965000,0.4357
215.158.238.240,<->,122.158.245.36,25,2562,0,0,25,2562,1.484786000,0.4615
207.162.182.125,<->,8.182.230.134,0,0,25,1645,25,1645,1.474555000,0.4699
215.158.140.219,<->,8.176.6.40,25,36672,0,0,25,36672,1.348473000,0.0516
215.158.140.87,<->,137.46.173.232,25,2157,0,0,25,2157,1.261407000,0.5967
221.102.103.73,<->,207.118.195.146,25,1688,0,0,25,1688,1.251400000,0.6138
221.196.122.207,<->,136.25.188.209,0,0,25,1641,25,1641,1.230952000,0.4960
220.28.115.46,<->,133.178.227.7,0,0,25,30395,25,30395,1.107626000,0.6193
248.239.119.105,<->,221.102.143.189,25,20513,0,0,25,20513,1.054920000,0.8516
204.3.189.5,<->,136.25.188.55,0,0,25,3649,25,3649,1.051202000,0.9468
142.201.0.93,<->,8.182.250.65,0,0,25,2224,25,2224,1.032970000,0.9450
195.71.130.7,<->,136.25.188.45,0,0,25,3121,25,3121,1.010375000,0.3469
215.158.239.111,<->,96.234.103.82,25,35206,0,0,25,35206,0.992174000,0.8441
195.13.88.26,<->,136.25.188.198,0,0,25,1686,25,1686,0.895342000,0.6637
215.158.140.231,<->,130.165.253.19,25,3771,0,0,25,3771,0.851368000,1.0785
133.178.227.16,<->,69.150.169.246,25,4391,0,0,25,4391,0.825734000,0.9938
215.158.238.82,<->,126.219.194.141,25,8758,0,0,25,8758,0.823650000,0.9437
215.158.239.56,<->,196.89.223.114,25,6580,0,0,25,6580,0.821857000,0.8428
192.224.146.35,<->,133.178.227.245,0,0,25,12184,25,12184,0.794196000,0.8523
215.158.239.48,<->,207.61.241.24,25,2915,0,0,25,2915,0.767919000,0.8616
215.158.239.95,<->,202.33.255.47,25,2529,0,0,25,2529,0.765004000,1.2210
221.102.143.189,<->,6.72.58.56,0,0,25,29433,25,29433,0.684939000,0.2165
144.85.170.208,<->,103.40.248.158,25,1747,0,0,25,1747,0.665821000,0.6697
205.150.176.250,<->,109.222.254.165,0,0,25,1334,25,1334,0.663611000,1.2344
245.161.127.245,<->,8.252.222.148,0,0,25,3757,25,3757,0.662406000,1.0319
215.158.238.142,<->,111.151.239.1,25,6284,0,0,25,6284,0.640388000,0.9037
215.158.44.201,<->,136.25.189.15,0,0,25,14714,25,14714,0.638990000,1.2566
89.152.249.100,<->,8.182.239.159,0,0,25,2179,25,2179,0.630614000,0.2620
142.191.125.176,<->,136.25.188.54,0,0,25,2436,25,2436,0.629447000,1.1971
215.158.239.76,<->,195.97.21.76,25,2600,0,0,25,2600,0.594292000,1.3301
194.234.203.117,<->,136.25.188.198,0,0,25,2660,25,2660,0.592223000,1.3891
136.25.189.95,<->,96.156.169.176,25,25307,0,0,25,25307,0.586904000,1.0020
144.85.169.244,<->,111.146.142.77,0,0,25,34544,25,34544,0.580157000,1.0878
136.25.188.179,<->,122.158.245.134,25,7697,0,0,25,7697,0.560567000,1.3782
221.102.143.189,<->,220.83.113.171,0,0,25,26389,25,26389,0.555608000,0.5819
215.158.6.223,<->,8.252.223.131,0,0,25,4577,25,4577,0.526507000,0.9746
133.178.226.43,<->,8.222.48.162,25,34941,0,0,25,34941,0.490657000,0.0014
220.28.85.14,<->,215.158.140.88,0,0,25,36330,25,36330,0.485672000,0.0001
215.158.239.94,<->,194.232.3.141,25,3989,0,0,25,3989,0.479949000,1.4589
133.178.227.27,<->,133.56.180.31,25,8177,0,0,25,8177,0.446995000,1.3135
215.158.238.143,<->,106.188.183.71,25,4116,0,0,25,4116,0.446233000,0.9712
215.158.239.68,<->,143.44.139.212,25,2986,0,0,25,2986,0.435870000,1.0011
215.158.238.198,<->,33.209.219.37,25,5175,0,0,25,5175,0.416691000,1.5775
196.240.168.35,<->,136.25.188.222,0,0,25,2224,25,2224,0.405943000,0.3311
133.178.226.21,<->,8.222.48.131,25,35255,0,0,25,35255,0.400348000,0.0012
136.25.188.53,<->,116.106.60.157,25,3778,0,0,25,3778,0.391653000,0.5470
215.158.239.36,<->,96.135.154.158,25,29387,0,0,25,29387,0.388200000,1.4336
222.244.24.200,<->,215.158.238.96,0,0,25,2653,25,2653,0.384763000,0.4766
210.220.219.150,<->,98.197.185.155,25,10432,0,0,25,10432,0.376222000,1.2083
133.178.227.24,<->,18.202.90.200,25,4586,0,0,25,4586,0.373407000,1.4216
102.118.144.248,<->,100.228.42.160,0,0,25,20407,25,20407,0.371876000,1.3743
195.13.25.19,<->,136.25.188.220,0,0,25,2429,25,2429,0.368624000,1.3285
136.25.188.243,<->,72.34.26.103,25,2635,0,0,25,2635,0.343498000,1.6193
148.55.210.208,<->,133.178.226.18,0,0,25,5175,25,5175,0.332850000,1.4284
215.158.238.82,<->,142.234.196.182,25,5175,0,0,25,5175,0.317375000,1.4169
133.178.227.60,<->,133.56.180.37,25,27566,0,0,25,27566,0.298722000,1.0166
192.204.123.39,<->,136.25.189.83,0,0,25,14070,25,14070,0.297510000,1.5459
215.158.238.107,<->,146.248.115.222,25,2813,0,0,25,2813,0.291245000,1.6523
199.72.44.182,<->,136.25.188.209,0,0,25,1457,25,1457,0.287850000,0.4902
133.178.227.16,<->,133.56.180.33,25,13990,0,0,25,13990,0.281695000,1.5315
92.27.219.188,<->,27.11.166.221,25,13126,0,0,25,13126,0.280841000,0.5980
149.250.115.24,<->,136.25.188.160,0,0,25,8258,25,8258,0.274076000,1.5184
149.250.115.4,<->,133.178.226.38,0,0,25,5223,25,5223,0.268633000,1.5692
133.178.226.37,<->,126.219.194.116,25,10343,0,0,25,10343,0.261879000,1.6263
215.158.239.70,<->,199.20.31.208,25,3815,0,0,25,3815,0.248240000,1.3299
136.25.188.177,<->,29.214.108.81,25,11583,0,0,25,11583,0.248042000,1.6918
215.158.140.92,<->,193.39.68.244,25,4391,0,0,25,4391,0.234965000,1.2289
229.69.240.213,<->,80.41.35.54,0,0,25,1776,25,1776,0.223692000,1.3647
207.63.96.43,<->,136.25.188.175,0,0,25,2109,25,2109,0.220669000,0.7212
215.158.239.97,<->,199.20.31.245,25,1473,0,0,25,1473,0.212545000,0.7010
231.143.121.22,<->,136.25.188.52,0,0,25,1328,25,1328,0.210667000,1.3802
215.158.239.233,<->,100.244.13.12,25,8516,0,0,25,8516,0.207580000,1.4055
215.158.61.182,<->,136.25.189.222,0,0,25,22310,25,22310,0.205372000,1.7242
142.221.150.26,<->,136.25.188.53,0,0,25,1882,25,1882,0.192392000,0.2961
98.67.144.152,<->,75.211.26.129,25,1250,0,0,25,1250,0.184524000,1.7902
215.158.239.56,<->,199.82.240.23,25,1934,0,0,25,1934,0.176174000,0.9414
207.58.161.119,<->,136.25.188.209,0,0,25,1823,25,1823,0.173978000,1.7261
215.158.239.69,<->,195.55.157.19,25,2176,0,0,25,2176,0.170246000,1.5593
215.158.3.188,<->,133.178.227.138,0,0,25,17602,25,17602,0.166444000,1.4773
133.178.226.196,<->,105.101.175.196,25,1400,0,0,25,1400,0.163796000,1.5031
215.158.238.143,<->,8.190.216.200,25,7985,0,0,25,7985,0.157090000,1.7538
215.158.61.183,<->,8.176.8.176,0,0,25,15486,25,15486,0.156512000,1.8297
196.20.210.148,<->,50.223.3.228,0,0,25,1250,25,1250,0.156195000,1.8336
207.119.143.199,<->,8.252.222.51,0,0,25,3264,25,3264,0.150938000,1.5902
215.158.127.59,<->,8.176.8.182,0,0,25,19460,25,19460,0.146810000,1.8158
133.178.227.27,<->,106.188.244.245,25,5698,0,0,25,5698,0.141770000,1.4736
215.158.239.96,<->,199.20.31.215,25,2862,0,0,25,2862,0.137630000,1.1591
136.25.188.255,<->,56.161.218.63,25,8850,0,0,25,8850,0.130468000,1.6906
139.244.182.239,<->,8.220.191.251,0,0,25,1539,25,1539,0.125492000,0.0708
143.12.65.89,<->,136.25.188.52,0,0,25,1328,25,1328,0.123314000,1.8422
215.158.61.182,<->,133.178.226.173,0,0,25,33375,25,33375,0.123221000,1.2042
92.168.217.241,<->,50.136.136.40,25,1659,0,0,25,1659,0.120332000,1.4364
136.25.189.78,<->,123.166.46.202,25,6897,0,0,25,6897,0.119714000,1.7484
142.255.35.16,<->,136.25.188.53,0,0,25,1440,25,1440,0.112073000,1.7570
94.194.25.1,<->,8.252.221.239,0,0,25,1532,25,1532,0.111170000,1.8290
136.25.188.45,<->,80.47.111.24,25,8966,0,0,25,8966,0.108922000,1.6973
142.252.215.125,<->,136.25.188.53,0,0,25,3933,25,3933,0.108824000,1.6360
215.158.238.47,<->,126.219.194.132,25,7745,0,0,25,7745,0.105123000,1.6918
156.142.24.244,<->,8.252.222.222,0,0,25,1672,25,1672,0.101371000,1.8637
215.158.238.135,<->,104.3.168.202,25,15008,0,0,25,15008,0.099791000,1.8534
215.158.238.96,<->,56.161.218.55,25,7549,0,0,25,7549,0.098631000,1.3360
36.116.94.228,<->,8.252.221.198,0,0,25,1310,25,1310,0.097381000,1.7705
215.158.238.67,<->,8.42.43.57,25,7853,0,0,25,7853,0.096926000,1.8774
215.158.238.238,<->,8.40.50.41,25,6458,0,0,25,6458,0.095622000,1.7356
122.131.173.65,<->,50.224.49.213,0,0,25,1400,25,1400,0.094541000,1.8400
215.158.239.87,<->,142.227.16.45,25,2842,0,0,25,2842,0.094234000,1.0852
97.198.98.50,<->,97.120.121.146,25,1448,0,0,25,1448,0.092852000,1.8624
215.158.239.85,<->,194.251.73.190,25,2259,0,0,25,2259,0.091814000,0.6628
60.101.95.55,<->,8.252.221.197,0,0,25,1290,25,1290,0.089881000,1.8422
136.25.189.33,<->,56.28.207.192,25,9558,0,0,25,9558,0.089863000,1.8125
139.241.56.117,<->,129.1.97.120,0,0,25,33600,25,33600,0.089052000,1.9015
215.158.239.68,<->,196.89.22.204,25,2435,0,0,25,2435,0.088404000,1.4984
220.83.79.113,<->,139.241.56.116,25,33600,0,0,25,33600,0.087180000,1.9035
192.65.116.33,<->,139.241.56.117,25,33600,0,0,25,33600,0.086894000,1.9026
223.120.91.165,<->,8.252.223.0,0,0,25,1708,25,1708,0.086421000,1.9054
136.25.188.210,<->,113.23.20.93,25,6076,0,0,25,6076,0.084654000,1.8060
144.46.53.233,<->,80.42.153.245,0,0,25,33600,25,33600,0.083523000,1.9040
111.150.187.185,<->,8.252.223.153,0,0,25,3858,25,3858,0.083362000,0.6803
246.253.168.231,<->,112.11.94.153,25,1841,0,0,25,1841,0.081705000,0.3440
8.252.221.198,<->,4.123.176.77,25,1472,0,0,25,1472,0.074774000,1.9049
8.252.221.223,<->,4.122.138.93,25,1326,0,0,25,1326,0.071970000,1.7906
110.11.91.149,<->,50.224.82.19,0,0,25,1400,25,1400,0.069897000,1.9114
215.158.238.176,<->,126.219.246.252,25,5487,0,0,25,5487,0.062234000,1.6500
247.136.233.174,<->,139.241.56.102,25,33600,0,0,25,33600,0.057581000,1.9041
139.241.56.102,<->,109.0.193.78,0,0,25,36098,25,36098,0.057253000,1.9041
215.158.239.68,<->,143.94.204.181,25,2876,0,0,25,2876,0.056957000,1.3519
136.25.188.252,<->,131.1.253.251,25,6636,0,0,25,6636,0.056831000,1.8551
132.20.222.234,<->,129.224.112.221,0,0,25,1677,25,1677,0.052440000,1.9059
143.13.230.223,<->,136.25.188.160,0,0,25,2915,25,2915,0.051545000,0.9394
197.113.99.196,<->,136.25.188.236,0,0,25,1400,25,1400,0.047909000,1.9402
112.8.200.82,<->,39.248.89.159,0,0,25,4536,25,4536,0.045289000,0.7749
199.53.132.106,<->,136.25.188.252,0,0,25,2280,25,2280,0.044970000,0.2826
195.70.147.69,<->,136.25.188.174,0,0,25,2163,25,2163,0.044541000,1.7988
243.185.81.59,<->,8.52.179.237,0,0,25,2020,25,2020,0.041460000,1.8692
215.158.61.191,<->,8.176.8.197,0,0,25,23046,25,23046,0.034280000,1.8872
97.126.14.75,<->,53.240.123.131,25,1687,0,0,25,1687,0.032420000,0.4685
136.25.188.197,<->,126.219.194.99,25,7393,0,0,25,7393,0.031066000,1.7464
133.178.226.70,<->,133.56.180.23,25,10715,0,0,25,10715,0.029969000,1.9575
117.131.109.97,<->,92.27.27.165,0,0,25,1797,25,1797,0.029844000,1.9531
199.55.212.93,<->,8.252.222.141,0,0,25,1328,25,1328,0.027155000,1.8686
195.41.238.252,<->,136.25.188.198,0,0,25,4519,25,4519,0.026949000,1.4459
204.63.194.7,<->,136.25.188.255,0,0,25,2209,25,2209,0.025949000,0.7390
146.224.127.191,<->,8.252.221.196,0,0,25,1310,25,1310,0.025043000,1.8857
192.67.123.168,<->,139.241.56.117,25,33600,0,0,25,33600,0.024044000,1.9128
136.25.188.47,<->,8.255.92.247,25,10912,0,0,25,10912,0.023480000,1.9486
202.33.250.52,<->,136.25.188.53,0,0,25,1506,25,1506,0.022784000,1.6090
48.19.210.39,<->,8.252.222.241,0,0,25,1568,25,1568,0.019807000,1.8629
94.192.241.84,<->,8.252.222.20,0,0,25,1636,25,1636,0.019478000,1.9152
159.36.238.148,<->,8.52.187.70,0,0,25,3527,25,3527,0.017832000,1.2080
215.158.239.48,<->,143.91.207.152,25,1770,0,0,25,1770,0.015021000,1.6001
215.158.239.78,<->,145.13.164.170,25,14812,0,0,25,14812,0.014675000,1.9751
215.158.140.241,<->,8.219.185.21,25,5132,0,0,25,5132,0.013017000,1.5230
247.136.133.71,<->,139.241.56.102,25,33600,0,0,25,33600,0.012682000,1.9182
144.85.170.254,<->,92.111.174.86,25,1400,0,0,25,1400,0.011321000,0.4612
136.25.188.227,<->,112.220.206.7,25,8914,0,0,25,8914,0.010940000,1.9451
207.92.141.166,<->,8.252.222.222,0,0,25,1545,25,1545,0.007873000,1.8514
246.108.107.211,<->,100.95.73.41,0,0,25,2900,25,2900,0.007394000,1.9022
199.82.49.149,<->,136.25.188.255,0,0,25,1250,25,1250,0.006988000,0.1412
136.25.188.198,<->,33.209.217.237,25,12367,0,0,25,12367,0.004156000,1.5615
215.158.238.132,<->,106.188.183.107,25,9419,0,0,25,9419,0.003866000,1.9285
215.158.238.196,<->,126.219.60.193,25,2557,0,0,25,2557,0.003201000,0.3949
97.20.0.76,<->,8.252.223.189,0,0,25,1250,25,1250,0.002353000,0.3013
129.225.135.32,<->,129.225.132.90,0,0,24,36096,24,36096,1.994129000,0.0003
221.101.8.215,<->,159.190.66.226,24,1698,0,0,24,1698,1.846554000,0.0892
215.158.238.124,<->,98.219.126.140,24,30313,0,0,24,30313,1.794083000,0.1853
128.158.165.112,<->,0.195.210.42,0,0,24,2777,24,2777,1.763358000,0.2247
215.158.238.92,<->,143.155.226.212,24,2501,0,0,24,2501,1.740424000,0.1978
129.225.134.164,<->,129.225.132.97,0,0,24,19139,24,19139,1.736593000,0.2369
111.151.142.164,<->,8.252.223.111,0,0,24,1344,24,1344,1.587142000,0.1116
136.25.188.163,<->,41.148.106.11,24,1487,0,0,24,1487,1.371107000,0.0499
139.241.115.4,<->,133.178.227.7,0,0,24,35165,24,35165,1.313855000,0.0003
111.150.74.61,<->,99.74.26.98,0,0,24,32856,24,32856,1.309183000,0.2330
215.158.239.48,<->,195.14.223.235,24,2053,0,0,24,2053,1.261942000,0.2584
111.199.229.147,<->,0.195.210.42,0,0,24,2442,24,2442,1.225350000,0.6550
253.66.34.7,<->,8.52.183.207,0,0,24,2186,24,2186,1.169578000,0.2814
215.158.239.84,<->,204.0.143.90,24,1272,0,0,24,1272,1.136087000,0.3299
215.158.239.58,<->,196.104.226.179,24,3704,0,0,24,3704,1.016442000,0.8592
133.178.226.28,<->,114.25.48.78,24,2509,0,0,24,2509,1.002954000,0.5585
136.25.189.53,<->,96.156.169.236,24,29485,0,0,24,29485,0.929716000,0.3989
215.158.239.56,<->,204.56.52.178,24,2640,0,0,24,2640,0.917736000,0.9538
129.225.132.224,<->,129.225.131.132,24,1200,0,0,24,1200,0.915192000,0.0098
215.158.238.83,<->,80.47.111.86,24,7541,0,0,24,7541,0.894496000,0.8777
215.158.140.75,<->,106.188.244.165,24,3390,0,0,24,3390,0.879524000,0.8107
143.52.27.249,<->,136.25.188.222,0,0,24,2942,24,2942,0.867926000,1.1314
207.61.137.58,<->,136.25.188.53,0,0,24,1989,24,1989,0.864879000,0.9717
159.36.243.10,<->,8.52.187.224,0,0,24,2165,24,2165,0.792023000,0.5672
215.158.239.84,<->,207.59.17.227,24,1554,0,0,24,1554,0.788777000,0.9676
215.158.239.93,<->,199.20.5.81,24,3059,0,0,24,3059,0.779930000,0.9797
50.49.172.140,<->,8.220.202.151,0,0,24,2950,24,2950,0.763782000,0.3589
207.193.113.191,<->,8.252.222.174,0,0,24,1735,24,1735,0.701887000,1.2478
194.252.199.80,<->,8.252.222.220,0,0,24,3024,24,3024,0.681256000,1.2826
139.246.60.46,<->,8.52.185.185,0,0,24,9857,24,9857,0.627353000,0.8990
197.113.99.68,<->,136.25.188.255,0,0,24,2101,24,2101,0.618924000,0.6605
133.178.226.18,<->,126.219.194.143,24,4987,0,0,24,4987,0.608412000,1.1150
204.21.153.119,<->,136.25.188.252,0,0,24,2042,24,2042,0.593973000,1.3439
114.83.212.226,<->,108.134.118.112,0,0,24,31766,24,31766,0.561114000,1.4331
145.19.8.119,<->,97.4.40.49,24,18598,0,0,24,18598,0.557465000,1.4353
136.25.189.33,<->,126.219.191.74,24,3796,0,0,24,3796,0.535681000,1.4503
215.158.238.123,<->,129.175.139.42,24,6327,0,0,24,6327,0.527741000,1.3032
136.25.189.62,<->,96.156.169.208,24,24184,0,0,24,24184,0.516656000,0.7337
197.113.99.70,<->,136.25.188.176,0,0,24,2332,24,2332,0.500396000,1.3182
136.25.188.255,<->,126.219.194.183,24,10553,0,0,24,10553,0.487603000,1.5068
92.38.225.68,<->,8.220.205.146,0,0,24,27000,24,27000,0.487321000,1.4500
194.232.232.240,<->,136.25.188.198,0,0,24,1278,24,1278,0.453365000,0.5987
89.155.213.217,<->,8.182.243.141,0,0,24,1968,24,1968,0.431866000,1.5585
136.25.188.210,<->,131.1.232.184,24,6868,0,0,24,6868,0.422444000,1.3148
144.85.170.246,<->,139.148.114.204,24,1696,0,0,24,1696,0.416727000,1.5050
215.158.239.52,<->,138.45.90.247,24,28089,0,0,24,28089,0.406307000,0.6408
207.72.115.190,<->,8.252.222.187,0,0,24,1453,24,1453,0.388916000,1.5705
215.158.238.64,<->,131.36.198.50,24,9206,0,0,24,9206,0.379157000,1.6006
215.158.238.38,<->,192.224.20.69,24,15610,0,0,24,15610,0.376099000,1.5513
215.158.238.106,<->,128.194.247.124,24,1344,0,0,24,1344,0.370074000,1.5032
133.178.227.14,<->,89.86.110.235,24,4427,0,0,24,4427,0.352173000,1.4401
215.158.238.102,<->,0.195.253.228,24,30867,0,0,24,30867,0.336256000,0.9143
197.113.99.156,<->,136.25.188.226,0,0,24,1389,24,1389,0.333386000,0.4995
215.158.238.88,<->,0.195.237.14,24,32206,0,0,24,32206,0.329209000,1.0296
136.25.188.177,<->,29.214.108.180,24,12310,0,0,24,12310,0.318832000,1.5278
220.28.104.193,<->,215.158.238.194,0,0,24,30570,24,30570,0.315746000,1.6731
216.184.2.232,<->,215.158.239.70,0,0,24,4799,24,4799,0.311807000,1.0776
215.158.238.82,<->,136.138.112.209,24,7481,0,0,24,7481,0.302546000,1.6788
215.158.238.221,<->,8.219.184.163,24,3501,0,0,24,3501,0.296657000,0.6410
136.25.189.31,<->,56.28.207.214,24,9194,0,0,24,9194,0.295615000,1.6756
215.158.140.229,<->,104.3.168.150,24,2656,0,0,24,2656,0.285962000,0.9927
215.158.140.95,<->,100.216.78.145,24,32761,0,0,24,32761,0.268466000,0.0002
145.13.164.203,<->,136.25.189.45,0,0,24,12477,24,12477,0.255881000,1.7287
215.158.239.78,<->,199.20.31.143,24,1500,0,0,24,1500,0.254297000,0.7000
136.25.188.230,<->,133.56.180.88,24,25454,0,0,24,25454,0.245395000,1.3028
136.25.188.254,<->,8.222.7.47,24,10067,0,0,24,10067,0.228541000,1.6864
215.158.239.96,<->,207.60.42.217,24,2856,0,0,24,2856,0.224777000,1.7231
142.206.175.56,<->,136.25.188.178,0,0,24,2379,24,2379,0.221064000,1.3911
196.148.133.194,<->,119.223.114.169,24,31973,0,0,24,31973,0.210828000,1.6247
220.39.233.209,<->,215.158.238.67,0,0,24,7317,24,7317,0.210486000,1.7701
142.248.178.25,<->,136.25.188.220,0,0,24,2942,24,2942,0.208323000,1.5042
220.39.233.170,<->,215.158.238.113,0,0,24,5119,24,5119,0.205255000,1.7133
215.158.238.47,<->,131.1.195.234,24,8490,0,0,24,8490,0.204404000,1.7408
215.158.238.134,<->,80.47.228.219,24,6692,0,0,24,6692,0.197556000,1.4718
215.158.238.135,<->,131.1.232.134,24,8730,0,0,24,8730,0.194214000,1.6066
215.158.239.48,<->,199.20.29.10,24,3465,0,0,24,3465,0.190277000,1.6498
133.178.226.21,<->,96.155.60.254,24,21637,0,0,24,21637,0.187636000,1.5022
247.136.255.233,<->,144.81.196.15,24,34397,0,0,24,34397,0.185477000,0.9996
136.25.188.197,<->,29.211.6.54,24,9038,0,0,24,9038,0.183302000,1.7633
220.28.73.211,<->,215.158.238.218,0,0,24,27757,24,27757,0.177725000,1.7261
136.25.188.177,<->,131.1.195.222,24,7980,0,0,24,7980,0.175340000,1.7293
136.25.188.44,<->,106.188.236.197,24,3958,0,0,24,3958,0.171209000,1.7945
133.54.17.233,<->,37.115.66.139,24,1640,0,0,24,1640,0.166042000,1.6486
215.158.239.17,<->,8.191.6.86,24,9551,0,0,24,9551,0.163533000,1.8128
136.25.188.45,<->,112.220.206.105,24,7653,0,0,24,7653,0.163476000,1.7319
136.25.188.163,<->,106.188.236.241,24,7529,0,0,24,7529,0.163391000,1.7558
94.192.251.97,<->,8.252.222.62,0,0,24,1928,24,1928,0.163355000,1.7140
133.178.227.79,<->,111.150.187.176,24,6455,0,0,24,6455,0.159027000,1.5200
133.178.226.41,<->,96.155.60.205,24,18285,0,0,24,18285,0.158764000,1.7054
223.115.10.147,<->,8.252.222.208,0,0,24,1596,24,1596,0.156591000,1.7655
139.241.56.102,<->,80.40.51.166,0,0,24,33188,24,33188,0.155771000,1.7702
107.127.101.53,<->,50.224.49.195,0,0,24,1344,24,1344,0.153890000,1.8284
215.158.239.49,<->,195.70.28.47,24,1636,0,0,24,1636,0.152866000,1.1884
215.158.239.92,<->,199.20.4.228,24,2187,0,0,24,2187,0.150352000,1.4191
215.158.140.87,<->,105.23.235.84,24,2212,0,0,24,2212,0.149074000,0.8094
133.178.226.55,<->,96.155.60.254,24,20011,0,0,24,20011,0.147957000,0.9942
17.143.241.23,<->,8.220.188.138,0,0,24,2254,24,2254,0.139426000,1.6322
136.25.188.176,<->,29.214.64.198,24,5151,0,0,24,5151,0.136888000,1.8084
133.178.227.76,<->,113.23.14.134,24,6525,0,0,24,6525,0.136669000,1.6618
136.25.189.1,<->,126.219.194.7,24,9303,0,0,24,9303,0.136295000,1.7143
220.39.233.164,<->,215.158.238.81,0,0,24,8814,24,8814,0.135616000,1.6714
204.95.230.191,<->,50.223.3.228,0,0,24,1200,24,1200,0.132501000,1.6993
215.158.239.67,<->,136.114.101.65,24,28243,0,0,24,28243,0.132091000,0.7942
136.25.189.21,<->,96.156.169.248,24,23368,0,0,24,23368,0.130438000,1.5187
136.25.188.197,<->,29.214.108.191,24,8539,0,0,24,8539,0.124557000,1.8730
215.158.239.9,<->,215.158.127.153,24,17935,0,0,24,17935,0.123570000,1.7033
133.178.226.38,<->,29.214.64.76,24,7285,0,0,24,7285,0.119641000,1.5376
215.158.238.132,<->,8.223.224.53,24,1344,0,0,24,1344,0.117830000,0.0066
194.233.0.17,<->,136.25.188.241,0,0,24,3614,24,3614,0.115610000,1.2798
133.178.226.94,<->,96.155.60.252,24,23870,0,0,24,23870,0.113366000,1.8748
215.158.239.84,<->,199.20.6.154,24,1344,0,0,24,1344,0.113165000,0.2684
136.25.188.246,<->,100.224.202.157,24,8619,0,0,24,8619,0.112366000,1.8052
215.158.238.104,<->,113.23.20.233,24,7573,0,0,24,7573,0.110029000,1.7002
133.178.227.2,<->,133.56.180.11,24,7543,0,0,24,7543,0.103293000,1.3964
94.192.140.132,<->,8.252.221.222,0,0,24,1476,24,1476,0.101139000,1.8681
215.158.140.60,<->,215.158.6.203,24,4480,0,0,24,4480,0.101061000,1.5762
136.25.188.172,<->,8.255.92.214,24,9134,0,0,24,9134,0.099520000,1.7665
125.222.182.215,<->,108.134.115.67,0,0,24,1344,24,1344,0.098087000,1.8299
142.244.102.214,<->,136.25.188.242,0,0,24,3748,24,3748,0.097945000,1.3816
197.107.23.231,<->,8.52.168.247,0,0,24,1224,24,1224,0.097230000,1.8873
95.246.46.111,<->,8.252.221.223,0,0,24,1260,24,1260,0.094632000,1.8429
133.178.226.77,<->,33.209.217.238,24,8129,0,0,24,8129,0.094360000,1.7768
139.241.56.117,<->,99.75.199.162,0,0,24,33544,24,33544,0.092178000,1.9006
192.64.237.86,<->,139.241.56.102,24,32144,0,0,24,32144,0.091095000,1.8289
220.83.110.127,<->,139.241.56.102,24,33544,0,0,24,33544,0.088189000,1.9038
239.227.98.245,<->,139.241.56.102,24,34654,0,0,24,34654,0.087406000,1.9040
133.178.227.1,<->,133.56.180.49,24,10044,0,0,24,10044,0.081269000,1.5498
192.205.36.140,<->,136.25.188.234,0,0,24,26518,24,26518,0.080027000,1.8300
215.158.239.76,<->,195.83.163.240,24,2954,0,0,24,2954,0.079760000,1.5391
215.158.238.64,<->,104.3.168.217,24,7621,0,0,24,7621,0.077805000,1.7374
136.25.188.44,<->,8.42.43.51,24,5119,0,0,24,5119,0.076052000,1.3797
199.82.190.198,<->,136.25.188.225,0,0,24,1744,24,1744,0.072637000,1.8286
204.89.48.31,<->,50.223.3.228,0,0,24,1242,24,1242,0.071256000,1.7728
133.178.226.37,<->,29.214.108.190,24,8670,0,0,24,8670,0.070436000,1.5386
108.130.85.45,<->,100.228.42.187,0,0,24,29201,24,29201,0.066688000,0.4744
133.178.226.61,<->,8.222.7.46,24,11304,0,0,24,11304,0.064737000,1.7352
215.158.127.107,<->,8.252.223.153,0,0,24,5012,24,5012,0.063351000,0.9471
204.184.148.88,<->,136.25.188.196,0,0,24,3101,24,3101,0.061336000,1.8196
95.246.228.141,<->,8.252.221.221,0,0,24,1260,24,1260,0.060299000,1.8021
94.194.43.230,<->,8.252.221.196,0,0,24,1975,24,1975,0.059237000,1.8030
202.8.158.61,<->,139.163.7.204,0,0,24,2200,24,2200,0.051846000,1.9001
95.247.29.69,<->,8.252.222.238,0,0,24,1616,24,1616,0.051512000,1.6340
136.25.188.222,<->,8.42.43.27,24,8798,0,0,24,8798,0.049739000,1.7512
133.178.226.57,<->,100.120.38.6,24,28953,0,0,24,28953,0.048202000,0.8118
197.113.64.177,<->,136.25.188.227,0,0,24,1344,24,1344,0.047051000,0.5694
136.25.188.220,<->,131.36.198.35,24,9505,0,0,24,9505,0.046374000,1.8670
143.134.172.207,<->,136.25.188.253,0,0,24,2639,24,2639,0.045973000,1.9238
213.186.61.112,<->,139.163.68.51,0,0,24,1344,24,1344,0.044446000,1.9121
223.115.216.95,<->,8.252.221.198,0,0,24,1528,24,1528,0.044019000,1.9159
114.215.225.176,<->,89.183.104.227,0,0,24,32158,24,32158,0.041602000,1.9190
199.38.61.76,<->,136.25.188.176,0,0,24,2130,24,2130,0.040369000,1.8510
245.161.124.44,<->,8.252.222.157,0,0,24,2053,24,2053,0.038684000,0.6007
215.158.238.73,<->,126.219.194.105,24,8574,0,0,24,8574,0.037425000,1.8764
215.158.239.78,<->,199.20.29.21,24,3802,0,0,24,3802,0.034918000,1.0491
133.178.227.19,<->,126.219.246.222,24,2417,0,0,24,2417,0.033995000,0.5232
133.178.227.76,<->,133.56.180.48,24,13837,0,0,24,13837,0.033988000,1.9507
215.158.238.148,<->,122.159.245.169,24,8794,0,0,24,8794,0.032707000,1.8029
94.195.69.166,<->,8.252.223.59,0,0,24,1452,24,1452,0.032556000,1.7747
215.158.239.79,<->,199.20.30.163,24,3129,0,0,24,3129,0.029698000,0.6989
215.158.140.231,<->,8.40.51.206,24,9420,0,0,24,9420,0.029196000,1.9234
215.158.239.79,<->,195.83.118.249,24,2215,0,0,24,2215,0.028450000,1.6600
215.158.239.96,<->,195.5.233.178,24,2920,0,0,24,2920,0.028253000,0.9747
133.178.227.57,<->,8.191.7.76,24,4426,0,0,24,4426,0.026612000,1.7686
215.158.239.87,<->,196.88.134.222,24,2178,0,0,24,2178,0.024748000,1.1222
100.160.171.19,<->,50.224.88.106,0,0,24,1344,24,1344,0.024298000,1.9315
133.178.226.49,<->,126.219.194.181,24,7438,0,0,24,7438,0.023867000,1.3578
215.158.238.123,<->,131.36.198.56,24,6640,0,0,24,6640,0.022175000,1.7219
133.178.226.28,<->,29.214.108.105,24,9269,0,0,24,9269,0.021919000,1.9259
17.41.75.11,<->,8.220.191.154,0,0,24,2451,24,2451,0.021286000,1.9635
103.155.157.132,<->,50.224.61.152,0,0,24,1344,24,1344,0.018616000,1.8982
215.158.6.195,<->,133.178.227.70,0,0,24,5446,24,5446,0.017720000,1.6910
215.158.238.99,<->,119.196.23.2,24,8734,0,0,24,8734,0.017200000,1.8898
136.25.188.162,<->,50.57.174.13,24,2367,0,0,24,2367,0.015912000,1.6607
204.62.218.163,<->,136.25.188.236,0,0,24,3614,24,3614,0.015402000,1.1882
215.158.239.92,<->,195.55.1.174,24,1514,0,0,24,1514,0.014698000,1.6291
207.236.207.74,<->,136.25.188.175,0,0,24,2427,24,2427,0.014392000,0.6245
215.158.239.59,<->,80.56.79.21,24,13518,0,0,24,13518,0.011484000,1.9110
215.158.239.87,<->,199.50.69.129,24,1604,0,0,24,1604,0.010339000,1.7024
215.158.239.50,<->,199.20.31.81,24,3012,0,0,24,3012,0.008792000,1.6401
94.194.108.187,<->,8.252.221.205,0,0,24,1300,24,1300,0.008205000,1.8567
215.158.239.87,<->,96.135.155.13,24,15207,0,0,24,15207,0.007959000,1.9631
159.47.123.42,<->,139.163.66.167,0,0,24,1742,24,1742,0.007695000,1.8024
196.29.8.207,<->,50.223.3.228,0,0,24,1212,24,1212,0.007652000,1.9663
136.25.189.63,<->,96.156.169.238,24,24792,0,0,24,24792,0.007188000,0.5776
136.25.188.226,<->,69.150.168.246,24,6212,0,0,24,6212,0.005391000,1.8638
215.158.238.82,<->,80.47.111.73,24,8366,0,0,24,8366,0.004524000,1.9830
215.158.239.92,<->,196.94.66.138,24,1743,0,0,24,1743,0.003043000,0.6899
204.2.1.227,<->,136.25.188.199,0,0,24,1296,24,1296,0.002904000,1.6438
136.25.188.243,<->,80.47.228.213,24,7593,0,0,24,7593,0.002734000,1.8697
143.89.180.162,<->,136.25.188.238,0,0,24,1434,24,1434,0.002416000,1.3354
133.178.227.4,<->,133.56.180.53,24,27802,0,0,24,27802,0.001185000,1.8721
75.214.57.73,<->,8.252.221.236,0,0,24,1266,24,1266,0.000516000,1.9645
192.65.74.251,<->,8.45.144.116,24,34357,0,0,24,34357,0.000436000,1.7938
215.158.238.113,<->,112.235.95.26,24,5972,0,0,24,5972,0.000255000,1.9867
215.158.239.93,<->,196.89.60.33,23,2171,0,0,23,2171,1.721746000,0.2582
136.25.188.164,<->,111.150.207.132,23,1288,0,0,23,1288,1.600282000,0.1294
48.129.132.210,<->,8.252.222.236,0,0,23,2669,23,2669,1.557893000,0.1945
136.25.189.92,<->,98.219.126.140,23,28998,0,0,23,28998,1.532360000,0.2418
244.1.41.59,<->,136.25.188.178,0,0,23,2828,23,2828,1.512113000,0.3759
133.178.227.2,<->,8.40.51.113,23,2605,0,0,23,2605,1.416891000,0.1058
215.158.238.135,<->,128.123.91.104,23,2433,0,0,23,2433,1.397055000,0.2958
100.124.212.246,<->,80.41.38.205,0,0,23,28987,23,28987,1.393606000,0.1272
215.158.238.87,<->,98.219.126.175,23,30070,0,0,23,30070,1.372087000,0.5921
215.158.239.76,<->,195.70.107.117,23,1982,0,0,23,1982,1.347782000,0.4439
215.158.239.77,<->,194.237.192.218,23,2328,0,0,23,2328,1.341116000,0.6569
215.158.140.76,<->,158.166.173.32,23,2308,0,0,23,2308,1.317758000,0.1155
132.249.141.207,<->,8.52.182.30,0,0,23,1903,23,1903,1.306662000,0.5929
195.15.226.84,<->,136.25.188.252,0,0,23,2339,23,2339,1.253678000,0.7434
111.20.172.119,<->,111.20.168.154,0,0,23,33144,23,33144,1.252010000,0.0001
99.187.125.122,<->,8.20.87.33,0,0,23,25007,23,25007,1.202508000,0.1346
207.61.130.166,<->,136.25.188.237,0,0,23,2784,23,2784,1.192794000,0.8057
220.28.73.211,<->,215.158.238.137,0,0,23,27221,23,27221,1.187382000,0.7058
136.25.188.254,<->,112.220.206.106,23,6204,0,0,23,6204,1.172865000,0.7781
139.111.66.186,<->,136.25.188.163,0,0,23,1987,23,1987,1.161864000,0.1974
216.184.2.48,<->,97.126.31.75,0,0,23,33442,23,33442,1.078584000,0.0005
140.71.207.94,<->,8.252.221.231,0,0,23,2316,23,2316,1.063220000,0.8632
215.158.239.22,<->,96.135.154.156,23,26620,0,0,23,26620,0.994854000,0.5928
199.32.137.31,<->,136.25.188.242,0,0,23,1997,23,1997,0.985512000,0.2917
215.158.140.84,<->,98.219.126.140,23,30646,0,0,23,30646,0.967998000,0.8477
133.178.226.38,<->,8.220.51.232,23,3682,0,0,23,3682,0.965971000,0.6459
95.246.65.143,<->,8.252.221.221,0,0,23,3402,23,3402,0.949734000,0.9800
142.255.20.192,<->,136.25.188.44,0,0,23,2355,23,2355,0.941207000,0.9575
136.25.188.49,<->,0.195.253.228,23,33307,0,0,23,33307,0.926528000,0.1359
58.242.187.145,<->,8.252.221.199,0,0,23,2393,23,2393,0.926525000,1.0136
143.74.137.76,<->,8.252.222.161,0,0,23,1997,23,1997,0.903511000,0.9406
215.158.239.56,<->,142.208.5.166,23,3033,0,0,23,3033,0.900823000,0.7578
215.158.238.107,<->,122.216.233.213,23,3666,0,0,23,3666,0.876581000,1.0212
215.158.234.105,<->,137.137.116.117,0,0,23,1939,23,1939,0.864619000,0.0808
199.15.175.78,<->,136.25.188.226,0,0,23,2240,23,2240,0.862403000,0.6649
133.178.227.16,<->,61.35.70.37,23,3694,0,0,23,3694,0.808705000,1.0088
215.158.238.251,<->,113.20.94.202,23,2273,0,0,23,2273,0.763207000,0.2061
215.158.238.99,<->,192.227.190.234,23,4402,0,0,23,4402,0.763144000,0.8082
142.228.55.242,<->,136.25.188.241,0,0,23,3684,23,3684,0.734102000,1.0506
220.28.73.211,<->,136.25.189.53,0,0,23,22110,23,22110,0.731009000,1.0657
136.25.189.15,<->,29.211.228.166,23,6860,0,0,23,6860,0.704458000,1.2583
220.28.109.52,<->,136.25.188.228,0,0,23,27819,23,27819,0.701925000,0.9368
133.178.227.62,<->,133.56.180.53,23,30978,0,0,23,30978,0.700217000,0.0055
215.158.239.99,<->,194.199.223.77,23,2348,0,0,23,2348,0.697573000,0.8052
215.158.239.63,<->,80.57.141.216,23,28606,0,0,23,28606,0.686837000,0.0757
101.224.182.5,<->,6.73.247.62,0,0,23,29703,23,29703,0.679285000,0.0740
195.55.44.158,<->,136.25.188.225,0,0,23,5138,23,5138,0.656726000,0.8300
133.178.226.77,<->,69.132.194.104,23,5219,0,0,23,5219,0.652530000,1.2657
136.25.188.175,<->,29.214.64.189,23,5079,0,0,23,5079,0.638291000,1.1755
240.207.22.74,<->,0.195.210.44,0,0,23,3253,23,3253,0.604052000,0.8661
215.158.238.83,<->,131.1.232.136,23,9185,0,0,23,9185,0.591225000,1.3553
192.205.36.152,<->,136.25.188.235,0,0,23,32231,23,32231,0.586462000,1.1193
95.244.92.36,<->,8.252.221.206,0,0,23,2733,23,2733,0.573793000,1.2772
215.158.238.32,<->,57.227.81.35,23,2365,0,0,23,2365,0.569836000,0.1297
133.178.227.27,<->,133.56.180.5,23,11215,0,0,23,11215,0.558212000,1.3486
231.143.242.82,<->,136.25.188.220,0,0,23,1420,23,1420,0.530001000,1.1747
215.158.238.124,<->,145.116.209.82,23,29739,0,0,23,29739,0.529442000,0.3742
158.192.3.223,<->,133.178.226.31,0,0,23,5095,23,5095,0.518851000,1.4406
215.158.239.92,<->,142.228.101.183,23,2791,0,0,23,2791,0.498979000,1.2251
215.158.238.66,<->,106.188.183.208,23,8900,0,0,23,8900,0.492753000,1.3489
143.76.107.239,<->,136.25.188.238,0,0,23,2489,23,2489,0.485575000,1.1802
142.208.190.55,<->,136.25.188.175,0,0,23,1786,23,1786,0.481817000,1.2893
215.158.239.86,<->,8.179.43.72,23,2589,0,0,23,2589,0.481698000,0.3980
199.33.110.34,<->,136.25.188.252,0,0,23,1997,23,1997,0.476660000,0.5257
136.25.189.77,<->,96.156.169.212,23,13093,0,0,23,13093,0.469168000,1.4982
215.158.238.223,<->,131.144.114.248,23,3938,0,0,23,3938,0.448850000,0.8623
215.158.239.87,<->,199.82.249.236,23,1981,0,0,23,1981,0.435539000,0.5931
247.136.177.71,<->,124.8.194.202,23,1282,0,0,23,1282,0.430728000,1.5315
215.158.239.71,<->,204.21.8.14,23,1967,0,0,23,1967,0.427325000,1.3780
215.158.239.50,<->,207.190.144.126,23,2867,0,0,23,2867,0.422822000,1.5497
215.158.239.40,<->,215.158.127.181,23,13195,0,0,23,13195,0.390637000,1.4085
133.178.226.30,<->,76.100.141.20,23,2565,0,0,23,2565,0.386410000,1.1477
215.158.238.79,<->,100.216.78.145,23,26480,0,0,23,26480,0.353918000,1.5121
139.47.193.207,<->,33.233.141.73,0,0,23,28536,23,28536,0.346119000,0.3663
95.245.97.163,<->,8.252.221.199,0,0,23,1735,23,1735,0.339730000,0.9364
142.229.0.171,<->,136.25.188.236,0,0,23,2259,23,2259,0.335463000,0.7256
195.55.188.47,<->,136.25.188.53,0,0,23,3643,23,3643,0.329215000,1.5368
215.158.238.107,<->,57.236.82.245,23,1324,0,0,23,1324,0.308414000,0.1408
220.28.114.28,<->,215.158.239.61,0,0,23,27195,23,27195,0.308298000,1.3757
142.220.96.49,<->,136.25.188.198,0,0,23,2852,23,2852,0.303916000,1.6311
133.178.226.90,<->,80.47.228.215,23,5215,0,0,23,5215,0.279656000,1.1927
136.25.188.55,<->,94.27.184.101,23,1544,0,0,23,1544,0.275280000,1.6063
216.184.2.182,<->,136.25.189.15,0,0,23,12657,23,12657,0.263009000,1.4528
199.15.254.108,<->,136.25.188.224,0,0,23,3113,23,3113,0.262246000,1.1217
220.28.104.193,<->,215.158.239.72,0,0,23,27242,23,27242,0.261049000,1.7142
215.158.238.83,<->,33.209.217.245,23,6827,0,0,23,6827,0.258186000,1.5929
215.158.239.51,<->,199.106.133.246,23,2319,0,0,23,2319,0.250514000,1.7201
133.178.226.61,<->,57.160.181.228,23,7441,0,0,23,7441,0.247666000,1.4881
215.158.238.102,<->,145.116.209.76,23,26520,0,0,23,26520,0.244805000,1.4531
215.158.239.79,<->,199.20.31.161,23,1288,0,0,23,1288,0.244508000,1.6917
215.158.239.59,<->,126.219.194.5,23,12181,0,0,23,12181,0.242518000,1.5329
133.178.227.24,<->,133.56.180.30,23,6182,0,0,23,6182,0.242162000,1.6396
215.158.238.33,<->,116.106.60.170,23,6044,0,0,23,6044,0.241994000,1.6323
215.158.61.182,<->,8.176.8.224,0,0,23,17932,23,17932,0.228201000,1.6935
136.25.188.237,<->,106.188.236.165,23,6252,0,0,23,6252,0.224739000,1.5870
109.1.59.202,<->,8.179.142.105,23,27853,0,0,23,27853,0.223437000,0.2793
195.85.132.79,<->,50.224.49.196,0,0,23,1348,23,1348,0.220492000,1.7121
215.158.239.97,<->,199.20.29.174,23,3032,0,0,23,3032,0.215759000,1.0789
215.158.239.85,<->,199.20.28.227,23,2223,0,0,23,2223,0.208605000,1.5499
215.158.239.58,<->,199.20.29.184,23,5811,0,0,23,5811,0.205144000,1.3293
133.178.227.119,<->,8.176.12.111,23,8512,0,0,23,8512,0.198782000,1.3083
133.178.227.23,<->,133.56.180.25,23,18351,0,0,23,18351,0.197729000,1.6636
136.25.189.77,<->,133.56.180.55,23,9607,0,0,23,9607,0.197539000,1.3815
195.4.57.69,<->,136.25.188.253,0,0,23,1288,23,1288,0.174609000,0.3447
215.158.239.95,<->,199.72.85.33,23,1288,0,0,23,1288,0.172453000,0.2998
136.25.189.14,<->,8.222.58.195,23,7505,0,0,23,7505,0.168951000,1.0496
199.51.211.251,<->,136.25.188.252,0,0,23,3431,23,3431,0.167282000,1.7125
247.136.209.128,<->,27.40.0.127,23,1464,0,0,23,1464,0.164816000,1.6739
133.178.227.91,<->,100.182.236.221,23,1150,0,0,23,1150,0.162970000,1.8305
215.158.239.93,<->,142.248.56.234,23,2794,0,0,23,2794,0.158646000,0.8461
215.158.239.66,<->,100.224.166.161,23,30221,0,0,23,30221,0.154047000,1.6265
215.158.238.243,<->,61.35.70.33,23,3326,0,0,23,3326,0.150121000,1.4380
131.78.5.109,<->,89.183.104.143,0,0,23,29631,23,29631,0.144211000,1.0578
215.158.238.67,<->,142.234.196.228,23,8662,0,0,23,8662,0.142574000,1.7439
136.25.188.174,<->,131.1.232.163,23,5495,0,0,23,5495,0.138772000,1.5388
215.158.238.73,<->,131.1.232.163,23,6396,0,0,23,6396,0.138191000,1.7174
136.138.112.200,<->,136.25.188.224,0,0,23,7281,23,7281,0.137770000,1.5339
207.193.113.211,<->,8.252.222.177,0,0,23,1217,23,1217,0.136143000,1.7694
207.62.98.53,<->,136.25.188.227,0,0,23,4183,23,4183,0.132092000,1.3428
75.214.9.73,<->,8.252.221.204,0,0,23,1198,23,1198,0.131523000,1.3677
143.54.151.242,<->,50.223.3.228,0,0,23,1288,23,1288,0.131386000,1.7119
199.52.198.133,<->,136.25.188.178,0,0,23,1869,23,1869,0.130437000,0.4770
231.143.109.135,<->,136.25.188.255,0,0,23,2035,23,2035,0.126404000,0.7903
133.178.227.76,<->,133.56.180.59,23,11115,0,0,23,11115,0.124484000,1.8592
133.178.227.27,<->,8.50.170.213,23,5426,0,0,23,5426,0.119353000,1.3221
156.142.126.79,<->,8.252.222.127,0,0,23,1440,23,1440,0.118966000,1.6975
201.209.65.171,<->,92.27.27.182,0,0,23,1528,23,1528,0.117777000,1.6130
141.86.31.72,<->,0.195.210.42,0,0,23,3038,23,3038,0.116527000,1.8389
215.158.238.148,<->,192.227.190.245,23,4146,0,0,23,4146,0.115942000,1.2905
97.126.115.85,<->,97.46.125.17,23,25698,0,0,23,25698,0.112438000,1.7287
144.85.170.244,<->,98.87.147.163,23,1440,0,0,23,1440,0.112338000,1.8734
237.147.180.23,<->,50.224.88.92,0,0,23,1300,23,1300,0.110508000,1.8803
95.247.29.69,<->,8.252.222.197,0,0,23,1600,23,1600,0.106487000,1.5570
95.246.192.146,<->,8.252.221.198,0,0,23,1230,23,1230,0.105638000,1.8863
136.25.188.220,<->,100.224.202.148,23,9358,0,0,23,9358,0.101742000,1.4528
92.27.219.36,<->,0.244.115.75,23,32982,0,0,23,32982,0.101382000,1.8957
133.178.227.27,<->,104.3.168.136,23,2589,0,0,23,2589,0.096611000,0.6007
136.25.189.59,<->,96.156.169.162,23,11271,0,0,23,11271,0.096485000,1.8451
139.241.56.117,<->,102.51.223.0,0,0,23,33486,23,33486,0.095165000,1.9006
111.151.139.139,<->,8.176.8.93,0,0,23,10836,23,10836,0.094901000,1.8853
215.158.239.84,<->,199.50.72.119,23,2176,0,0,23,2176,0.093451000,0.9974
139.241.56.117,<->,99.73.229.194,0,0,23,33486,23,33486,0.093426000,1.9006
139.241.56.117,<->,99.72.199.26,0,0,23,33210,23,33210,0.092454000,1.9006
66.47.201.111,<->,8.252.221.237,0,0,23,1210,23,1210,0.088446000,1.8784
139.241.56.117,<->,98.128.18.123,0,0,23,33210,23,33210,0.088416000,1.9018
139.241.56.116,<->,100.95.51.182,0,0,23,33210,23,33210,0.088409000,1.9020
139.241.56.105,<->,6.228.57.59,0,0,23,33210,23,33210,0.088348000,1.9038
215.158.238.221,<->,8.40.51.86,23,2477,0,0,23,2477,0.088273000,0.4140
247.136.245.95,<->,139.241.56.117,23,33210,0,0,23,33210,0.088249000,1.9019
95.247.18.232,<->,8.252.222.29,0,0,23,2915,23,2915,0.088165000,0.8385
139.163.27.110,<->,101.55.119.53,23,1150,0,0,23,1150,0.084324000,1.9022
144.253.55.144,<->,80.40.14.25,0,0,23,33486,23,33486,0.083647000,1.9040
133.178.227.27,<->,133.56.180.34,23,16248,0,0,23,16248,0.081395000,1.8612
48.131.158.213,<->,8.252.222.211,0,0,23,3906,23,3906,0.078765000,1.8672
139.163.17.163,<->,117.206.57.12,23,1150,0,0,23,1150,0.076392000,1.9162
195.55.66.28,<->,136.25.188.173,0,0,23,1288,23,1288,0.074883000,0.2639
76.179.64.128,<->,8.252.221.204,0,0,23,1631,23,1631,0.074816000,1.7909
133.178.226.18,<->,126.219.247.87,23,6168,0,0,23,6168,0.074472000,1.7026
215.158.238.135,<->,106.188.183.68,23,4432,0,0,23,4432,0.073792000,1.8706
94.193.145.172,<->,8.252.221.198,0,0,23,1432,23,1432,0.058364000,1.8387
139.241.56.117,<->,99.73.108.156,0,0,23,33486,23,33486,0.058141000,1.9040
206.111.193.105,<->,50.224.105.45,0,0,23,1150,23,1150,0.056271000,1.9243
125.9.106.97,<->,109.1.17.245,0,0,23,1334,23,1334,0.056086000,1.8929
98.87.124.13,<->,50.224.82.19,0,0,23,1288,23,1288,0.049389000,1.9100
215.158.140.60,<->,8.57.163.183,23,3728,0,0,23,3728,0.048063000,1.8470
8.252.221.222,<->,4.122.165.215,23,1216,0,0,23,1216,0.047538000,1.9141
215.158.239.92,<->,199.14.87.131,23,1288,0,0,23,1288,0.047402000,0.2488
136.25.189.85,<->,98.219.126.175,23,22725,0,0,23,22725,0.047281000,1.5010
136.25.189.59,<->,80.56.79.41,23,9787,0,0,23,9787,0.045823000,1.8310
247.136.207.38,<->,144.46.53.239,23,33210,0,0,23,33210,0.045256000,1.9062
136.25.188.220,<->,111.151.239.73,23,8582,0,0,23,8582,0.043310000,1.9168
144.53.252.128,<->,50.224.49.195,0,0,23,1324,23,1324,0.043243000,1.8262
246.254.97.105,<->,145.250.89.228,23,9365,0,0,23,9365,0.039871000,1.0956
136.25.188.220,<->,29.214.108.81,23,7979,0,0,23,7979,0.039783000,1.8070
60.101.117.220,<->,8.252.221.206,0,0,23,1204,23,1204,0.036091000,1.9614
139.163.161.48,<->,136.25.188.249,0,0,23,29751,23,29751,0.032607000,0.0638
139.163.96.127,<->,112.192.51.20,23,1216,0,0,23,1216,0.030745000,1.9498
136.25.189.15,<->,29.212.198.189,23,12469,0,0,23,12469,0.030590000,1.8555
192.204.123.22,<->,136.25.189.12,0,0,23,9979,23,9979,0.027767000,1.8511
142.236.213.9,<->,136.25.188.252,0,0,23,2261,23,2261,0.026514000,0.8484
199.81.36.108,<->,133.32.39.39,0,0,23,1288,23,1288,0.023400000,1.8386
136.25.188.105,<->,135.88.171.34,23,5276,0,0,23,5276,0.017994000,1.9527
136.25.189.1,<->,96.156.169.233,23,6731,0,0,23,6731,0.017151000,1.9418
133.178.227.86,<->,17.23.199.45,23,1168,0,0,23,1168,0.016912000,1.9589
95.245.111.27,<->,8.252.222.204,0,0,23,1412,23,1412,0.016337000,1.6363
215.158.239.76,<->,199.20.30.133,23,4279,0,0,23,4279,0.016011000,1.1303
92.27.219.221,<->,29.158.128.133,23,32030,0,0,23,32030,0.015401000,1.6512
215.158.239.78,<->,8.255.92.169,23,7873,0,0,23,7873,0.011887000,1.9814
136.25.188.254,<->,104.3.163.5,23,4839,0,0,23,4839,0.010969000,1.9066
144.85.170.246,<->,98.87.145.249,23,1492,0,0,23,1492,0.010586000,1.9890
145.13.164.200,<->,136.25.189.29,0,0,23,10551,23,10551,0.009635000,1.9376
142.208.244.203,<->,136.25.188.252,0,0,23,1162,23,1162,0.009011000,0.9903
197.113.99.69,<->,136.25.188.55,0,0,23,2807,23,2807,0.008596000,1.5303
56.115.197.173,<->,50.224.91.83,0,0,23,1150,23,1150,0.008380000,1.9412
142.175.192.130,<->,50.223.3.228,0,0,23,1186,23,1186,0.008070000,1.9424
215.158.239.99,<->,195.42.202.249,23,2182,0,0,23,2182,0.007803000,1.6197
144.85.170.246,<->,6.242.47.97,23,1288,0,0,23,1288,0.005833000,1.7140
215.158.140.60,<->,128.194.247.55,23,4462,0,0,23,4462,0.005215000,1.7432
136.25.189.78,<->,80.56.79.105,23,13734,0,0,23,13734,0.004199000,1.7185
139.163.17.135,<->,102.227.77.109,23,20640,0,0,23,20640,0.004129000,1.9521
133.178.226.28,<->,96.155.60.195,23,14326,0,0,23,14326,0.003154000,1.6239
215.158.239.95,<->,195.55.221.148,23,1300,0,0,23,1300,0.003112000,0.3062
204.95.87.205,<->,50.223.3.228,0,0,23,1208,23,1208,0.002966000,1.8383
149.250.115.21,<->,133.178.226.37,0,0,23,6172,23,6172,0.002421000,1.9241
139.163.96.101,<->,105.110.16.247,23,2624,0,0,23,2624,0.000272000,1.9177
215.158.238.221,<->,6.5.128.203,23,1150,0,0,23,1150,0.000090000,0.4882
192.64.219.151,<->,48.106.195.65,23,1208,0,0,23,1208,0.000079000,1.9818
247.136.150.232,<->,14.27.104.50,22,26186,0,0,22,26186,1.911845000,0.0857
192.67.186.145,<->,139.19.249.130,22,27428,0,0,22,27428,1.868598000,0.0781
17.192.237.19,<->,8.220.234.159,0,0,22,1581,22,1581,1.619568000,0.0814
133.178.227.2,<->,8.191.14.84,22,2542,0,0,22,2542,1.611394000,0.0363
249.101.238.119,<->,111.20.62.72,22,27432,0,0,22,27432,1.586277000,0.1334
98.129.34.250,<->,8.55.224.156,22,24091,0,0,22,24091,1.479282000,0.4708
248.239.184.227,<->,221.102.56.46,22,20053,0,0,22,20053,1.355933000,0.2663
218.111.161.49,<->,8.220.176.253,0,0,22,2540,22,2540,1.341798000,0.4909
215.158.140.232,<->,98.219.126.140,22,27795,0,0,22,27795,1.328203000,0.6337
247.127.93.99,<->,221.102.105.151,0,0,22,3148,22,3148,1.238183000,0.7257
137.231.11.95,<->,136.25.188.255,0,0,22,2489,22,2489,1.234534000,0.1910
195.12.232.91,<->,136.25.188.225,0,0,22,1366,22,1366,1.211821000,0.5044
195.126.153.13,<->,136.25.188.52,0,0,22,2120,22,2120,1.168363000,0.8199
215.158.238.223,<->,140.174.84.228,22,2501,0,0,22,2501,1.165483000,0.3306
215.158.32.179,<->,6.73.247.101,0,0,22,27351,22,27351,1.158873000,0.2951
215.158.238.198,<->,192.224.20.234,22,2260,0,0,22,2260,1.146336000,0.2373
215.158.140.75,<->,29.211.6.151,22,3299,0,0,22,3299,1.102163000,0.2879
8.252.223.153,<->,8.219.185.43,22,4673,0,0,22,4673,1.068204000,0.8468
195.15.205.230,<->,136.25.188.46,0,0,22,3532,22,3532,1.066669000,0.8399
136.25.188.195,<->,98.219.126.175,22,26739,0,0,22,26739,1.037833000,0.3678
212.249.34.46,<->,109.222.233.44,0,0,22,18345,22,18345,1.037430000,0.8833
143.128.61.200,<->,136.25.188.236,0,0,22,2772,22,2772,1.037348000,0.9263
142.191.48.191,<->,136.25.188.220,0,0,22,2157,22,2157,1.012088000,0.9371
215.158.238.106,<->,192.204.151.111,22,3722,0,0,22,3722,0.994458000,0.8808
133.178.226.112,<->,91.57.162.46,22,5475,0,0,22,5475,0.974681000,0.4899
215.158.239.51,<->,194.237.112.226,22,2457,0,0,22,2457,0.963690000,0.8276
220.28.73.211,<->,136.25.189.93,0,0,22,21549,22,21549,0.940683000,0.7393
215.158.239.87,<->,143.129.189.188,22,2741,0,0,22,2741,0.916722000,1.0565
76.179.26.127,<->,8.252.221.221,0,0,22,1923,22,1923,0.911699000,0.3469
215.158.239.77,<->,196.92.3.148,22,2714,0,0,22,2714,0.870985000,0.7395
215.158.238.112,<->,106.188.252.233,22,2549,0,0,22,2549,0.868610000,0.1122
142.240.62.162,<->,136.25.188.252,0,0,22,2748,22,2748,0.859758000,1.0973
133.178.227.1,<->,8.191.14.88,22,2287,0,0,22,2287,0.855090000,0.0565
215.158.238.198,<->,8.57.163.188,22,2577,0,0,22,2577,0.833019000,1.0361
215.158.239.92,<->,207.239.224.78,22,2172,0,0,22,2172,0.824291000,0.6388
220.28.114.28,<->,215.158.239.91,0,0,22,29033,22,29033,0.823897000,0.0461
215.158.238.148,<->,114.25.48.32,22,4859,0,0,22,4859,0.822939000,1.1217
220.20.200.112,<->,132.216.159.4,22,23211,0,0,22,23211,0.787233000,0.4158
194.232.246.152,<->,136.25.188.243,0,0,22,2283,22,2283,0.785761000,0.7785
220.28.115.46,<->,215.158.239.72,0,0,22,24605,22,24605,0.774329000,1.0724
215.158.238.148,<->,80.47.111.27,22,7669,0,0,22,7669,0.761077000,1.1722
136.25.188.59,<->,100.224.166.146,22,26868,0,0,22,26868,0.709114000,0.6753
133.178.227.26,<->,8.191.14.58,22,3720,0,0,22,3720,0.688073000,0.6732
247.136.135.179,<->,237.7.82.49,22,29841,0,0,22,29841,0.665621000,0.8765
212.70.75.122,<->,133.178.226.19,0,0,22,5007,22,5007,0.624850000,1.1852
254.126.111.238,<->,6.228.27.68,0,0,22,1581,22,1581,0.624550000,1.3099
136.25.188.220,<->,8.222.212.23,22,7481,0,0,22,7481,0.613638000,1.2216
215.158.238.132,<->,131.1.195.220,22,3919,0,0,22,3919,0.611958000,1.2346
215.158.239.87,<->,143.42.18.52,22,2768,0,0,22,2768,0.606142000,1.3314
220.28.115.46,<->,215.158.239.52,0,0,22,29879,22,29879,0.577064000,0.2107
215.158.238.80,<->,8.190.216.212,22,5147,0,0,22,5147,0.561639000,1.3299
215.158.238.82,<->,91.57.173.10,22,12317,0,0,22,12317,0.547356000,1.3379
233.121.195.221,<->,8.183.25.124,0,0,22,3615,22,3615,0.546500000,0.2698
111.146.254.223,<->,16.222.25.95,22,1100,0,0,22,1100,0.540747000,1.4161
136.25.188.226,<->,8.190.216.194,22,6392,0,0,22,6392,0.529699000,1.4030
89.204.94.77,<->,8.182.224.87,0,0,22,2449,22,2449,0.524484000,0.6456
142.249.52.212,<->,136.25.188.236,0,0,22,2296,22,2296,0.516145000,1.4765
221.196.123.201,<->,138.98.250.43,0,0,22,1298,22,1298,0.503937000,0.2601
231.143.200.156,<->,136.25.188.52,0,0,22,3610,22,3610,0.495080000,0.6298
215.158.140.83,<->,192.171.32.25,22,2448,0,0,22,2448,0.494535000,0.3312
215.158.238.153,<->,0.195.237.14,22,28092,0,0,22,28092,0.478934000,1.3619
136.25.188.45,<->,27.178.41.39,22,3754,0,0,22,3754,0.478664000,1.0286
204.200.43.11,<->,136.25.188.226,0,0,22,3770,22,3770,0.474130000,1.4002
133.178.227.16,<->,33.209.213.2,22,3315,0,0,22,3315,0.470461000,0.9321
215.158.239.76,<->,207.60.124.52,22,2736,0,0,22,2736,0.469913000,1.4897
215.158.239.49,<->,199.20.115.15,22,2148,0,0,22,2148,0.468683000,0.5005
220.28.73.211,<->,215.158.238.203,0,0,22,24990,22,24990,0.439410000,1.5096
215.158.238.105,<->,29.212.182.225,22,2437,0,0,22,2437,0.434948000,0.1289
199.51.177.82,<->,136.25.188.52,0,0,22,2187,22,2187,0.431930000,1.5666
215.158.239.29,<->,106.188.184.165,22,6866,0,0,22,6866,0.430133000,1.4361
144.85.170.208,<->,98.87.144.198,22,1851,0,0,22,1851,0.414576000,0.2955
192.227.190.59,<->,8.252.223.175,0,0,22,3978,22,3978,0.401839000,1.4420
142.236.194.239,<->,136.25.188.54,0,0,22,2888,22,2888,0.361427000,0.5606
215.158.239.85,<->,199.106.14.92,22,2821,0,0,22,2821,0.352602000,0.9860
58.40.229.187,<->,0.195.210.42,0,0,22,1619,22,1619,0.342489000,1.5215
215.158.238.99,<->,111.150.186.223,22,6196,0,0,22,6196,0.329507000,1.6021
136.25.188.251,<->,100.224.202.171,22,24559,0,0,22,24559,0.326034000,1.4772
136.25.188.211,<->,131.1.195.245,22,7801,0,0,22,7801,0.317410000,1.6642
195.12.243.37,<->,136.25.188.252,0,0,22,2058,22,2058,0.308390000,0.4180
136.25.189.32,<->,96.135.154.247,22,7433,0,0,22,7433,0.304025000,1.5541
215.158.238.190,<->,8.190.217.84,22,7253,0,0,22,7253,0.300460000,1.6225
215.158.239.95,<->,199.20.30.38,22,3624,0,0,22,3624,0.286601000,1.7093
204.200.55.93,<->,136.25.188.176,0,0,22,3818,22,3818,0.280992000,0.7561
203.117.167.190,<->,0.195.210.42,0,0,22,1908,22,1908,0.280729000,0.2801
200.226.80.179,<->,129.92.113.143,0,0,22,1100,22,1100,0.276439000,1.4226
215.158.239.95,<->,199.20.28.173,22,2295,0,0,22,2295,0.275620000,1.6895
215.158.140.229,<->,131.144.112.246,22,6313,0,0,22,6313,0.273456000,1.7018
133.178.227.24,<->,69.150.169.162,22,4991,0,0,22,4991,0.262357000,1.5587
215.158.238.136,<->,100.120.38.6,22,23352,0,0,22,23352,0.261208000,0.8159
215.158.238.96,<->,61.34.184.209,22,3546,0,0,22,3546,0.260861000,1.5633
199.120.37.42,<->,136.25.188.163,0,0,22,2741,22,2741,0.250443000,1.7448
136.25.189.12,<->,96.156.169.171,22,9433,0,0,22,9433,0.242208000,1.7479
215.158.239.92,<->,199.20.31.101,22,2703,0,0,22,2703,0.241361000,1.2099
215.158.239.84,<->,199.20.5.25,22,2283,0,0,22,2283,0.240006000,1.3602
195.15.228.209,<->,136.25.188.253,0,0,22,1322,22,1322,0.238164000,0.6209
139.1.224.2,<->,133.178.226.233,0,0,22,1232,22,1232,0.234370000,1.5375
215.158.239.48,<->,143.91.230.56,22,2073,0,0,22,2073,0.233506000,0.7897
207.193.113.191,<->,8.252.222.177,0,0,22,2136,22,2136,0.230808000,1.5943
220.28.85.14,<->,215.158.238.86,0,0,22,24723,22,24723,0.227835000,1.3550
127.15.206.204,<->,89.183.104.227,0,0,22,12232,22,12232,0.219007000,1.5063
215.158.238.135,<->,126.219.194.151,22,7157,0,0,22,7157,0.214471000,1.2452
133.178.226.29,<->,126.219.132.211,22,3738,0,0,22,3738,0.212509000,0.6242
195.40.217.107,<->,136.25.188.208,0,0,22,1660,22,1660,0.211383000,1.4031
215.158.239.33,<->,215.158.127.169,22,5641,0,0,22,5641,0.209651000,0.7673
136.25.188.163,<->,131.36.198.24,22,8435,0,0,22,8435,0.204008000,1.6892
136.25.188.210,<->,106.188.236.198,22,7577,0,0,22,7577,0.199888000,1.6970
133.178.226.38,<->,38.104.11.16,22,2341,0,0,22,2341,0.196172000,1.4635
215.158.239.32,<->,8.252.214.212,22,10761,0,0,22,10761,0.192345000,1.6858
215.158.239.57,<->,204.2.105.75,22,1418,0,0,22,1418,0.192097000,0.6877
195.15.160.132,<->,136.25.188.46,0,0,22,2146,22,2146,0.184780000,0.3431
139.163.34.3,<->,110.222.217.99,22,1232,0,0,22,1232,0.184209000,1.5647
196.204.45.134,<->,136.25.188.178,0,0,22,1378,22,1378,0.183778000,1.3396
215.158.140.198,<->,144.95.111.33,22,4736,0,0,22,4736,0.181089000,1.6465
136.25.188.172,<->,106.188.236.186,22,6244,0,0,22,6244,0.176749000,1.8179
149.250.115.23,<->,136.25.188.253,0,0,22,7433,22,7433,0.170480000,1.7897
136.25.188.173,<->,106.188.236.151,22,6196,0,0,22,6196,0.169739000,1.8273
91.100.188.203,<->,80.38.33.27,0,0,22,1100,22,1100,0.165704000,1.8172
215.158.238.67,<->,8.190.216.220,22,6304,0,0,22,6304,0.162467000,1.4104
143.132.25.93,<->,136.25.188.255,0,0,22,1696,22,1696,0.162455000,1.4519
215.158.239.96,<->,199.20.6.78,22,1361,0,0,22,1361,0.159676000,1.4596
215.158.239.56,<->,196.93.243.22,22,1292,0,0,22,1292,0.158011000,1.6002
215.158.238.104,<->,143.45.0.148,22,5711,0,0,22,5711,0.157887000,1.6092
194.237.87.119,<->,136.25.188.252,0,0,22,3704,22,3704,0.152356000,1.1343
215.158.239.94,<->,204.1.227.231,22,2475,0,0,22,2475,0.148121000,1.6522
220.39.233.181,<->,136.25.188.237,0,0,22,9987,22,9987,0.143365000,1.8126
194.253.81.124,<->,8.252.222.243,0,0,22,1220,22,1220,0.141651000,1.7468
215.158.239.99,<->,196.106.144.16,22,2458,0,0,22,2458,0.140799000,0.4803
207.61.3.109,<->,136.25.188.225,0,0,22,2743,22,2743,0.139962000,1.5017
215.202.175.5,<->,215.158.238.123,0,0,22,1232,22,1232,0.139074000,0.0088
8.252.223.130,<->,8.222.7.160,22,2346,0,0,22,2346,0.137006000,0.1124
195.120.129.171,<->,99.75.125.132,0,0,22,1144,22,1144,0.134814000,1.7746
215.158.239.87,<->,195.126.107.17,22,2192,0,0,22,2192,0.128606000,0.3873
215.158.238.64,<->,131.1.195.187,22,9390,0,0,22,9390,0.126872000,1.5766
215.158.140.170,<->,144.95.111.33,22,5342,0,0,22,5342,0.125817000,1.8293
69.243.123.18,<->,8.252.221.239,0,0,22,1340,22,1340,0.124943000,1.7512
194.253.248.68,<->,8.252.222.197,0,0,22,1454,22,1454,0.123377000,1.7312
215.158.239.87,<->,196.0.241.50,22,2151,0,0,22,2151,0.120878000,1.1103
199.71.19.20,<->,136.25.188.175,0,0,22,2249,22,2249,0.118373000,1.1274
202.124.160.181,<->,8.252.221.198,0,0,22,1154,22,1154,0.117746000,1.8600
215.158.239.86,<->,80.56.79.58,22,8494,0,0,22,8494,0.117125000,1.7429
215.158.238.113,<->,141.199.67.37,22,3546,0,0,22,3546,0.114673000,1.8203
139.163.34.116,<->,80.56.72.19,22,1100,0,0,22,1100,0.109693000,1.8120
215.158.140.231,<->,106.188.252.171,22,7317,0,0,22,7317,0.099887000,1.6623
204.184.84.248,<->,136.25.188.177,0,0,22,3012,22,3012,0.099130000,1.5499
136.25.188.226,<->,57.160.181.250,22,8526,0,0,22,8526,0.098831000,1.8468
215.158.239.95,<->,207.166.112.56,22,4265,0,0,22,4265,0.094583000,1.8799
111.20.172.118,<->,101.224.89.178,0,0,22,29756,22,29756,0.092786000,0.0002
133.178.227.40,<->,133.56.180.32,22,14594,0,0,22,14594,0.087360000,1.6834
43.52.3.19,<->,8.252.222.31,0,0,22,2534,22,2534,0.082938000,0.9026
48.17.38.203,<->,8.252.222.205,0,0,22,2074,22,2074,0.082825000,1.2151
158.200.13.147,<->,8.20.87.156,0,0,22,1100,22,1100,0.082094000,1.8394
94.195.235.251,<->,8.252.221.198,0,0,22,1174,22,1174,0.080733000,1.9060
133.178.227.122,<->,108.47.155.94,22,1100,0,0,22,1100,0.077231000,1.8163
204.186.152.142,<->,136.25.188.238,0,0,22,2084,22,2084,0.076970000,1.0100
75.214.145.63,<->,8.252.222.133,0,0,22,1396,22,1396,0.075967000,1.8472
215.158.239.96,<->,199.20.29.190,22,1277,0,0,22,1277,0.074640000,0.6806
136.25.188.197,<->,106.188.236.197,22,6148,0,0,22,6148,0.070415000,1.7897
136.25.188.226,<->,126.219.247.16,22,8590,0,0,22,8590,0.069632000,1.8217
210.229.230.20,<->,132.212.130.128,22,1242,0,0,22,1242,0.069615000,1.8295
222.3.81.165,<->,139.163.0.100,0,0,22,1232,22,1232,0.069220000,1.9069
145.180.135.157,<->,136.25.188.40,0,0,22,22162,22,22162,0.067884000,0.5431
215.158.239.70,<->,199.20.30.11,22,1367,0,0,22,1367,0.067757000,0.6398
142.167.77.142,<->,136.25.188.252,0,0,22,1100,22,1100,0.059063000,1.8329
223.114.238.25,<->,8.252.222.205,0,0,22,1368,22,1368,0.057809000,1.9416
136.25.188.162,<->,116.106.61.237,22,4735,0,0,22,4735,0.053186000,1.7792
142.172.230.69,<->,50.223.3.228,0,0,22,1100,22,1100,0.052559000,0.7776
91.231.194.211,<->,18.136.116.31,22,1308,0,0,22,1308,0.051517000,1.8128
89.183.104.184,<->,14.27.104.54,22,30712,0,0,22,30712,0.051459000,1.9414
207.102.135.139,<->,8.252.222.178,0,0,22,1100,22,1100,0.050601000,1.9474
142.223.172.211,<->,136.25.188.196,0,0,22,1232,22,1232,0.049492000,0.2698
43.54.164.16,<->,8.252.221.205,0,0,22,1196,22,1196,0.048113000,1.8486
136.25.189.33,<->,29.214.109.182,22,7513,0,0,22,7513,0.046178000,1.9168
215.158.238.198,<->,106.188.251.56,22,4443,0,0,22,4443,0.044958000,1.8293
159.64.140.45,<->,50.224.88.98,0,0,22,1232,22,1232,0.041100000,1.7602
100.95.193.114,<->,8.55.224.156,22,2011,0,0,22,2011,0.040740000,0.4076
215.158.238.64,<->,106.188.183.119,22,7289,0,0,22,7289,0.040317000,1.6298
156.142.35.248,<->,8.252.222.176,0,0,22,1292,22,1292,0.037425000,1.9212
100.78.123.243,<->,50.224.105.45,0,0,22,1232,22,1232,0.037001000,1.9408
95.247.129.20,<->,8.252.222.70,0,0,22,1376,22,1376,0.036299000,1.8684
215.158.239.87,<->,199.20.30.144,22,1232,0,0,22,1232,0.036040000,0.1630
136.25.188.210,<->,104.3.168.218,22,5812,0,0,22,5812,0.035344000,1.4748
215.158.239.57,<->,80.56.79.74,22,7852,0,0,22,7852,0.035196000,1.6728
192.204.170.197,<->,136.25.188.220,0,0,22,2501,22,2501,0.033884000,1.8071
195.55.31.40,<->,136.25.188.173,0,0,22,2929,22,2929,0.033883000,1.4648
97.182.5.191,<->,8.53.4.211,0,0,22,1208,22,1208,0.031792000,1.3927
136.25.189.77,<->,126.219.194.11,22,13033,0,0,22,13033,0.031342000,1.9260
215.158.239.57,<->,156.165.37.111,22,6512,0,0,22,6512,0.030595000,1.8388
136.25.189.40,<->,96.156.169.210,22,21347,0,0,22,21347,0.027036000,1.1254
193.11.210.41,<->,159.23.227.57,0,0,22,1100,22,1100,0.027026000,1.8331
207.60.189.167,<->,136.25.188.209,0,0,22,2267,22,2267,0.025701000,1.3962
215.158.44.194,<->,136.25.189.59,0,0,22,13506,22,13506,0.025072000,1.9208
119.238.208.112,<->,109.222.251.151,0,0,22,1289,22,1289,0.023816000,1.8070
215.158.239.76,<->,195.5.170.96,22,2197,0,0,22,2197,0.023517000,1.9320
142.227.70.185,<->,136.25.188.252,0,0,22,2154,22,2154,0.023015000,0.6417
136.25.188.44,<->,112.235.95.24,22,6304,0,0,22,6304,0.021713000,1.8442
136.25.188.162,<->,91.57.173.38,22,5007,0,0,22,5007,0.021623000,1.7861
215.158.238.81,<->,112.220.206.118,22,7397,0,0,22,7397,0.019678000,1.6278
215.158.239.93,<->,207.16.255.47,22,1305,0,0,22,1305,0.018943000,1.0801
144.85.170.244,<->,98.87.147.193,22,1360,0,0,22,1360,0.018646000,1.9472
215.158.239.94,<->,8.215.68.83,22,11300,0,0,22,11300,0.018226000,1.9743
133.178.227.7,<->,133.56.180.44,22,19814,0,0,22,19814,0.016698000,1.7319
136.25.189.18,<->,96.135.155.22,22,11044,0,0,22,11044,0.016489000,1.8227
215.158.30.238,<->,8.252.222.41,0,0,22,14820,22,14820,0.015197000,1.8412
204.186.26.239,<->,136.25.188.173,0,0,22,1232,22,1232,0.014618000,0.8699
198.70.5.37,<->,89.183.110.193,0,0,22,1371,22,1371,0.012159000,0.6217
215.158.239.79,<->,80.56.79.90,22,10330,0,0,22,10330,0.011744000,1.7690
215.158.140.76,<->,8.191.7.118,22,7485,0,0,22,7485,0.011600000,1.8116
133.178.227.242,<->,96.155.60.130,22,7733,0,0,22,7733,0.011339000,1.5209
136.25.188.211,<->,80.47.111.65,22,6148,0,0,22,6148,0.010674000,1.7636
221.196.127.3,<->,139.163.8.107,0,0,22,1244,22,1244,0.009923000,1.7399
92.27.219.241,<->,40.213.57.116,22,1276,0,0,22,1276,0.008020000,1.8363
143.239.149.114,<->,8.20.87.195,0,0,22,2089,22,2089,0.006424000,1.8404
136.25.189.6,<->,96.156.169.167,22,24542,0,0,22,24542,0.005496000,1.0870
192.204.243.54,<->,133.178.227.251,0,0,22,8896,22,8896,0.004916000,1.7922
215.158.239.85,<->,207.59.12.230,22,2122,0,0,22,2122,0.004090000,0.4657
195.14.142.88,<->,136.25.188.236,0,0,22,1385,22,1385,0.003940000,1.9836
215.158.238.223,<->,8.240.116.197,22,4815,0,0,22,4815,0.002763000,1.8445
204.185.215.107,<->,136.25.188.243,0,0,22,1340,22,1340,0.002618000,1.6698
127.111.95.13,<->,97.126.46.188,0,0,22,1178,22,1178,0.000614000,1.9288
215.158.239.87,<->,199.20.28.152,22,2183,0,0,22,2183,0.000589000,1.4291
207.58.161.119,<->,136.25.188.252,0,0,22,1100,22,1100,0.000356000,0.9220
133.178.226.255,<->,111.150.207.80,21,1176,0,0,21,1176,1.895271000,0.0920
192.170.245.60,<->,133.178.227.2,0,0,21,2212,21,2212,1.858666000,0.0354
220.28.114.28,<->,215.158.238.90,0,0,21,26774,21,26774,1.715884000,0.2619
215.158.238.135,<->,29.212.195.11,21,1188,0,0,21,1188,1.519756000,0.4760
152.40.232.143,<->,8.252.222.141,0,0,21,1641,21,1641,1.472305000,0.3619
143.79.149.193,<->,136.25.188.210,0,0,21,2075,21,2075,1.471520000,0.2933
197.146.101.6,<->,8.20.87.95,0,0,21,1689,21,1689,1.413640000,0.5673
8.252.223.106,<->,8.240.116.203,21,3601,0,0,21,3601,1.367897000,0.4349
215.158.239.95,<->,199.20.6.22,21,1885,0,0,21,1885,1.316889000,0.5611
204.56.10.186,<->,136.25.188.162,0,0,21,1869,21,1869,1.286629000,0.4107
195.13.214.197,<->,136.25.188.46,0,0,21,1922,21,1922,1.273635000,0.5994
215.158.238.133,<->,89.86.110.85,21,2333,0,0,21,2333,1.216556000,0.3539
136.25.189.22,<->,98.219.126.175,21,29345,0,0,21,29345,1.202847000,0.0001
215.158.23.24,<->,111.150.207.148,21,1176,0,0,21,1176,1.197696000,0.1506
215.158.238.70,<->,0.195.253.228,21,27254,0,0,21,27254,1.183374000,0.5240
98.105.42.28,<->,8.252.222.46,0,0,21,2225,21,2225,1.166581000,0.8322
215.158.238.108,<->,0.195.253.228,21,26945,0,0,21,26945,1.165720000,0.0332
215.158.238.81,<->,212.70.75.55,21,2397,0,0,21,2397,1.153841000,0.0517
215.158.238.106,<->,8.191.10.86,21,2781,0,0,21,2781,1.134976000,0.0690
204.58.127.65,<->,136.25.188.198,0,0,21,2721,21,2721,1.097013000,0.7162
215.158.238.104,<->,140.174.85.72,21,2861,0,0,21,2861,1.055440000,0.4172
143.134.32.44,<->,136.25.188.242,0,0,21,2775,21,2775,1.026425000,0.8211
136.25.188.213,<->,80.57.141.187,21,20472,0,0,21,20472,0.984761000,0.6709
195.125.15.45,<->,136.25.188.198,0,0,21,1561,21,1561,0.958376000,0.5223
195.54.134.173,<->,136.25.188.177,0,0,21,2749,21,2749,0.951706000,0.8756
125.181.234.162,<->,89.183.104.230,0,0,21,1104,21,1104,0.939663000,0.9710
142.191.53.184,<->,136.25.188.255,0,0,21,3552,21,3552,0.843763000,1.1498
195.15.191.220,<->,136.25.188.226,0,0,21,1789,21,1789,0.827577000,0.3934
215.158.238.81,<->,128.123.91.106,21,3618,0,0,21,3618,0.816340000,1.0959
142.166.208.248,<->,136.25.188.253,0,0,21,2686,21,2686,0.804571000,0.8943
215.158.238.123,<->,112.235.95.6,21,4979,0,0,21,4979,0.794064000,1.0780
94.193.162.63,<->,8.252.222.48,0,0,21,2653,21,2653,0.756924000,0.7632
133.178.226.60,<->,30.249.194.214,21,2781,0,0,21,2781,0.749698000,0.4786
145.16.59.85,<->,144.85.169.209,21,23059,0,0,21,23059,0.749049000,0.1553
220.55.126.63,<->,137.44.153.224,21,1299,0,0,21,1299,0.746599000,1.0676
133.178.226.220,<->,100.224.163.93,21,26524,0,0,21,26524,0.744124000,0.6566
215.158.239.92,<->,195.69.31.186,21,2504,0,0,21,2504,0.742764000,1.2230
203.215.2.153,<->,8.181.37.222,21,25086,0,0,21,25086,0.698289000,0.7318
215.158.238.99,<->,38.104.11.38,21,3490,0,0,21,3490,0.693174000,1.1005
207.61.104.245,<->,136.25.188.220,0,0,21,2413,21,2413,0.674600000,1.2344
139.163.17.164,<->,133.129.49.254,21,4593,0,0,21,4593,0.645750000,0.9218
136.158.219.207,<->,8.220.177.81,0,0,21,2300,21,2300,0.633022000,0.8646
192.204.170.198,<->,136.25.188.47,0,0,21,4999,21,4999,0.556142000,1.3854
136.25.188.174,<->,104.3.161.85,21,3698,0,0,21,3698,0.535483000,0.7200
89.155.251.27,<->,8.182.227.14,0,0,21,3566,21,3566,0.533451000,0.3475
136.25.188.179,<->,57.210.107.43,21,7505,0,0,21,7505,0.531484000,1.4133
136.25.188.162,<->,122.158.245.122,21,5804,0,0,21,5804,0.526453000,1.3265
215.158.239.79,<->,195.4.176.240,21,2236,0,0,21,2236,0.522043000,1.1228
140.218.109.12,<->,136.25.188.178,0,0,21,5047,21,5047,0.518473000,1.2663
215.158.239.56,<->,196.1.15.161,21,1176,0,0,21,1176,0.516857000,0.5399
215.158.239.56,<->,196.91.47.95,21,2931,0,0,21,2931,0.514842000,0.7700
215.158.61.193,<->,136.25.188.41,0,0,21,24863,21,24863,0.499258000,1.4515
136.25.188.255,<->,131.1.253.250,21,6195,0,0,21,6195,0.493917000,1.2579
95.246.192.238,<->,8.252.221.199,0,0,21,1746,21,1746,0.484126000,0.3617
215.158.140.93,<->,131.219.110.150,21,3675,0,0,21,3675,0.480397000,0.8039
89.183.104.130,<->,76.178.32.105,21,1173,0,0,21,1173,0.472430000,1.3341
133.178.227.57,<->,133.56.180.34,21,11133,0,0,21,11133,0.469213000,1.2557
204.200.58.249,<->,136.25.188.238,0,0,21,2667,21,2667,0.465792000,0.6840
133.178.226.18,<->,131.144.114.218,21,7505,0,0,21,7505,0.454955000,1.4510
136.138.112.194,<->,133.178.226.7,0,0,21,6076,21,6076,0.451370000,1.4758
204.142.57.128,<->,50.223.3.228,0,0,21,1182,21,1182,0.449058000,1.5489
195.40.21.252,<->,136.25.188.178,0,0,21,1303,21,1303,0.445412000,1.4841
141.163.50.125,<->,8.252.222.156,0,0,21,3020,21,3020,0.437705000,1.1311
207.58.218.25,<->,136.25.188.225,0,0,21,4301,21,4301,0.423475000,1.3324
136.25.188.208,<->,29.214.108.119,21,9547,0,0,21,9547,0.418969000,1.4838
194.234.236.73,<->,136.25.188.253,0,0,21,1572,21,1572,0.407240000,0.6637
143.134.59.79,<->,136.25.188.198,0,0,21,1472,21,1472,0.405397000,1.3419
215.158.239.58,<->,196.91.159.141,21,3019,0,0,21,3019,0.386346000,1.4797
133.178.226.29,<->,99.192.168.162,21,6039,0,0,21,6039,0.381327000,1.6057
194.237.110.215,<->,136.25.188.177,0,0,21,1272,21,1272,0.370918000,0.8375
207.61.58.64,<->,136.25.188.198,0,0,21,2448,21,2448,0.369663000,1.2645
133.178.227.40,<->,131.22.233.139,21,4202,0,0,21,4202,0.365288000,1.3836
215.158.239.56,<->,195.70.4.190,21,1813,0,0,21,1813,0.361194000,1.6346
136.25.188.255,<->,111.151.239.1,21,9815,0,0,21,9815,0.358687000,1.5818
195.41.112.6,<->,136.25.188.227,0,0,21,3323,21,3323,0.335830000,1.5421
199.63.178.200,<->,136.25.188.44,0,0,21,6284,21,6284,0.334343000,1.3124
109.222.230.185,<->,53.208.110.227,21,9300,0,0,21,9300,0.332838000,1.2539
215.158.61.193,<->,136.25.189.222,0,0,21,27158,21,27158,0.330447000,1.5358
221.102.143.189,<->,192.67.165.112,0,0,21,26119,21,26119,0.324457000,0.7431
197.113.99.89,<->,136.25.188.237,0,0,21,1311,21,1311,0.323910000,1.5499
195.71.62.57,<->,136.25.188.177,0,0,21,2379,21,2379,0.318004000,1.4436
215.158.238.141,<->,57.210.107.42,21,4887,0,0,21,4887,0.315312000,1.5763
144.253.54.250,<->,133.178.226.202,0,0,21,1176,21,1176,0.315061000,1.5014
142.241.241.58,<->,136.25.188.177,0,0,21,1176,21,1176,0.313800000,0.2410
122.195.239.38,<->,8.182.136.169,0,0,21,1176,21,1176,0.308903000,0.2760
215.158.238.47,<->,119.196.23.26,21,3870,0,0,21,3870,0.308315000,0.9375
136.25.188.210,<->,76.100.108.197,21,2705,0,0,21,2705,0.301030000,0.6593
215.158.238.233,<->,98.219.126.175,21,28285,0,0,21,28285,0.299728000,0.1038
144.85.170.248,<->,98.87.146.200,21,2051,0,0,21,2051,0.299058000,1.4457
199.120.37.42,<->,136.25.188.241,0,0,21,2685,21,2685,0.296177000,1.2084
195.5.63.250,<->,136.25.188.178,0,0,21,2222,21,2222,0.281016000,1.5789
215.158.239.4,<->,29.211.5.198,21,8157,0,0,21,8157,0.277033000,1.5903
101.112.192.32,<->,89.90.112.31,21,27496,0,0,21,27496,0.273953000,0.3719
133.178.226.93,<->,100.120.38.6,21,22331,0,0,21,22331,0.264399000,0.5411
136.25.188.29,<->,53.208.237.45,21,28986,0,0,21,28986,0.253865000,0.0236
215.158.61.182,<->,8.176.8.242,0,0,21,17851,21,17851,0.252388000,1.4429
215.158.239.50,<->,29.211.228.235,21,5260,0,0,21,5260,0.249142000,1.7411
235.42.34.54,<->,133.178.226.37,0,0,21,2461,21,2461,0.244494000,1.4626
215.158.239.93,<->,199.20.31.91,21,1188,0,0,21,1188,0.242325000,0.4797
220.60.81.139,<->,136.25.189.1,0,0,21,12725,21,12725,0.236508000,1.4146
149.250.115.7,<->,133.178.226.90,0,0,21,8246,21,8246,0.236233000,1.6023
215.158.238.190,<->,126.207.73.86,21,1176,0,0,21,1176,0.233117000,0.0112
195.71.87.219,<->,136.25.188.176,0,0,21,1280,21,1280,0.228644000,1.7677
144.85.170.254,<->,98.87.144.231,21,1528,0,0,21,1528,0.228129000,0.8805
207.231.190.193,<->,8.252.222.176,0,0,21,1364,21,1364,0.217909000,1.2696
136.25.188.237,<->,104.3.168.213,21,8614,0,0,21,8614,0.214901000,1.4380
136.25.188.221,<->,57.210.107.11,21,6236,0,0,21,6236,0.212960000,1.5719
215.158.238.135,<->,57.210.107.8,21,3602,0,0,21,3602,0.209555000,1.7393
220.39.233.218,<->,215.158.238.135,0,0,21,6188,21,6188,0.207706000,1.7470
215.158.239.115,<->,159.61.251.14,21,30384,0,0,21,30384,0.207294000,0.0364
8.252.223.131,<->,8.219.185.43,21,6625,0,0,21,6625,0.207261000,1.4499
136.25.189.10,<->,96.156.169.166,21,22827,0,0,21,22827,0.201614000,1.5420
215.158.238.67,<->,113.23.21.201,21,5864,0,0,21,5864,0.199727000,1.6801
138.98.203.225,<->,114.94.62.173,21,1516,0,0,21,1516,0.193733000,1.5649
136.25.188.178,<->,120.154.221.218,21,6028,0,0,21,6028,0.190646000,1.7109
195.41.103.56,<->,136.25.188.46,0,0,21,1800,21,1800,0.186949000,1.8087
133.178.226.77,<->,8.219.187.251,21,1176,0,0,21,1176,0.182777000,0.0951
215.158.239.48,<->,196.109.154.128,21,1176,0,0,21,1176,0.178337000,0.3108
212.164.135.173,<->,111.168.99.60,21,1176,0,0,21,1176,0.177261000,1.8212
142.237.46.140,<->,136.25.188.54,0,0,21,1540,21,1540,0.175661000,0.9512
142.241.142.33,<->,136.25.188.253,0,0,21,1365,21,1365,0.174012000,0.5176
215.158.140.87,<->,80.34.211.22,21,3043,0,0,21,3043,0.173680000,0.6088
220.39.233.164,<->,136.25.188.220,0,0,21,6380,21,6380,0.165012000,1.6430
140.136.9.105,<->,136.25.188.105,0,0,21,4640,21,4640,0.164620000,1.6491
142.173.201.53,<->,50.223.3.228,0,0,21,1068,21,1068,0.164497000,1.7158
144.79.253.46,<->,50.224.88.92,0,0,21,1050,21,1050,0.158807000,1.7499
196.148.124.252,<->,196.119.218.132,21,2399,0,0,21,2399,0.156781000,1.2304
125.3.248.172,<->,80.41.18.181,0,0,21,29452,21,29452,0.154441000,1.6603
215.158.238.80,<->,29.211.6.17,21,6108,0,0,21,6108,0.154212000,1.7829
136.25.188.160,<->,80.47.111.75,21,7265,0,0,21,7265,0.154097000,1.7516
136.25.189.1,<->,120.154.71.8,21,11404,0,0,21,11404,0.153461000,1.5250
97.126.115.85,<->,97.46.127.17,21,27575,0,0,21,27575,0.150718000,1.7534
215.158.238.116,<->,145.116.209.93,21,23196,0,0,21,23196,0.147879000,1.0552
215.158.239.79,<->,199.20.4.239,21,2115,0,0,21,2115,0.146534000,1.6100
223.120.84.40,<->,8.252.222.236,0,0,21,1340,21,1340,0.146379000,1.0631
215.158.140.93,<->,126.219.191.56,21,5789,0,0,21,5789,0.145738000,1.7202
139.163.8.107,<->,98.3.217.56,21,1176,0,0,21,1176,0.141735000,1.7722
8.252.222.134,<->,4.120.148.132,21,2076,0,0,21,2076,0.141316000,1.2640
108.0.230.240,<->,92.27.219.165,0,0,21,27305,21,27305,0.140204000,1.4715
215.158.238.83,<->,8.252.210.160,21,3698,0,0,21,3698,0.136468000,1.7784
207.239.27.8,<->,136.25.188.253,0,0,21,2132,21,2132,0.132167000,0.5635
136.25.189.33,<->,29.211.228.178,21,10179,0,0,21,10179,0.129861000,1.8643
195.71.178.125,<->,136.25.188.255,0,0,21,1378,21,1378,0.127769000,0.8231
92.27.27.183,<->,76.178.137.163,21,1092,0,0,21,1092,0.124174000,1.6102
136.25.188.239,<->,8.255.92.247,21,5932,0,0,21,5932,0.121277000,1.6030
80.42.164.116,<->,33.57.78.82,21,28034,0,0,21,28034,0.119700000,1.7643
215.158.238.135,<->,106.188.183.85,21,5597,0,0,21,5597,0.119496000,1.1731
215.158.238.134,<->,140.19.166.218,21,1212,0,0,21,1212,0.119073000,1.7844
215.158.239.97,<->,199.20.4.105,21,1176,0,0,21,1176,0.116037000,0.5299
136.25.188.255,<->,29.214.108.168,21,6608,0,0,21,6608,0.115724000,0.9394
215.158.238.133,<->,8.42.43.3,21,6184,0,0,21,6184,0.114850000,1.5911
195.6.221.235,<->,136.25.188.175,0,0,21,1237,21,1237,0.114843000,0.8301
139.163.8.107,<->,98.87.144.8,21,1176,0,0,21,1176,0.110481000,1.8714
136.25.189.62,<->,56.28.207.196,21,18896,0,0,21,18896,0.108223000,1.6443
215.158.239.95,<->,195.83.116.23,21,2691,0,0,21,2691,0.106296000,1.1488
136.25.189.77,<->,29.214.108.227,21,4887,0,0,21,4887,0.105120000,1.4245
231.140.105.59,<->,215.158.239.49,0,0,21,1885,21,1885,0.104163000,0.5909
212.164.135.173,<->,50.241.122.159,21,1176,0,0,21,1176,0.103847000,1.7405
152.43.94.93,<->,8.252.221.198,0,0,21,1128,21,1128,0.103019000,1.8459
132.176.149.230,<->,50.224.108.39,0,0,21,1056,21,1056,0.102538000,1.8387
207.58.174.87,<->,136.25.188.254,0,0,21,2060,21,2060,0.101686000,0.4104
50.224.105.34,<->,18.203.51.189,21,1176,0,0,21,1176,0.100486000,1.8729
202.124.172.129,<->,8.252.222.4,0,0,21,1218,21,1218,0.100021000,1.7335
195.55.62.165,<->,136.25.188.53,0,0,21,1272,21,1272,0.099032000,1.7907
142.227.201.92,<->,136.25.188.177,0,0,21,2928,21,2928,0.096100000,1.8632
215.158.239.56,<->,196.0.145.187,21,1352,0,0,21,1352,0.093777000,0.3290
222.39.45.120,<->,50.224.68.211,0,0,21,1176,21,1176,0.092654000,1.8503
136.25.188.224,<->,106.188.236.197,21,7505,0,0,21,7505,0.092540000,1.6822
91.69.181.247,<->,50.224.105.45,0,0,21,1176,21,1176,0.091688000,1.9018
93.127.111.72,<->,0.195.210.8,0,0,21,3321,21,3321,0.087438000,1.7604
215.158.239.231,<->,192.226.44.94,21,8519,0,0,21,8519,0.086800000,1.5261
215.158.239.50,<->,199.20.28.139,21,1509,0,0,21,1509,0.085914000,1.4698
121.139.59.102,<->,101.224.167.97,0,0,21,2274,21,2274,0.084958000,1.7490
215.158.238.33,<->,112.235.95.68,21,8406,0,0,21,8406,0.080515000,1.8661
133.178.227.14,<->,133.56.180.5,21,10666,0,0,21,10666,0.073384000,1.7302
145.57.129.205,<->,139.163.8.98,0,0,21,1176,21,1176,0.066255000,1.9125
56.7.61.135,<->,50.224.68.215,0,0,21,1050,21,1050,0.064657000,1.9255
136.25.189.30,<->,29.212.180.224,21,13450,0,0,21,13450,0.064176000,1.9334
139.163.0.100,<->,110.198.110.151,21,1176,0,0,21,1176,0.063781000,1.9046
221.196.90.61,<->,144.85.170.246,0,0,21,1316,21,1316,0.055860000,1.4702
66.47.42.139,<->,8.252.222.176,0,0,21,1316,21,1316,0.054534000,1.8641
207.190.81.152,<->,136.25.188.252,0,0,21,2147,21,2147,0.052365000,1.0873
136.25.188.199,<->,100.224.202.182,21,9013,0,0,21,9013,0.051438000,1.5477
143.134.189.85,<->,136.25.188.176,0,0,21,2757,21,2757,0.051138000,0.9782
145.252.114.80,<->,120.159.137.169,21,2092,0,0,21,2092,0.049778000,0.9158
145.13.164.182,<->,136.25.189.59,0,0,21,12117,21,12117,0.049449000,1.8795
100.50.96.162,<->,8.252.223.153,0,0,21,2226,21,2226,0.049438000,0.4716
215.158.238.106,<->,113.23.21.196,21,3362,0,0,21,3362,0.049340000,1.2181
213.186.61.102,<->,139.163.8.107,0,0,21,1176,21,1176,0.047199000,1.9198
215.158.239.92,<->,199.20.31.245,21,2261,0,0,21,2261,0.047028000,0.7899
159.15.126.249,<->,139.163.8.107,0,0,21,1176,21,1176,0.046766000,1.9221
237.147.122.165,<->,139.163.8.98,0,0,21,1176,21,1176,0.045311000,1.9190
207.193.112.70,<->,8.252.222.207,0,0,21,1122,21,1122,0.043063000,1.8503
42.31.13.75,<->,8.182.227.71,0,0,21,1176,21,1176,0.042278000,1.8971
207.2.200.17,<->,50.223.3.228,0,0,21,1098,21,1098,0.039526000,1.7562
215.158.239.93,<->,126.219.191.6,21,11100,0,0,21,11100,0.035899000,1.9361
215.158.239.71,<->,29.211.228.217,21,7809,0,0,21,7809,0.035107000,1.9395
215.158.239.92,<->,143.128.180.248,21,1332,0,0,21,1332,0.031779000,1.1341
215.158.239.11,<->,215.158.127.140,21,13947,0,0,21,13947,0.031500000,1.9111
221.102.123.31,<->,194.245.232.253,21,1098,0,0,21,1098,0.031038000,1.6544
142.249.162.203,<->,136.25.188.239,0,0,21,1056,21,1056,0.027117000,0.8222
215.158.239.95,<->,199.20.29.150,21,2071,0,0,21,2071,0.026219000,0.5194
136.25.189.18,<->,29.211.228.176,21,5591,0,0,21,5591,0.025614000,0.7730
136.25.189.30,<->,96.156.169.162,21,8732,0,0,21,8732,0.025431000,1.9223
215.158.239.92,<->,207.213.108.126,21,1356,0,0,21,1356,0.025151000,0.6702
133.178.226.31,<->,69.246.42.39,21,1188,0,0,21,1188,0.025133000,0.0187
204.56.10.171,<->,136.25.188.209,0,0,21,2065,21,2065,0.023364000,0.2993
136.25.188.197,<->,122.159.245.164,21,9563,0,0,21,9563,0.023272000,1.9540
215.158.44.186,<->,136.25.189.59,0,0,21,11104,21,11104,0.023220000,1.9572
139.163.33.76,<->,129.13.169.26,21,1176,0,0,21,1176,0.022404000,1.9761
50.224.61.152,<->,50.99.81.230,21,1176,0,0,21,1176,0.022371000,1.9065
195.5.37.247,<->,136.25.188.211,0,0,21,1350,21,1350,0.020739000,1.3181
139.163.0.101,<->,117.32.247.134,21,1188,0,0,21,1188,0.019562000,1.9212
136.25.189.26,<->,96.156.169.208,21,18064,0,0,21,18064,0.016524000,0.5295
133.54.22.69,<->,35.55.8.92,21,1176,0,0,21,1176,0.011124000,0.1127
215.158.239.84,<->,142.221.10.212,21,1128,0,0,21,1128,0.009682000,0.8111
247.136.210.162,<->,125.194.237.4,21,10664,0,0,21,10664,0.008089000,1.9188
215.158.239.49,<->,195.5.15.69,21,2353,0,0,21,2353,0.008000000,1.6649
139.163.0.110,<->,101.168.248.6,21,1176,0,0,21,1176,0.006739000,1.8711
105.155.60.93,<->,92.27.219.175,0,0,21,30492,21,30492,0.005625000,1.9932
215.158.238.135,<->,8.42.43.75,21,9835,0,0,21,9835,0.003839000,1.7555
194.232.127.157,<->,136.25.188.242,0,0,21,1221,21,1221,0.002458000,0.1930
143.76.120.199,<->,136.25.188.224,0,0,21,2268,21,2268,0.000133000,1.1364
133.178.226.85,<->,111.150.207.148,20,1120,0,0,20,1120,1.867981000,0.1250
137.231.34.73,<->,89.183.104.181,0,0,20,26712,20,26712,1.723222000,0.1611
17.226.144.40,<->,8.53.4.39,0,0,20,1801,20,1801,1.696789000,0.2172
194.237.23.184,<->,136.25.188.255,0,0,20,1813,20,1813,1.618520000,0.3216
215.158.239.78,<->,194.250.218.150,20,1300,0,0,20,1300,1.559624000,0.3147
215.158.239.82,<->,80.57.141.226,20,20048,0,0,20,20048,1.479247000,0.2258
133.178.227.76,<->,18.202.90.199,20,2203,0,0,20,2203,1.461092000,0.4611
132.123.44.21,<->,8.37.122.231,20,19485,0,0,20,19485,1.417441000,0.5165
220.50.217.46,<->,8.52.228.29,0,0,20,4473,20,4473,1.408076000,0.0921
144.70.14.36,<->,111.160.232.222,20,2444,0,0,20,2444,1.396108000,0.4237
215.158.239.92,<->,195.49.164.235,20,1873,0,0,20,1873,1.374978000,0.3259
82.248.207.148,<->,8.220.239.66,0,0,20,3707,20,3707,1.343621000,0.6519
215.158.239.84,<->,143.72.68.211,20,1498,0,0,20,1498,1.326248000,0.5984
192.226.44.67,<->,133.178.227.244,0,0,20,3497,20,3497,1.323553000,0.1893
255.29.205.169,<->,80.41.46.174,0,0,20,2818,20,2818,1.318312000,0.5118
133.178.227.16,<->,122.216.233.89,20,2277,0,0,20,2277,1.316213000,0.1219
139.192.40.145,<->,8.52.222.23,0,0,20,2420,20,2420,1.290860000,0.6443
212.118.48.193,<->,192.229.216.117,0,0,20,1401,20,1401,1.184179000,0.2110
199.72.62.147,<->,136.25.188.220,0,0,20,3432,20,3432,1.096001000,0.8109
215.158.238.96,<->,29.214.71.87,20,2229,0,0,20,2229,1.081539000,0.1266
215.158.239.57,<->,142.221.129.95,20,1635,0,0,20,1635,1.072039000,0.8041
215.158.140.241,<->,215.158.6.213,20,3725,0,0,20,3725,1.046144000,0.9138
215.158.238.125,<->,100.120.38.6,20,23762,0,0,20,23762,1.001423000,0.9618
215.158.238.115,<->,136.138.112.201,20,10712,0,0,20,10712,0.992863000,0.9864
215.158.238.141,<->,29.212.43.247,20,2165,0,0,20,2165,0.983177000,0.1326
215.158.239.86,<->,199.20.28.177,20,2006,0,0,20,2006,0.974290000,0.5690
215.158.238.45,<->,8.253.128.20,20,2533,0,0,20,2533,0.969450000,0.8341
143.10.50.22,<->,136.25.188.197,0,0,20,2196,20,2196,0.968640000,1.0195
111.151.106.200,<->,8.252.222.35,0,0,20,1120,20,1120,0.960934000,0.1017
144.87.238.89,<->,8.182.226.78,0,0,20,2130,20,2130,0.958679000,0.8772
215.158.239.95,<->,196.95.114.199,20,2915,0,0,20,2915,0.955075000,0.9792
199.70.188.9,<->,136.25.188.237,0,0,20,2453,20,2453,0.949141000,1.0498
199.83.49.97,<->,136.25.188.255,0,0,20,1992,20,1992,0.940434000,0.9419
220.28.114.28,<->,215.158.140.80,0,0,20,23141,20,23141,0.887232000,0.9614
136.25.188.254,<->,48.131.156.32,20,3658,0,0,20,3658,0.886145000,1.0154
215.158.239.95,<->,199.20.31.127,20,2646,0,0,20,2646,0.885678000,0.9189
133.178.227.16,<->,122.158.49.117,20,3722,0,0,20,3722,0.861519000,1.0138
221.102.56.69,<->,213.38.233.112,0,0,20,2350,20,2350,0.858033000,0.7068
215.158.239.87,<->,204.226.3.45,20,2590,0,0,20,2590,0.843085000,1.1125
199.69.24.204,<->,136.25.188.199,0,0,20,1572,20,1572,0.832714000,1.0548
142.253.240.20,<->,136.25.188.211,0,0,20,2196,20,2196,0.813173000,1.0936
136.25.189.12,<->,96.156.169.203,20,7108,0,0,20,7108,0.807386000,1.0032
195.14.69.194,<->,136.25.188.176,0,0,20,2156,20,2156,0.797476000,1.0980
220.39.233.171,<->,136.25.188.226,0,0,20,5019,20,5019,0.786469000,1.1733
136.25.189.85,<->,56.28.207.205,20,21317,0,0,20,21317,0.775517000,0.9891
195.126.59.142,<->,136.25.188.253,0,0,20,2631,20,2631,0.766979000,0.6857
142.249.245.193,<->,136.25.188.209,0,0,20,2171,20,2171,0.763128000,1.2300
215.158.239.48,<->,142.236.196.209,20,2135,0,0,20,2135,0.750885000,0.9816
100.230.151.30,<->,80.27.157.131,0,0,20,3993,20,3993,0.743594000,0.3817
215.158.238.111,<->,0.195.237.14,20,26023,0,0,20,26023,0.739491000,0.3961
215.158.3.108,<->,102.51.130.116,0,0,20,21121,20,21121,0.737979000,0.6304
215.158.239.84,<->,207.236.255.124,20,2634,0,0,20,2634,0.732606000,0.7685
69.103.234.233,<->,8.252.222.23,0,0,20,2457,20,2457,0.728813000,1.0918
195.71.136.169,<->,136.25.188.54,0,0,20,1811,20,1811,0.700987000,0.5009
215.158.239.92,<->,194.251.130.243,20,2442,0,0,20,2442,0.692869000,0.5283
195.40.0.40,<->,136.25.188.177,0,0,20,1411,20,1411,0.690248000,0.8567
136.25.188.179,<->,48.131.156.32,20,6276,0,0,20,6276,0.679193000,1.2737
204.60.25.85,<->,136.25.188.196,0,0,20,2288,20,2288,0.677536000,1.0399
133.178.227.118,<->,8.3.254.154,20,1006,0,0,20,1006,0.667790000,0.1520
220.28.115.46,<->,136.25.188.49,0,0,20,25258,20,25258,0.657063000,1.1976
206.72.234.70,<->,97.198.98.50,0,0,20,1000,20,1000,0.630255000,1.0562
254.126.111.238,<->,109.2.122.176,0,0,20,7992,20,7992,0.624539000,1.1779
108.47.147.137,<->,8.52.182.119,0,0,20,2291,20,2291,0.623740000,1.3542
136.25.188.224,<->,111.151.239.91,20,7305,0,0,20,7305,0.622144000,0.6811
195.41.200.52,<->,136.25.188.209,0,0,20,2461,20,2461,0.610327000,1.2543
220.38.239.213,<->,133.178.227.42,0,0,20,2069,20,2069,0.609094000,0.1741
192.228.30.221,<->,133.178.227.243,0,0,20,3074,20,3074,0.597554000,0.5558
138.20.59.183,<->,8.52.147.55,0,0,20,2355,20,2355,0.595976000,0.0947
215.158.239.92,<->,196.90.121.195,20,2013,0,0,20,2013,0.593313000,1.2998
133.178.227.2,<->,133.56.180.90,20,11542,0,0,20,11542,0.579450000,1.3080
80.52.60.162,<->,8.220.189.63,0,0,20,1693,20,1693,0.560203000,1.4021
215.158.30.219,<->,136.25.188.234,0,0,20,22843,20,22843,0.553405000,0.2607
215.158.239.86,<->,199.20.28.113,20,2132,0,0,20,2132,0.549771000,1.0300
159.137.254.96,<->,106.17.43.150,20,2035,0,0,20,2035,0.549169000,0.8993
136.25.189.13,<->,96.156.169.244,20,10795,0,0,20,10795,0.548288000,1.3545
215.158.239.58,<->,199.20.30.18,20,2593,0,0,20,2593,0.534015000,1.2510
133.178.227.19,<->,89.86.110.235,20,4535,0,0,20,4535,0.532859000,1.2996
76.179.38.28,<->,8.252.222.7,0,0,20,1240,20,1240,0.518533000,1.4333
215.158.239.56,<->,195.81.16.191,20,2614,0,0,20,2614,0.514128000,0.7399
210.220.19.70,<->,139.163.8.98,0,0,20,1120,20,1120,0.505146000,1.3694
207.57.161.89,<->,136.25.188.220,0,0,20,5061,20,5061,0.465093000,1.5258
146.249.226.60,<->,8.252.221.197,0,0,20,1160,20,1160,0.458227000,1.4000
197.113.99.30,<->,136.25.188.46,0,0,20,2018,20,2018,0.454918000,1.2699
207.193.113.191,<->,8.252.222.141,0,0,20,3743,20,3743,0.454015000,1.4780
215.158.239.63,<->,159.215.65.150,20,26239,0,0,20,26239,0.451753000,0.8040
133.178.226.41,<->,96.155.60.211,20,12255,0,0,20,12255,0.449872000,1.4646
143.23.185.26,<->,136.25.188.253,0,0,20,2449,20,2449,0.448507000,1.5216
141.236.159.26,<->,80.27.154.150,0,0,20,3386,20,3386,0.439376000,0.9949
204.187.78.195,<->,136.25.188.222,0,0,20,2187,20,2187,0.430905000,1.5399
199.51.54.127,<->,136.25.188.253,0,0,20,2685,20,2685,0.424397000,0.9848
215.158.239.211,<->,145.82.220.164,20,11450,0,0,20,11450,0.423804000,0.4664
207.39.214.65,<->,0.195.210.42,0,0,20,1366,20,1366,0.421523000,1.5103
133.178.227.41,<->,106.188.251.54,20,4146,0,0,20,4146,0.416883000,1.0651
215.158.238.132,<->,57.210.107.9,20,6292,0,0,20,6292,0.415825000,1.5426
215.158.239.95,<->,199.70.221.36,20,3450,0,0,20,3450,0.410654000,1.4999
133.178.226.93,<->,96.155.60.205,20,16979,0,0,20,16979,0.410174000,1.4070
136.25.189.30,<->,126.219.191.52,20,7417,0,0,20,7417,0.409588000,1.4862
215.158.61.145,<->,8.176.8.224,0,0,20,16724,20,16724,0.408629000,1.4429
136.25.189.14,<->,96.156.169.245,20,10851,0,0,20,10851,0.396315000,1.5783
136.25.189.33,<->,8.222.98.100,20,12142,0,0,20,12142,0.391562000,1.5220
194.237.22.26,<->,136.25.188.176,0,0,20,2009,20,2009,0.386591000,0.4412
215.158.239.92,<->,142.247.252.8,20,1491,0,0,20,1491,0.381105000,1.3229
143.42.0.200,<->,136.25.188.198,0,0,20,2387,20,2387,0.364560000,1.6300
136.25.188.193,<->,100.224.202.157,20,15229,0,0,20,15229,0.363499000,1.6278
142.207.48.53,<->,136.25.188.163,0,0,20,2416,20,2416,0.362573000,1.6074
215.158.239.85,<->,29.213.219.104,20,4997,0,0,20,4997,0.361479000,1.2838
194.220.245.63,<->,50.223.3.228,0,0,20,1000,20,1000,0.352903000,1.5843
136.25.188.211,<->,8.252.213.29,20,2437,0,0,20,2437,0.344900000,0.4415
221.102.121.56,<->,126.87.219.73,20,1618,0,0,20,1618,0.343158000,1.5872
133.178.226.71,<->,8.53.216.225,20,4208,0,0,20,4208,0.342483000,1.2255
215.158.140.216,<->,111.151.139.154,20,7864,0,0,20,7864,0.341674000,1.6145
226.68.196.218,<->,111.181.114.114,0,0,20,13556,20,13556,0.335775000,1.3800
195.13.248.58,<->,136.25.188.252,0,0,20,2104,20,2104,0.317058000,1.0890
215.158.239.46,<->,100.224.202.179,20,24399,0,0,20,24399,0.316687000,1.4767
215.158.238.97,<->,69.31.238.42,20,3722,0,0,20,3722,0.314514000,0.5688
84.20.180.29,<->,0.195.210.33,0,0,20,1345,20,1345,0.305428000,1.3418
215.158.238.120,<->,80.47.111.74,20,3370,0,0,20,3370,0.301111000,0.7067
66.47.209.135,<->,8.252.221.223,0,0,20,1180,20,1180,0.293657000,1.5424
133.178.226.28,<->,126.219.194.160,20,5415,0,0,20,5415,0.286240000,1.6632
215.158.238.122,<->,29.214.73.166,20,2229,0,0,20,2229,0.280392000,0.2392
196.25.1.192,<->,8.52.168.63,0,0,20,1334,20,1334,0.272129000,0.7126
136.25.188.254,<->,69.150.168.232,20,5684,0,0,20,5684,0.266935000,1.4874
136.25.188.236,<->,106.188.236.250,20,6068,0,0,20,6068,0.260642000,1.7211
215.158.238.67,<->,27.178.41.9,20,4831,0,0,20,4831,0.260217000,1.1834
149.250.115.59,<->,136.25.188.178,0,0,20,4479,20,4479,0.253427000,1.0609
203.63.76.8,<->,50.224.88.92,0,0,20,1000,20,1000,0.248532000,1.7466
133.178.226.19,<->,8.219.187.251,20,6692,0,0,20,6692,0.237262000,1.7615
136.25.189.55,<->,96.156.169.209,20,19288,0,0,20,19288,0.236203000,1.5710
136.25.188.16,<->,92.58.185.135,20,1000,0,0,20,1000,0.234559000,1.7199
145.170.227.223,<->,8.52.187.43,0,0,20,3973,20,3973,0.232548000,1.6139
215.158.239.49,<->,196.105.62.165,20,2448,0,0,20,2448,0.227353000,1.4398
215.158.239.56,<->,142.228.91.8,20,2040,0,0,20,2040,0.227184000,1.5527
215.158.238.133,<->,104.3.161.24,20,3690,0,0,20,3690,0.225237000,1.6491
142.198.49.238,<->,50.223.3.228,0,0,20,1000,20,1000,0.215779000,1.7367
215.158.238.82,<->,126.219.132.246,20,3514,0,0,20,3514,0.212033000,0.9447
133.178.227.16,<->,131.22.233.154,20,9665,0,0,20,9665,0.211746000,1.6499
215.158.239.85,<->,199.51.197.185,20,1968,0,0,20,1968,0.211132000,1.2738
136.25.188.243,<->,27.178.41.26,20,3498,0,0,20,3498,0.210057000,1.5477
204.185.150.69,<->,136.25.188.52,0,0,20,1132,20,1132,0.206621000,1.6390
204.184.137.77,<->,136.25.188.255,0,0,20,2328,20,2328,0.206346000,1.7901
142.220.22.18,<->,136.25.188.208,0,0,20,1294,20,1294,0.205614000,0.9155
133.178.226.70,<->,133.56.180.7,20,8185,0,0,20,8185,0.203803000,1.2963
207.92.143.171,<->,8.252.222.187,0,0,20,1265,20,1265,0.198398000,1.7664
215.158.238.133,<->,113.23.20.106,20,3546,0,0,20,3546,0.198094000,0.6457
215.158.239.77,<->,199.20.30.212,20,2686,0,0,20,2686,0.195985000,1.1899
215.158.239.58,<->,196.107.149.137,20,2706,0,0,20,2706,0.194372000,1.6399
133.178.226.77,<->,106.188.236.172,20,4827,0,0,20,4827,0.194073000,1.2028
92.27.219.18,<->,66.244.110.20,20,1197,0,0,20,1197,0.189247000,1.7003
215.158.30.252,<->,8.252.222.230,0,0,20,22971,20,22971,0.187608000,0.5570
144.71.41.191,<->,33.58.44.223,20,2693,0,0,20,2693,0.185684000,1.6855
142.234.196.215,<->,133.178.226.31,0,0,20,6084,20,6084,0.185678000,1.6941
215.158.239.95,<->,142.254.246.164,20,1181,0,0,20,1181,0.185565000,0.2725
146.249.227.169,<->,8.252.222.97,0,0,20,1312,20,1312,0.184568000,1.8099
195.13.125.184,<->,136.25.188.237,0,0,20,2191,20,2191,0.184281000,1.0003
194.218.132.215,<->,50.223.3.228,0,0,20,1000,20,1000,0.180962000,1.6359
133.32.39.44,<->,83.243.58.120,20,1180,0,0,20,1180,0.178909000,1.7422
129.92.117.26,<->,53.239.138.161,20,2935,0,0,20,2935,0.173740000,0.1945
194.253.83.73,<->,8.252.222.206,0,0,20,1672,20,1672,0.173039000,1.3338
196.25.93.70,<->,50.223.3.228,0,0,20,1060,20,1060,0.172298000,1.6383
133.178.227.16,<->,131.144.113.150,20,3139,0,0,20,3139,0.167227000,1.4269
133.178.226.43,<->,96.155.60.252,20,6065,0,0,20,6065,0.164228000,1.2850
215.158.239.77,<->,199.20.5.239,20,3612,0,0,20,3612,0.163559000,1.7313
215.158.239.49,<->,199.20.30.3,20,1165,0,0,20,1165,0.162199000,0.3112
220.39.233.155,<->,136.25.188.254,0,0,20,7177,20,7177,0.154851000,1.5865
144.86.149.46,<->,35.56.3.196,20,2560,0,0,20,2560,0.149525000,1.8302
98.23.102.124,<->,8.252.221.249,0,0,20,9921,20,9921,0.142665000,1.7460
133.178.227.1,<->,8.53.216.49,20,3202,0,0,20,3202,0.140059000,0.2975
133.178.226.28,<->,33.209.217.221,20,9053,0,0,20,9053,0.139799000,1.6192
215.158.239.85,<->,199.20.30.55,20,1120,0,0,20,1120,0.136604000,0.3602
215.158.239.114,<->,111.151.237.118,20,22039,0,0,20,22039,0.136002000,1.2776
152.43.87.87,<->,8.252.221.223,0,0,20,2443,20,2443,0.134505000,1.7315
94.195.26.163,<->,8.252.221.222,0,0,20,1060,20,1060,0.131820000,1.7675
136.25.189.45,<->,56.28.207.201,20,4138,0,0,20,4138,0.130841000,1.8586
215.158.239.71,<->,126.219.194.88,20,7193,0,0,20,7193,0.129196000,1.8441
58.143.253.106,<->,8.252.221.198,0,0,20,1036,20,1036,0.128496000,1.8502
136.25.189.14,<->,120.154.71.52,20,9683,0,0,20,9683,0.126791000,1.8442
215.158.238.83,<->,57.210.107.1,20,6543,0,0,20,6543,0.125180000,1.6136
133.178.227.57,<->,133.56.180.21,20,10054,0,0,20,10054,0.123700000,1.7622
97.190.215.135,<->,57.144.153.193,20,1154,0,0,20,1154,0.123364000,1.8663
207.236.52.182,<->,136.25.188.253,0,0,20,1060,20,1060,0.123126000,0.5435
215.158.238.133,<->,33.209.217.237,20,9263,0,0,20,9263,0.120330000,1.6596
136.25.189.28,<->,126.219.194.17,20,11885,0,0,20,11885,0.119872000,1.8305
133.178.226.29,<->,131.1.232.151,20,5247,0,0,20,5247,0.119637000,1.2942
136.25.188.227,<->,122.158.245.90,20,5972,0,0,20,5972,0.117852000,1.7074
207.239.31.248,<->,136.25.188.252,0,0,20,3491,20,3491,0.116778000,0.6440
215.158.238.97,<->,126.219.132.237,20,4927,0,0,20,4927,0.112273000,1.7481
139.163.0.110,<->,100.78.240.208,20,1120,0,0,20,1120,0.111190000,1.8588
218.4.168.98,<->,66.90.171.112,20,1139,0,0,20,1139,0.110864000,1.7825
133.178.226.66,<->,133.56.180.1,20,21281,0,0,20,21281,0.110559000,1.7683
69.243.77.101,<->,8.252.221.196,0,0,20,1060,20,1060,0.109414000,1.7586
193.21.29.222,<->,92.27.219.192,0,0,20,27920,20,27920,0.107056000,1.8358
136.25.188.225,<->,133.23.136.210,20,1237,0,0,20,1237,0.106598000,1.2944
124.69.78.221,<->,8.52.252.204,0,0,20,1042,20,1042,0.105929000,1.8015
142.253.225.218,<->,136.25.188.236,0,0,20,1165,20,1165,0.105846000,0.1538
215.158.239.70,<->,142.236.193.144,20,1813,0,0,20,1813,0.105760000,0.5475
212.164.140.188,<->,101.80.35.193,20,1120,0,0,20,1120,0.104190000,1.7658
195.40.236.53,<->,136.25.188.209,0,0,20,2794,20,2794,0.102052000,1.8959
136.25.188.254,<->,126.219.194.170,20,8398,0,0,20,8398,0.100138000,1.7425
136.25.189.53,<->,96.156.169.173,20,21656,0,0,20,21656,0.096458000,1.7816
100.81.65.164,<->,50.224.88.96,0,0,20,1120,20,1120,0.096320000,1.8335
228.114.187.55,<->,50.224.61.154,0,0,20,1120,20,1120,0.095846000,1.9021
136.139.59.127,<->,136.25.188.226,0,0,20,4671,20,4671,0.093313000,1.8200
215.158.239.50,<->,207.228.242.169,20,1237,0,0,20,1237,0.092936000,1.3201
215.158.239.57,<->,142.227.70.96,20,5736,0,0,20,5736,0.090401000,1.0277
156.154.241.246,<->,8.252.221.222,0,0,20,1066,20,1066,0.089805000,1.8215
220.39.233.211,<->,136.25.188.163,0,0,20,6004,20,6004,0.087593000,1.6921
139.163.17.163,<->,110.20.37.91,20,1000,0,0,20,1000,0.086617000,1.9081
213.186.52.90,<->,139.163.8.98,0,0,20,1120,20,1120,0.086079000,1.9128
139.163.0.100,<->,128.135.182.42,20,1120,0,0,20,1120,0.083677000,1.9000
145.57.96.195,<->,139.163.8.98,0,0,20,1120,20,1120,0.082604000,1.9087
139.163.0.100,<->,91.69.185.183,20,1120,0,0,20,1120,0.082599000,1.9118
152.40.104.74,<->,8.252.221.196,0,0,20,1036,20,1036,0.079344000,1.7564
139.163.0.100,<->,91.69.185.154,20,1120,0,0,20,1120,0.078654000,1.9125
139.163.0.100,<->,82.162.10.172,20,1120,0,0,20,1120,0.078473000,1.9081
139.163.8.98,<->,91.69.185.188,20,1120,0,0,20,1120,0.077507000,1.9147
139.163.0.100,<->,91.69.185.218,20,1120,0,0,20,1120,0.076950000,1.9116
139.163.8.107,<->,103.0.30.102,20,1120,0,0,20,1120,0.076410000,1.8249
215.158.238.82,<->,106.188.183.116,20,4195,0,0,20,4195,0.076191000,1.6038
8.252.222.115,<->,4.122.110.170,20,1204,0,0,20,1204,0.075354000,1.7459
195.65.1.185,<->,133.178.227.24,0,0,20,5039,20,5039,0.075181000,1.7015
149.250.115.24,<->,136.25.188.197,0,0,20,4775,20,4775,0.071340000,1.7581
139.163.0.106,<->,56.109.45.241,20,1120,0,0,20,1120,0.070271000,1.9203
237.147.16.247,<->,139.163.8.98,0,0,20,1120,20,1120,0.069946000,1.9202
215.158.239.57,<->,133.146.0.254,20,10147,0,0,20,10147,0.069811000,1.9252
215.158.140.60,<->,113.23.14.216,20,5529,0,0,20,5529,0.069706000,1.3164
215.158.239.86,<->,126.219.191.27,20,4975,0,0,20,4975,0.068401000,1.8112
215.158.238.133,<->,56.161.218.41,20,7593,0,0,20,7593,0.068075000,1.8663
213.186.59.251,<->,139.163.33.76,0,0,20,1120,20,1120,0.066188000,1.8922
249.114.124.114,<->,139.163.17.163,0,0,20,1120,20,1120,0.066182000,1.9125
139.163.8.107,<->,98.3.191.156,20,1120,0,0,20,1120,0.065694000,1.9331
215.158.238.134,<->,131.144.113.183,20,5780,0,0,20,5780,0.065248000,1.7781
195.43.51.41,<->,136.25.188.236,0,0,20,1120,20,1120,0.064086000,0.0288
215.158.238.93,<->,8.222.109.107,20,1248,0,0,20,1248,0.063755000,1.8414
213.186.61.52,<->,139.163.8.107,0,0,20,1120,20,1120,0.062379000,1.9100
145.57.63.191,<->,139.163.8.98,0,0,20,1120,20,1120,0.061861000,1.9163
194.221.7.248,<->,50.223.3.228,0,0,20,1018,20,1018,0.061068000,1.8588
139.163.0.100,<->,91.69.185.251,20,1120,0,0,20,1120,0.060218000,1.9070
215.158.239.48,<->,199.20.31.19,20,2734,0,0,20,2734,0.059995000,1.5699
215.158.30.252,<->,8.252.222.34,0,0,20,21673,20,21673,0.059836000,0.2601
133.178.226.7,<->,69.150.168.203,20,9747,0,0,20,9747,0.059744000,1.7571
133.178.227.76,<->,133.56.180.49,20,11179,0,0,20,11179,0.059609000,1.9124
139.163.8.107,<->,101.113.107.21,20,1120,0,0,20,1120,0.059588000,1.9304
215.158.238.250,<->,130.165.253.35,20,5173,0,0,20,5173,0.059116000,1.8391
213.186.59.136,<->,50.224.51.129,0,0,20,1120,20,1120,0.058877000,1.9034
136.25.188.44,<->,80.47.111.72,20,8170,0,0,20,8170,0.058716000,1.9077
145.57.190.242,<->,139.163.8.98,0,0,20,1120,20,1120,0.058686000,1.9142
221.196.127.107,<->,139.163.8.107,0,0,20,1120,20,1120,0.056338000,1.9296
139.163.0.100,<->,91.69.181.176,20,1120,0,0,20,1120,0.056265000,1.9158
139.163.0.100,<->,107.116.62.128,20,1120,0,0,20,1120,0.055926000,1.9105
210.44.62.45,<->,50.224.105.45,0,0,20,1120,20,1120,0.054601000,1.9362
91.69.181.249,<->,50.224.105.41,0,0,20,1120,20,1120,0.054032000,1.9365
215.158.239.95,<->,204.3.64.250,20,1325,0,0,20,1325,0.053996000,1.0600
110.87.242.110,<->,50.224.105.45,0,0,20,1120,20,1120,0.053987000,1.9361
139.163.0.100,<->,100.24.240.107,20,1120,0,0,20,1120,0.052625000,1.9216
210.227.197.43,<->,50.224.61.115,0,0,20,7219,20,7219,0.050866000,1.8979
139.163.0.100,<->,98.87.187.86,20,1120,0,0,20,1120,0.050570000,1.9091
142.255.52.178,<->,136.25.188.222,0,0,20,1094,20,1094,0.049974000,1.7461
215.158.239.70,<->,142.236.228.100,20,2619,0,0,20,2619,0.049657000,1.4810
136.25.188.49,<->,80.57.141.206,20,21673,0,0,20,21673,0.049132000,0.2324
8.252.221.204,<->,4.123.178.5,20,1036,0,0,20,1036,0.049003000,1.8141
139.163.0.100,<->,91.69.184.27,20,1120,0,0,20,1120,0.048764000,1.9119
139.163.8.107,<->,98.3.185.126,20,1120,0,0,20,1120,0.047384000,1.8983
207.239.154.200,<->,136.25.188.198,0,0,20,1340,20,1340,0.046811000,0.7438
136.217.111.229,<->,50.224.105.43,0,0,20,1120,20,1120,0.044537000,1.9223
213.186.52.114,<->,139.163.0.100,0,0,20,1120,20,1120,0.043983000,1.9108
137.210.168.171,<->,50.224.51.129,0,0,20,1000,20,1000,0.043270000,1.8944
215.158.238.141,<->,33.209.217.244,20,8071,0,0,20,8071,0.043009000,1.8712
139.163.0.100,<->,82.162.9.245,20,1144,0,0,20,1144,0.042744000,1.9200
212.164.135.173,<->,91.69.181.139,20,1120,0,0,20,1120,0.042480000,1.8912
215.158.239.76,<->,207.213.128.20,20,2068,0,0,20,2068,0.042133000,1.9101
91.69.185.172,<->,50.224.105.45,0,0,20,1120,20,1120,0.041640000,1.9335
91.69.185.141,<->,50.224.105.45,0,0,20,1120,20,1120,0.041329000,1.9337
116.108.200.72,<->,20.207.104.204,0,0,20,2032,20,2032,0.041270000,1.8813
213.186.59.139,<->,139.163.8.98,0,0,20,1120,20,1120,0.041260000,1.9157
139.163.8.107,<->,132.77.25.142,20,1120,0,0,20,1120,0.040836000,1.9200
213.186.52.12,<->,50.224.105.45,0,0,20,1120,20,1120,0.040823000,1.9337
213.221.90.238,<->,139.163.8.107,0,0,20,1120,20,1120,0.040598000,1.9232
229.96.180.39,<->,8.181.37.222,20,25094,0,0,20,25094,0.040492000,0.2596
102.47.132.35,<->,50.224.105.41,0,0,20,1120,20,1120,0.040231000,1.9301
91.69.185.177,<->,50.224.105.45,0,0,20,1120,20,1120,0.039079000,1.9342
195.55.27.126,<->,136.25.188.176,0,0,20,2180,20,2180,0.038151000,1.9531
139.163.0.100,<->,91.69.181.208,20,1120,0,0,20,1120,0.036948000,1.9128
98.87.186.180,<->,50.224.105.45,0,0,20,1120,20,1120,0.036904000,1.9334
215.158.238.123,<->,131.1.253.210,20,4864,0,0,20,4864,0.036397000,1.9188
199.90.42.21,<->,50.224.105.41,0,0,20,1000,20,1000,0.035791000,1.9290
215.158.239.69,<->,199.20.28.20,20,1966,0,0,20,1966,0.035765000,1.1600
215.158.239.87,<->,143.89.215.76,20,1288,0,0,20,1288,0.035429000,1.7093
143.35.73.5,<->,136.25.188.220,0,0,20,2449,20,2449,0.035361000,0.9350
139.163.0.100,<->,91.69.181.243,20,1120,0,0,20,1120,0.033577000,1.9159
213.221.90.185,<->,139.163.8.107,0,0,20,1120,20,1120,0.033422000,1.9249
213.186.61.82,<->,139.163.8.107,0,0,20,1120,20,1120,0.033278000,1.9245
239.66.236.178,<->,139.163.0.110,0,0,20,1120,20,1120,0.031484000,1.9196
144.85.170.244,<->,98.87.146.92,20,1336,0,0,20,1336,0.031387000,1.9510
139.163.8.107,<->,101.246.123.240,20,1120,0,0,20,1120,0.031277000,1.9271
100.76.141.170,<->,50.224.105.42,0,0,20,1120,20,1120,0.030582000,1.9344
114.216.173.200,<->,92.27.219.51,0,0,20,20380,20,20380,0.030272000,1.9330
98.87.186.65,<->,50.224.105.45,0,0,20,1120,20,1120,0.030246000,1.9303
247.136.220.220,<->,139.241.56.102,20,25639,0,0,20,25639,0.030239000,1.8801
136.25.188.177,<->,100.224.202.172,20,11648,0,0,20,11648,0.030170000,1.5477
215.158.61.191,<->,8.176.8.248,0,0,20,20815,20,20815,0.029677000,1.9213
136.25.189.76,<->,80.56.79.71,20,8756,0,0,20,8756,0.029664000,1.9247
215.158.238.133,<->,29.211.238.65,20,1120,0,0,20,1120,0.028818000,0.1529
159.15.77.8,<->,139.163.8.107,0,0,20,1120,20,1120,0.028411000,1.9243
139.163.0.100,<->,110.50.43.235,20,1120,0,0,20,1120,0.028139000,1.9248
145.13.164.185,<->,136.25.189.34,0,0,20,10324,20,10324,0.027718000,1.5856
50.224.61.152,<->,50.22.250.161,20,1120,0,0,20,1120,0.027705000,1.8788
91.69.185.217,<->,50.224.105.45,0,0,20,1120,20,1120,0.026980000,1.9298
139.163.0.100,<->,97.182.242.25,20,1120,0,0,20,1120,0.026368000,1.8295
221.196.127.68,<->,139.163.8.107,0,0,20,1120,20,1120,0.026324000,1.9103
215.158.239.35,<->,29.211.5.201,20,7008,0,0,20,7008,0.026199000,1.2609
239.66.72.43,<->,102.50.37.229,0,0,20,25698,20,25698,0.026115000,1.7838
98.87.149.11,<->,50.224.105.45,0,0,20,1120,20,1120,0.026102000,1.9301
132.249.70.233,<->,91.54.155.124,20,1566,0,0,20,1566,0.025713000,1.6966
207.193.113.144,<->,8.252.222.199,0,0,20,1036,20,1036,0.025700000,1.8957
136.25.188.105,<->,132.5.71.202,20,4415,0,0,20,4415,0.023821000,1.8538
139.163.8.107,<->,98.3.219.83,20,1120,0,0,20,1120,0.023704000,1.9088
136.25.188.210,<->,122.158.245.86,20,8414,0,0,20,8414,0.023675000,1.9157
139.163.20.253,<->,110.66.15.168,20,1000,0,0,20,1000,0.023500000,1.9165
139.163.0.106,<->,99.235.25.46,20,1120,0,0,20,1120,0.023365000,1.9224
205.127.108.115,<->,111.20.168.209,0,0,20,8259,20,8259,0.023082000,1.9315
199.70.191.248,<->,136.25.188.238,0,0,20,1078,20,1078,0.022857000,0.6183
152.43.87.87,<->,8.252.221.206,0,0,20,2449,20,2449,0.022654000,1.8186
144.54.95.245,<->,139.163.8.107,0,0,20,1120,20,1120,0.022127000,1.9092
50.224.105.45,<->,6.21.244.66,20,1120,0,0,20,1120,0.021861000,1.9294
136.25.188.197,<->,112.220.206.12,20,7289,0,0,20,7289,0.021214000,1.6926
197.107.14.244,<->,136.25.188.243,0,0,20,1012,20,1012,0.020642000,1.2783
133.178.227.16,<->,131.144.116.213,20,5118,0,0,20,5118,0.020631000,1.8414
50.224.105.45,<->,42.71.193.254,20,1120,0,0,20,1120,0.019220000,1.9257
91.69.181.133,<->,50.224.105.45,0,0,20,1120,20,1120,0.019205000,1.9296
136.25.189.28,<->,29.214.73.167,20,2261,0,0,20,2261,0.017343000,1.7173
215.158.239.92,<->,207.213.60.85,20,2804,0,0,20,2804,0.016828000,0.6618
50.224.78.133,<->,6.213.116.109,20,1120,0,0,20,1120,0.016693000,1.9124
139.163.8.107,<->,98.87.145.42,20,1120,0,0,20,1120,0.016510000,1.8794
136.25.189.1,<->,126.219.194.9,20,8975,0,0,20,8975,0.015210000,1.3808
137.123.84.215,<->,50.224.61.152,0,0,20,1120,20,1120,0.014432000,1.9153
215.158.238.148,<->,131.1.253.250,20,5111,0,0,20,5111,0.014295000,1.9499
213.186.52.38,<->,50.224.105.45,0,0,20,1120,20,1120,0.014245000,1.9293
136.25.188.220,<->,48.25.220.86,20,1972,0,0,20,1972,0.013857000,1.4563
50.224.68.210,<->,6.210.196.126,20,1000,0,0,20,1000,0.011298000,1.9174
213.186.59.164,<->,139.163.8.107,0,0,20,1120,20,1120,0.010572000,1.9191
133.178.227.2,<->,131.144.112.235,20,4246,0,0,20,4246,0.010479000,1.0028
99.42.222.141,<->,50.224.108.39,0,0,20,1000,20,1000,0.010372000,1.9100
149.97.149.24,<->,50.224.68.210,0,0,20,1120,20,1120,0.010264000,1.9183
136.25.189.12,<->,96.156.169.169,20,9674,0,0,20,9674,0.009851000,1.8381
139.163.8.98,<->,46.38.48.250,20,1120,0,0,20,1120,0.009832000,1.9484
220.28.115.46,<->,215.158.238.129,0,0,20,23438,20,23438,0.009543000,1.3566
133.178.227.57,<->,133.56.180.32,20,7790,0,0,20,7790,0.009431000,1.9029
231.141.0.244,<->,215.158.239.92,0,0,20,2627,20,2627,0.009209000,1.8090
103.144.124.204,<->,50.224.68.210,0,0,20,1000,20,1000,0.008942000,1.9183
215.158.239.49,<->,199.20.5.74,20,1210,0,0,20,1210,0.008336000,0.6300
156.150.157.123,<->,8.252.222.140,0,0,20,2391,20,2391,0.008174000,1.8002
215.158.238.75,<->,131.1.195.185,20,9196,0,0,20,9196,0.006735000,1.9462
231.141.204.236,<->,136.25.188.243,0,0,20,4279,20,4279,0.005783000,1.9099
215.158.2.115,<->,8.176.8.71,0,0,20,9965,20,9965,0.005721000,1.7286
204.62.118.170,<->,136.25.188.162,0,0,20,2754,20,2754,0.005601000,0.7671
215.158.238.114,<->,104.3.161.24,20,3610,0,0,20,3610,0.005378000,1.9239
215.158.238.220,<->,93.39.51.85,20,2111,0,0,20,2111,0.004980000,0.4202
139.163.0.100,<->,98.87.186.52,20,1120,0,0,20,1120,0.004905000,1.9180
215.158.239.95,<->,207.57.122.110,20,1772,0,0,20,1772,0.003929000,0.9756
215.158.238.177,<->,126.219.246.238,20,6215,0,0,20,6215,0.003265000,1.9959
136.217.0.38,<->,50.224.105.41,0,0,20,1120,20,1120,0.003146000,1.9263
215.158.140.207,<->,6.15.196.209,20,1120,0,0,20,1120,0.002306000,1.8380
50.224.105.44,<->,18.203.58.62,20,1120,0,0,20,1120,0.002008000,1.9304
142.190.228.6,<->,136.25.188.209,0,0,20,2390,20,2390,0.001911000,1.1476
139.163.0.106,<->,139.128.173.135,20,1120,0,0,20,1120,0.001719000,1.9222
136.25.188.46,<->,126.219.194.148,20,7369,0,0,20,7369,0.001059000,1.2425
94.195.235.119,<->,8.252.221.196,0,0,20,1060,20,1060,0.000942000,1.9463
91.69.185.240,<->,50.224.105.44,0,0,20,1120,20,1120,0.000676000,1.9363
216.184.1.125,<->,8.252.222.27,0,0,19,20574,19,20574,1.742526000,0.2459
216.184.1.103,<->,8.252.222.169,0,0,19,21614,19,21614,1.695262000,0.0883
221.196.123.231,<->,136.25.188.173,0,0,19,1697,19,1697,1.683971000,0.2952
220.20.200.91,<->,132.216.159.4,19,21666,0,0,19,21666,1.669103000,0.2798
194.232.165.179,<->,136.25.188.175,0,0,19,1773,19,1773,1.642020000,0.3461
137.137.103.123,<->,123.212.48.165,19,17996,0,0,19,17996,1.619575000,0.2780
136.25.188.213,<->,80.57.141.161,19,20547,0,0,19,20547,1.585088000,0.1376
136.25.188.213,<->,56.51.205.162,19,20572,0,0,19,20572,1.509421000,0.4887
210.221.107.50,<->,8.222.6.88,19,24328,0,0,19,24328,1.482256000,0.3748
207.60.34.137,<->,136.25.188.174,0,0,19,1933,19,1933,1.394150000,0.5147
197.113.99.27,<->,136.25.188.252,0,0,19,1833,19,1833,1.367315000,0.2990
136.25.188.161,<->,113.20.94.98,19,2301,0,0,19,2301,1.355443000,0.6116
129.224.112.252,<->,97.242.126.186,19,1278,0,0,19,1278,1.354836000,0.6045
136.25.188.202,<->,80.57.141.161,19,19075,0,0,19,19075,1.257178000,0.0926
207.172.137.205,<->,136.25.188.237,0,0,19,2021,19,2021,1.209262000,0.5294
215.158.238.73,<->,131.1.195.229,19,3745,0,0,19,3745,1.172415000,0.6138
215.158.239.55,<->,80.57.141.179,19,17891,0,0,19,17891,1.151384000,0.1427
133.178.227.2,<->,80.57.141.55,19,2277,0,0,19,2277,1.066681000,0.0721
220.50.215.89,<->,50.224.80.75,0,0,19,4337,19,4337,1.066626000,0.8465
215.158.239.57,<->,199.20.30.126,19,1101,0,0,19,1101,1.034560000,0.9499
215.158.239.70,<->,207.236.179.176,19,3458,0,0,19,3458,1.021496000,0.7706
133.178.227.2,<->,133.56.180.95,19,9575,0,0,19,9575,1.017273000,0.9290
142.228.131.170,<->,136.25.188.220,0,0,19,2576,19,2576,0.989069000,0.9488
133.178.227.2,<->,29.211.228.152,19,5211,0,0,19,5211,0.974434000,1.0150
215.158.238.141,<->,131.36.198.123,19,6473,0,0,19,6473,0.920829000,1.0148
97.230.215.131,<->,8.52.186.156,0,0,19,3357,19,3357,0.917333000,1.0377
136.25.189.22,<->,96.156.169.209,19,15806,0,0,19,15806,0.909554000,1.0412
221.102.123.31,<->,204.140.169.186,19,1138,0,0,19,1138,0.886407000,1.0400
215.158.239.49,<->,194.251.138.47,19,2099,0,0,19,2099,0.877478000,0.9105
215.158.238.6,<->,192.224.20.83,19,4290,0,0,19,4290,0.868504000,0.5417
66.58.105.211,<->,8.252.221.198,0,0,19,2437,19,2437,0.862052000,0.7193
136.25.188.176,<->,131.1.195.246,19,6636,0,0,19,6636,0.841591000,0.9222
215.158.238.223,<->,69.31.238.218,19,2413,0,0,19,2413,0.827465000,0.3356
215.158.238.64,<->,57.210.107.19,19,3330,0,0,19,3330,0.808888000,0.9328
133.178.227.14,<->,8.219.184.110,19,4432,0,0,19,4432,0.758441000,1.1996
215.158.239.95,<->,196.90.120.144,19,3512,0,0,19,3512,0.731794000,1.1397
215.158.239.76,<->,199.20.5.88,19,2579,0,0,19,2579,0.727500000,1.1709
195.13.28.254,<->,136.25.188.177,0,0,19,2391,19,2391,0.726361000,0.8547
192.170.245.62,<->,136.25.189.2,0,0,19,3308,19,3308,0.725751000,0.1269
215.158.239.48,<->,199.20.4.163,19,1064,0,0,19,1064,0.720576000,0.8615
207.56.104.108,<->,136.25.188.177,0,0,19,2396,19,2396,0.716278000,1.2828
215.158.239.58,<->,199.20.29.215,19,2111,0,0,19,2111,0.712748000,1.2604
215.158.140.241,<->,131.144.116.37,19,4225,0,0,19,4225,0.704699000,1.2360
215.158.239.76,<->,196.1.173.85,19,1064,0,0,19,1064,0.699713000,0.6600
142.223.185.89,<->,136.25.188.222,0,0,19,2099,19,2099,0.667058000,1.1062
100.123.0.59,<->,92.162.253.130,0,0,19,23598,19,23598,0.651755000,0.0240
111.151.237.2,<->,98.236.87.190,0,0,19,24248,19,24248,0.627920000,0.7421
215.158.239.56,<->,199.20.30.25,19,1495,0,0,19,1495,0.626819000,0.4906
207.59.132.245,<->,136.25.188.226,0,0,19,1916,19,1916,0.625611000,0.2880
215.158.239.78,<->,199.20.28.23,19,2662,0,0,19,2662,0.613720000,1.2806
197.105.108.14,<->,136.25.188.241,0,0,19,2808,19,2808,0.599836000,1.2033
143.135.73.220,<->,136.25.188.177,0,0,19,1915,19,1915,0.591696000,0.5773
133.178.226.7,<->,119.196.23.71,19,5996,0,0,19,5996,0.591610000,1.1965
215.158.238.250,<->,61.72.108.171,19,2979,0,0,19,2979,0.588285000,1.2671
136.25.188.237,<->,116.99.180.180,19,3474,0,0,19,3474,0.574673000,1.2451
215.158.239.69,<->,199.20.31.43,19,2760,0,0,19,2760,0.562791000,1.0901
220.20.200.99,<->,132.216.159.4,19,20187,0,0,19,20187,0.560260000,0.5689
215.158.238.94,<->,131.144.113.148,19,7425,0,0,19,7425,0.557344000,1.3312
215.158.239.50,<->,199.20.5.232,19,2242,0,0,19,2242,0.556293000,0.8905
215.158.140.92,<->,8.190.217.1,19,3634,0,0,19,3634,0.552790000,0.5815
159.36.5.214,<->,136.25.188.253,0,0,19,2132,19,2132,0.546788000,0.1313
215.158.239.99,<->,199.20.30.215,19,2083,0,0,19,2083,0.542102000,1.2298
144.85.170.246,<->,98.87.144.212,19,1160,0,0,19,1160,0.528454000,1.4710
215.158.133.22,<->,8.176.8.183,0,0,19,6266,19,6266,0.526485000,1.4257
215.158.239.63,<->,106.188.183.100,19,24023,0,0,19,24023,0.517695000,0.1036
139.36.120.118,<->,99.74.26.151,0,0,19,3895,19,3895,0.510373000,1.1746
133.178.226.49,<->,91.57.173.21,19,3834,0,0,19,3834,0.496509000,1.1059
136.25.188.197,<->,100.224.202.175,19,11841,0,0,19,11841,0.493409000,1.1144
215.158.238.101,<->,0.195.253.228,19,23563,0,0,19,23563,0.486645000,0.8856
136.25.188.196,<->,80.47.111.24,19,7105,0,0,19,7105,0.481673000,1.4081
215.158.238.94,<->,38.104.11.41,19,6428,0,0,19,6428,0.472592000,1.4816
207.237.137.5,<->,136.25.188.211,0,0,19,1914,19,1914,0.468388000,1.1198
136.25.188.242,<->,116.106.61.245,19,3666,0,0,19,3666,0.461592000,0.9351
215.158.239.51,<->,195.6.47.59,19,2196,0,0,19,2196,0.452530000,1.4180
221.102.143.189,<->,109.1.35.27,0,0,19,22867,19,22867,0.449305000,0.1424
136.25.188.177,<->,111.2.132.128,19,3360,0,0,19,3360,0.435067000,0.4052
216.184.2.177,<->,6.73.247.53,0,0,19,26690,19,26690,0.432059000,0.0002
207.59.237.91,<->,136.25.188.225,0,0,19,2503,19,2503,0.406161000,1.4204
199.73.186.99,<->,136.25.188.173,0,0,19,3150,19,3150,0.401141000,1.0895
133.178.226.14,<->,96.155.60.212,19,9195,0,0,19,9195,0.387133000,0.7850
8.252.221.197,<->,4.123.45.57,19,5923,0,0,19,5923,0.378627000,1.5753
152.40.102.175,<->,8.252.222.93,0,0,19,1460,19,1460,0.377228000,1.2580
99.187.125.122,<->,8.20.87.3,0,0,19,18682,19,18682,0.373092000,0.3019
215.158.238.68,<->,0.195.253.228,19,26182,0,0,19,26182,0.366683000,0.0248
215.158.238.250,<->,18.202.90.172,19,3425,0,0,19,3425,0.366450000,1.3937
136.25.189.80,<->,29.211.228.165,19,7157,0,0,19,7157,0.364232000,1.3130
17.12.130.178,<->,8.220.206.67,0,0,19,2024,19,2024,0.361646000,0.3436
215.158.238.73,<->,106.188.183.91,19,2152,0,0,19,2152,0.358331000,0.4012
196.247.95.61,<->,136.25.188.225,0,0,19,1028,19,1028,0.354788000,0.9000
196.94.112.182,<->,50.224.76.248,0,0,19,1625,19,1625,0.346094000,0.8435
215.158.238.123,<->,136.139.59.102,19,2030,0,0,19,2030,0.342830000,0.3138
215.158.239.92,<->,194.199.203.105,19,1733,0,0,19,1733,0.337785000,0.5199
215.158.238.104,<->,80.47.111.66,19,7229,0,0,19,7229,0.332642000,1.2912
215.158.239.87,<->,142.221.134.198,19,2901,0,0,19,2901,0.330288000,0.9416
192.204.123.37,<->,136.25.189.77,0,0,19,8662,19,8662,0.313681000,1.6291
143.89.71.49,<->,136.25.188.225,0,0,19,1198,19,1198,0.311449000,0.8049
133.178.226.77,<->,112.220.206.117,19,3410,0,0,19,3410,0.302274000,1.5089
215.158.238.135,<->,113.23.20.95,19,6012,0,0,19,6012,0.301805000,1.5834
147.183.19.90,<->,8.252.221.230,0,0,19,3169,19,3169,0.301702000,1.6316
215.158.239.48,<->,195.127.171.142,19,2156,0,0,19,2156,0.299488000,0.7389
213.155.190.188,<->,50.224.88.92,0,0,19,1064,19,1064,0.290510000,1.6882
215.158.239.84,<->,196.94.238.65,19,2706,0,0,19,2706,0.286280000,1.6888
136.25.188.254,<->,132.97.204.206,19,2353,0,0,19,2353,0.282068000,0.2268
136.25.189.30,<->,6.15.207.105,19,7281,0,0,19,7281,0.280274000,1.0327
80.42.184.215,<->,8.55.237.110,19,4236,0,0,19,4236,0.267311000,1.3303
215.158.239.51,<->,199.20.28.85,19,1923,0,0,19,1923,0.266892000,1.6909
215.158.44.211,<->,136.25.189.0,0,0,19,10496,19,10496,0.256384000,1.5640
133.178.227.22,<->,133.56.180.94,19,22717,0,0,19,22717,0.256152000,1.6285
215.158.239.92,<->,195.55.146.191,19,2015,0,0,19,2015,0.254020000,1.2225
212.70.227.60,<->,56.121.60.30,0,0,19,25125,19,25125,0.249621000,1.6559
225.159.165.74,<->,50.224.88.92,0,0,19,950,19,950,0.247533000,1.6040
215.158.239.23,<->,96.135.154.114,19,19766,0,0,19,19766,0.241249000,1.2896
136.25.188.174,<->,29.214.108.191,19,5676,0,0,19,5676,0.231910000,1.2469
215.158.140.76,<->,111.150.187.215,19,5618,0,0,19,5618,0.224317000,1.4870
215.158.238.75,<->,119.196.23.42,19,4519,0,0,19,4519,0.218974000,1.7059
215.158.238.135,<->,33.209.217.203,19,10379,0,0,19,10379,0.203204000,1.7149
136.25.189.25,<->,96.156.169.236,19,18603,0,0,19,18603,0.201569000,1.0475
215.158.238.133,<->,65.27.228.202,19,4691,0,0,19,4691,0.199548000,1.5721
215.158.238.143,<->,113.23.104.221,19,8198,0,0,19,8198,0.199168000,1.7461
143.132.83.17,<->,136.25.188.242,0,0,19,1741,19,1741,0.197200000,0.7713
215.158.239.24,<->,96.135.154.114,19,20306,0,0,19,20306,0.193790000,1.7055
199.32.118.83,<->,136.25.188.236,0,0,19,962,19,962,0.191042000,0.5595
133.178.226.38,<->,57.227.83.251,19,3470,0,0,19,3470,0.184693000,1.7684
215.158.239.76,<->,215.158.44.185,19,12181,0,0,19,12181,0.184412000,1.8110
136.25.189.81,<->,96.156.169.163,19,9174,0,0,19,9174,0.180690000,1.2357
215.158.238.190,<->,8.220.54.105,19,6436,0,0,19,6436,0.179562000,1.7628
215.158.238.64,<->,113.23.20.116,19,5692,0,0,19,5692,0.178081000,1.5446
133.178.226.31,<->,8.179.43.91,19,4903,0,0,19,4903,0.177531000,1.5274
207.236.202.206,<->,136.25.188.241,0,0,19,1064,19,1064,0.177115000,0.4095
133.178.226.77,<->,96.155.60.232,19,10441,0,0,19,10441,0.175953000,1.5215
133.178.227.16,<->,133.56.180.48,19,9588,0,0,19,9588,0.173514000,1.8237
204.186.106.155,<->,136.25.188.174,0,0,19,1064,19,1064,0.170571000,0.1505
246.108.106.178,<->,111.147.80.111,0,0,19,12417,19,12417,0.166275000,1.6798
231.142.103.130,<->,136.25.188.177,0,0,19,2394,19,2394,0.164709000,0.7328
199.39.215.192,<->,136.25.188.209,0,0,19,2566,19,2566,0.155957000,0.9855
220.20.200.22,<->,112.219.43.107,19,24725,0,0,19,24725,0.155652000,0.5426
95.245.118.128,<->,8.252.221.198,0,0,19,1532,19,1532,0.154375000,1.6941
215.158.239.58,<->,196.95.163.249,19,6275,0,0,19,6275,0.150167000,1.3380
145.98.215.25,<->,139.163.0.110,0,0,19,1064,19,1064,0.150158000,1.8123
215.158.238.134,<->,131.1.232.161,19,3666,0,0,19,3666,0.146577000,1.8521
215.158.238.188,<->,8.219.185.56,19,3490,0,0,19,3490,0.139878000,1.7986
215.158.239.78,<->,207.115.97.255,19,2110,0,0,19,2110,0.138097000,1.4503
133.178.227.86,<->,10.186.7.76,19,950,0,0,19,950,0.136114000,1.7606
215.158.238.141,<->,80.47.111.74,19,4551,0,0,19,4551,0.134590000,1.8641
133.178.227.79,<->,33.209.219.25,19,4775,0,0,19,4775,0.134197000,1.7324
91.100.187.90,<->,50.224.88.92,0,0,19,1064,19,1064,0.133354000,1.7081
245.244.35.73,<->,8.182.228.219,0,0,19,1332,19,1332,0.132830000,1.8188
215.158.140.241,<->,8.191.7.251,19,5578,0,0,19,5578,0.131777000,1.6177
109.222.223.196,<->,98.197.184.11,19,6731,0,0,19,6731,0.129068000,1.0164
197.125.126.182,<->,133.178.226.7,0,0,19,7377,19,7377,0.128710000,1.7937
234.121.18.121,<->,97.198.98.33,0,0,19,1064,19,1064,0.126291000,1.8142
50.224.105.41,<->,6.194.254.99,19,1064,0,0,19,1064,0.125825000,1.8192
215.158.239.95,<->,196.93.134.85,19,1669,0,0,19,1669,0.124931000,1.6901
43.52.48.157,<->,8.252.221.220,0,0,19,1112,19,1112,0.124606000,1.7200
215.158.239.59,<->,29.212.180.246,19,3474,0,0,19,3474,0.122042000,1.4454
143.128.120.135,<->,136.25.188.239,0,0,19,2157,19,2157,0.121582000,1.8535
215.158.239.84,<->,196.106.160.213,19,1848,0,0,19,1848,0.121536000,0.9699
221.102.56.46,<->,220.83.32.78,0,0,19,7420,19,7420,0.121308000,0.6280
215.158.238.92,<->,126.219.132.253,19,7617,0,0,19,7617,0.120379000,1.7036
215.158.239.94,<->,96.135.155.29,19,12325,0,0,19,12325,0.119673000,1.8684
199.14.5.196,<->,136.25.188.220,0,0,19,2123,19,2123,0.118655000,0.8594
142.195.47.244,<->,136.25.188.222,0,0,19,2019,19,2019,0.118416000,1.1010
104.70.118.211,<->,89.183.104.237,0,0,19,8716,19,8716,0.117226000,1.8519
136.25.188.197,<->,122.158.245.102,19,7037,0,0,19,7037,0.116943000,1.5069
215.158.3.191,<->,133.178.227.250,0,0,19,3229,19,3229,0.115050000,0.0295
133.178.226.37,<->,122.158.245.90,19,7249,0,0,19,7249,0.113540000,1.6613
215.158.239.205,<->,148.140.162.140,19,8473,0,0,19,8473,0.113355000,0.5156
221.196.127.129,<->,139.163.0.101,0,0,19,1064,19,1064,0.112700000,1.7810
207.173.107.121,<->,136.25.188.178,0,0,19,1939,19,1939,0.111863000,1.0245
136.25.189.77,<->,118.20.100.91,19,6268,0,0,19,6268,0.111678000,1.5936
136.25.189.94,<->,96.156.169.209,19,16949,0,0,19,16949,0.109198000,1.7095
223.115.220.58,<->,8.252.221.236,0,0,19,1408,19,1408,0.108436000,1.6115
136.25.189.29,<->,33.209.219.165,19,9830,0,0,19,9830,0.108436000,1.7564
215.158.239.50,<->,194.234.172.202,19,4304,0,0,19,4304,0.105738000,1.5464
133.178.227.79,<->,8.190.216.195,19,4123,0,0,19,4123,0.105699000,1.7759
199.68.83.137,<->,136.25.188.222,0,0,19,2513,19,2513,0.101050000,1.1038
126.88.32.178,<->,92.27.219.212,0,0,19,13242,19,13242,0.100154000,1.7433
215.158.239.34,<->,96.135.154.111,19,7385,0,0,19,7385,0.099328000,1.7607
94.193.253.70,<->,8.252.221.236,0,0,19,1004,19,1004,0.098671000,1.8369
136.25.189.222,<->,8.235.71.12,19,25927,0,0,19,25927,0.098046000,0.0836
139.163.8.98,<->,101.124.10.145,19,1064,0,0,19,1064,0.096927000,1.8123
220.80.38.227,<->,139.241.56.117,19,24864,0,0,19,24864,0.096433000,1.9010
213.186.52.121,<->,139.163.0.100,0,0,19,1064,19,1064,0.096080000,1.8128
195.71.65.107,<->,136.25.188.177,0,0,19,1088,19,1088,0.095967000,1.8906
215.158.238.149,<->,33.209.217.228,19,8018,0,0,19,8018,0.095177000,1.3457
239.134.72.200,<->,50.224.61.154,0,0,19,1064,19,1064,0.093570000,1.8067
157.127.231.145,<->,8.252.221.204,0,0,19,1172,19,1172,0.093371000,1.7228
133.178.226.80,<->,122.158.245.89,19,9831,0,0,19,9831,0.092327000,1.8256
139.163.0.110,<->,136.217.121.51,19,1064,0,0,19,1064,0.090505000,1.8142
213.186.52.75,<->,139.163.8.98,0,0,19,1064,19,1064,0.090028000,1.8500
195.41.45.253,<->,136.25.188.238,0,0,19,1709,19,1709,0.089107000,0.5110
207.74.198.33,<->,50.224.105.44,0,0,19,1064,19,1064,0.088116000,1.8305
139.163.8.107,<->,101.117.234.61,19,950,0,0,19,950,0.088005000,1.8143
139.163.8.107,<->,6.211.67.163,19,1064,0,0,19,1064,0.085508000,1.8203
215.158.239.78,<->,133.146.0.201,19,10976,0,0,19,10976,0.085422000,1.7614
139.163.8.98,<->,91.69.181.204,19,1064,0,0,19,1064,0.083528000,1.8520
136.217.64.176,<->,50.224.105.45,0,0,19,1064,19,1064,0.082785000,1.8284
144.85.170.208,<->,98.87.145.237,19,1064,0,0,19,1064,0.081230000,0.5666
215.158.2.8,<->,8.176.8.71,0,0,19,9500,19,9500,0.081040000,1.2933
215.158.239.76,<->,199.106.98.229,19,2089,0,0,19,2089,0.080986000,1.4111
136.25.188.175,<->,56.161.218.20,19,4759,0,0,19,4759,0.080982000,0.9554
139.163.8.98,<->,98.87.186.43,19,1064,0,0,19,1064,0.080621000,1.8140
136.25.188.253,<->,114.25.48.63,19,2261,0,0,19,2261,0.080527000,1.0949
112.24.162.152,<->,92.168.217.133,0,0,19,968,19,968,0.080452000,1.7970
195.37.8.164,<->,8.182.224.87,0,0,19,950,19,950,0.079080000,0.9356
142.253.140.101,<->,136.25.188.175,0,0,19,1789,19,1789,0.078310000,1.1384
215.158.238.133,<->,91.57.173.21,19,8710,0,0,19,8710,0.078289000,1.8002
215.158.238.83,<->,104.154.137.3,19,1064,0,0,19,1064,0.078193000,0.2554
91.69.181.217,<->,50.224.105.45,0,0,19,1064,19,1064,0.077895000,1.8240
215.158.239.49,<->,199.20.5.151,19,3465,0,0,19,3465,0.077032000,1.6293
8.252.221.223,<->,4.121.64.45,19,2138,0,0,19,2138,0.075877000,1.8219
215.158.238.64,<->,69.150.169.42,19,4599,0,0,19,4599,0.075323000,1.6814
136.25.188.250,<->,100.224.202.176,19,12452,0,0,19,12452,0.074636000,1.4888
215.158.140.221,<->,50.220.141.103,19,1784,0,0,19,1784,0.073043000,0.1980
205.127.108.113,<->,33.233.141.16,0,0,19,9761,19,9761,0.070814000,1.7424
133.178.227.76,<->,106.188.228.2,19,4275,0,0,19,4275,0.070055000,0.8538
215.158.239.95,<->,195.13.238.8,19,2639,0,0,19,2639,0.069629000,0.5361
139.163.8.107,<->,98.87.147.163,19,1064,0,0,19,1064,0.065114000,1.8392
96.190.2.40,<->,50.224.105.45,0,0,19,1064,19,1064,0.064767000,1.8280
199.39.54.6,<->,136.25.188.177,0,0,19,1806,19,1806,0.064746000,0.5196
136.25.188.175,<->,113.23.20.117,19,7473,0,0,19,7473,0.064620000,1.9245
58.50.231.64,<->,8.252.222.125,0,0,19,1256,19,1256,0.063408000,1.8450
139.163.0.100,<->,17.214.49.156,19,1064,0,0,19,1064,0.063307000,1.8503
204.200.36.112,<->,136.25.188.253,0,0,19,2474,19,2474,0.063222000,1.5917
36.116.245.250,<->,8.252.221.206,0,0,19,1042,19,1042,0.063046000,1.7811
98.87.186.191,<->,50.224.105.44,0,0,19,1064,19,1064,0.062802000,1.8397
215.158.238.135,<->,122.159.245.149,19,6065,0,0,19,6065,0.062528000,1.5340
98.87.186.238,<->,50.224.105.44,0,0,19,1064,19,1064,0.062412000,1.8396
136.25.188.44,<->,106.188.236.151,19,4855,0,0,19,4855,0.059534000,1.6303
215.158.239.30,<->,29.214.74.194,19,6738,0,0,19,6738,0.057309000,1.8783
207.92.183.112,<->,8.182.224.248,0,0,19,1040,19,1040,0.056362000,1.2479
247.136.165.38,<->,199.98.194.147,19,965,0,0,19,965,0.055572000,1.7154
133.178.226.72,<->,133.56.180.35,19,19260,0,0,19,19260,0.053466000,1.5800
221.196.90.126,<->,144.85.170.246,0,0,19,1160,19,1160,0.053372000,1.9392
215.158.239.33,<->,215.158.127.160,19,8752,0,0,19,8752,0.050367000,1.8597
254.64.119.99,<->,92.27.219.243,0,0,19,14204,19,14204,0.047999000,1.7507
200.14.164.203,<->,0.195.210.8,0,0,19,1360,19,1360,0.047217000,1.8904
146.249.226.8,<->,8.252.222.135,0,0,19,2959,19,2959,0.046146000,0.3803
195.69.252.157,<->,136.25.188.236,0,0,19,2051,19,2051,0.045660000,1.2225
50.224.105.45,<->,6.133.244.232,19,1064,0,0,19,1064,0.045320000,1.7978
215.158.239.50,<->,194.232.3.141,19,3008,0,0,19,3008,0.044733000,1.7616
215.158.239.237,<->,136.158.73.44,19,2774,0,0,19,2774,0.042948000,1.8239
215.158.239.92,<->,195.49.2.75,19,2375,0,0,19,2375,0.040223000,1.8290
215.158.239.87,<->,204.2.203.208,19,1125,0,0,19,1125,0.039611000,0.4032
207.176.77.248,<->,50.223.3.228,0,0,19,950,19,950,0.038791000,1.8655
133.178.226.90,<->,126.219.247.8,19,7037,0,0,19,7037,0.037875000,1.9166
215.158.238.176,<->,8.221.197.119,19,5500,0,0,19,5500,0.037419000,1.3809
107.107.28.233,<->,50.224.61.152,0,0,19,1064,19,1064,0.035153000,1.8963
215.158.238.133,<->,8.42.43.10,19,7329,0,0,19,7329,0.034945000,1.5965
223.120.40.0,<->,8.252.221.207,0,0,19,1028,19,1028,0.034143000,1.8671
204.200.58.145,<->,136.25.188.225,0,0,19,2473,19,2473,0.032311000,0.5558
215.158.239.218,<->,33.235.161.209,19,8526,0,0,19,8526,0.032051000,1.8935
159.137.169.58,<->,42.71.214.220,19,1112,0,0,19,1112,0.030965000,1.8469
91.251.106.110,<->,8.45.162.111,19,16206,0,0,19,16206,0.030501000,0.5170
215.158.239.68,<->,199.20.28.139,19,1992,0,0,19,1992,0.030023000,0.9901
237.147.40.6,<->,139.163.8.98,0,0,19,1064,19,1064,0.029603000,1.9203
146.249.226.101,<->,8.252.223.99,0,0,19,1124,19,1124,0.027911000,1.9411
195.15.236.116,<->,136.25.188.220,0,0,19,3489,19,3489,0.027536000,0.7530
195.5.96.228,<->,136.25.188.174,0,0,19,1046,19,1046,0.026531000,0.3257
139.163.8.107,<->,98.3.195.198,19,1064,0,0,19,1064,0.026271000,1.9166
215.158.140.228,<->,133.213.24.157,19,2044,0,0,19,2044,0.024436000,0.4083
204.187.243.126,<->,136.25.188.224,0,0,19,2577,19,2577,0.023651000,1.9198
209.91.188.207,<->,8.52.147.55,0,0,19,2195,19,2195,0.022396000,0.2888
246.253.253.101,<->,215.158.133.8,19,15370,0,0,19,15370,0.021689000,1.8508
215.158.239.49,<->,196.89.239.231,19,4384,0,0,19,4384,0.020907000,0.8594
215.158.238.66,<->,106.188.251.194,19,9982,0,0,19,9982,0.020652000,1.8830
138.112.247.164,<->,39.15.146.228,0,0,19,20412,19,20412,0.020455000,1.6541
199.68.139.129,<->,136.25.188.174,0,0,19,2398,19,2398,0.019795000,0.9756
215.158.239.96,<->,194.232.14.110,19,2106,0,0,19,2106,0.018234000,1.6323
133.56.201.50,<->,8.52.189.207,0,0,19,2946,19,2946,0.018191000,0.9969
215.158.239.80,<->,98.219.126.140,19,17059,0,0,19,17059,0.017068000,1.3710
139.163.96.127,<->,114.214.96.59,19,980,0,0,19,980,0.013644000,1.9573
136.25.188.210,<->,29.211.6.19,19,5063,0,0,19,5063,0.011334000,1.1674
215.158.239.70,<->,196.88.29.131,19,2601,0,0,19,2601,0.011044000,0.8632
159.137.169.58,<->,120.107.191.99,19,1100,0,0,19,1100,0.009340000,1.8938
215.158.140.93,<->,8.219.184.108,19,1064,0,0,19,1064,0.009310000,0.0020
133.178.227.76,<->,133.56.180.41,19,8841,0,0,19,8841,0.007508000,0.5707
215.158.238.80,<->,126.219.132.169,19,6140,0,0,19,6140,0.006994000,1.9871
215.158.238.83,<->,104.3.168.212,19,7409,0,0,19,7409,0.006128000,1.8425
222.4.130.143,<->,50.224.49.195,0,0,19,1076,19,1076,0.005350000,1.9686
91.100.189.41,<->,80.38.33.27,0,0,19,950,19,950,0.004483000,1.8093
194.232.200.149,<->,136.25.188.243,0,0,19,1154,19,1154,0.003720000,0.4193
215.158.238.143,<->,106.188.183.107,19,7038,0,0,19,7038,0.003711000,1.6464
207.60.32.237,<->,136.25.188.199,0,0,19,1907,19,1907,0.003661000,1.1752
133.178.226.18,<->,69.150.169.36,19,7041,0,0,19,7041,0.003333000,1.7400
220.39.233.217,<->,215.158.238.64,0,0,19,6620,19,6620,0.002749000,1.4733
133.178.227.95,<->,82.216.224.205,19,950,0,0,19,950,0.002545000,0.0710
215.158.239.59,<->,145.13.164.216,19,10832,0,0,19,10832,0.001436000,1.5998
207.175.241.91,<->,136.25.188.55,0,0,19,1635,19,1635,0.000319000,0.8100
132.213.199.16,<->,8.52.148.104,0,0,18,1425,18,1425,1.927815000,0.0593
136.25.188.53,<->,80.47.228.214,18,1452,0,0,18,1452,1.850319000,0.1064
133.178.227.79,<->,8.33.227.61,18,1941,0,0,18,1941,1.711055000,0.1862
143.95.233.162,<->,136.25.188.196,0,0,18,2322,18,2322,1.597232000,0.3936
215.158.238.74,<->,8.240.117.62,18,2197,0,0,18,2197,1.560653000,0.3734
133.178.226.30,<->,126.219.49.8,18,2117,0,0,18,2117,1.554966000,0.2546
133.178.227.18,<->,102.225.141.41,18,2381,0,0,18,2381,1.544276000,0.0661
129.225.134.164,<->,129.225.132.80,0,0,18,11599,18,11599,1.530288000,0.1698
192.67.129.30,<->,121.42.178.118,18,23624,0,0,18,23624,1.495758000,0.4895
220.28.65.9,<->,215.158.238.69,0,0,18,20297,18,20297,1.491859000,0.4622
144.78.108.130,<->,133.178.226.176,0,0,18,21903,18,21903,1.477855000,0.1858
195.5.16.250,<->,136.25.188.208,0,0,18,1917,18,1917,1.466782000,0.3522
215.158.239.4,<->,144.253.55.16,18,2123,0,0,18,2123,1.444283000,0.0618
133.178.227.11,<->,111.151.109.16,18,1008,0,0,18,1008,1.388576000,0.1272
138.37.223.61,<->,8.182.244.19,0,0,18,1980,18,1980,1.388562000,0.2229
133.20.191.58,<->,8.20.87.94,0,0,18,1206,18,1206,1.388560000,0.3379
215.158.239.49,<->,207.166.104.125,18,1894,0,0,18,1894,1.386023000,0.5203
196.240.168.92,<->,136.25.188.253,0,0,18,1008,18,1008,1.372559000,0.1337
199.80.80.167,<->,136.25.188.252,0,0,18,1008,18,1008,1.338868000,0.2703
207.173.72.84,<->,136.25.188.44,0,0,18,1443,18,1443,1.303680000,0.5392
136.25.189.29,<->,96.135.155.29,18,7966,0,0,18,7966,1.300796000,0.3713
199.82.203.26,<->,136.25.188.53,0,0,18,1336,18,1336,1.274676000,0.4171
215.158.61.237,<->,8.252.223.64,0,0,18,26035,18,26035,1.273731000,0.0002
215.158.30.254,<->,8.252.222.189,0,0,18,19243,18,19243,1.268121000,0.3197
215.158.238.92,<->,141.199.76.251,18,2101,0,0,18,2101,1.232690000,0.4451
143.194.134.147,<->,8.252.222.143,0,0,18,2466,18,2466,1.196534000,0.5816
193.31.225.146,<->,92.162.252.222,0,0,18,20722,18,20722,1.189637000,0.3034
194.237.250.247,<->,136.25.188.220,0,0,18,1330,18,1330,1.169898000,0.4190
215.158.239.56,<->,199.20.109.177,18,4220,0,0,18,4220,1.150877000,0.7092
136.139.59.103,<->,133.178.226.37,0,0,18,3482,18,3482,1.146892000,0.7678
231.143.197.5,<->,136.25.188.255,0,0,18,1080,18,1080,1.143971000,0.8401
215.158.239.49,<->,196.92.93.217,18,1717,0,0,18,1717,1.130599000,0.4999
215.158.239.58,<->,199.72.194.10,18,2505,0,0,18,2505,1.119796000,0.6539
133.178.227.40,<->,8.219.184.110,18,3242,0,0,18,3242,1.116082000,0.8547
137.44.173.220,<->,100.228.42.166,0,0,18,20473,18,20473,1.108673000,0.1121
136.25.189.209,<->,96.234.109.145,18,18822,0,0,18,18822,1.107872000,0.3703
122.212.152.132,<->,92.27.219.175,0,0,18,13338,18,13338,1.069877000,0.9209
143.89.245.183,<->,136.25.188.163,0,0,18,2512,18,2512,1.052060000,0.7534
215.158.239.83,<->,80.57.141.226,18,19355,0,0,18,19355,1.036691000,0.1810
204.3.183.232,<->,136.25.188.198,0,0,18,1831,18,1831,1.028879000,0.6800
215.158.238.141,<->,131.1.195.244,18,5071,0,0,18,5071,1.028249000,0.7644
114.76.111.145,<->,92.162.253.150,0,0,18,23105,18,23105,1.015488000,0.2144
136.138.112.227,<->,133.178.226.90,0,0,18,5716,18,5716,1.013129000,0.9277
195.43.122.84,<->,136.25.188.54,0,0,18,2505,18,2505,1.006312000,0.8030
215.158.239.51,<->,195.15.18.212,18,2266,0,0,18,2266,0.995354000,0.7763
215.158.239.96,<->,199.106.17.217,18,1944,0,0,18,1944,0.991402000,0.3700
215.158.239.85,<->,204.58.251.144,18,2427,0,0,18,2427,0.990922000,0.6694
199.111.103.209,<->,8.182.239.190,0,0,18,2067,18,2067,0.989372000,0.5891
215.158.239.58,<->,199.20.28.23,18,2536,0,0,18,2536,0.980480000,0.8806
215.158.239.70,<->,199.20.100.95,18,1728,0,0,18,1728,0.960115000,0.5467
215.158.239.92,<->,199.52.40.31,18,2552,0,0,18,2552,0.955766000,0.7293
215.158.239.77,<->,199.71.97.231,18,1717,0,0,18,1717,0.951663000,0.3018
225.120.209.61,<->,50.224.76.235,0,0,18,10079,18,10079,0.948243000,0.2966
251.20.81.56,<->,108.134.108.240,0,0,18,4420,18,4420,0.943436000,1.0007
136.25.188.51,<->,111.52.91.227,18,21840,0,0,18,21840,0.941361000,0.9094
215.158.239.41,<->,8.191.15.9,18,5644,0,0,18,5644,0.940977000,0.8022
215.158.239.124,<->,111.151.237.102,18,22038,0,0,18,22038,0.934906000,1.0308
108.38.16.192,<->,50.224.80.64,0,0,18,1363,18,1363,0.930818000,0.7382
215.158.239.50,<->,194.237.93.55,18,3375,0,0,18,3375,0.923613000,1.0274
215.158.239.56,<->,199.72.175.74,18,1979,0,0,18,1979,0.921808000,0.8280
8.182.243.141,<->,6.133.205.181,18,1832,0,0,18,1832,0.903163000,0.3993
196.148.174.227,<->,53.243.94.39,18,21464,0,0,18,21464,0.894285000,0.4844
215.158.239.86,<->,141.42.200.186,18,3482,0,0,18,3482,0.891139000,1.0037
215.158.239.93,<->,199.20.29.71,18,1053,0,0,18,1053,0.886458000,0.9001
215.158.239.94,<->,199.20.29.173,18,2511,0,0,18,2511,0.875923000,0.9268
133.178.226.18,<->,122.158.49.128,18,6820,0,0,18,6820,0.869957000,1.0077
195.4.55.57,<->,136.25.188.174,0,0,18,2709,18,2709,0.865071000,0.9687
133.178.227.252,<->,56.12.208.252,18,1008,0,0,18,1008,0.860173000,0.0103
142.208.234.83,<->,136.25.188.224,0,0,18,2096,18,2096,0.842552000,0.8039
195.70.195.205,<->,136.25.188.239,0,0,18,2043,18,2043,0.836158000,1.0939
215.158.239.96,<->,207.62.35.45,18,2170,0,0,18,2170,0.822969000,0.6531
133.178.226.90,<->,126.219.194.171,18,8320,0,0,18,8320,0.811976000,1.1028
204.56.11.64,<->,136.25.188.209,0,0,18,1401,18,1401,0.805151000,1.0054
215.158.239.21,<->,96.135.154.142,18,19545,0,0,18,19545,0.797501000,1.0982
199.98.29.192,<->,8.252.222.223,0,0,18,2568,18,2568,0.796593000,0.9887
136.25.188.149,<->,56.23.170.253,18,5839,0,0,18,5839,0.793552000,0.6538
133.178.227.24,<->,89.86.110.201,18,6127,0,0,18,6127,0.791213000,1.2004
196.205.207.94,<->,136.25.188.46,0,0,18,2043,18,2043,0.773449000,1.1299
202.33.102.175,<->,136.25.188.240,0,0,18,1736,18,1736,0.772756000,1.2094
138.102.212.203,<->,92.168.217.142,0,0,18,900,18,900,0.762434000,1.2128
215.158.238.92,<->,8.219.185.97,18,2213,0,0,18,2213,0.757782000,0.0669
195.40.146.119,<->,136.25.188.220,0,0,18,3327,18,3327,0.747620000,0.9739
136.25.189.2,<->,57.236.82.216,18,3470,0,0,18,3470,0.738672000,0.8610
215.158.239.50,<->,195.49.96.28,18,1283,0,0,18,1283,0.718696000,0.7791
215.158.238.135,<->,106.188.183.96,18,7136,0,0,18,7136,0.714062000,0.8405
215.158.238.81,<->,8.252.214.133,18,2037,0,0,18,2037,0.712022000,0.0753
216.79.129.253,<->,8.183.25.124,0,0,18,3496,18,3496,0.704068000,0.4802
215.158.239.84,<->,143.135.202.149,18,2523,0,0,18,2523,0.697117000,0.7195
215.158.239.93,<->,199.14.85.95,18,2059,0,0,18,2059,0.693301000,0.6657
207.84.109.3,<->,8.43.221.222,0,0,18,1792,18,1792,0.686984000,0.4793
199.83.79.32,<->,136.25.188.176,0,0,18,1468,18,1468,0.672907000,1.1289
215.158.239.78,<->,195.42.88.33,18,2298,0,0,18,2298,0.670888000,1.2487
142.206.163.206,<->,136.25.188.252,0,0,18,3102,18,3102,0.667098000,1.0727
215.158.239.5,<->,8.191.6.121,18,7167,0,0,18,7167,0.663075000,1.1820
215.158.238.133,<->,8.240.116.198,18,2357,0,0,18,2357,0.659858000,0.0359
215.158.238.45,<->,114.150.180.137,18,1008,0,0,18,1008,0.647260000,0.0325
220.28.114.28,<->,136.25.188.195,0,0,18,24635,18,24635,0.640130000,0.1867
215.158.140.184,<->,100.116.190.4,18,1853,0,0,18,1853,0.628387000,0.1033
215.158.239.92,<->,196.91.244.101,18,2527,0,0,18,2527,0.622514000,1.0898
215.158.239.56,<->,195.13.248.126,18,3364,0,0,18,3364,0.614982000,0.9109
207.236.203.114,<->,136.25.188.210,0,0,18,1547,18,1547,0.612157000,0.7173
96.48.188.33,<->,8.53.2.29,0,0,18,2643,18,2643,0.602848000,1.2551
133.178.226.70,<->,106.188.253.52,18,3054,0,0,18,3054,0.598976000,0.6680
145.252.125.112,<->,112.86.216.201,18,1142,0,0,18,1142,0.597017000,0.9495
215.158.238.133,<->,104.3.163.89,18,4731,0,0,18,4731,0.581161000,1.3786
197.113.99.135,<->,136.25.188.209,0,0,18,1717,18,1717,0.567228000,0.9378
199.83.212.246,<->,136.25.188.52,0,0,18,3369,18,3369,0.562042000,1.2917
111.150.186.97,<->,6.73.247.116,0,0,18,25303,18,25303,0.551504000,0.2921
136.25.188.56,<->,96.155.61.60,18,21834,0,0,18,21834,0.551176000,0.6292
207.236.186.73,<->,136.25.188.253,0,0,18,1008,18,1008,0.537768000,0.0343
136.25.188.44,<->,8.222.212.20,18,4799,0,0,18,4799,0.533449000,1.0371
231.140.126.19,<->,215.158.239.79,0,0,18,2214,18,2214,0.518489000,1.2602
215.158.239.85,<->,195.14.38.36,18,2075,0,0,18,2075,0.517908000,1.0961
204.61.34.127,<->,136.25.188.236,0,0,18,1930,18,1930,0.500770000,0.9741
133.178.226.70,<->,8.219.184.156,18,3404,0,0,18,3404,0.494884000,0.4694
215.158.238.141,<->,131.1.253.245,18,3553,0,0,18,3553,0.490537000,0.6547
142.229.89.36,<->,136.25.188.236,0,0,18,2049,18,2049,0.480915000,1.1592
215.158.239.76,<->,199.20.30.219,18,2287,0,0,18,2287,0.463723000,1.3226
143.134.143.212,<->,136.25.188.227,0,0,18,3806,18,3806,0.458929000,1.1072
199.71.81.191,<->,136.25.188.236,0,0,18,1008,18,1008,0.447554000,0.7197
215.158.238.45,<->,140.138.86.214,18,1008,0,0,18,1008,0.445405000,0.1231
215.158.239.56,<->,199.20.29.64,18,1749,0,0,18,1749,0.443367000,0.9798
215.158.238.83,<->,57.210.107.19,18,3354,0,0,18,3354,0.439796000,1.0725
140.173.227.55,<->,136.25.188.47,0,0,18,4751,18,4751,0.424823000,1.2074
246.254.97.103,<->,193.94.10.149,18,1770,0,0,18,1770,0.420188000,1.4868
8.252.221.237,<->,4.122.180.204,18,942,0,0,18,942,0.413080000,1.4346
204.186.176.194,<->,136.25.188.238,0,0,18,2346,18,2346,0.408935000,1.3375
207.62.152.200,<->,136.25.188.174,0,0,18,2156,18,2156,0.407316000,1.3669
215.158.61.191,<->,8.176.8.232,0,0,18,17542,18,17542,0.401381000,1.1699
215.158.239.48,<->,199.20.6.122,18,1860,0,0,18,1860,0.392278000,0.6016
133.178.226.60,<->,8.42.43.65,18,7129,0,0,18,7129,0.381251000,1.1582
159.215.65.173,<->,136.25.188.228,0,0,18,15438,18,15438,0.375177000,1.0180
136.25.189.9,<->,100.216.78.145,18,23635,0,0,18,23635,0.374209000,1.1481
142.253.231.238,<->,136.25.188.163,0,0,18,906,18,906,0.373460000,1.4834
231.142.169.11,<->,215.158.239.68,0,0,18,942,18,942,0.364713000,1.4985
144.87.238.91,<->,8.182.226.78,0,0,18,3734,18,3734,0.357811000,1.6333
136.139.59.117,<->,133.178.226.77,0,0,18,1987,18,1987,0.356984000,0.3000
215.158.239.78,<->,196.91.186.38,18,1817,0,0,18,1817,0.349252000,1.4197
99.124.196.93,<->,8.52.246.196,0,0,18,1996,18,1996,0.343220000,0.1958
215.158.239.44,<->,111.52.91.239,18,17005,0,0,18,17005,0.341285000,1.4097
215.158.239.56,<->,199.20.29.3,18,3476,0,0,18,3476,0.336743000,1.4699
205.127.108.113,<->,101.224.89.175,0,0,18,9757,18,9757,0.330091000,1.4141
215.158.238.95,<->,38.51.98.247,18,2197,0,0,18,2197,0.329524000,0.1707
215.158.239.76,<->,199.20.22.69,18,3195,0,0,18,3195,0.328641000,1.5050
199.52.92.223,<->,136.25.188.255,0,0,18,2553,18,2553,0.323975000,0.8102
215.158.140.92,<->,33.209.219.12,18,4429,0,0,18,4429,0.320946000,0.9703
215.158.238.190,<->,33.209.219.19,18,2133,0,0,18,2133,0.313337000,0.4194
136.25.189.28,<->,120.154.131.20,18,6523,0,0,18,6523,0.307194000,1.6080
195.42.91.72,<->,136.25.188.242,0,0,18,1276,18,1276,0.305224000,0.7156
215.158.239.76,<->,194.232.207.62,18,1902,0,0,18,1902,0.299346000,0.1891
215.158.238.107,<->,111.150.186.175,18,2293,0,0,18,2293,0.297075000,0.9214
220.28.73.211,<->,136.25.189.7,0,0,18,12205,18,12205,0.295661000,0.9924
215.158.239.56,<->,199.76.91.225,18,2524,0,0,18,2524,0.286849000,1.3896
123.129.231.146,<->,92.27.219.242,0,0,18,1010,18,1010,0.286823000,1.4219
221.102.143.189,<->,6.74.79.98,0,0,18,16134,18,16134,0.286362000,0.6574
139.163.0.103,<->,97.95.211.77,18,1008,0,0,18,1008,0.283038000,1.5624
215.158.238.135,<->,197.125.126.183,18,6036,0,0,18,6036,0.281784000,1.7147
215.158.238.176,<->,113.23.101.151,18,1008,0,0,18,1008,0.278902000,0.0036
215.158.61.255,<->,8.252.221.166,0,0,18,14858,18,14858,0.275412000,1.2433
215.158.239.92,<->,199.20.29.189,18,1053,0,0,18,1053,0.272253000,0.4303
136.25.188.163,<->,131.1.195.244,18,6579,0,0,18,6579,0.271975000,1.0708
195.55.123.88,<->,136.25.188.238,0,0,18,1008,18,1008,0.268415000,0.0357
215.158.238.66,<->,205.227.96.23,18,2165,0,0,18,2165,0.267721000,0.1304
142.190.253.86,<->,136.25.188.254,0,0,18,1200,18,1200,0.263726000,1.6189
215.158.3.219,<->,99.74.26.100,0,0,18,7783,18,7783,0.254608000,1.5242
133.178.227.2,<->,126.219.132.13,18,5291,0,0,18,5291,0.251579000,1.6527
215.158.239.56,<->,196.109.48.139,18,1008,0,0,18,1008,0.250836000,0.4800
204.1.227.200,<->,136.25.188.242,0,0,18,1008,18,1008,0.248944000,0.3771
199.80.8.197,<->,136.25.188.179,0,0,18,1928,18,1928,0.244061000,0.8332
215.158.239.87,<->,195.81.84.48,18,2789,0,0,18,2789,0.233322000,1.7400
133.178.226.77,<->,8.190.216.200,18,6064,0,0,18,6064,0.230286000,1.4250
215.158.239.45,<->,111.52.91.236,18,22573,0,0,18,22573,0.224161000,0.0967
99.246.131.108,<->,50.224.49.195,0,0,18,1008,18,1008,0.222647000,1.6160
136.25.189.95,<->,96.156.169.218,18,17566,0,0,18,17566,0.217273000,1.1044
215.158.239.46,<->,56.97.186.175,18,19261,0,0,18,19261,0.213618000,0.8352
204.62.76.78,<->,136.25.188.163,0,0,18,2528,18,2528,0.210445000,1.7200
204.3.154.98,<->,136.25.188.196,0,0,18,2737,18,2737,0.210026000,1.2839
133.178.226.37,<->,91.57.173.47,18,5632,0,0,18,5632,0.207145000,1.2350
94.194.227.91,<->,8.252.223.106,0,0,18,1068,18,1068,0.206747000,1.6411
215.158.238.73,<->,112.220.206.107,18,4687,0,0,18,4687,0.206676000,1.2958
136.25.188.179,<->,113.23.20.105,18,4763,0,0,18,4763,0.205183000,1.5756
196.206.131.132,<->,136.25.188.243,0,0,18,2596,18,2596,0.203013000,0.5814
215.158.239.85,<->,194.237.190.159,18,2043,0,0,18,2043,0.196673000,1.7133
146.249.227.5,<->,8.252.222.115,0,0,18,1124,18,1124,0.193435000,1.7330
215.158.30.165,<->,8.252.222.55,0,0,18,20836,18,20836,0.191324000,0.9052
215.158.239.84,<->,196.1.59.55,18,3388,0,0,18,3388,0.187775000,1.7898
195.14.81.169,<->,136.25.188.198,0,0,18,1193,18,1193,0.183372000,0.9892
215.158.238.148,<->,27.178.41.49,18,4847,0,0,18,4847,0.178307000,1.5609
197.113.99.170,<->,136.25.188.196,0,0,18,1701,18,1701,0.175407000,0.7198
205.127.108.114,<->,33.233.141.6,0,0,18,9979,18,9979,0.175299000,1.8242
145.57.214.37,<->,50.224.88.92,0,0,18,1008,18,1008,0.173593000,1.6039
220.55.79.216,<->,35.56.3.196,18,2848,0,0,18,2848,0.171419000,1.3189
139.163.0.100,<->,101.85.239.14,18,1008,0,0,18,1008,0.168977000,1.8291
136.25.188.45,<->,8.42.43.90,18,8686,0,0,18,8686,0.168167000,1.8090
220.28.109.52,<->,136.25.188.217,0,0,18,21128,18,21128,0.167828000,0.3387
94.192.165.151,<->,8.252.222.149,0,0,18,2589,18,2589,0.165799000,0.5517
215.158.140.231,<->,104.3.168.55,18,4311,0,0,18,4311,0.164201000,1.2603
215.158.239.94,<->,195.49.84.18,18,1053,0,0,18,1053,0.161974000,0.1001
136.25.188.53,<->,41.48.192.108,18,1266,0,0,18,1266,0.159888000,0.5282
215.158.239.86,<->,207.213.160.127,18,1430,0,0,18,1430,0.158336000,1.7890
195.13.79.155,<->,136.25.188.55,0,0,18,3200,18,3200,0.157971000,1.8137
133.178.227.79,<->,8.53.216.61,18,4863,0,0,18,4863,0.155135000,1.3300
215.158.238.72,<->,8.190.216.234,18,2277,0,0,18,2277,0.152878000,1.7033
129.224.112.252,<->,97.242.126.203,18,1201,0,0,18,1201,0.152641000,1.1600
215.158.239.70,<->,199.52.40.31,18,2552,0,0,18,2552,0.152246000,0.9002
215.158.239.99,<->,199.20.30.106,18,1720,0,0,18,1720,0.149821000,1.6308
215.158.239.50,<->,199.72.51.187,18,2655,0,0,18,2655,0.148075000,0.8993
215.158.239.79,<->,199.20.29.98,18,1008,0,0,18,1008,0.143914000,1.8500
136.25.189.29,<->,80.56.79.89,18,9131,0,0,18,9131,0.143681000,1.0562
207.191.137.190,<->,136.25.188.254,0,0,18,1974,18,1974,0.142547000,0.7736
133.178.226.7,<->,57.210.107.26,18,9907,0,0,18,9907,0.142378000,1.7931
195.7.218.163,<->,136.25.188.240,0,0,18,1496,18,1496,0.141874000,0.4337
215.158.239.79,<->,196.89.114.29,18,1496,0,0,18,1496,0.137576000,1.4665
195.5.246.138,<->,136.25.188.238,0,0,18,2045,18,2045,0.137448000,1.3869
220.20.200.109,<->,132.216.159.4,18,18369,0,0,18,18369,0.137013000,0.1258
133.178.226.80,<->,29.214.108.151,18,6921,0,0,18,6921,0.134243000,1.6786
58.59.89.38,<->,8.252.221.198,0,0,18,1144,18,1144,0.134056000,1.8576
215.158.238.95,<->,131.1.253.227,18,6318,0,0,18,6318,0.132899000,1.7507
133.178.227.14,<->,18.202.90.214,18,2055,0,0,18,2055,0.132639000,0.4217
215.158.238.98,<->,80.47.111.106,18,6004,0,0,18,6004,0.130737000,1.6948
195.41.245.135,<->,136.25.188.174,0,0,18,2591,18,2591,0.130261000,1.2415
215.158.239.56,<->,207.236.248.0,18,1967,0,0,18,1967,0.130042000,1.0370
48.19.54.253,<->,8.252.221.206,0,0,18,960,18,960,0.127858000,1.7354
215.158.238.134,<->,122.158.49.138,18,4522,0,0,18,4522,0.127823000,1.5056
215.158.238.113,<->,120.154.221.219,18,5888,0,0,18,5888,0.127245000,1.7332
215.158.239.96,<->,207.213.60.85,18,2341,0,0,18,2341,0.127188000,0.8740
215.158.238.82,<->,8.255.92.202,18,5748,0,0,18,5748,0.126160000,1.6001
195.55.20.234,<->,136.25.188.255,0,0,18,2503,18,2503,0.126038000,1.3731
215.158.238.64,<->,120.154.221.229,18,5956,0,0,18,5956,0.125168000,1.6371
215.158.140.60,<->,192.227.190.9,18,3059,0,0,18,3059,0.124840000,0.8314
215.158.239.94,<->,199.72.66.120,18,3013,0,0,18,3013,0.122176000,1.5608
220.39.233.186,<->,215.158.238.134,0,0,18,6244,18,6244,0.120568000,1.4284
159.23.227.241,<->,141.21.241.15,18,1435,0,0,18,1435,0.117201000,1.6315
215.158.238.220,<->,8.240.116.237,18,5128,0,0,18,5128,0.115883000,1.2588
215.158.238.74,<->,8.188.227.11,18,4815,0,0,18,4815,0.112624000,1.2721
215.158.238.114,<->,131.1.195.251,18,3578,0,0,18,3578,0.111006000,1.0578
142.249.242.45,<->,136.25.188.239,0,0,18,1170,18,1170,0.110172000,1.6899
80.42.138.90,<->,0.239.65.47,18,952,0,0,18,952,0.109599000,1.8003
215.158.239.58,<->,199.20.31.19,18,1008,0,0,18,1008,0.109455000,0.0600
215.158.239.34,<->,29.211.5.202,18,7932,0,0,18,7932,0.109294000,1.8353
133.178.227.76,<->,111.150.187.245,18,6054,0,0,18,6054,0.107528000,1.4844
199.33.17.43,<->,136.25.188.53,0,0,18,2863,18,2863,0.107468000,1.8409
136.25.188.220,<->,57.160.181.248,18,5936,0,0,18,5936,0.105926000,1.4245
50.224.78.140,<->,0.104.222.72,18,1008,0,0,18,1008,0.103795000,1.8323
144.86.149.237,<->,124.50.117.248,18,1301,0,0,18,1301,0.101628000,0.6783
144.85.170.246,<->,98.87.147.136,18,1008,0,0,18,1008,0.099345000,1.7473
215.158.239.49,<->,196.0.238.210,18,1053,0,0,18,1053,0.097057000,0.3099
215.158.239.95,<->,126.219.194.82,18,7577,0,0,18,7577,0.094411000,1.7029
197.113.99.127,<->,136.25.188.176,0,0,18,1008,18,1008,0.093997000,1.4008
248.75.10.77,<->,99.74.11.229,0,0,18,11312,18,11312,0.093767000,0.9387
136.25.188.175,<->,69.150.168.218,18,5812,0,0,18,5812,0.093452000,1.8592
215.158.239.99,<->,126.219.191.5,18,11480,0,0,18,11480,0.092438000,1.8130
136.217.115.13,<->,50.224.105.44,0,0,18,1008,18,1008,0.092167000,1.8325
68.72.133.189,<->,8.252.221.223,0,0,18,1781,18,1781,0.092132000,0.5968
136.25.189.85,<->,96.156.169.225,18,20932,0,0,18,20932,0.089658000,1.8842
215.158.239.94,<->,199.20.30.86,18,1008,0,0,18,1008,0.087438000,0.3401
195.13.194.219,<->,136.25.188.220,0,0,18,1970,18,1970,0.086427000,0.3629
207.173.245.15,<->,136.25.188.252,0,0,18,2377,18,2377,0.085372000,0.6905
69.246.47.115,<->,8.252.222.95,0,0,18,1284,18,1284,0.084307000,0.8727
215.158.238.67,<->,106.188.183.120,18,6933,0,0,18,6933,0.082025000,1.8657
215.158.239.99,<->,199.20.31.109,18,1886,0,0,18,1886,0.081242000,1.8580
215.158.238.143,<->,65.27.220.208,18,4843,0,0,18,4843,0.080562000,1.8823
142.240.166.10,<->,136.25.188.253,0,0,18,2298,18,2298,0.079111000,1.4974
215.158.239.57,<->,142.166.44.108,18,2561,0,0,18,2561,0.075448000,1.9201
136.25.189.1,<->,29.211.228.215,18,8382,0,0,18,8382,0.075000000,1.9135
215.158.238.121,<->,126.219.132.160,18,6052,0,0,18,6052,0.073282000,1.6559
215.158.238.94,<->,141.199.76.214,18,1008,0,0,18,1008,0.072245000,1.7227
136.25.189.46,<->,126.219.194.33,18,10776,0,0,18,10776,0.071733000,1.8617
95.247.100.11,<->,8.252.221.220,0,0,18,1164,18,1164,0.069651000,1.8994
215.158.61.183,<->,8.176.8.218,0,0,18,16679,18,16679,0.068790000,1.1531
50.224.88.107,<->,50.96.139.212,18,1008,0,0,18,1008,0.068541000,1.5864
215.158.238.220,<->,106.188.251.23,18,3482,0,0,18,3482,0.067821000,1.9053
222.28.123.161,<->,50.224.76.234,0,0,18,1673,18,1673,0.067277000,0.1992
195.215.92.58,<->,50.223.3.228,0,0,18,930,18,930,0.066890000,1.9103
48.18.143.12,<->,8.252.221.198,0,0,18,986,18,986,0.064524000,1.9248
215.158.238.67,<->,131.1.253.224,18,6419,0,0,18,6419,0.063067000,1.0235
215.158.239.50,<->,199.20.5.15,18,1053,0,0,18,1053,0.060599000,0.3591
159.137.169.58,<->,42.230.147.25,18,1044,0,0,18,1044,0.060384000,1.7959
215.158.239.79,<->,199.122.13.65,18,1098,0,0,18,1098,0.059953000,0.3518
192.204.123.11,<->,136.25.189.29,0,0,18,8846,18,8846,0.059280000,1.5910
195.3.2.203,<->,8.20.87.206,0,0,18,906,18,906,0.059207000,0.8856
215.158.238.83,<->,8.42.43.89,18,4619,0,0,18,4619,0.051739000,0.8049
195.70.17.125,<->,136.25.188.45,0,0,18,1450,18,1450,0.050939000,1.5384
136.25.189.57,<->,8.215.68.89,18,8302,0,0,18,8302,0.050509000,1.8019
204.200.48.192,<->,136.25.188.178,0,0,18,3001,18,3001,0.050489000,0.7276
101.70.127.226,<->,83.155.125.5,18,2208,0,0,18,2208,0.049054000,1.9044
209.91.165.24,<->,133.178.227.86,0,0,18,924,18,924,0.048526000,1.8277
246.254.97.112,<->,111.151.237.104,18,11334,0,0,18,11334,0.048184000,1.6686
136.25.188.161,<->,126.219.194.180,18,6036,0,0,18,6036,0.047405000,1.7625
215.158.238.47,<->,8.190.216.193,18,6272,0,0,18,6272,0.047229000,1.8254
212.164.138.162,<->,155.132.69.253,18,1104,0,0,18,1104,0.046275000,1.8236
149.250.115.70,<->,133.178.227.76,0,0,18,7041,18,7041,0.045705000,1.7283
215.158.238.121,<->,96.38.231.127,18,1008,0,0,18,1008,0.045013000,1.9005
215.158.238.92,<->,131.36.198.58,18,7911,0,0,18,7911,0.044585000,1.8329
136.25.188.255,<->,111.151.239.44,18,4799,0,0,18,4799,0.043902000,1.8748
68.73.105.222,<->,8.252.221.236,0,0,18,3975,18,3975,0.042247000,1.7904
139.241.56.117,<->,6.138.226.73,0,0,18,13607,18,13607,0.041547000,1.8413
122.245.191.228,<->,92.27.219.216,0,0,18,22978,18,22978,0.041528000,1.7643
145.13.164.247,<->,136.25.189.0,0,0,18,12157,18,12157,0.039733000,1.9555
17.193.242.92,<->,8.220.188.138,0,0,18,1568,18,1568,0.038445000,1.8981
8.252.221.236,<->,4.122.174.165,18,962,0,0,18,962,0.038385000,1.8116
215.158.239.69,<->,196.105.79.16,18,1008,0,0,18,1008,0.037903000,0.0409
232.31.47.174,<->,139.163.8.98,0,0,18,1008,18,1008,0.037685000,1.9198
111.42.21.99,<->,8.176.8.86,0,0,18,8049,18,8049,0.037173000,1.6200
109.222.230.140,<->,109.57.161.32,18,6532,0,0,18,6532,0.036747000,1.9011
136.25.188.160,<->,57.210.107.38,18,6969,0,0,18,6969,0.033277000,1.8967
207.3.128.159,<->,159.23.227.182,0,0,18,933,18,933,0.033235000,1.8502
220.39.233.87,<->,215.158.140.229,0,0,18,1008,18,1008,0.031227000,0.0018
106.186.17.103,<->,100.95.49.204,0,0,18,1032,18,1032,0.030809000,1.9332
215.158.239.94,<->,204.61.239.79,18,2051,0,0,18,2051,0.029556000,0.8574
48.18.192.11,<->,8.252.221.239,0,0,18,1128,18,1128,0.028354000,1.3787
136.25.188.177,<->,100.224.202.175,18,9978,0,0,18,9978,0.026696000,1.3891
215.158.238.81,<->,112.220.206.14,18,7157,0,0,18,7157,0.025889000,1.6702
106.163.116.4,<->,89.183.104.227,0,0,18,13932,18,13932,0.025000000,1.7482
215.158.238.123,<->,118.20.114.81,18,2341,0,0,18,2341,0.024050000,1.5063
220.28.65.9,<->,215.158.140.248,0,0,18,14739,18,14739,0.023547000,1.5570
50.224.105.33,<->,50.94.190.144,18,1056,0,0,18,1056,0.021691000,1.9687
194.220.14.164,<->,50.223.3.228,0,0,18,900,18,900,0.020455000,1.9515
207.86.9.133,<->,8.252.222.29,0,0,18,2791,18,2791,0.020399000,0.7537
58.51.53.14,<->,8.252.221.239,0,0,18,1068,18,1068,0.019867000,1.9323
215.158.238.132,<->,136.138.112.247,18,6180,0,0,18,6180,0.019685000,1.8269
136.25.189.16,<->,29.211.228.165,18,8258,0,0,18,8258,0.019564000,1.9430
136.25.189.14,<->,29.212.180.213,18,9875,0,0,18,9875,0.018580000,1.9495
146.249.227.139,<->,8.252.221.230,0,0,18,1080,18,1080,0.017219000,1.8600
59.141.23.72,<->,8.252.221.198,0,0,18,960,18,960,0.016120000,1.2875
215.158.239.76,<->,195.49.224.235,18,1020,0,0,18,1020,0.014738000,0.2000
92.27.27.150,<->,29.162.32.50,18,936,0,0,18,936,0.013959000,1.5665
136.25.189.29,<->,96.156.169.195,18,6260,0,0,18,6260,0.012298000,1.2949
195.40.74.55,<->,136.25.188.196,0,0,18,1008,18,1008,0.009692000,1.1328
133.178.226.90,<->,69.150.168.213,18,5764,0,0,18,5764,0.009393000,1.4023
231.140.4.123,<->,215.158.239.49,0,0,18,2043,18,2043,0.009351000,1.7814
215.158.30.238,<->,8.252.222.33,0,0,18,19412,18,19412,0.008495000,0.3328
215.158.239.94,<->,199.20.31.143,18,1008,0,0,18,1008,0.007375000,0.2800
215.158.238.80,<->,197.125.126.249,18,4655,0,0,18,4655,0.007354000,1.9810
250.65.195.91,<->,139.163.96.104,0,0,18,900,18,900,0.007063000,1.9916
215.158.239.94,<->,199.20.29.83,18,1121,0,0,18,1121,0.006487000,1.0619
195.54.86.110,<->,136.25.188.252,0,0,18,4328,18,4328,0.005102000,1.7290
204.21.139.233,<->,136.25.188.174,0,0,18,1020,18,1020,0.004575000,0.2890
215.158.239.58,<->,207.59.86.226,18,1156,0,0,18,1156,0.003612000,0.5297
207.62.98.53,<->,136.25.188.209,0,0,18,1008,18,1008,0.001864000,0.4065
215.158.238.221,<->,139.8.186.146,18,6278,0,0,18,6278,0.001348000,1.6705
195.89.57.100,<->,8.252.222.223,0,0,18,948,18,948,0.000964000,1.8529
215.158.239.57,<->,204.2.183.9,18,1164,0,0,18,1164,0.000528000,1.6202
146.249.220.207,<->,8.252.221.197,0,0,18,1092,18,1092,0.000099000,1.9454
221.102.56.46,<->,192.67.115.24,0,0,17,12994,17,12994,1.730006000,0.1341
215.158.61.182,<->,8.176.8.196,0,0,17,15284,17,15284,1.607574000,0.3311
136.25.188.199,<->,109.221.20.33,17,1987,0,0,17,1987,1.552240000,0.3299
215.158.239.95,<->,194.202.34.195,17,1200,0,0,17,1200,1.538807000,0.1501
215.158.239.76,<->,199.20.29.42,17,1677,0,0,17,1677,1.503256000,0.4900
8.52.181.238,<->,8.3.152.166,17,1280,0,0,17,1280,1.497777000,0.1960
207.190.98.134,<->,136.25.188.174,0,0,17,1140,17,1140,1.474762000,0.4692
136.181.47.188,<->,53.240.176.115,17,1693,0,0,17,1693,1.472736000,0.5208
17.12.130.178,<->,8.220.179.115,0,0,17,2095,17,2095,1.444100000,0.5050
215.158.3.212,<->,133.178.227.243,0,0,17,1757,17,1757,1.403304000,0.0853
136.25.188.229,<->,80.57.141.175,17,19486,0,0,17,19486,1.358089000,0.1024
215.158.238.241,<->,8.219.184.121,17,4773,0,0,17,4773,1.350406000,0.5056
97.19.5.28,<->,8.182.226.78,0,0,17,4954,17,4954,1.329932000,0.4622
231.143.162.104,<->,136.25.188.225,0,0,17,1661,17,1661,1.291967000,0.6677
221.102.56.46,<->,192.64.248.163,0,0,17,2520,17,2520,1.288682000,0.2842
199.32.125.184,<->,136.25.188.54,0,0,17,1549,17,1549,1.278542000,0.3050
220.28.104.193,<->,215.158.238.125,0,0,17,20817,17,20817,1.275978000,0.4201
195.42.91.197,<->,136.25.188.160,0,0,17,964,17,964,1.232767000,0.6783
215.158.239.50,<->,194.232.219.52,17,2460,0,0,17,2460,1.225037000,0.7404
215.158.239.68,<->,143.13.248.253,17,1768,0,0,17,1768,1.216702000,0.3382
215.158.238.177,<->,38.104.11.119,17,2301,0,0,17,2301,1.213355000,0.3255
215.158.238.96,<->,50.218.56.251,17,2141,0,0,17,2141,1.198254000,0.0293
136.25.188.171,<->,111.151.109.35,17,952,0,0,17,952,1.194817000,0.1004
215.158.238.104,<->,128.123.91.10,17,3442,0,0,17,3442,1.188238000,0.7475
133.178.227.24,<->,133.56.180.32,17,5960,0,0,17,5960,1.163343000,0.7900
144.232.192.125,<->,132.168.198.156,0,0,17,17694,17,17694,1.160976000,0.1551
35.56.16.129,<->,8.182.224.87,0,0,17,2096,17,2096,1.108089000,0.2751
215.158.140.17,<->,100.224.141.62,17,16971,0,0,17,16971,1.087975000,0.8430
215.158.238.241,<->,8.42.42.108,17,2125,0,0,17,2125,1.072777000,0.2971
195.69.197.9,<->,136.25.188.175,0,0,17,2281,17,2281,1.062963000,0.9052
232.111.67.19,<->,192.64.201.167,0,0,17,3508,17,3508,1.026628000,0.6710
215.158.239.92,<->,194.232.222.255,17,1661,0,0,17,1661,1.019360000,0.1674
215.158.239.96,<->,143.79.208.138,17,1641,0,0,17,1641,1.006476000,0.9673
204.186.232.252,<->,136.25.188.177,0,0,17,3496,17,3496,1.002601000,0.3893
215.158.239.48,<->,143.132.73.27,17,2533,0,0,17,2533,0.997292000,0.9629
142.236.216.98,<->,136.25.188.253,0,0,17,3435,17,3435,0.995482000,1.0036
215.158.238.146,<->,0.195.253.228,17,22876,0,0,17,22876,0.989002000,0.0001
215.158.239.97,<->,142.236.227.239,17,2035,0,0,17,2035,0.984469000,0.9598
133.178.226.77,<->,118.20.114.81,17,3410,0,0,17,3410,0.976375000,0.8815
199.82.180.205,<->,136.25.188.163,0,0,17,2457,17,2457,0.973071000,1.0198
195.124.165.237,<->,136.25.188.220,0,0,17,1988,17,1988,0.962475000,0.7795
215.158.239.50,<->,199.80.212.221,17,2469,0,0,17,2469,0.958402000,0.8229
207.191.158.193,<->,136.25.188.163,0,0,17,2467,17,2467,0.954569000,0.9784
146.249.221.205,<->,8.252.221.221,0,0,17,1166,17,1166,0.954203000,0.2382
215.158.239.50,<->,142.229.177.113,17,1805,0,0,17,1805,0.952352000,0.3146
215.158.239.95,<->,143.13.237.202,17,3273,0,0,17,3273,0.949085000,0.7825
215.158.239.78,<->,199.20.28.166,17,1864,0,0,17,1864,0.913789000,0.9599
215.158.238.135,<->,8.42.43.40,17,5964,0,0,17,5964,0.889751000,1.0369
199.70.59.102,<->,136.25.188.198,0,0,17,3163,17,3163,0.877766000,0.7465
214.237.183.201,<->,0.195.210.42,0,0,17,1790,17,1790,0.860706000,0.9376
195.4.113.29,<->,136.25.188.220,0,0,17,1581,17,1581,0.845663000,0.2542
215.158.239.96,<->,195.55.37.34,17,2045,0,0,17,2045,0.832206000,0.7372
133.178.227.2,<->,29.213.219.11,17,3650,0,0,17,3650,0.827803000,0.4674
207.239.224.78,<->,136.25.188.255,0,0,17,1909,17,1909,0.822914000,0.4395
111.20.168.123,<->,92.160.9.244,17,1386,0,0,17,1386,0.811379000,0.3991
215.158.238.188,<->,148.26.113.119,17,1924,0,0,17,1924,0.801325000,0.3334
215.158.238.32,<->,29.211.122.181,17,2125,0,0,17,2125,0.797330000,0.1403
215.158.239.94,<->,196.94.187.62,17,2455,0,0,17,2455,0.792855000,1.1097
50.224.76.235,<->,4.129.153.247,17,6817,0,0,17,6817,0.788265000,0.5038
204.185.87.213,<->,136.25.188.177,0,0,17,1072,17,1072,0.785099000,1.1402
143.68.157.101,<->,136.25.188.238,0,0,17,1759,17,1759,0.764376000,1.1851
133.244.28.235,<->,118.45.61.37,17,1197,0,0,17,1197,0.743946000,1.1759
215.158.239.77,<->,194.202.40.232,17,1722,0,0,17,1722,0.740563000,1.2200
145.48.251.16,<->,133.178.227.134,0,0,17,16944,17,16944,0.729466000,1.2525
215.158.239.49,<->,196.108.8.45,17,997,0,0,17,997,0.725746000,0.1196
215.158.239.85,<->,199.50.124.88,17,856,0,0,17,856,0.693607000,1.0141
136.25.189.34,<->,96.156.169.220,17,6588,0,0,17,6588,0.681951000,1.0399
215.158.238.106,<->,149.254.114.247,17,2125,0,0,17,2125,0.678850000,0.3476
146.249.227.135,<->,8.252.221.199,0,0,17,1621,17,1621,0.671049000,0.9800
136.25.189.45,<->,96.156.169.221,17,7869,0,0,17,7869,0.668975000,1.2696
215.158.239.95,<->,204.2.144.255,17,886,0,0,17,886,0.644938000,0.4255
8.252.222.205,<->,4.120.229.56,17,1359,0,0,17,1359,0.636209000,1.2280
204.62.195.166,<->,136.25.188.197,0,0,17,1928,17,1928,0.631260000,1.1892
195.13.134.170,<->,136.25.188.44,0,0,17,1759,17,1759,0.621761000,0.2764
111.150.186.220,<->,8.252.222.205,0,0,17,4567,17,4567,0.617975000,1.2677
58.143.177.240,<->,8.252.222.178,0,0,17,1648,17,1648,0.616214000,0.2376
231.142.139.22,<->,215.158.239.51,0,0,17,2541,17,2541,0.616127000,1.3447
215.158.239.166,<->,8.50.169.192,17,13244,0,0,17,13244,0.582661000,1.0388
215.158.239.58,<->,196.92.57.133,17,1048,0,0,17,1048,0.580978000,0.8700
136.25.188.49,<->,80.57.141.179,17,15742,0,0,17,15742,0.578615000,0.0708
136.25.189.86,<->,96.156.169.236,17,19569,0,0,17,19569,0.575788000,0.7764
204.200.46.60,<->,136.25.188.178,0,0,17,2031,17,2031,0.573008000,1.3180
142.240.217.193,<->,136.25.188.241,0,0,17,2207,17,2207,0.571526000,0.9743
136.25.188.211,<->,100.224.202.189,17,10365,0,0,17,10365,0.566110000,0.6608
215.158.238.96,<->,99.192.168.162,17,4526,0,0,17,4526,0.557577000,0.9302
204.60.26.225,<->,136.25.188.163,0,0,17,2572,17,2572,0.552917000,0.7731
215.158.239.23,<->,96.135.154.142,17,15971,0,0,17,15971,0.543971000,1.0583
207.56.107.29,<->,136.25.188.253,0,0,17,1709,17,1709,0.520276000,1.3638
136.214.10.22,<->,92.27.194.112,0,0,17,1445,17,1445,0.519194000,1.4614
199.69.203.52,<->,136.25.188.175,0,0,17,2632,17,2632,0.506583000,0.5862
215.158.239.43,<->,8.255.92.118,17,2158,0,0,17,2158,0.503683000,1.1048
192.65.98.231,<->,132.18.67.30,17,5450,0,0,17,5450,0.494266000,0.2793
215.158.238.67,<->,131.144.113.148,17,4839,0,0,17,4839,0.493836000,1.4910
215.158.239.93,<->,194.237.113.199,17,1104,0,0,17,1104,0.490578000,0.4760
215.158.239.48,<->,199.82.79.91,17,1673,0,0,17,1673,0.488438000,0.9310
17.5.228.52,<->,8.220.184.183,0,0,17,1533,17,1533,0.466517000,0.0879
192.204.123.54,<->,136.25.189.57,0,0,17,8742,17,8742,0.459728000,1.4705
99.162.77.146,<->,53.243.9.83,17,7710,0,0,17,7710,0.449240000,1.4780
215.158.238.243,<->,131.144.116.219,17,4019,0,0,17,4019,0.445432000,0.9596
133.178.226.29,<->,126.219.247.41,17,5864,0,0,17,5864,0.445203000,1.5269
215.158.239.51,<->,199.20.29.176,17,2174,0,0,17,2174,0.444655000,1.3302
204.187.61.28,<->,136.25.188.174,0,0,17,1903,17,1903,0.433493000,0.6498
199.70.78.141,<->,136.25.188.225,0,0,17,1136,17,1136,0.429495000,1.5489
215.158.239.70,<->,207.191.20.186,17,1501,0,0,17,1501,0.427700000,0.5704
215.158.61.183,<->,8.176.8.224,0,0,17,11258,17,11258,0.420748000,1.5200
247.127.89.61,<->,221.102.105.151,0,0,17,2512,17,2512,0.407546000,0.1502
215.158.140.231,<->,106.188.228.59,17,4198,0,0,17,4198,0.405323000,1.4195
215.158.239.51,<->,204.56.138.100,17,1987,0,0,17,1987,0.396177000,0.9735
142.208.125.122,<->,136.25.188.254,0,0,17,2464,17,2464,0.383743000,0.8892
215.158.239.29,<->,114.142.109.181,17,3879,0,0,17,3879,0.380935000,0.9545
215.158.238.110,<->,0.195.237.14,17,21296,0,0,17,21296,0.380628000,0.7465
148.55.210.229,<->,133.178.226.7,0,0,17,4647,17,4647,0.370159000,0.8985
204.63.29.181,<->,136.25.188.220,0,0,17,3287,17,3287,0.367741000,1.3969
246.253.217.242,<->,207.92.46.27,17,13966,0,0,17,13966,0.365974000,0.9105
215.158.239.69,<->,199.20.30.174,17,1087,0,0,17,1087,0.352648000,1.4395
136.25.189.62,<->,96.156.169.237,17,13029,0,0,17,13029,0.350491000,1.3454
136.25.188.198,<->,29.214.108.122,17,13186,0,0,17,13186,0.344510000,1.6310
215.158.238.134,<->,8.42.43.9,17,5752,0,0,17,5752,0.344490000,1.6320
231.141.23.189,<->,215.158.239.97,0,0,17,2456,17,2456,0.341743000,0.9441
220.28.114.28,<->,136.25.189.23,0,0,17,15156,17,15156,0.341714000,1.2804
215.158.239.49,<->,133.224.119.41,17,6092,0,0,17,6092,0.334048000,1.6604
136.25.189.45,<->,120.154.131.39,17,7852,0,0,17,7852,0.333350000,1.6599
199.33.126.138,<->,136.25.188.175,0,0,17,2187,17,2187,0.332063000,1.1146
207.239.31.248,<->,136.25.188.227,0,0,17,2544,17,2544,0.331310000,0.9688
133.178.226.60,<->,8.222.212.8,17,8502,0,0,17,8502,0.324777000,1.6555
215.158.239.35,<->,29.211.5.197,17,3951,0,0,17,3951,0.323280000,1.4636
215.158.239.92,<->,199.20.127.112,17,1955,0,0,17,1955,0.318778000,0.8608
215.158.238.134,<->,113.23.20.105,17,4663,0,0,17,4663,0.318275000,1.3564
215.158.238.114,<->,91.57.173.62,17,2173,0,0,17,2173,0.310319000,0.4318
220.60.81.134,<->,136.25.189.1,0,0,17,12277,17,12277,0.305309000,1.5981
215.158.61.182,<->,136.25.188.41,0,0,17,13929,17,13929,0.301788000,1.6612
215.158.61.145,<->,8.176.8.179,0,0,17,13322,17,13322,0.297302000,0.8402
142.167.148.25,<->,136.25.188.237,0,0,17,2044,17,2044,0.293181000,0.8450
215.158.238.47,<->,145.116.209.75,17,10898,0,0,17,10898,0.288178000,1.0831
215.158.239.49,<->,29.211.228.235,17,6180,0,0,17,6180,0.274505000,1.4991
215.158.238.133,<->,143.227.65.185,17,5660,0,0,17,5660,0.272292000,1.6530
220.39.174.104,<->,133.178.227.16,0,0,17,1954,17,1954,0.269594000,1.3700
136.25.189.18,<->,96.156.169.215,17,7105,0,0,17,7105,0.268754000,1.3189
215.158.239.96,<->,195.7.49.169,17,1845,0,0,17,1845,0.262115000,0.3107
204.200.43.65,<->,136.25.188.209,0,0,17,1060,17,1060,0.259476000,1.4438
215.158.61.252,<->,8.252.222.2,0,0,17,18057,17,18057,0.256660000,1.2810
133.178.226.18,<->,106.188.236.172,17,5948,0,0,17,5948,0.249944000,1.4509
215.158.239.57,<->,207.61.203.69,17,3692,0,0,17,3692,0.249758000,1.5945
136.25.188.226,<->,80.47.111.72,17,8310,0,0,17,8310,0.248884000,1.4822
136.25.188.237,<->,65.27.220.219,17,3330,0,0,17,3330,0.248782000,1.6093
215.158.238.64,<->,131.2.115.228,17,4711,0,0,17,4711,0.246669000,1.5536
199.121.170.163,<->,136.25.188.241,0,0,17,3208,17,3208,0.242585000,1.6281
136.25.189.54,<->,96.156.169.199,17,21356,0,0,17,21356,0.239646000,0.1291
215.158.238.223,<->,61.35.70.28,17,2301,0,0,17,2301,0.238663000,0.4442
133.178.227.1,<->,106.188.252.228,17,5045,0,0,17,5045,0.233073000,1.4394
215.158.239.56,<->,199.20.28.170,17,4028,0,0,17,4028,0.230163000,1.2990
97.126.119.92,<->,53.182.77.210,17,23654,0,0,17,23654,0.228194000,1.7499
215.158.239.96,<->,199.15.164.233,17,2459,0,0,17,2459,0.227941000,0.8533
215.158.239.87,<->,196.109.140.138,17,952,0,0,17,952,0.220376000,0.2906
215.158.238.133,<->,122.159.245.155,17,8102,0,0,17,8102,0.220002000,1.7114
136.25.188.211,<->,33.209.217.201,17,4849,0,0,17,4849,0.214529000,1.6483
144.87.238.89,<->,8.183.25.124,0,0,17,2848,17,2848,0.209903000,0.5679
201.209.26.37,<->,92.27.219.189,0,0,17,23176,17,23176,0.207734000,1.3007
215.158.239.56,<->,204.56.7.3,17,2566,0,0,17,2566,0.204099000,0.7900
215.158.239.75,<->,129.175.139.13,17,16353,0,0,17,16353,0.202230000,1.0508
136.25.188.211,<->,131.2.115.252,17,4983,0,0,17,4983,0.197990000,0.9134
215.158.239.96,<->,199.20.28.140,17,2469,0,0,17,2469,0.197599000,1.0199
98.101.95.18,<->,8.182.224.248,0,0,17,2655,17,2655,0.196841000,1.4679
142.228.74.159,<->,136.25.188.225,0,0,17,952,17,952,0.194169000,0.2442
121.74.207.64,<->,92.162.253.217,0,0,17,25166,17,25166,0.191878000,0.0019
215.158.239.96,<->,199.20.29.73,17,2592,0,0,17,2592,0.189085000,1.1492
136.25.188.243,<->,104.3.163.7,17,6961,0,0,17,6961,0.188340000,1.6352
215.158.239.77,<->,204.226.55.178,17,2558,0,0,17,2558,0.187464000,0.7940
215.158.239.58,<->,199.20.29.73,17,2580,0,0,17,2580,0.187052000,1.1098
215.158.239.84,<->,199.20.30.33,17,2332,0,0,17,2332,0.182540000,1.4003
142.220.56.95,<->,136.25.188.220,0,0,17,1979,17,1979,0.179026000,1.0367
215.158.140.60,<->,131.144.113.150,17,3319,0,0,17,3319,0.178177000,1.5074
204.60.102.195,<->,136.25.188.209,0,0,17,1855,17,1855,0.178064000,1.3815
215.158.239.49,<->,196.104.222.88,17,2464,0,0,17,2464,0.176987000,1.6399
252.98.180.157,<->,80.27.155.102,17,20591,0,0,17,20591,0.176403000,0.0010
247.136.231.91,<->,125.207.62.135,17,902,0,0,17,902,0.172823000,1.1582
229.102.86.37,<->,80.41.53.231,0,0,17,1006,17,1006,0.171108000,1.6397
215.158.238.149,<->,114.25.48.61,17,4435,0,0,17,4435,0.169481000,1.7347
215.158.238.113,<->,139.160.226.167,17,5644,0,0,17,5644,0.166248000,1.8118
136.25.188.160,<->,8.222.212.22,17,4679,0,0,17,4679,0.165811000,1.7082
215.158.239.70,<->,199.20.28.0,17,1923,0,0,17,1923,0.162446000,0.3789
215.158.238.47,<->,131.1.195.229,17,7794,0,0,17,7794,0.160917000,1.7421
133.178.226.29,<->,131.144.113.213,17,4583,0,0,17,4583,0.158348000,1.7960
142.191.151.66,<->,136.25.188.241,0,0,17,1988,17,1988,0.154977000,0.7066
215.158.238.61,<->,98.219.126.175,17,21078,0,0,17,21078,0.154435000,1.2532
215.158.238.98,<->,111.150.186.224,17,2205,0,0,17,2205,0.152600000,1.4345
215.158.239.58,<->,199.20.30.246,17,952,0,0,17,952,0.151204000,0.4100
215.158.238.97,<->,141.199.76.213,17,952,0,0,17,952,0.150634000,1.7273
58.50.173.24,<->,8.252.221.221,0,0,17,1048,17,1048,0.150424000,0.1525
215.158.238.135,<->,8.42.43.3,17,7085,0,0,17,7085,0.148074000,1.7428
207.239.156.159,<->,136.25.188.175,0,0,17,2539,17,2539,0.145618000,1.5857
142.239.121.93,<->,133.178.226.29,0,0,17,2029,17,2029,0.144365000,1.8275
215.158.239.87,<->,126.219.194.5,17,8955,0,0,17,8955,0.142793000,1.5844
159.36.241.98,<->,92.27.219.243,0,0,17,8185,17,8185,0.141603000,1.8430
215.158.239.7,<->,215.158.127.150,17,4192,0,0,17,4192,0.139367000,0.7721
94.195.7.223,<->,8.252.222.7,0,0,17,1208,17,1208,0.134927000,1.7992
195.14.28.254,<->,136.25.188.253,0,0,17,2011,17,2011,0.134758000,0.7641
8.252.221.220,<->,4.123.86.144,17,1332,0,0,17,1332,0.133506000,1.8013
143.132.80.71,<->,136.25.188.175,0,0,17,1042,17,1042,0.133137000,0.9294
215.158.238.243,<->,113.23.66.34,17,3078,0,0,17,3078,0.132679000,1.2760
197.113.64.138,<->,136.25.188.226,0,0,17,952,17,952,0.130678000,1.8605
215.158.140.147,<->,8.222.7.162,17,3837,0,0,17,3837,0.129891000,1.8408
215.158.140.241,<->,29.214.109.166,17,2919,0,0,17,2919,0.127822000,0.4688
204.200.33.169,<->,136.25.188.224,0,0,17,1754,17,1754,0.127637000,0.8211
133.178.227.52,<->,133.56.180.38,17,18826,0,0,17,18826,0.124351000,1.4212
136.25.189.57,<->,29.211.228.200,17,9671,0,0,17,9671,0.123928000,1.8520
215.158.238.121,<->,69.150.169.42,17,2061,0,0,17,2061,0.117050000,1.3624
95.247.17.207,<->,8.252.221.220,0,0,17,1024,17,1024,0.115792000,1.7594
136.25.188.172,<->,65.27.220.219,17,4743,0,0,17,4743,0.115277000,1.8642
76.179.210.170,<->,8.252.222.135,0,0,17,1068,17,1068,0.114490000,0.8894
136.25.188.211,<->,104.3.161.56,17,2109,0,0,17,2109,0.108827000,0.7126
247.136.138.229,<->,144.89.245.216,17,17306,0,0,17,17306,0.102722000,1.2798
142.248.90.193,<->,136.25.188.163,0,0,17,952,17,952,0.102589000,0.0806
215.158.239.117,<->,127.246.120.125,17,21587,0,0,17,21587,0.101322000,0.3617
215.158.238.133,<->,131.1.195.249,17,7866,0,0,17,7866,0.101165000,1.6852
133.178.227.57,<->,133.56.180.30,17,8249,0,0,17,8249,0.100452000,1.6058
215.158.239.84,<->,199.20.31.16,17,952,0,0,17,952,0.099421000,1.8599
215.158.238.92,<->,104.3.161.26,17,4851,0,0,17,4851,0.098686000,1.7181
195.5.66.134,<->,136.25.188.225,0,0,17,1782,17,1782,0.098412000,0.9697
199.73.201.218,<->,136.25.188.55,0,0,17,2468,17,2468,0.094000000,1.6215
196.30.108.229,<->,50.223.3.228,0,0,17,850,17,850,0.092386000,1.8728
152.105.182.170,<->,8.252.221.206,0,0,17,904,17,904,0.092147000,1.7945
103.154.12.2,<->,92.27.27.186,0,0,17,2309,17,2309,0.090916000,1.6342
53.231.94.172,<->,48.55.122.124,0,0,17,25568,17,25568,0.089873000,1.7208
215.158.61.243,<->,136.25.189.215,0,0,17,14956,17,14956,0.088449000,1.8817
133.178.227.76,<->,133.56.180.9,17,9619,0,0,17,9619,0.086042000,0.9790
136.25.188.162,<->,41.142.21.110,17,1154,0,0,17,1154,0.085905000,1.7151
95.246.218.197,<->,8.252.221.220,0,0,17,1084,17,1084,0.083554000,1.6546
143.155.227.59,<->,136.25.188.44,0,0,17,2049,17,2049,0.081444000,1.8283
215.158.239.95,<->,207.236.115.177,17,1988,0,0,17,1988,0.080334000,0.5452
199.38.238.137,<->,136.25.188.253,0,0,17,1693,17,1693,0.078392000,0.9700
192.204.123.38,<->,136.25.189.1,0,0,17,8054,17,8054,0.076308000,1.8121
17.255.107.2,<->,8.220.178.194,0,0,17,1270,17,1270,0.075609000,0.1094
194.210.133.239,<->,50.223.3.228,0,0,17,892,17,892,0.074507000,1.9193
239.66.218.250,<->,139.163.41.64,0,0,17,1661,17,1661,0.073811000,1.8116
159.64.157.34,<->,97.198.98.50,0,0,17,21148,17,21148,0.073748000,1.9104
122.12.244.202,<->,92.162.253.82,0,0,17,21929,17,21929,0.073398000,1.4682
94.194.228.43,<->,8.252.221.230,0,0,17,1080,17,1080,0.071442000,1.8935
101.126.179.254,<->,94.242.29.167,17,1084,0,0,17,1084,0.070121000,1.6306
97.198.98.50,<->,92.169.75.211,17,952,0,0,17,952,0.069217000,1.8701
231.136.218.58,<->,215.158.239.78,0,0,17,952,17,952,0.068576000,0.2070
139.163.46.197,<->,116.143.150.136,17,952,0,0,17,952,0.068496000,1.8713
133.178.227.243,<->,80.47.111.58,17,4305,0,0,17,4305,0.068377000,1.8106
133.178.227.19,<->,93.39.51.99,17,3073,0,0,17,3073,0.067992000,1.6817
95.247.78.62,<->,8.252.221.205,0,0,17,1306,17,1306,0.065996000,1.7816
143.72.45.202,<->,136.25.188.54,0,0,17,1208,17,1208,0.065660000,1.3072
142.229.169.5,<->,136.25.188.255,0,0,17,2433,17,2433,0.064666000,1.0784
146.15.20.243,<->,80.27.158.180,0,0,17,6744,17,6744,0.063536000,1.8274
133.178.227.79,<->,123.166.46.117,17,1934,0,0,17,1934,0.063452000,0.7386
215.158.238.198,<->,89.86.110.166,17,6122,0,0,17,6122,0.063230000,1.8795
215.158.239.86,<->,120.154.71.91,17,11024,0,0,17,11024,0.061112000,1.9042
220.39.233.168,<->,215.158.238.82,0,0,17,5980,17,5980,0.060596000,1.8434
216.184.1.91,<->,8.252.222.170,0,0,17,14883,17,14883,0.060077000,0.5537
199.70.191.248,<->,136.25.188.44,0,0,17,2048,17,2048,0.059497000,0.8979
215.158.238.105,<->,8.222.109.123,17,1084,0,0,17,1084,0.059159000,1.9142
215.158.238.196,<->,131.22.233.146,17,3965,0,0,17,3965,0.057440000,1.8461
145.116.119.52,<->,53.239.135.111,17,13230,0,0,17,13230,0.055692000,1.9253
215.158.239.50,<->,126.219.191.58,17,6993,0,0,17,6993,0.052996000,1.8024
215.158.6.212,<->,8.252.223.130,0,0,17,4155,17,4155,0.051996000,1.5460
215.158.238.221,<->,8.222.6.193,17,2999,0,0,17,2999,0.051254000,0.6370
215.158.238.176,<->,192.226.161.38,17,5006,0,0,17,5006,0.048337000,1.6513
215.158.239.66,<->,98.219.126.140,17,23814,0,0,17,23814,0.047389000,1.0192
139.163.34.3,<->,89.204.3.233,17,952,0,0,17,952,0.044686000,1.9072
53.231.66.6,<->,48.54.81.68,0,0,17,25092,17,25092,0.043732000,1.8006
215.158.140.76,<->,131.144.112.246,17,5029,0,0,17,5029,0.043240000,1.4305
94.193.80.56,<->,8.252.221.221,0,0,17,894,17,894,0.042076000,1.9247
111.151.139.139,<->,8.252.221.226,0,0,17,6310,17,6310,0.040258000,1.9564
133.178.226.71,<->,8.191.7.223,17,7048,0,0,17,7048,0.039602000,1.9392
199.38.111.142,<->,136.25.188.174,0,0,17,2319,17,2319,0.039568000,1.8429
136.25.189.46,<->,29.212.199.229,17,9563,0,0,17,9563,0.037795000,1.9500
133.178.227.2,<->,133.56.180.9,17,9652,0,0,17,9652,0.036814000,1.6718
215.158.238.148,<->,106.188.183.105,17,3930,0,0,17,3930,0.035261000,1.7310
220.80.180.55,<->,139.241.56.117,17,24750,0,0,17,24750,0.035140000,1.6808
17.136.211.157,<->,8.220.180.180,0,0,17,952,17,952,0.034934000,0.0079
69.103.120.52,<->,8.252.221.236,0,0,17,1678,17,1678,0.034505000,1.8818
215.158.239.92,<->,199.20.63.99,17,2806,0,0,17,2806,0.034250000,1.9135
48.17.51.75,<->,8.252.221.204,0,0,17,1688,17,1688,0.034186000,1.9332
136.25.188.221,<->,126.219.247.16,17,2221,0,0,17,2221,0.032156000,0.2527
214.245.140.57,<->,50.224.118.88,0,0,17,938,17,938,0.032028000,1.4720
195.127.57.50,<->,136.25.188.162,0,0,17,1941,17,1941,0.031996000,1.0579
215.158.239.96,<->,195.126.189.33,17,1952,0,0,17,1952,0.030558000,0.5489
111.151.139.138,<->,8.252.221.214,0,0,17,6310,17,6310,0.029612000,1.9564
215.158.238.135,<->,8.190.217.127,17,1028,0,0,17,1028,0.027170000,0.0288
133.178.227.19,<->,33.209.219.25,17,6426,0,0,17,6426,0.026572000,1.9559
220.39.233.217,<->,215.158.238.106,0,0,17,4819,17,4819,0.026273000,1.0978
92.27.219.147,<->,57.240.3.219,17,19123,0,0,17,19123,0.025848000,1.3837
133.178.227.30,<->,133.56.180.25,17,17628,0,0,17,17628,0.025667000,1.9536
136.25.188.163,<->,35.104.42.45,17,997,0,0,17,997,0.024661000,0.1688
99.162.77.146,<->,53.243.12.169,17,4677,0,0,17,4677,0.024072000,1.8583
207.57.19.45,<->,136.25.188.241,0,0,17,1046,17,1046,0.023817000,0.5130
8.252.223.176,<->,8.219.184.149,17,5324,0,0,17,5324,0.022829000,1.8249
206.17.241.68,<->,80.40.50.117,0,0,17,884,17,884,0.022751000,0.7182
215.158.238.99,<->,136.139.59.124,17,4274,0,0,17,4274,0.022472000,1.6011
199.73.145.97,<->,136.25.188.177,0,0,17,1078,17,1078,0.021759000,1.3620
215.158.140.93,<->,126.219.246.239,17,4048,0,0,17,4048,0.019189000,1.5678
50.224.91.83,<->,50.176.250.138,17,952,0,0,17,952,0.018002000,1.8552
133.178.227.10,<->,133.56.180.2,17,18487,0,0,17,18487,0.017805000,1.2593
215.158.239.56,<->,207.188.67.91,17,1795,0,0,17,1795,0.017422000,0.7337
144.85.170.244,<->,89.230.228.136,17,850,0,0,17,850,0.016893000,1.6457
136.25.188.160,<->,65.27.220.219,17,3782,0,0,17,3782,0.016187000,1.9691
158.85.50.71,<->,133.178.227.1,0,0,17,4215,17,4215,0.014869000,1.7940
136.25.189.21,<->,56.28.207.196,17,15712,0,0,17,15712,0.014088000,1.5458
133.178.227.242,<->,120.154.187.198,17,5127,0,0,17,5127,0.013789000,1.5603
144.85.170.254,<->,98.87.144.155,17,952,0,0,17,952,0.013620000,0.1192
142.255.56.186,<->,136.25.188.52,0,0,17,2060,17,2060,0.013065000,1.4486
136.25.188.210,<->,122.158.245.102,17,5916,0,0,17,5916,0.012119000,1.3858
215.158.238.81,<->,119.196.23.0,17,6044,0,0,17,6044,0.011290000,1.9230
215.158.238.92,<->,145.116.209.91,17,10863,0,0,17,10863,0.010388000,1.9675
215.158.238.92,<->,145.116.209.90,17,9650,0,0,17,9650,0.010058000,1.8161
133.178.226.29,<->,106.41.201.42,17,952,0,0,17,952,0.010003000,0.0011
215.158.238.236,<->,8.240.116.231,17,4226,0,0,17,4226,0.009460000,1.9895
215.158.239.93,<->,199.20.30.134,17,1013,0,0,17,1013,0.008729000,0.6296
221.196.122.175,<->,138.98.250.43,0,0,17,952,17,952,0.008096000,1.9596
129.243.217.199,<->,80.27.153.103,0,0,17,6369,17,6369,0.007373000,1.9767
196.206.213.182,<->,136.25.188.220,0,0,17,2490,17,2490,0.007295000,0.6872
120.114.211.51,<->,89.183.104.172,0,0,17,986,17,986,0.005636000,1.9105
136.25.188.173,<->,111.151.239.87,17,6140,0,0,17,6140,0.005452000,1.7512
127.159.140.231,<->,98.232.172.244,0,0,17,19703,17,19703,0.004276000,0.3401
215.158.239.58,<->,207.61.34.5,17,1840,0,0,17,1840,0.004144000,1.9031
133.54.43.82,<->,112.21.139.241,17,952,0,0,17,952,0.004128000,0.1316
195.213.129.176,<->,50.223.3.228,0,0,17,904,17,904,0.003313000,1.9297
215.158.239.99,<->,199.20.31.127,17,964,0,0,17,964,0.003205000,0.2403
220.60.81.164,<->,136.25.189.46,0,0,17,9415,17,9415,0.002529000,1.9644
136.25.189.83,<->,29.211.228.176,17,7717,0,0,17,7717,0.002160000,1.3755
68.72.204.26,<->,8.252.221.222,0,0,17,952,17,952,0.001552000,0.5818
95.246.99.131,<->,8.252.221.222,0,0,17,920,17,920,0.000535000,1.9072
199.52.135.210,<->,136.25.188.55,0,0,17,1277,17,1277,0.000170000,0.5623
100.50.96.237,<->,8.252.223.141,0,0,17,7252,17,7252,0.000079000,1.8290
139.47.239.28,<->,33.106.172.157,16,22663,0,0,16,22663,1.950272000,0.0250
93.181.154.23,<->,92.27.219.145,0,0,16,17101,16,17101,1.736246000,0.1969
133.178.226.14,<->,8.222.212.40,16,2146,0,0,16,2146,1.733011000,0.1054
109.119.182.230,<->,8.182.244.19,0,0,16,1001,16,1001,1.730839000,0.1931
133.178.227.41,<->,131.22.233.138,16,1876,0,0,16,1876,1.708401000,0.2734
137.44.153.212,<->,136.25.188.198,0,0,16,2110,16,2110,1.630525000,0.1133
220.28.114.28,<->,215.158.238.116,0,0,16,21810,16,21810,1.585749000,0.0487
215.158.238.197,<->,8.222.0.245,16,2052,0,0,16,2052,1.580947000,0.3922
133.178.227.16,<->,69.31.238.216,16,1883,0,0,16,1883,1.564063000,0.3999
8.252.222.35,<->,8.219.184.146,16,23711,0,0,16,23711,1.556230000,0.0018
215.158.140.87,<->,132.213.244.180,16,2569,0,0,16,2569,1.530058000,0.3184
207.172.149.78,<->,136.25.188.196,0,0,16,944,16,944,1.528532000,0.3680
215.158.238.193,<->,215.158.33.121,16,22714,0,0,16,22714,1.458229000,0.0013
8.183.24.79,<->,6.245.226.89,16,1921,0,0,16,1921,1.458121000,0.3756
136.25.188.192,<->,96.156.169.173,16,18207,0,0,16,18207,1.442614000,0.5549
215.158.239.97,<->,196.109.149.114,16,1489,0,0,16,1489,1.439824000,0.4601
215.158.238.92,<->,80.47.228.215,16,1836,0,0,16,1836,1.430105000,0.4320
133.178.226.61,<->,29.212.195.10,16,1989,0,0,16,1989,1.351893000,0.1680
94.193.87.81,<->,8.252.222.127,0,0,16,1004,16,1004,1.346506000,0.4993
252.171.236.72,<->,50.224.76.248,0,0,16,10403,16,10403,1.260199000,0.2500
142.236.202.155,<->,136.25.188.177,0,0,16,3282,16,3282,1.253855000,0.7335
159.23.130.164,<->,136.25.188.254,0,0,16,2181,16,2181,1.253706000,0.0532
220.28.85.14,<->,136.25.189.8,0,0,16,12711,16,12711,1.228428000,0.7658
254.242.184.207,<->,58.202.245.16,16,1345,0,0,16,1345,1.208321000,0.7090
134.48.97.57,<->,80.42.185.67,0,0,16,980,16,980,1.197712000,0.7818
194.237.11.86,<->,136.25.188.198,0,0,16,2578,16,2578,1.194599000,0.5095
136.25.188.53,<->,50.176.223.89,16,2367,0,0,16,2367,1.191139000,0.4548
159.23.130.164,<->,133.178.226.61,0,0,16,2181,16,2181,1.176961000,0.0490
8.252.222.199,<->,4.121.253.129,16,1250,0,0,16,1250,1.169234000,0.6113
221.102.143.189,<->,98.128.149.196,0,0,16,10588,16,10588,1.165869000,0.3599
197.103.151.87,<->,133.178.226.61,0,0,16,2197,16,2197,1.164617000,0.3877
207.21.2.14,<->,8.252.222.23,0,0,16,2408,16,2408,1.153762000,0.6896
195.69.146.135,<->,136.25.188.163,0,0,16,2401,16,2401,1.151679000,0.7559
66.63.121.251,<->,8.252.221.238,0,0,16,2066,16,2066,1.144788000,0.7437
17.204.222.243,<->,8.220.177.212,0,0,16,1865,16,1865,1.140883000,0.3809
215.158.239.85,<->,207.236.235.100,16,2503,0,0,16,2503,1.116032000,0.8431
133.178.227.242,<->,111.150.74.121,16,12150,0,0,16,12150,1.109620000,0.1840
215.158.238.198,<->,18.202.90.165,16,3226,0,0,16,3226,1.066129000,0.7880
133.178.227.19,<->,111.150.187.215,16,3434,0,0,16,3434,1.057663000,0.5927
215.158.239.224,<->,145.116.223.4,16,20730,0,0,16,20730,1.050707000,0.0857
136.139.59.106,<->,136.25.188.255,0,0,16,2355,16,2355,1.038756000,0.4906
215.158.239.87,<->,204.21.96.63,16,3223,0,0,16,3223,1.036131000,0.7070
143.155.227.54,<->,133.178.226.49,0,0,16,1968,16,1968,1.033745000,0.6350
221.102.143.189,<->,6.74.84.69,0,0,16,16028,16,16028,1.028685000,0.6632
111.150.74.74,<->,99.74.26.144,0,0,16,9833,16,9833,1.020763000,0.7728
136.25.189.43,<->,100.216.78.145,16,21449,0,0,16,21449,1.009102000,0.9306
215.158.239.76,<->,199.20.4.50,16,1081,0,0,16,1081,1.008545000,0.3400
215.158.239.49,<->,199.20.28.2,16,2412,0,0,16,2412,0.997380000,0.9957
210.158.44.190,<->,124.55.166.114,16,18114,0,0,16,18114,0.954189000,0.3651
120.154.99.219,<->,8.176.8.48,0,0,16,16100,16,16100,0.953872000,1.0347
142.190.245.222,<->,136.25.188.175,0,0,16,896,16,896,0.923459000,0.4120
215.158.239.57,<->,142.221.134.198,16,2213,0,0,16,2213,0.899423000,1.0710
142.190.183.209,<->,136.25.188.174,0,0,16,1803,16,1803,0.895682000,0.8298
196.247.119.116,<->,136.25.188.174,0,0,16,1963,16,1963,0.878332000,1.0795
215.158.61.189,<->,8.176.8.176,0,0,16,11548,16,11548,0.860992000,1.0721
207.60.43.197,<->,136.25.188.198,0,0,16,3224,16,3224,0.858863000,1.0412
215.158.238.66,<->,0.34.21.19,16,2021,0,0,16,2021,0.857011000,0.1224
142.255.40.201,<->,136.25.188.173,0,0,16,2106,16,2106,0.853957000,0.8935
142.209.125.133,<->,136.25.188.222,0,0,16,2461,16,2461,0.850723000,1.0680
192.65.97.112,<->,8.55.224.156,16,15915,0,0,16,15915,0.837209000,0.1636
196.88.183.93,<->,136.25.188.220,0,0,16,1931,16,1931,0.831851000,0.9958
215.158.238.132,<->,8.190.216.249,16,4655,0,0,16,4655,0.814993000,1.0732
215.158.239.76,<->,199.20.4.7,16,1975,0,0,16,1975,0.813974000,1.0794
133.178.227.14,<->,100.50.96.203,16,3306,0,0,16,3306,0.780029000,0.9238
142.227.128.98,<->,136.25.188.239,0,0,16,1493,16,1493,0.770776000,0.9022
109.222.216.36,<->,53.214.88.203,16,5039,0,0,16,5039,0.760184000,0.3294
215.158.239.92,<->,199.20.7.43,16,3461,0,0,16,3461,0.747738000,1.2400
215.158.239.49,<->,207.228.134.130,16,2368,0,0,16,2368,0.742288000,1.1289
159.137.160.61,<->,120.101.94.28,16,1213,0,0,16,1213,0.742236000,1.1604
129.236.114.39,<->,33.233.141.76,0,0,16,18575,16,18575,0.702537000,0.9461
136.25.189.32,<->,56.28.207.202,16,6432,0,0,16,6432,0.698066000,1.1350
129.252.19.149,<->,8.182.244.237,0,0,16,1656,16,1656,0.690158000,0.5557
215.158.238.120,<->,69.150.169.181,16,4463,0,0,16,4463,0.685885000,1.1354
192.229.42.171,<->,136.25.188.180,0,0,16,5285,16,5285,0.669217000,0.1716
142.234.32.238,<->,8.52.175.115,0,0,16,1765,16,1765,0.662982000,1.3345
197.125.118.214,<->,133.178.227.14,0,0,16,3562,16,3562,0.650493000,1.0918
215.158.238.33,<->,114.25.48.52,16,2229,0,0,16,2229,0.642690000,0.1898
133.178.227.27,<->,8.192.205.72,16,3969,0,0,16,3969,0.639205000,1.1077
215.158.239.49,<->,195.41.163.2,16,1826,0,0,16,1826,0.629140000,0.7418
145.252.117.167,<->,79.20.58.74,16,1928,0,0,16,1928,0.617760000,1.2654
215.158.239.58,<->,207.115.116.172,16,2602,0,0,16,2602,0.615196000,0.4699
207.63.5.97,<->,136.25.188.163,0,0,16,1776,16,1776,0.611750000,1.2304
220.28.104.193,<->,215.158.238.247,0,0,16,21670,16,21670,0.607420000,0.0665
215.158.238.221,<->,126.219.191.11,16,3908,0,0,16,3908,0.606544000,1.1738
133.178.226.7,<->,100.50.100.23,16,3491,0,0,16,3491,0.577597000,0.3510
215.158.239.95,<->,196.104.169.239,16,3296,0,0,16,3296,0.577515000,1.3397
136.25.188.53,<->,119.196.23.21,16,2493,0,0,16,2493,0.572821000,1.0599
136.25.189.15,<->,131.144.115.254,16,4683,0,0,16,4683,0.567895000,1.3495
199.80.85.234,<->,136.25.188.225,0,0,16,2163,16,2163,0.567837000,0.9929
133.178.226.246,<->,111.151.139.216,16,896,0,0,16,896,0.564338000,0.1031
136.25.188.174,<->,80.47.111.106,16,6745,0,0,16,6745,0.553261000,1.4242
215.158.239.56,<->,142.237.129.145,16,1599,0,0,16,1599,0.544123000,0.5918
215.158.239.31,<->,29.214.74.194,16,6937,0,0,16,6937,0.543725000,1.3589
194.232.237.196,<->,136.25.188.220,0,0,16,1994,16,1994,0.541162000,1.2601
215.158.238.83,<->,57.210.107.42,16,4543,0,0,16,4543,0.525331000,1.1690
215.158.30.184,<->,136.25.188.244,0,0,16,12512,16,12512,0.521803000,0.5715
215.158.239.4,<->,8.191.6.111,16,7168,0,0,16,7168,0.513903000,1.2268
215.158.140.76,<->,61.72.108.214,16,2907,0,0,16,2907,0.511124000,1.4003
215.158.239.27,<->,96.135.154.156,16,16886,0,0,16,16886,0.506826000,1.2789
142.249.202.133,<->,136.25.188.198,0,0,16,2485,16,2485,0.503637000,0.9005
133.178.227.79,<->,113.23.101.169,16,4268,0,0,16,4268,0.496831000,1.4431
136.25.189.81,<->,96.156.169.169,16,6548,0,0,16,6548,0.490658000,1.4612
133.178.227.24,<->,133.56.180.81,16,8057,0,0,16,8057,0.488523000,0.8500
215.158.238.94,<->,192.204.170.197,16,4639,0,0,16,4639,0.485274000,1.3918
193.74.180.128,<->,139.163.71.70,0,0,16,15492,16,15492,0.483474000,1.4855
133.178.226.61,<->,96.155.60.202,16,8140,0,0,16,8140,0.476775000,1.1091
195.7.228.211,<->,136.25.188.196,0,0,16,2410,16,2410,0.472710000,0.8853
159.23.227.225,<->,112.10.159.14,16,961,0,0,16,961,0.472516000,0.8965
142.167.142.0,<->,136.25.188.238,0,0,16,2412,16,2412,0.469886000,1.2851
247.136.217.118,<->,8.20.81.74,16,23378,0,0,16,23378,0.465271000,0.1041
195.0.175.222,<->,8.52.181.95,0,0,16,1125,16,1125,0.461106000,0.5923
215.158.238.134,<->,33.220.0.39,16,1934,0,0,16,1934,0.453361000,1.4147
215.158.239.50,<->,142.206.241.125,16,2966,0,0,16,2966,0.434085000,1.5610
94.194.209.218,<->,8.252.222.49,0,0,16,1933,16,1933,0.431244000,1.4612
133.178.226.18,<->,8.255.92.228,16,4527,0,0,16,4527,0.428452000,1.3496
199.72.82.90,<->,136.25.188.252,0,0,16,1482,16,1482,0.428056000,0.5987
143.132.219.180,<->,136.25.188.255,0,0,16,2428,16,2428,0.427301000,1.2506
145.242.124.39,<->,102.51.175.212,0,0,16,11525,16,11525,0.420254000,0.2021
197.113.64.144,<->,136.25.188.174,0,0,16,1943,16,1943,0.417496000,1.4698
204.200.41.38,<->,136.25.188.241,0,0,16,2063,16,2063,0.413944000,0.9284
199.15.255.209,<->,136.25.188.252,0,0,16,1457,16,1457,0.410488000,1.5556
193.36.78.114,<->,89.183.108.40,0,0,16,4656,16,4656,0.410241000,1.5409
215.158.239.56,<->,199.20.6.46,16,2409,0,0,16,2409,0.406024000,1.3300
215.158.239.49,<->,199.73.44.127,16,2396,0,0,16,2396,0.398413000,1.1981
136.25.188.52,<->,126.219.194.186,16,5860,0,0,16,5860,0.395845000,1.3064
220.28.115.46,<->,133.178.227.21,0,0,16,18952,16,18952,0.390453000,0.5493
215.158.238.120,<->,113.23.104.203,16,1995,0,0,16,1995,0.389350000,1.2498
215.158.239.76,<->,136.139.59.125,16,7225,0,0,16,7225,0.385953000,1.5480
215.158.239.61,<->,98.219.126.175,16,9378,0,0,16,9378,0.385607000,1.3595
215.158.238.135,<->,80.47.111.90,16,5632,0,0,16,5632,0.382878000,0.8343
89.164.4.169,<->,8.52.187.70,0,0,16,2299,16,2299,0.375807000,0.3161
207.190.79.213,<->,136.25.188.198,0,0,16,1923,16,1923,0.373102000,1.0423
204.141.230.251,<->,8.252.222.161,0,0,16,2624,16,2624,0.372948000,0.3653
136.25.188.237,<->,116.106.60.159,16,3194,0,0,16,3194,0.366457000,0.8900
215.158.239.31,<->,215.158.127.150,16,6778,0,0,16,6778,0.356568000,1.4723
136.25.189.45,<->,96.156.169.28,16,6841,0,0,16,6841,0.356334000,1.3063
133.178.226.90,<->,8.222.212.27,16,3018,0,0,16,3018,0.355718000,0.7785
204.2.41.205,<->,136.25.188.196,0,0,16,1732,16,1732,0.351735000,0.2954
113.254.12.142,<->,92.27.219.200,0,0,16,896,16,896,0.351193000,1.4965
136.25.188.225,<->,8.227.55.135,16,2485,0,0,16,2485,0.350760000,0.6168
133.178.226.30,<->,99.192.168.150,16,5360,0,0,16,5360,0.350391000,1.1867
202.77.251.220,<->,8.252.221.221,0,0,16,1308,16,1308,0.349779000,1.5631
215.158.140.131,<->,215.158.42.206,16,21930,0,0,16,21930,0.348243000,0.0013
215.158.140.60,<->,122.159.123.91,16,5276,0,0,16,5276,0.340750000,1.6022
136.25.189.14,<->,80.56.79.51,16,7189,0,0,16,7189,0.337543000,1.6393
215.158.239.77,<->,199.20.5.105,16,1857,0,0,16,1857,0.320787000,1.1602
216.144.221.244,<->,215.158.140.193,0,0,16,1919,16,1919,0.314812000,1.3049
144.232.206.149,<->,0.195.210.46,0,0,16,4920,16,4920,0.311683000,0.8448
143.89.139.130,<->,136.25.188.222,0,0,16,2435,16,2435,0.307348000,0.5731
215.158.61.189,<->,8.176.8.248,0,0,16,16797,16,16797,0.300441000,1.4626
133.178.226.38,<->,8.42.43.36,16,7113,0,0,16,7113,0.294668000,1.4461
136.25.189.27,<->,96.156.169.210,16,13934,0,0,16,13934,0.288208000,1.5926
136.25.189.83,<->,29.212.199.27,16,6857,0,0,16,6857,0.280216000,1.6228
129.236.114.39,<->,101.224.89.150,0,0,16,20753,16,20753,0.279809000,0.0664
206.195.88.219,<->,102.51.87.198,0,0,16,19489,16,19489,0.276584000,0.8497
8.20.87.92,<->,6.145.149.209,16,2134,0,0,16,2134,0.275873000,0.4521
136.25.188.47,<->,65.27.228.213,16,3210,0,0,16,3210,0.271747000,1.6688
215.158.239.49,<->,199.20.29.153,16,818,0,0,16,818,0.270264000,0.1898
215.158.42.59,<->,8.252.223.153,0,0,16,3754,16,3754,0.266936000,0.9222
215.158.239.51,<->,199.20.30.197,16,2630,0,0,16,2630,0.266630000,1.6890
195.124.234.45,<->,136.25.188.174,0,0,16,1882,16,1882,0.263252000,1.7208
215.158.61.195,<->,8.176.8.89,0,0,16,6599,16,6599,0.248447000,1.6273
143.10.227.173,<->,136.25.188.175,0,0,16,3479,16,3479,0.240536000,1.7121
142.220.120.173,<->,136.25.188.176,0,0,16,1912,16,1912,0.239489000,1.6805
195.71.140.171,<->,136.25.188.255,0,0,16,2424,16,2424,0.231798000,0.5373
92.181.172.215,<->,8.204.53.229,16,1880,0,0,16,1880,0.229540000,0.5081
133.178.226.77,<->,48.131.158.252,16,3482,0,0,16,3482,0.224883000,0.7891
215.158.239.99,<->,195.55.135.171,16,1815,0,0,16,1815,0.220203000,1.0560
136.25.188.173,<->,91.57.173.54,16,8318,0,0,16,8318,0.216216000,1.6780
215.158.239.95,<->,142.237.129.145,16,1793,0,0,16,1793,0.216082000,0.8414
215.158.238.177,<->,8.190.217.52,16,3876,0,0,16,3876,0.213897000,1.4984
136.25.188.255,<->,126.219.194.161,16,5059,0,0,16,5059,0.213868000,1.3640
98.197.185.159,<->,8.228.219.58,0,0,16,2044,16,2044,0.213463000,1.5608
136.25.188.254,<->,104.3.163.14,16,5684,0,0,16,5684,0.213407000,1.4278
133.178.226.29,<->,8.42.43.37,16,7001,0,0,16,7001,0.212489000,1.6925
142.229.9.248,<->,136.25.188.238,0,0,16,2117,16,2117,0.209944000,0.4205
215.158.238.145,<->,97.174.232.216,16,14240,0,0,16,14240,0.209344000,1.6967
215.158.140.83,<->,126.219.101.174,16,4072,0,0,16,4072,0.207872000,1.3055
215.158.238.83,<->,80.47.111.65,16,4431,0,0,16,4431,0.201044000,0.4845
195.41.227.184,<->,136.25.188.54,0,0,16,1813,16,1813,0.200276000,0.8438
133.178.226.212,<->,122.158.49.183,16,896,0,0,16,896,0.199307000,1.6634
136.25.189.13,<->,126.219.194.25,16,8606,0,0,16,8606,0.195353000,1.7840
215.158.238.153,<->,139.163.161.62,16,12617,0,0,16,12617,0.193317000,0.4445
215.158.44.185,<->,136.25.189.28,0,0,16,8942,16,8942,0.190812000,1.7662
207.173.95.133,<->,136.25.188.253,0,0,16,1959,16,1959,0.189823000,1.2393
215.158.239.95,<->,143.53.141.154,16,1540,0,0,16,1540,0.189334000,0.3415
215.158.238.114,<->,80.47.111.66,16,7061,0,0,16,7061,0.187590000,1.5457
215.158.239.79,<->,199.122.59.17,16,1896,0,0,16,1896,0.186517000,1.7696
133.178.227.19,<->,69.150.168.244,16,4868,0,0,16,4868,0.185684000,1.7113
133.178.226.95,<->,100.216.78.145,16,22795,0,0,16,22795,0.184073000,0.8018
215.158.239.56,<->,195.83.176.83,16,1855,0,0,16,1855,0.183544000,0.6296
136.25.189.62,<->,56.28.207.191,16,15721,0,0,16,15721,0.180728000,1.7094
215.158.239.97,<->,195.42.202.249,16,1820,0,0,16,1820,0.178987000,1.3585
215.158.239.93,<->,195.55.214.71,16,896,0,0,16,896,0.178649000,0.3645
145.166.2.99,<->,8.182.226.194,0,0,16,2218,16,2218,0.174284000,1.4090
215.158.238.134,<->,119.196.23.52,16,3498,0,0,16,3498,0.172265000,1.7428
215.158.238.73,<->,33.209.217.230,16,5092,0,0,16,5092,0.171159000,1.1959
136.25.189.0,<->,29.211.228.200,16,6532,0,0,16,6532,0.170771000,1.7776
136.25.189.17,<->,29.214.108.215,16,7870,0,0,16,7870,0.168105000,1.7503
143.87.228.208,<->,136.25.188.220,0,0,16,896,16,896,0.167194000,0.1486
215.158.239.58,<->,196.94.176.109,16,1637,0,0,16,1637,0.163276000,0.7693
196.119.216.210,<->,50.223.3.228,0,0,16,824,16,824,0.162533000,1.7792
136.25.189.28,<->,96.156.169.223,16,8798,0,0,16,8798,0.160083000,1.6666
195.54.103.253,<->,136.25.188.178,0,0,16,896,16,896,0.157210000,0.2998
48.16.142.71,<->,8.252.221.230,0,0,16,1032,16,1032,0.156991000,1.7186
136.25.188.243,<->,8.222.212.10,16,3370,0,0,16,3370,0.156576000,0.8030
215.158.140.229,<->,8.57.163.158,16,1950,0,0,16,1950,0.152585000,1.8153
136.25.188.44,<->,69.150.168.246,16,5860,0,0,16,5860,0.151674000,1.4910
215.158.239.87,<->,199.20.30.101,16,1864,0,0,16,1864,0.151094000,0.4491
93.95.39.140,<->,50.224.76.248,0,0,16,4711,16,4711,0.148132000,0.6237
143.10.126.95,<->,136.25.188.225,0,0,16,1810,16,1810,0.147778000,1.2444
136.25.188.253,<->,8.255.92.246,16,4411,0,0,16,4411,0.147078000,1.6473
215.158.238.236,<->,126.219.101.144,16,2935,0,0,16,2935,0.141979000,1.6766
215.158.239.86,<->,120.154.71.53,16,7045,0,0,16,7045,0.141741000,1.5813
215.158.239.33,<->,215.158.127.149,16,5434,0,0,16,5434,0.141127000,1.5428
230.156.240.7,<->,8.252.221.205,0,0,16,848,16,848,0.139291000,1.7540
215.158.239.40,<->,29.211.5.164,16,5284,0,0,16,5284,0.137605000,1.0708
92.27.219.54,<->,88.5.223.142,16,1583,0,0,16,1583,0.137071000,1.7143
204.142.55.3,<->,50.223.3.228,0,0,16,800,16,800,0.133989000,1.3697
43.55.250.109,<->,8.252.221.196,0,0,16,968,16,968,0.133604000,1.7869
215.158.214.223,<->,8.176.8.88,0,0,16,8654,16,8654,0.132943000,1.7689
57.83.4.242,<->,35.56.97.193,0,0,16,800,16,800,0.131747000,1.7428
195.5.40.52,<->,136.25.188.178,0,0,16,2121,16,2121,0.128532000,0.7116
204.1.235.138,<->,136.25.188.160,0,0,16,2656,16,2656,0.127454000,1.8106
215.158.239.93,<->,194.237.190.26,16,2482,0,0,16,2482,0.127453000,0.7754
196.87.49.136,<->,136.25.188.239,0,0,16,2507,16,2507,0.126367000,1.0999
136.25.188.196,<->,113.23.20.105,16,6180,0,0,16,6180,0.126271000,1.8545
133.178.227.19,<->,57.184.236.83,16,896,0,0,16,896,0.125412000,0.0010
199.4.24.122,<->,50.223.3.228,0,0,16,848,16,848,0.124714000,1.8742
220.28.115.46,<->,136.25.189.39,0,0,16,19043,16,19043,0.124199000,1.8371
215.158.140.241,<->,197.125.117.129,16,3955,0,0,16,3955,0.124106000,1.8559
145.13.164.50,<->,133.178.227.251,0,0,16,10683,16,10683,0.121687000,1.8377
129.209.198.203,<->,8.182.136.20,0,0,16,944,16,944,0.120486000,0.3835
215.158.238.47,<->,104.3.168.217,16,7369,0,0,16,7369,0.120248000,1.7924
221.102.143.189,<->,102.83.183.153,0,0,16,12209,16,12209,0.119696000,1.3411
152.40.77.165,<->,8.252.222.148,0,0,16,1344,16,1344,0.119172000,1.8005
215.158.239.94,<->,196.104.233.238,16,3356,0,0,16,3356,0.118398000,1.0178
201.143.50.223,<->,8.252.222.62,0,0,16,2323,16,2323,0.118067000,0.7282
75.214.219.131,<->,8.252.221.220,0,0,16,830,16,830,0.117494000,1.7887
196.22.94.231,<->,89.183.104.177,0,0,16,20996,16,20996,0.114655000,1.5968
215.158.239.57,<->,196.105.30.196,16,3387,0,0,16,3387,0.113972000,0.6288
8.252.221.230,<->,4.122.60.98,16,1632,0,0,16,1632,0.111002000,1.6372
215.158.239.49,<->,195.55.148.74,16,1805,0,0,16,1805,0.110769000,1.7488
199.52.80.127,<->,136.25.188.174,0,0,16,2167,16,2167,0.110151000,0.7874
29.214.108.201,<->,8.252.223.130,0,0,16,3918,16,3918,0.109440000,1.8518
96.155.148.99,<->,50.224.75.42,0,0,16,1024,16,1024,0.109078000,1.4677
207.58.162.88,<->,136.25.188.236,0,0,16,839,16,839,0.107945000,0.2183
215.158.239.79,<->,199.14.9.124,16,2466,0,0,16,2466,0.107819000,0.7603
156.142.11.103,<->,8.252.222.227,0,0,16,1140,16,1140,0.107658000,1.3123
111.20.172.70,<->,33.233.141.71,0,0,16,1827,16,1827,0.107015000,1.0074
195.54.103.253,<->,136.25.188.238,0,0,16,3230,16,3230,0.106073000,0.7860
126.223.18.230,<->,92.27.219.247,0,0,16,1073,16,1073,0.104769000,1.8095
143.95.86.26,<->,136.25.188.174,0,0,16,2387,16,2387,0.104352000,0.3415
204.47.49.224,<->,50.223.3.228,0,0,16,800,16,800,0.103117000,1.8672
136.25.188.47,<->,104.3.163.25,16,5892,0,0,16,5892,0.102739000,1.8468
136.25.188.221,<->,126.219.132.252,16,3290,0,0,16,3290,0.102485000,1.3364
136.25.189.57,<->,106.188.253.230,16,7220,0,0,16,7220,0.102445000,1.6853
133.178.226.94,<->,96.155.60.210,16,7844,0,0,16,7844,0.101395000,1.3709
220.39.233.196,<->,133.178.226.90,0,0,16,5796,16,5796,0.100295000,1.6043
207.59.20.253,<->,136.25.188.209,0,0,16,2604,16,2604,0.098195000,1.1926
195.4.163.27,<->,136.25.188.198,0,0,16,1945,16,1945,0.097748000,1.2002
215.158.239.76,<->,199.20.29.243,16,806,0,0,16,806,0.097556000,0.2206
136.25.189.29,<->,8.50.171.231,16,9763,0,0,16,9763,0.095641000,1.8759
197.107.119.42,<->,136.25.188.252,0,0,16,1456,16,1456,0.095130000,0.2925
136.25.188.45,<->,106.188.236.165,16,7193,0,0,16,7193,0.094905000,1.7153
199.80.212.72,<->,136.25.188.196,0,0,16,986,16,986,0.092528000,1.5495
43.52.205.20,<->,8.252.221.204,0,0,16,1640,16,1640,0.091369000,1.9040
215.158.239.59,<->,126.219.194.19,16,8174,0,0,16,8174,0.089443000,1.8742
215.158.238.198,<->,106.188.253.27,16,4029,0,0,16,4029,0.088823000,1.7233
133.178.227.24,<->,133.56.180.7,16,10684,0,0,16,10684,0.085286000,1.1946
110.88.231.173,<->,50.224.88.107,0,0,16,908,16,908,0.083507000,1.8708
136.25.189.80,<->,118.20.100.121,16,5956,0,0,16,5956,0.080918000,1.1681
215.158.239.56,<->,199.79.149.107,16,957,0,0,16,957,0.080166000,0.6820
220.185.79.194,<->,89.183.108.132,0,0,16,1384,16,1384,0.079601000,1.5848
215.158.238.251,<->,89.86.110.223,16,7354,0,0,16,7354,0.079128000,1.6773
111.20.172.118,<->,33.233.141.227,0,0,16,7201,16,7201,0.078508000,0.8873
215.158.239.94,<->,195.15.87.61,16,957,0,0,16,957,0.077527000,0.2343
204.184.127.58,<->,136.25.188.53,0,0,16,2485,16,2485,0.076757000,0.7704
93.236.5.150,<->,35.56.99.76,0,0,16,11490,16,11490,0.075484000,1.5452
204.61.175.233,<->,136.25.188.46,0,0,16,1076,16,1076,0.073507000,0.1280
215.158.234.146,<->,133.178.227.245,0,0,16,8204,16,8204,0.072221000,0.5699
136.25.188.176,<->,100.224.202.149,16,8599,0,0,16,8599,0.069710000,1.8949
215.201.245.121,<->,8.182.226.78,0,0,16,5138,16,5138,0.067124000,0.6915
215.158.238.141,<->,131.1.195.185,16,6594,0,0,16,6594,0.066835000,1.8482
197.113.64.185,<->,136.25.188.173,0,0,16,2532,16,2532,0.065746000,0.9588
207.117.160.72,<->,100.93.89.174,0,0,16,896,16,896,0.061927000,1.9055
215.158.140.92,<->,111.150.187.223,16,5507,0,0,16,5507,0.059929000,1.7830
143.155.228.41,<->,133.178.226.28,0,0,16,3258,16,3258,0.059179000,0.6321
213.186.52.63,<->,159.137.246.87,0,0,16,896,16,896,0.058054000,1.7635
136.25.189.18,<->,8.50.171.138,16,9395,0,0,16,9395,0.056483000,1.8851
215.158.238.80,<->,65.27.220.202,16,4623,0,0,16,4623,0.054984000,1.5518
231.142.29.215,<->,215.158.239.78,0,0,16,2447,16,2447,0.054948000,0.4191
159.150.169.25,<->,8.176.39.253,0,0,16,1322,16,1322,0.053616000,0.1677
136.25.189.14,<->,96.156.169.234,16,10211,0,0,16,10211,0.052536000,1.9028
130.217.163.17,<->,92.27.219.171,0,0,16,22891,16,22891,0.052071000,1.8801
142.255.15.124,<->,136.25.188.252,0,0,16,957,16,957,0.051408000,0.3028
215.158.239.76,<->,199.20.31.201,16,1940,0,0,16,1940,0.050992000,0.5199
157.127.237.43,<->,8.252.223.0,0,0,16,1088,16,1088,0.050014000,1.8669
146.193.75.8,<->,8.252.221.236,0,0,16,1246,16,1246,0.048535000,1.6292
133.178.226.37,<->,65.27.228.203,16,3574,0,0,16,3574,0.048071000,1.8995
215.158.238.64,<->,80.47.111.90,16,8126,0,0,16,8126,0.048020000,1.8715
136.25.189.17,<->,126.219.194.18,16,9299,0,0,16,9299,0.047923000,1.7741
159.137.169.58,<->,117.139.51.205,16,1012,0,0,16,1012,0.047399000,1.8971
215.158.239.97,<->,196.92.146.126,16,1851,0,0,16,1851,0.046872000,1.9115
210.158.44.59,<->,121.74.207.64,16,23624,0,0,16,23624,0.045632000,0.0018
207.56.132.222,<->,136.25.188.237,0,0,16,896,16,896,0.044295000,0.0325
136.25.189.83,<->,29.211.228.178,16,5752,0,0,16,5752,0.044292000,1.5888
149.250.115.24,<->,136.25.188.255,0,0,16,4735,16,4735,0.044278000,0.9893
215.158.239.30,<->,8.191.6.122,16,7435,0,0,16,7435,0.041066000,1.9200
207.83.29.78,<->,139.163.7.204,0,0,16,3236,16,3236,0.040788000,1.8471
215.158.239.58,<->,199.71.14.28,16,1920,0,0,16,1920,0.040579000,0.7098
215.158.238.75,<->,33.209.217.201,16,7486,0,0,16,7486,0.040144000,1.8449
215.158.239.68,<->,199.20.30.40,16,2396,0,0,16,2396,0.038420000,1.1423
133.178.226.77,<->,112.220.206.88,16,5812,0,0,16,5812,0.037342000,1.9466
215.158.239.70,<->,126.219.194.88,16,8170,0,0,16,8170,0.036844000,1.8924
215.158.239.52,<->,97.174.232.172,16,14276,0,0,16,14276,0.035641000,1.7553
204.63.182.172,<->,136.25.188.242,0,0,16,1255,16,1255,0.035171000,1.9595
142.209.155.50,<->,136.25.188.198,0,0,16,1988,16,1988,0.034832000,1.9157
215.158.239.48,<->,199.20.31.67,16,2665,0,0,16,2665,0.034716000,0.7299
133.178.227.19,<->,106.188.245.7,16,2069,0,0,16,2069,0.034541000,1.9398
133.178.227.27,<->,33.209.219.58,16,7380,0,0,16,7380,0.034061000,1.8520
6.145.166.151,<->,0.195.210.44,0,0,16,1827,16,1827,0.032334000,0.7998
199.68.64.226,<->,136.25.188.255,0,0,16,1666,16,1666,0.032317000,1.1935
215.158.238.65,<->,136.138.112.201,16,4619,0,0,16,4619,0.032259000,1.4804
222.78.57.246,<->,8.20.81.41,16,6744,0,0,16,6744,0.031564000,0.7022
215.158.238.143,<->,136.138.112.218,16,5636,0,0,16,5636,0.030135000,1.2378
139.241.56.102,<->,6.74.85.210,0,0,16,23294,16,23294,0.028996000,1.9502
133.178.227.45,<->,133.56.180.25,16,5746,0,0,16,5746,0.028792000,1.9417
246.254.97.104,<->,210.231.140.38,16,6690,0,0,16,6690,0.028084000,0.3391
133.178.226.38,<->,8.222.212.8,16,6048,0,0,16,6048,0.025976000,1.9709
207.62.180.98,<->,136.25.188.209,0,0,16,800,16,800,0.025130000,1.5450
215.158.238.82,<->,80.47.111.27,16,2069,0,0,16,2069,0.023561000,0.9851
204.43.44.115,<->,50.223.3.228,0,0,16,830,16,830,0.022966000,1.9520
215.158.61.189,<->,8.176.8.247,0,0,16,11864,16,11864,0.021885000,1.4317
94.195.13.218,<->,8.252.221.231,0,0,16,850,16,850,0.020852000,1.9132
215.158.238.1,<->,215.158.35.210,16,13930,0,0,16,13930,0.019784000,0.3120
215.158.238.64,<->,122.159.245.162,16,8366,0,0,16,8366,0.019568000,1.9292
136.25.188.237,<->,131.144.113.162,16,5668,0,0,16,5668,0.019244000,1.3759
207.236.47.30,<->,136.25.188.226,0,0,16,1708,16,1708,0.018770000,0.9966
215.158.238.148,<->,131.2.115.231,16,3386,0,0,16,3386,0.018545000,1.2663
133.54.43.80,<->,38.17.161.138,16,1068,0,0,16,1068,0.018205000,1.7452
136.25.189.0,<->,126.219.194.27,16,8174,0,0,16,8174,0.017886000,1.8614
133.178.226.77,<->,122.158.245.103,16,4383,0,0,16,4383,0.015701000,1.9840
82.117.204.93,<->,8.220.187.125,0,0,16,12861,16,12861,0.015491000,1.1818
113.246.46.133,<->,92.27.219.165,0,0,16,18062,16,18062,0.015043000,1.7370
215.158.239.57,<->,80.56.79.10,16,7337,0,0,16,7337,0.014638000,1.9574
136.25.189.77,<->,96.156.169.231,16,10015,0,0,16,10015,0.013595000,1.9676
215.158.140.60,<->,158.85.50.137,16,4927,0,0,16,4927,0.013505000,1.0418
144.85.170.208,<->,111.38.51.83,16,1160,0,0,16,1160,0.012217000,0.3726
136.25.189.94,<->,96.156.169.239,16,14750,0,0,16,14750,0.011120000,1.9794
196.251.73.169,<->,8.252.222.179,0,0,16,1687,16,1687,0.010282000,0.8248
199.21.67.107,<->,50.223.3.228,0,0,16,850,16,850,0.010113000,1.6014
215.158.239.86,<->,8.50.171.139,16,6601,0,0,16,6601,0.009398000,1.7534
98.87.186.203,<->,50.224.105.35,0,0,16,896,16,896,0.007424000,1.9340
215.158.238.64,<->,113.23.20.241,16,7177,0,0,16,7177,0.007170000,1.9330
194.222.49.28,<->,50.223.3.228,0,0,16,800,16,800,0.006981000,0.2620
215.158.238.90,<->,100.224.166.161,16,11426,0,0,16,11426,0.006489000,1.3541
205.243.108.176,<->,92.27.194.136,0,0,16,2129,16,2129,0.005406000,1.6153
246.253.169.66,<->,8.35.106.93,16,800,0,0,16,800,0.005033000,0.0722
120.193.155.221,<->,101.224.174.212,0,0,16,2055,16,2055,0.004688000,1.7525
215.158.239.85,<->,196.94.223.242,16,1821,0,0,16,1821,0.004655000,1.1700
136.25.188.225,<->,75.238.231.93,16,800,0,0,16,800,0.003430000,0.2799
199.68.163.42,<->,136.25.188.220,0,0,16,1504,16,1504,0.003241000,0.8244
145.116.209.4,<->,136.25.188.203,0,0,16,20735,16,20735,0.002542000,0.0437
215.158.238.85,<->,0.195.253.228,15,20028,0,0,15,20028,1.905585000,0.0001
111.20.168.122,<->,101.224.91.111,15,1533,0,0,15,1533,1.890343000,0.0757
84.203.220.182,<->,8.252.223.176,0,0,15,2157,15,2157,1.728658000,0.2700
222.20.241.60,<->,221.102.112.165,0,0,15,1439,15,1439,1.727346000,0.1303
105.204.179.13,<->,92.168.217.252,0,0,15,840,15,840,1.719381000,0.2222
215.158.238.81,<->,61.35.124.167,15,2045,0,0,15,2045,1.678693000,0.2317
144.87.235.222,<->,139.241.58.74,15,11223,0,0,15,11223,1.660239000,0.1284
215.158.238.236,<->,159.137.139.94,15,2093,0,0,15,2093,1.650199000,0.2060
132.249.141.243,<->,8.52.178.109,0,0,15,1872,15,1872,1.641273000,0.3566
145.176.45.183,<->,39.15.169.212,0,0,15,17559,15,17559,1.567929000,0.2741
139.241.56.116,<->,99.73.161.228,0,0,15,9544,15,9544,1.481284000,0.4185
129.236.114.39,<->,33.233.141.11,0,0,15,18766,15,18766,1.459994000,0.0002
8.176.8.48,<->,8.33.227.22,15,6243,0,0,15,6243,1.400493000,0.3892
142.229.16.33,<->,136.25.188.199,0,0,15,1944,15,1944,1.344272000,0.6524
246.254.97.109,<->,117.194.179.115,15,18055,0,0,15,18055,1.339838000,0.2592
220.20.200.102,<->,122.12.244.202,15,18392,0,0,15,18392,1.326288000,0.2781
231.142.6.77,<->,136.25.188.52,0,0,15,2770,15,2770,1.306650000,0.6771
145.116.214.177,<->,133.178.227.138,0,0,15,3032,15,3032,1.304876000,0.1507
92.27.219.185,<->,42.204.31.48,15,18452,0,0,15,18452,1.294908000,0.5101
199.122.62.229,<->,136.25.188.236,0,0,15,2231,15,2231,1.293777000,0.7039
142.240.201.149,<->,136.25.188.252,0,0,15,2358,15,2358,1.280200000,0.7154
127.128.154.1,<->,92.168.217.142,0,0,15,840,15,840,1.274882000,0.3601
220.28.108.254,<->,215.158.238.41,0,0,15,19552,15,19552,1.258170000,0.3065
215.158.238.132,<->,8.191.6.88,15,3186,0,0,15,3186,1.244586000,0.5486
97.182.7.133,<->,8.52.153.105,0,0,15,1568,15,1568,1.238478000,0.7142
215.158.239.92,<->,196.91.140.17,15,840,0,0,15,840,1.223357000,0.7005
204.21.142.191,<->,136.25.188.220,0,0,15,1356,15,1356,1.219083000,0.2836
138.55.219.111,<->,8.52.179.217,0,0,15,7069,15,7069,1.211980000,0.2906
215.158.61.243,<->,8.176.8.197,0,0,15,13226,15,13226,1.199103000,0.7520
215.158.238.133,<->,149.99.94.68,15,2173,0,0,15,2173,1.191986000,0.1089
194.232.228.105,<->,136.25.188.253,0,0,15,3166,15,3166,1.184023000,0.8142
198.204.76.246,<->,133.178.226.28,0,0,15,840,15,840,1.173806000,0.2216
8.252.223.130,<->,8.192.205.88,15,2489,0,0,15,2489,1.161905000,0.6189
195.12.245.216,<->,136.25.188.174,0,0,15,2567,15,2567,1.148836000,0.7639
142.248.167.39,<->,136.25.188.252,0,0,15,2345,15,2345,1.102706000,0.8690
97.126.0.114,<->,56.121.22.229,15,8226,0,0,15,8226,1.098716000,0.3250
215.158.238.198,<->,69.150.168.200,15,2891,0,0,15,2891,1.092040000,0.7265
230.114.203.33,<->,92.168.217.130,0,0,15,840,15,840,1.086904000,0.1719
199.70.36.204,<->,136.25.188.52,0,0,15,1758,15,1758,1.064495000,0.2749
195.55.63.35,<->,136.25.188.174,0,0,15,1785,15,1785,1.050239000,0.8358
136.25.189.0,<->,126.219.191.52,15,4535,0,0,15,4535,1.038193000,0.8299
100.50.96.246,<->,8.252.223.141,0,0,15,2189,15,2189,1.023369000,0.9595
142.223.147.36,<->,136.25.188.176,0,0,15,1825,15,1825,1.021853000,0.8379
199.15.38.78,<->,136.25.188.239,0,0,15,1720,15,1720,1.021375000,0.8552
207.57.195.68,<->,136.25.188.54,0,0,15,1722,15,1722,1.006256000,0.4479
215.158.238.111,<->,98.219.126.175,15,17857,0,0,15,17857,1.001199000,0.4661
207.56.33.193,<->,136.25.188.226,0,0,15,1009,15,1009,0.996643000,0.4653
215.158.239.78,<->,142.182.132.235,15,3238,0,0,15,3238,0.989818000,0.8609
204.21.174.204,<->,136.25.188.225,0,0,15,1011,15,1011,0.982600000,0.8806
138.74.27.44,<->,0.195.216.196,15,20417,0,0,15,20417,0.969412000,0.6371
142.221.131.21,<->,136.25.188.239,0,0,15,1756,15,1756,0.931415000,1.0523
145.185.206.51,<->,8.252.222.37,0,0,15,1338,15,1338,0.928206000,0.0973
138.74.30.197,<->,137.170.15.145,15,14469,0,0,15,14469,0.923374000,0.3658
231.142.242.193,<->,215.158.239.96,0,0,15,2377,15,2377,0.899586000,0.9127
196.148.174.227,<->,53.243.94.134,15,16583,0,0,15,16583,0.897745000,0.5750
218.111.226.62,<->,8.220.176.253,0,0,15,1872,15,1872,0.887317000,0.2917
212.70.3.113,<->,136.25.188.46,0,0,15,1887,15,1887,0.867433000,0.5932
220.28.85.14,<->,133.178.227.60,0,0,15,19529,15,19529,0.862166000,0.3678
111.151.142.130,<->,97.126.31.66,0,0,15,840,15,840,0.836225000,0.1142
133.178.227.76,<->,133.56.180.32,15,6908,0,0,15,6908,0.814196000,1.1635
203.116.25.29,<->,136.25.188.223,0,0,15,2000,15,2000,0.810623000,1.1293
215.158.239.92,<->,142.223.243.28,15,1943,0,0,15,1943,0.799102000,1.1139
215.158.238.106,<->,116.106.60.137,15,3522,0,0,15,3522,0.790675000,0.9887
207.236.166.199,<->,136.25.188.177,0,0,15,1747,15,1747,0.782139000,1.1419
215.158.239.49,<->,207.228.92.10,15,2385,0,0,15,2385,0.774003000,1.2120
136.25.188.175,<->,29.214.108.170,15,3655,0,0,15,3655,0.761908000,0.9153
142.249.245.193,<->,136.25.188.238,0,0,15,1565,15,1565,0.754750000,0.7149
145.76.231.17,<->,111.20.168.180,0,0,15,17418,15,17418,0.749054000,0.1544
215.158.61.189,<->,8.176.8.183,0,0,15,12634,15,12634,0.744622000,1.1164
204.200.50.182,<->,136.25.188.174,0,0,15,2626,15,2626,0.743320000,1.1926
136.25.188.220,<->,61.35.22.241,15,2381,0,0,15,2381,0.740905000,0.4691
106.149.129.48,<->,89.183.104.152,0,0,15,21855,15,21855,0.739426000,0.8782
136.25.189.32,<->,8.249.253.225,15,6044,0,0,15,6044,0.733202000,1.1869
215.158.239.58,<->,196.88.100.102,15,2346,0,0,15,2346,0.733020000,0.8565
138.35.86.96,<->,136.25.188.236,0,0,15,1726,15,1726,0.722850000,0.1660
142.166.243.214,<->,136.25.188.252,0,0,15,2345,15,2345,0.721060000,0.9132
215.158.238.239,<->,149.250.116.47,15,2140,0,0,15,2140,0.720255000,0.4979
215.158.239.68,<->,199.71.247.119,15,2380,0,0,15,2380,0.720026000,1.0836
136.25.188.168,<->,0.195.237.14,15,21630,0,0,15,21630,0.701776000,0.0001
215.158.238.135,<->,113.23.20.106,15,5756,0,0,15,5756,0.694409000,1.2887
133.178.226.90,<->,120.20.132.54,15,4567,0,0,15,4567,0.688499000,1.1312
204.61.132.176,<->,136.25.188.198,0,0,15,1591,15,1591,0.671666000,1.1230
204.200.49.26,<->,136.25.188.173,0,0,15,1871,15,1871,0.665658000,1.0479
136.25.188.200,<->,100.224.202.176,15,15661,0,0,15,15661,0.657407000,0.1045
136.25.189.1,<->,80.56.79.87,15,6439,0,0,15,6439,0.656962000,0.9969
133.178.226.60,<->,126.219.194.151,15,6986,0,0,15,6986,0.656109000,1.3124
142.206.160.40,<->,136.25.188.210,0,0,15,840,15,840,0.648331000,0.0476
215.158.239.87,<->,126.219.194.82,15,10131,0,0,15,10131,0.645339000,1.3263
17.59.146.123,<->,8.52.154.255,0,0,15,1209,15,1209,0.638526000,0.2061
215.158.239.95,<->,195.41.158.62,15,2510,0,0,15,2510,0.635547000,1.3181
99.187.125.121,<->,8.20.87.34,0,0,15,3252,15,3252,0.611490000,1.2887
133.178.227.76,<->,126.219.191.10,15,5102,0,0,15,5102,0.604114000,1.2346
215.158.239.84,<->,207.16.217.102,15,2352,0,0,15,2352,0.601292000,0.7462
215.158.61.243,<->,8.176.8.248,0,0,15,5935,15,5935,0.594403000,1.2887
220.28.85.14,<->,133.178.226.85,0,0,15,21183,15,21183,0.588284000,0.0000
215.158.238.241,<->,69.150.168.9,15,4028,0,0,15,4028,0.584809000,1.3907
195.4.32.221,<->,136.25.188.238,0,0,15,2322,15,2322,0.576923000,1.2618
136.25.188.220,<->,104.3.163.27,15,6076,0,0,15,6076,0.572598000,1.4159
204.58.72.225,<->,136.25.188.54,0,0,15,3166,15,3166,0.569102000,0.8855
139.250.219.6,<->,50.224.122.17,0,0,15,1778,15,1778,0.568469000,0.0792
220.50.215.68,<->,50.224.80.75,0,0,15,1332,15,1332,0.565346000,0.7360
215.158.239.51,<->,199.121.38.183,15,1875,0,0,15,1875,0.565033000,0.9828
143.52.112.102,<->,136.25.188.55,0,0,15,1318,15,1318,0.559666000,0.9885
215.158.239.7,<->,8.191.6.123,15,6939,0,0,15,6939,0.540335000,1.0498
91.100.190.69,<->,50.224.88.92,0,0,15,840,15,840,0.539266000,1.3809
194.210.27.30,<->,8.182.241.177,0,0,15,798,15,798,0.528369000,1.0824
215.158.239.44,<->,98.219.126.140,15,15728,0,0,15,15728,0.526230000,0.6181
143.128.136.182,<->,136.25.188.53,0,0,15,1939,15,1939,0.524902000,1.3674
215.158.239.6,<->,8.219.187.245,15,3017,0,0,15,3017,0.520793000,0.9938
136.25.189.2,<->,29.211.93.23,15,3282,0,0,15,3282,0.518065000,0.3692
215.158.239.99,<->,199.20.30.93,15,3057,0,0,15,3057,0.517939000,1.4521
136.25.188.44,<->,122.158.245.73,15,5804,0,0,15,5804,0.512353000,1.4729
43.55.248.38,<->,8.252.222.238,0,0,15,1020,15,1020,0.504770000,1.3905
136.25.188.220,<->,100.224.202.182,15,9250,0,0,15,9250,0.503549000,1.0636
221.102.113.114,<->,111.29.9.14,15,750,0,0,15,750,0.502747000,1.4801
215.158.61.195,<->,8.176.8.176,0,0,15,11549,15,11549,0.498188000,1.4328
143.135.87.181,<->,136.25.188.210,0,0,15,1897,15,1897,0.493211000,1.1681
142.255.45.106,<->,136.25.188.163,0,0,15,2193,15,2193,0.482136000,1.3806
210.221.107.50,<->,8.37.249.53,15,2054,0,0,15,2054,0.480257000,0.4595
136.25.188.226,<->,111.151.70.36,15,3314,0,0,15,3314,0.470030000,1.3742
195.71.188.138,<->,136.25.188.163,0,0,15,1875,15,1875,0.463413000,0.7320
197.113.99.231,<->,136.25.188.196,0,0,15,1694,15,1694,0.462670000,1.5290
99.251.31.170,<->,92.27.219.165,0,0,15,3594,15,3594,0.449175000,1.4126
215.158.140.241,<->,140.174.84.20,15,2148,0,0,15,2148,0.444344000,0.3589
215.158.238.64,<->,91.57.173.23,15,6721,0,0,15,6721,0.439448000,0.8675
136.25.188.175,<->,56.161.218.52,15,5868,0,0,15,5868,0.431195000,1.4523
215.158.239.56,<->,199.20.31.140,15,750,0,0,15,750,0.428113000,0.1400
215.158.238.73,<->,27.178.41.50,15,5916,0,0,15,5916,0.422641000,1.4669
221.102.56.46,<->,109.3.156.160,0,0,15,10594,15,10594,0.421546000,0.2239
148.190.126.29,<->,133.178.226.29,0,0,15,1965,15,1965,0.417479000,0.6046
100.112.36.136,<->,8.52.188.77,0,0,15,1511,15,1511,0.411825000,1.4263
215.158.239.99,<->,199.20.30.218,15,1735,0,0,15,1735,0.402873000,0.5798
215.158.239.56,<->,199.72.65.36,15,750,0,0,15,750,0.402636000,1.1314
215.158.239.79,<->,199.20.28.42,15,909,0,0,15,909,0.400712000,1.4600
143.134.93.106,<->,136.25.188.243,0,0,15,1039,15,1039,0.400199000,0.5519
142.227.56.211,<->,136.25.188.198,0,0,15,3085,15,3085,0.398981000,1.3940
221.102.143.189,<->,220.80.156.5,0,0,15,10677,15,10677,0.398417000,1.2404
232.31.155.18,<->,97.198.118.56,0,0,15,2046,15,2046,0.384899000,0.6441
136.25.189.2,<->,96.156.169.192,15,4835,0,0,15,4835,0.383783000,0.6547
220.28.104.193,<->,215.158.140.225,0,0,15,13983,15,13983,0.381005000,0.6220
215.158.239.77,<->,204.1.219.196,15,1907,0,0,15,1907,0.374048000,1.2174
139.163.96.127,<->,117.0.163.160,15,828,0,0,15,828,0.372882000,1.6218
133.178.226.97,<->,8.191.7.183,15,6359,0,0,15,6359,0.370628000,0.2549
196.112.116.208,<->,0.195.210.46,0,0,15,1872,15,1872,0.367631000,0.8939
143.52.161.152,<->,136.25.188.210,0,0,15,1769,15,1769,0.367413000,1.5880
212.164.136.25,<->,46.44.170.240,15,840,0,0,15,840,0.366022000,1.5951
232.31.155.17,<->,97.198.118.56,0,0,15,2067,15,2067,0.364721000,0.6704
215.158.238.64,<->,142.234.196.202,15,7201,0,0,15,7201,0.364289000,1.6274
136.25.188.177,<->,65.63.242.219,15,1661,0,0,15,1661,0.360587000,1.4925
98.87.147.0,<->,50.224.49.211,0,0,15,840,15,840,0.352981000,1.6321
136.25.188.176,<->,126.219.102.191,15,2109,0,0,15,2109,0.350968000,0.1654
215.158.238.250,<->,69.150.169.232,15,2934,0,0,15,2934,0.349173000,1.5734
215.158.239.105,<->,215.158.61.243,15,10340,0,0,15,10340,0.349103000,1.4519
194.193.7.63,<->,50.223.3.228,0,0,15,750,15,750,0.348664000,1.6032
136.139.59.125,<->,136.25.188.220,0,0,15,1806,15,1806,0.346714000,0.3672
204.200.53.231,<->,136.25.188.255,0,0,15,1891,15,1891,0.342116000,0.7649
215.158.239.94,<->,199.20.30.189,15,750,0,0,15,750,0.340144000,1.1067
133.178.226.60,<->,113.23.21.212,15,2109,0,0,15,2109,0.331523000,0.3489
73.14.193.173,<->,8.252.222.161,0,0,15,1504,15,1504,0.329213000,1.1576
58.143.193.33,<->,8.252.222.134,0,0,15,1940,15,1940,0.324323000,0.5732
215.158.140.75,<->,106.188.228.55,15,3863,0,0,15,3863,0.322702000,0.6670
215.158.140.92,<->,61.72.108.192,15,4561,0,0,15,4561,0.321387000,1.4582
207.193.109.109,<->,136.25.188.174,0,0,15,1931,15,1931,0.319436000,1.4112
91.100.189.12,<->,50.224.88.92,0,0,15,840,15,840,0.315187000,1.5743
139.163.96.101,<->,38.90.74.141,15,1401,0,0,15,1401,0.313092000,1.5326
133.178.227.16,<->,29.211.6.201,15,3999,0,0,15,3999,0.305264000,1.6514
215.158.238.223,<->,29.212.182.20,15,1814,0,0,15,1814,0.304388000,0.3359
109.3.142.140,<->,8.45.175.127,15,7733,0,0,15,7733,0.303610000,1.6937
222.39.206.14,<->,50.224.105.38,0,0,15,840,15,840,0.297313000,1.5038
215.158.61.193,<->,8.176.8.202,0,0,15,17595,15,17595,0.296301000,1.2425
133.178.226.18,<->,8.42.43.65,15,7878,0,0,15,7878,0.287403000,1.6944
215.158.238.67,<->,131.144.114.208,15,7169,0,0,15,7169,0.283799000,1.5755
215.158.239.48,<->,196.105.62.165,15,2216,0,0,15,2216,0.280034000,1.5713
143.68.251.244,<->,136.25.188.238,0,0,15,750,15,750,0.278248000,0.2079
139.248.30.196,<->,100.228.42.154,0,0,15,13671,15,13671,0.269144000,1.1171
215.158.238.97,<->,91.57.173.21,15,8086,0,0,15,8086,0.264962000,1.7138
215.158.239.197,<->,56.97.186.255,15,11504,0,0,15,11504,0.263232000,1.5167
215.158.238.236,<->,139.163.163.208,15,2173,0,0,15,2173,0.262945000,0.1393
199.111.0.242,<->,8.182.224.248,0,0,15,1679,15,1679,0.259257000,1.0034
215.158.238.123,<->,140.174.85.227,15,1128,0,0,15,1128,0.254171000,0.2554
215.158.238.141,<->,33.209.217.200,15,3642,0,0,15,3642,0.251847000,1.5597
111.189.69.82,<->,50.224.88.92,0,0,15,840,15,840,0.251356000,1.6002
221.196.123.28,<->,136.25.188.209,0,0,15,876,15,876,0.249066000,0.6600
216.184.2.165,<->,136.25.189.59,0,0,15,9627,15,9627,0.246931000,1.6488
215.158.238.95,<->,136.139.59.119,15,4183,0,0,15,4183,0.246428000,0.8598
145.116.223.7,<->,133.178.226.220,0,0,15,18071,15,18071,0.238626000,1.7013
194.227.108.90,<->,50.223.3.228,0,0,15,768,15,768,0.237053000,1.5851
215.158.238.243,<->,89.86.110.221,15,5184,0,0,15,5184,0.236917000,1.6569
215.158.239.49,<->,195.43.121.138,15,1678,0,0,15,1678,0.235527000,0.3924
215.158.238.132,<->,131.144.114.218,15,5596,0,0,15,5596,0.235215000,1.7642
220.60.81.132,<->,136.25.189.77,0,0,15,8326,15,8326,0.233235000,1.5878
136.25.189.13,<->,29.212.180.227,15,8150,0,0,15,8150,0.229831000,1.6921
89.183.107.124,<->,35.62.70.46,15,1090,0,0,15,1090,0.229264000,0.2074
136.25.188.55,<->,120.154.221.231,15,5836,0,0,15,5836,0.228538000,1.5279
215.158.238.190,<->,131.22.233.154,15,6930,0,0,15,6930,0.227051000,1.6722
207.62.119.39,<->,136.25.188.227,0,0,15,1101,15,1101,0.225912000,1.2210
212.164.136.25,<->,82.85.145.229,15,840,0,0,15,840,0.224439000,1.5930
215.158.239.86,<->,196.88.121.14,15,885,0,0,15,885,0.223090000,0.7588
220.39.233.203,<->,136.25.188.237,0,0,15,7025,15,7025,0.220412000,1.5295
145.116.209.76,<->,136.25.188.203,0,0,15,5359,15,5359,0.220143000,1.7569
199.15.38.100,<->,136.25.188.252,0,0,15,1771,15,1771,0.219506000,0.6742
136.25.188.226,<->,122.158.49.130,15,7116,0,0,15,7116,0.218582000,1.3840
215.158.239.7,<->,215.158.127.162,15,5286,0,0,15,5286,0.216124000,1.3179
196.89.40.44,<->,136.25.188.220,0,0,15,1684,15,1684,0.212138000,0.4013
199.54.1.74,<->,8.252.222.141,0,0,15,2378,15,2378,0.211402000,0.4731
111.172.223.19,<->,50.224.88.92,0,0,15,816,15,816,0.211020000,1.6082
221.196.123.196,<->,138.98.250.43,0,0,15,840,15,840,0.210640000,1.6070
139.163.34.3,<->,101.71.30.58,15,750,0,0,15,750,0.210446000,1.7361
215.158.239.49,<->,195.83.109.240,15,2414,0,0,15,2414,0.210029000,0.7608
136.25.189.30,<->,56.28.207.192,15,6993,0,0,15,6993,0.206377000,1.0962
204.58.99.194,<->,136.25.188.55,0,0,15,1008,15,1008,0.205610000,0.5403
220.20.200.57,<->,132.216.159.29,15,18218,0,0,15,18218,0.203991000,0.0696
8.252.221.236,<->,4.123.51.114,15,1606,0,0,15,1606,0.198729000,1.5706
195.65.179.46,<->,8.182.243.141,0,0,15,1464,15,1464,0.197121000,1.7828
136.25.188.252,<->,27.178.41.9,15,4567,0,0,15,4567,0.195363000,0.8194
133.178.227.79,<->,8.219.185.50,15,4103,0,0,15,4103,0.194688000,1.4962
215.158.61.202,<->,8.176.8.188,0,0,15,12287,15,12287,0.192613000,1.4793
215.158.238.196,<->,104.3.168.52,15,4063,0,0,15,4063,0.190590000,1.6977
57.154.233.234,<->,50.224.76.230,0,0,15,1757,15,1757,0.187616000,1.6797
92.27.219.143,<->,4.111.14.19,15,798,0,0,15,798,0.186142000,1.6501
146.249.227.36,<->,8.252.222.205,0,0,15,932,15,932,0.180934000,1.6800
48.19.213.154,<->,8.252.222.159,0,0,15,2451,15,2451,0.175631000,0.7260
89.183.104.231,<->,48.111.111.145,15,887,0,0,15,887,0.174940000,1.8136
152.47.95.34,<->,139.163.96.101,0,0,15,1835,15,1835,0.171999000,1.7270
136.25.188.211,<->,56.161.218.39,15,4519,0,0,15,4519,0.169963000,1.6953
136.25.188.242,<->,8.253.128.63,15,3314,0,0,15,3314,0.168757000,1.6815
144.87.238.20,<->,144.87.235.144,0,0,15,1263,15,1263,0.168011000,0.2884
215.158.238.148,<->,112.220.206.116,15,4338,0,0,15,4338,0.167974000,1.3532
196.97.162.45,<->,133.32.39.1,0,0,15,11401,15,11401,0.167340000,0.1822
215.158.239.85,<->,142.182.131.253,15,2347,0,0,15,2347,0.166300000,0.6561
136.139.59.119,<->,133.178.226.37,0,0,15,4503,15,4503,0.165363000,1.3675
145.118.84.220,<->,98.236.235.32,0,0,15,840,15,840,0.164637000,1.7963
95.247.58.24,<->,8.252.221.239,0,0,15,810,15,810,0.164562000,1.6908
215.158.239.92,<->,196.91.247.212,15,1807,0,0,15,1807,0.162185000,0.9295
215.158.239.73,<->,98.219.126.140,15,12228,0,0,15,12228,0.158049000,1.2937
194.247.170.74,<->,50.223.3.228,0,0,15,780,15,780,0.156748000,1.8426
215.158.238.209,<->,89.86.110.166,15,4547,0,0,15,4547,0.153605000,1.8327
205.127.108.115,<->,33.233.141.230,0,0,15,5651,15,5651,0.147233000,1.7003
159.23.224.2,<->,76.115.16.128,15,786,0,0,15,786,0.146635000,1.6480
215.158.239.49,<->,199.20.28.217,15,840,0,0,15,840,0.140796000,0.4796
139.163.96.94,<->,60.108.132.218,15,800,0,0,15,800,0.139086000,1.6961
201.139.222.17,<->,8.252.221.223,0,0,15,818,15,818,0.138471000,1.6424
139.254.208.128,<->,129.243.217.199,15,9450,0,0,15,9450,0.138358000,1.7303
136.25.188.45,<->,104.3.163.5,15,3202,0,0,15,3202,0.138152000,1.4769
215.158.239.56,<->,199.106.233.210,15,1469,0,0,15,1469,0.136465000,1.6100
215.158.238.64,<->,8.222.96.20,15,2125,0,0,15,2125,0.135807000,0.1293
138.98.250.39,<->,98.87.124.57,15,840,0,0,15,840,0.133116000,1.5974
215.158.238.250,<->,126.219.102.53,15,6065,0,0,15,6065,0.133022000,1.7845
138.98.250.39,<->,98.87.186.50,15,840,0,0,15,840,0.131722000,1.5976
220.28.73.211,<->,215.158.239.66,0,0,15,12336,15,12336,0.130000000,1.2243
58.202.114.136,<->,8.252.221.237,0,0,15,804,15,804,0.127902000,1.7462
215.158.239.69,<->,199.52.40.31,15,2235,0,0,15,2235,0.127329000,0.7856
97.209.130.5,<->,8.52.181.91,0,0,15,750,15,750,0.126702000,1.7756
136.25.189.0,<->,29.211.228.214,15,4635,0,0,15,4635,0.123984000,1.8540
136.25.188.230,<->,80.57.141.141,15,14670,0,0,15,14670,0.123946000,0.1882
215.158.239.84,<->,199.20.29.28,15,2353,0,0,15,2353,0.123127000,1.1197
137.21.23.55,<->,131.229.126.74,15,1180,0,0,15,1180,0.122947000,0.5907
158.156.31.151,<->,98.236.235.32,0,0,15,840,15,840,0.122895000,1.8223
220.250.34.57,<->,50.224.82.18,0,0,15,750,15,750,0.122758000,1.5623
197.198.41.118,<->,0.195.210.46,0,0,15,1898,15,1898,0.120029000,1.3142
215.158.238.241,<->,33.209.219.25,15,5890,0,0,15,5890,0.119438000,1.8017
94.195.98.61,<->,8.252.221.197,0,0,15,1277,15,1277,0.118059000,1.8751
95.245.106.162,<->,8.252.221.230,0,0,15,818,15,818,0.117061000,1.8809
103.146.10.15,<->,50.224.80.64,0,0,15,2455,15,2455,0.116918000,0.6715
199.72.28.204,<->,136.25.188.238,0,0,15,1939,15,1939,0.116444000,1.6151
145.79.69.255,<->,138.98.250.39,0,0,15,840,15,840,0.112734000,1.5982
142.254.34.156,<->,136.25.188.53,0,0,15,1698,15,1698,0.112451000,1.8733
136.25.189.46,<->,80.56.79.73,15,7554,0,0,15,7554,0.110683000,1.0533
221.102.122.201,<->,89.10.2.92,15,1256,0,0,15,1256,0.110332000,0.0896
204.63.80.101,<->,136.25.188.177,0,0,15,1819,15,1819,0.109927000,0.4802
136.25.188.173,<->,57.210.107.26,15,6817,0,0,15,6817,0.109897000,1.8187
255.0.0.15,<->,50.224.88.92,0,0,15,750,15,750,0.109205000,1.8075
129.208.24.226,<->,50.224.82.18,0,0,15,750,15,750,0.108566000,1.5418
215.158.61.182,<->,8.176.8.197,0,0,15,15291,15,15291,0.108461000,1.8590
126.243.53.31,<->,0.195.210.46,0,0,15,4014,15,4014,0.107076000,1.5966
194.232.103.13,<->,136.25.188.253,0,0,15,840,15,840,0.106950000,0.0213
129.47.116.119,<->,98.232.172.137,0,0,15,2968,15,2968,0.106237000,0.5355
75.214.174.133,<->,8.252.221.239,0,0,15,780,15,780,0.104392000,1.7992
207.92.36.45,<->,8.252.222.62,0,0,15,768,15,768,0.101733000,0.4030
215.158.239.96,<->,195.55.120.128,15,1935,0,0,15,1935,0.101220000,1.2440
136.25.189.58,<->,96.156.169.223,15,5063,0,0,15,5063,0.101188000,1.8475
200.175.234.79,<->,50.189.172.216,15,19302,0,0,15,19302,0.101063000,1.4480
136.25.188.55,<->,69.150.168.195,15,3154,0,0,15,3154,0.100869000,1.8034
223.115.220.15,<->,8.252.221.198,0,0,15,804,15,804,0.100401000,1.8531
231.143.137.170,<->,136.25.188.46,0,0,15,2608,15,2608,0.097195000,1.8995
215.158.239.96,<->,199.76.14.89,15,840,0,0,15,840,0.097008000,0.1901
229.96.182.37,<->,8.49.190.133,15,1212,0,0,15,1212,0.095412000,0.0080
215.158.239.79,<->,195.83.129.234,15,840,0,0,15,840,0.095385000,0.8297
133.178.226.18,<->,131.1.232.135,15,3438,0,0,15,3438,0.093959000,0.6490
114.90.99.163,<->,0.195.210.42,0,0,15,4171,15,4171,0.092321000,0.8035
215.158.239.86,<->,29.209.59.196,15,8662,0,0,15,8662,0.091155000,1.8037
215.158.239.96,<->,199.38.254.180,15,1758,0,0,15,1758,0.090992000,1.0555
136.25.188.172,<->,122.159.245.163,15,8534,0,0,15,8534,0.089045000,1.7955
142.166.98.108,<->,136.25.188.238,0,0,15,2427,15,2427,0.088998000,0.8027
133.178.227.27,<->,126.219.246.223,15,8555,0,0,15,8555,0.087124000,1.9037
43.52.24.109,<->,8.252.221.238,0,0,15,916,15,916,0.086967000,1.4770
204.41.33.93,<->,50.223.3.228,0,0,15,750,15,750,0.086684000,1.8262
215.158.61.191,<->,8.176.8.219,0,0,15,13477,15,13477,0.084623000,1.6774
142.208.195.173,<->,136.25.188.46,0,0,15,1683,15,1683,0.081784000,1.6260
216.184.1.91,<->,8.252.222.27,0,0,15,11555,15,11555,0.080148000,0.0967
136.25.189.7,<->,96.156.169.197,15,16956,0,0,15,16956,0.078682000,0.7471
199.51.130.193,<->,136.25.188.208,0,0,15,1799,15,1799,0.072325000,0.4484
215.158.239.195,<->,53.208.30.76,15,4332,0,0,15,4332,0.071243000,1.8872
215.158.238.132,<->,76.100.108.217,15,3346,0,0,15,3346,0.071019000,1.7155
112.7.79.190,<->,80.38.36.39,0,0,15,1080,15,1080,0.069369000,1.7452
142.218.198.234,<->,8.52.182.30,0,0,15,1653,15,1653,0.068825000,1.4360
66.35.141.102,<->,8.252.221.236,0,0,15,834,15,834,0.067589000,1.8857
195.88.168.203,<->,50.223.3.228,0,0,15,792,15,792,0.067539000,1.9323
134.48.74.144,<->,80.41.48.154,0,0,15,899,15,899,0.066802000,1.7786
136.25.189.61,<->,96.156.169.226,15,11926,0,0,15,11926,0.066575000,1.9097
215.158.44.247,<->,136.25.189.15,0,0,15,9179,15,9179,0.066473000,1.6075
133.178.227.57,<->,133.56.180.89,15,4695,0,0,15,4695,0.066166000,0.4945
133.178.227.38,<->,133.56.180.36,15,18571,0,0,15,18571,0.065908000,1.7077
215.158.238.33,<->,38.104.11.52,15,5852,0,0,15,5852,0.065291000,1.6338
136.25.189.14,<->,29.213.219.69,15,4894,0,0,15,4894,0.064747000,1.8302
199.58.43.121,<->,8.20.87.153,0,0,15,7235,15,7235,0.063587000,1.8206
136.25.188.172,<->,131.1.232.139,15,7153,0,0,15,7153,0.062024000,1.9157
195.4.91.61,<->,136.25.188.178,0,0,15,840,15,840,0.061976000,0.0651
215.158.140.179,<->,136.129.35.1,15,840,0,0,15,840,0.056668000,1.8568
133.178.227.57,<->,133.56.180.6,15,9677,0,0,15,9677,0.056463000,1.9320
221.196.122.178,<->,138.98.250.39,0,0,15,840,15,840,0.056379000,1.6293
93.218.215.183,<->,50.224.91.82,0,0,15,852,15,852,0.054145000,1.8850
38.87.119.68,<->,0.195.210.42,0,0,15,1303,15,1303,0.052193000,1.7133
192.204.123.1,<->,136.25.189.18,0,0,15,9243,15,9243,0.049903000,1.8600
136.25.189.1,<->,96.156.169.201,15,7921,0,0,15,7921,0.048247000,1.8066
242.6.19.104,<->,50.224.76.235,0,0,15,8507,15,8507,0.041004000,0.2866
134.48.177.113,<->,80.42.191.110,0,0,15,952,15,952,0.037771000,1.8915
215.158.239.96,<->,142.254.70.115,15,2845,0,0,15,2845,0.037304000,1.8561
215.158.238.73,<->,131.1.253.234,15,6032,0,0,15,6032,0.036844000,1.8850
139.163.96.127,<->,42.31.91.145,15,798,0,0,15,798,0.034197000,1.9568
142.240.59.130,<->,136.25.188.255,0,0,15,750,15,750,0.033407000,0.6469
111.14.238.97,<->,8.182.226.42,0,0,15,1356,15,1356,0.033291000,0.1758
215.158.239.86,<->,96.156.169.203,15,8198,0,0,15,8198,0.033220000,1.5214
215.201.227.68,<->,144.85.170.244,0,0,15,864,15,864,0.029931000,0.2890
204.56.0.132,<->,136.25.188.209,0,0,15,885,15,885,0.028322000,0.7914
142.206.82.96,<->,136.25.188.222,0,0,15,2374,15,2374,0.028163000,0.9997
197.45.74.148,<->,89.183.104.147,0,0,15,22050,15,22050,0.026869000,1.8635
220.20.200.48,<->,116.123.12.248,15,19850,0,0,15,19850,0.026451000,0.2087
122.215.10.126,<->,92.27.219.165,0,0,15,940,15,940,0.025776000,1.9634
192.229.42.165,<->,133.178.227.138,0,0,15,7431,15,7431,0.024958000,0.9103
215.158.238.83,<->,131.1.253.234,15,4806,0,0,15,4806,0.023710000,1.4310
247.115.62.51,<->,136.25.188.253,0,0,15,1811,15,1811,0.023267000,0.4959
215.158.238.90,<->,100.120.38.6,15,13264,0,0,15,13264,0.022726000,1.7875
94.195.239.37,<->,8.252.222.227,0,0,15,996,15,996,0.021427000,1.8405
136.25.188.47,<->,131.144.113.189,15,5564,0,0,15,5564,0.021291000,1.8444
194.233.160.232,<->,136.25.188.54,0,0,15,2400,15,2400,0.020781000,1.2100
140.218.109.36,<->,133.178.226.19,0,0,15,4663,15,4663,0.019954000,1.4095
106.168.191.252,<->,102.50.246.13,0,0,15,2686,15,2686,0.019912000,1.2292
195.5.132.27,<->,136.25.188.163,0,0,15,756,15,756,0.019665000,0.4369
139.163.96.94,<->,66.58.211.113,15,780,0,0,15,780,0.018113000,1.9763
118.221.45.56,<->,89.183.104.174,0,0,15,786,15,786,0.017909000,1.8553
76.179.67.62,<->,8.252.221.205,0,0,15,1198,15,1198,0.017286000,1.2153
136.25.189.81,<->,116.106.46.84,15,7434,0,0,15,7434,0.017159000,1.7965
192.64.223.86,<->,117.84.5.182,15,870,0,0,15,870,0.016930000,1.8764
195.124.115.131,<->,136.25.188.44,0,0,15,1623,15,1623,0.016307000,1.7686
136.25.189.24,<->,96.156.169.208,15,14834,0,0,15,14834,0.015264000,1.3567
192.67.176.153,<->,122.127.16.36,15,780,0,0,15,780,0.015260000,1.8021
152.105.112.160,<->,8.252.221.222,0,0,15,842,15,842,0.015128000,1.8252
215.158.238.188,<->,126.219.191.7,15,5299,0,0,15,5299,0.014496000,1.7696
136.25.188.237,<->,131.1.232.85,15,4615,0,0,15,4615,0.014102000,1.9437
129.78.112.201,<->,102.45.210.141,15,1291,0,0,15,1291,0.013342000,0.8846
215.158.239.92,<->,143.20.210.71,15,1226,0,0,15,1226,0.012491000,1.1846
138.98.250.39,<->,50.137.9.92,15,840,0,0,15,840,0.011967000,1.6023
136.25.189.15,<->,96.156.169.203,15,6924,0,0,15,6924,0.011027000,1.9300
142.236.203.19,<->,136.25.188.176,0,0,15,897,15,897,0.010351000,0.2133
109.222.209.65,<->,66.241.199.76,15,2824,0,0,15,2824,0.009487000,0.8689
149.250.115.38,<->,136.25.188.179,0,0,15,3282,15,3282,0.008757000,1.8466
109.222.230.147,<->,95.221.118.55,15,1238,0,0,15,1238,0.007920000,1.7307
100.115.92.194,<->,97.110.90.36,15,895,0,0,15,895,0.007424000,0.5890
192.204.123.61,<->,136.25.189.47,0,0,15,10544,15,10544,0.007198000,1.9545
220.28.108.254,<->,136.25.189.55,0,0,15,19183,15,19183,0.005313000,1.6772
215.158.238.120,<->,8.222.109.88,15,900,0,0,15,900,0.004947000,1.8286
215.158.238.99,<->,48.129.133.30,15,4679,0,0,15,4679,0.004820000,1.4958
215.158.238.45,<->,122.158.49.233,15,2189,0,0,15,2189,0.004611000,1.2961
207.60.246.109,<->,136.25.188.220,0,0,15,750,15,750,0.003444000,0.6128
215.158.140.83,<->,8.222.213.13,15,5940,0,0,15,5940,0.001930000,1.7905
215.158.239.92,<->,195.80.209.137,15,1469,0,0,15,1469,0.001792000,1.8210
136.25.189.80,<->,133.56.180.22,15,7073,0,0,15,7073,0.001746000,1.9469
215.158.239.76,<->,199.71.52.180,15,818,0,0,15,818,0.001099000,1.3696
215.158.239.57,<->,204.61.169.241,15,840,0,0,15,840,0.000239000,0.2998
8.45.144.116,<->,6.228.25.12,0,0,14,17829,14,17829,1.946439000,0.0214
136.25.188.176,<->,41.154.159.9,14,2297,0,0,14,2297,1.772809000,0.2102
215.158.239.46,<->,136.114.101.93,14,12467,0,0,14,12467,1.764005000,0.2088
215.158.140.136,<->,139.252.1.230,14,2282,0,0,14,2282,1.753935000,0.0033
224.129.13.57,<->,8.182.224.87,0,0,14,1819,14,1819,1.700688000,0.2986
215.158.140.76,<->,113.23.14.135,14,2125,0,0,14,2125,1.631588000,0.1342
143.94.195.175,<->,136.25.188.174,0,0,14,1933,14,1933,1.624547000,0.3209
136.25.189.53,<->,96.156.169.208,14,16906,0,0,14,16906,1.593253000,0.1945
133.178.226.95,<->,100.120.38.6,14,15635,0,0,14,15635,1.582105000,0.1414
194.237.64.106,<->,136.25.188.55,0,0,14,1509,14,1509,1.550295000,0.3684
220.55.97.164,<->,111.151.237.44,14,15919,0,0,14,15919,1.542940000,0.0662
98.236.238.137,<->,27.11.22.41,14,1122,0,0,14,1122,1.539072000,0.3295
133.178.226.14,<->,99.192.168.186,14,3089,0,0,14,3089,1.524562000,0.4074
215.158.238.241,<->,84.203.220.166,14,1989,0,0,14,1989,1.490147000,0.2210
6.145.165.86,<->,0.195.210.46,0,0,14,2462,14,2462,1.437697000,0.5396
145.116.223.6,<->,133.178.226.178,0,0,14,18842,14,18842,1.436907000,0.0001
220.55.72.171,<->,220.20.206.129,14,1954,0,0,14,1954,1.420773000,0.5441
144.87.238.91,<->,8.182.224.248,0,0,14,1086,14,1086,1.410022000,0.1951
207.162.155.243,<->,8.182.138.83,0,0,14,1559,14,1559,1.404175000,0.5216
17.31.40.178,<->,8.220.189.63,0,0,14,1110,14,1110,1.396105000,0.5435
136.25.188.224,<->,110.32.234.47,14,3102,0,0,14,3102,1.376607000,0.3067
142.236.5.158,<->,136.25.188.174,0,0,14,1974,14,1974,1.363169000,0.5371
136.25.188.51,<->,98.219.126.140,14,18120,0,0,14,18120,1.353960000,0.0579
8.55.195.24,<->,6.138.239.59,0,0,14,15565,14,15565,1.353751000,0.1622
136.18.231.246,<->,8.182.226.78,0,0,14,2173,14,2173,1.343352000,0.6357
145.13.164.229,<->,136.25.189.2,0,0,14,7550,14,7550,1.335539000,0.6111
221.196.122.52,<->,136.25.188.173,0,0,14,1084,14,1084,1.294583000,0.3197
98.67.155.83,<->,53.224.64.121,14,5240,0,0,14,5240,1.293396000,0.5564
204.200.37.111,<->,136.25.188.238,0,0,14,4074,14,4074,1.292821000,0.6132
195.14.93.212,<->,136.25.188.236,0,0,14,2462,14,2462,1.291060000,0.6787
223.141.212.240,<->,39.54.1.198,0,0,14,859,14,859,1.283440000,0.7107
133.178.227.57,<->,38.104.11.118,14,3922,0,0,14,3922,1.266523000,0.7136
253.182.227.8,<->,136.25.188.179,0,0,14,2077,14,2077,1.245160000,0.3851
98.101.64.87,<->,8.182.226.42,0,0,14,1305,14,1305,1.202282000,0.7801
50.48.55.79,<->,8.220.235.178,0,0,14,1168,14,1168,1.170662000,0.0304
215.158.239.94,<->,215.158.44.217,14,6036,0,0,14,6036,1.167363000,0.7525
218.4.180.68,<->,111.151.239.4,14,10163,0,0,14,10163,1.165264000,0.4249
215.158.239.48,<->,199.20.5.51,14,2591,0,0,14,2591,1.155339000,0.8137
215.158.239.48,<->,195.40.147.246,14,997,0,0,14,997,1.153953000,0.7948
142.221.6.28,<->,136.25.188.252,0,0,14,1889,14,1889,1.151606000,0.7138
99.187.125.122,<->,8.20.87.34,0,0,14,12968,14,12968,1.135616000,0.1211
114.204.207.137,<->,92.27.219.236,0,0,14,17019,14,17019,1.091484000,0.4938
133.178.227.57,<->,112.93.136.105,14,1796,0,0,14,1796,1.072085000,0.2196
220.28.65.9,<->,136.25.189.62,0,0,14,10979,14,10979,1.069566000,0.3847
143.135.247.111,<->,136.25.188.173,0,0,14,2359,14,2359,1.046151000,0.8818
220.28.114.28,<->,133.178.227.73,0,0,14,17049,14,17049,1.045721000,0.8988
136.25.188.172,<->,29.211.6.55,14,2085,0,0,14,2085,1.041248000,0.4114
195.42.123.47,<->,136.25.188.54,0,0,14,2144,14,2144,1.035666000,0.9601
48.137.28.241,<->,8.252.222.223,0,0,14,1573,14,1573,1.023562000,0.3617
136.114.101.39,<->,136.25.188.202,0,0,14,11766,14,11766,1.002493000,0.1478
221.102.56.69,<->,102.83.11.76,0,0,14,1530,14,1530,0.999334000,0.6877
215.158.238.96,<->,111.150.34.229,14,3302,0,0,14,3302,0.995255000,0.4779
210.95.218.218,<->,8.220.180.184,0,0,14,1336,14,1336,0.989281000,0.0881
17.22.250.252,<->,8.20.87.187,0,0,14,4228,14,4228,0.981667000,0.2089
212.70.217.81,<->,133.178.226.38,0,0,14,4495,14,4495,0.979415000,0.8295
215.158.239.76,<->,196.104.8.201,14,829,0,0,14,829,0.972577000,0.5400
136.25.189.33,<->,8.255.92.169,14,4687,0,0,14,4687,0.970787000,0.9075
215.158.238.132,<->,106.188.183.104,14,3684,0,0,14,3684,0.967684000,0.8433
111.146.175.140,<->,97.110.90.232,14,1299,0,0,14,1299,0.966985000,0.6158
142.167.63.71,<->,136.25.188.176,0,0,14,1669,14,1669,0.959173000,0.8487
142.236.6.229,<->,136.25.188.52,0,0,14,1198,14,1198,0.946634000,0.4072
215.158.239.48,<->,199.20.115.112,14,1855,0,0,14,1855,0.946278000,0.9670
215.158.239.50,<->,195.55.212.4,14,1243,0,0,14,1243,0.942700000,0.3153
138.100.120.14,<->,8.52.163.19,0,0,14,3556,14,3556,0.940300000,0.1681
121.252.111.148,<->,92.162.253.185,0,0,14,12611,14,12611,0.935295000,0.6598
142.236.30.149,<->,136.25.188.255,0,0,14,3343,14,3343,0.933518000,0.5154
246.45.209.95,<->,132.119.140.253,14,700,0,0,14,700,0.929264000,0.7288
128.1.13.147,<->,89.183.110.72,0,0,14,8092,14,8092,0.914454000,1.0787
207.58.64.35,<->,136.25.188.253,0,0,14,1393,14,1393,0.893601000,1.0340
215.158.239.87,<->,195.13.208.34,14,2323,0,0,14,2323,0.879200000,0.6347
215.158.239.57,<->,196.1.147.104,14,784,0,0,14,784,0.876137000,0.5718
195.13.159.99,<->,136.25.188.242,0,0,14,1609,14,1609,0.849637000,0.3067
193.14.166.13,<->,100.228.42.68,0,0,14,16154,14,16154,0.844673000,0.2662
136.25.189.1,<->,96.156.169.235,14,5151,0,0,14,5151,0.832106000,0.9746
136.25.188.255,<->,67.0.40.34,14,2419,0,0,14,2419,0.823677000,1.1007
215.158.238.220,<->,8.219.185.98,14,7127,0,0,14,7127,0.815414000,1.0139
215.158.239.48,<->,195.126.170.210,14,2580,0,0,14,2580,0.811343000,0.8269
201.211.113.35,<->,133.178.227.79,0,0,14,2133,14,2133,0.803702000,0.5110
118.208.11.148,<->,89.183.104.245,0,0,14,10206,14,10206,0.802818000,0.2424
215.158.239.87,<->,204.61.158.214,14,2303,0,0,14,2303,0.799865000,0.6616
133.178.227.242,<->,29.212.136.170,14,5497,0,0,14,5497,0.799793000,1.1563
210.209.251.211,<->,98.67.151.76,0,0,14,8575,14,8575,0.791032000,0.4961
215.158.239.77,<->,199.20.29.26,14,2296,0,0,14,2296,0.790344000,1.2094
144.87.235.136,<->,137.83.182.37,14,700,0,0,14,700,0.780303000,1.0547
8.182.244.237,<->,6.21.253.57,14,2296,0,0,14,2296,0.761060000,0.7327
109.222.245.43,<->,101.64.145.123,14,10415,0,0,14,10415,0.758903000,1.1454
197.113.99.130,<->,136.25.188.252,0,0,14,1677,14,1677,0.756591000,1.2192
148.190.124.62,<->,133.178.227.16,0,0,14,2165,14,2165,0.721168000,0.3504
106.219.68.17,<->,98.236.194.252,0,0,14,784,14,784,0.716705000,1.1121
132.24.63.111,<->,100.228.42.185,0,0,14,7079,14,7079,0.714824000,1.1106
215.158.239.56,<->,194.250.223.134,14,2284,0,0,14,2284,0.712595000,0.6903
215.158.140.92,<->,69.150.169.200,14,3430,0,0,14,3430,0.708650000,1.2187
101.70.118.35,<->,100.53.195.10,14,700,0,0,14,700,0.704514000,1.2425
199.69.70.141,<->,136.25.188.178,0,0,14,1493,14,1493,0.693122000,0.4918
133.178.227.21,<->,133.56.180.35,14,11667,0,0,14,11667,0.685605000,1.0572
133.178.226.18,<->,8.222.7.47,14,6857,0,0,14,6857,0.675233000,1.2856
192.224.21.67,<->,133.178.226.29,0,0,14,1941,14,1941,0.674208000,0.4465
215.158.239.49,<->,199.80.0.226,14,3001,0,0,14,3001,0.653798000,1.1636
199.82.49.53,<->,136.25.188.174,0,0,14,754,14,754,0.653336000,1.3137
215.158.140.75,<->,8.252.253.148,14,4895,0,0,14,4895,0.651481000,1.3304
215.158.239.224,<->,192.226.44.4,14,14570,0,0,14,14570,0.641763000,0.2667
143.43.127.33,<->,136.25.188.208,0,0,14,1239,14,1239,0.638796000,1.2385
133.178.227.8,<->,98.219.126.140,14,12478,0,0,14,12478,0.610521000,1.2983
136.25.188.223,<->,8.255.92.219,14,4543,0,0,14,4543,0.608821000,1.0460
197.196.67.132,<->,0.195.210.46,0,0,14,3901,14,3901,0.605191000,1.2538
204.200.32.239,<->,136.25.188.54,0,0,14,3087,14,3087,0.603608000,0.5535
207.61.156.37,<->,136.25.188.54,0,0,14,808,14,808,0.599407000,1.2812
195.6.239.178,<->,136.25.188.225,0,0,14,1393,14,1393,0.580573000,0.6994
215.158.238.223,<->,158.85.50.151,14,4989,0,0,14,4989,0.576058000,1.3313
136.25.188.172,<->,112.220.206.106,14,4287,0,0,14,4287,0.572876000,0.8120
50.224.76.248,<->,50.51.78.188,14,5378,0,0,14,5378,0.570313000,0.1073
144.85.170.245,<->,91.69.181.133,14,1504,0,0,14,1504,0.568750000,0.4011
136.25.189.59,<->,8.50.171.247,14,9363,0,0,14,9363,0.563777000,1.3004
136.25.188.44,<->,48.129.133.32,14,2117,0,0,14,2117,0.561579000,0.3686
199.54.3.20,<->,8.182.224.248,0,0,14,1092,14,1092,0.545026000,0.5006
142.241.229.0,<->,136.25.188.45,0,0,14,1493,14,1493,0.538537000,0.4165
195.13.150.93,<->,136.25.188.225,0,0,14,1405,14,1405,0.528824000,0.5383
239.66.110.113,<->,203.215.177.34,0,0,14,1197,14,1197,0.518199000,1.4781
215.158.61.183,<->,8.176.8.237,0,0,14,9722,14,9722,0.514465000,1.2743
215.158.239.35,<->,120.155.14.168,14,2350,0,0,14,2350,0.513826000,0.2328
75.214.144.153,<->,8.252.222.23,0,0,14,1093,14,1093,0.509859000,1.4469
215.158.239.76,<->,196.104.141.156,14,784,0,0,14,784,0.508550000,0.0999
215.158.239.93,<->,199.20.31.230,14,2937,0,0,14,2937,0.495576000,1.3657
215.158.239.93,<->,195.7.203.27,14,2010,0,0,14,2010,0.493666000,1.3369
215.158.238.121,<->,72.23.179.41,14,2085,0,0,14,2085,0.491685000,0.4462
213.221.90.234,<->,144.85.170.248,0,0,14,1579,14,1579,0.483899000,1.4206
143.52.101.113,<->,136.25.188.198,0,0,14,2322,14,2322,0.483686000,1.4329
142.207.100.195,<->,136.25.188.255,0,0,14,2365,14,2365,0.481635000,0.5625
92.59.22.204,<->,92.27.219.203,0,0,14,17095,14,17095,0.480515000,1.0501
53.64.93.17,<->,8.20.87.4,0,0,14,20222,14,20222,0.477779000,0.1677
205.227.96.25,<->,136.25.189.1,0,0,14,3700,14,3700,0.475154000,1.4611
95.245.104.233,<->,8.252.221.198,0,0,14,920,14,920,0.472686000,1.3443
199.102.34.95,<->,50.223.3.228,0,0,14,748,14,748,0.471827000,1.1225
136.25.188.255,<->,33.209.217.236,14,6259,0,0,14,6259,0.470678000,1.5227
220.40.166.212,<->,215.158.238.99,0,0,14,1973,14,1973,0.468806000,0.5258
220.39.233.40,<->,133.178.227.76,0,0,14,2839,14,2839,0.463188000,1.1791
221.102.56.46,<->,192.67.169.78,0,0,14,9274,14,9274,0.451218000,0.1242
105.65.117.137,<->,92.27.27.174,0,0,14,17744,14,17744,0.443902000,1.1441
144.93.132.234,<->,53.230.38.178,14,19183,0,0,14,19183,0.413062000,0.6015
215.158.61.243,<->,8.176.8.176,0,0,14,7964,14,7964,0.410921000,1.5316
201.211.112.247,<->,133.178.227.2,0,0,14,2197,14,2197,0.409734000,1.3440
98.236.90.195,<->,93.254.7.61,14,705,0,0,14,705,0.408715000,0.7155
136.25.188.254,<->,122.158.49.136,14,3930,0,0,14,3930,0.402369000,1.5560
122.184.13.50,<->,8.52.178.227,0,0,14,4186,14,4186,0.402263000,0.4207
143.129.206.171,<->,136.25.188.222,0,0,14,2313,14,2313,0.396758000,0.8427
136.25.188.197,<->,100.224.202.189,14,3954,0,0,14,3954,0.394001000,0.3689
204.200.32.141,<->,136.25.188.255,0,0,14,1379,14,1379,0.391357000,0.1945
136.25.188.45,<->,106.188.236.136,14,4399,0,0,14,4399,0.389104000,1.0367
215.158.239.84,<->,196.108.105.153,14,2370,0,0,14,2370,0.389098000,1.5100
200.174.170.71,<->,53.231.93.37,14,20776,0,0,14,20776,0.387457000,1.5600
215.158.239.5,<->,118.20.114.86,14,5016,0,0,14,5016,0.385948000,1.5205
215.158.239.70,<->,194.237.30.74,14,2429,0,0,14,2429,0.385556000,0.8814
199.70.97.127,<->,136.25.188.163,0,0,14,1688,14,1688,0.377674000,1.3560
215.158.61.191,<->,8.176.8.191,0,0,14,16111,14,16111,0.373477000,1.3964
207.56.101.49,<->,136.25.188.225,0,0,14,1703,14,1703,0.360496000,1.0407
195.14.125.23,<->,136.25.188.46,0,0,14,2168,14,2168,0.352719000,1.0678
159.36.5.214,<->,136.25.188.198,0,0,14,987,14,987,0.349388000,0.0357
101.129.32.178,<->,98.67.158.12,0,0,14,5335,14,5335,0.349237000,0.3441
215.158.61.182,<->,8.176.8.180,0,0,14,10866,14,10866,0.343273000,0.7871
215.158.140.92,<->,131.144.113.138,14,2022,0,0,14,2022,0.337173000,0.1769
136.25.188.32,<->,54.49.181.218,14,9081,0,0,14,9081,0.334275000,1.2514
196.87.86.103,<->,136.25.188.210,0,0,14,1651,14,1651,0.329771000,1.2097
96.76.243.91,<->,50.224.76.234,0,0,14,1431,14,1431,0.328485000,0.3025
205.127.108.115,<->,33.233.141.1,0,0,14,5864,14,5864,0.327781000,1.6471
215.158.239.84,<->,204.226.12.195,14,1897,0,0,14,1897,0.322069000,0.8922
215.158.238.122,<->,143.20.121.168,14,4527,0,0,14,4527,0.321177000,1.3430
135.243.190.253,<->,8.52.176.134,0,0,14,1867,14,1867,0.319240000,0.4334
215.158.239.99,<->,199.33.181.32,14,1372,0,0,14,1372,0.319113000,1.3293
136.25.189.16,<->,96.156.169.244,14,7145,0,0,14,7145,0.317986000,1.5234
212.164.143.185,<->,132.213.199.17,14,1270,0,0,14,1270,0.311312000,0.9521
215.158.238.135,<->,69.150.169.181,14,4415,0,0,14,4415,0.310036000,1.6301
156.165.37.111,<->,133.178.227.16,0,0,14,2085,14,2085,0.309408000,0.3807
142.220.64.205,<->,136.25.188.174,0,0,14,1693,14,1693,0.307638000,1.2367
220.28.114.28,<->,133.178.226.85,0,0,14,16571,14,16571,0.304765000,0.9673
215.158.239.68,<->,194.251.72.26,14,1722,0,0,14,1722,0.303955000,0.4883
212.100.244.206,<->,8.52.185.88,0,0,14,1423,14,1423,0.303295000,0.1508
142.249.41.31,<->,136.25.188.174,0,0,14,2296,14,2296,0.296624000,0.8519
215.158.239.68,<->,196.93.217.19,14,2221,0,0,14,2221,0.291528000,1.0496
119.253.0.22,<->,92.27.219.46,0,0,14,17013,14,17013,0.287185000,0.1529
143.68.179.58,<->,136.25.188.196,0,0,14,2286,14,2286,0.285272000,0.8461
136.25.188.234,<->,100.224.202.157,14,3934,0,0,14,3934,0.284463000,1.6148
233.97.214.65,<->,129.6.83.0,0,0,14,2033,14,2033,0.283985000,1.6679
204.62.108.194,<->,136.25.188.242,0,0,14,952,14,952,0.275915000,0.6599
215.158.239.96,<->,207.63.249.180,14,1568,0,0,14,1568,0.272234000,1.6399
108.36.39.240,<->,98.236.194.252,0,0,14,784,14,784,0.270941000,1.1395
92.27.27.151,<->,72.36.193.223,14,804,0,0,14,804,0.266204000,1.4489
136.25.188.45,<->,72.23.179.39,14,1893,0,0,14,1893,0.262729000,1.2106
215.158.238.134,<->,131.36.198.41,14,4351,0,0,14,4351,0.262432000,1.6666
215.158.239.76,<->,199.20.30.80,14,3402,0,0,14,3402,0.261294000,1.4625
139.163.68.55,<->,110.45.99.143,14,701,0,0,14,701,0.253000000,1.6825
215.158.238.176,<->,192.171.32.168,14,2847,0,0,14,2847,0.252625000,1.6425
220.39.233.203,<->,136.25.188.221,0,0,14,4415,14,4415,0.250501000,0.8947
136.25.189.58,<->,29.214.108.255,14,8670,0,0,14,8670,0.247014000,1.6757
215.158.239.70,<->,204.58.237.154,14,700,0,0,14,700,0.245877000,0.1397
215.158.61.192,<->,99.74.26.195,0,0,14,15912,14,15912,0.244942000,0.3277
194.192.110.115,<->,50.223.3.228,0,0,14,712,14,712,0.242522000,1.6706
215.158.238.104,<->,113.23.20.126,14,4431,0,0,14,4431,0.239094000,1.4968
196.88.217.33,<->,136.25.188.252,0,0,14,1703,14,1703,0.237688000,0.2972
220.20.200.41,<->,42.105.196.8,14,16307,0,0,14,16307,0.235553000,0.4228
136.25.188.220,<->,131.36.198.57,14,7698,0,0,14,7698,0.234590000,1.5888
215.158.239.19,<->,91.57.162.183,14,5364,0,0,14,5364,0.233842000,1.2182
133.178.227.79,<->,113.23.14.219,14,3753,0,0,14,3753,0.233537000,1.4418
143.68.139.82,<->,136.25.188.54,0,0,14,2288,14,2288,0.232894000,0.8481
192.204.123.39,<->,136.25.189.33,0,0,14,7193,14,7193,0.232607000,1.5679
215.158.239.87,<->,29.214.73.167,14,4367,0,0,14,4367,0.230817000,1.6925
215.158.238.148,<->,131.144.115.215,14,1893,0,0,14,1893,0.230759000,0.8179
215.158.239.95,<->,199.20.30.229,14,1591,0,0,14,1591,0.228489000,0.9688
119.126.161.254,<->,92.27.27.99,0,0,14,17125,14,17125,0.228385000,0.7626
133.178.226.19,<->,122.158.245.138,14,5860,0,0,14,5860,0.227542000,1.5304
215.158.238.141,<->,112.220.206.14,14,7353,0,0,14,7353,0.227390000,1.6543
136.25.189.0,<->,8.215.68.83,14,9571,0,0,14,9571,0.225428000,1.6748
215.158.239.68,<->,199.20.29.73,14,2337,0,0,14,2337,0.225146000,0.8399
215.158.239.79,<->,204.61.156.93,14,1743,0,0,14,1743,0.224393000,0.9340
199.72.87.54,<->,136.25.188.178,0,0,14,2234,14,2234,0.223851000,0.4540
199.72.228.2,<->,136.25.188.253,0,0,14,814,14,814,0.222234000,1.6218
92.162.253.98,<->,33.229.46.107,14,16598,0,0,14,16598,0.222064000,1.1582
215.158.140.83,<->,126.219.100.251,14,1924,0,0,14,1924,0.218846000,0.7900
136.25.188.105,<->,128.243.151.33,14,3072,0,0,14,3072,0.217492000,1.5153
192.204.170.200,<->,136.25.188.178,0,0,14,4687,14,4687,0.215083000,1.7805
215.158.140.24,<->,56.112.84.79,14,13029,0,0,14,13029,0.214230000,1.4144
215.158.238.251,<->,113.23.56.89,14,3841,0,0,14,3841,0.213947000,1.4708
110.66.114.217,<->,50.224.82.18,0,0,14,700,14,700,0.213921000,1.7496
215.158.239.76,<->,207.115.98.212,14,3827,0,0,14,3827,0.212986000,1.6270
136.25.188.236,<->,30.73.221.141,14,784,0,0,14,784,0.212751000,0.2400
220.28.85.14,<->,136.25.188.250,0,0,14,19028,14,19028,0.212281000,0.0000
50.224.82.18,<->,50.52.197.172,14,700,0,0,14,700,0.211110000,1.5580
215.158.61.145,<->,8.176.8.181,0,0,14,9520,14,9520,0.209145000,1.1766
215.158.239.59,<->,29.212.198.183,14,5604,0,0,14,5604,0.207355000,1.5279
215.158.238.73,<->,197.125.126.183,14,4559,0,0,14,4559,0.205957000,1.7905
215.158.239.78,<->,196.90.13.76,14,784,0,0,14,784,0.205819000,0.1800
220.87.252.199,<->,139.163.96.101,0,0,14,2058,14,2058,0.205336000,1.5880
133.178.226.61,<->,69.150.168.216,14,5508,0,0,14,5508,0.205024000,1.7630
142.190.141.209,<->,136.25.188.253,0,0,14,1698,14,1698,0.202277000,1.0050
136.95.243.159,<->,100.228.42.97,0,0,14,13588,14,13588,0.197616000,0.0848
143.77.187.28,<->,8.252.222.162,0,0,14,1657,14,1657,0.196429000,0.3593
220.39.233.187,<->,133.178.226.7,0,0,14,6969,14,6969,0.194765000,1.7950
199.33.16.158,<->,136.25.188.52,0,0,14,1932,14,1932,0.194574000,1.8027
215.158.239.87,<->,199.70.227.212,14,1384,0,0,14,1384,0.193546000,1.1148
207.207.68.195,<->,50.223.3.228,0,0,14,724,14,724,0.192618000,1.6890
129.5.98.95,<->,58.244.208.176,0,0,14,20944,14,20944,0.191542000,1.7796
136.25.189.80,<->,118.20.100.145,14,7497,0,0,14,7497,0.190261000,1.5590
95.247.96.36,<->,8.252.221.198,0,0,14,1130,14,1130,0.189488000,1.5760
204.186.24.58,<->,136.25.188.172,0,0,14,878,14,878,0.189469000,1.4402
207.57.148.180,<->,136.25.188.238,0,0,14,1817,14,1817,0.188896000,1.3014
143.53.209.117,<->,136.25.188.163,0,0,14,1734,14,1734,0.188331000,1.4214
133.178.226.80,<->,57.227.83.61,14,1925,0,0,14,1925,0.187698000,0.1146
197.81.31.144,<->,136.25.188.225,0,0,14,1720,14,1720,0.185040000,1.6702
195.41.197.10,<->,136.25.188.226,0,0,14,1827,14,1827,0.184756000,1.2322
215.158.238.67,<->,27.178.41.58,14,6857,0,0,14,6857,0.184168000,1.5916
136.25.188.162,<->,69.150.169.180,14,1925,0,0,14,1925,0.180528000,0.7571
215.158.238.238,<->,192.226.161.159,14,3883,0,0,14,3883,0.179564000,1.8070
239.66.213.57,<->,50.224.120.21,0,0,14,784,14,784,0.179252000,1.7155
136.25.189.45,<->,133.224.119.42,14,7241,0,0,14,7241,0.178213000,1.8125
231.143.114.45,<->,136.25.188.225,0,0,14,2525,14,2525,0.177717000,0.7991
251.24.86.17,<->,8.252.222.161,0,0,14,1915,14,1915,0.174163000,0.8906
195.65.1.171,<->,133.178.227.70,0,0,14,3418,14,3418,0.173799000,1.1093
195.58.110.181,<->,50.223.3.228,0,0,14,700,14,700,0.173409000,1.7824
146.249.226.232,<->,8.252.222.151,0,0,14,1895,14,1895,0.170591000,1.1040
195.43.119.146,<->,136.25.188.55,0,0,14,700,14,700,0.169328000,1.8282
192.229.43.33,<->,133.178.227.242,0,0,14,7013,14,7013,0.169220000,1.2527
133.178.227.24,<->,111.150.187.231,14,1816,0,0,14,1816,0.168337000,1.1526
133.178.226.3,<->,96.155.60.253,14,4383,0,0,14,4383,0.167506000,1.5049
247.136.212.186,<->,121.12.84.230,14,9202,0,0,14,9202,0.163618000,1.8116
207.62.190.212,<->,139.163.7.204,0,0,14,2320,14,2320,0.163092000,1.7192
143.14.191.92,<->,136.25.188.162,0,0,14,796,14,796,0.160327000,0.0020
215.158.239.49,<->,195.7.115.113,14,1738,0,0,14,1738,0.160096000,1.7406
213.186.61.117,<->,139.163.27.110,0,0,14,784,14,784,0.159228000,1.7196
207.194.71.227,<->,50.223.3.228,0,0,14,718,14,718,0.158346000,1.7754
199.69.140.83,<->,136.25.188.160,0,0,14,784,14,784,0.157595000,0.2281
204.200.165.192,<->,136.25.188.45,0,0,14,700,14,700,0.157316000,1.0109
215.158.239.57,<->,143.128.158.57,14,784,0,0,14,784,0.156586000,0.6606
220.55.74.96,<->,194.52.204.29,14,700,0,0,14,700,0.154603000,1.6654
136.25.189.95,<->,98.219.126.175,14,18702,0,0,14,18702,0.154125000,0.3595
208.24.194.54,<->,8.43.155.247,0,0,14,1290,14,1290,0.152815000,0.7986
215.158.61.195,<->,8.176.8.236,0,0,14,13629,14,13629,0.151597000,1.7128
133.178.227.41,<->,126.219.102.8,14,4937,0,0,14,4937,0.149906000,1.3380
195.7.156.64,<->,136.25.188.253,0,0,14,784,14,784,0.147244000,0.0192
213.186.59.156,<->,139.163.27.106,0,0,14,784,14,784,0.143277000,1.7732
136.25.188.236,<->,8.188.227.20,14,4655,0,0,14,4655,0.141766000,1.7279
136.25.188.237,<->,8.42.43.8,14,3366,0,0,14,3366,0.140650000,1.6073
215.158.239.93,<->,196.104.240.183,14,1104,0,0,14,1104,0.140163000,1.7800
215.158.238.33,<->,128.123.91.10,14,3210,0,0,14,3210,0.139614000,1.4596
215.158.238.132,<->,118.20.114.80,14,4507,0,0,14,4507,0.139597000,1.8086
192.224.146.144,<->,133.178.226.85,0,0,14,18093,14,18093,0.138845000,0.0057
215.158.238.198,<->,195.65.1.162,14,2857,0,0,14,2857,0.137873000,1.2255
205.127.108.113,<->,33.233.141.232,0,0,14,5266,14,5266,0.135963000,1.8129
133.178.227.19,<->,18.202.90.214,14,4988,0,0,14,4988,0.135593000,1.7070
215.158.238.135,<->,131.144.114.208,14,4383,0,0,14,4383,0.133224000,1.8018
98.128.241.87,<->,8.45.162.111,14,15763,0,0,14,15763,0.130031000,0.2674
194.220.53.193,<->,50.223.3.228,0,0,14,724,14,724,0.125318000,1.7702
215.158.239.58,<->,199.20.6.1,14,784,0,0,14,784,0.124826000,0.2703
207.60.237.243,<->,136.25.188.54,0,0,14,1622,14,1622,0.120998000,1.5645
199.33.119.216,<->,136.25.188.163,0,0,14,1868,14,1868,0.119818000,0.8453
215.158.238.142,<->,33.209.217.237,14,7426,0,0,14,7426,0.118785000,1.8744
136.25.189.88,<->,96.156.169.160,14,6660,0,0,14,6660,0.117984000,1.3845
143.129.198.157,<->,136.25.188.241,0,0,14,2738,14,2738,0.117978000,0.5667
152.1.221.131,<->,20.213.77.127,0,0,14,840,14,840,0.117215000,1.7681
215.158.238.132,<->,131.144.113.216,14,8222,0,0,14,8222,0.116885000,1.7652
215.158.239.69,<->,199.20.30.21,14,3209,0,0,14,3209,0.112961000,1.8602
194.251.88.58,<->,97.198.98.47,0,0,14,3808,14,3808,0.111668000,1.8490
215.158.238.250,<->,106.188.244.180,14,3082,0,0,14,3082,0.111093000,1.7032
43.52.3.19,<->,8.252.222.172,0,0,14,770,14,770,0.110709000,1.7365
204.2.252.19,<->,136.25.188.177,0,0,14,996,14,996,0.106217000,0.4589
105.144.76.111,<->,92.27.219.142,0,0,14,19544,14,19544,0.104597000,1.8436
136.25.189.54,<->,96.156.169.239,14,10814,0,0,14,10814,0.103558000,0.3290
121.210.96.252,<->,92.27.219.181,0,0,14,17528,14,17528,0.100861000,1.8224
215.158.239.57,<->,142.227.16.45,14,1706,0,0,14,1706,0.100428000,1.7373
136.25.189.15,<->,120.154.71.73,14,8330,0,0,14,8330,0.100395000,1.6451
143.135.8.141,<->,136.25.188.196,0,0,14,2285,14,2285,0.097645000,0.7681
207.60.121.202,<->,136.25.188.55,0,0,14,1493,14,1493,0.095277000,0.4070
133.178.227.30,<->,133.56.180.78,14,6940,0,0,14,6940,0.094241000,1.8531
136.25.188.220,<->,131.1.253.227,14,2006,0,0,14,2006,0.094060000,0.8175
136.25.188.197,<->,8.217.44.58,14,2085,0,0,14,2085,0.093860000,0.7798
192.64.90.176,<->,128.154.170.88,14,6044,0,0,14,6044,0.093477000,1.7323
215.158.239.42,<->,8.191.6.219,14,7002,0,0,14,7002,0.093090000,1.6622
199.38.102.150,<->,136.25.188.196,0,0,14,766,14,766,0.092389000,0.9105
136.25.189.2,<->,80.56.79.104,14,8896,0,0,14,8896,0.091309000,1.4402
215.158.140.241,<->,8.53.216.69,14,3909,0,0,14,3909,0.088485000,1.8238
139.241.56.117,<->,100.92.203.223,0,0,14,20384,14,20384,0.087652000,1.6698
215.158.239.41,<->,120.155.14.71,14,3671,0,0,14,3671,0.087597000,1.3931
215.158.239.50,<->,199.20.31.86,14,1817,0,0,14,1817,0.086544000,1.3310
136.25.188.211,<->,57.160.181.245,14,7001,0,0,14,7001,0.082794000,1.8090
215.158.238.105,<->,8.188.227.60,14,3066,0,0,14,3066,0.082187000,1.8256
111.146.228.90,<->,53.201.176.118,14,4648,0,0,14,4648,0.079911000,1.8281
215.158.239.48,<->,143.94.230.214,14,1602,0,0,14,1602,0.079813000,0.5353
109.14.211.137,<->,50.224.49.195,0,0,14,784,14,784,0.078271000,1.7923
133.178.227.14,<->,126.219.246.222,14,6264,0,0,14,6264,0.077871000,1.8286
215.158.140.83,<->,106.188.228.23,14,5040,0,0,14,5040,0.075028000,1.7266
215.158.239.69,<->,29.211.228.247,14,8242,0,0,14,8242,0.074966000,1.3712
199.72.49.30,<->,136.25.188.46,0,0,14,700,14,700,0.074230000,0.1116
115.235.50.183,<->,92.27.219.236,0,0,14,17013,14,17013,0.074051000,0.1374
215.158.239.50,<->,199.33.239.39,14,1630,0,0,14,1630,0.073805000,1.4266
111.20.172.118,<->,33.233.141.232,0,0,14,18113,14,18113,0.072996000,0.0001
121.183.1.193,<->,8.43.213.64,0,0,14,730,14,730,0.071037000,1.8704
95.245.158.40,<->,8.252.221.221,0,0,14,742,14,742,0.068795000,1.9218
231.142.118.47,<->,215.158.239.87,0,0,14,730,14,730,0.067322000,1.6619
215.158.239.95,<->,33.209.219.82,14,8633,0,0,14,8633,0.066893000,1.9236
136.42.218.57,<->,50.224.88.116,0,0,14,784,14,784,0.065942000,1.8503
133.178.226.83,<->,96.155.60.250,14,8359,0,0,14,8359,0.065333000,1.5894
48.131.156.42,<->,8.252.222.176,0,0,14,2085,14,2085,0.065224000,0.7569
247.136.184.114,<->,132.163.66.239,14,1781,0,0,14,1781,0.065064000,1.9117
136.25.188.255,<->,104.3.168.218,14,5812,0,0,14,5812,0.062369000,1.7298
143.132.135.155,<->,136.25.188.197,0,0,14,748,14,748,0.062072000,0.6251
203.117.64.94,<->,0.195.210.42,0,0,14,784,14,784,0.061077000,1.7599
215.158.238.176,<->,8.192.205.86,14,4703,0,0,14,4703,0.060159000,1.8748
58.60.203.21,<->,8.252.221.198,0,0,14,748,14,748,0.059920000,1.8633
136.25.189.32,<->,126.219.194.7,14,6521,0,0,14,6521,0.058556000,1.9244
111.20.172.70,<->,111.20.168.23,0,0,14,1681,14,1681,0.057990000,1.0616
94.194.248.164,<->,8.252.221.196,0,0,14,700,14,700,0.056418000,1.8120
247.136.162.181,<->,136.117.43.13,14,6026,0,0,14,6026,0.056177000,1.8236
221.196.94.84,<->,8.52.179.22,0,0,14,1040,14,1040,0.056062000,1.6101
210.221.107.50,<->,8.37.242.166,14,7870,0,0,14,7870,0.055810000,1.7865
192.67.172.133,<->,144.91.199.60,14,13071,0,0,14,13071,0.055474000,1.8852
144.86.147.98,<->,35.56.3.196,14,1756,0,0,14,1756,0.055297000,1.5824
215.158.238.67,<->,113.23.104.213,14,7950,0,0,14,7950,0.052836000,1.6400
215.158.239.34,<->,122.158.246.201,14,5035,0,0,14,5035,0.052834000,0.8459
129.95.133.231,<->,14.119.194.95,0,0,14,1191,14,1191,0.052540000,0.2652
106.168.190.214,<->,102.50.235.188,0,0,14,1620,14,1620,0.051398000,1.1759
207.60.205.169,<->,136.25.188.163,0,0,14,700,14,700,0.051123000,1.0037
199.30.197.36,<->,50.223.3.228,0,0,14,736,14,736,0.048968000,1.6382
215.158.239.50,<->,120.154.131.36,14,8741,0,0,14,8741,0.048628000,1.6962
221.196.123.136,<->,139.163.27.106,0,0,14,784,14,784,0.047853000,1.7999
215.158.239.17,<->,96.135.154.110,14,3771,0,0,14,3771,0.047544000,1.4228
215.158.239.77,<->,195.7.8.48,14,1380,0,0,14,1380,0.045936000,0.7829
94.195.120.159,<->,8.252.222.199,0,0,14,1647,14,1647,0.044182000,1.7464
215.158.239.76,<->,199.20.30.89,14,874,0,0,14,874,0.043946000,1.4401
200.10.212.233,<->,8.252.221.198,0,0,14,742,14,742,0.043273000,1.8366
215.158.140.241,<->,106.188.252.228,14,4812,0,0,14,4812,0.041207000,1.7222
215.158.238.99,<->,65.27.220.218,14,4191,0,0,14,4191,0.040708000,1.8583
146.133.58.23,<->,8.252.222.45,0,0,14,754,14,754,0.040373000,0.7841
196.31.137.79,<->,50.223.3.228,0,0,14,736,14,736,0.039992000,1.8262
133.178.227.27,<->,133.56.180.47,14,8196,0,0,14,8196,0.039817000,1.9521
139.163.96.127,<->,104.137.51.93,14,766,0,0,14,766,0.038912000,1.9435
136.25.189.13,<->,96.156.169.222,14,6164,0,0,14,6164,0.038743000,1.8883
197.113.99.244,<->,136.25.188.197,0,0,14,1586,14,1586,0.037882000,1.8989
97.198.98.50,<->,91.100.188.166,14,784,0,0,14,784,0.037562000,1.7193
146.193.21.83,<->,8.252.221.239,0,0,14,1064,14,1064,0.037446000,0.4702
215.158.239.84,<->,196.109.125.58,14,784,0,0,14,784,0.037251000,0.1880
204.20.175.50,<->,136.25.188.222,0,0,14,1802,14,1802,0.037217000,1.0631
195.41.227.184,<->,136.25.188.254,0,0,14,1720,14,1720,0.035890000,1.0414
139.160.226.234,<->,136.25.188.161,0,0,14,4511,14,4511,0.035287000,1.8168
216.184.2.61,<->,8.252.222.2,0,0,14,17497,14,17497,0.032419000,0.0368
136.25.189.38,<->,96.156.169.210,14,18303,0,0,14,18303,0.031448000,0.9271
136.25.189.35,<->,120.154.71.23,14,8054,0,0,14,8054,0.030489000,1.9095
215.158.140.83,<->,106.188.245.60,14,5136,0,0,14,5136,0.029522000,1.2718
215.158.239.78,<->,194.251.84.58,14,1660,0,0,14,1660,0.029394000,0.7327
215.158.238.113,<->,112.235.95.60,14,5652,0,0,14,5652,0.029061000,1.8449
215.158.239.109,<->,100.224.141.62,14,11140,0,0,14,11140,0.028040000,1.9590
98.87.178.229,<->,50.224.61.156,0,0,14,784,14,784,0.026938000,1.8693
204.35.130.104,<->,50.223.3.228,0,0,14,730,14,730,0.026903000,1.7278
204.14.245.77,<->,50.223.3.228,0,0,14,700,14,700,0.026101000,1.8166
215.158.239.49,<->,29.209.59.232,14,9571,0,0,14,9571,0.024014000,1.9192
215.158.239.58,<->,199.106.249.74,14,2330,0,0,14,2330,0.023315000,0.8456
136.25.188.162,<->,8.252.210.250,14,3258,0,0,14,3258,0.022927000,1.3329
215.158.238.73,<->,65.27.228.201,14,4555,0,0,14,4555,0.020640000,1.8448
142.209.70.144,<->,136.25.188.252,0,0,14,1549,14,1549,0.019426000,1.2521
215.158.238.123,<->,48.49.55.182,14,3130,0,0,14,3130,0.015698000,1.5420
159.23.225.171,<->,118.66.172.149,14,700,0,0,14,700,0.015673000,1.8080
126.226.46.137,<->,0.195.210.46,0,0,14,9089,14,9089,0.014802000,1.4731
195.13.79.155,<->,136.25.188.227,0,0,14,2621,14,2621,0.014112000,1.9557
215.158.239.99,<->,199.20.29.93,14,2321,0,0,14,2321,0.011440000,0.9697
215.158.238.96,<->,131.2.115.236,14,4719,0,0,14,4719,0.009205000,1.8208
139.163.27.106,<->,136.116.9.54,14,784,0,0,14,784,0.008127000,1.7872
136.119.203.229,<->,136.25.188.30,0,0,14,2032,14,2032,0.007630000,0.1598
139.163.81.178,<->,100.96.191.255,14,784,0,0,14,784,0.007282000,1.5937
194.237.22.26,<->,136.25.188.163,0,0,14,1673,14,1673,0.006418000,0.3510
215.158.239.56,<->,199.106.6.24,14,1742,0,0,14,1742,0.005818000,0.4912
142.252.174.204,<->,136.25.188.198,0,0,14,1625,14,1625,0.005577000,0.6829
138.20.59.183,<->,8.53.2.255,0,0,14,2548,14,2548,0.004279000,1.9383
117.166.148.72,<->,92.27.219.219,0,0,14,799,14,799,0.004270000,1.6243
143.129.206.95,<->,136.25.188.54,0,0,14,784,14,784,0.002191000,0.2047
146.249.227.96,<->,8.252.222.4,0,0,14,844,14,844,0.002159000,1.8720
215.158.239.57,<->,194.237.139.11,14,2492,0,0,14,2492,0.001939000,1.1980
143.42.155.197,<->,136.25.188.53,0,0,14,1028,14,1028,0.001907000,1.9334
143.20.32.91,<->,136.25.188.241,0,0,14,700,14,700,0.001751000,0.5817
107.8.60.69,<->,92.27.219.204,0,0,14,18551,14,18551,0.000765000,1.0508
215.158.140.75,<->,89.86.110.196,14,4951,0,0,14,4951,0.000598000,1.6505
215.158.238.64,<->,136.138.112.218,14,3354,0,0,14,3354,0.000478000,1.3503
215.158.238.218,<->,215.158.132.242,13,18096,0,0,13,18096,1.928261000,0.0001
129.80.83.17,<->,35.56.100.21,0,0,13,1196,13,1196,1.909115000,0.0611
209.91.132.145,<->,8.220.191.251,0,0,13,1044,13,1044,1.839957000,0.1247
129.225.135.32,<->,129.225.132.95,0,0,13,10969,13,10969,1.832180000,0.1314
216.184.1.115,<->,136.25.188.165,0,0,13,8307,13,8307,1.779290000,0.1733
98.128.112.144,<->,8.45.175.127,13,8038,0,0,13,8038,1.754751000,0.2179
215.158.239.78,<->,194.199.217.220,13,1636,0,0,13,1636,1.715511000,0.1647
136.96.191.218,<->,136.25.188.198,0,0,13,2076,13,2076,1.711467000,0.1920
136.25.188.212,<->,80.57.141.209,13,9571,0,0,13,9571,1.699469000,0.1753
204.130.115.175,<->,8.252.223.106,0,0,13,2061,13,2061,1.689730000,0.1750
248.225.27.2,<->,82.193.207.46,13,9271,0,0,13,9271,1.669155000,0.2455
244.1.41.59,<->,136.25.188.163,0,0,13,1825,13,1825,1.662183000,0.3126
192.64.93.227,<->,8.55.211.213,13,1728,0,0,13,1728,1.634607000,0.3112
210.220.219.181,<->,53.240.183.135,13,6892,0,0,13,6892,1.607305000,0.2089
215.158.239.84,<->,199.20.5.196,13,650,0,0,13,650,1.590217000,0.3602
215.158.239.105,<->,215.158.61.189,13,7064,0,0,13,7064,1.576256000,0.3838
215.158.239.66,<->,145.116.209.92,13,8403,0,0,13,8403,1.564845000,0.1306
233.30.195.29,<->,8.20.87.187,0,0,13,1232,13,1232,1.563448000,0.2203
213.21.35.44,<->,8.220.191.251,0,0,13,1112,13,1112,1.559323000,0.0814
142.240.10.46,<->,136.25.188.198,0,0,13,2396,13,2396,1.519632000,0.3463
220.28.85.14,<->,215.158.238.88,0,0,13,18096,13,18096,1.518200000,0.0000
129.236.115.40,<->,111.20.168.123,0,0,13,977,13,977,1.517972000,0.0196
97.233.114.122,<->,8.252.222.143,0,0,13,2279,13,2279,1.515643000,0.1661
133.178.226.20,<->,8.222.48.144,13,18986,0,0,13,18986,1.508168000,0.0346
212.70.99.177,<->,8.220.200.124,0,0,13,4364,13,4364,1.488240000,0.4486
204.2.109.51,<->,136.25.188.225,0,0,13,2467,13,2467,1.464686000,0.4203
204.200.55.151,<->,136.25.188.255,0,0,13,2263,13,2263,1.459206000,0.4413
215.158.239.96,<->,195.54.150.59,13,1341,0,0,13,1341,1.395768000,0.3981
136.25.189.1,<->,94.110.153.229,13,2248,0,0,13,2248,1.368542000,0.4918
246.253.253.107,<->,56.148.119.56,13,5750,0,0,13,5750,1.364333000,0.1463
50.224.76.248,<->,17.139.200.50,13,4134,0,0,13,4134,1.337954000,0.1070
143.129.165.208,<->,136.25.188.209,0,0,13,1652,13,1652,1.322858000,0.6002
136.25.189.42,<->,96.156.169.218,13,18487,0,0,13,18487,1.313986000,0.0002
195.42.100.56,<->,136.25.188.174,0,0,13,1588,13,1588,1.293251000,0.2841
145.89.76.85,<->,8.204.67.165,13,10691,0,0,13,10691,1.292904000,0.3060
199.73.39.223,<->,136.25.188.55,0,0,13,1444,13,1444,1.290563000,0.6679
221.196.122.207,<->,136.25.188.226,0,0,13,981,13,981,1.288834000,0.6129
210.220.218.67,<->,17.43.172.58,13,5087,0,0,13,5087,1.254229000,0.4469
197.161.251.39,<->,136.25.188.178,0,0,13,2586,13,2586,1.252170000,0.5159
215.158.239.92,<->,195.55.190.198,13,1226,0,0,13,1226,1.242026000,0.6553
195.6.133.76,<->,136.25.188.46,0,0,13,2243,13,2243,1.228433000,0.6412
215.158.140.93,<->,192.224.20.45,13,1631,0,0,13,1631,1.222973000,0.0385
222.31.192.130,<->,8.220.189.63,0,0,13,1833,13,1833,1.189340000,0.7961
215.158.239.76,<->,199.82.203.26,13,946,0,0,13,946,1.179531000,0.4855
215.158.238.140,<->,114.150.180.157,13,1885,0,0,13,1885,1.177118000,0.2019
207.60.111.65,<->,136.25.188.54,0,0,13,1258,13,1258,1.168004000,0.5574
53.231.85.206,<->,48.55.113.111,0,0,13,10616,13,10616,1.164261000,0.7250
210.158.20.243,<->,80.38.62.152,0,0,13,2239,13,2239,1.163628000,0.7333
231.136.201.240,<->,136.25.188.241,0,0,13,937,13,937,1.156262000,0.5031
215.158.238.106,<->,136.139.59.118,13,3234,0,0,13,3234,1.155132000,0.8035
143.10.250.108,<->,136.25.188.160,0,0,13,2865,13,2865,1.147330000,0.7353
204.139.18.203,<->,50.223.3.228,0,0,13,896,13,896,1.133639000,0.7583
136.141.228.139,<->,8.182.224.143,0,0,13,8056,13,8056,1.132398000,0.1468
215.158.238.67,<->,38.104.11.106,13,1677,0,0,13,1677,1.127545000,0.1756
215.158.238.82,<->,112.220.206.18,13,4119,0,0,13,4119,1.120277000,0.8028
142.227.168.201,<->,136.25.188.241,0,0,13,3176,13,3176,1.120106000,0.8575
215.158.239.77,<->,199.20.31.198,13,1628,0,0,13,1628,1.096613000,0.2791
195.54.56.6,<->,136.25.188.236,0,0,13,1318,13,1318,1.094105000,0.3840
215.158.239.84,<->,199.20.7.200,13,2278,0,0,13,2278,1.082752000,0.9093
142.253.219.46,<->,136.25.188.253,0,0,13,1844,13,1844,1.070953000,0.8172
100.235.148.203,<->,8.220.202.4,0,0,13,1255,13,1255,1.064518000,0.4828
195.55.16.198,<->,136.25.188.227,0,0,13,2232,13,2232,1.038504000,0.9599
215.158.238.75,<->,8.188.227.11,13,4519,0,0,13,4519,1.026781000,0.8591
142.209.200.35,<->,136.25.188.54,0,0,13,728,13,728,1.021583000,0.9290
136.25.189.1,<->,96.156.169.229,13,6332,0,0,13,6332,1.019091000,0.9625
136.25.188.53,<->,104.3.161.25,13,3154,0,0,13,3154,1.014841000,0.9363
136.25.188.44,<->,111.150.34.233,13,1965,0,0,13,1965,1.003669000,0.2586
215.158.140.185,<->,8.222.7.181,13,1899,0,0,13,1899,0.995865000,0.2592
215.158.238.66,<->,61.34.184.202,13,1853,0,0,13,1853,0.952266000,0.6590
215.158.239.70,<->,199.20.29.209,13,1577,0,0,13,1577,0.945317000,0.6698
142.236.6.229,<->,136.25.188.220,0,0,13,1149,13,1149,0.937681000,0.4220
195.14.126.58,<->,136.25.188.253,0,0,13,3117,13,3117,0.935966000,0.4419
215.158.239.57,<->,195.15.186.62,13,2238,0,0,13,2238,0.935012000,0.6458
215.158.238.95,<->,206.103.215.57,13,1693,0,0,13,1693,0.915688000,0.0999
215.158.238.186,<->,215.158.43.40,13,1552,0,0,13,1552,0.903777000,1.0467
192.67.167.86,<->,111.82.148.238,13,1349,0,0,13,1349,0.879175000,1.1164
136.25.188.178,<->,72.56.141.85,13,746,0,0,13,746,0.876220000,0.8293
195.70.56.191,<->,8.52.226.196,0,0,13,3646,13,3646,0.875477000,1.0905
136.25.188.221,<->,112.235.95.74,13,5532,0,0,13,5532,0.868237000,0.9649
215.158.239.49,<->,145.13.164.193,13,8502,0,0,13,8502,0.861463000,1.0941
196.233.50.71,<->,8.182.229.19,0,0,13,728,13,728,0.854670000,1.1003
136.25.188.237,<->,38.20.151.87,13,1853,0,0,13,1853,0.830843000,0.2858
144.85.170.208,<->,98.87.124.2,13,1377,0,0,13,1377,0.824482000,0.0491
215.158.238.106,<->,139.160.226.221,13,1853,0,0,13,1853,0.822498000,0.2265
215.158.61.189,<->,8.176.8.229,0,0,13,12782,13,12782,0.822425000,0.8052
215.158.238.148,<->,104.3.161.71,13,4295,0,0,13,4295,0.805607000,1.0455
215.158.239.51,<->,196.91.5.248,13,2092,0,0,13,2092,0.804891000,1.1105
216.184.2.185,<->,136.25.189.57,0,0,13,4343,13,4343,0.797149000,1.1015
199.38.27.249,<->,136.25.188.254,0,0,13,2243,13,2243,0.786198000,0.8879
215.158.140.75,<->,18.202.90.252,13,3879,0,0,13,3879,0.781440000,1.1871
215.158.239.92,<->,199.20.6.26,13,2249,0,0,13,2249,0.776878000,1.0216
204.226.28.18,<->,136.25.188.177,0,0,13,2261,13,2261,0.771035000,1.1272
197.113.99.226,<->,136.25.188.253,0,0,13,740,13,740,0.767486000,1.1892
136.25.188.254,<->,8.255.92.214,13,3166,0,0,13,3166,0.761682000,0.9857
136.25.188.201,<->,98.219.126.140,13,17162,0,0,13,17162,0.760966000,0.0573
220.20.200.113,<->,105.134.162.139,13,16266,0,0,13,16266,0.760030000,0.2939
204.63.11.80,<->,136.25.188.176,0,0,13,2233,13,2233,0.756345000,0.7501
195.43.207.94,<->,136.25.188.173,0,0,13,3092,13,3092,0.749038000,1.0176
215.158.239.49,<->,199.20.4.94,13,2435,0,0,13,2435,0.744988000,1.2526
215.158.239.95,<->,199.20.29.220,13,1846,0,0,13,1846,0.740974000,0.7799
142.221.197.84,<->,136.25.188.176,0,0,13,1573,13,1573,0.731356000,0.3584
243.117.93.198,<->,159.137.243.250,0,0,13,2155,13,2155,0.730067000,0.5268
215.158.239.49,<->,207.236.7.89,13,2281,0,0,13,2281,0.702976000,1.2466
111.146.224.2,<->,53.149.237.205,13,3539,0,0,13,3539,0.700999000,0.7605
197.125.126.182,<->,133.178.226.37,0,0,13,4311,13,4311,0.692521000,0.9595
142.239.121.92,<->,133.178.226.28,0,0,13,1837,13,1837,0.691244000,0.1486
146.188.225.225,<->,89.183.104.144,0,0,13,16978,13,16978,0.680476000,0.4991
199.82.178.179,<->,136.25.188.176,0,0,13,2242,13,2242,0.674779000,0.5806
215.158.239.84,<->,195.43.0.104,13,1670,0,0,13,1670,0.672124000,0.7630
144.87.238.91,<->,8.183.25.124,0,0,13,1550,13,1550,0.670385000,0.4462
218.4.182.159,<->,8.192.160.86,13,10691,0,0,13,10691,0.668325000,0.3248
207.57.191.210,<->,136.25.188.252,0,0,13,801,13,801,0.665162000,1.0743
207.58.193.117,<->,136.25.188.222,0,0,13,1350,13,1350,0.661239000,0.3415
133.178.227.27,<->,8.219.184.161,13,2037,0,0,13,2037,0.658989000,0.0605
215.158.239.48,<->,142.191.199.129,13,3573,0,0,13,3573,0.654791000,1.2185
89.204.65.12,<->,8.182.251.47,0,0,13,1422,13,1422,0.650707000,0.5782
207.60.166.80,<->,136.25.188.224,0,0,13,1765,13,1765,0.637898000,0.9877
215.158.140.231,<->,8.190.217.21,13,4788,0,0,13,4788,0.632696000,1.3656
145.252.121.82,<->,91.69.185.132,13,1026,0,0,13,1026,0.627081000,0.1025
159.223.99.61,<->,8.52.185.129,0,0,13,805,13,805,0.616324000,1.1052
136.25.188.172,<->,69.150.168.9,13,4663,0,0,13,4663,0.614182000,1.3084
138.73.24.177,<->,100.228.42.42,0,0,13,8552,13,8552,0.610225000,1.1840
218.138.21.138,<->,215.158.103.203,0,0,13,6658,13,6658,0.605752000,0.2787
215.158.239.48,<->,195.55.208.81,13,698,0,0,13,698,0.595911000,1.1540
215.158.239.49,<->,199.20.30.95,13,2226,0,0,13,2226,0.594076000,1.3594
111.20.168.123,<->,92.160.6.97,13,977,0,0,13,977,0.591984000,0.0250
201.79.210.61,<->,136.25.188.176,0,0,13,3401,13,3401,0.591335000,1.1191
204.60.234.12,<->,136.25.188.226,0,0,13,1239,13,1239,0.587197000,1.3996
204.63.3.52,<->,136.25.188.53,0,0,13,1777,13,1777,0.584430000,0.9603
215.158.238.64,<->,114.94.161.204,13,1805,0,0,13,1805,0.581722000,0.1864
215.158.238.133,<->,197.125.88.7,13,2013,0,0,13,2013,0.575828000,0.3831
215.158.239.92,<->,199.20.127.207,13,2249,0,0,13,2249,0.573906000,0.4953
199.69.87.93,<->,133.178.226.28,0,0,13,1933,13,1933,0.571478000,1.2657
143.128.180.187,<->,136.25.188.252,0,0,13,1573,13,1573,0.568837000,0.8076
199.39.15.249,<->,136.25.188.178,0,0,13,1465,13,1465,0.563107000,1.0624
215.158.140.241,<->,119.168.0.231,13,1869,0,0,13,1869,0.560552000,0.3231
136.25.188.193,<->,98.219.126.140,13,15147,0,0,13,15147,0.559375000,1.4285
215.158.238.100,<->,100.224.166.122,13,13055,0,0,13,13055,0.556626000,1.2598
231.140.52.82,<->,215.158.239.77,0,0,13,1897,13,1897,0.550862000,1.3856
215.158.238.177,<->,156.181.145.3,13,2866,0,0,13,2866,0.550197000,1.3052
204.187.33.146,<->,136.25.188.252,0,0,13,1594,13,1594,0.538299000,1.0797
215.158.239.56,<->,199.20.31.84,13,2249,0,0,13,2249,0.536579000,1.4602
111.147.193.127,<->,53.201.91.18,13,4139,0,0,13,4139,0.535177000,0.6607
215.158.239.93,<->,207.239.139.25,13,1765,0,0,13,1765,0.527687000,1.3812
215.158.238.83,<->,113.23.104.221,13,4454,0,0,13,4454,0.521831000,1.4251
97.11.170.243,<->,53.243.12.169,13,4477,0,0,13,4477,0.516865000,1.0166
133.178.226.37,<->,126.219.247.41,13,5304,0,0,13,5304,0.516455000,1.1943
215.158.239.56,<->,196.91.153.250,13,2275,0,0,13,2275,0.515066000,1.0296
197.233.125.43,<->,50.224.80.64,0,0,13,2962,13,2962,0.513489000,1.4670
136.25.188.221,<->,131.144.113.188,13,4567,0,0,13,4567,0.502180000,1.4262
231.44.187.208,<->,192.64.198.194,0,0,13,1807,13,1807,0.502067000,0.9684
136.177.72.3,<->,92.162.253.154,0,0,13,4091,13,4091,0.499122000,1.1953
215.158.238.70,<->,111.151.106.200,13,728,0,0,13,728,0.492259000,0.0356
215.158.238.177,<->,8.57.163.138,13,2189,0,0,13,2189,0.489639000,1.2652
215.158.140.60,<->,148.190.126.44,13,2778,0,0,13,2778,0.487266000,1.4743
215.158.238.148,<->,106.188.183.87,13,3790,0,0,13,3790,0.481976000,1.3032
136.25.188.224,<->,32.183.36.249,13,5660,0,0,13,5660,0.476678000,1.4826
143.129.192.211,<->,136.25.188.176,0,0,13,1843,13,1843,0.476228000,0.7459
136.25.189.27,<->,96.156.169.199,13,9265,0,0,13,9265,0.473082000,1.1032
215.158.140.204,<->,8.222.7.162,13,3322,0,0,13,3322,0.468719000,1.4935
202.33.106.132,<->,136.25.188.252,0,0,13,2158,13,2158,0.465933000,0.9561
133.178.227.253,<->,126.219.54.44,13,2337,0,0,13,2337,0.465188000,0.8294
215.201.235.99,<->,144.85.170.254,0,0,13,1497,13,1497,0.465031000,0.3258
133.178.226.31,<->,126.219.247.8,13,4487,0,0,13,4487,0.464633000,0.5530
215.158.238.114,<->,104.154.137.220,13,3442,0,0,13,3442,0.464533000,0.9362
133.178.226.28,<->,131.1.195.250,13,4877,0,0,13,4877,0.458203000,1.3151
120.83.30.208,<->,101.70.116.99,0,0,13,2116,13,2116,0.457257000,0.9396
136.25.188.172,<->,131.1.253.227,13,3250,0,0,13,3250,0.449075000,1.3160
133.178.227.252,<->,56.12.208.227,13,728,0,0,13,728,0.448834000,0.0107
215.158.140.231,<->,29.211.6.200,13,3040,0,0,13,3040,0.448146000,1.3407
215.158.238.133,<->,8.191.0.72,13,1853,0,0,13,1853,0.442016000,0.1114
50.53.79.13,<->,8.52.178.59,0,0,13,1263,13,1263,0.433241000,1.2858
220.83.56.195,<->,8.45.162.111,13,12280,0,0,13,12280,0.428097000,0.0667
215.158.239.35,<->,29.211.5.208,13,5485,0,0,13,5485,0.427981000,0.9530
142.223.114.231,<->,136.25.188.54,0,0,13,1576,13,1576,0.423284000,0.7505
213.155.190.34,<->,50.224.88.92,0,0,13,728,13,728,0.422298000,1.0260
199.69.141.133,<->,136.25.188.176,0,0,13,1624,13,1624,0.419683000,0.7790
136.25.188.226,<->,65.27.228.213,13,4391,0,0,13,4391,0.418431000,1.3318
203.114.93.245,<->,136.25.188.174,0,0,13,1677,13,1677,0.417906000,1.1689
136.25.188.209,<->,56.9.75.29,13,2269,0,0,13,2269,0.416910000,0.3633
156.165.37.73,<->,136.25.189.59,0,0,13,3206,13,3206,0.416104000,1.3011
147.47.194.21,<->,8.252.221.197,0,0,13,650,13,650,0.403194000,1.5121
192.67.186.56,<->,127.84.46.105,13,771,0,0,13,771,0.402426000,0.7159
136.25.189.12,<->,96.156.169.170,13,6316,0,0,13,6316,0.402057000,1.4830
215.158.238.134,<->,56.161.218.41,13,5724,0,0,13,5724,0.401002000,1.3491
215.158.238.56,<->,113.23.7.38,13,2125,0,0,13,2125,0.390922000,0.1458
215.158.239.51,<->,199.20.4.184,13,2253,0,0,13,2253,0.389061000,0.8357
139.163.16.217,<->,111.148.10.188,13,728,0,0,13,728,0.388342000,1.5469
215.158.238.141,<->,131.144.113.192,13,5676,0,0,13,5676,0.388210000,1.5829
136.25.188.52,<->,64.108.32.174,13,1081,0,0,13,1081,0.387570000,1.0520
218.4.168.98,<->,121.211.58.14,13,17692,0,0,13,17692,0.387532000,1.0199
215.158.239.56,<->,199.20.31.127,13,2228,0,0,13,2228,0.387507000,1.2446
136.25.189.2,<->,96.156.169.234,13,6476,0,0,13,6476,0.387419000,1.4361
133.178.227.2,<->,61.35.124.214,13,2816,0,0,13,2816,0.385693000,1.5286
215.158.61.195,<->,8.176.8.188,0,0,13,15522,13,15522,0.384223000,1.4552
229.45.129.61,<->,129.19.188.26,13,13179,0,0,13,13179,0.383185000,0.5191
204.3.154.98,<->,136.25.188.177,0,0,13,2258,13,2258,0.382996000,0.8572
145.7.22.134,<->,100.228.42.103,0,0,13,5032,13,5032,0.377491000,1.4159
133.178.227.16,<->,29.214.211.23,13,1707,0,0,13,1707,0.371170000,0.1633
215.158.238.148,<->,131.144.113.193,13,3186,0,0,13,3186,0.370421000,1.1171
245.150.122.254,<->,8.182.241.177,0,0,13,2688,13,2688,0.359438000,0.7626
143.132.194.76,<->,136.25.188.175,0,0,13,656,13,656,0.357609000,0.2613
215.158.238.47,<->,111.150.186.204,13,4615,0,0,13,4615,0.353689000,1.6287
136.25.188.237,<->,104.154.137.213,13,4455,0,0,13,4455,0.353546000,1.5606
92.27.219.217,<->,38.84.57.194,13,15440,0,0,13,15440,0.353117000,1.6318
91.100.190.130,<->,50.224.88.92,0,0,13,728,13,728,0.345983000,1.6099
215.158.238.66,<->,131.1.195.221,13,4901,0,0,13,4901,0.344550000,1.4151
215.158.238.67,<->,112.220.206.107,13,2057,0,0,13,2057,0.340705000,1.3648
136.25.188.161,<->,104.3.163.54,13,4599,0,0,13,4599,0.340005000,1.4991
133.178.226.28,<->,120.154.177.212,13,1741,0,0,13,1741,0.335705000,0.1322
136.25.188.176,<->,84.14.253.204,13,2241,0,0,13,2241,0.332648000,0.7956
222.68.66.166,<->,132.216.20.84,13,4702,0,0,13,4702,0.331240000,0.8860
196.89.49.194,<->,136.25.188.254,0,0,13,1763,13,1763,0.329872000,1.0735
58.169.41.162,<->,0.195.210.33,0,0,13,650,13,650,0.326160000,1.5703
215.158.239.192,<->,145.116.223.80,13,17538,0,0,13,17538,0.325494000,0.7749
195.14.99.97,<->,136.25.188.222,0,0,13,728,13,728,0.321302000,0.1536
215.158.238.123,<->,136.139.59.105,13,1693,0,0,13,1693,0.320749000,0.4651
102.91.241.73,<->,50.224.82.18,0,0,13,728,13,728,0.320022000,1.5438
136.25.188.198,<->,131.1.195.233,13,6193,0,0,13,6193,0.319350000,1.5899
215.158.239.84,<->,207.188.4.192,13,2271,0,0,13,2271,0.317278000,1.3996
199.72.38.107,<->,136.25.188.177,0,0,13,728,13,728,0.314289000,1.6471
215.158.238.104,<->,27.178.41.58,13,3202,0,0,13,3202,0.310226000,1.4661
215.158.238.133,<->,136.139.59.124,13,2227,0,0,13,2227,0.309785000,1.1574
215.158.140.76,<->,33.209.217.27,13,2060,0,0,13,2060,0.309319000,0.6302
212.70.217.70,<->,133.178.226.28,0,0,13,4183,13,4183,0.306520000,1.4617
215.158.239.95,<->,196.93.205.113,13,1357,0,0,13,1357,0.303000000,0.5298
215.158.239.84,<->,196.94.9.24,13,728,0,0,13,728,0.299800000,0.3400
210.222.223.220,<->,136.25.188.38,0,0,13,10051,13,10051,0.296414000,0.8882
136.25.189.32,<->,56.161.218.54,13,8310,0,0,13,8310,0.295922000,1.6558
133.178.227.1,<->,122.159.123.19,13,3052,0,0,13,3052,0.295377000,1.5730
215.158.140.229,<->,131.144.114.235,13,3918,0,0,13,3918,0.292576000,0.8754
133.178.226.29,<->,131.144.114.208,13,3042,0,0,13,3042,0.292533000,1.3181
195.13.254.86,<->,136.25.188.53,0,0,13,1408,13,1408,0.291247000,1.2565
136.25.188.222,<->,95.90.177.91,13,1800,0,0,13,1800,0.286181000,1.4355
215.158.238.67,<->,120.154.221.218,13,1869,0,0,13,1869,0.286012000,1.5013
136.25.189.0,<->,133.56.180.24,13,5413,0,0,13,5413,0.282538000,1.6457
116.178.189.227,<->,92.27.219.169,0,0,13,18148,13,18148,0.282435000,1.6055
143.13.43.123,<->,136.25.188.160,0,0,13,656,13,656,0.281383000,1.6394
215.158.238.75,<->,8.179.43.65,13,4503,0,0,13,4503,0.280711000,1.6541
215.158.239.18,<->,8.241.236.231,13,5291,0,0,13,5291,0.278393000,1.5057
215.158.239.76,<->,142.166.122.161,13,1928,0,0,13,1928,0.277996000,1.0721
221.102.143.189,<->,129.1.112.208,0,0,13,10314,13,10314,0.276794000,0.6682
136.25.188.227,<->,8.255.92.246,13,4631,0,0,13,4631,0.276536000,1.4100
227.56.253.56,<->,220.20.200.66,0,0,13,16361,13,16361,0.276099000,0.4056
215.158.239.94,<->,195.70.128.189,13,1419,0,0,13,1419,0.273862000,0.8843
196.206.210.12,<->,136.25.188.178,0,0,13,1566,13,1566,0.273636000,1.1501
89.183.104.252,<->,33.57.79.43,13,9328,0,0,13,9328,0.270361000,1.6904
136.25.188.208,<->,131.1.195.250,13,4738,0,0,13,4738,0.270307000,0.9404
197.7.105.185,<->,8.183.25.25,0,0,13,1437,13,1437,0.267978000,0.7968
215.158.239.56,<->,196.109.216.251,13,2250,0,0,13,2250,0.267908000,0.6894
92.26.156.28,<->,14.71.95.20,0,0,13,3810,13,3810,0.267491000,1.4756
223.122.173.123,<->,0.195.210.46,0,0,13,2221,13,2221,0.264417000,0.8373
215.158.238.92,<->,126.219.196.180,13,2978,0,0,13,2978,0.258537000,1.3345
215.158.239.87,<->,199.20.31.0,13,1163,0,0,13,1163,0.251337000,1.1199
215.158.239.93,<->,196.111.90.208,13,2708,0,0,13,2708,0.250780000,0.5991
136.25.188.229,<->,100.224.166.146,13,13981,0,0,13,13981,0.250530000,0.9574
99.226.167.241,<->,50.224.49.195,0,0,13,788,13,788,0.246640000,1.6629
207.59.44.200,<->,136.25.188.174,0,0,13,1313,13,1313,0.245246000,1.0329
133.178.226.43,<->,8.222.48.187,13,18044,0,0,13,18044,0.240302000,0.0005
215.158.238.196,<->,113.23.101.139,13,2759,0,0,13,2759,0.239332000,0.6996
143.20.121.150,<->,133.178.226.30,0,0,13,4455,13,4455,0.238317000,1.2332
195.55.188.47,<->,136.25.188.46,0,0,13,7884,13,7884,0.238124000,1.5572
215.158.239.50,<->,199.20.28.111,13,2243,0,0,13,2243,0.236979000,0.6705
215.158.239.95,<->,196.1.8.118,13,2430,0,0,13,2430,0.236261000,0.4198
199.70.97.127,<->,136.25.188.162,0,0,13,1624,13,1624,0.233103000,0.9554
139.163.7.204,<->,130.18.163.63,13,1450,0,0,13,1450,0.232925000,1.7655
215.158.239.35,<->,96.135.154.110,13,8157,0,0,13,8157,0.231166000,1.5792
224.250.117.119,<->,100.228.42.204,0,0,13,1711,13,1711,0.228842000,0.5666
207.178.101.90,<->,50.223.3.228,0,0,13,704,13,704,0.225758000,1.6737
69.103.135.5,<->,8.252.221.222,0,0,13,1196,13,1196,0.225169000,1.3280
215.158.238.45,<->,143.155.227.54,13,4398,0,0,13,4398,0.224861000,1.0309
247.136.253.142,<->,221.102.143.189,13,10420,0,0,13,10420,0.221403000,0.3480
195.70.196.238,<->,136.25.188.163,0,0,13,1437,13,1437,0.219463000,0.4909
136.25.189.11,<->,56.28.207.205,13,9073,0,0,13,9073,0.218496000,1.5460
204.142.129.112,<->,92.27.219.221,0,0,13,728,13,728,0.216280000,1.7481
215.158.239.5,<->,8.255.92.134,13,3693,0,0,13,3693,0.214443000,1.3129
207.57.129.16,<->,136.25.188.55,0,0,13,2310,13,2310,0.208915000,0.9240
131.178.248.254,<->,80.40.4.150,0,0,13,15552,13,15552,0.208894000,1.2446
215.158.238.75,<->,122.159.245.162,13,4599,0,0,13,4599,0.205857000,1.5086
136.25.188.220,<->,111.151.70.41,13,4419,0,0,13,4419,0.205693000,1.6600
215.158.239.101,<->,129.222.36.37,13,8572,0,0,13,8572,0.205407000,0.8369
98.67.158.232,<->,53.196.74.85,13,17029,0,0,13,17029,0.204834000,0.9552
215.158.239.4,<->,215.158.127.169,13,7393,0,0,13,7393,0.202952000,0.8545
220.55.175.209,<->,98.102.221.116,13,936,0,0,13,936,0.202574000,1.7520
224.93.235.36,<->,80.27.157.15,0,0,13,5260,13,5260,0.201886000,1.5761
199.6.14.174,<->,50.223.3.228,0,0,13,650,13,650,0.201028000,1.6322
195.70.149.228,<->,136.25.188.178,0,0,13,773,13,773,0.200195000,0.0138
69.128.73.245,<->,53.160.1.15,13,16664,0,0,13,16664,0.199402000,1.5721
215.158.238.66,<->,112.235.116.38,13,3218,0,0,13,3218,0.199054000,0.8076
215.158.238.96,<->,57.97.102.151,13,728,0,0,13,728,0.197939000,0.1238
136.25.189.34,<->,56.28.207.201,13,4963,0,0,13,4963,0.195830000,1.0031
133.178.227.247,<->,8.61.93.38,13,4802,0,0,13,4802,0.195625000,1.6173
215.158.239.79,<->,199.20.31.225,13,1078,0,0,13,1078,0.194534000,0.4100
17.249.7.237,<->,8.53.2.20,0,0,13,1352,13,1352,0.194513000,1.7671
207.60.87.201,<->,136.25.188.243,0,0,13,1284,13,1284,0.191060000,1.5692
97.126.14.75,<->,53.154.203.180,13,17090,0,0,13,17090,0.187990000,0.9973
149.250.115.13,<->,136.25.188.252,0,0,13,4263,13,4263,0.187811000,0.9143
195.71.143.115,<->,136.25.188.44,0,0,13,1615,13,1615,0.187706000,0.2307
136.25.188.55,<->,29.214.108.158,13,5404,0,0,13,5404,0.184319000,1.2057
207.58.70.100,<->,136.25.188.253,0,0,13,848,13,848,0.182419000,0.0244
247.136.131.134,<->,144.91.199.50,13,8722,0,0,13,8722,0.179593000,1.6496
215.158.239.94,<->,195.14.206.212,13,2227,0,0,13,2227,0.179313000,0.7187
136.25.189.32,<->,120.154.71.20,13,4359,0,0,13,4359,0.178891000,1.7318
215.158.239.96,<->,196.90.43.112,13,728,0,0,13,728,0.178805000,1.0800
136.25.189.59,<->,8.249.253.235,13,5484,0,0,13,5484,0.178501000,1.6329
136.25.188.178,<->,60.111.50.162,13,882,0,0,13,882,0.173956000,1.8214
125.24.121.131,<->,80.40.41.27,0,0,13,809,13,809,0.172836000,1.6697
215.158.140.76,<->,8.222.213.8,13,5857,0,0,13,5857,0.172310000,1.7115
139.163.7.204,<->,33.241.5.24,13,1047,0,0,13,1047,0.172134000,0.7925
215.158.238.118,<->,100.224.166.115,13,17864,0,0,13,17864,0.171941000,0.8652
203.117.191.81,<->,0.195.210.42,0,0,13,728,13,728,0.171273000,0.6501
200.10.209.215,<->,8.252.221.222,0,0,13,840,13,840,0.170314000,1.5669
215.158.239.35,<->,8.191.6.109,13,6880,0,0,13,6880,0.168350000,1.6125
215.158.239.95,<->,80.56.79.48,13,6833,0,0,13,6833,0.167071000,1.7356
136.25.188.160,<->,69.150.169.185,13,3330,0,0,13,3330,0.166389000,0.8034
136.25.188.211,<->,8.188.227.37,13,3150,0,0,13,3150,0.164615000,1.5974
215.158.239.79,<->,195.7.20.231,13,2292,0,0,13,2292,0.163833000,1.6340
199.68.238.123,<->,136.25.188.237,0,0,13,1861,13,1861,0.161750000,1.0129
152.11.225.23,<->,92.27.27.143,0,0,13,718,13,718,0.160645000,1.8170
142.234.196.229,<->,133.178.226.19,0,0,13,5900,13,5900,0.159950000,1.6968
221.102.113.220,<->,207.193.113.191,13,1548,0,0,13,1548,0.154872000,0.7015
136.25.189.1,<->,29.212.198.167,13,7814,0,0,13,7814,0.152023000,1.8170
133.178.227.16,<->,113.23.14.231,13,3866,0,0,13,3866,0.151965000,1.7534
69.243.74.39,<->,8.252.221.236,0,0,13,3839,13,3839,0.151033000,1.7902
215.158.239.51,<->,199.20.31.59,13,728,0,0,13,728,0.150211000,0.3590
133.178.226.31,<->,119.196.23.21,13,4167,0,0,13,4167,0.147825000,0.6171
143.129.198.157,<->,136.25.188.176,0,0,13,2467,13,2467,0.147569000,0.7080
215.158.238.83,<->,131.1.253.245,13,3346,0,0,13,3346,0.147132000,1.7703
109.222.207.76,<->,53.244.1.230,13,5049,0,0,13,5049,0.147127000,0.1924
215.158.239.95,<->,207.60.52.190,13,1449,0,0,13,1449,0.145467000,1.0033
204.56.105.249,<->,136.25.188.236,0,0,13,1334,13,1334,0.142645000,0.7323
139.8.186.147,<->,133.178.227.2,0,0,13,3915,13,3915,0.141909000,1.2419
240.208.49.128,<->,0.195.210.42,0,0,13,806,13,806,0.141901000,1.0389
215.158.6.220,<->,133.178.227.24,0,0,13,6180,13,6180,0.141061000,1.8360
215.158.238.148,<->,131.144.114.231,13,5596,0,0,13,5596,0.139058000,1.5727
195.126.60.183,<->,136.25.188.54,0,0,13,2249,13,2249,0.134142000,0.6729
215.158.239.49,<->,199.20.5.79,13,728,0,0,13,728,0.133067000,1.0289
91.69.185.175,<->,50.224.61.156,0,0,13,728,13,728,0.132412000,1.7587
215.158.238.250,<->,106.188.252.231,13,4820,0,0,13,4820,0.131263000,1.7456
133.178.226.31,<->,131.144.113.171,13,5404,0,0,13,5404,0.131189000,1.8064
98.236.235.232,<->,86.76.182.144,13,728,0,0,13,728,0.130506000,1.7208
95.246.170.215,<->,8.252.221.206,0,0,13,700,13,700,0.129852000,1.8374
245.158.27.7,<->,8.252.222.208,0,0,13,741,13,741,0.128509000,1.6271
159.137.169.60,<->,99.154.240.215,13,728,0,0,13,728,0.125482000,1.7638
215.158.238.223,<->,120.154.179.31,13,1901,0,0,13,1901,0.123901000,0.7720
215.158.238.133,<->,131.1.232.134,13,3170,0,0,13,3170,0.122807000,0.7597
195.5.209.52,<->,136.25.188.178,0,0,13,1799,13,1799,0.121439000,0.6066
195.40.28.13,<->,136.25.188.226,0,0,13,1766,13,1766,0.121002000,0.8536
136.25.188.223,<->,91.247.40.2,13,4450,0,0,13,4450,0.120336000,1.0041
215.158.127.200,<->,8.252.223.131,0,0,13,2061,13,2061,0.119024000,0.1216
215.158.238.94,<->,139.160.226.220,13,1869,0,0,13,1869,0.117652000,1.8550
139.8.186.160,<->,133.178.227.14,0,0,13,4869,13,4869,0.116893000,1.4895
204.200.36.112,<->,136.25.188.220,0,0,13,904,13,904,0.116640000,1.8792
215.158.239.7,<->,158.166.175.232,13,5283,0,0,13,5283,0.115475000,1.7479
199.71.208.67,<->,136.25.188.198,0,0,13,773,13,773,0.114168000,0.1297
204.2.108.115,<->,136.25.188.242,0,0,13,1832,13,1832,0.112996000,0.9830
199.71.56.109,<->,136.25.188.44,0,0,13,2201,13,2201,0.110775000,1.0350
97.149.24.218,<->,53.231.73.170,13,11230,0,0,13,11230,0.110214000,1.0793
91.250.161.24,<->,0.195.210.33,0,0,13,728,13,728,0.109180000,1.7660
136.25.188.177,<->,57.160.181.214,13,6152,0,0,13,6152,0.108420000,1.8321
82.180.135.152,<->,50.224.49.195,0,0,13,728,13,728,0.107302000,1.6524
195.124.138.246,<->,136.25.188.199,0,0,13,764,13,764,0.106968000,1.3792
133.178.226.38,<->,65.27.220.217,13,3386,0,0,13,3386,0.106385000,1.7715
204.187.137.207,<->,136.25.188.255,0,0,13,821,13,821,0.104555000,1.8599
207.172.102.178,<->,136.25.188.173,0,0,13,818,13,818,0.100670000,0.7805
210.157.109.19,<->,139.163.111.125,0,0,13,650,13,650,0.100215000,1.7240
142.166.114.214,<->,136.25.188.236,0,0,13,857,13,857,0.099302000,0.5570
136.25.188.202,<->,80.57.141.142,13,7843,0,0,13,7843,0.097866000,0.1447
207.59.191.133,<->,136.25.188.252,0,0,13,728,13,728,0.096490000,0.3260
136.25.188.175,<->,27.178.41.27,13,4435,0,0,13,4435,0.096420000,1.8166
104.139.44.208,<->,100.92.65.165,0,0,13,676,13,676,0.095045000,1.4171
133.178.227.16,<->,106.188.252.213,13,1791,0,0,13,1791,0.093339000,1.6352
232.31.30.241,<->,100.94.156.86,0,0,13,12754,13,12754,0.089088000,1.8740
215.158.61.189,<->,8.176.8.210,0,0,13,5537,13,5537,0.088897000,1.8920
215.158.238.196,<->,8.222.58.187,13,2795,0,0,13,2795,0.088488000,1.2384
204.47.29.236,<->,50.223.3.228,0,0,13,650,13,650,0.088139000,1.5296
113.198.122.159,<->,92.27.27.146,0,0,13,18148,13,18148,0.087441000,1.0189
133.178.227.52,<->,133.56.180.53,13,6578,0,0,13,6578,0.086780000,1.8782
220.39.233.203,<->,215.158.238.33,0,0,13,4455,13,4455,0.086339000,1.0158
111.20.172.70,<->,33.233.141.101,0,0,13,1890,13,1890,0.082950000,1.0135
136.25.189.16,<->,29.211.93.22,13,6945,0,0,13,6945,0.082424000,1.8736
144.85.170.244,<->,89.25.123.255,13,728,0,0,13,728,0.080283000,1.7403
136.25.188.224,<->,69.150.169.151,13,4455,0,0,13,4455,0.077887000,1.6138
136.25.188.211,<->,8.222.212.22,13,4279,0,0,13,4279,0.077534000,1.2750
215.158.239.78,<->,199.20.28.17,13,1695,0,0,13,1695,0.076769000,0.6000
82.162.132.166,<->,8.220.200.250,0,0,13,832,13,832,0.075399000,1.2498
215.158.238.80,<->,8.42.43.88,13,5916,0,0,13,5916,0.075141000,1.9098
215.158.239.79,<->,118.20.100.147,13,6833,0,0,13,6833,0.074836000,1.8425
215.158.239.49,<->,199.50.8.237,13,1962,0,0,13,1962,0.071655000,1.8519
215.158.239.86,<->,199.51.240.0,13,1330,0,0,13,1330,0.071229000,0.2620
136.25.189.33,<->,29.212.180.213,13,5752,0,0,13,5752,0.070226000,1.3431
192.88.60.18,<->,139.163.27.110,0,0,13,728,13,728,0.070201000,1.8347
220.18.254.59,<->,99.167.136.236,0,0,13,16797,13,16797,0.068582000,0.0620
136.25.189.78,<->,96.156.169.255,13,4759,0,0,13,4759,0.068318000,1.0658
94.194.105.141,<->,8.252.221.230,0,0,13,1510,13,1510,0.068279000,1.8856
138.98.233.218,<->,91.100.187.228,13,728,0,0,13,728,0.068186000,1.7102
204.3.186.162,<->,136.25.188.253,0,0,13,1508,13,1508,0.067962000,1.4692
207.61.79.245,<->,136.25.188.220,0,0,13,650,13,650,0.065677000,0.6279
207.236.79.134,<->,136.25.188.255,0,0,13,1779,13,1779,0.063737000,1.8461
215.158.140.83,<->,192.226.161.39,13,4814,0,0,13,4814,0.063271000,1.8826
192.226.161.60,<->,136.25.188.160,0,0,13,3698,13,3698,0.062283000,1.8166
215.158.239.6,<->,126.219.102.169,13,5024,0,0,13,5024,0.061689000,1.6953
136.25.189.2,<->,106.188.253.129,13,4535,0,0,13,4535,0.061577000,1.4625
205.254.139.169,<->,109.1.35.93,0,0,13,1240,13,1240,0.060612000,1.8872
136.25.189.23,<->,96.156.169.178,13,16135,0,0,13,16135,0.059949000,0.8311
215.158.238.67,<->,65.27.228.202,13,4375,0,0,13,4375,0.059797000,1.4551
215.158.239.50,<->,204.226.86.122,13,752,0,0,13,752,0.059303000,0.6852
215.158.238.133,<->,122.159.245.162,13,7990,0,0,13,7990,0.058629000,1.8835
215.158.239.96,<->,199.20.29.122,13,1954,0,0,13,1954,0.056777000,1.3399
133.178.227.27,<->,8.221.197.108,13,3740,0,0,13,3740,0.054821000,1.8569
92.27.27.145,<->,48.109.16.112,13,15724,0,0,13,15724,0.052430000,0.9103
136.25.189.29,<->,113.92.151.25,13,7413,0,0,13,7413,0.051030000,1.9066
204.142.20.223,<->,50.223.3.228,0,0,13,650,13,650,0.050034000,1.8242
215.158.239.96,<->,199.20.30.204,13,2261,0,0,13,2261,0.049364000,0.6692
97.198.98.222,<->,91.69.185.130,13,728,0,0,13,728,0.048258000,1.9411
122.222.237.212,<->,92.27.219.32,0,0,13,16969,13,16969,0.047837000,1.3892
136.25.188.211,<->,131.144.114.229,13,6737,0,0,13,6737,0.047760000,1.5183
136.25.189.21,<->,96.156.169.225,13,10966,0,0,13,10966,0.047141000,1.5918
136.25.189.16,<->,29.213.219.69,13,6074,0,0,13,6074,0.045488000,1.8963
215.158.140.144,<->,8.222.7.161,13,728,0,0,13,728,0.045022000,1.8193
133.178.226.77,<->,122.159.245.149,13,4503,0,0,13,4503,0.044532000,1.9437
215.158.239.76,<->,204.61.202.136,13,1619,0,0,13,1619,0.042818000,1.7693
215.158.238.149,<->,69.31.238.54,13,3170,0,0,13,3170,0.042211000,1.1615
215.158.238.33,<->,156.181.149.249,13,1965,0,0,13,1965,0.040993000,1.7042
109.50.149.126,<->,8.183.25.124,0,0,13,954,13,954,0.040914000,0.3650
215.158.238.221,<->,29.214.109.128,13,4031,0,0,13,4031,0.040788000,1.4480
136.25.189.90,<->,96.156.169.253,13,6156,0,0,13,6156,0.039687000,1.9367
215.158.239.76,<->,8.255.92.166,13,6220,0,0,13,6220,0.035868000,1.8508
215.158.238.135,<->,57.210.107.27,13,5884,0,0,13,5884,0.035141000,1.7542
136.25.188.199,<->,8.222.212.23,13,4471,0,0,13,4471,0.035101000,1.5474
8.182.251.151,<->,6.133.203.187,13,1086,0,0,13,1086,0.034821000,0.7211
215.158.238.113,<->,80.47.111.107,13,3090,0,0,13,3090,0.033069000,1.8596
215.158.239.58,<->,199.20.4.48,13,728,0,0,13,728,0.032927000,0.3508
202.124.175.48,<->,8.252.222.199,0,0,13,1219,13,1219,0.032162000,1.7694
253.103.78.162,<->,215.158.238.99,0,0,13,3170,13,3170,0.031840000,1.0486
136.25.189.0,<->,133.224.119.43,13,8534,0,0,13,8534,0.031121000,0.9070
215.158.238.95,<->,111.150.186.233,13,6961,0,0,13,6961,0.029627000,1.8463
215.158.238.132,<->,131.1.195.223,13,4679,0,0,13,4679,0.028920000,1.9672
133.178.227.76,<->,113.23.117.46,13,3912,0,0,13,3912,0.028835000,1.4718
91.69.181.145,<->,50.224.61.156,0,0,13,728,13,728,0.026977000,1.9087
139.241.56.105,<->,100.94.59.215,0,0,13,18926,13,18926,0.026797000,1.9260
220.20.200.128,<->,121.105.194.190,13,13674,0,0,13,13674,0.026402000,0.4440
215.158.238.134,<->,131.144.113.163,13,3186,0,0,13,3186,0.026207000,1.3422
136.25.189.15,<->,29.214.109.128,13,5420,0,0,13,5420,0.025174000,1.4172
221.102.98.9,<->,100.239.17.130,13,1221,0,0,13,1221,0.025155000,1.3101
195.54.100.230,<->,136.25.188.241,0,0,13,845,13,845,0.024678000,1.7195
215.158.140.229,<->,8.219.185.59,13,3362,0,0,13,3362,0.024463000,1.6233
215.158.239.224,<->,192.226.44.84,13,4753,0,0,13,4753,0.023610000,1.0075
149.57.173.231,<->,139.163.96.101,0,0,13,1952,13,1952,0.022709000,1.8756
98.236.235.234,<->,46.37.220.19,13,728,0,0,13,728,0.022250000,1.9440
199.38.246.54,<->,136.25.188.160,0,0,13,884,13,884,0.022006000,1.5814
215.158.238.148,<->,149.250.115.40,13,5476,0,0,13,5476,0.020439000,1.8069
139.163.27.106,<->,110.221.17.148,13,728,0,0,13,728,0.020377000,1.8840
215.158.239.51,<->,142.252.139.96,13,1724,0,0,13,1724,0.019685000,0.7232
144.64.138.63,<->,107.250.233.36,13,4000,0,0,13,4000,0.018576000,0.9807
215.158.238.75,<->,131.2.115.231,13,4583,0,0,13,4583,0.016512000,1.6150
136.25.189.33,<->,29.214.108.255,13,7281,0,0,13,7281,0.016453000,1.9208
235.42.34.53,<->,136.25.188.237,0,0,13,3266,13,3266,0.015199000,0.2258
159.137.138.253,<->,27.154.128.2,13,728,0,0,13,728,0.014666000,1.8001
144.70.14.36,<->,116.100.98.32,13,1370,0,0,13,1370,0.014660000,1.4025
195.70.227.210,<->,136.25.188.163,0,0,13,728,13,728,0.014422000,0.1335
133.178.227.76,<->,8.191.7.233,13,5817,0,0,13,5817,0.014293000,1.0665
205.243.108.184,<->,89.183.107.67,0,0,13,1619,13,1619,0.014288000,1.5610
215.158.239.56,<->,204.58.43.207,13,1350,0,0,13,1350,0.013567000,0.6752
195.40.159.157,<->,136.25.188.225,0,0,13,650,13,650,0.013334000,0.2212
195.41.238.252,<->,136.25.188.241,0,0,13,2146,13,2146,0.013135000,0.8031
97.53.116.162,<->,8.182.136.20,0,0,13,722,13,722,0.012485000,0.1122
215.158.239.79,<->,196.93.102.242,13,728,0,0,13,728,0.010850000,0.2000
207.231.207.141,<->,8.252.222.225,0,0,13,728,13,728,0.010782000,1.9250
132.249.70.233,<->,53.201.149.31,13,1131,0,0,13,1131,0.010478000,1.7934
194.237.63.180,<->,136.25.188.252,0,0,13,1460,13,1460,0.008868000,1.0841
215.158.238.67,<->,112.220.206.22,13,2409,0,0,13,2409,0.008501000,1.3302
136.25.188.174,<->,41.166.167.52,13,1622,0,0,13,1622,0.008021000,0.0417
215.158.238.135,<->,8.241.236.25,13,2191,0,0,13,2191,0.007478000,0.4869
215.158.61.203,<->,136.25.189.243,0,0,13,9804,13,9804,0.007058000,1.5467
215.158.239.76,<->,196.109.90.218,13,728,0,0,13,728,0.006910000,0.5163
215.158.239.68,<->,199.20.28.12,13,728,0,0,13,728,0.005559000,0.0698
136.25.189.78,<->,80.56.79.87,13,6048,0,0,13,6048,0.004639000,1.8658
212.70.217.75,<->,133.178.226.18,0,0,13,2029,13,2029,0.004323000,0.0407
204.130.120.232,<->,8.252.222.61,0,0,13,1755,13,1755,0.002418000,0.4180
215.158.238.190,<->,8.252.253.226,13,3876,0,0,13,3876,0.002109000,1.3760
215.158.239.69,<->,195.49.133.217,13,2338,0,0,13,2338,0.001906000,0.8491
220.60.81.139,<->,136.25.189.57,0,0,13,6721,13,6721,0.001575000,1.0060
215.158.239.49,<->,118.20.100.135,13,6865,0,0,13,6865,0.001291000,1.5830
215.158.239.70,<->,199.20.4.230,13,1771,0,0,13,1771,0.000320000,0.9699
215.158.239.29,<->,122.158.246.174,13,7498,0,0,13,7498,0.000195000,1.7161
215.158.33.106,<->,8.252.223.89,0,0,12,16434,12,16434,1.890915000,0.0055
131.2.59.100,<->,92.162.252.133,0,0,12,15146,12,15146,1.867696000,0.1134
17.124.213.2,<->,8.52.148.157,0,0,12,1942,12,1942,1.847085000,0.1160
133.178.227.24,<->,8.190.217.102,12,2021,0,0,12,2021,1.837166000,0.0481
136.25.188.58,<->,133.56.180.203,12,14338,0,0,12,14338,1.809652000,0.1616
97.193.137.173,<->,50.224.91.83,0,0,12,672,12,672,1.793703000,0.1409
133.178.226.57,<->,0.195.237.14,12,16603,0,0,12,16603,1.788534000,0.0000
193.81.55.4,<->,92.162.253.40,0,0,12,13703,12,13703,1.785170000,0.1169
215.158.239.35,<->,120.155.14.152,12,1936,0,0,12,1936,1.765041000,0.2140
192.74.94.26,<->,8.182.245.240,0,0,12,1052,12,1052,1.764399000,0.1499
220.81.2.23,<->,115.151.119.78,12,15146,0,0,12,15146,1.739931000,0.2261
92.181.45.37,<->,8.204.53.229,12,1410,0,0,12,1410,1.727792000,0.1889
199.50.209.48,<->,136.25.188.53,0,0,12,717,12,717,1.712966000,0.0221
229.45.58.205,<->,224.76.13.221,12,13039,0,0,12,13039,1.683596000,0.2469
56.8.55.61,<->,8.183.25.25,0,0,12,1335,12,1335,1.647150000,0.2981
210.220.219.181,<->,91.42.219.84,12,4769,0,0,12,4769,1.646124000,0.3100
94.192.19.253,<->,8.252.221.199,0,0,12,1046,12,1046,1.641826000,0.3312
220.39.233.120,<->,215.158.238.45,0,0,12,1637,12,1637,1.621661000,0.1562
215.201.227.68,<->,8.182.229.180,0,0,12,1018,12,1018,1.612679000,0.1688
129.224.112.252,<->,97.242.126.196,12,786,0,0,12,786,1.595933000,0.3395
17.61.4.176,<->,8.52.177.123,0,0,12,982,12,982,1.587934000,0.1118
109.119.182.234,<->,8.182.235.52,0,0,12,787,12,787,1.571215000,0.0670
136.25.189.83,<->,125.84.55.12,12,1989,0,0,12,1989,1.570537000,0.1910
98.156.225.133,<->,8.182.226.78,0,0,12,1242,12,1242,1.559490000,0.3596
159.219.44.30,<->,50.224.102.157,0,0,12,680,12,680,1.533274000,0.1067
221.196.123.25,<->,136.25.188.226,0,0,12,961,12,961,1.513849000,0.2777
246.253.168.245,<->,149.45.186.44,12,3298,0,0,12,3298,1.501220000,0.3350
215.158.140.241,<->,159.137.139.2,12,5038,0,0,12,5038,1.496077000,0.4693
136.25.188.174,<->,100.228.244.4,12,1183,0,0,12,1183,1.488996000,0.3781
17.46.87.216,<->,8.53.0.43,0,0,12,2552,12,2552,1.473035000,0.2947
126.109.2.56,<->,50.224.76.248,0,0,12,1926,12,1926,1.472469000,0.3244
159.162.25.67,<->,8.182.251.218,0,0,12,1700,12,1700,1.471419000,0.2897
76.179.15.94,<->,8.252.222.37,0,0,12,1397,12,1397,1.467762000,0.3849
195.70.105.69,<->,136.25.188.225,0,0,12,1381,12,1381,1.459532000,0.4173
215.158.238.83,<->,8.255.92.245,12,3018,0,0,12,3018,1.456711000,0.4298
136.25.189.5,<->,56.28.207.191,12,14489,0,0,12,14489,1.455002000,0.4518
215.158.61.243,<->,8.176.8.249,0,0,12,12693,12,12693,1.443819000,0.5542
136.25.188.245,<->,80.57.208.50,12,14554,0,0,12,14554,1.429982000,0.0328
221.102.56.69,<->,98.128.231.37,0,0,12,1410,12,1410,1.423213000,0.3822
8.52.179.237,<->,6.231.239.220,12,1036,0,0,12,1036,1.414047000,0.1758
92.162.252.153,<->,33.148.8.234,12,12552,0,0,12,12552,1.412125000,0.4959
199.32.118.218,<->,136.25.188.197,0,0,12,1381,12,1381,1.400035000,0.2084
215.158.239.70,<->,204.56.185.101,12,1840,0,0,12,1840,1.397394000,0.4770
215.158.239.77,<->,199.70.96.26,12,1844,0,0,12,1844,1.360845000,0.6082
233.121.8.176,<->,8.182.136.93,0,0,12,2012,12,2012,1.354917000,0.6291
215.158.140.76,<->,120.154.179.41,12,3009,0,0,12,3009,1.347809000,0.4406
195.14.118.234,<->,136.25.188.252,0,0,12,2192,12,2192,1.326437000,0.6095
136.25.189.77,<->,98.28.95.85,12,2970,0,0,12,2970,1.317483000,0.2288
142.208.195.1,<->,136.25.188.175,0,0,12,1561,12,1561,1.313714000,0.3188
195.5.23.72,<->,136.25.188.53,0,0,12,1645,12,1645,1.302039000,0.5809
192.67.139.230,<->,22.63.36.222,12,5796,0,0,12,5796,1.295714000,0.2634
159.223.99.55,<->,8.52.183.207,0,0,12,2695,12,2695,1.288882000,0.0730
136.25.188.160,<->,8.252.213.21,12,1845,0,0,12,1845,1.288158000,0.0373
98.101.7.51,<->,8.176.63.62,0,0,12,5447,12,5447,1.280484000,0.5169
220.20.200.54,<->,159.70.33.186,12,13943,0,0,12,13943,1.275972000,0.0328
207.239.68.181,<->,136.25.188.220,0,0,12,1562,12,1562,1.271675000,0.4358
122.193.57.250,<->,8.52.183.96,0,0,12,826,12,826,1.266494000,0.4738
220.28.114.28,<->,133.178.227.44,0,0,12,13766,12,13766,1.262353000,0.4587
142.252.66.180,<->,136.25.188.176,0,0,12,2186,12,2186,1.252522000,0.6047
221.101.9.15,<->,136.128.112.242,12,3795,0,0,12,3795,1.249668000,0.4107
136.25.188.36,<->,53.231.225.223,12,11052,0,0,12,11052,1.248760000,0.0861
136.25.188.174,<->,4.233.73.83,12,2327,0,0,12,2327,1.248170000,0.6658
215.158.239.48,<->,199.20.7.47,12,672,0,0,12,672,1.246575000,0.3201
136.25.188.250,<->,0.195.237.14,12,15556,0,0,12,15556,1.219414000,0.0005
195.6.239.139,<->,136.25.188.222,0,0,12,2186,12,2186,1.214055000,0.6817
215.158.239.92,<->,199.68.184.64,12,1285,0,0,12,1285,1.213913000,0.5104
58.247.147.166,<->,8.252.221.221,0,0,12,748,12,748,1.204969000,0.6989
215.158.238.72,<->,27.178.41.36,12,3114,0,0,12,3114,1.194015000,0.7972
142.229.110.49,<->,136.25.188.178,0,0,12,858,12,858,1.185070000,0.8122
136.25.188.225,<->,131.215.37.28,12,3002,0,0,12,3002,1.180913000,0.6412
98.129.116.148,<->,8.45.252.128,12,2949,0,0,12,2949,1.178339000,0.8180
215.158.238.142,<->,119.168.0.40,12,1925,0,0,12,1925,1.168208000,0.2632
91.51.152.82,<->,8.53.2.189,0,0,12,994,12,994,1.160045000,0.1486
199.73.182.207,<->,136.25.188.160,0,0,12,1503,12,1503,1.156728000,0.6543
194.253.94.99,<->,8.182.244.19,0,0,12,1654,12,1654,1.153079000,0.6039
215.158.238.250,<->,139.163.163.240,12,2869,0,0,12,2869,1.149240000,0.8474
192.67.140.203,<->,93.170.135.84,12,16925,0,0,12,16925,1.139029000,0.0073
143.135.7.4,<->,136.25.188.198,0,0,12,2188,12,2188,1.130039000,0.7357
215.158.239.76,<->,207.61.20.6,12,1098,0,0,12,1098,1.126865000,0.7301
143.132.177.31,<->,136.25.188.173,0,0,12,2215,12,2215,1.126224000,0.6080
143.129.165.227,<->,136.25.188.176,0,0,12,2193,12,2193,1.125443000,0.8259
215.158.239.96,<->,207.236.235.100,12,2037,0,0,12,2037,1.120903000,0.7633
215.158.239.86,<->,202.107.204.42,12,1765,0,0,12,1765,1.118984000,0.5975
136.25.188.252,<->,131.144.113.215,12,3242,0,0,12,3242,1.118841000,0.8744
247.136.142.34,<->,14.30.152.106,12,7273,0,0,12,7273,1.116436000,0.3402
215.158.239.87,<->,199.72.81.3,12,1604,0,0,12,1604,1.105669000,0.7339
215.158.239.70,<->,195.81.47.95,12,2004,0,0,12,2004,1.104623000,0.8400
142.209.111.137,<->,136.25.188.45,0,0,12,1522,12,1522,1.095309000,0.4684
140.71.207.94,<->,8.252.221.204,0,0,12,1131,12,1131,1.091979000,0.4279
199.33.86.253,<->,136.25.188.254,0,0,12,1755,12,1755,1.081553000,0.8941
133.165.252.43,<->,132.18.67.27,12,8518,0,0,12,8518,1.078871000,0.2165
133.178.227.76,<->,69.31.239.22,12,2743,0,0,12,2743,1.078524000,0.8636
215.158.239.78,<->,207.59.13.77,12,2187,0,0,12,2187,1.073659000,0.7743
215.158.239.76,<->,199.52.40.31,12,2182,0,0,12,2182,1.068456000,0.6403
138.121.99.24,<->,8.52.175.13,0,0,12,2129,12,2129,1.066931000,0.2053
248.225.27.2,<->,53.240.100.109,12,6172,0,0,12,6172,1.066316000,0.6266
199.39.46.92,<->,136.25.188.243,0,0,12,1738,12,1738,1.063268000,0.7855
144.93.201.3,<->,8.220.186.82,0,0,12,859,12,859,1.057161000,0.1604
194.237.25.123,<->,136.25.188.176,0,0,12,873,12,873,1.055961000,0.7590
207.239.146.3,<->,136.25.188.53,0,0,12,1629,12,1629,1.053383000,0.9155
215.158.238.135,<->,126.219.196.169,12,2906,0,0,12,2906,1.047131000,0.7894
215.158.239.82,<->,80.57.141.206,12,10614,0,0,12,10614,1.046078000,0.1249
220.50.242.215,<->,136.25.189.195,0,0,12,12467,12,12467,1.037156000,0.0489
215.158.239.17,<->,8.255.92.100,12,1804,0,0,12,1804,1.033256000,0.0755
199.68.150.36,<->,136.25.188.241,0,0,12,1652,12,1652,1.031836000,0.3988
95.247.202.207,<->,8.252.222.38,0,0,12,1491,12,1491,1.029661000,0.5445
194.237.7.104,<->,136.25.188.196,0,0,12,1301,12,1301,1.027645000,0.6237
136.25.188.162,<->,120.154.221.219,12,1941,0,0,12,1941,1.027586000,0.1477
215.158.239.79,<->,199.20.30.245,12,684,0,0,12,684,1.026919000,0.8300
143.42.29.66,<->,136.25.188.252,0,0,12,1551,12,1551,1.015639000,0.3327
56.8.55.61,<->,8.182.224.87,0,0,12,698,12,698,1.008687000,0.0583
193.35.127.52,<->,50.224.108.164,0,0,12,752,12,752,1.007174000,0.3555
136.25.188.163,<->,6.141.223.146,12,1511,0,0,12,1511,1.001782000,0.1476
139.254.215.30,<->,129.243.217.199,12,8346,0,0,12,8346,0.998604000,0.9437
215.158.238.82,<->,106.188.251.218,12,4275,0,0,12,4275,0.974159000,0.9037
159.137.231.128,<->,134.151.121.211,12,1572,0,0,12,1572,0.971737000,0.7931
194.237.11.0,<->,136.25.188.55,0,0,12,1739,12,1739,0.967820000,0.9475
139.59.41.196,<->,8.182.224.87,0,0,12,11452,12,11452,0.966575000,0.3791
144.72.195.98,<->,102.50.40.7,0,0,12,5919,12,5919,0.964376000,0.5432
215.158.239.30,<->,126.219.102.190,12,3772,0,0,12,3772,0.950738000,0.5819
231.136.198.109,<->,136.25.188.196,0,0,12,1328,12,1328,0.946699000,1.0380
215.158.239.96,<->,195.83.105.182,12,2036,0,0,12,2036,0.945250000,0.9200
215.158.140.241,<->,139.8.186.147,12,4918,0,0,12,4918,0.933873000,1.0213
43.52.153.114,<->,8.252.221.239,0,0,12,1259,12,1259,0.932270000,1.0519
136.25.189.82,<->,131.144.113.17,12,3445,0,0,12,3445,0.925144000,0.9561
215.158.238.148,<->,80.47.228.219,12,1957,0,0,12,1957,0.923618000,0.2138
215.158.239.211,<->,210.231.140.46,12,2074,0,0,12,2074,0.917525000,0.0579
215.158.239.79,<->,199.20.29.115,12,1393,0,0,12,1393,0.914819000,0.5893
99.162.78.220,<->,53.164.73.93,12,13748,0,0,12,13748,0.914630000,1.0333
246.253.253.106,<->,210.231.140.55,12,2334,0,0,12,2334,0.910256000,0.1530
196.247.115.39,<->,136.25.188.176,0,0,12,1723,12,1723,0.907621000,1.0004
143.135.226.84,<->,136.25.188.236,0,0,12,1736,12,1736,0.904702000,0.5610
136.25.188.179,<->,8.222.7.58,12,3178,0,0,12,3178,0.902925000,0.0791
207.239.140.47,<->,136.25.188.239,0,0,12,1787,12,1787,0.883631000,1.0335
221.196.122.52,<->,136.25.188.163,0,0,12,972,12,972,0.882366000,0.4123
113.224.111.103,<->,50.224.89.241,0,0,12,2827,12,2827,0.876727000,0.3228
95.245.200.203,<->,8.252.221.199,0,0,12,886,12,886,0.875357000,0.3229
199.80.188.86,<->,136.25.188.173,0,0,12,2181,12,2181,0.872632000,0.8745
215.158.239.34,<->,96.135.154.101,12,2151,0,0,12,2151,0.867715000,0.1971
97.11.170.243,<->,53.214.127.174,12,6000,0,0,12,6000,0.867335000,0.3720
136.25.189.11,<->,98.219.126.140,12,7891,0,0,12,7891,0.843686000,0.5185
215.158.239.92,<->,194.202.228.183,12,1819,0,0,12,1819,0.837078000,0.8602
215.158.238.133,<->,113.23.21.212,12,3146,0,0,12,3146,0.835333000,1.0974
133.178.226.18,<->,118.20.87.114,12,3162,0,0,12,3162,0.829497000,0.2305
142.249.41.15,<->,136.25.188.252,0,0,12,1772,12,1772,0.828487000,1.1099
215.158.239.48,<->,204.0.234.66,12,2284,0,0,12,2284,0.826644000,1.0801
215.158.238.134,<->,29.212.189.31,12,1701,0,0,12,1701,0.823750000,0.7353
199.38.228.57,<->,136.25.188.226,0,0,12,2261,12,2261,0.823267000,1.0745
215.158.239.96,<->,199.14.8.64,12,1707,0,0,12,1707,0.820523000,1.0636
80.42.171.157,<->,8.55.224.156,12,10364,0,0,12,10364,0.820352000,0.1972
204.200.43.11,<->,136.25.188.173,0,0,12,1183,12,1183,0.818318000,0.9439
215.158.238.83,<->,57.227.82.251,12,1941,0,0,12,1941,0.815972000,0.2187
99.187.125.121,<->,8.20.87.32,0,0,12,2662,12,2662,0.813788000,1.1849
207.87.59.219,<->,136.25.188.198,0,0,12,2120,12,2120,0.809160000,0.9190
136.25.188.255,<->,8.252.213.30,12,3098,0,0,12,3098,0.806627000,1.1160
133.178.226.37,<->,91.247.40.9,12,4106,0,0,12,4106,0.804275000,1.0728
137.45.170.79,<->,8.220.234.165,0,0,12,1583,12,1583,0.803352000,0.9557
215.158.239.85,<->,199.20.28.17,12,696,0,0,12,696,0.796508000,0.5507
215.158.239.32,<->,96.135.154.110,12,2194,0,0,12,2194,0.795198000,0.3750
104.149.211.148,<->,80.40.13.234,0,0,12,658,12,658,0.783984000,1.1439
133.178.227.251,<->,29.212.207.49,12,3772,0,0,12,3772,0.771969000,1.1513
215.158.238.99,<->,27.178.41.9,12,4431,0,0,12,4431,0.766552000,1.0559
136.25.188.34,<->,127.168.165.134,12,1832,0,0,12,1832,0.765630000,0.2929
196.148.167.157,<->,120.154.64.187,12,12321,0,0,12,12321,0.765391000,0.9873
215.158.239.113,<->,129.222.39.190,12,5239,0,0,12,5239,0.757718000,1.0723
247.136.253.140,<->,221.102.143.189,12,10364,0,0,12,10364,0.748271000,0.1837
213.191.193.86,<->,133.32.39.40,0,0,12,1004,12,1004,0.746971000,1.1187
215.158.238.120,<->,69.132.194.169,12,1781,0,0,12,1781,0.740396000,0.2528
136.25.189.16,<->,96.156.169.231,12,6164,0,0,12,6164,0.737051000,1.2485
215.158.30.240,<->,8.252.222.59,0,0,12,10742,12,10742,0.729919000,0.1847
136.25.189.27,<->,96.156.169.238,12,16383,0,0,12,16383,0.725756000,0.7782
133.178.226.38,<->,91.57.162.225,12,4095,0,0,12,4095,0.723358000,1.2336
218.147.52.203,<->,8.176.48.218,0,0,12,3216,12,3216,0.716278000,0.7876
136.25.189.57,<->,29.212.180.233,12,6105,0,0,12,6105,0.716197000,1.1989
133.32.39.45,<->,83.225.157.222,12,671,0,0,12,671,0.716088000,0.7736
17.5.13.62,<->,8.52.179.237,0,0,12,1006,12,1006,0.715902000,0.4958
111.150.186.97,<->,6.73.247.117,0,0,12,16253,12,16253,0.713701000,0.2075
133.178.226.31,<->,8.255.92.218,12,5588,0,0,12,5588,0.710922000,1.1273
192.226.161.43,<->,133.178.227.2,0,0,12,2698,12,2698,0.706868000,1.0255
215.158.239.95,<->,199.20.28.90,12,1380,0,0,12,1380,0.705569000,0.3890
142.166.50.130,<->,136.25.188.176,0,0,12,1269,12,1269,0.700975000,0.4462
136.25.189.12,<->,120.154.131.47,12,5928,0,0,12,5928,0.696935000,1.0288
132.249.70.127,<->,27.155.137.55,12,2380,0,0,12,2380,0.696574000,0.8025
143.10.147.55,<->,136.25.188.54,0,0,12,2185,12,2185,0.691114000,0.6559
199.70.176.137,<->,136.25.188.54,0,0,12,2799,12,2799,0.691001000,1.2033
207.85.89.173,<->,145.252.125.112,0,0,12,660,12,660,0.687782000,0.7851
136.25.189.196,<->,129.222.39.209,12,4640,0,0,12,4640,0.687711000,1.2509
221.102.56.69,<->,192.65.35.88,0,0,12,1410,12,1410,0.677154000,0.4872
207.60.155.192,<->,136.25.188.163,0,0,12,1381,12,1381,0.672314000,0.8075
195.55.18.245,<->,136.25.188.224,0,0,12,1510,12,1510,0.659815000,1.3254
133.178.226.215,<->,133.146.0.83,12,672,0,0,12,672,0.657497000,1.0723
215.158.238.106,<->,42.226.3.105,12,4399,0,0,12,4399,0.653031000,0.9920
133.178.227.243,<->,100.224.133.68,12,1475,0,0,12,1475,0.635829000,0.2414
194.232.96.97,<->,136.25.188.225,0,0,12,1381,12,1381,0.635298000,0.4679
212.70.75.121,<->,136.25.189.1,0,0,12,3226,12,3226,0.630848000,0.7593
215.158.238.221,<->,113.23.14.216,12,2680,0,0,12,2680,0.629790000,1.0125
144.87.238.89,<->,8.182.227.5,0,0,12,1405,12,1405,0.628243000,0.2463
139.47.194.179,<->,100.92.48.176,0,0,12,6702,12,6702,0.626502000,0.4034
215.158.140.92,<->,8.53.216.223,12,3745,0,0,12,3745,0.624011000,1.0314
215.158.238.133,<->,8.188.227.0,12,3082,0,0,12,3082,0.611363000,1.2194
139.246.60.46,<->,8.250.152.93,0,0,12,10531,12,10531,0.610972000,1.0282
215.158.239.56,<->,196.92.207.48,12,708,0,0,12,708,0.610046000,0.4202
192.65.173.78,<->,8.55.224.156,12,10364,0,0,12,10364,0.608783000,0.3653
195.14.149.126,<->,136.25.188.227,0,0,12,1099,12,1099,0.608225000,0.9525
246.253.253.170,<->,231.255.129.230,12,10544,0,0,12,10544,0.607030000,0.4636
136.25.188.253,<->,57.247.184.198,12,3290,0,0,12,3290,0.606451000,0.4749
215.158.239.68,<->,204.3.30.210,12,2196,0,0,12,2196,0.605772000,0.8350
17.0.7.92,<->,8.220.190.86,0,0,12,3648,12,3648,0.600838000,1.0883
194.237.34.104,<->,136.25.188.173,0,0,12,2157,12,2157,0.598673000,0.8759
120.42.121.172,<->,92.168.217.138,0,0,12,600,12,600,0.597940000,1.1183
136.25.188.252,<->,57.210.107.8,12,2083,0,0,12,2083,0.597866000,0.9216
215.158.140.93,<->,192.171.32.169,12,2687,0,0,12,2687,0.597303000,1.3340
89.183.104.129,<->,48.105.80.135,12,16608,0,0,12,16608,0.594423000,1.3644
149.250.115.13,<->,136.25.188.45,0,0,12,4575,12,4575,0.592402000,1.2087
136.25.188.16,<->,96.217.93.41,12,672,0,0,12,672,0.584360000,1.1304
215.158.239.247,<->,8.191.14.216,12,6425,0,0,12,6425,0.584159000,1.4134
204.2.225.153,<->,136.25.188.178,0,0,12,1099,12,1099,0.583398000,0.8710
136.25.188.47,<->,111.151.70.60,12,3162,0,0,12,3162,0.576673000,0.7260
215.158.2.8,<->,8.176.8.90,0,0,12,5076,12,5076,0.575272000,1.4195
109.222.237.131,<->,53.196.94.83,12,15406,0,0,12,15406,0.575116000,1.0130
136.25.188.175,<->,131.144.113.212,12,4191,0,0,12,4191,0.572632000,0.9809
142.221.99.102,<->,136.25.188.227,0,0,12,1629,12,1629,0.569097000,1.2826
221.102.56.69,<->,98.128.75.116,0,0,12,1410,12,1410,0.568319000,1.0963
76.179.80.245,<->,8.252.221.221,0,0,12,1165,12,1165,0.567549000,0.3175
194.232.238.24,<->,136.25.188.55,0,0,12,1397,12,1397,0.558617000,0.4001
215.158.239.48,<->,207.16.217.102,12,2184,0,0,12,2184,0.556869000,0.7043
136.25.188.53,<->,106.188.236.181,12,3186,0,0,12,3186,0.555860000,1.3800
195.70.145.112,<->,136.25.188.46,0,0,12,1099,12,1099,0.549623000,1.0488
215.158.61.183,<->,8.176.8.199,0,0,12,11738,12,11738,0.541625000,1.0609
215.158.238.190,<->,158.85.50.151,12,6087,0,0,12,6087,0.541322000,1.3978
199.14.204.198,<->,136.25.188.198,0,0,12,1553,12,1553,0.533930000,0.3230
220.28.73.211,<->,215.158.238.19,0,0,12,11496,12,11496,0.531730000,0.1445
207.61.238.85,<->,136.25.188.163,0,0,12,1515,12,1515,0.531355000,0.9216
215.158.239.58,<->,199.20.31.233,12,1559,0,0,12,1559,0.526018000,0.4990
215.158.239.93,<->,196.93.49.247,12,1630,0,0,12,1630,0.524010000,1.3800
215.158.239.17,<->,8.255.92.139,12,2839,0,0,12,2839,0.522381000,1.4442
132.244.73.42,<->,108.134.108.240,0,0,12,1451,12,1451,0.518333000,1.4600
133.178.226.37,<->,29.214.108.118,12,3290,0,0,12,3290,0.511901000,0.4987
136.25.189.1,<->,56.161.218.36,12,7129,0,0,12,7129,0.494287000,1.2598
215.158.239.86,<->,196.109.26.182,12,717,0,0,12,717,0.492473000,0.5197
133.32.39.39,<->,17.2.1.166,12,758,0,0,12,758,0.492166000,0.3343
133.178.226.203,<->,56.23.171.42,12,672,0,0,12,672,0.484067000,1.0297
8.252.223.142,<->,8.219.187.245,12,1606,0,0,12,1606,0.483791000,1.3914
215.158.238.223,<->,131.144.113.139,12,1893,0,0,12,1893,0.482061000,0.1958
215.158.238.132,<->,126.219.194.134,12,4203,0,0,12,4203,0.480748000,0.8455
95.246.109.87,<->,8.252.221.221,0,0,12,1154,12,1154,0.479930000,1.0893
241.180.252.231,<->,92.27.27.175,0,0,12,16944,12,16944,0.477945000,1.3225
215.158.239.108,<->,215.158.61.189,12,12691,0,0,12,12691,0.476611000,0.5738
136.25.189.83,<->,29.214.73.136,12,4575,0,0,12,4575,0.476338000,1.5021
215.158.239.67,<->,0.195.253.228,12,14121,0,0,12,14121,0.471277000,0.1852
137.231.32.86,<->,89.139.241.201,0,0,12,7290,12,7290,0.466176000,0.1880
136.25.188.254,<->,104.3.161.25,12,3162,0,0,12,3162,0.463796000,0.9183
215.158.238.223,<->,106.188.244.246,12,2676,0,0,12,2676,0.462065000,1.2240
215.158.238.148,<->,126.219.193.188,12,1637,0,0,12,1637,0.457487000,0.8590
213.155.188.162,<->,50.224.88.92,0,0,12,672,12,672,0.456630000,1.1687
215.158.238.85,<->,100.120.38.6,12,9608,0,0,12,9608,0.456379000,1.4346
215.158.238.81,<->,116.106.60.156,12,3034,0,0,12,3034,0.455984000,1.3539
80.41.9.16,<->,8.55.224.156,12,10364,0,0,12,10364,0.446446000,0.2372
215.158.238.67,<->,119.196.23.42,12,4255,0,0,12,4255,0.445459000,1.1947
142.241.120.60,<->,136.25.188.209,0,0,12,1381,12,1381,0.444610000,0.3732
247.118.160.190,<->,8.182.229.19,0,0,12,7972,12,7972,0.443598000,1.1821
195.4.4.228,<->,136.25.188.226,0,0,12,2175,12,2175,0.442603000,0.9027
215.158.238.176,<->,8.240.116.213,12,5284,0,0,12,5284,0.438953000,1.4668
215.158.238.73,<->,126.219.132.243,12,3338,0,0,12,3338,0.438467000,0.9039
213.21.35.45,<->,8.220.190.86,0,0,12,2739,12,2739,0.437746000,1.2115
246.254.97.228,<->,56.148.119.56,12,5684,0,0,12,5684,0.437258000,0.2883
143.20.121.130,<->,133.178.226.28,0,0,12,5172,12,5172,0.432414000,1.4738
133.178.226.61,<->,8.222.109.84,12,1954,0,0,12,1954,0.424724000,0.5509
199.50.85.249,<->,136.25.188.255,0,0,12,1213,12,1213,0.422436000,0.5483
136.25.189.31,<->,33.209.219.75,12,5567,0,0,12,5567,0.420452000,1.5407
215.158.239.57,<->,195.70.6.245,12,1555,0,0,12,1555,0.418134000,0.2560
199.50.19.159,<->,136.25.188.160,0,0,12,1188,12,1188,0.409032000,0.7382
136.25.189.1,<->,29.213.219.57,12,6049,0,0,12,6049,0.408914000,1.3551
215.158.239.37,<->,96.135.154.158,12,15172,0,0,12,15172,0.408759000,0.0065
215.158.239.48,<->,195.6.218.147,12,2317,0,0,12,2317,0.406574000,0.8953
212.70.75.32,<->,133.178.227.27,0,0,12,5082,12,5082,0.406180000,1.5215
237.147.133.221,<->,50.224.88.92,0,0,12,672,12,672,0.403844000,1.2283
215.158.239.36,<->,96.135.154.142,12,10832,0,0,12,10832,0.403142000,0.7854
215.158.239.94,<->,199.20.30.166,12,4239,0,0,12,4239,0.401776000,1.4999
215.158.238.81,<->,57.210.107.8,12,3450,0,0,12,3450,0.398596000,0.7633
158.192.3.236,<->,136.25.188.242,0,0,12,4415,12,4415,0.393058000,1.3390
215.158.238.66,<->,126.219.194.170,12,5112,0,0,12,5112,0.390527000,1.4889
142.255.11.101,<->,136.25.188.239,0,0,12,672,12,672,0.390430000,0.0606
136.25.188.178,<->,72.52.201.135,12,708,0,0,12,708,0.389143000,1.4058
223.115.162.41,<->,8.252.222.187,0,0,12,752,12,752,0.387235000,1.5205
199.8.94.20,<->,8.20.87.206,0,0,12,1117,12,1117,0.384597000,0.1716
142.191.1.22,<->,136.25.188.220,0,0,12,2255,12,2255,0.383667000,1.1638
215.158.239.49,<->,195.126.167.168,12,1708,0,0,12,1708,0.382887000,1.0321
242.12.5.146,<->,215.158.239.42,0,0,12,11824,12,11824,0.378059000,1.3239
215.158.239.94,<->,133.56.180.55,12,8190,0,0,12,8190,0.377270000,1.5254
139.163.96.101,<->,42.108.71.96,12,1472,0,0,12,1472,0.376462000,1.3900
142.248.143.211,<->,136.25.188.196,0,0,12,1530,12,1530,0.374025000,1.2466
142.249.228.40,<->,136.25.188.198,0,0,12,1029,12,1029,0.373422000,1.4048
142.248.23.11,<->,136.25.188.46,0,0,12,770,12,770,0.368292000,1.4967
136.25.189.92,<->,96.156.169.173,12,16965,0,0,12,16965,0.367224000,0.0001
215.158.238.72,<->,197.125.126.181,12,4415,0,0,12,4415,0.365487000,1.3310
133.178.226.38,<->,104.154.137.220,12,3034,0,0,12,3034,0.358996000,1.2038
215.158.239.204,<->,133.102.42.226,12,13686,0,0,12,13686,0.356604000,1.3131
193.21.29.244,<->,80.40.61.86,0,0,12,16925,12,16925,0.354646000,0.3086
204.200.19.178,<->,0.195.210.33,0,0,12,600,12,600,0.352682000,1.5937
133.178.226.18,<->,113.23.104.223,12,4207,0,0,12,4207,0.349666000,1.5782
215.158.61.189,<->,8.176.8.232,0,0,12,9124,12,9124,0.346265000,1.5330
215.158.238.142,<->,32.183.36.118,12,3194,0,0,12,3194,0.345987000,1.3759
215.158.140.241,<->,29.214.108.248,12,3717,0,0,12,3717,0.342687000,1.2032
215.158.140.92,<->,146.14.145.54,12,2759,0,0,12,2759,0.338470000,1.2046
202.33.226.149,<->,136.25.188.226,0,0,12,1727,12,1727,0.337574000,1.0195
138.98.233.218,<->,102.228.128.30,12,672,0,0,12,672,0.337319000,1.6302
136.25.189.37,<->,98.219.126.175,12,1473,0,0,12,1473,0.336830000,1.2930
215.158.239.56,<->,199.20.28.58,12,2217,0,0,12,2217,0.336383000,1.4294
215.158.239.94,<->,207.213.125.132,12,2931,0,0,12,2931,0.328678000,1.6504
199.82.49.53,<->,136.25.188.236,0,0,12,648,12,648,0.326341000,1.2846
99.162.77.146,<->,54.37.113.65,12,7028,0,0,12,7028,0.326176000,1.2285
120.109.66.55,<->,98.236.194.252,0,0,12,600,12,600,0.324366000,1.1200
207.198.85.65,<->,89.183.104.224,0,0,12,653,12,653,0.322046000,1.6035
215.158.238.93,<->,133.73.194.11,12,672,0,0,12,672,0.321095000,0.1875
215.158.239.56,<->,199.20.29.243,12,600,0,0,12,600,0.319727000,1.0394
221.196.123.122,<->,138.98.250.39,0,0,12,672,12,672,0.312170000,1.6593
215.158.238.132,<->,143.227.65.187,12,3418,0,0,12,3418,0.310508000,1.3772
215.158.140.87,<->,105.66.16.98,12,768,0,0,12,768,0.305079000,1.0976
142.221.173.130,<->,136.25.188.46,0,0,12,846,12,846,0.301318000,0.8635
215.158.238.47,<->,80.47.111.87,12,2810,0,0,12,2810,0.298659000,0.7374
215.158.140.93,<->,89.86.110.196,12,4396,0,0,12,4396,0.297732000,1.4808
50.224.88.92,<->,46.45.82.217,12,672,0,0,12,672,0.296406000,1.6073
215.158.238.142,<->,122.159.245.165,12,5588,0,0,12,5588,0.295360000,1.3206
196.115.133.150,<->,136.25.188.252,0,0,12,3146,12,3146,0.293929000,1.3677
199.50.23.168,<->,136.25.188.44,0,0,12,1743,12,1743,0.293079000,0.9218
215.158.238.212,<->,215.158.43.1,12,1496,0,0,12,1496,0.292726000,1.0204
136.25.189.90,<->,29.211.228.200,12,7075,0,0,12,7075,0.290588000,1.5715
197.113.98.49,<->,136.25.188.178,0,0,12,1768,12,1768,0.289216000,1.2595
136.25.189.20,<->,96.156.169.238,12,11966,0,0,12,11966,0.289170000,1.4343
215.158.239.79,<->,199.20.31.209,12,2189,0,0,12,2189,0.289069000,0.8400
199.51.199.220,<->,136.25.188.253,0,0,12,934,12,934,0.288667000,1.3968
215.158.239.79,<->,96.156.169.194,12,7353,0,0,12,7353,0.287283000,1.6824
215.158.239.76,<->,195.40.179.152,12,2184,0,0,12,2184,0.287256000,0.9305
215.158.239.78,<->,196.89.223.114,12,2176,0,0,12,2176,0.285161000,1.5622
234.155.180.244,<->,139.163.68.55,0,0,12,600,12,600,0.285021000,1.5692
220.40.166.219,<->,215.158.238.83,0,0,12,1925,12,1925,0.285005000,0.3241
215.158.239.93,<->,204.1.223.5,12,1547,0,0,12,1547,0.282930000,1.1310
195.12.18.255,<->,136.25.188.196,0,0,12,1178,12,1178,0.281426000,1.0237
220.20.200.171,<->,121.105.194.40,12,7783,0,0,12,7783,0.280329000,1.5068
195.41.132.186,<->,136.25.188.252,0,0,12,1596,12,1596,0.279960000,0.3050
215.158.61.183,<->,8.176.8.211,0,0,12,7903,12,7903,0.279221000,1.1738
215.158.238.122,<->,99.192.168.186,12,3086,0,0,12,3086,0.277409000,1.2738
139.163.96.127,<->,97.148.50.186,12,656,0,0,12,656,0.275525000,1.6280
207.63.175.159,<->,136.25.188.174,0,0,12,1994,12,1994,0.275311000,0.8820
136.25.189.59,<->,56.28.207.192,12,4863,0,0,12,4863,0.273540000,1.1162
136.25.188.43,<->,59.158.157.233,12,5093,0,0,12,5093,0.271454000,1.6812
199.33.30.127,<->,136.25.188.255,0,0,12,1087,12,1087,0.270166000,0.9373
69.243.104.90,<->,8.252.221.198,0,0,12,931,12,931,0.269300000,0.8612
58.202.65.113,<->,8.252.221.238,0,0,12,1462,12,1462,0.254335000,0.3475
215.158.238.64,<->,122.158.51.86,12,4271,0,0,12,4271,0.251509000,1.0711
207.7.232.242,<->,136.25.188.241,0,0,12,1460,12,1460,0.250541000,0.7601
215.158.238.241,<->,100.50.96.201,12,4766,0,0,12,4766,0.248895000,1.7273
215.158.239.94,<->,207.57.169.119,12,2195,0,0,12,2195,0.243801000,0.9050
192.227.190.233,<->,133.178.226.7,0,0,12,3898,12,3898,0.242752000,0.6271
112.158.194.201,<->,89.183.104.136,0,0,12,17021,12,17021,0.242411000,0.1978
139.163.163.240,<->,133.178.227.16,0,0,12,3130,12,3130,0.232613000,0.3874
92.162.252.161,<->,33.228.228.108,12,12652,0,0,12,12652,0.231641000,0.7657
204.61.38.125,<->,136.25.188.238,0,0,12,1450,12,1450,0.231450000,1.5024
139.36.120.125,<->,99.74.26.98,0,0,12,5194,12,5194,0.230429000,1.4055
215.158.238.75,<->,57.210.107.41,12,5892,0,0,12,5892,0.226725000,1.6323
204.200.35.226,<->,136.25.188.177,0,0,12,1631,12,1631,0.226348000,0.7870
215.158.238.141,<->,80.57.141.53,12,2938,0,0,12,2938,0.223077000,1.3609
215.158.140.231,<->,29.214.109.175,12,3753,0,0,12,3753,0.221835000,1.4325
138.127.205.200,<->,109.222.255.204,0,0,12,5393,12,5393,0.220371000,0.4267
220.38.84.230,<->,136.25.189.14,0,0,12,3166,12,3166,0.217540000,1.1960
202.33.14.164,<->,136.25.188.222,0,0,12,600,12,600,0.216172000,0.0318
215.158.238.82,<->,104.3.163.83,12,4319,0,0,12,4319,0.216127000,0.7771
206.89.65.36,<->,133.178.227.16,0,0,12,1714,12,1714,0.215767000,1.6507
215.158.239.231,<->,54.38.248.166,12,13145,0,0,12,13145,0.214801000,1.6430
136.25.188.172,<->,119.196.23.52,12,1973,0,0,12,1973,0.214488000,1.7468
56.121.46.242,<->,8.240.117.207,12,2736,0,0,12,2736,0.214245000,1.6100
215.158.140.231,<->,159.137.139.1,12,3181,0,0,12,3181,0.211617000,0.6483
215.158.238.221,<->,140.19.166.246,12,3194,0,0,12,3194,0.211498000,0.9557
215.158.239.69,<->,142.227.33.164,12,1638,0,0,12,1638,0.211014000,0.9579
206.241.112.70,<->,97.168.71.84,0,0,12,1558,12,1558,0.209728000,0.9104
142.208.84.30,<->,136.25.188.163,0,0,12,1413,12,1413,0.206004000,1.7062
199.73.72.6,<->,136.25.188.174,0,0,12,612,12,612,0.203848000,1.0113
215.158.239.57,<->,96.135.155.31,12,1829,0,0,12,1829,0.203411000,0.1013
215.158.238.188,<->,131.219.230.246,12,2742,0,0,12,2742,0.203280000,1.6718
215.158.238.133,<->,104.3.168.214,12,5364,0,0,12,5364,0.203279000,1.5505
195.89.62.194,<->,8.252.222.236,0,0,12,606,12,606,0.203021000,1.7302
144.87.238.89,<->,8.182.230.205,0,0,12,1235,12,1235,0.201673000,0.8805
204.185.111.248,<->,136.25.188.253,0,0,12,1808,12,1808,0.200652000,1.1579
215.158.238.221,<->,106.188.251.34,12,3825,0,0,12,3825,0.198644000,1.6800
215.158.239.49,<->,199.79.142.2,12,2197,0,0,12,2197,0.198497000,1.2999
117.6.100.72,<->,50.224.76.234,0,0,12,5067,12,5067,0.197202000,0.5319
215.158.239.33,<->,149.96.53.40,12,5232,0,0,12,5232,0.197190000,0.8777
139.163.161.148,<->,133.178.227.247,0,0,12,1736,12,1736,0.196656000,0.1052
215.158.239.85,<->,207.57.20.41,12,600,0,0,12,600,0.193785000,0.2296
215.158.238.146,<->,139.163.161.62,12,2479,0,0,12,2479,0.192650000,0.7794
215.158.238.190,<->,69.150.168.212,12,672,0,0,12,672,0.192526000,0.0009
159.23.227.242,<->,125.156.219.10,12,1253,0,0,12,1253,0.187783000,0.7472
148.23.229.32,<->,133.178.226.77,0,0,12,1941,12,1941,0.187722000,1.7953
215.158.140.60,<->,111.150.187.205,12,4818,0,0,12,4818,0.187478000,1.7339
215.158.238.80,<->,148.129.19.125,12,1973,0,0,12,1973,0.186398000,0.1231
215.158.140.93,<->,122.159.123.10,12,1658,0,0,12,1658,0.185968000,1.1792
215.158.239.56,<->,207.188.175.220,12,2372,0,0,12,2372,0.185452000,1.4692
215.158.239.84,<->,142.221.133.139,12,1412,0,0,12,1412,0.185045000,1.1200
82.162.114.98,<->,50.224.105.45,0,0,12,672,12,672,0.184505000,0.8513
215.158.238.129,<->,97.174.232.252,12,5577,0,0,12,5577,0.183090000,1.6558
144.81.196.177,<->,56.121.53.122,0,0,12,600,12,600,0.180768000,1.7867
204.187.156.11,<->,136.25.188.46,0,0,12,672,12,672,0.177525000,0.2800
136.25.188.211,<->,69.150.169.37,12,2938,0,0,12,2938,0.177457000,1.1915
231.141.11.141,<->,215.158.239.79,0,0,12,1519,12,1519,0.175748000,1.0671
215.158.239.94,<->,192.204.123.39,12,6997,0,0,12,6997,0.175522000,1.7613
215.158.239.79,<->,204.61.173.58,12,1744,0,0,12,1744,0.175438000,1.0573
196.89.213.141,<->,136.25.188.54,0,0,12,2513,12,2513,0.174783000,0.3380
136.25.188.105,<->,129.70.124.49,12,2495,0,0,12,2495,0.174587000,1.7274
139.163.8.98,<->,98.87.178.236,12,672,0,0,12,672,0.173832000,1.8203
215.158.140.84,<->,53.231.142.158,12,5913,0,0,12,5913,0.173800000,0.0777
215.158.238.209,<->,126.219.102.4,12,2673,0,0,12,2673,0.171901000,1.8023
207.200.193.161,<->,8.252.222.210,0,0,12,600,12,600,0.170420000,1.6666
194.237.125.123,<->,136.25.188.255,0,0,12,672,12,672,0.169958000,0.2121
113.202.241.177,<->,80.40.53.91,0,0,12,780,12,780,0.168813000,1.8151
215.158.238.134,<->,192.204.170.196,12,3210,0,0,12,3210,0.168685000,1.3957
220.28.109.52,<->,136.25.188.245,0,0,12,16508,12,16508,0.167047000,0.0000
129.225.135.200,<->,129.225.132.224,0,0,12,1208,12,1208,0.165211000,0.1460
215.158.61.237,<->,99.74.26.218,0,0,12,15134,12,15134,0.164313000,1.2780
215.158.238.243,<->,131.144.116.40,12,4791,0,0,12,4791,0.164135000,1.6074
142.190.151.24,<->,136.25.188.177,0,0,12,1579,12,1579,0.160123000,1.3101
144.88.76.38,<->,129.124.149.19,12,12715,0,0,12,12715,0.159986000,1.3578
215.158.239.78,<->,207.60.50.67,12,672,0,0,12,672,0.159570000,0.1054
142.220.64.205,<->,136.25.188.178,0,0,12,1598,12,1598,0.155941000,0.9385
139.163.96.127,<->,82.151.226.232,12,674,0,0,12,674,0.155816000,1.7422
215.158.238.133,<->,131.36.198.41,12,2016,0,0,12,2016,0.155620000,0.7976
223.120.20.50,<->,8.252.221.220,0,0,12,624,12,624,0.155150000,1.6900
246.253.145.197,<->,195.107.242.74,12,4124,0,0,12,4124,0.154810000,1.6081
215.158.238.133,<->,131.144.115.170,12,2778,0,0,12,2778,0.154409000,1.2524
204.185.105.172,<->,136.25.188.174,0,0,12,672,12,672,0.154246000,1.7616
221.102.56.69,<->,192.65.85.199,0,0,12,1410,12,1410,0.152221000,1.7021
235.227.241.156,<->,139.163.96.127,0,0,12,688,12,688,0.151976000,1.7997
152.43.90.133,<->,8.252.222.241,0,0,12,1288,12,1288,0.150189000,0.5510
246.253.253.207,<->,142.178.23.162,12,3644,0,0,12,3644,0.149740000,1.7915
199.80.156.77,<->,136.25.188.242,0,0,12,700,12,700,0.149622000,0.4467
215.158.239.77,<->,106.188.253.173,12,4613,0,0,12,4613,0.148878000,1.7289
194.214.160.24,<->,92.27.219.201,0,0,12,15110,12,15110,0.148515000,1.8287
196.201.67.113,<->,8.252.222.61,0,0,12,1285,12,1285,0.148145000,0.3886
144.87.238.89,<->,8.182.243.35,0,0,12,1314,12,1314,0.147747000,0.5412
215.158.239.95,<->,199.20.28.145,12,1707,0,0,12,1707,0.146925000,0.6200
109.93.17.150,<->,50.224.82.18,0,0,12,600,12,600,0.146386000,1.7978
94.192.164.159,<->,8.252.222.172,0,0,12,1753,12,1753,0.145457000,1.2980
215.158.239.70,<->,196.92.227.118,12,744,0,0,12,744,0.144910000,1.2600
215.158.239.79,<->,196.109.184.155,12,2193,0,0,12,2193,0.144547000,0.9889
133.178.227.60,<->,133.56.180.36,12,11257,0,0,12,11257,0.142750000,1.4661
220.20.200.107,<->,132.216.159.4,12,11484,0,0,12,11484,0.142134000,0.1655
215.158.238.223,<->,29.211.6.94,12,4792,0,0,12,4792,0.142073000,1.7538
207.0.0.82,<->,50.223.3.228,0,0,12,634,12,634,0.141746000,1.6925
143.89.173.236,<->,136.25.188.255,0,0,12,2185,12,2185,0.141694000,1.2888
136.25.188.225,<->,57.199.250.202,12,3290,0,0,12,3290,0.140618000,0.6229
136.25.189.11,<->,98.219.126.175,12,5777,0,0,12,5777,0.140592000,1.6532
100.161.12.53,<->,50.224.88.92,0,0,12,672,12,672,0.140167000,1.5993
43.52.141.149,<->,8.252.221.236,0,0,12,642,12,642,0.140041000,1.8266
195.70.253.186,<->,136.25.188.252,0,0,12,1259,12,1259,0.138901000,0.3150
159.137.169.60,<->,103.16.182.246,12,672,0,0,12,672,0.138194000,1.7685
215.158.238.67,<->,91.57.173.63,12,4431,0,0,12,4431,0.138057000,0.8523
210.232.86.88,<->,159.137.169.60,0,0,12,600,12,600,0.136842000,1.7593
230.95.240.156,<->,6.228.37.66,0,0,12,624,12,624,0.136359000,1.6988
215.158.239.58,<->,199.20.30.10,12,3385,0,0,12,3385,0.136150000,1.7714
195.127.103.212,<->,136.25.188.46,0,0,12,672,12,672,0.136110000,0.4152
215.158.238.73,<->,131.1.253.235,12,4555,0,0,12,4555,0.133255000,1.5288
50.224.76.248,<->,29.211.4.112,12,4495,0,0,12,4495,0.132672000,0.3681
98.248.212.146,<->,50.224.82.18,0,0,12,600,12,600,0.132335000,1.8110
130.77.154.37,<->,0.195.210.8,0,0,12,2248,12,2248,0.131911000,0.5413
215.158.238.141,<->,131.36.198.56,12,6353,0,0,12,6353,0.131033000,1.6538
133.178.226.37,<->,96.155.60.193,12,5414,0,0,12,5414,0.130429000,0.2836
215.158.238.251,<->,33.239.214.162,12,1797,0,0,12,1797,0.128191000,0.4331
204.56.195.61,<->,136.25.188.176,0,0,12,717,12,717,0.127196000,1.5781
136.129.71.11,<->,75.92.190.105,12,1978,0,0,12,1978,0.126316000,1.7642
139.163.34.3,<->,50.224.13.218,12,672,0,0,12,672,0.125643000,1.7050
220.60.81.133,<->,215.158.239.79,0,0,12,5860,12,5860,0.125031000,1.3369
195.70.106.33,<->,136.25.188.241,0,0,12,860,12,860,0.124234000,0.4828
136.25.189.47,<->,120.154.131.38,12,4549,0,0,12,4549,0.121140000,1.7551
136.25.189.77,<->,126.219.194.17,12,6709,0,0,12,6709,0.119304000,1.8447
111.20.172.70,<->,111.20.168.4,0,0,12,1784,12,1784,0.116496000,1.0029
144.57.190.199,<->,139.163.17.164,0,0,12,672,12,672,0.116327000,1.5399
147.47.243.225,<->,8.252.221.198,0,0,12,752,12,752,0.115786000,1.6826
136.25.189.88,<->,29.211.228.247,12,5500,0,0,12,5500,0.115557000,1.3989
239.66.236.178,<->,97.198.98.32,0,0,12,672,12,672,0.115070000,1.8381
221.102.56.69,<->,80.41.225.188,0,0,12,1410,12,1410,0.114538000,0.1884
207.72.127.90,<->,8.252.222.60,0,0,12,666,12,666,0.114005000,1.5616
215.158.61.225,<->,8.252.222.24,0,0,12,15805,12,15805,0.112603000,0.0758
101.49.199.226,<->,98.236.235.234,0,0,12,612,12,612,0.112217000,1.8747
142.220.162.102,<->,136.25.188.238,0,0,12,2178,12,2178,0.111985000,0.4633
215.158.239.50,<->,126.219.191.27,12,6809,0,0,12,6809,0.111529000,1.5158
195.124.206.22,<->,136.25.188.163,0,0,12,733,12,733,0.111294000,0.3510
204.184.234.142,<->,136.25.188.226,0,0,12,804,12,804,0.111051000,0.7999
133.178.226.57,<->,96.155.60.205,12,3817,0,0,12,3817,0.110726000,1.8008
215.158.239.49,<->,199.20.5.235,12,1522,0,0,12,1522,0.110464000,0.3903
136.25.189.14,<->,80.56.79.21,12,7033,0,0,12,7033,0.110451000,1.8053
215.158.140.231,<->,8.222.213.28,12,3871,0,0,12,3871,0.110189000,1.5076
215.158.239.76,<->,29.212.180.246,12,5556,0,0,12,5556,0.106258000,1.6321
246.253.134.201,<->,131.144.207.116,12,11574,0,0,12,11574,0.105511000,1.7860
215.158.61.145,<->,8.176.8.229,0,0,12,6598,12,6598,0.105360000,1.6390
142.221.253.237,<->,136.25.188.209,0,0,12,2080,12,2080,0.105220000,1.8822
204.200.52.221,<->,136.25.188.252,0,0,12,1600,12,1600,0.104588000,0.4036
142.207.66.47,<->,50.224.88.75,0,0,12,600,12,600,0.103461000,1.8921
215.158.140.60,<->,106.188.245.195,12,2960,0,0,12,2960,0.103067000,1.8184
199.69.255.191,<->,136.25.188.239,0,0,12,1365,12,1365,0.102317000,0.6316
108.134.114.215,<->,99.119.141.109,12,600,0,0,12,600,0.099054000,1.8108
215.158.238.250,<->,120.154.179.20,12,3663,0,0,12,3663,0.098543000,1.5047
218.4.190.253,<->,131.49.250.246,12,800,0,0,12,800,0.098186000,1.7001
215.158.239.70,<->,96.156.169.160,12,7129,0,0,12,7129,0.095987000,1.4994
195.108.191.243,<->,50.223.3.228,0,0,12,600,12,600,0.095712000,1.8169
136.25.188.224,<->,104.3.168.214,12,8398,0,0,12,8398,0.095344000,1.8509
148.26.113.230,<->,133.178.227.76,0,0,12,672,12,672,0.095062000,0.0038
215.158.140.204,<->,8.222.6.154,12,672,0,0,12,672,0.094307000,0.0050
205.127.108.115,<->,101.224.89.171,0,0,12,14711,12,14711,0.093587000,0.4828
215.158.238.73,<->,80.47.111.107,12,3258,0,0,12,3258,0.092652000,1.6818
17.249.7.18,<->,8.220.204.147,0,0,12,4888,12,4888,0.092007000,0.2389
143.129.44.86,<->,136.25.188.53,0,0,12,740,12,740,0.091431000,1.4226
111.147.160.213,<->,33.250.6.41,12,8865,0,0,12,8865,0.089159000,1.8345
136.25.188.45,<->,104.3.168.216,12,4175,0,0,12,4175,0.088282000,1.1963
158.192.3.233,<->,136.25.188.44,0,0,12,4287,12,4287,0.086901000,1.7395
133.178.226.90,<->,8.188.227.60,12,5268,0,0,12,5268,0.086696000,1.0592
48.17.222.97,<->,8.252.221.197,0,0,12,642,12,642,0.085089000,1.6456
204.226.28.18,<->,136.25.188.253,0,0,12,1707,12,1707,0.085050000,1.0785
133.178.226.90,<->,8.253.128.68,12,3306,0,0,12,3306,0.084276000,1.2774
215.158.239.49,<->,113.23.14.135,12,6697,0,0,12,6697,0.081880000,1.5481
231.143.227.224,<->,136.25.188.253,0,0,12,1465,12,1465,0.081851000,1.5614
215.158.239.84,<->,196.240.181.125,12,1515,0,0,12,1515,0.080778000,0.4996
145.13.164.163,<->,136.25.189.13,0,0,12,7806,12,7806,0.078135000,0.9161
215.158.239.99,<->,207.228.5.17,12,762,0,0,12,762,0.076259000,0.2875
194.223.216.214,<->,50.223.3.228,0,0,12,600,12,600,0.076088000,1.8784
215.158.239.70,<->,199.20.30.146,12,1477,0,0,12,1477,0.075490000,1.4749
96.58.68.79,<->,8.220.234.159,0,0,12,4114,12,4114,0.075295000,1.8307
252.36.55.128,<->,8.182.248.147,0,0,12,1350,12,1350,0.074625000,1.7861
133.178.227.57,<->,113.23.14.132,12,2750,0,0,12,2750,0.071918000,1.2440
195.78.180.156,<->,50.223.3.228,0,0,12,636,12,636,0.071835000,1.8122
136.25.189.80,<->,29.211.228.213,12,5536,0,0,12,5536,0.071633000,0.9566
48.17.235.128,<->,8.252.221.204,0,0,12,656,12,656,0.071079000,1.9042
136.25.189.34,<->,120.154.131.37,12,5811,0,0,12,5811,0.070049000,1.8209
95.246.75.18,<->,8.252.221.205,0,0,12,1432,12,1432,0.067125000,1.4248
215.158.61.191,<->,8.176.8.250,0,0,12,13379,12,13379,0.066032000,1.9240
109.1.39.166,<->,54.92.206.16,12,633,0,0,12,633,0.065768000,1.8659
136.25.188.161,<->,131.6.152.21,12,3082,0,0,12,3082,0.065403000,1.6527
215.158.239.56,<->,207.60.115.196,12,2178,0,0,12,2178,0.063157000,1.2126
201.43.193.20,<->,139.163.96.127,0,0,12,654,12,654,0.063091000,1.7943
215.158.238.82,<->,106.188.183.98,12,2198,0,0,12,2198,0.061712000,0.9222
215.158.238.67,<->,112.220.206.116,12,4095,0,0,12,4095,0.061208000,1.4188
136.25.189.59,<->,106.188.253.166,12,5570,0,0,12,5570,0.059028000,1.8960
133.178.226.37,<->,122.158.245.155,12,4239,0,0,12,4239,0.057985000,1.8301
111.20.172.70,<->,33.233.141.15,0,0,12,1485,12,1485,0.056932000,0.9998
97.198.108.233,<->,6.125.252.183,12,600,0,0,12,600,0.056496000,1.8548
104.39.26.5,<->,92.27.219.207,0,0,12,624,12,624,0.056169000,1.7689
139.163.8.98,<->,98.87.179.210,12,672,0,0,12,672,0.056044000,1.6465
139.163.27.110,<->,111.168.41.34,12,672,0,0,12,672,0.055807000,1.7681
215.158.239.78,<->,8.50.171.199,12,6809,0,0,12,6809,0.055789000,1.6312
215.158.238.149,<->,119.196.23.9,12,4415,0,0,12,4415,0.055651000,1.7286
138.98.233.218,<->,101.233.103.224,12,672,0,0,12,672,0.055459000,1.8884
215.158.239.28,<->,8.191.6.123,12,6705,0,0,12,6705,0.055217000,1.4329
136.25.189.32,<->,29.209.59.213,12,7061,0,0,12,7061,0.055132000,1.9229
215.158.239.69,<->,8.50.171.169,12,6873,0,0,12,6873,0.052966000,1.7469
215.158.239.28,<->,122.158.246.233,12,5190,0,0,12,5190,0.051931000,1.8596
145.252.120.119,<->,136.116.9.166,12,672,0,0,12,672,0.051771000,1.8336
215.158.239.50,<->,29.212.199.252,12,4431,0,0,12,4431,0.049965000,0.8463
239.66.238.72,<->,97.198.98.50,0,0,12,672,12,672,0.047682000,1.9018
196.25.149.67,<->,50.223.3.228,0,0,12,624,12,624,0.047497000,1.9331
142.221.177.7,<->,136.25.188.226,0,0,12,836,12,836,0.046944000,0.6913
231.140.77.165,<->,215.158.239.92,0,0,12,1413,12,1413,0.046675000,0.5060
133.178.227.16,<->,111.150.187.245,12,5993,0,0,12,5993,0.045207000,1.9227
133.178.227.14,<->,8.222.6.200,12,2954,0,0,12,2954,0.044874000,1.3581
136.25.189.0,<->,126.219.194.89,12,5508,0,0,12,5508,0.041179000,1.9087
221.102.56.46,<->,100.182.164.197,0,0,12,6513,12,6513,0.040946000,0.3863
106.218.57.10,<->,97.198.98.50,0,0,12,672,12,672,0.039976000,1.8414
215.158.238.122,<->,8.222.109.89,12,784,0,0,12,784,0.039288000,1.7199
136.25.189.59,<->,133.56.180.0,12,6965,0,0,12,6965,0.039109000,1.4488
113.79.203.253,<->,80.42.175.248,0,0,12,624,12,624,0.038983000,1.8655
215.158.238.45,<->,69.150.169.154,12,5508,0,0,12,5508,0.038181000,1.7435
215.158.239.56,<->,143.13.107.14,12,1701,0,0,12,1701,0.037171000,0.4747
207.236.1.46,<->,136.25.188.177,0,0,12,1590,12,1590,0.036963000,0.1843
133.178.226.31,<->,111.151.239.91,12,4415,0,0,12,4415,0.036848000,1.8733
215.158.140.60,<->,131.144.116.43,12,3177,0,0,12,3177,0.036445000,1.8283
136.25.188.52,<->,57.160.181.180,12,3114,0,0,12,3114,0.036316000,1.1074
159.175.76.76,<->,97.198.98.222,0,0,12,672,12,672,0.036070000,1.9446
245.244.32.221,<->,8.182.248.147,0,0,12,612,12,612,0.035560000,0.3904
215.158.238.144,<->,97.174.232.172,12,3369,0,0,12,3369,0.034750000,1.7013
98.232.38.67,<->,50.224.49.211,0,0,12,672,12,672,0.034126000,1.6210
215.158.61.243,<->,136.25.188.41,0,0,12,10377,12,10377,0.033170000,1.6569
195.41.227.184,<->,136.25.188.52,0,0,12,1614,12,1614,0.032900000,0.8202
215.158.239.34,<->,29.211.5.196,12,3724,0,0,12,3724,0.032519000,0.6983
247.136.137.168,<->,8.179.131.127,12,6297,0,0,12,6297,0.032267000,1.8109
197.113.99.96,<->,136.25.188.209,0,0,12,1536,12,1536,0.031339000,0.4689
215.158.238.108,<->,0.195.237.14,12,14948,0,0,12,14948,0.030097000,0.2349
215.158.238.190,<->,113.23.66.244,12,2759,0,0,12,2759,0.027981000,1.5096
215.158.239.76,<->,199.20.30.220,12,672,0,0,12,672,0.027320000,0.4401
215.158.238.221,<->,106.188.228.2,12,3050,0,0,12,3050,0.026065000,1.4508
215.158.238.135,<->,113.23.104.212,12,4219,0,0,12,4219,0.025776000,0.9463
146.249.227.49,<->,8.252.221.221,0,0,12,708,12,708,0.025687000,1.7482
231.143.180.216,<->,136.25.188.252,0,0,12,672,12,672,0.025675000,1.4800
215.158.239.95,<->,96.156.169.202,12,7918,0,0,12,7918,0.025526000,1.9229
233.97.211.191,<->,100.93.191.61,0,0,12,3021,12,3021,0.024528000,0.9842
212.241.174.245,<->,80.27.152.229,0,0,12,5609,12,5609,0.024277000,1.9613
133.178.226.19,<->,106.188.236.180,12,4539,0,0,12,4539,0.023975000,1.4846
48.129.132.235,<->,8.252.222.199,0,0,12,5120,12,5120,0.023440000,1.7815
136.25.188.176,<->,57.210.107.25,12,4111,0,0,12,4111,0.022131000,1.5978
91.162.97.67,<->,50.224.76.60,0,0,12,600,12,600,0.020503000,1.9493
207.172.4.27,<->,136.25.188.224,0,0,12,2193,12,2193,0.020207000,1.1201
233.30.195.19,<->,50.224.61.156,0,0,12,672,12,672,0.020162000,1.9101
136.25.189.33,<->,133.56.180.57,12,6601,0,0,12,6601,0.019758000,1.3873
192.170.241.192,<->,8.252.221.166,0,0,12,795,12,795,0.019129000,0.2883
215.158.239.50,<->,199.20.30.4,12,672,0,0,12,672,0.018863000,0.5100
199.73.74.2,<->,136.25.188.174,0,0,12,606,12,606,0.018689000,1.2435
122.12.244.202,<->,92.162.253.84,0,0,12,15873,12,15873,0.018392000,0.1549
195.68.239.235,<->,136.25.188.198,0,0,12,720,12,720,0.017798000,1.7001
149.103.163.101,<->,92.27.194.117,0,0,12,3643,12,3643,0.017274000,0.6671
194.253.94.223,<->,8.252.222.199,0,0,12,762,12,762,0.017162000,1.7486
136.25.188.225,<->,84.250.180.126,12,1583,0,0,12,1583,0.016469000,0.4841
215.158.239.13,<->,8.191.15.129,12,672,0,0,12,672,0.016292000,0.0003
215.158.239.95,<->,29.212.198.189,12,6505,0,0,12,6505,0.016226000,1.7181
136.25.188.210,<->,126.219.194.119,12,1841,0,0,12,1841,0.016124000,0.4495
136.25.189.25,<->,96.156.169.165,12,8996,0,0,12,8996,0.016066000,1.9124
221.102.56.46,<->,213.38.232.157,0,0,12,6461,12,6461,0.015747000,0.1720
215.158.239.79,<->,113.23.100.185,12,6569,0,0,12,6569,0.014271000,1.5006
139.163.102.15,<->,107.12.120.56,12,1061,0,0,12,1061,0.013802000,0.4984
215.158.239.79,<->,199.20.28.88,12,3197,0,0,12,3197,0.013475000,0.5593
133.178.227.79,<->,8.50.170.212,12,3829,0,0,12,3829,0.013096000,1.8982
147.58.211.37,<->,8.252.221.213,0,0,12,5477,12,5477,0.012569000,1.9407
146.249.226.229,<->,8.252.222.109,0,0,12,720,12,720,0.012254000,1.4891
131.92.11.2,<->,80.38.33.27,0,0,12,600,12,600,0.010970000,1.7909
215.158.239.34,<->,96.135.154.148,12,4948,0,0,12,4948,0.010471000,1.5309
199.91.177.40,<->,8.252.222.176,0,0,12,675,12,675,0.008843000,1.9632
136.25.189.0,<->,8.222.98.120,12,5508,0,0,12,5508,0.008619000,1.9676
215.158.238.66,<->,91.57.173.39,12,3002,0,0,12,3002,0.007898000,1.9278
136.25.188.227,<->,111.79.238.157,12,738,0,0,12,738,0.007015000,0.9175
204.21.153.170,<->,136.25.188.177,0,0,12,672,12,672,0.006795000,0.3356
215.158.239.85,<->,142.254.70.49,12,1707,0,0,12,1707,0.006753000,1.9873
215.158.239.96,<->,199.20.29.98,12,672,0,0,12,672,0.005720000,0.2600
220.81.6.61,<->,8.55.221.148,12,4628,0,0,12,4628,0.005284000,1.9346
215.158.3.130,<->,8.176.8.90,0,0,12,2094,12,2094,0.005182000,0.4071
239.227.73.148,<->,221.102.56.69,12,1410,0,0,12,1410,0.004504000,0.7253
215.158.239.77,<->,199.20.5.252,12,729,0,0,12,729,0.002618000,0.2900
212.70.217.105,<->,136.25.188.47,0,0,12,3162,12,3162,0.002130000,0.9836
220.74.83.46,<->,139.163.87.34,0,0,12,600,12,600,0.002039000,1.9047
139.163.27.110,<->,50.63.15.179,12,672,0,0,12,672,0.000904000,1.8527
143.42.16.202,<->,136.25.188.252,0,0,12,1949,12,1949,0.000503000,1.8129
215.158.238.148,<->,120.154.221.218,12,1765,0,0,12,1765,0.000298000,1.2486
144.85.169.211,<->,97.126.83.79,0,0,11,8590,11,8590,1.880122000,0.1103
221.102.143.189,<->,6.228.22.53,0,0,11,10272,11,10272,1.863876000,0.1297
50.224.89.243,<->,50.25.80.46,11,2983,0,0,11,2983,1.860388000,0.1311
215.158.61.189,<->,8.176.8.109,0,0,11,8639,11,8639,1.832839000,0.0852
220.28.110.130,<->,144.86.150.89,0,0,11,877,11,877,1.812188000,0.1492
192.65.90.162,<->,132.250.195.48,11,12590,0,0,11,12590,1.811905000,0.0351
132.216.159.29,<->,92.162.253.28,0,0,11,4953,11,4953,1.810881000,0.1651
221.98.66.193,<->,98.249.162.2,11,1205,0,0,11,1205,1.763148000,0.2037
220.28.73.211,<->,215.158.238.234,0,0,11,9723,11,9723,1.760287000,0.2371
215.158.238.70,<->,111.150.207.137,11,616,0,0,11,616,1.747165000,0.0461
195.55.79.143,<->,136.25.188.225,0,0,11,1442,11,1442,1.743956000,0.2552
111.146.235.136,<->,100.218.108.151,11,14401,0,0,11,14401,1.734751000,0.0936
215.158.238.120,<->,193.10.94.22,11,1789,0,0,11,1789,1.725326000,0.1544
132.216.159.4,<->,92.162.253.85,0,0,11,9731,11,9731,1.722761000,0.2402
215.158.239.113,<->,56.19.241.86,11,13771,0,0,11,13771,1.721479000,0.0080
213.38.171.239,<->,50.224.76.248,0,0,11,5125,11,5125,1.699040000,0.1139
129.225.135.32,<->,129.225.132.72,0,0,11,10781,11,10781,1.697696000,0.0500
136.25.188.47,<->,33.209.217.237,11,1725,0,0,11,1725,1.695492000,0.2510
148.186.207.196,<->,136.25.188.224,0,0,11,1725,11,1725,1.683943000,0.2356
144.85.170.254,<->,91.69.181.215,11,1004,0,0,11,1004,1.664762000,0.2294
144.85.170.254,<->,91.69.181.222,11,1019,0,0,11,1019,1.662368000,0.1832
215.158.239.79,<->,194.251.75.182,11,2448,0,0,11,2448,1.639921000,0.3208
145.252.126.139,<->,98.219.126.40,11,1017,0,0,11,1017,1.598163000,0.1563
215.158.238.119,<->,100.120.38.6,11,12961,0,0,11,12961,1.595396000,0.4031
8.235.250.45,<->,8.228.208.45,0,0,11,6780,11,6780,1.585303000,0.3130
129.225.141.239,<->,129.225.132.80,0,0,11,10781,11,10781,1.576620000,0.2009
215.158.238.82,<->,8.255.92.251,11,1681,0,0,11,1681,1.563975000,0.4184
194.220.115.30,<->,50.223.3.228,0,0,11,798,11,798,1.562834000,0.3277
196.88.114.25,<->,136.25.188.237,0,0,11,616,11,616,1.558897000,0.4154
136.119.203.136,<->,136.25.188.30,0,0,11,15819,11,15819,1.553601000,0.0006
136.25.188.232,<->,0.195.253.228,11,13620,0,0,11,13620,1.550235000,0.0224
215.158.238.99,<->,32.183.36.120,11,1885,0,0,11,1885,1.549090000,0.1248
221.102.143.189,<->,192.65.21.248,0,0,11,7151,11,7151,1.543350000,0.2381
133.178.226.7,<->,112.220.206.17,11,3122,0,0,11,3122,1.537906000,0.2929
109.222.212.198,<->,82.193.206.111,11,1668,0,0,11,1668,1.521665000,0.1624
246.253.145.7,<->,145.89.27.67,11,3566,0,0,11,3566,1.508214000,0.3328
252.2.178.146,<->,92.27.219.178,0,0,11,7972,11,7972,1.505540000,0.2232
215.158.239.50,<->,207.61.167.106,11,1442,0,0,11,1442,1.491238000,0.4161
136.25.189.59,<->,80.56.79.90,11,4652,0,0,11,4652,1.489714000,0.4988
215.158.238.148,<->,8.191.6.90,11,1741,0,0,11,1741,1.487668000,0.0394
215.158.239.76,<->,207.191.238.79,11,1157,0,0,11,1157,1.486119000,0.5011
98.128.148.250,<->,8.49.69.111,11,8145,0,0,11,8145,1.483435000,0.1729
133.178.226.49,<->,113.23.113.227,11,1789,0,0,11,1789,1.472563000,0.1772
17.99.120.221,<->,8.53.4.39,0,0,11,1210,11,1210,1.471237000,0.4887
133.178.226.60,<->,29.211.6.53,11,4199,0,0,11,4199,1.462438000,0.5203
133.178.226.90,<->,96.155.60.216,11,3755,0,0,11,3755,1.460544000,0.3214
204.200.55.151,<->,136.25.188.178,0,0,11,2956,11,2956,1.455103000,0.4726
215.158.61.243,<->,8.176.8.102,0,0,11,8767,11,8767,1.431115000,0.1440
207.236.24.89,<->,136.25.188.55,0,0,11,1244,11,1244,1.430903000,0.4401
224.234.193.175,<->,8.20.87.229,0,0,11,1124,11,1124,1.430642000,0.3756
133.178.226.19,<->,131.144.115.213,11,3026,0,0,11,3026,1.422918000,0.2738
215.158.239.67,<->,80.57.141.205,11,6846,0,0,11,6846,1.422653000,0.1032
133.178.227.16,<->,128.23.167.186,11,1735,0,0,11,1735,1.410738000,0.1164
197.113.99.160,<->,136.25.188.163,0,0,11,1467,11,1467,1.390686000,0.3594
215.158.239.87,<->,199.20.29.53,11,968,0,0,11,968,1.387476000,0.5400
199.73.35.72,<->,136.25.188.253,0,0,11,2171,11,2171,1.381446000,0.5363
220.20.200.249,<->,119.45.35.142,11,13168,0,0,11,13168,1.355722000,0.3839
215.158.239.84,<->,195.42.14.160,11,2941,0,0,11,2941,1.353227000,0.6402
136.25.188.163,<->,8.190.216.201,11,1949,0,0,11,1949,1.352741000,0.1580
139.163.26.146,<->,137.167.73.77,11,4238,0,0,11,4238,1.349370000,0.1830
139.193.141.139,<->,105.201.186.230,11,1648,0,0,11,1648,1.341412000,0.4093
197.113.99.96,<->,136.25.188.220,0,0,11,1472,11,1472,1.340075000,0.3387
104.247.202.21,<->,39.248.149.53,0,0,11,6197,11,6197,1.325286000,0.5318
136.25.189.86,<->,96.156.169.251,11,12876,0,0,11,12876,1.320813000,0.1810
215.158.238.209,<->,29.211.122.151,11,1936,0,0,11,1936,1.319776000,0.1089
206.243.229.66,<->,89.216.125.197,0,0,11,5373,11,5373,1.309688000,0.3523
215.158.239.77,<->,204.227.193.143,11,2161,0,0,11,2161,1.308246000,0.5598
215.158.239.87,<->,142.167.140.82,11,1451,0,0,11,1451,1.307566000,0.4644
215.158.61.195,<->,8.176.8.197,0,0,11,12898,11,12898,1.305485000,0.3028
142.228.238.253,<->,136.25.188.225,0,0,11,1430,11,1430,1.293043000,0.5698
215.158.140.80,<->,98.219.126.175,11,13733,0,0,11,13733,1.290281000,0.0366
136.25.189.53,<->,96.156.169.209,11,12374,0,0,11,12374,1.286133000,0.3683
251.24.86.2,<->,8.252.222.44,0,0,11,2198,11,2198,1.276814000,0.7066
207.56.153.215,<->,136.25.188.255,0,0,11,1277,11,1277,1.274905000,0.3569
122.223.116.201,<->,50.224.108.171,0,0,11,4887,11,4887,1.268197000,0.7149
61.125.168.197,<->,8.252.222.70,0,0,11,1092,11,1092,1.267996000,0.4435
199.121.37.174,<->,136.25.188.174,0,0,11,1441,11,1441,1.267893000,0.2788
197.107.15.174,<->,136.25.188.253,0,0,11,1616,11,1616,1.267236000,0.4800
215.158.239.200,<->,145.82.220.164,11,5834,0,0,11,5834,1.257031000,0.0689
132.18.67.29,<->,111.147.180.135,0,0,11,6761,11,6761,1.247521000,0.5421
215.158.239.76,<->,142.229.151.74,11,1261,0,0,11,1261,1.247110000,0.4171
215.158.238.115,<->,91.247.40.68,11,2477,0,0,11,2477,1.245341000,0.1181
106.152.213.55,<->,101.224.206.44,0,0,11,882,11,882,1.238548000,0.7156
215.158.58.237,<->,6.73.247.89,0,0,11,15078,11,15078,1.222247000,0.0002
133.54.43.44,<->,126.82.157.67,11,1333,0,0,11,1333,1.202280000,0.6463
193.114.179.141,<->,50.224.105.38,0,0,11,1005,11,1005,1.201526000,0.7149
142.229.179.113,<->,136.25.188.163,0,0,11,2131,11,2131,1.200437000,0.7556
215.158.239.105,<->,215.158.61.202,11,13682,0,0,11,13682,1.197391000,0.6401
199.69.62.62,<->,136.25.188.177,0,0,11,1176,11,1176,1.193490000,0.3998
136.25.189.202,<->,131.31.144.144,11,12411,0,0,11,12411,1.185491000,0.1687
231.142.43.110,<->,215.158.239.78,0,0,11,2257,11,2257,1.185138000,0.7886
99.215.70.113,<->,8.182.228.189,0,0,11,1064,11,1064,1.173905000,0.7979
194.237.204.62,<->,136.25.188.243,0,0,11,2283,11,2283,1.168587000,0.2975
215.158.238.104,<->,80.47.111.67,11,3006,0,0,11,3006,1.168109000,0.3959
195.55.213.173,<->,136.25.188.176,0,0,11,1669,11,1669,1.166134000,0.8291
215.158.238.98,<->,65.27.228.230,11,1693,0,0,11,1693,1.152809000,0.2798
215.158.239.40,<->,122.158.53.55,11,4914,0,0,11,4914,1.136940000,0.6759
136.25.188.197,<->,57.199.250.213,11,1917,0,0,11,1917,1.136688000,0.3264
215.158.238.106,<->,112.212.118.149,11,616,0,0,11,616,1.136516000,0.8185
139.205.240.199,<->,0.195.210.46,0,0,11,3430,11,3430,1.130529000,0.6567
111.147.80.171,<->,97.85.66.113,11,1341,0,0,11,1341,1.130487000,0.0870
213.221.90.140,<->,144.85.170.208,0,0,11,1308,11,1308,1.129948000,0.2389
215.158.238.221,<->,131.1.194.197,11,2838,0,0,11,2838,1.124523000,0.5637
50.224.76.235,<->,48.129.113.186,11,5028,0,0,11,5028,1.123747000,0.4200
114.251.240.197,<->,50.224.76.248,0,0,11,4765,11,4765,1.123467000,0.7743
111.147.221.66,<->,53.69.106.30,11,3952,0,0,11,3952,1.122033000,0.4363
215.158.61.243,<->,8.176.8.224,0,0,11,8207,11,8207,1.115728000,0.8825
215.158.239.56,<->,194.199.209.221,11,1531,0,0,11,1531,1.107352000,0.1665
215.158.238.134,<->,142.234.196.200,11,3058,0,0,11,3058,1.073774000,0.4005
243.117.107.187,<->,80.38.1.52,0,0,11,550,11,550,1.065867000,0.0048
220.20.200.89,<->,122.12.244.202,11,12749,0,0,11,12749,1.064585000,0.1465
98.236.87.230,<->,54.39.102.167,11,8204,0,0,11,8204,1.062089000,0.2402
215.158.239.92,<->,199.20.29.71,11,628,0,0,11,628,1.060227000,0.4000
215.158.238.143,<->,122.216.233.246,11,1853,0,0,11,1853,1.058909000,0.1769
136.25.189.34,<->,8.252.253.247,11,1933,0,0,11,1933,1.053517000,0.1316
136.25.188.162,<->,131.1.195.234,11,3026,0,0,11,3026,1.050922000,0.1843
142.248.197.65,<->,136.25.188.239,0,0,11,1529,11,1529,1.044923000,0.7111
215.158.238.252,<->,215.158.43.40,11,3778,0,0,11,3778,1.043546000,0.9533
220.38.239.140,<->,215.158.140.228,0,0,11,1597,11,1597,1.005885000,0.1344
136.25.188.237,<->,80.47.111.87,11,3026,0,0,11,3026,1.002648000,0.6286
144.85.170.254,<->,98.87.146.72,11,1274,0,0,11,1274,1.002172000,0.1261
215.158.239.96,<->,199.20.30.138,11,2107,0,0,11,2107,0.991082000,1.0003
215.158.238.72,<->,38.104.11.55,11,1917,0,0,11,1917,0.986193000,0.2604
215.158.239.56,<->,199.20.29.175,11,1827,0,0,11,1827,0.984669000,0.9629
215.158.239.206,<->,137.107.106.103,11,6550,0,0,11,6550,0.976936000,0.9528
133.178.226.7,<->,96.155.60.192,11,5392,0,0,11,5392,0.976028000,0.5152
50.224.108.164,<->,50.54.143.245,11,1055,0,0,11,1055,0.975306000,0.1732
58.60.45.79,<->,8.252.222.172,0,0,11,2086,11,2086,0.973997000,0.4955
215.158.239.85,<->,29.213.219.42,11,1922,0,0,11,1922,0.972403000,0.2312
223.177.36.73,<->,8.252.221.230,0,0,11,996,11,996,0.969377000,0.9952
194.237.11.0,<->,136.25.188.163,0,0,11,1357,11,1357,0.962116000,0.3142
136.25.189.2,<->,126.219.191.9,11,6881,0,0,11,6881,0.951271000,1.0416
213.221.90.230,<->,144.85.170.208,0,0,11,1003,11,1003,0.946799000,0.2670
142.229.35.114,<->,136.25.188.222,0,0,11,1401,11,1401,0.941269000,1.0481
136.25.188.32,<->,54.38.188.137,11,12519,0,0,11,12519,0.940382000,0.0504
212.70.59.185,<->,136.25.188.178,0,0,11,2122,11,2122,0.938200000,0.4191
97.126.8.42,<->,53.231.146.167,11,13859,0,0,11,13859,0.936042000,0.0725
121.119.162.206,<->,50.224.76.248,0,0,11,4892,11,4892,0.934072000,1.0440
199.69.182.51,<->,136.25.188.255,0,0,11,1924,11,1924,0.932621000,1.0312
207.60.161.220,<->,136.25.188.252,0,0,11,1414,11,1414,0.929134000,1.0569
231.140.71.101,<->,136.25.188.45,0,0,11,648,11,648,0.928144000,0.2904
148.55.210.192,<->,136.25.188.178,0,0,11,1917,11,1917,0.925604000,0.2061
159.223.99.62,<->,8.52.188.75,0,0,11,1444,11,1444,0.922413000,0.1551
215.158.3.188,<->,133.178.227.253,0,0,11,6764,11,6764,0.922129000,0.9381
133.32.39.1,<->,14.75.233.199,11,5419,0,0,11,5419,0.914546000,0.1268
252.64.251.36,<->,80.27.157.212,0,0,11,2676,11,2676,0.914429000,0.3060
215.158.239.5,<->,8.241.236.247,11,3516,0,0,11,3516,0.913314000,1.0421
142.236.96.13,<->,136.25.188.252,0,0,11,2131,11,2131,0.911238000,0.9508
192.226.44.81,<->,136.25.188.29,0,0,11,8194,11,8194,0.903530000,0.9710
199.51.211.251,<->,136.25.188.55,0,0,11,2791,11,2791,0.898410000,0.9618
215.158.140.231,<->,130.13.228.203,11,1698,0,0,11,1698,0.898280000,0.4137
215.158.239.58,<->,196.106.51.196,11,2116,0,0,11,2116,0.878168000,1.1000
142.227.59.72,<->,136.25.188.54,0,0,11,929,11,929,0.877008000,0.4039
136.25.188.210,<->,91.57.173.62,11,5308,0,0,11,5308,0.874423000,1.0814
207.236.204.71,<->,136.25.188.163,0,0,11,2128,11,2128,0.872040000,0.6509
215.158.239.76,<->,207.239.224.78,11,1352,0,0,11,1352,0.870561000,0.4639
221.102.143.189,<->,192.67.160.106,0,0,11,7668,11,7668,0.867186000,0.2721
215.158.239.56,<->,196.106.249.180,11,2154,0,0,11,2154,0.861946000,0.9828
249.101.200.68,<->,53.167.151.133,11,9700,0,0,11,9700,0.855638000,1.0161
81.96.70.52,<->,80.27.158.234,0,0,11,1760,11,1760,0.853132000,0.3904
136.25.189.18,<->,126.219.194.73,11,6019,0,0,11,6019,0.847848000,1.1246
142.206.24.42,<->,136.25.188.178,0,0,11,2094,11,2094,0.842472000,1.0490
215.158.238.107,<->,38.104.11.116,11,2914,0,0,11,2914,0.841595000,0.5056
215.158.238.66,<->,69.150.169.224,11,1821,0,0,11,1821,0.841514000,0.3018
215.158.239.76,<->,199.20.20.241,11,1325,0,0,11,1325,0.834818000,0.7585
118.66.41.107,<->,50.224.76.235,0,0,11,4938,11,4938,0.828256000,0.5045
193.53.171.7,<->,80.38.7.235,0,0,11,1074,11,1074,0.825060000,0.2082
229.65.17.196,<->,215.158.239.19,0,0,11,928,11,928,0.822325000,0.2041
215.158.239.51,<->,29.211.93.23,11,3026,0,0,11,3026,0.810357000,0.7681
215.158.238.97,<->,29.213.216.213,11,2125,0,0,11,2125,0.804982000,0.2360
133.178.227.39,<->,133.56.180.46,11,10353,0,0,11,10353,0.791856000,0.8632
136.25.189.15,<->,120.154.71.44,11,5516,0,0,11,5516,0.791040000,1.1836
95.245.112.186,<->,8.252.221.230,0,0,11,984,11,984,0.790791000,1.1897
32.233.119.118,<->,8.220.191.154,0,0,11,1690,11,1690,0.790547000,0.1333
133.178.227.2,<->,69.150.168.219,11,1997,0,0,11,1997,0.784728000,0.2134
129.224.112.252,<->,97.242.126.179,11,742,0,0,11,742,0.781119000,1.1785
133.178.227.24,<->,8.190.217.43,11,2069,0,0,11,2069,0.775443000,0.2183
215.158.238.104,<->,8.240.118.218,11,3366,0,0,11,3366,0.767265000,1.0622
215.158.140.92,<->,122.159.123.53,11,1655,0,0,11,1655,0.767068000,0.1364
231.143.112.142,<->,136.25.188.198,0,0,11,676,11,676,0.765822000,0.2861
97.11.170.243,<->,53.243.10.49,11,4283,0,0,11,4283,0.765238000,0.4598
212.249.34.44,<->,196.148.165.183,0,0,11,8816,11,8816,0.764860000,0.4994
133.178.227.2,<->,8.240.116.203,11,4700,0,0,11,4700,0.763529000,1.2262
215.158.238.135,<->,80.47.111.87,11,1968,0,0,11,1968,0.762848000,1.1370
140.138.86.214,<->,136.25.188.242,0,0,11,1757,11,1757,0.756932000,0.2099
136.25.188.47,<->,61.35.22.193,11,2093,0,0,11,2093,0.750751000,0.5637
210.226.164.119,<->,8.235.250.45,11,6780,0,0,11,6780,0.747263000,0.4748
215.158.239.87,<->,199.20.29.189,11,2187,0,0,11,2187,0.745551000,0.6095
48.19.216.67,<->,8.252.222.160,0,0,11,892,11,892,0.740034000,0.4820
136.25.189.82,<->,29.209.59.247,11,6337,0,0,11,6337,0.732831000,1.2089
221.102.114.234,<->,199.12.104.169,11,2479,0,0,11,2479,0.732152000,1.0441
111.151.142.166,<->,99.74.26.169,0,0,11,616,11,616,0.729607000,0.0488
215.158.238.95,<->,29.213.219.30,11,1869,0,0,11,1869,0.728843000,0.1208
134.224.209.54,<->,92.27.194.117,0,0,11,2710,11,2710,0.726743000,1.1163
136.25.188.179,<->,8.188.227.40,11,3170,0,0,11,3170,0.725701000,1.2562
205.127.108.115,<->,101.224.89.228,0,0,11,6875,11,6875,0.724466000,1.2133
136.25.189.18,<->,8.215.68.83,11,4343,0,0,11,4343,0.720206000,0.8634
215.158.239.35,<->,29.212.195.102,11,4929,0,0,11,4929,0.714393000,0.6792
215.158.61.220,<->,8.252.222.66,0,0,11,12032,11,12032,0.709798000,0.6562
215.158.239.56,<->,199.20.30.242,11,628,0,0,11,628,0.702100000,0.3501
129.236.114.39,<->,33.233.141.12,0,0,11,16409,11,16409,0.695449000,0.2670
231.140.164.121,<->,215.158.239.95,0,0,11,2137,11,2137,0.689596000,0.6838
136.25.189.77,<->,96.156.169.233,11,5159,0,0,11,5159,0.687677000,1.0806
192.66.145.148,<->,8.45.168.98,11,8206,0,0,11,8206,0.687108000,0.1634
111.20.168.123,<->,92.160.6.227,11,877,0,0,11,877,0.677109000,0.0244
215.158.30.178,<->,8.252.222.189,0,0,11,3402,11,3402,0.673039000,1.3073
132.249.70.183,<->,53.188.42.81,11,647,0,0,11,647,0.670669000,0.0565
221.196.123.30,<->,80.38.35.198,0,0,11,1167,11,1167,0.668142000,0.4804
215.158.140.228,<->,139.1.221.212,11,2188,0,0,11,2188,0.666033000,0.0354
215.158.238.45,<->,80.57.141.94,11,2087,0,0,11,2087,0.659279000,0.7579
215.158.239.95,<->,199.20.6.208,11,1325,0,0,11,1325,0.656446000,0.4500
133.178.227.2,<->,8.53.216.225,11,4765,0,0,11,4765,0.651462000,1.2328
215.158.238.223,<->,57.199.250.221,11,1965,0,0,11,1965,0.647295000,0.4612
215.158.239.29,<->,139.7.138.31,11,1552,0,0,11,1552,0.647062000,0.1492
136.25.188.226,<->,113.23.104.212,11,5036,0,0,11,5036,0.645356000,1.2199
197.113.99.81,<->,136.25.188.173,0,0,11,1590,11,1590,0.645108000,1.2299
215.158.61.242,<->,8.176.8.248,0,0,11,12356,11,12356,0.643218000,1.2356
215.158.238.94,<->,131.1.195.249,11,4610,0,0,11,4610,0.642133000,0.7964
142.208.172.186,<->,136.25.188.253,0,0,11,2133,11,2133,0.640740000,1.2072
195.71.51.137,<->,136.25.188.220,0,0,11,1568,11,1568,0.636431000,0.7525
215.158.238.80,<->,192.227.190.244,11,3810,0,0,11,3810,0.635226000,1.0289
143.44.245.177,<->,136.25.188.220,0,0,11,1909,11,1909,0.633558000,1.1931
215.158.239.50,<->,199.20.31.38,11,1127,0,0,11,1127,0.628022000,0.9984
133.178.227.115,<->,111.150.207.137,11,660,0,0,11,660,0.627291000,1.1306
199.73.182.207,<->,136.25.188.162,0,0,11,2319,11,2319,0.617894000,0.7758
215.158.239.33,<->,8.191.6.84,11,5325,0,0,11,5325,0.614635000,1.2867
136.25.189.85,<->,96.156.169.208,11,13999,0,0,11,13999,0.614220000,0.0068
204.185.186.248,<->,136.25.188.252,0,0,11,1576,11,1576,0.603781000,0.7097
133.178.227.1,<->,113.23.14.135,11,4579,0,0,11,4579,0.603527000,1.3221
195.54.121.135,<->,136.25.188.196,0,0,11,556,11,556,0.602390000,0.8101
246.253.153.54,<->,145.128.214.14,11,3431,0,0,11,3431,0.598704000,0.2478
210.226.165.92,<->,53.144.192.64,11,14748,0,0,11,14748,0.597329000,1.0116
215.158.239.56,<->,199.20.30.100,11,628,0,0,11,628,0.596813000,0.1215
215.158.238.67,<->,126.219.194.140,11,2942,0,0,11,2942,0.594857000,1.2970
215.158.140.231,<->,156.165.33.9,11,1674,0,0,11,1674,0.591818000,1.3630
231.141.2.36,<->,215.158.239.96,0,0,11,2131,11,2131,0.591690000,0.7616
204.62.236.175,<->,136.25.188.255,0,0,11,1740,11,1740,0.586722000,1.3590
133.178.226.29,<->,89.86.110.9,11,3010,0,0,11,3010,0.586534000,0.8522
207.58.99.223,<->,136.25.188.255,0,0,11,2193,11,2193,0.578222000,1.0942
204.61.174.141,<->,136.25.188.196,0,0,11,616,11,616,0.574859000,0.0269
136.25.189.57,<->,8.222.98.136,11,3378,0,0,11,3378,0.573469000,0.3845
215.158.140.60,<->,122.251.2.195,11,1649,0,0,11,1649,0.560614000,0.1104
144.85.170.254,<->,98.87.146.71,11,1277,0,0,11,1277,0.547832000,1.0722
136.25.188.221,<->,104.3.163.5,11,4215,0,0,11,4215,0.546312000,1.3642
109.222.193.196,<->,100.83.51.162,11,9603,0,0,11,9603,0.540175000,0.1843
195.124.146.164,<->,136.25.188.236,0,0,11,1004,11,1004,0.539950000,1.2399
215.158.238.96,<->,128.194.247.212,11,2013,0,0,11,2013,0.538330000,0.9108
144.86.148.17,<->,92.162.221.215,11,1932,0,0,11,1932,0.535993000,0.3048
204.2.22.159,<->,136.25.188.255,0,0,11,2164,11,2164,0.535214000,1.0791
136.25.189.38,<->,96.156.169.218,11,11066,0,0,11,11066,0.534006000,0.2428
215.158.239.94,<->,96.156.169.221,11,5468,0,0,11,5468,0.533995000,1.2759
201.139.235.25,<->,8.252.221.204,0,0,11,982,11,982,0.533333000,1.0023
133.178.227.24,<->,104.3.168.136,11,4655,0,0,11,4655,0.533320000,1.2854
215.158.239.71,<->,33.209.219.82,11,5836,0,0,11,5836,0.531102000,0.6076
204.186.243.46,<->,136.25.188.255,0,0,11,3214,11,3214,0.530190000,1.3300
215.158.239.96,<->,207.63.16.107,11,1502,0,0,11,1502,0.528768000,0.2612
133.178.227.16,<->,38.104.11.171,11,3266,0,0,11,3266,0.527027000,0.4976
215.158.61.182,<->,8.176.8.219,0,0,11,9796,11,9796,0.525163000,1.4133
220.28.104.193,<->,136.25.189.36,0,0,11,8497,11,8497,0.524395000,1.3426
91.56.78.100,<->,8.220.238.6,0,0,11,1311,11,1311,0.515664000,0.9600
142.229.18.200,<->,136.25.188.45,0,0,11,1713,11,1713,0.511760000,1.3046
132.249.71.176,<->,100.94.46.112,0,0,11,6673,11,6673,0.502918000,1.2232
136.25.188.45,<->,8.190.216.201,11,3202,0,0,11,3202,0.496984000,0.6968
215.158.140.76,<->,139.163.163.198,11,1944,0,0,11,1944,0.494648000,0.0375
60.101.123.202,<->,8.252.221.230,0,0,11,1388,11,1388,0.485791000,1.4940
215.158.238.93,<->,131.36.198.41,11,1959,0,0,11,1959,0.483014000,1.0032
156.165.37.109,<->,133.178.227.1,0,0,11,3362,11,3362,0.482459000,1.0314
215.158.239.195,<->,80.31.246.206,11,2827,0,0,11,2827,0.476655000,1.4996
215.158.238.148,<->,111.150.34.229,11,1829,0,0,11,1829,0.475538000,1.3111
215.158.238.96,<->,8.191.15.32,11,4039,0,0,11,4039,0.469106000,1.1383
215.158.239.45,<->,98.219.126.175,11,11441,0,0,11,11441,0.468855000,0.2159
136.25.188.55,<->,131.144.114.231,11,3090,0,0,11,3090,0.461953000,1.2453
215.158.239.70,<->,116.106.46.111,11,3467,0,0,11,3467,0.454623000,0.5305
133.178.226.31,<->,113.23.20.105,11,4551,0,0,11,4551,0.453366000,1.3914
53.149.127.239,<->,48.53.178.63,0,0,11,6936,11,6936,0.451470000,1.1850
95.247.133.246,<->,8.252.221.236,0,0,11,1418,11,1418,0.447781000,1.3906
196.246.22.239,<->,136.25.188.178,0,0,11,732,11,732,0.447404000,1.3101
215.158.239.84,<->,196.0.204.198,11,1512,0,0,11,1512,0.445485000,0.4191
207.61.128.138,<->,136.25.188.54,0,0,11,1224,11,1224,0.443709000,0.6396
143.132.88.112,<->,136.25.188.227,0,0,11,2135,11,2135,0.438914000,0.8187
215.158.238.241,<->,104.3.168.52,11,3154,0,0,11,3154,0.438723000,1.3647
207.61.88.169,<->,136.25.188.252,0,0,11,2120,11,2120,0.433732000,0.8522
215.158.239.70,<->,204.226.48.226,11,2128,0,0,11,2128,0.429395000,0.7257
215.158.239.97,<->,199.20.5.42,11,1570,0,0,11,1570,0.424870000,1.1202
215.158.239.84,<->,196.237.251.85,11,736,0,0,11,736,0.422930000,0.4800
53.161.180.137,<->,48.55.35.116,0,0,11,714,11,714,0.416364000,1.5045
139.163.8.101,<->,104.158.145.179,11,616,0,0,11,616,0.416133000,1.5748
136.25.188.176,<->,29.214.108.83,11,4783,0,0,11,4783,0.414061000,1.5323
231.139.0.115,<->,136.25.188.176,0,0,11,1583,11,1583,0.409428000,0.7198
133.178.226.90,<->,114.25.48.54,11,4503,0,0,11,4503,0.408570000,1.4147
100.94.114.216,<->,6.242.28.74,11,641,0,0,11,641,0.403473000,1.5778
196.20.95.28,<->,8.52.182.119,0,0,11,1347,11,1347,0.400084000,1.5228
200.174.219.227,<->,53.213.6.51,11,11470,0,0,11,11470,0.395203000,0.3623
111.151.106.202,<->,97.126.31.86,0,0,11,616,11,616,0.394336000,0.0803
50.224.49.195,<->,50.88.162.101,11,616,0,0,11,616,0.393229000,1.5321
220.28.85.14,<->,215.158.239.90,0,0,11,4655,11,4655,0.391464000,1.5522
195.124.195.23,<->,136.25.188.227,0,0,11,2138,11,2138,0.387627000,1.5503
136.25.189.57,<->,126.219.194.18,11,6609,0,0,11,6609,0.386639000,1.5587
215.158.238.176,<->,126.219.100.178,11,2653,0,0,11,2653,0.383444000,0.4190
215.158.239.85,<->,120.154.131.46,11,4317,0,0,11,4317,0.382649000,0.8045
215.158.238.149,<->,136.138.112.201,11,5548,0,0,11,5548,0.381305000,1.5115
215.158.238.32,<->,122.158.49.148,11,3234,0,0,11,3234,0.379291000,1.2209
215.158.103.203,<->,17.6.149.126,11,968,0,0,11,968,0.378106000,1.2408
215.158.61.242,<->,8.176.8.207,0,0,11,10156,11,10156,0.375681000,1.0607
139.163.68.55,<->,108.40.157.206,11,550,0,0,11,550,0.372618000,1.5739
124.30.115.231,<->,50.224.76.235,0,0,11,2642,11,2642,0.370441000,0.3256
194.233.11.39,<->,136.25.188.253,0,0,11,2136,11,2136,0.364100000,0.7873
215.158.239.85,<->,196.90.250.153,11,616,0,0,11,616,0.360688000,0.8403
215.158.239.84,<->,143.72.80.9,11,801,0,0,11,801,0.353487000,1.1981
210.220.219.150,<->,206.243.231.162,11,6367,0,0,11,6367,0.342839000,0.1841
215.158.140.83,<->,8.40.51.98,11,3879,0,0,11,3879,0.342119000,1.3820
220.28.73.211,<->,136.25.188.216,0,0,11,13352,11,13352,0.340588000,1.4068
133.178.227.41,<->,133.56.180.15,11,7185,0,0,11,7185,0.339863000,1.6392
215.158.239.48,<->,142.221.134.198,11,1534,0,0,11,1534,0.338071000,0.6841
199.18.9.104,<->,136.25.188.179,0,0,11,1773,11,1773,0.333118000,0.1510
133.178.227.24,<->,100.50.96.170,11,4876,0,0,11,4876,0.331842000,1.5467
215.158.239.95,<->,194.251.64.62,11,1325,0,0,11,1325,0.331569000,0.4017
142.208.49.216,<->,136.25.188.255,0,0,11,2009,11,2009,0.331514000,0.6034
136.25.188.230,<->,80.57.141.206,11,6766,0,0,11,6766,0.328139000,0.0787
213.221.90.129,<->,144.85.170.208,0,0,11,1007,11,1007,0.325844000,0.2293
215.158.238.64,<->,122.159.245.155,11,7073,0,0,11,7073,0.321384000,1.5464
218.154.30.233,<->,8.52.222.23,0,0,11,3184,11,3184,0.316172000,0.5897
142.190.17.168,<->,136.25.188.178,0,0,11,1936,11,1936,0.315797000,1.5091
235.42.34.22,<->,136.25.188.174,0,0,11,2878,11,2878,0.315787000,0.6818
136.25.188.175,<->,131.1.195.250,11,6019,0,0,11,6019,0.311946000,1.5021
136.181.46.200,<->,53.240.9.138,11,5665,0,0,11,5665,0.311055000,0.2391
102.53.88.245,<->,89.183.104.184,0,0,11,570,11,570,0.309477000,1.3324
142.252.211.172,<->,136.25.188.46,0,0,11,556,11,556,0.307946000,1.5846
149.254.205.158,<->,133.178.226.30,0,0,11,1789,11,1789,0.301966000,0.1090
136.25.188.224,<->,69.150.168.134,11,4183,0,0,11,4183,0.301946000,1.6780
215.158.239.97,<->,196.108.16.150,11,2164,0,0,11,2164,0.300621000,1.2100
204.56.13.140,<->,136.25.188.174,0,0,11,1486,11,1486,0.300198000,0.4930
215.158.238.134,<->,42.97.54.90,11,3106,0,0,11,3106,0.299499000,0.8706
136.25.188.253,<->,41.140.18.236,11,2084,0,0,11,2084,0.299155000,0.2941
215.158.239.86,<->,133.56.180.7,11,6721,0,0,11,6721,0.298801000,1.5150
202.33.110.228,<->,136.25.188.52,0,0,11,1357,11,1357,0.296197000,0.6999
215.158.238.81,<->,158.253.43.166,11,3106,0,0,11,3106,0.294412000,1.2885
139.163.8.107,<->,133.174.7.97,11,568,0,0,11,568,0.292871000,1.5083
215.158.239.68,<->,199.20.29.20,11,2142,0,0,11,2142,0.291136000,1.4801
50.224.76.234,<->,30.183.186.118,11,4462,0,0,11,4462,0.289355000,0.4801
215.158.239.92,<->,199.20.31.201,11,2366,0,0,11,2366,0.288880000,1.2708
136.25.188.197,<->,8.179.43.83,11,3186,0,0,11,3186,0.286704000,0.9793
215.158.239.58,<->,199.20.31.178,11,2130,0,0,11,2130,0.285989000,1.6988
195.126.184.133,<->,136.25.188.54,0,0,11,2267,11,2267,0.285929000,0.9913
133.178.227.14,<->,106.188.251.57,11,3736,0,0,11,3736,0.285382000,1.6972
204.184.201.54,<->,136.25.188.209,0,0,11,2147,11,2147,0.284399000,1.4801
195.43.241.6,<->,136.25.188.226,0,0,11,1842,11,1842,0.282655000,0.9692
136.25.188.178,<->,69.150.169.137,11,3074,0,0,11,3074,0.281889000,0.9431
199.14.138.98,<->,136.25.188.220,0,0,11,616,11,616,0.279488000,0.1781
215.158.239.56,<->,199.15.29.219,11,700,0,0,11,700,0.275846000,0.9370
215.158.239.50,<->,207.115.181.57,11,696,0,0,11,696,0.274535000,1.0994
140.126.225.28,<->,98.232.164.173,0,0,11,5421,11,5421,0.274248000,1.5934
132.213.199.19,<->,8.52.154.27,0,0,11,1082,11,1082,0.272747000,0.1102
139.163.68.55,<->,110.50.87.116,11,550,0,0,11,550,0.270578000,1.5726
215.158.238.135,<->,131.36.198.21,11,3097,0,0,11,3097,0.268820000,1.3975
215.158.239.94,<->,207.190.73.63,11,1490,0,0,11,1490,0.268603000,0.3306
138.98.250.39,<->,98.87.178.75,11,616,0,0,11,616,0.265731000,1.6032
92.27.27.163,<->,33.57.77.133,11,1566,0,0,11,1566,0.261281000,1.6139
132.213.244.180,<->,8.53.4.39,0,0,11,1247,11,1247,0.260316000,0.5950
215.158.239.41,<->,131.95.192.196,11,4782,0,0,11,4782,0.258554000,1.5155
215.158.239.95,<->,195.127.163.56,11,2132,0,0,11,2132,0.256812000,0.9077
215.158.239.51,<->,199.39.121.249,11,550,0,0,11,550,0.256227000,1.5419
142.254.41.202,<->,136.25.188.238,0,0,11,616,11,616,0.252966000,0.0111
139.163.0.103,<->,110.65.146.136,11,550,0,0,11,550,0.250834000,1.5672
203.214.3.163,<->,120.83.217.156,11,550,0,0,11,550,0.249729000,1.5597
98.219.117.2,<->,80.38.56.218,0,0,11,4459,11,4459,0.249107000,0.1458
215.158.239.85,<->,80.56.79.22,11,5340,0,0,11,5340,0.248669000,1.7272
192.66.145.148,<->,56.13.192.199,11,5534,0,0,11,5534,0.245959000,0.9747
136.25.189.88,<->,80.56.79.33,11,3991,0,0,11,3991,0.243180000,1.1833
136.25.188.47,<->,113.20.94.83,11,1773,0,0,11,1773,0.242323000,0.2114
138.98.250.39,<->,133.252.204.12,11,550,0,0,11,550,0.241357000,1.6016
142.252.3.127,<->,136.25.188.227,0,0,11,2230,11,2230,0.241071000,0.6950
136.25.188.227,<->,131.36.198.50,11,4247,0,0,11,4247,0.240420000,1.7234
215.158.239.95,<->,207.62.13.218,11,653,0,0,11,653,0.240284000,0.4644
215.158.61.191,<->,136.25.189.202,0,0,11,11308,11,11308,0.239946000,1.4430
136.25.189.14,<->,89.80.251.9,11,4199,0,0,11,4199,0.239621000,1.6302
215.158.238.92,<->,32.183.36.108,11,1853,0,0,11,1853,0.236638000,0.1434
204.186.141.244,<->,136.25.188.53,0,0,11,841,11,841,0.234929000,0.9401
207.239.32.8,<->,136.25.188.243,0,0,11,616,11,616,0.234513000,0.1060
215.158.239.93,<->,199.20.28.170,11,2119,0,0,11,2119,0.230121000,1.1891
201.136.184.218,<->,136.25.188.199,0,0,11,1933,11,1933,0.225175000,0.3486
139.163.96.127,<->,42.71.212.181,11,604,0,0,11,604,0.224739000,1.6336
136.25.189.32,<->,8.215.68.89,11,5480,0,0,11,5480,0.223201000,1.7536
215.158.239.69,<->,195.49.62.93,11,2357,0,0,11,2357,0.222915000,1.6500
246.253.253.207,<->,207.83.100.194,11,3119,0,0,11,3119,0.220921000,1.6425
215.158.239.96,<->,199.76.52.36,11,2064,0,0,11,2064,0.219763000,1.7799
139.163.68.55,<->,112.209.50.148,11,550,0,0,11,550,0.219266000,1.5390
149.96.170.163,<->,136.25.188.52,0,0,11,1789,11,1789,0.217354000,0.1043
215.158.238.241,<->,8.221.197.68,11,4020,0,0,11,4020,0.216971000,1.1938
133.178.227.57,<->,61.35.70.37,11,1677,0,0,11,1677,0.216803000,1.7179
194.221.245.47,<->,50.223.3.228,0,0,11,550,11,550,0.216310000,1.6291
199.92.24.251,<->,50.223.3.228,0,0,11,700,11,700,0.211664000,1.0703
117.31.119.160,<->,92.27.27.145,0,0,11,6342,11,6342,0.206354000,1.7420
215.158.238.141,<->,104.3.169.44,11,2738,0,0,11,2738,0.205051000,0.8184
215.158.239.95,<->,194.232.115.252,11,1842,0,0,11,1842,0.204982000,1.2495
197.113.64.162,<->,136.25.188.175,0,0,11,1699,11,1699,0.201236000,1.7198
133.178.226.29,<->,112.220.206.107,11,628,0,0,11,628,0.201052000,0.1229
199.21.94.144,<->,50.223.3.228,0,0,11,602,11,602,0.198295000,1.4400
142.236.26.141,<->,136.25.188.225,0,0,11,824,11,824,0.197626000,1.2285
136.25.189.31,<->,96.156.169.231,11,7393,0,0,11,7393,0.196433000,1.7252
136.25.188.221,<->,106.188.236.184,11,5228,0,0,11,5228,0.195982000,1.3603
215.158.239.71,<->,80.56.79.10,11,8134,0,0,11,8134,0.195964000,1.7019
136.25.189.95,<->,96.156.169.207,11,12956,0,0,11,12956,0.195426000,1.7766
136.25.188.224,<->,99.192.168.187,11,3097,0,0,11,3097,0.195328000,1.7739
204.185.119.153,<->,136.25.188.196,0,0,11,700,11,700,0.192611000,1.4604
143.128.55.116,<->,136.25.188.252,0,0,11,1054,11,1054,0.192414000,1.5893
215.158.239.70,<->,196.92.102.235,11,616,0,0,11,616,0.190262000,0.3700
215.158.239.51,<->,199.20.29.52,11,1457,0,0,11,1457,0.185948000,0.7894
136.25.188.226,<->,8.255.92.231,11,2898,0,0,11,2898,0.184133000,1.1415
136.25.188.177,<->,29.214.108.122,11,6822,0,0,11,6822,0.184065000,1.6508
195.43.205.170,<->,136.25.188.255,0,0,11,616,11,616,0.182201000,0.0191
215.158.238.83,<->,112.235.95.27,11,5580,0,0,11,5580,0.179786000,1.7771
136.25.189.1,<->,118.20.100.88,11,5628,0,0,11,5628,0.177600000,1.4648
139.241.56.117,<->,98.129.89.174,0,0,11,14616,11,14616,0.177518000,1.8101
136.25.188.45,<->,91.57.173.36,11,5628,0,0,11,5628,0.177333000,1.7199
247.136.130.205,<->,144.91.199.50,11,8331,0,0,11,8331,0.177278000,1.6517
215.158.238.45,<->,143.20.121.150,11,3410,0,0,11,3410,0.176487000,0.8626
133.178.226.49,<->,113.23.104.221,11,3058,0,0,11,3058,0.175634000,1.6706
142.252.135.17,<->,136.25.188.253,0,0,11,2178,11,2178,0.174788000,1.1259
215.158.238.200,<->,122.158.69.2,11,12232,0,0,11,12232,0.174375000,1.2393
139.163.96.127,<->,50.163.236.128,11,600,0,0,11,600,0.174248000,1.8016
139.59.41.197,<->,8.182.226.78,0,0,11,4346,11,4346,0.174198000,1.1459
136.25.189.34,<->,29.212.199.227,11,5564,0,0,11,5564,0.171023000,1.5889
215.158.239.231,<->,111.151.237.68,11,12301,0,0,11,12301,0.167782000,1.8129
206.243.231.162,<->,111.146.255.212,0,0,11,5293,11,5293,0.167589000,0.2461
142.208.205.70,<->,136.25.188.196,0,0,11,1919,11,1919,0.164995000,0.9062
229.96.182.37,<->,8.181.37.222,11,10058,0,0,11,10058,0.164916000,0.5021
98.236.235.234,<->,6.133.232.41,11,616,0,0,11,616,0.164702000,1.8200
136.25.189.31,<->,56.161.218.54,11,5916,0,0,11,5916,0.162895000,1.3418
197.197.42.231,<->,139.163.68.55,0,0,11,550,11,550,0.161989000,1.7195
92.27.27.143,<->,88.4.11.196,11,14004,0,0,11,14004,0.159709000,1.1727
204.44.84.191,<->,102.50.97.18,0,0,11,572,11,572,0.159183000,1.7759
196.113.250.60,<->,0.195.210.43,0,0,11,2177,11,2177,0.157358000,1.7067
215.158.239.84,<->,149.163.129.215,11,7782,0,0,11,7782,0.155422000,1.8019
215.158.239.56,<->,199.20.7.105,11,1277,0,0,11,1277,0.154661000,1.6000
139.163.96.127,<->,92.180.206.211,11,604,0,0,11,604,0.154621000,1.7445
142.178.1.21,<->,50.223.3.228,0,0,11,556,11,556,0.153979000,1.7243
139.163.34.116,<->,80.56.72.130,11,550,0,0,11,550,0.153721000,1.7443
215.158.238.97,<->,158.192.3.233,11,3298,0,0,11,3298,0.152974000,1.6797
195.5.213.210,<->,136.25.188.254,0,0,11,2145,11,2145,0.151905000,0.7233
139.163.96.127,<->,6.214.19.223,11,598,0,0,11,598,0.150663000,1.7461
223.115.143.166,<->,8.252.221.237,0,0,11,1176,11,1176,0.150449000,1.7371
139.163.96.94,<->,84.1.171.148,11,550,0,0,11,550,0.150259000,1.5320
136.25.189.59,<->,89.80.251.8,11,6657,0,0,11,6657,0.148922000,1.6333
202.162.46.148,<->,8.252.221.204,0,0,11,604,11,604,0.148706000,1.8477
195.14.255.243,<->,136.25.188.209,0,0,11,1566,11,1566,0.148625000,1.7414
232.31.246.42,<->,139.193.141.139,0,0,11,1642,11,1642,0.148364000,0.3817
215.158.239.76,<->,29.213.219.59,11,7020,0,0,11,7020,0.147832000,1.7738
215.158.238.123,<->,33.209.217.214,11,1973,0,0,11,1973,0.146767000,1.5597
148.55.210.235,<->,136.25.189.16,0,0,11,2850,11,2850,0.146505000,0.6776
139.163.96.127,<->,110.97.79.169,11,604,0,0,11,604,0.146497000,1.8025
215.158.239.56,<->,207.167.248.82,11,1235,0,0,11,1235,0.144180000,0.8600
221.196.123.187,<->,138.98.250.43,0,0,11,616,11,616,0.144090000,1.7809
109.1.3.222,<->,88.156.140.61,11,586,0,0,11,586,0.143735000,1.0538
136.25.189.80,<->,29.211.93.22,11,6353,0,0,11,6353,0.142340000,1.6964
142.221.6.119,<->,136.25.188.178,0,0,11,1365,11,1365,0.141978000,0.6892
75.214.96.0,<->,8.252.221.222,0,0,11,574,11,574,0.141434000,1.7846
215.158.239.57,<->,199.20.30.53,11,616,0,0,11,616,0.141278000,1.4996
194.232.239.61,<->,136.25.188.163,0,0,11,1818,11,1818,0.138808000,1.3726
133.178.227.2,<->,106.188.252.234,11,3639,0,0,11,3639,0.137709000,1.4857
194.232.226.23,<->,136.25.188.55,0,0,11,1349,11,1349,0.134587000,0.2546
136.25.188.199,<->,80.47.111.87,11,2882,0,0,11,2882,0.133841000,1.8273
215.158.239.102,<->,122.158.176.233,11,4553,0,0,11,4553,0.132974000,1.6493
215.158.239.87,<->,196.88.102.199,11,804,0,0,11,804,0.132958000,1.5489
157.127.224.62,<->,8.252.221.204,0,0,11,990,11,990,0.131788000,1.3970
215.158.239.96,<->,207.213.62.211,11,1325,0,0,11,1325,0.130275000,0.2610
204.184.177.16,<->,136.25.188.174,0,0,11,2140,11,2140,0.130028000,0.6194
215.158.140.88,<->,98.219.126.175,11,2224,0,0,11,2224,0.127533000,1.4924
136.138.112.13,<->,133.178.227.41,0,0,11,3442,11,3442,0.125719000,0.2190
215.158.140.93,<->,8.57.163.139,11,640,0,0,11,640,0.123457000,1.8228
17.41.77.69,<->,8.220.181.167,0,0,11,2131,11,2131,0.123377000,0.0757
104.153.164.174,<->,92.27.27.157,0,0,11,572,11,572,0.123213000,1.4490
215.158.239.57,<->,142.221.137.149,11,628,0,0,11,628,0.122246000,0.4432
215.158.238.113,<->,119.196.23.54,11,4039,0,0,11,4039,0.122194000,0.9931
196.0.208.125,<->,0.195.210.42,0,0,11,628,11,628,0.120954000,1.8604
215.158.239.79,<->,195.54.43.47,11,1602,0,0,11,1602,0.120594000,0.4925
142.174.234.224,<->,8.52.175.115,0,0,11,1261,11,1261,0.120445000,0.5094
197.125.110.212,<->,136.25.189.77,0,0,11,7089,11,7089,0.117521000,1.7739
143.13.230.223,<->,136.25.188.253,0,0,11,2133,11,2133,0.116670000,0.7499
215.158.239.227,<->,53.191.179.79,11,10997,0,0,11,10997,0.115556000,1.8698
215.158.239.76,<->,199.20.31.114,11,1127,0,0,11,1127,0.114943000,1.7500
215.158.239.5,<->,126.219.102.252,11,3605,0,0,11,3605,0.112110000,0.5662
159.137.169.60,<->,98.242.56.84,11,616,0,0,11,616,0.112019000,1.8366
146.249.227.159,<->,139.163.17.163,0,0,11,696,11,696,0.110470000,1.7410
139.163.81.178,<->,46.42.127.115,11,550,0,0,11,550,0.110288000,1.6535
136.25.188.210,<->,29.214.108.148,11,5372,0,0,11,5372,0.109967000,1.6669
199.121.0.96,<->,136.25.188.241,0,0,11,808,11,808,0.107528000,0.6835
133.178.226.18,<->,8.255.92.215,11,3054,0,0,11,3054,0.106410000,1.2009
215.158.238.196,<->,106.188.253.38,11,3886,0,0,11,3886,0.106151000,1.7576
125.59.16.30,<->,80.41.51.34,0,0,11,638,11,638,0.106040000,1.2930
111.20.172.70,<->,33.233.141.57,0,0,11,1361,11,1361,0.104782000,1.0059
136.25.189.45,<->,96.156.169.162,11,6316,0,0,11,6316,0.104676000,1.0534
124.64.43.233,<->,109.222.200.118,0,0,11,12054,11,12054,0.103389000,1.8073
6.145.173.53,<->,0.195.210.44,0,0,11,1328,11,1328,0.101301000,0.8636
204.200.35.117,<->,136.25.188.176,0,0,11,1966,11,1966,0.099405000,1.6958
133.178.227.19,<->,131.22.233.155,11,3697,0,0,11,3697,0.099364000,1.4286
111.20.172.70,<->,111.20.168.157,0,0,11,1480,11,1480,0.098826000,1.0029
133.178.227.208,<->,8.191.14.216,11,5943,0,0,11,5943,0.098753000,1.4764
205.127.108.114,<->,33.233.141.227,0,0,11,3061,11,3061,0.097636000,1.6550
220.28.115.46,<->,215.158.140.81,0,0,11,9958,11,9958,0.095592000,1.1167
215.158.238.99,<->,65.27.220.203,11,3098,0,0,11,3098,0.094055000,1.7733
215.158.238.225,<->,113.207.62.41,11,792,0,0,11,792,0.093378000,0.4006
136.25.188.221,<->,29.214.108.89,11,3250,0,0,11,3250,0.092969000,1.7964
136.25.189.14,<->,8.215.68.65,11,7366,0,0,11,7366,0.092075000,1.8691
204.42.60.56,<->,50.223.3.228,0,0,11,580,11,580,0.091663000,1.8486
215.158.239.92,<->,199.20.4.225,11,1582,0,0,11,1582,0.089813000,0.7799
142.240.151.157,<->,136.25.188.160,0,0,11,1127,11,1127,0.087456000,1.6032
199.15.237.64,<->,136.25.188.238,0,0,11,616,11,616,0.087008000,0.2753
220.28.85.14,<->,215.158.140.247,0,0,11,12774,11,12774,0.086649000,0.1505
195.215.103.3,<->,50.223.3.228,0,0,11,550,11,550,0.085167000,1.8410
205.127.108.114,<->,33.233.141.115,0,0,11,6537,11,6537,0.085015000,1.7611
133.178.227.16,<->,106.188.228.1,11,3698,0,0,11,3698,0.082370000,1.9024
95.246.87.146,<->,8.252.221.236,0,0,11,1408,11,1408,0.081978000,1.7663
80.38.39.168,<->,0.82.61.6,11,550,0,0,11,550,0.081409000,0.2081
204.186.60.3,<->,136.25.188.209,0,0,11,748,11,748,0.081404000,0.6216
220.77.116.30,<->,139.163.20.253,0,0,11,550,11,550,0.080895000,1.7428
8.252.223.175,<->,8.219.184.92,11,1803,0,0,11,1803,0.080756000,1.4204
200.175.87.179,<->,54.37.9.160,11,6716,0,0,11,6716,0.080624000,1.5236
136.25.188.224,<->,131.144.113.195,11,4231,0,0,11,4231,0.077968000,1.1818
94.185.214.164,<->,8.252.221.196,0,0,11,586,11,586,0.077691000,1.9152
197.113.99.67,<->,136.25.188.238,0,0,11,2185,11,2185,0.076708000,1.5700
215.158.238.83,<->,131.173.115.91,11,2930,0,0,11,2930,0.076531000,1.0569
136.25.188.197,<->,131.2.115.252,11,3106,0,0,11,3106,0.075473000,1.6109
207.58.249.49,<->,136.25.188.241,0,0,11,2121,11,2121,0.075422000,1.7523
142.207.236.246,<->,136.25.188.220,0,0,11,803,11,803,0.075035000,0.3982
111.20.172.70,<->,111.20.168.144,0,0,11,1473,11,1473,0.074827000,1.0152
215.158.238.123,<->,8.252.210.250,11,4375,0,0,11,4375,0.074044000,1.5779
215.158.239.56,<->,195.54.182.21,11,550,0,0,11,550,0.073734000,0.1624
141.125.12.236,<->,139.163.96.94,0,0,11,576,11,576,0.072685000,1.8825
136.25.188.174,<->,27.178.41.38,11,3122,0,0,11,3122,0.071864000,0.5308
210.220.217.34,<->,102.251.235.53,11,1282,0,0,11,1282,0.071849000,1.7696
247.136.177.71,<->,124.9.21.238,11,833,0,0,11,833,0.071456000,1.7884
215.158.239.70,<->,196.109.201.160,11,1341,0,0,11,1341,0.071431000,0.3799
215.158.239.95,<->,215.158.44.209,11,6689,0,0,11,6689,0.070764000,1.8117
195.125.180.140,<->,136.25.188.45,0,0,11,1457,11,1457,0.069546000,0.7391
199.82.176.65,<->,136.25.188.177,0,0,11,1656,11,1656,0.069499000,0.7790
215.158.239.57,<->,204.226.42.240,11,1115,0,0,11,1115,0.067955000,1.6440
91.231.195.136,<->,27.231.94.211,11,1226,0,0,11,1226,0.066978000,1.4813
138.98.250.43,<->,102.241.208.235,11,616,0,0,11,616,0.065744000,1.5994
136.25.188.255,<->,122.158.245.86,11,4535,0,0,11,4535,0.065285000,1.8141
89.86.110.126,<->,8.252.223.120,0,0,11,3897,11,3897,0.064474000,0.8141
143.194.53.201,<->,136.25.188.105,0,0,11,2568,11,2568,0.063677000,1.5885
136.25.189.14,<->,96.156.169.244,11,3378,0,0,11,3378,0.063197000,1.2408
133.178.226.61,<->,119.196.23.27,11,3262,0,0,11,3262,0.062712000,1.2802
215.158.239.40,<->,29.211.5.208,11,3516,0,0,11,3516,0.062163000,0.5922
215.158.238.73,<->,122.159.245.165,11,3815,0,0,11,3815,0.062083000,1.5952
143.132.118.227,<->,136.25.188.173,0,0,11,2088,11,2088,0.061731000,0.8707
209.18.32.202,<->,8.220.178.246,0,0,11,1416,11,1416,0.061502000,1.2432
139.36.120.125,<->,99.74.26.190,0,0,11,4823,11,4823,0.060952000,1.6410
199.38.230.44,<->,136.25.188.209,0,0,11,1325,11,1325,0.060622000,0.6616
215.158.239.57,<->,143.79.204.203,11,2127,0,0,11,2127,0.059443000,0.5263
136.25.189.1,<->,29.211.228.176,11,3026,0,0,11,3026,0.059423000,0.6735
136.25.188.52,<->,113.23.104.215,11,2139,0,0,11,2139,0.057658000,0.9847
215.158.238.113,<->,118.20.114.90,11,3154,0,0,11,3154,0.054956000,1.0126
215.158.239.77,<->,192.204.123.37,11,7009,0,0,11,7009,0.054299000,1.7656
215.158.238.45,<->,131.36.198.58,11,3170,0,0,11,3170,0.052498000,1.7891
215.158.238.81,<->,131.144.113.183,11,4279,0,0,11,4279,0.052413000,1.6135
142.221.52.212,<->,136.25.188.224,0,0,11,1309,11,1309,0.052119000,0.3903
111.150.187.250,<->,8.252.223.153,0,0,11,4747,11,4747,0.052055000,1.5786
215.158.238.33,<->,192.226.161.144,11,2962,0,0,11,2962,0.050800000,1.3969
215.158.239.50,<->,196.93.91.240,11,1465,0,0,11,1465,0.050032000,0.9396
114.83.250.130,<->,91.231.195.136,0,0,11,1226,11,1226,0.049897000,1.5016
231.138.213.159,<->,136.25.188.255,0,0,11,736,11,736,0.049719000,1.3620
109.206.167.116,<->,50.224.92.97,0,0,11,956,11,956,0.049569000,1.1359
215.158.61.191,<->,8.176.8.229,0,0,11,3637,11,3637,0.049070000,1.8584
215.158.239.77,<->,199.20.29.218,11,1442,0,0,11,1442,0.047650000,1.0596
215.158.239.93,<->,207.63.154.158,11,664,0,0,11,664,0.047441000,1.3856
136.25.188.239,<->,57.160.181.180,11,4423,0,0,11,4423,0.047346000,1.3101
215.158.61.182,<->,8.176.8.226,0,0,11,10328,11,10328,0.046784000,1.5431
145.235.126.144,<->,50.224.77.118,0,0,11,616,11,616,0.046390000,1.8674
192.64.195.164,<->,33.78.157.45,11,550,0,0,11,550,0.043826000,1.8172
215.158.238.241,<->,106.188.252.212,11,3698,0,0,11,3698,0.042982000,0.7855
192.65.71.62,<->,139.241.56.102,11,14616,0,0,11,14616,0.042472000,1.9284
215.158.239.58,<->,143.135.90.118,11,1735,0,0,11,1735,0.041537000,0.6344
215.158.238.123,<->,8.188.227.70,11,5532,0,0,11,5532,0.041421000,1.8672
215.158.140.75,<->,8.57.163.149,11,640,0,0,11,640,0.039927000,1.8835
215.158.239.70,<->,195.126.16.171,11,1671,0,0,11,1671,0.039577000,1.8002
246.253.253.213,<->,207.2.91.41,11,1028,0,0,11,1028,0.039357000,1.9281
8.182.226.78,<->,6.242.53.9,11,1413,0,0,11,1413,0.038118000,0.3106
139.163.17.129,<->,102.232.100.126,11,8190,0,0,11,8190,0.037834000,1.7063
139.193.141.128,<->,35.55.104.73,11,616,0,0,11,616,0.037832000,1.7141
143.72.233.132,<->,136.25.188.179,0,0,11,1899,11,1899,0.037771000,0.9264
136.25.188.55,<->,29.214.64.198,11,3170,0,0,11,3170,0.037175000,1.6598
133.178.227.1,<->,29.211.6.203,11,2680,0,0,11,2680,0.035691000,1.1976
215.158.140.60,<->,104.3.168.139,11,6959,0,0,11,6959,0.035336000,1.8771
136.25.188.53,<->,84.246.156.172,11,616,0,0,11,616,0.034991000,0.2376
215.158.239.79,<->,207.16.222.29,11,717,0,0,11,717,0.034975000,0.5690
215.158.239.87,<->,199.81.22.225,11,1274,0,0,11,1274,0.033741000,1.9096
195.213.33.223,<->,50.223.3.228,0,0,11,550,11,550,0.033389000,1.7962
136.25.189.52,<->,96.156.169.167,11,9036,0,0,11,9036,0.032606000,0.3769
215.158.238.113,<->,126.219.132.160,11,6012,0,0,11,6012,0.032303000,1.7761
139.163.161.169,<->,133.32.39.20,0,0,11,1427,11,1427,0.031618000,0.1703
215.158.238.132,<->,114.25.48.40,11,2946,0,0,11,2946,0.030909000,1.5438
136.25.188.225,<->,73.179.102.129,11,550,0,0,11,550,0.030056000,1.3671
199.39.72.29,<->,136.25.188.255,0,0,11,610,11,610,0.029900000,1.1516
215.158.238.64,<->,139.160.226.215,11,1805,0,0,11,1805,0.029060000,1.5195
207.22.224.140,<->,0.195.210.46,0,0,11,3398,11,3398,0.027358000,1.9588
136.25.188.237,<->,131.144.113.190,11,3074,0,0,11,3074,0.027099000,0.9258
133.178.227.4,<->,133.56.180.77,11,5279,0,0,11,5279,0.026004000,1.9363
215.158.239.79,<->,194.251.143.80,11,2122,0,0,11,2122,0.025549000,0.5298
207.62.191.68,<->,136.25.188.46,0,0,11,1571,11,1571,0.025526000,0.9675
247.136.249.91,<->,120.32.206.98,11,664,0,0,11,664,0.024894000,1.9611
196.89.233.128,<->,136.25.188.237,0,0,11,804,11,804,0.024259000,1.9398
192.204.170.198,<->,136.25.188.197,0,0,11,3242,11,3242,0.024118000,1.2063
204.21.245.115,<->,136.25.188.227,0,0,11,2349,11,2349,0.023976000,0.9103
215.158.239.84,<->,199.52.193.186,11,2156,0,0,11,2156,0.023045000,0.6260
100.50.96.228,<->,8.252.223.153,0,0,11,5013,11,5013,0.022526000,1.6733
215.158.238.64,<->,33.209.217.230,11,6154,0,0,11,6154,0.022000000,1.8777
99.75.190.89,<->,8.55.237.110,11,5618,0,0,11,5618,0.020454000,0.1741
120.171.208.194,<->,35.56.98.220,0,0,11,1336,11,1336,0.020147000,1.5395
98.230.213.115,<->,8.182.244.237,0,0,11,1737,11,1737,0.019579000,0.4478
134.5.66.105,<->,109.222.250.46,0,0,11,709,11,709,0.019412000,1.9522
143.10.144.64,<->,136.25.188.255,0,0,11,1411,11,1411,0.019028000,0.6303
249.101.100.85,<->,53.230.38.130,11,15197,0,0,11,15197,0.018753000,0.0000
139.163.96.94,<->,130.97.61.143,11,550,0,0,11,550,0.018428000,1.9644
136.25.188.253,<->,99.192.168.187,11,4020,0,0,11,4020,0.017924000,1.4759
136.25.189.15,<->,131.2.102.25,11,4679,0,0,11,4679,0.017796000,1.3506
8.252.223.115,<->,8.240.116.229,11,3707,0,0,11,3707,0.016509000,1.9637
158.85.50.137,<->,133.178.227.16,0,0,11,3820,11,3820,0.015870000,1.8020
192.64.199.47,<->,125.14.105.156,11,820,0,0,11,820,0.015431000,1.9047
133.178.226.25,<->,96.155.60.255,11,3314,0,0,11,3314,0.014011000,1.7912
215.158.239.51,<->,196.89.123.50,11,728,0,0,11,728,0.013913000,1.1154
133.178.227.8,<->,133.56.180.53,11,5280,0,0,11,5280,0.013824000,1.9593
100.94.152.199,<->,89.155.61.122,11,1741,0,0,11,1741,0.012015000,1.3167
139.193.141.128,<->,129.225.2.237,11,616,0,0,11,616,0.011500000,1.9071
215.158.239.99,<->,199.20.28.70,11,673,0,0,11,673,0.011278000,0.0400
136.25.189.32,<->,126.219.49.10,11,4263,0,0,11,4263,0.010343000,1.4595
195.21.173.113,<->,50.223.3.228,0,0,11,556,11,556,0.010031000,1.9724
76.179.107.76,<->,8.252.222.77,0,0,11,914,11,914,0.009261000,0.5894
220.20.200.16,<->,144.83.60.136,11,15501,0,0,11,15501,0.009226000,0.0004
136.25.188.45,<->,91.247.40.77,11,4306,0,0,11,4306,0.008801000,1.8483
43.52.17.33,<->,8.252.221.204,0,0,11,1360,11,1360,0.007650000,1.7664
89.155.31.210,<->,8.183.25.124,0,0,11,945,11,945,0.007502000,0.3207
215.158.239.68,<->,199.20.22.50,11,2090,0,0,11,2090,0.007472000,1.3491
194.195.113.100,<->,50.223.3.228,0,0,11,604,11,604,0.007441000,1.8670
138.98.233.218,<->,111.169.196.215,11,616,0,0,11,616,0.006885000,1.7701
215.158.239.85,<->,196.93.233.5,11,616,0,0,11,616,0.006548000,0.5614
136.25.189.82,<->,126.219.194.73,11,4953,0,0,11,4953,0.006334000,1.8211
111.14.251.154,<->,8.182.243.141,0,0,11,1115,11,1115,0.006110000,1.8646
246.253.134.209,<->,199.9.92.253,11,3969,0,0,11,3969,0.005972000,0.8317
215.158.239.85,<->,131.2.102.9,11,5724,0,0,11,5724,0.005874000,1.7978
202.178.8.195,<->,144.64.139.42,0,0,11,550,11,550,0.005773000,0.0027
144.85.170.244,<->,98.87.144.84,11,616,0,0,11,616,0.005206000,0.1818
136.25.188.239,<->,50.147.180.226,11,616,0,0,11,616,0.003857000,0.0018
141.84.51.10,<->,8.252.221.205,0,0,11,954,11,954,0.003513000,1.0790
136.25.189.33,<->,96.156.169.194,11,4439,0,0,11,4439,0.003193000,1.7585
215.158.239.33,<->,126.219.102.199,11,3512,0,0,11,3512,0.003082000,0.7937
99.187.125.151,<->,8.20.87.11,0,0,11,11372,11,11372,0.003055000,1.4857
136.25.188.198,<->,33.209.217.239,11,4688,0,0,11,4688,0.003034000,1.7228
195.55.16.25,<->,136.25.188.253,0,0,11,724,11,724,0.001686000,1.2533
199.122.244.8,<->,136.25.188.162,0,0,11,924,11,924,0.000916000,0.2188
220.28.108.254,<->,215.158.238.232,0,0,10,13911,10,13911,1.983421000,0.0000
136.25.188.220,<->,133.183.252.51,10,1642,0,0,10,1642,1.883760000,0.1022
17.143.152.222,<->,8.220.190.86,0,0,10,2317,10,2317,1.882420000,0.1092
129.225.141.239,<->,129.225.132.96,0,0,10,10731,10,10731,1.878967000,0.1011
121.166.87.142,<->,80.38.39.172,0,0,10,500,10,500,1.863700000,0.0011
139.47.193.207,<->,101.224.89.249,0,0,10,11081,10,11081,1.860455000,0.0172
220.20.200.8,<->,144.83.60.153,10,5219,0,0,10,5219,1.831251000,0.1489
215.158.239.240,<->,54.50.105.135,10,5603,0,0,10,5603,1.826499000,0.1713
193.21.29.218,<->,99.75.112.7,0,0,10,13521,10,13521,1.816147000,0.0001
129.254.96.7,<->,80.38.33.214,0,0,10,4982,10,4982,1.813949000,0.1399
207.239.110.42,<->,136.25.188.222,0,0,10,560,10,560,1.812535000,0.1631
133.178.226.98,<->,8.191.15.144,10,3486,0,0,10,3486,1.811255000,0.1035
144.85.170.208,<->,98.87.145.175,10,1216,0,0,10,1216,1.778840000,0.2087
133.178.227.2,<->,8.219.184.156,10,1653,0,0,10,1653,1.774748000,0.0689
215.158.239.59,<->,196.90.32.49,10,560,0,0,10,560,1.770907000,0.0001
215.158.238.83,<->,8.191.15.28,10,1749,0,0,10,1749,1.751268000,0.0248
132.240.84.216,<->,80.27.159.58,0,0,10,1692,10,1692,1.747175000,0.1801
129.236.115.161,<->,111.20.168.123,0,0,10,1718,10,1718,1.742860000,0.0646
136.25.188.225,<->,97.80.224.204,10,900,0,0,10,900,1.736759000,0.1642
145.252.114.15,<->,109.31.72.114,10,956,0,0,10,956,1.730279000,0.1143
215.158.239.74,<->,100.216.78.145,10,13758,0,0,10,13758,1.704946000,0.2523
215.158.195.89,<->,126.219.137.61,10,12760,0,0,10,12760,1.689538000,0.0004
215.158.195.38,<->,126.219.137.61,10,12760,0,0,10,12760,1.688194000,0.0003
133.178.226.37,<->,91.57.162.253,10,1845,0,0,10,1845,1.684935000,0.2006
143.132.37.51,<->,136.25.188.177,0,0,10,791,10,791,1.673544000,0.2950
133.178.226.60,<->,57.227.83.185,10,1653,0,0,10,1653,1.668129000,0.1251
129.19.150.122,<->,50.224.108.164,0,0,10,1172,10,1172,1.655250000,0.3317
101.224.178.156,<->,8.182.253.231,0,0,10,560,10,560,1.654576000,0.1162
218.147.52.203,<->,8.176.58.168,0,0,10,3184,10,3184,1.652214000,0.1363
215.158.239.82,<->,80.57.141.131,10,5558,0,0,10,5558,1.637820000,0.2075
195.124.55.155,<->,136.25.188.226,0,0,10,1277,10,1277,1.625068000,0.3199
199.122.49.168,<->,136.25.188.225,0,0,10,1269,10,1269,1.623188000,0.2648
255.17.29.128,<->,8.220.205.146,0,0,10,2229,10,2229,1.622870000,0.3451
133.178.226.93,<->,98.219.126.140,10,11776,0,0,10,11776,1.614294000,0.0287
94.192.236.19,<->,8.252.221.205,0,0,10,950,10,950,1.609074000,0.3853
144.88.76.130,<->,53.231.73.123,10,5100,0,0,10,5100,1.609003000,0.3754
133.178.226.254,<->,111.150.74.50,10,9841,0,0,10,9841,1.608058000,0.2554
215.158.239.79,<->,204.56.177.45,10,2212,0,0,10,2212,1.571037000,0.4189
221.101.9.49,<->,145.185.253.130,10,1774,0,0,10,1774,1.561023000,0.3262
215.158.238.188,<->,192.226.161.159,10,1580,0,0,10,1580,1.542971000,0.2471
133.178.226.77,<->,106.188.236.229,10,2954,0,0,10,2954,1.534656000,0.2452
56.8.135.115,<->,8.182.139.168,0,0,10,921,10,921,1.529580000,0.1135
133.178.226.61,<->,116.99.180.166,10,1853,0,0,10,1853,1.525634000,0.3592
215.158.61.189,<->,8.176.8.206,0,0,10,7993,10,7993,1.518899000,0.4122
212.70.3.113,<->,136.25.188.178,0,0,10,1718,10,1718,1.509113000,0.4236
215.158.239.95,<->,194.202.160.71,10,636,0,0,10,636,1.507962000,0.1000
143.79.133.25,<->,136.25.188.252,0,0,10,1045,10,1045,1.507262000,0.4921
99.124.166.199,<->,8.52.183.96,0,0,10,702,10,702,1.485619000,0.4515
215.158.238.82,<->,142.234.196.171,10,2970,0,0,10,2970,1.471701000,0.3102
144.85.170.208,<->,98.87.147.120,10,1210,0,0,10,1210,1.470453000,0.3394
133.178.227.57,<->,29.211.6.94,10,3210,0,0,10,3210,1.465701000,0.5292
136.25.188.172,<->,8.255.92.234,10,3162,0,0,10,3162,1.464594000,0.1747
220.20.200.179,<->,144.83.60.138,10,5401,0,0,10,5401,1.459211000,0.1880
199.122.47.65,<->,136.25.188.163,0,0,10,2146,10,2146,1.452708000,0.5442
221.102.56.46,<->,109.0.228.33,0,0,10,2810,10,2810,1.450367000,0.1274
215.158.239.79,<->,199.122.172.88,10,1841,0,0,10,1841,1.444829000,0.5219
195.5.151.25,<->,136.25.188.252,0,0,10,1841,10,1841,1.441118000,0.3321
210.229.231.45,<->,210.229.230.19,0,0,10,640,10,640,1.435324000,0.2728
215.158.239.94,<->,145.13.164.171,10,5668,0,0,10,5668,1.433130000,0.5519
199.73.33.102,<->,136.25.188.241,0,0,10,1403,10,1403,1.432014000,0.5152
136.25.189.53,<->,96.156.169.224,10,10790,0,0,10,10790,1.431134000,0.2959
142.252.3.127,<->,136.25.188.199,0,0,10,2961,10,2961,1.419192000,0.5456
215.158.239.85,<->,143.128.132.244,10,500,0,0,10,500,1.411956000,0.0128
204.200.44.112,<->,136.25.188.197,0,0,10,1679,10,1679,1.411287000,0.5569
98.156.229.198,<->,8.183.25.25,0,0,10,1264,10,1264,1.407204000,0.2679
223.114.90.164,<->,8.252.221.199,0,0,10,921,10,921,1.404156000,0.3341
17.41.129.123,<->,8.53.0.16,0,0,10,1498,10,1498,1.396406000,0.5912
215.158.30.219,<->,8.252.222.34,0,0,10,7974,10,7974,1.385814000,0.4744
119.111.182.129,<->,101.224.206.46,0,0,10,967,10,967,1.374312000,0.6099
82.195.7.180,<->,8.228.209.115,0,0,10,6736,10,6736,1.367878000,0.2458
207.236.166.125,<->,136.25.188.173,0,0,10,970,10,970,1.359412000,0.6259
215.158.239.77,<->,142.221.81.26,10,560,0,0,10,560,1.359267000,0.0146
199.15.1.146,<->,136.25.188.53,0,0,10,752,10,752,1.348083000,0.6372
215.158.238.134,<->,193.39.69.168,10,1557,0,0,10,1557,1.344092000,0.1926
207.190.79.1,<->,136.25.188.239,0,0,10,1234,10,1234,1.342346000,0.5691
197.113.99.228,<->,136.25.188.176,0,0,10,2315,10,2315,1.341750000,0.4000
207.57.193.77,<->,136.25.188.220,0,0,10,2099,10,2099,1.341192000,0.6362
136.25.188.213,<->,80.57.141.206,10,7734,0,0,10,7734,1.340560000,0.1713
192.67.159.55,<->,88.152.234.41,10,520,0,0,10,520,1.334886000,0.6220
142.220.219.246,<->,136.25.188.46,0,0,10,2291,10,2291,1.321888000,0.6765
91.48.164.164,<->,8.52.226.56,0,0,10,4726,10,4726,1.320683000,0.5584
8.52.183.207,<->,6.16.234.145,10,1640,0,0,10,1640,1.320527000,0.3185
8.52.180.162,<->,6.228.47.149,10,1780,0,0,10,1780,1.318765000,0.4801
145.3.163.230,<->,136.25.188.253,0,0,10,1447,10,1447,1.315186000,0.6706
139.163.16.203,<->,50.56.118.190,10,4708,0,0,10,4708,1.308976000,0.3920
111.20.168.122,<->,101.224.91.211,10,1246,0,0,10,1246,1.307441000,0.0276
213.186.61.57,<->,144.85.170.208,0,0,10,1259,10,1259,1.307028000,0.2099
231.140.186.59,<->,215.158.239.87,0,0,10,2204,10,2204,1.304206000,0.5029
91.250.161.24,<->,0.195.210.42,0,0,10,1536,10,1536,1.298700000,0.5396
136.25.188.211,<->,69.132.194.105,10,1861,0,0,10,1861,1.295817000,0.4548
210.236.203.57,<->,91.231.193.139,0,0,10,939,10,939,1.286973000,0.1595
215.158.239.55,<->,98.219.126.175,10,14020,0,0,10,14020,1.286554000,0.5595
220.55.106.26,<->,105.67.223.235,10,3726,0,0,10,3726,1.285791000,0.5814
136.25.188.178,<->,95.99.148.203,10,1958,0,0,10,1958,1.275081000,0.6347
206.103.215.23,<->,136.25.189.15,0,0,10,1845,10,1845,1.274539000,0.4458
215.158.140.87,<->,83.226.246.109,10,1598,0,0,10,1598,1.269158000,0.3378
143.18.198.122,<->,8.182.224.87,0,0,10,1619,10,1619,1.267177000,0.6747
133.178.226.90,<->,131.36.198.20,10,1637,0,0,10,1637,1.266648000,0.6589
139.193.141.139,<->,50.149.195.148,10,1138,0,0,10,1138,1.261732000,0.3162
248.225.25.84,<->,53.231.144.231,10,5654,0,0,10,5654,1.252482000,0.1993
243.49.81.35,<->,192.66.158.212,0,0,10,11630,10,11630,1.252180000,0.7091
109.222.199.189,<->,0.195.212.152,10,8406,0,0,10,8406,1.247647000,0.0545
215.158.140.207,<->,8.222.7.170,10,2198,0,0,10,2198,1.232828000,0.2125
142.236.202.155,<->,136.25.188.178,0,0,10,1430,10,1430,1.232487000,0.2587
111.14.241.152,<->,8.183.25.124,0,0,10,1609,10,1609,1.229497000,0.2905
195.6.62.22,<->,136.25.188.178,0,0,10,1988,10,1988,1.227175000,0.3974
215.158.238.92,<->,201.136.143.26,10,1573,0,0,10,1573,1.215913000,0.2474
8.183.25.25,<->,6.33.17.20,10,1274,0,0,10,1274,1.213421000,0.4392
142.228.165.122,<->,136.25.188.209,0,0,10,1627,10,1627,1.207924000,0.7064
204.185.182.19,<->,136.25.188.225,0,0,10,1253,10,1253,1.202069000,0.3883
220.60.81.155,<->,215.158.239.78,0,0,10,7097,10,7097,1.200687000,0.6231
215.158.127.14,<->,99.74.26.99,0,0,10,6199,10,6199,1.192551000,0.1717
136.141.45.155,<->,101.70.127.50,0,0,10,4046,10,4046,1.190543000,0.1587
140.78.204.46,<->,0.195.210.8,0,0,10,1417,10,1417,1.189278000,0.7228
239.66.46.155,<->,159.137.235.224,0,0,10,803,10,803,1.186659000,0.2883
215.158.238.134,<->,111.151.70.38,10,2826,0,0,10,2826,1.185112000,0.6245
215.158.239.58,<->,199.106.41.213,10,1720,0,0,10,1720,1.182246000,0.8099
138.121.99.24,<->,8.220.200.124,0,0,10,2089,10,2089,1.177380000,0.7642
245.227.234.55,<->,8.182.224.248,0,0,10,1128,10,1128,1.174091000,0.6209
215.158.239.40,<->,120.155.14.85,10,1818,0,0,10,1818,1.172004000,0.2127
215.158.238.141,<->,113.23.117.105,10,2506,0,0,10,2506,1.159899000,0.3714
215.158.239.101,<->,129.222.39.211,10,5684,0,0,10,5684,1.154860000,0.7928
235.42.34.40,<->,215.158.238.67,0,0,10,1781,10,1781,1.142295000,0.3779
215.158.238.95,<->,133.73.194.32,10,560,0,0,10,560,1.130676000,0.1244
144.87.238.89,<->,8.182.136.146,0,0,10,973,10,973,1.109830000,0.0697
215.158.238.141,<->,131.144.113.180,10,1765,0,0,10,1765,1.109414000,0.7168
215.158.239.92,<->,207.239.52.13,10,1453,0,0,10,1453,1.105180000,0.1924
215.158.61.182,<->,8.176.8.195,0,0,10,12359,10,12359,1.104587000,0.8061
207.56.100.244,<->,136.25.188.222,0,0,10,2065,10,2065,1.092021000,0.8923
145.252.126.224,<->,42.140.56.190,10,1046,0,0,10,1046,1.089781000,0.8774
159.117.147.237,<->,92.162.253.191,0,0,10,14622,10,14622,1.086775000,0.0711
213.186.52.66,<->,144.85.170.208,0,0,10,1238,10,1238,1.085721000,0.1919
159.57.90.83,<->,109.222.201.90,0,0,10,6374,10,6374,1.079963000,0.2791
220.38.162.21,<->,215.158.238.109,0,0,10,6116,10,6116,1.079227000,0.5633
221.102.103.73,<->,207.200.207.65,10,1292,0,0,10,1292,1.064228000,0.7964
142.255.40.123,<->,136.25.188.227,0,0,10,1409,10,1409,1.062278000,0.7715
139.163.7.204,<->,130.79.84.77,10,831,0,0,10,831,1.059484000,0.4557
215.158.239.105,<->,215.158.61.145,10,7238,0,0,10,7238,1.055384000,0.7984
215.158.239.79,<->,143.13.245.216,10,891,0,0,10,891,1.054815000,0.7130
207.46.243.242,<->,92.27.219.39,0,0,10,11088,10,11088,1.048080000,0.9449
204.2.36.142,<->,136.25.188.54,0,0,10,1071,10,1071,1.047359000,0.9213
133.178.226.90,<->,119.196.23.42,10,2874,0,0,10,2874,1.046887000,0.8441
136.25.189.23,<->,96.156.169.250,10,7812,0,0,10,7812,1.045704000,0.7394
215.158.238.113,<->,57.227.82.229,10,3114,0,0,10,3114,1.044863000,0.8230
95.247.101.226,<->,8.252.221.238,0,0,10,530,10,530,1.043761000,0.9419
207.93.182.223,<->,8.182.250.65,0,0,10,1194,10,1194,1.040271000,0.8813
204.187.230.96,<->,136.25.188.176,0,0,10,2145,10,2145,1.034360000,0.8991
205.224.35.9,<->,139.193.141.207,0,0,10,1493,10,1493,1.031549000,0.3847
215.158.140.229,<->,68.231.10.151,10,2790,0,0,10,2790,1.028950000,0.7884
142.207.78.16,<->,136.25.188.178,0,0,10,1818,10,1818,1.027239000,0.8850
198.204.76.245,<->,136.25.189.2,0,0,10,1877,10,1877,1.026231000,0.1558
143.134.208.181,<->,136.25.188.224,0,0,10,1884,10,1884,1.026075000,0.8960
215.158.239.96,<->,143.42.77.50,10,1394,0,0,10,1394,1.023892000,0.2035
215.158.238.33,<->,156.181.149.251,10,3146,0,0,10,3146,1.017495000,0.8584
136.25.189.80,<->,8.222.98.139,10,5476,0,0,10,5476,1.013211000,0.6584
97.53.94.59,<->,8.182.239.190,0,0,10,1382,10,1382,1.010435000,0.2118
215.158.239.249,<->,8.191.15.144,10,4244,0,0,10,4244,1.008911000,0.9027
133.178.227.70,<->,128.194.247.63,10,2542,0,0,10,2542,1.007254000,0.9575
142.206.31.176,<->,136.25.188.209,0,0,10,2068,10,2068,1.006913000,0.9762
133.178.227.115,<->,111.151.109.27,10,560,0,0,10,560,1.006297000,0.0003
142.182.132.200,<->,136.25.188.239,0,0,10,1393,10,1393,1.001739000,0.3641
215.158.239.76,<->,204.3.241.178,10,650,0,0,10,650,1.000103000,0.7493
215.158.239.7,<->,29.211.5.198,10,3444,0,0,10,3444,1.000004000,0.6810
50.224.76.235,<->,29.211.4.107,10,1292,0,0,10,1292,0.995539000,0.2710
204.200.43.159,<->,136.25.188.225,0,0,10,1518,10,1518,0.995297000,0.2717
215.158.239.69,<->,38.104.11.1,10,5492,0,0,10,5492,0.995170000,0.8519
215.158.238.221,<->,158.85.50.84,10,2698,0,0,10,2698,0.994833000,0.9811
215.158.239.33,<->,113.93.9.19,10,3808,0,0,10,3808,0.993858000,0.3440
224.100.216.216,<->,92.162.253.44,0,0,10,9472,10,9472,0.991609000,0.3107
246.253.198.33,<->,198.114.103.82,10,4163,0,0,10,4163,0.990096000,0.5917
207.236.29.192,<->,136.25.188.209,0,0,10,1512,10,1512,0.988350000,0.9003
145.236.82.22,<->,8.52.176.86,0,0,10,890,10,890,0.982619000,0.4147
136.25.188.241,<->,26.253.31.168,10,1643,0,0,10,1643,0.982004000,0.4403
215.158.61.238,<->,8.252.221.166,0,0,10,7375,10,7375,0.980358000,0.7457
193.53.171.164,<->,144.64.139.133,0,0,10,670,10,670,0.978897000,0.3600
139.193.141.139,<->,113.130.29.26,10,1720,0,0,10,1720,0.977001000,0.3436
142.244.204.243,<->,136.25.188.178,0,0,10,2070,10,2070,0.975946000,0.9518
215.158.239.97,<->,199.80.212.113,10,1579,0,0,10,1579,0.973006000,0.9615
75.214.236.212,<->,8.252.221.230,0,0,10,985,10,985,0.962437000,0.7630
215.158.239.97,<->,143.42.79.210,10,1968,0,0,10,1968,0.951648000,0.9629
195.7.114.141,<->,136.25.188.220,0,0,10,3636,10,3636,0.951439000,0.9989
215.158.238.251,<->,33.209.217.37,10,3844,0,0,10,3844,0.951416000,1.0015
195.13.78.57,<->,136.25.188.53,0,0,10,672,10,672,0.945740000,1.0037
207.193.110.84,<->,50.223.3.228,0,0,10,512,10,512,0.941892000,0.9253
89.90.113.239,<->,82.231.227.44,0,0,10,4427,10,4427,0.938014000,0.1699
215.158.238.190,<->,8.191.7.104,10,5634,0,0,10,5634,0.927023000,0.9681
215.158.238.223,<->,106.188.251.53,10,1893,0,0,10,1893,0.925970000,0.3902
133.178.227.2,<->,72.23.148.212,10,3258,0,0,10,3258,0.921687000,0.8242
111.20.172.118,<->,33.233.141.34,0,0,10,10228,10,10228,0.916000000,0.6624
215.158.239.58,<->,199.20.31.129,10,1838,0,0,10,1838,0.914347000,0.8299
220.20.200.131,<->,121.105.194.40,10,7203,0,0,10,7203,0.914271000,0.7322
136.25.189.82,<->,29.209.59.175,10,5248,0,0,10,5248,0.914240000,0.9125
215.158.103.203,<->,54.35.184.63,10,4260,0,0,10,4260,0.912790000,0.6587
215.158.239.83,<->,80.57.141.227,10,6790,0,0,10,6790,0.911863000,0.1008
215.158.238.106,<->,113.23.104.220,10,598,0,0,10,598,0.908730000,0.1643
159.178.74.181,<->,8.52.189.207,0,0,10,1438,10,1438,0.903274000,0.2243
215.158.239.42,<->,131.95.192.249,10,4691,0,0,10,4691,0.901588000,1.0742
133.54.26.241,<->,27.117.140.41,10,884,0,0,10,884,0.887712000,0.7342
215.158.238.251,<->,8.53.217.178,10,2613,0,0,10,2613,0.887509000,0.7920
196.251.77.66,<->,8.252.222.176,0,0,10,1694,10,1694,0.886454000,0.9421
215.158.238.75,<->,148.55.210.235,10,1845,0,0,10,1845,0.883898000,0.2563
215.158.239.113,<->,129.222.36.45,10,2417,0,0,10,2417,0.881803000,1.1113
204.200.43.159,<->,136.25.188.236,0,0,10,1519,10,1519,0.881346000,0.3956
100.228.42.61,<->,57.49.185.65,10,4116,0,0,10,4116,0.878729000,0.4579
136.109.109.253,<->,100.228.42.41,0,0,10,9966,10,9966,0.877653000,0.4991
110.16.211.248,<->,50.224.76.235,0,0,10,4904,10,4904,0.875824000,0.1602
215.158.239.232,<->,144.22.87.63,10,11733,0,0,10,11733,0.861344000,0.0637
215.158.140.76,<->,131.219.230.225,10,1548,0,0,10,1548,0.856490000,0.1540
215.158.238.82,<->,104.3.161.84,10,4367,0,0,10,4367,0.856401000,0.8880
215.158.238.98,<->,131.36.198.59,10,4722,0,0,10,4722,0.848331000,1.0349
215.158.238.186,<->,215.158.43.14,10,1116,0,0,10,1116,0.840425000,0.2764
199.121.85.206,<->,136.25.188.253,0,0,10,1350,10,1350,0.839809000,0.4230
215.158.239.87,<->,194.237.195.187,10,2062,0,0,10,2062,0.839612000,0.9677
220.28.108.254,<->,133.178.227.73,0,0,10,1896,10,1896,0.836676000,0.9972
58.168.69.30,<->,8.252.222.38,0,0,10,1788,10,1788,0.836032000,0.3604
136.25.189.1,<->,80.56.79.51,10,4607,0,0,10,4607,0.832523000,0.9666
192.226.161.99,<->,136.25.188.223,0,0,10,2922,10,2922,0.829636000,0.9955
215.158.238.93,<->,149.163.129.232,10,1729,0,0,10,1729,0.828193000,0.3658
142.190.18.27,<->,136.25.188.209,0,0,10,2062,10,2062,0.821667000,0.9128
212.116.196.137,<->,8.182.226.42,0,0,10,1100,10,1100,0.820259000,0.5819
215.158.239.50,<->,207.166.169.32,10,560,0,0,10,560,0.808621000,0.7444
215.158.239.79,<->,199.20.4.65,10,1595,0,0,10,1595,0.808306000,0.8101
215.158.239.112,<->,111.151.237.68,10,11143,0,0,10,11143,0.806784000,0.1001
215.158.238.45,<->,128.123.91.50,10,1733,0,0,10,1733,0.803659000,0.4632
215.158.238.21,<->,122.158.245.26,10,3318,0,0,10,3318,0.803490000,0.5948
215.158.239.85,<->,195.126.100.110,10,1621,0,0,10,1621,0.803031000,0.8877
82.231.227.39,<->,8.55.221.134,10,5041,0,0,10,5041,0.785482000,0.1542
204.2.22.159,<->,136.25.188.196,0,0,10,2109,10,2109,0.773908000,1.0318
215.158.239.93,<->,196.88.133.137,10,796,0,0,10,796,0.773079000,0.5769
215.158.239.34,<->,29.211.5.198,10,3168,0,0,10,3168,0.770721000,0.4695
215.158.239.76,<->,207.167.190.198,10,1285,0,0,10,1285,0.768797000,0.8999
215.158.239.97,<->,199.20.28.90,10,1596,0,0,10,1596,0.768296000,0.9599
215.158.238.92,<->,131.144.116.202,10,3018,0,0,10,3018,0.760190000,0.8513
215.158.238.250,<->,8.240.116.162,10,5814,0,0,10,5814,0.758090000,1.1961
215.158.140.241,<->,193.39.68.239,10,3685,0,0,10,3685,0.758067000,0.7538
140.15.123.30,<->,0.195.210.42,0,0,10,560,10,560,0.757046000,0.3148
215.158.140.229,<->,100.50.96.215,10,2655,0,0,10,2655,0.751043000,0.6240
204.200.34.7,<->,136.25.188.177,0,0,10,2035,10,2035,0.746408000,0.6527
215.158.239.87,<->,195.54.47.3,10,1400,0,0,10,1400,0.744017000,0.9951
215.158.238.92,<->,29.214.73.165,10,1701,0,0,10,1701,0.743394000,1.1259
199.121.243.169,<->,136.25.188.220,0,0,10,1786,10,1786,0.734319000,0.6558
142.240.56.53,<->,136.25.188.46,0,0,10,2075,10,2075,0.732763000,0.7963
246.253.253.107,<->,100.108.23.169,10,1143,0,0,10,1143,0.728870000,0.0954
231.140.220.234,<->,136.25.188.53,0,0,10,1562,10,1562,0.728158000,0.9403
109.222.198.150,<->,56.114.235.120,10,5325,0,0,10,5325,0.720652000,0.3102
139.36.120.249,<->,101.224.207.61,0,0,10,4293,10,4293,0.719314000,0.6057
193.51.144.28,<->,109.1.35.91,0,0,10,1190,10,1190,0.719089000,0.7985
142.223.171.101,<->,136.25.188.227,0,0,10,2072,10,2072,0.717754000,1.1002
215.158.239.76,<->,207.191.224.128,10,1403,0,0,10,1403,0.713847000,0.5349
215.158.238.129,<->,139.163.161.50,10,1918,0,0,10,1918,0.707628000,0.5758
246.253.198.51,<->,119.119.129.12,10,504,0,0,10,504,0.707551000,0.7741
215.158.238.66,<->,106.188.183.217,10,5143,0,0,10,5143,0.706304000,1.2335
133.178.227.108,<->,41.161.45.58,10,1048,0,0,10,1048,0.701203000,0.2191
220.28.85.14,<->,215.158.239.62,0,0,10,13135,10,13135,0.694247000,0.0001
215.158.238.120,<->,104.154.137.226,10,3066,0,0,10,3066,0.693269000,1.0936
249.85.97.100,<->,56.121.39.173,0,0,10,3989,10,3989,0.688166000,0.3770
215.158.239.30,<->,8.252.253.225,10,4982,0,0,10,4982,0.687097000,1.1209
156.156.131.245,<->,8.252.221.198,0,0,10,524,10,524,0.683943000,1.3152
144.72.195.98,<->,100.92.3.121,0,0,10,5164,10,5164,0.682704000,0.2576
220.20.200.133,<->,121.105.194.40,10,7198,0,0,10,7198,0.681001000,0.3767
215.158.238.113,<->,57.247.184.208,10,3002,0,0,10,3002,0.680774000,0.4799
136.25.189.17,<->,29.209.59.199,10,6633,0,0,10,6633,0.680654000,1.1858
207.56.138.208,<->,136.25.188.173,0,0,10,2043,10,2043,0.673604000,1.2265
199.68.125.1,<->,136.25.188.209,0,0,10,1269,10,1269,0.673266000,0.2734
215.158.140.217,<->,112.235.95.54,10,896,0,0,10,896,0.670049000,0.3238
220.28.104.193,<->,215.158.239.53,0,0,10,7314,10,7314,0.669866000,0.3501
143.128.118.67,<->,136.25.188.175,0,0,10,950,10,950,0.669225000,0.8105
215.158.239.93,<->,136.139.59.117,10,5300,0,0,10,5300,0.668257000,1.3254
136.25.189.77,<->,80.56.79.5,10,4556,0,0,10,4556,0.662998000,0.9574
243.117.36.147,<->,89.183.110.72,0,0,10,1336,10,1336,0.662755000,0.6205
215.158.238.198,<->,114.94.161.247,10,3776,0,0,10,3776,0.658700000,1.2741
232.31.110.202,<->,97.198.118.56,0,0,10,1260,10,1260,0.652803000,0.5106
232.31.43.150,<->,97.198.118.56,0,0,10,1367,10,1367,0.651868000,0.3717
195.41.136.79,<->,136.25.188.45,0,0,10,1637,10,1637,0.649304000,1.2946
215.158.239.70,<->,199.20.31.215,10,1611,0,0,10,1611,0.647012000,1.1506
133.178.226.23,<->,96.155.60.254,10,3258,0,0,10,3258,0.646686000,1.3509
143.10.156.243,<->,136.25.188.255,0,0,10,1066,10,1066,0.646078000,1.2082
138.121.99.24,<->,8.220.188.50,0,0,10,2656,10,2656,0.645116000,1.1367
215.158.238.82,<->,122.159.245.156,10,3146,0,0,10,3146,0.645098000,1.0823
215.158.239.56,<->,142.221.50.164,10,2073,0,0,10,2073,0.642808000,0.9211
92.27.27.174,<->,18.200.16.20,10,526,0,0,10,526,0.638330000,1.2800
143.53.4.153,<->,136.25.188.255,0,0,10,2079,10,2079,0.636409000,0.7630
8.253.128.41,<->,8.252.222.204,0,0,10,3514,10,3514,0.633178000,1.3654
239.66.104.49,<->,97.198.118.56,0,0,10,1291,10,1291,0.628940000,0.3755
136.25.189.196,<->,129.222.39.150,10,3121,0,0,10,3121,0.627682000,0.5752
109.1.58.226,<->,103.115.97.227,10,1193,0,0,10,1193,0.626752000,0.9639
206.103.215.215,<->,136.25.189.32,0,0,10,2063,10,2063,0.625460000,0.3900
215.158.239.93,<->,196.107.127.197,10,1414,0,0,10,1414,0.619859000,0.4515
215.158.239.57,<->,204.0.192.205,10,560,0,0,10,560,0.618882000,1.3111
215.158.238.95,<->,69.31.239.5,10,2970,0,0,10,2970,0.615948000,1.1421
215.158.239.70,<->,207.239.242.80,10,1794,0,0,10,1794,0.615574000,0.7433
203.114.24.27,<->,136.25.188.237,0,0,10,1978,10,1978,0.614982000,1.0193
215.158.238.190,<->,131.144.116.39,10,3581,0,0,10,3581,0.613247000,1.0055
193.51.144.28,<->,80.40.11.116,0,0,10,1055,10,1055,0.613218000,0.8835
192.64.244.21,<->,8.45.175.31,10,8205,0,0,10,8205,0.612231000,0.2075
139.163.96.127,<->,74.71.40.209,10,572,0,0,10,572,0.604475000,1.3090
136.25.188.239,<->,57.210.107.8,10,1749,0,0,10,1749,0.596572000,0.1706
136.25.189.14,<->,126.219.194.74,10,4175,0,0,10,4175,0.594804000,0.9874
136.25.188.253,<->,56.99.122.10,10,1219,0,0,10,1219,0.592170000,0.9497
215.158.239.50,<->,207.114.255.71,10,1411,0,0,10,1411,0.589901000,0.5905
247.127.88.19,<->,221.102.108.186,0,0,10,7772,10,7772,0.583591000,0.7451
215.158.238.68,<->,139.163.161.50,10,2807,0,0,10,2807,0.580663000,1.3183
215.158.61.202,<->,8.176.8.104,0,0,10,8254,10,8254,0.579626000,1.0756
192.228.25.179,<->,133.178.226.234,0,0,10,12556,10,12556,0.574325000,1.0011
139.163.95.3,<->,97.227.196.236,10,1040,0,0,10,1040,0.572367000,0.0927
197.113.99.188,<->,136.25.188.176,0,0,10,560,10,560,0.567971000,0.2292
111.147.237.123,<->,0.195.218.61,10,1166,0,0,10,1166,0.565815000,1.3497
109.1.51.20,<->,40.215.63.180,10,622,0,0,10,622,0.565370000,0.9533
139.163.167.38,<->,133.178.226.246,0,0,10,11389,10,11389,0.563248000,1.0828
220.39.233.180,<->,136.25.188.197,0,0,10,4059,10,4059,0.561573000,1.2829
145.186.84.51,<->,54.37.245.208,10,7755,0,0,10,7755,0.557462000,0.6770
137.129.0.243,<->,129.47.117.200,10,5945,0,0,10,5945,0.555644000,1.3405
133.178.226.28,<->,131.36.198.59,10,4690,0,0,10,4690,0.552299000,1.3740
215.158.238.190,<->,126.219.101.159,10,3759,0,0,10,3759,0.550199000,1.4497
143.10.219.32,<->,136.25.188.176,0,0,10,2056,10,2056,0.545435000,0.6704
136.25.188.227,<->,57.210.107.16,10,4299,0,0,10,4299,0.544836000,0.9732
215.158.239.59,<->,199.20.29.164,10,1407,0,0,10,1407,0.536047000,0.8400
199.33.113.60,<->,136.25.188.253,0,0,10,1704,10,1704,0.535384000,0.7754
144.83.60.153,<->,92.162.253.68,0,0,10,13481,10,13481,0.532461000,0.0002
136.25.189.33,<->,116.106.46.86,10,1877,0,0,10,1877,0.528755000,0.2431
133.178.226.90,<->,126.219.247.1,10,3983,0,0,10,3983,0.528252000,1.0953
92.27.27.173,<->,48.111.250.235,10,520,0,0,10,520,0.525636000,1.3517
139.148.178.253,<->,8.182.253.40,0,0,10,1461,10,1461,0.525519000,0.0934
204.187.39.175,<->,136.25.188.238,0,0,10,1410,10,1410,0.525139000,0.3204
133.178.227.1,<->,8.219.184.95,10,2594,0,0,10,2594,0.520787000,0.9169
220.39.202.203,<->,215.158.238.54,0,0,10,3258,10,3258,0.518280000,1.2131
220.28.114.28,<->,133.178.227.61,0,0,10,7162,10,7162,0.515751000,1.3709
159.112.18.124,<->,0.195.210.46,0,0,10,2465,10,2465,0.515692000,0.6029
112.17.120.20,<->,50.224.108.163,0,0,10,648,10,648,0.514515000,1.2039
252.98.139.93,<->,210.209.251.211,10,1284,0,0,10,1284,0.513869000,0.1622
144.87.238.89,<->,8.182.243.208,0,0,10,1250,10,1250,0.511496000,0.4629
197.113.99.151,<->,136.25.188.174,0,0,10,596,10,596,0.508678000,0.7628
199.69.131.204,<->,136.25.188.255,0,0,10,800,10,800,0.505504000,1.3824
207.57.66.250,<->,136.25.188.209,0,0,10,506,10,506,0.501579000,1.4521
215.158.239.92,<->,195.43.81.103,10,1393,0,0,10,1393,0.495412000,0.3282
199.39.215.192,<->,136.25.188.163,0,0,10,2073,10,2073,0.490349000,0.6859
215.158.61.189,<->,8.176.8.205,0,0,10,6888,10,6888,0.488014000,1.4489
136.25.188.49,<->,80.57.141.130,10,6086,0,0,10,6086,0.486186000,0.0837
215.158.140.241,<->,57.97.102.151,10,1834,0,0,10,1834,0.484701000,0.2813
210.235.161.217,<->,144.79.46.244,10,11160,0,0,10,11160,0.480282000,0.9048
215.158.239.76,<->,199.20.28.113,10,1734,0,0,10,1734,0.477692000,1.1091
145.252.112.8,<->,117.9.165.149,10,640,0,0,10,640,0.477212000,1.2726
136.25.188.173,<->,50.49.94.154,10,2060,0,0,10,2060,0.472723000,0.3866
215.158.239.31,<->,122.29.158.171,10,4892,0,0,10,4892,0.471006000,1.3383
133.178.226.19,<->,80.47.111.90,10,6617,0,0,10,6617,0.466080000,1.4706
215.158.239.41,<->,8.252.253.227,10,3592,0,0,10,3592,0.465237000,1.2119
136.25.189.57,<->,96.135.155.31,10,5892,0,0,10,5892,0.458066000,1.3952
136.25.188.198,<->,126.219.194.182,10,2300,0,0,10,2300,0.457502000,0.7379
142.206.141.203,<->,136.25.188.236,0,0,10,977,10,977,0.456250000,0.8172
215.158.238.120,<->,143.155.227.57,10,1774,0,0,10,1774,0.454288000,0.6116
194.253.89.181,<->,8.252.222.179,0,0,10,1463,10,1463,0.452621000,1.3435
215.158.238.209,<->,8.192.205.0,10,2524,0,0,10,2524,0.452599000,0.6636
143.88.15.116,<->,133.178.227.200,0,0,10,1344,10,1344,0.442866000,1.2617
136.25.189.18,<->,29.212.180.201,10,4319,0,0,10,4319,0.439950000,1.3289
136.25.189.77,<->,96.156.169.235,10,4815,0,0,10,4815,0.438289000,0.7060
215.158.61.195,<->,8.176.8.251,0,0,10,12282,10,12282,0.432605000,0.6798
204.184.11.236,<->,136.25.188.239,0,0,10,2081,10,2081,0.431149000,0.7396
207.60.59.191,<->,136.25.188.177,0,0,10,952,10,952,0.430112000,1.4383
215.158.239.30,<->,106.188.184.70,10,3614,0,0,10,3614,0.427384000,1.5695
142.228.173.132,<->,136.25.188.225,0,0,10,500,10,500,0.421714000,0.0226
139.249.90.146,<->,100.120.38.6,10,4991,0,0,10,4991,0.419126000,1.2915
132.180.38.22,<->,8.220.202.4,0,0,10,893,10,893,0.418680000,0.1966
159.137.141.196,<->,134.240.235.240,10,1171,0,0,10,1171,0.412433000,0.3989
144.87.235.136,<->,137.83.182.31,10,500,0,0,10,500,0.410939000,1.3003
215.158.238.104,<->,6.116.31.30,10,3034,0,0,10,3034,0.410185000,0.6162
136.25.188.175,<->,8.42.43.23,10,4239,0,0,10,4239,0.407625000,1.5201
98.236.90.167,<->,53.83.207.25,10,7043,0,0,10,7043,0.406834000,0.2327
149.224.19.220,<->,97.198.118.56,0,0,10,1620,10,1620,0.405178000,0.3712
215.158.238.80,<->,116.107.47.35,10,1733,0,0,10,1733,0.402483000,0.2399
220.50.215.94,<->,50.224.80.75,0,0,10,888,10,888,0.399428000,1.3875
112.29.96.63,<->,50.224.76.235,0,0,10,4294,10,4294,0.398706000,0.3192
200.174.223.53,<->,53.68.64.193,10,668,0,0,10,668,0.392449000,1.5818
204.184.27.177,<->,136.25.188.253,0,0,10,621,10,621,0.392334000,0.9209
133.178.226.29,<->,99.192.168.180,10,4018,0,0,10,4018,0.392014000,1.5782
56.8.21.164,<->,8.182.141.52,0,0,10,1036,10,1036,0.390659000,0.4510
232.31.192.216,<->,97.198.118.56,0,0,10,1255,10,1255,0.388446000,0.3167
215.158.239.56,<->,199.20.28.194,10,1611,0,0,10,1611,0.387523000,1.2011
136.25.189.60,<->,56.28.207.205,10,5641,0,0,10,5641,0.386172000,1.0313
239.66.164.120,<->,97.198.118.56,0,0,10,1505,10,1505,0.384820000,0.4042
97.198.118.56,<->,27.11.142.84,10,1289,0,0,10,1289,0.383424000,0.5854
232.31.192.220,<->,97.198.118.56,0,0,10,1497,10,1497,0.383161000,0.9721
133.178.226.61,<->,8.179.43.9,10,2938,0,0,10,2938,0.382242000,1.0958
215.158.238.177,<->,68.231.26.200,10,5108,0,0,10,5108,0.381459000,1.5599
232.31.196.176,<->,97.198.118.56,0,0,10,1382,10,1382,0.381381000,0.3789
194.234.236.73,<->,136.25.188.243,0,0,10,1341,10,1341,0.377427000,1.5062
136.25.188.255,<->,57.227.83.169,10,1861,0,0,10,1861,0.377239000,0.2378
215.158.238.132,<->,42.97.54.90,10,1749,0,0,10,1749,0.376773000,0.2214
142.223.188.46,<->,136.25.188.220,0,0,10,1611,10,1611,0.375908000,1.5331
215.158.239.50,<->,207.190.159.218,10,1523,0,0,10,1523,0.374564000,0.9899
239.66.21.86,<->,97.198.118.56,0,0,10,1308,10,1308,0.373209000,0.5816
232.31.148.10,<->,97.198.118.56,0,0,10,1319,10,1319,0.372832000,0.3755
196.88.224.202,<->,136.25.188.237,0,0,10,1187,10,1187,0.371781000,1.5029
215.158.239.49,<->,120.154.71.52,10,5328,0,0,10,5328,0.371552000,1.5082
159.58.186.67,<->,8.20.87.155,0,0,10,1053,10,1053,0.369111000,0.6437
111.146.147.199,<->,53.200.100.108,10,4383,0,0,10,4383,0.368358000,0.3470
144.85.170.254,<->,91.69.181.168,10,950,0,0,10,950,0.368059000,0.3412
215.158.238.105,<->,148.55.210.201,10,3018,0,0,10,3018,0.364836000,0.5815
207.233.248.44,<->,50.223.3.228,0,0,10,500,10,500,0.360880000,1.5977
243.117.82.36,<->,129.78.117.164,0,0,10,1930,10,1930,0.360739000,0.7338
136.25.188.53,<->,29.214.108.91,10,652,0,0,10,652,0.358560000,1.4138
215.158.239.79,<->,207.61.19.4,10,500,0,0,10,500,0.357776000,0.5462
215.158.238.81,<->,80.47.111.107,10,1781,0,0,10,1781,0.357490000,0.7874
97.85.150.178,<->,8.52.173.15,0,0,10,1984,10,1984,0.356456000,0.6282
215.158.238.133,<->,131.144.113.182,10,1861,0,0,10,1861,0.356315000,0.4676
136.25.188.36,<->,111.42.21.99,10,3070,0,0,10,3070,0.355626000,1.2266
129.254.96.10,<->,80.38.33.214,0,0,10,4982,10,4982,0.355543000,0.1438
129.236.114.39,<->,33.233.141.227,0,0,10,9644,10,9644,0.355456000,0.7045
214.237.183.200,<->,8.220.238.62,0,0,10,2075,10,2075,0.355333000,0.7382
195.54.95.180,<->,136.25.188.52,0,0,10,1269,10,1269,0.355307000,0.3577
207.190.127.169,<->,136.25.188.174,0,0,10,1770,10,1770,0.353839000,0.7692
136.25.188.221,<->,57.227.83.247,10,560,0,0,10,560,0.351281000,0.0014
210.95.218.219,<->,8.220.202.151,0,0,10,1834,10,1834,0.348263000,0.7355
142.253.75.176,<->,136.25.188.174,0,0,10,536,10,536,0.342971000,1.2854
139.163.0.100,<->,98.87.145.146,10,560,0,0,10,560,0.340123000,1.6431
215.158.239.94,<->,98.28.95.88,10,4479,0,0,10,4479,0.339380000,1.6025
215.158.238.148,<->,113.23.20.251,10,4399,0,0,10,4399,0.338176000,1.5115
117.50.142.14,<->,50.224.49.194,0,0,10,560,10,560,0.337273000,1.6032
199.82.93.225,<->,136.25.188.53,0,0,10,1475,10,1475,0.331941000,0.8392
138.98.250.43,<->,46.36.234.165,10,500,0,0,10,500,0.330843000,1.6007
145.10.79.98,<->,50.224.49.194,0,0,10,560,10,560,0.329629000,1.5988
195.40.2.86,<->,136.25.188.208,0,0,10,506,10,506,0.328427000,0.7648
215.158.238.47,<->,120.154.221.245,10,2986,0,0,10,2986,0.326429000,1.6397
204.185.172.15,<->,136.25.188.46,0,0,10,572,10,572,0.326090000,0.1903
215.158.239.4,<->,106.188.214.9,10,3656,0,0,10,3656,0.323295000,1.4290
142.255.224.168,<->,136.25.188.210,0,0,10,1193,10,1193,0.320452000,0.2520
215.158.239.93,<->,204.2.7.188,10,560,0,0,10,560,0.316883000,0.0525
215.158.140.76,<->,122.159.123.1,10,1592,0,0,10,1592,0.316589000,0.7664
216.184.1.125,<->,136.25.188.247,0,0,10,7094,10,7094,0.314648000,0.1656
136.25.189.34,<->,96.156.169.160,10,4895,0,0,10,4895,0.305790000,0.9773
97.126.124.195,<->,54.48.104.170,10,4676,0,0,10,4676,0.304705000,0.4904
207.193.113.144,<->,8.252.222.179,0,0,10,644,10,644,0.303544000,1.5574
215.158.238.132,<->,113.23.104.215,10,3871,0,0,10,3871,0.301475000,1.5715
133.178.227.24,<->,104.3.168.53,10,3700,0,0,10,3700,0.298797000,1.3365
246.253.253.208,<->,194.195.11.79,10,2210,0,0,10,2210,0.298494000,1.1089
215.158.239.99,<->,142.182.55.169,10,560,0,0,10,560,0.296467000,0.2286
215.158.238.82,<->,38.104.11.36,10,3046,0,0,10,3046,0.295137000,1.5785
125.12.139.167,<->,89.183.104.227,0,0,10,13960,10,13960,0.295034000,1.6820
215.158.239.92,<->,199.20.28.34,10,560,0,0,10,560,0.294579000,0.0700
97.94.150.221,<->,50.224.108.163,0,0,10,2066,10,2066,0.294257000,0.3381
215.158.238.113,<->,116.106.61.226,10,1745,0,0,10,1745,0.293510000,0.5612
215.158.238.148,<->,104.3.168.203,10,4399,0,0,10,4399,0.293008000,1.6873
8.252.223.143,<->,8.222.6.193,10,1653,0,0,10,1653,0.292631000,0.1558
133.54.30.209,<->,38.28.228.78,10,907,0,0,10,907,0.292534000,0.7540
194.237.78.125,<->,136.25.188.174,0,0,10,1526,10,1526,0.292354000,0.9204
221.196.122.249,<->,138.98.250.39,0,0,10,560,10,560,0.290890000,1.6191
94.194.188.21,<->,8.252.221.236,0,0,10,1316,10,1316,0.289914000,1.6753
239.66.110.113,<->,203.215.177.37,0,0,10,1732,10,1732,0.287605000,1.6148
136.25.188.254,<->,113.23.104.220,10,3002,0,0,10,3002,0.284784000,1.5513
215.158.238.83,<->,131.2.115.254,10,4255,0,0,10,4255,0.283670000,1.7073
197.161.94.7,<->,8.252.222.23,0,0,10,560,10,560,0.283287000,1.0281
199.32.203.17,<->,136.25.188.177,0,0,10,572,10,572,0.283011000,0.5795
221.196.122.125,<->,138.98.250.39,0,0,10,560,10,560,0.277435000,1.5993
142.228.48.50,<->,136.25.188.252,0,0,10,2077,10,2077,0.276951000,0.6368
204.63.66.52,<->,136.25.188.220,0,0,10,2044,10,2044,0.275017000,0.5528
196.206.163.14,<->,136.25.188.255,0,0,10,560,10,560,0.274594000,0.9164
215.158.238.105,<->,126.207.73.76,10,1813,0,0,10,1813,0.274113000,0.2428
212.164.136.25,<->,98.87.189.80,10,560,0,0,10,560,0.273643000,1.6032
133.178.227.24,<->,8.240.116.196,10,3679,0,0,10,3679,0.272438000,1.2389
102.15.50.166,<->,8.52.178.59,0,0,10,1078,10,1078,0.272138000,0.2199
133.178.227.24,<->,126.219.102.63,10,4631,0,0,10,4631,0.270879000,1.6371
215.158.61.189,<->,8.176.8.215,0,0,10,3833,10,3833,0.270534000,1.5236
133.178.227.16,<->,29.211.165.103,10,3858,0,0,10,3858,0.268256000,1.7259
53.231.94.90,<->,48.55.122.124,0,0,10,13586,10,13586,0.263305000,1.6244
215.158.239.71,<->,29.212.180.226,10,4948,0,0,10,4948,0.262959000,1.6771
215.158.238.67,<->,148.55.210.228,10,4159,0,0,10,4159,0.262950000,1.6250
136.25.188.240,<->,89.153.100.167,10,2016,0,0,10,2016,0.262743000,0.6635
89.183.109.183,<->,6.251.66.197,10,576,0,0,10,576,0.255095000,1.6442
205.186.190.236,<->,92.27.27.146,0,0,10,1714,10,1714,0.254926000,1.5306
207.172.165.168,<->,136.25.188.163,0,0,10,1269,10,1269,0.253645000,1.6694
8.182.226.78,<->,6.20.41.44,10,1855,0,0,10,1855,0.253287000,1.3101
143.155.227.58,<->,136.25.188.225,0,0,10,1589,10,1589,0.252723000,0.9216
136.25.189.77,<->,116.106.46.57,10,5695,0,0,10,5695,0.252076000,1.6052
215.158.239.84,<->,199.20.29.159,10,1682,0,0,10,1682,0.249966000,1.4411
124.63.50.43,<->,80.41.63.61,0,0,10,5945,10,5945,0.245752000,0.9094
215.158.238.32,<->,136.139.59.124,10,1928,0,0,10,1928,0.241684000,1.5167
204.190.211.116,<->,136.25.188.175,0,0,10,1611,10,1611,0.240888000,1.5001
53.76.72.192,<->,35.56.98.42,0,0,10,560,10,560,0.238429000,1.5347
215.158.239.57,<->,192.204.123.40,10,4319,0,0,10,4319,0.238102000,1.3639
215.158.140.60,<->,111.151.78.71,10,3428,0,0,10,3428,0.235938000,1.6117
112.226.31.137,<->,92.168.217.241,0,0,10,1053,10,1053,0.235287000,1.7551
215.158.239.49,<->,196.92.118.173,10,1175,0,0,10,1175,0.234609000,1.5400
149.235.39.67,<->,145.252.120.231,0,0,10,500,10,500,0.233057000,0.3687
215.158.239.49,<->,126.219.194.17,10,6617,0,0,10,6617,0.232745000,1.2020
207.84.253.83,<->,136.25.188.209,0,0,10,1026,10,1026,0.232738000,0.7735
120.41.168.218,<->,89.183.104.143,0,0,10,12614,10,12614,0.231423000,1.4470
139.163.16.210,<->,82.99.227.248,10,11162,0,0,10,11162,0.231027000,1.6577
215.158.239.92,<->,80.56.79.11,10,5412,0,0,10,5412,0.230308000,1.2643
247.136.240.193,<->,229.69.132.202,10,520,0,0,10,520,0.230000000,1.3909
215.158.239.78,<->,33.209.219.164,10,4042,0,0,10,4042,0.229111000,0.9134
215.158.238.97,<->,8.222.109.115,10,620,0,0,10,620,0.226697000,1.7594
136.25.189.44,<->,8.215.68.58,10,4463,0,0,10,4463,0.226668000,1.3211
215.158.239.96,<->,199.20.30.62,10,2154,0,0,10,2154,0.224593000,1.5198
136.25.189.12,<->,29.213.219.87,10,5816,0,0,10,5816,0.223617000,1.6629
35.56.31.182,<->,8.182.226.78,0,0,10,5426,10,5426,0.222625000,0.9532
215.158.239.51,<->,207.63.21.191,10,2059,0,0,10,2059,0.219511000,0.4922
133.178.226.38,<->,122.158.51.62,10,4079,0,0,10,4079,0.219106000,1.7527
133.178.227.1,<->,126.219.100.183,10,2557,0,0,10,2557,0.216898000,1.7258
136.25.189.2,<->,96.135.155.20,10,6633,0,0,10,6633,0.216239000,1.5869
215.158.238.250,<->,126.219.132.29,10,4672,0,0,10,4672,0.215125000,1.6843
159.224.8.238,<->,138.98.250.39,0,0,10,560,10,560,0.214289000,1.6907
96.58.68.79,<->,8.220.202.4,0,0,10,864,10,864,0.213037000,0.9215
207.58.49.144,<->,136.25.188.198,0,0,10,1469,10,1469,0.212919000,1.7309
215.158.140.229,<->,192.171.32.183,10,3728,0,0,10,3728,0.212646000,1.7695
215.158.239.35,<->,122.158.53.52,10,4670,0,0,10,4670,0.211517000,1.6653
131.158.117.199,<->,50.224.76.248,0,0,10,3874,10,3874,0.210956000,0.3824
136.25.188.179,<->,69.132.194.169,10,1741,0,0,10,1741,0.210914000,1.4964
215.158.239.76,<->,199.20.30.178,10,608,0,0,10,608,0.210139000,1.5304
215.158.238.94,<->,33.209.217.202,10,4513,0,0,10,4513,0.209237000,0.8190
133.178.227.40,<->,113.23.66.34,10,3691,0,0,10,3691,0.208624000,1.3757
138.98.250.39,<->,133.55.11.209,10,560,0,0,10,560,0.206750000,1.6127
35.55.212.12,<->,8.182.251.42,0,0,10,925,10,925,0.205879000,0.8611
215.158.239.99,<->,143.135.48.154,10,1052,0,0,10,1052,0.205500000,0.4321
215.158.238.190,<->,18.202.90.231,10,3688,0,0,10,3688,0.203648000,1.5816
144.54.85.148,<->,138.98.250.43,0,0,10,560,10,560,0.203419000,1.5998
215.158.239.76,<->,196.105.48.2,10,560,0,0,10,560,0.203363000,0.1302
255.17.29.137,<->,8.220.205.146,0,0,10,1186,10,1186,0.201809000,0.4368
133.178.226.19,<->,27.178.41.41,10,4303,0,0,10,4303,0.199533000,1.6602
221.196.123.26,<->,212.164.136.25,0,0,10,560,10,560,0.198681000,1.5996
109.1.23.148,<->,98.18.91.3,10,10165,0,0,10,10165,0.198531000,1.2621
215.158.239.70,<->,195.42.202.249,10,1520,0,0,10,1520,0.197907000,1.2467
221.196.122.81,<->,212.164.136.25,0,0,10,560,10,560,0.196718000,1.5996
138.98.250.39,<->,136.106.78.232,10,584,0,0,10,584,0.196457000,1.5992
133.178.227.79,<->,131.1.195.40,10,2612,0,0,10,2612,0.194886000,1.3105
215.158.238.148,<->,113.23.104.203,10,3030,0,0,10,3030,0.194351000,1.7338
215.158.238.247,<->,215.158.43.33,10,1116,0,0,10,1116,0.190867000,1.5477
215.158.239.56,<->,196.88.109.62,10,500,0,0,10,500,0.190252000,0.4585
195.40.127.28,<->,136.25.188.225,0,0,10,2248,10,2248,0.189804000,0.4649
215.158.61.202,<->,8.176.8.183,0,0,10,3545,10,3545,0.188816000,1.3825
144.54.85.196,<->,138.98.250.39,0,0,10,560,10,560,0.188285000,1.7258
215.158.239.92,<->,199.20.29.6,10,1285,0,0,10,1285,0.187329000,0.6199
221.196.123.76,<->,138.98.250.39,0,0,10,560,10,560,0.185667000,1.5808
215.158.140.229,<->,8.252.253.251,10,2766,0,0,10,2766,0.184523000,1.6294
215.158.238.82,<->,57.227.83.202,10,1845,0,0,10,1845,0.184239000,0.0939
144.54.85.243,<->,138.98.250.43,0,0,10,560,10,560,0.184230000,1.6401
215.158.238.97,<->,122.159.245.165,10,1717,0,0,10,1717,0.183535000,1.6767
215.158.239.49,<->,142.191.249.107,10,560,0,0,10,560,0.182502000,1.2371
8.176.8.25,<->,8.35.106.194,10,6852,0,0,10,6852,0.182102000,1.6603
136.25.188.254,<->,8.255.92.213,10,2890,0,0,10,2890,0.180517000,1.2166
139.163.96.127,<->,89.220.203.245,10,530,0,0,10,530,0.179358000,1.6633
215.158.140.60,<->,126.219.194.41,10,2584,0,0,10,2584,0.177915000,1.5327
199.33.57.242,<->,136.25.188.241,0,0,10,861,10,861,0.177431000,0.2005
215.158.239.70,<->,29.212.199.125,10,2970,0,0,10,2970,0.176453000,1.1796
215.158.239.58,<->,142.220.110.154,10,2099,0,0,10,2099,0.174962000,0.5443
136.25.189.57,<->,126.219.194.19,10,4155,0,0,10,4155,0.174542000,1.1368
215.158.239.68,<->,196.106.83.145,10,560,0,0,10,560,0.174283000,0.2400
215.158.239.84,<->,204.227.240.179,10,1373,0,0,10,1373,0.173385000,1.4762
99.192.215.115,<->,50.224.68.215,0,0,10,500,10,500,0.168714000,1.7221
215.158.61.202,<->,136.25.188.35,0,0,10,6357,10,6357,0.168312000,1.6693
215.158.239.97,<->,199.20.31.34,10,560,0,0,10,560,0.167863000,0.2402
207.231.198.197,<->,8.252.222.236,0,0,10,4487,10,4487,0.166886000,1.7947
243.49.81.35,<->,111.147.147.40,0,0,10,11175,10,11175,0.166229000,0.6975
195.110.45.244,<->,50.223.3.228,0,0,10,629,10,629,0.165537000,1.7899
136.25.188.173,<->,48.129.133.47,10,1829,0,0,10,1829,0.164160000,0.9766
205.127.108.113,<->,33.233.141.231,0,0,10,2866,10,2866,0.164084000,1.6619
136.25.188.208,<->,57.160.181.245,10,4303,0,0,10,4303,0.163650000,1.7568
136.25.189.34,<->,33.209.219.107,10,5727,0,0,10,5727,0.163581000,1.0906
194.234.232.96,<->,136.25.188.176,0,0,10,1433,10,1433,0.163082000,1.8005
207.59.39.216,<->,136.25.188.241,0,0,10,2052,10,2052,0.162155000,0.6905
142.179.115.200,<->,50.223.3.228,0,0,10,512,10,512,0.161901000,1.7120
199.82.99.56,<->,136.25.188.220,0,0,10,560,10,560,0.159002000,0.0920
215.158.140.92,<->,104.3.168.150,10,3547,0,0,10,3547,0.158511000,1.7412
136.25.188.252,<->,48.131.158.213,10,1797,0,0,10,1797,0.155073000,0.9620
199.70.88.221,<->,136.25.188.197,0,0,10,1226,10,1226,0.154852000,1.7734
231.140.112.48,<->,215.158.239.95,0,0,10,2034,10,2034,0.154431000,0.7182
50.224.88.92,<->,17.248.138.60,10,500,0,0,10,500,0.152571000,1.6057
107.250.82.48,<->,50.224.61.152,0,0,10,500,10,500,0.150977000,1.7797
143.45.0.151,<->,133.178.226.61,0,0,10,4479,10,4479,0.150731000,1.7831
139.163.96.94,<->,64.252.189.135,10,500,0,0,10,500,0.149803000,1.8117
215.158.239.86,<->,204.226.34.31,10,2094,0,0,10,2094,0.149421000,0.4330
215.158.238.198,<->,148.26.113.214,10,2707,0,0,10,2707,0.148693000,1.5470
204.200.38.162,<->,136.25.188.252,0,0,10,1653,10,1653,0.148552000,0.4046
215.158.238.251,<->,8.222.213.21,10,3696,0,0,10,3696,0.147170000,0.9586
136.25.189.12,<->,72.23.194.201,10,3018,0,0,10,3018,0.147019000,1.7613
220.20.200.55,<->,127.62.25.159,10,11596,0,0,10,11596,0.145859000,1.1469
250.5.201.28,<->,0.195.210.42,0,0,10,591,10,591,0.145553000,0.6119
199.122.62.83,<->,136.25.188.252,0,0,10,1529,10,1529,0.145538000,0.4389
139.163.96.94,<->,64.253.169.54,10,540,0,0,10,540,0.144945000,1.6174
195.71.167.102,<->,136.25.188.175,0,0,10,1823,10,1823,0.144283000,1.0999
139.163.96.127,<->,74.140.178.102,10,500,0,0,10,500,0.143848000,1.8073
145.61.118.108,<->,50.224.61.152,0,0,10,500,10,500,0.143364000,1.7016
221.196.123.142,<->,50.224.61.154,0,0,10,560,10,560,0.142083000,1.7284
136.25.188.199,<->,125.216.33.160,10,1653,0,0,10,1653,0.141332000,0.1528
98.101.92.221,<->,8.182.136.57,0,0,10,1695,10,1695,0.139926000,1.4360
142.229.223.78,<->,136.25.188.44,0,0,10,605,10,605,0.139835000,0.0888
205.224.85.211,<->,92.27.8.30,0,0,10,6446,10,6446,0.139628000,0.5400
133.178.227.60,<->,133.56.180.75,10,4608,0,0,10,4608,0.139075000,1.6601
50.145.94.82,<->,48.55.120.172,0,0,10,614,10,614,0.139047000,1.7610
210.95.218.224,<->,138.98.250.43,0,0,10,560,10,560,0.138260000,1.5997
215.158.238.113,<->,143.45.0.136,10,4303,0,0,10,4303,0.138111000,1.7897
197.113.99.113,<->,136.25.188.44,0,0,10,560,10,560,0.138105000,0.0300
215.158.239.71,<->,29.214.109.128,10,5572,0,0,10,5572,0.138058000,1.7895
215.158.238.75,<->,112.220.206.24,10,2906,0,0,10,2906,0.136802000,1.4807
207.60.80.240,<->,136.25.188.253,0,0,10,560,10,560,0.133790000,0.0493
197.125.110.181,<->,136.25.189.17,0,0,10,2874,10,2874,0.132998000,1.3470
215.158.238.113,<->,192.226.161.158,10,1717,0,0,10,1717,0.132843000,1.0672
149.254.114.242,<->,136.25.189.2,0,0,10,1861,10,1861,0.131547000,0.1312
50.224.49.212,<->,17.214.49.158,10,560,0,0,10,560,0.130934000,1.6926
94.193.1.179,<->,8.252.221.198,0,0,10,530,10,530,0.130426000,1.3345
110.216.139.224,<->,50.224.61.152,0,0,10,500,10,500,0.130313000,1.8123
207.172.233.228,<->,136.25.188.253,0,0,10,1352,10,1352,0.130101000,1.6301
215.158.238.75,<->,33.209.217.244,10,5937,0,0,10,5937,0.127727000,1.7934
153.168.22.239,<->,8.252.221.204,0,0,10,1308,10,1308,0.127594000,1.5885
215.158.239.68,<->,199.82.250.91,10,4276,0,0,10,4276,0.126661000,1.5488
192.64.199.47,<->,122.105.219.3,10,624,0,0,10,624,0.126155000,1.8523
215.158.239.210,<->,215.158.44.5,10,9855,0,0,10,9855,0.125981000,0.0026
136.25.189.34,<->,29.212.199.2,10,4223,0,0,10,4223,0.125848000,1.8629
136.25.188.162,<->,8.222.212.57,10,4239,0,0,10,4239,0.123983000,1.5025
249.115.161.75,<->,139.163.0.100,0,0,10,500,10,500,0.123573000,1.8132
146.249.225.48,<->,8.252.222.225,0,0,10,608,10,608,0.121619000,1.8401
210.95.218.224,<->,8.220.178.166,0,0,10,1288,10,1288,0.120119000,0.1196
57.16.187.238,<->,50.224.68.215,0,0,10,500,10,500,0.118677000,1.8056
138.98.174.211,<->,50.157.102.221,10,500,0,0,10,500,0.118525000,1.7254
215.158.239.96,<->,120.154.71.36,10,4159,0,0,10,4159,0.118371000,1.4451
111.20.172.70,<->,33.233.141.49,0,0,10,1268,10,1268,0.115871000,1.0082
207.60.128.142,<->,136.25.188.45,0,0,10,2074,10,2074,0.113932000,0.7127
215.158.239.113,<->,129.222.39.230,10,4502,0,0,10,4502,0.112253000,1.6232
199.39.214.82,<->,136.25.188.252,0,0,10,560,10,560,0.107684000,0.1110
215.158.239.84,<->,204.226.51.219,10,2070,0,0,10,2070,0.107250000,0.4385
215.158.238.114,<->,118.20.87.65,10,2986,0,0,10,2986,0.107097000,1.8199
142.191.245.48,<->,136.25.188.220,0,0,10,1339,10,1339,0.106794000,1.0097
246.253.253.215,<->,207.205.106.161,10,1210,0,0,10,1210,0.106363000,1.8456
111.20.172.70,<->,101.224.89.129,0,0,10,1422,10,1422,0.106184000,1.0021
249.85.61.6,<->,99.75.192.222,0,0,10,9748,10,9748,0.105837000,1.8507
215.158.6.223,<->,8.252.223.176,0,0,10,4714,10,4714,0.105826000,1.6506
221.102.56.69,<->,220.80.167.49,0,0,10,1084,10,1084,0.105807000,1.7943
139.239.137.234,<->,50.224.61.152,0,0,10,500,10,500,0.105532000,1.8056
111.20.172.70,<->,111.20.168.3,0,0,10,1293,10,1293,0.105196000,0.0157
136.25.189.28,<->,29.212.198.166,10,5332,0,0,10,5332,0.103967000,1.8023
220.39.233.197,<->,215.158.238.114,0,0,10,4331,10,4331,0.103779000,0.8178
111.20.172.70,<->,33.233.141.62,0,0,10,1259,10,1259,0.102877000,1.0117
138.98.250.39,<->,98.232.50.19,10,500,0,0,10,500,0.102309000,1.5990
231.140.77.165,<->,215.158.239.95,0,0,10,1301,10,1301,0.101480000,0.3659
144.85.170.244,<->,98.87.147.161,10,560,0,0,10,560,0.100748000,1.8330
95.246.204.167,<->,8.252.221.236,0,0,10,922,10,922,0.099871000,1.8628
207.193.113.211,<->,8.252.222.223,0,0,10,524,10,524,0.099483000,1.8645
215.158.140.231,<->,113.23.66.41,10,4826,0,0,10,4826,0.099114000,1.3711
238.118.126.42,<->,200.175.107.40,10,500,0,0,10,500,0.099081000,0.4533
215.158.140.60,<->,8.219.184.92,10,3731,0,0,10,3731,0.098959000,1.7175
108.46.199.1,<->,50.224.49.211,0,0,10,500,10,500,0.098284000,1.8024
139.163.81.178,<->,50.138.148.239,10,500,0,0,10,500,0.097905000,1.4834
133.178.226.61,<->,120.20.132.40,10,2842,0,0,10,2842,0.096825000,0.8285
139.241.56.117,<->,100.92.28.107,0,0,10,13160,10,13160,0.096585000,1.8573
139.163.96.127,<->,88.56.15.246,10,608,0,0,10,608,0.096099000,1.8484
156.158.74.255,<->,139.163.96.94,0,0,10,500,10,500,0.095260000,1.7151
142.240.56.26,<->,136.25.188.255,0,0,10,2418,10,2418,0.095148000,1.6148
143.13.221.216,<->,136.25.188.220,0,0,10,1511,10,1511,0.094921000,0.3250
215.158.239.92,<->,195.55.120.128,10,1781,0,0,10,1781,0.094646000,1.8140
215.158.239.49,<->,96.135.155.15,10,7337,0,0,10,7337,0.094388000,1.4727
127.13.41.126,<->,80.42.175.248,0,0,10,520,10,520,0.092987000,1.6524
136.50.56.220,<->,109.1.72.27,0,0,10,11631,10,11631,0.092519000,0.2390
251.24.86.2,<->,8.252.222.142,0,0,10,1398,10,1398,0.091908000,0.2544
138.98.250.39,<->,17.214.49.159,10,560,0,0,10,560,0.091222000,1.6621
134.53.24.179,<->,89.183.104.144,0,0,10,1554,10,1554,0.090550000,1.4070
215.158.239.104,<->,111.151.237.117,10,11484,0,0,10,11484,0.089517000,0.1373
215.158.238.83,<->,104.3.163.39,10,5620,0,0,10,5620,0.089440000,1.7786
215.158.239.95,<->,199.20.30.88,10,560,0,0,10,560,0.088890000,0.2001
8.252.221.236,<->,4.121.147.111,10,906,0,0,10,906,0.088741000,1.8745
133.178.226.90,<->,112.220.206.88,10,5188,0,0,10,5188,0.087328000,1.4239
136.25.189.32,<->,113.23.66.232,10,5284,0,0,10,5284,0.085955000,1.8148
142.241.13.237,<->,136.25.188.55,0,0,10,1415,10,1415,0.084443000,1.4686
215.158.239.49,<->,142.236.184.127,10,1335,0,0,10,1335,0.084107000,0.8409
195.54.131.111,<->,136.25.188.163,0,0,10,500,10,500,0.083510000,0.0145
133.178.226.90,<->,29.214.108.81,10,1717,0,0,10,1717,0.083358000,1.9015
136.25.188.172,<->,8.252.210.162,10,3146,0,0,10,3146,0.082746000,1.8195
215.158.238.33,<->,76.100.108.197,10,1897,0,0,10,1897,0.082458000,0.5027
195.127.171.142,<->,136.25.188.236,0,0,10,768,10,768,0.082432000,0.6157
198.103.11.54,<->,139.163.96.127,0,0,10,548,10,548,0.081390000,1.7440
133.178.227.19,<->,133.56.180.40,10,6808,0,0,10,6808,0.080992000,1.6575
198.221.9.105,<->,159.137.169.58,0,0,10,500,10,500,0.080923000,1.8532
136.25.189.31,<->,98.28.95.84,10,5716,0,0,10,5716,0.080851000,1.6595
94.185.227.35,<->,8.252.222.238,0,0,10,712,10,712,0.080576000,0.5366
221.102.56.69,<->,109.1.51.9,0,0,10,1282,10,1282,0.080174000,0.5476
204.184.149.238,<->,136.25.188.243,0,0,10,3580,10,3580,0.079753000,1.8807
215.158.140.93,<->,18.202.90.252,10,1620,0,0,10,1620,0.079271000,1.9139
192.64.227.90,<->,117.71.193.184,10,546,0,0,10,546,0.079138000,1.7069
215.158.61.189,<->,136.25.189.194,0,0,10,8500,10,8500,0.078233000,1.5502
136.25.189.2,<->,29.214.73.159,10,5492,0,0,10,5492,0.077819000,1.6111
215.158.61.189,<->,8.176.8.193,0,0,10,8971,10,8971,0.077306000,0.5400
86.135.8.107,<->,8.252.222.158,0,0,10,1599,10,1599,0.077299000,0.7295
221.94.74.82,<->,50.224.78.140,0,0,10,500,10,500,0.076110000,1.8315
109.93.218.219,<->,50.224.61.152,0,0,10,500,10,500,0.075970000,1.8049
247.136.205.189,<->,118.244.125.226,10,560,0,0,10,560,0.075578000,0.7905
143.42.47.211,<->,136.25.188.253,0,0,10,1883,10,1883,0.074214000,0.6672
215.158.239.71,<->,80.56.79.104,10,4474,0,0,10,4474,0.073697000,1.6871
215.158.239.76,<->,106.188.253.234,10,5809,0,0,10,5809,0.073351000,1.8880
246.45.208.21,<->,58.62.42.67,10,3349,0,0,10,3349,0.073263000,0.7969
215.158.238.94,<->,136.139.59.87,10,3034,0,0,10,3034,0.071636000,1.8461
215.158.239.95,<->,196.1.34.239,10,572,0,0,10,572,0.071194000,0.0100
215.158.239.97,<->,142.236.230.25,10,560,0,0,10,560,0.070226000,0.4726
201.139.255.95,<->,8.252.221.205,0,0,10,926,10,926,0.070079000,1.8553
111.20.172.70,<->,33.233.141.21,0,0,10,1263,10,1263,0.069996000,1.0047
215.158.239.96,<->,195.49.234.69,10,560,0,0,10,560,0.069283000,0.3329
142.234.196.233,<->,133.178.226.29,0,0,10,5396,10,5396,0.068810000,1.6049
192.67.128.252,<->,29.196.111.121,10,580,0,0,10,580,0.067606000,1.5625
207.63.177.218,<->,136.25.188.226,0,0,10,605,10,605,0.067004000,0.0798
133.178.226.7,<->,104.3.163.39,10,4351,0,0,10,4351,0.066639000,1.4970
136.25.189.0,<->,80.56.79.20,10,5332,0,0,10,5332,0.066449000,1.2471
145.57.211.150,<->,139.163.8.98,0,0,10,500,10,500,0.064929000,1.8182
158.85.50.170,<->,133.178.227.27,0,0,10,4605,10,4605,0.064602000,1.6341
215.158.239.94,<->,194.234.164.216,10,1253,0,0,10,1253,0.064337000,1.0416
215.158.238.33,<->,113.23.104.245,10,2826,0,0,10,2826,0.063880000,1.4972
204.130.115.204,<->,8.252.222.222,0,0,10,548,10,548,0.063605000,1.6199
111.20.172.70,<->,111.20.168.11,0,0,10,1631,10,1631,0.063087000,1.0151
239.227.104.241,<->,221.102.143.189,10,8486,0,0,10,8486,0.062646000,0.3227
231.136.200.213,<->,215.158.239.76,0,0,10,1257,10,1257,0.062617000,1.0966
98.219.126.37,<->,80.38.52.231,0,0,10,860,10,860,0.062230000,0.1693
43.52.245.73,<->,8.252.221.236,0,0,10,1314,10,1314,0.061744000,1.7260
111.20.172.70,<->,111.20.168.6,0,0,10,1380,10,1380,0.060557000,1.0161
142.165.241.107,<->,8.52.132.187,0,0,10,560,10,560,0.058231000,0.2682
220.77.119.165,<->,50.224.82.18,0,0,10,500,10,500,0.057202000,1.8726
113.224.216.39,<->,92.27.219.21,0,0,10,617,10,617,0.057150000,1.7630
206.226.101.109,<->,89.183.111.204,0,0,10,3728,10,3728,0.056888000,1.9086
215.158.140.83,<->,8.190.216.249,10,3567,0,0,10,3567,0.056276000,1.7790
142.182.40.182,<->,136.25.188.198,0,0,10,1194,10,1194,0.056104000,0.5023
215.158.140.93,<->,131.22.233.146,10,6041,0,0,10,6041,0.055635000,1.8977
215.158.239.92,<->,195.54.177.60,10,1403,0,0,10,1403,0.055319000,0.9073
136.25.188.44,<->,106.188.236.212,10,5604,0,0,10,5604,0.055176000,1.8662
139.163.0.110,<->,136.141.44.41,10,500,0,0,10,500,0.054762000,1.8131
215.158.239.113,<->,215.158.61.242,10,9156,0,0,10,9156,0.054707000,1.6490
207.62.24.74,<->,136.25.188.163,0,0,10,1183,10,1183,0.053943000,0.3991
215.158.238.97,<->,142.234.196.161,10,4303,0,0,10,4303,0.053658000,1.8115
140.28.153.241,<->,139.163.96.94,0,0,10,500,10,500,0.053240000,1.8697
215.158.239.56,<->,199.78.242.244,10,1299,0,0,10,1299,0.052485000,1.5994
133.178.227.8,<->,133.56.180.25,10,3955,0,0,10,3955,0.052232000,1.9447
205.104.181.26,<->,100.93.115.150,0,0,10,1492,10,1492,0.052049000,0.6203
143.13.202.241,<->,136.25.188.175,0,0,10,2064,10,2064,0.050332000,0.4011
215.158.140.178,<->,8.222.7.180,10,4482,0,0,10,4482,0.048199000,1.0369
215.158.239.68,<->,199.15.213.31,10,1122,0,0,10,1122,0.047645000,1.7076
194.218.9.93,<->,8.182.229.19,0,0,10,2863,10,2863,0.046860000,0.4756
205.243.108.178,<->,89.153.90.52,0,0,10,1280,10,1280,0.046740000,1.5037
215.158.238.133,<->,113.23.104.246,10,2091,0,0,10,2091,0.045882000,1.7821
215.158.238.33,<->,212.70.75.152,10,4251,0,0,10,4251,0.045365000,1.8762
133.178.226.80,<->,38.104.11.8,10,3546,0,0,10,3546,0.043334000,1.3332
215.158.238.92,<->,8.223.224.53,10,1749,0,0,10,1749,0.042405000,0.2066
138.98.151.44,<->,124.50.117.254,10,1088,0,0,10,1088,0.040964000,0.4218
197.125.117.130,<->,133.178.227.79,0,0,10,3584,10,3584,0.039912000,1.4763
215.158.238.36,<->,29.214.108.202,10,1829,0,0,10,1829,0.039278000,1.9246
239.66.238.81,<->,97.198.98.50,0,0,10,560,10,560,0.039098000,1.9032
215.158.239.101,<->,129.222.36.34,10,3479,0,0,10,3479,0.036657000,1.0672
144.252.153.20,<->,139.163.8.107,0,0,10,500,10,500,0.036510000,1.8220
215.158.239.93,<->,199.70.165.39,10,1584,0,0,10,1584,0.036339000,0.2695
133.178.227.79,<->,133.56.180.47,10,6100,0,0,10,6100,0.036022000,1.3163
136.25.189.80,<->,29.211.93.6,10,4175,0,0,10,4175,0.035499000,1.3583
136.25.188.255,<->,29.214.108.171,10,6423,0,0,10,6423,0.035350000,1.7066
136.25.188.226,<->,57.210.107.16,10,1899,0,0,10,1899,0.034418000,0.7673
139.241.56.104,<->,80.42.215.104,0,0,10,14560,10,14560,0.034395000,1.6803
215.158.239.96,<->,199.20.4.209,10,2062,0,0,10,2062,0.034223000,1.3509
136.25.188.171,<->,100.224.202.157,10,2368,0,0,10,2368,0.034215000,1.4517
122.158.69.68,<->,97.126.31.73,0,0,10,3703,10,3703,0.034010000,1.7922
221.102.56.69,<->,192.67.172.205,0,0,10,1052,10,1052,0.033830000,0.5603
215.158.238.83,<->,29.214.71.95,10,1749,0,0,10,1749,0.033823000,0.3748
204.187.168.225,<->,136.25.188.46,0,0,10,1509,10,1509,0.033807000,1.8294
231.140.220.148,<->,136.25.188.174,0,0,10,1520,10,1520,0.033698000,0.7305
215.158.140.74,<->,133.199.54.185,10,3151,0,0,10,3151,0.033466000,1.7743
99.154.185.152,<->,97.198.108.255,0,0,10,500,10,500,0.032472000,1.7557
136.25.188.163,<->,33.209.217.228,10,6142,0,0,10,6142,0.032422000,1.7009
215.158.239.56,<->,199.32.175.22,10,2184,0,0,10,2184,0.032085000,1.9475
129.175.139.42,<->,8.252.222.204,0,0,10,3097,10,3097,0.031925000,1.5684
233.85.146.164,<->,144.85.170.254,0,0,10,560,10,560,0.031028000,0.0049
133.178.227.27,<->,131.22.233.155,10,5679,0,0,10,5679,0.030980000,1.8609
215.158.239.96,<->,199.20.4.0,10,1057,0,0,10,1057,0.030978000,1.6400
198.30.207.215,<->,35.56.98.42,0,0,10,1292,10,1292,0.030885000,1.5350
204.184.168.96,<->,136.25.188.163,0,0,10,898,10,898,0.030625000,1.8184
247.136.177.100,<->,110.46.216.59,10,1400,0,0,10,1400,0.028931000,1.8312
139.160.226.233,<->,136.25.188.220,0,0,10,2970,10,2970,0.028607000,1.2128
109.214.187.42,<->,8.52.178.109,0,0,10,560,10,560,0.026539000,0.1936
215.158.238.123,<->,69.31.238.195,10,4399,0,0,10,4399,0.026349000,1.6645
133.178.227.27,<->,111.150.187.231,10,2539,0,0,10,2539,0.026332000,1.5055
195.54.67.155,<->,136.25.188.254,0,0,10,1339,10,1339,0.025432000,0.4602
215.158.44.254,<->,136.25.189.80,0,0,10,5412,10,5412,0.024998000,0.4806
98.3.249.3,<->,50.224.49.212,0,0,10,524,10,524,0.024898000,1.5919
215.158.238.176,<->,149.250.115.15,10,2599,0,0,10,2599,0.024423000,0.8834
204.200.37.111,<->,136.25.188.55,0,0,10,1527,10,1527,0.022957000,0.7919
231.142.214.36,<->,136.25.188.209,0,0,10,1178,10,1178,0.022424000,0.4247
136.25.188.221,<->,122.159.245.172,10,4447,0,0,10,4447,0.020382000,1.7603
215.158.239.87,<->,207.213.17.12,10,1802,0,0,10,1802,0.020116000,1.0400
215.158.239.57,<->,8.215.68.89,10,4463,0,0,10,4463,0.019793000,0.5610
215.158.238.106,<->,119.196.23.71,10,3158,0,0,10,3158,0.019506000,1.9388
215.158.239.93,<->,199.20.30.46,10,972,0,0,10,972,0.019175000,1.3589
138.98.180.141,<->,134.245.87.117,10,1131,0,0,10,1131,0.018120000,1.8537
136.25.188.221,<->,131.1.232.148,10,3030,0,0,10,3030,0.017301000,1.1873
205.127.108.115,<->,33.233.141.11,0,0,10,2239,10,2239,0.017161000,1.8374
215.158.238.74,<->,120.20.132.25,10,560,0,0,10,560,0.016741000,0.0345
215.158.238.236,<->,131.144.114.249,10,4748,0,0,10,4748,0.016532000,1.9321
204.187.39.175,<->,136.25.188.241,0,0,10,2071,10,2071,0.016321000,0.4586
215.158.239.48,<->,199.20.28.213,10,621,0,0,10,621,0.016061000,0.6511
196.245.62.33,<->,136.25.188.163,0,0,10,560,10,560,0.015466000,1.9101
195.40.201.0,<->,136.25.188.253,0,0,10,506,10,506,0.014349000,1.1784
139.241.56.117,<->,99.75.98.129,0,0,10,13160,10,13160,0.013289000,1.8587
220.20.200.70,<->,133.248.86.103,10,9376,0,0,10,9376,0.013149000,0.1063
75.214.135.150,<->,8.252.222.142,0,0,10,621,10,621,0.012735000,0.9536
195.106.14.119,<->,92.27.219.34,0,0,10,3330,10,3330,0.012610000,1.7662
99.252.44.234,<->,50.224.49.194,0,0,10,572,10,572,0.012053000,1.6142
136.25.189.57,<->,116.106.46.75,10,5604,0,0,10,5604,0.011894000,1.7510
249.101.202.218,<->,53.214.236.51,10,10589,0,0,10,10589,0.011614000,1.0122
215.158.238.82,<->,131.144.113.216,10,4111,0,0,10,4111,0.011503000,1.5522
215.158.239.43,<->,29.214.74.225,10,4747,0,0,10,4747,0.011410000,1.2800
215.158.239.86,<->,192.204.123.37,10,5604,0,0,10,5604,0.011088000,0.6412
215.158.238.133,<->,112.220.206.116,10,2986,0,0,10,2986,0.010959000,1.4773
192.64.252.249,<->,139.241.56.102,10,13160,0,0,10,13160,0.010877000,1.8593
215.158.239.94,<->,199.20.4.195,10,560,0,0,10,560,0.010771000,0.3088
136.217.111.214,<->,50.224.91.82,0,0,10,560,10,560,0.010010000,1.7517
215.158.238.67,<->,131.144.113.193,10,5348,0,0,10,5348,0.009690000,1.8087
204.187.52.200,<->,136.25.188.225,0,0,10,1405,10,1405,0.009032000,0.2697
192.67.160.161,<->,117.196.96.71,10,1143,0,0,10,1143,0.008569000,1.7005
136.25.188.226,<->,8.191.15.68,10,4383,0,0,10,4383,0.007678000,1.5338
220.60.81.132,<->,136.25.189.15,0,0,10,5380,10,5380,0.006746000,1.8825
215.158.239.70,<->,207.213.60.85,10,1508,0,0,10,1508,0.006699000,0.6856
215.158.239.79,<->,29.213.219.71,10,5831,0,0,10,5831,0.006343000,1.3635
132.222.168.48,<->,33.250.131.226,10,13586,0,0,10,13586,0.006291000,1.7093
204.200.43.103,<->,136.25.188.176,0,0,10,1080,10,1080,0.005674000,0.4832
196.89.53.134,<->,136.25.188.209,0,0,10,596,10,596,0.005508000,0.2052
215.158.238.229,<->,215.158.43.12,10,1720,0,0,10,1720,0.005178000,0.5700
136.25.188.196,<->,120.154.221.231,10,3050,0,0,10,3050,0.003578000,1.6525
93.141.161.227,<->,92.27.219.43,0,0,10,8888,10,8888,0.003427000,1.4970
142.227.72.209,<->,136.25.188.178,0,0,10,500,10,500,0.003135000,0.5810
235.42.34.24,<->,215.158.238.135,0,0,10,1701,10,1701,0.002858000,0.4658
80.38.8.26,<->,46.44.235.228,10,1013,0,0,10,1013,0.002796000,1.7788
215.158.239.58,<->,196.105.70.214,10,1233,0,0,10,1233,0.002699000,0.4098
197.113.64.237,<->,136.25.188.220,0,0,10,605,10,605,0.002549000,1.0802
132.133.159.10,<->,8.182.224.203,0,0,10,1308,10,1308,0.001686000,0.8547
199.52.31.51,<->,136.25.188.173,0,0,10,1896,10,1896,0.001628000,0.9636
199.80.3.39,<->,136.25.188.239,0,0,10,572,10,572,0.001306000,0.2261
215.158.238.134,<->,29.211.6.45,10,4299,0,0,10,4299,0.000932000,1.9182
192.204.170.244,<->,133.178.227.27,0,0,10,2572,10,2572,0.000793000,1.9160
215.158.238.241,<->,113.23.14.212,10,2922,0,0,10,2922,0.000285000,1.5128
215.158.238.45,<->,192.205.37.205,9,1600,0,0,9,1600,1.936956000,0.0479
133.178.227.78,<->,80.57.141.92,9,1899,0,0,9,1899,1.853745000,0.0821
215.158.238.115,<->,56.161.218.21,9,3154,0,0,9,3154,1.852220000,0.1468
138.12.41.193,<->,50.224.108.137,0,0,9,4921,9,4921,1.802808000,0.1329
133.178.227.16,<->,133.56.180.58,9,3250,0,0,9,3250,1.802592000,0.1814
220.28.85.14,<->,136.25.188.234,0,0,9,12102,9,12102,1.802420000,0.0000
220.55.77.11,<->,220.50.241.131,9,2327,0,0,9,2327,1.792758000,0.1921
220.20.200.95,<->,139.33.210.9,9,5472,0,0,9,5472,1.767948000,0.0672
215.158.238.190,<->,201.136.143.27,9,1869,0,0,9,1869,1.760421000,0.2124
111.150.207.194,<->,8.252.221.65,0,0,9,504,9,504,1.736115000,0.0277
215.158.238.66,<->,131.2.102.201,9,1725,0,0,9,1725,1.735025000,0.1412
215.158.238.97,<->,142.204.32.87,9,1661,0,0,9,1661,1.720995000,0.1680
102.231.177.209,<->,8.20.81.32,9,9005,0,0,9,9005,1.671188000,0.2346
197.113.89.43,<->,136.25.188.222,0,0,9,1277,9,1277,1.666014000,0.1883
220.20.200.155,<->,198.205.121.180,9,7137,0,0,9,7137,1.653498000,0.2965
127.230.110.178,<->,102.51.94.244,0,0,9,6501,9,6501,1.649679000,0.2574
145.252.122.253,<->,100.120.38.6,9,4548,0,0,9,4548,1.635426000,0.3189
215.158.239.41,<->,114.142.109.167,9,1959,0,0,9,1959,1.622322000,0.1180
133.178.226.37,<->,131.6.152.20,9,1725,0,0,9,1725,1.618472000,0.2797
195.71.77.50,<->,136.25.188.209,0,0,9,2474,9,2474,1.616276000,0.3376
146.234.124.46,<->,0.195.210.8,0,0,9,814,9,814,1.595274000,0.1802
215.158.238.65,<->,106.188.251.205,9,1709,0,0,9,1709,1.591590000,0.1150
136.25.188.232,<->,98.219.126.140,9,10954,0,0,9,10954,1.589430000,0.0137
213.186.52.58,<->,144.85.170.208,0,0,9,1292,9,1292,1.587360000,0.1636
215.158.239.43,<->,8.252.253.232,9,3493,0,0,9,3493,1.586676000,0.2673
215.158.239.84,<->,207.59.48.166,9,705,0,0,9,705,1.576016000,0.3651
215.158.61.223,<->,8.176.8.179,0,0,9,5107,9,5107,1.573858000,0.1456
8.182.226.78,<->,6.133.198.119,9,1467,0,0,9,1467,1.559729000,0.1311
192.229.210.156,<->,50.55.217.174,9,1232,0,0,9,1232,1.551315000,0.1588
215.158.238.148,<->,122.158.49.129,9,3874,0,0,9,3874,1.544610000,0.4282
136.14.231.45,<->,8.176.43.29,0,0,9,864,9,864,1.531718000,0.2124
80.247.151.43,<->,8.52.135.159,0,0,9,1469,9,1469,1.523361000,0.0920
215.158.58.169,<->,6.73.247.119,0,0,9,10203,9,10203,1.521015000,0.2385
143.79.176.194,<->,136.25.188.236,0,0,9,993,9,993,1.513193000,0.3319
215.158.239.110,<->,111.151.237.143,9,11034,0,0,9,11034,1.512556000,0.1425
92.27.219.185,<->,54.46.22.61,9,5028,0,0,9,5028,1.508874000,0.4831
144.101.142.22,<->,136.25.188.253,0,0,9,1625,9,1625,1.507338000,0.2846
215.158.239.97,<->,199.33.218.12,9,1645,0,0,9,1645,1.503166000,0.3728
142.220.219.246,<->,136.25.188.52,0,0,9,1986,9,1986,1.503160000,0.4934
127.255.90.88,<->,92.162.253.37,0,0,9,8588,9,8588,1.503055000,0.2833
215.158.239.56,<->,143.13.158.147,9,734,0,0,9,734,1.501306000,0.4243
136.25.188.254,<->,29.211.6.38,9,1657,0,0,9,1657,1.500548000,0.3130
17.114.65.102,<->,8.220.176.253,0,0,9,1003,9,1003,1.494000000,0.3922
136.25.188.253,<->,97.233.59.95,9,1316,0,0,9,1316,1.492872000,0.2787
199.54.0.36,<->,50.223.3.228,0,0,9,700,9,700,1.486584000,0.4675
122.12.244.168,<->,92.162.253.187,0,0,9,10170,9,10170,1.480717000,0.1773
196.88.102.214,<->,136.25.188.253,0,0,9,1376,9,1376,1.478896000,0.3352
196.89.56.249,<->,136.25.188.241,0,0,9,702,9,702,1.474815000,0.5113
128.141.90.222,<->,0.195.210.42,0,0,9,1153,9,1153,1.470110000,0.4685
199.50.64.61,<->,136.25.188.163,0,0,9,1379,9,1379,1.466050000,0.2141
215.158.238.9,<->,8.191.10.214,9,1948,0,0,9,1948,1.464655000,0.0321
204.200.58.228,<->,136.25.188.55,0,0,9,943,9,943,1.463452000,0.5279
207.56.99.96,<->,136.25.188.236,0,0,9,1781,9,1781,1.461562000,0.4369
199.98.24.198,<->,8.252.222.179,0,0,9,1950,9,1950,1.460260000,0.5271
136.25.188.198,<->,114.66.221.60,9,1117,0,0,9,1117,1.459926000,0.3944
133.148.242.157,<->,8.220.202.24,0,0,9,821,9,821,1.457356000,0.2626
215.158.238.104,<->,80.47.111.27,9,4231,0,0,9,4231,1.452360000,0.4545
207.56.62.103,<->,136.25.188.225,0,0,9,1276,9,1276,1.446534000,0.3866
97.168.64.3,<->,54.55.198.23,9,5056,0,0,9,5056,1.444224000,0.3212
199.15.232.65,<->,136.25.188.174,0,0,9,1730,9,1730,1.431040000,0.5457
133.178.226.38,<->,64.152.12.85,9,1725,0,0,9,1725,1.416580000,0.3960
207.172.1.228,<->,136.25.188.252,0,0,9,1213,9,1213,1.409614000,0.5899
159.190.87.59,<->,8.182.226.78,0,0,9,851,9,851,1.408427000,0.3420
204.3.22.53,<->,136.25.188.198,0,0,9,1383,9,1383,1.398710000,0.3358
97.203.38.177,<->,8.182.252.86,0,0,9,1067,9,1067,1.397939000,0.5011
215.158.61.211,<->,136.25.189.214,0,0,9,5075,9,5075,1.390965000,0.3308
127.24.153.155,<->,50.224.108.171,0,0,9,1912,9,1912,1.390095000,0.5803
215.158.239.32,<->,106.188.184.169,9,3615,0,0,9,3615,1.377278000,0.3822
215.158.239.58,<->,202.33.247.174,9,504,0,0,9,504,1.375363000,0.2390
146.249.227.195,<->,8.252.222.140,0,0,9,1696,9,1696,1.370319000,0.6223
215.158.239.85,<->,8.255.92.165,9,2942,0,0,9,2942,1.369524000,0.5403
136.25.189.33,<->,57.227.81.41,9,2135,0,0,9,2135,1.362790000,0.4678
142.229.195.2,<->,136.25.188.222,0,0,9,2018,9,2018,1.358230000,0.6388
215.158.239.95,<->,204.226.116.98,9,1381,0,0,9,1381,1.355535000,0.2662
142.167.120.221,<->,136.25.188.173,0,0,9,862,9,862,1.344813000,0.6493
136.138.112.209,<->,133.178.226.77,0,0,9,2834,9,2834,1.341185000,0.4429
144.85.170.208,<->,98.87.147.158,9,1176,0,0,9,1176,1.337959000,0.5669
146.148.96.104,<->,8.252.221.223,0,0,9,1024,9,1024,1.331547000,0.5274
136.25.188.178,<->,98.32.65.40,9,925,0,0,9,925,1.330312000,0.2959
146.199.211.55,<->,0.195.210.42,0,0,9,1341,9,1341,1.326678000,0.6439
224.148.55.181,<->,100.124.212.156,9,4843,0,0,9,4843,1.325683000,0.3085
213.186.59.172,<->,144.85.170.208,0,0,9,891,9,891,1.317255000,0.5246
215.158.238.107,<->,88.3.1.165,9,1709,0,0,9,1709,1.316029000,0.5257
139.160.226.234,<->,136.25.188.47,0,0,9,3026,9,3026,1.314094000,0.3410
215.158.239.30,<->,125.84.52.215,9,1976,0,0,9,1976,1.306471000,0.3233
215.158.239.232,<->,192.228.30.153,9,6031,0,0,9,6031,1.304053000,0.0998
215.158.239.71,<->,48.131.158.219,9,3090,0,0,9,3090,1.303287000,0.3780
17.125.125.157,<->,8.52.182.237,0,0,9,8555,9,8555,1.302381000,0.6575
215.158.238.64,<->,8.42.43.38,9,3217,0,0,9,3217,1.299793000,0.5290
139.193.141.143,<->,127.138.6.148,9,1996,0,0,9,1996,1.296491000,0.4336
80.41.26.161,<->,8.179.131.127,9,4316,0,0,9,4316,1.295410000,0.6645
221.102.56.69,<->,6.74.243.3,0,0,9,996,9,996,1.293570000,0.5654
149.210.211.99,<->,50.224.76.248,0,0,9,2897,9,2897,1.290173000,0.3698
138.127.205.200,<->,97.126.19.181,0,0,9,6802,9,6802,1.284000000,0.0973
142.244.196.118,<->,136.25.188.241,0,0,9,1352,9,1352,1.282298000,0.1823
130.2.106.238,<->,50.224.76.234,0,0,9,4872,9,4872,1.279362000,0.6466
53.160.78.66,<->,48.54.99.153,0,0,9,5382,9,5382,1.268589000,0.6142
142.167.129.36,<->,136.25.188.242,0,0,9,1848,9,1848,1.265944000,0.5377
142.195.173.168,<->,136.25.188.242,0,0,9,1807,9,1807,1.265063000,0.4728
215.158.239.96,<->,194.234.245.232,9,936,0,0,9,936,1.263824000,0.7290
215.158.238.132,<->,104.3.163.55,9,4435,0,0,9,4435,1.259660000,0.6499
215.158.239.56,<->,199.106.247.102,9,612,0,0,9,612,1.257330000,0.7198
215.158.238.66,<->,56.102.22.9,9,2770,0,0,9,2770,1.253212000,0.4160
133.178.227.27,<->,133.56.180.7,9,6734,0,0,9,6734,1.251334000,0.7472
215.158.238.176,<->,201.211.112.235,9,1789,0,0,9,1789,1.247011000,0.3893
215.158.238.73,<->,80.47.111.91,9,4183,0,0,9,4183,1.236267000,0.7074
204.17.171.198,<->,50.223.3.228,0,0,9,701,9,701,1.231674000,0.6496
136.25.188.45,<->,122.159.245.164,9,5724,0,0,9,5724,1.229222000,0.7536
53.86.58.175,<->,8.228.213.135,0,0,9,4391,9,4391,1.226680000,0.3544
215.158.239.25,<->,96.135.154.115,9,6550,0,0,9,6550,1.220672000,0.2639
215.110.27.80,<->,8.220.178.166,0,0,9,3303,9,3303,1.218549000,0.2082
97.203.79.210,<->,8.182.228.189,0,0,9,880,9,880,1.215693000,0.4418
136.25.188.47,<->,29.214.108.64,9,4247,0,0,9,4247,1.211613000,0.6959
215.158.30.218,<->,8.252.222.59,0,0,9,6014,9,6014,1.209233000,0.2637
199.71.214.85,<->,136.25.188.254,0,0,9,1229,9,1229,1.201322000,0.3670
138.90.73.184,<->,133.32.39.1,0,0,9,3778,9,3778,1.196504000,0.1614
215.158.238.63,<->,8.192.205.94,9,11017,0,0,9,11017,1.195778000,0.1714
199.54.200.215,<->,8.252.222.174,0,0,9,864,9,864,1.195098000,0.7503
215.158.239.94,<->,194.251.88.123,9,2057,0,0,9,2057,1.193625000,0.4860
213.186.61.53,<->,144.85.170.208,0,0,9,898,9,898,1.190881000,0.2459
204.143.31.64,<->,8.182.248.147,0,0,9,818,9,818,1.189483000,0.7007
215.158.239.35,<->,106.188.214.30,9,3405,0,0,9,3405,1.185187000,0.7159
215.158.239.56,<->,196.105.24.5,9,4210,0,0,9,4210,1.181525000,0.6710
213.221.90.178,<->,144.85.170.254,0,0,9,794,9,794,1.180571000,0.3270
97.198.121.8,<->,80.27.154.150,9,1497,0,0,9,1497,1.180564000,0.1666
109.222.206.118,<->,53.209.197.220,9,4887,0,0,9,4887,1.178044000,0.3143
144.72.193.17,<->,99.75.53.165,0,0,9,5046,9,5046,1.170689000,0.1706
135.253.11.54,<->,133.178.226.19,0,0,9,2327,9,2327,1.169285000,0.4342
249.101.118.139,<->,144.72.193.17,9,5046,0,0,9,5046,1.161886000,0.1860
197.113.99.93,<->,136.25.188.236,0,0,9,1213,9,1213,1.161195000,0.7789
215.158.239.87,<->,196.95.52.65,9,504,0,0,9,504,1.152760000,0.7002
159.137.162.213,<->,82.150.50.215,9,1032,0,0,9,1032,1.150301000,0.2100
159.80.141.193,<->,8.252.223.143,0,0,9,4333,9,4333,1.148636000,0.0587
144.64.139.153,<->,27.155.173.243,9,814,0,0,9,814,1.146942000,0.7599
133.178.226.77,<->,113.23.21.222,9,2850,0,0,9,2850,1.139424000,0.8169
136.139.59.106,<->,136.25.188.210,0,0,9,1565,9,1565,1.138652000,0.1827
143.43.127.33,<->,136.25.188.226,0,0,9,742,9,742,1.137705000,0.6854
138.127.224.166,<->,136.25.188.35,0,0,9,2532,9,2532,1.132240000,0.0059
136.25.189.59,<->,56.28.207.200,9,4707,0,0,9,4707,1.124784000,0.5543
215.158.238.121,<->,65.27.228.187,9,3090,0,0,9,3090,1.117175000,0.5747
210.221.107.50,<->,8.222.6.39,9,3101,0,0,9,3101,1.113294000,0.3995
215.158.239.51,<->,199.20.122.136,9,1365,0,0,9,1365,1.100948000,0.1673
215.158.238.148,<->,118.20.114.86,9,1661,0,0,9,1661,1.100899000,0.2786
199.32.227.43,<->,136.25.188.163,0,0,9,1312,9,1312,1.100724000,0.5179
215.158.238.32,<->,57.227.77.108,9,1613,0,0,9,1613,1.092066000,0.0985
209.91.207.218,<->,8.53.11.187,0,0,9,863,9,863,1.089101000,0.0520
109.1.61.54,<->,97.198.98.222,0,0,9,504,9,504,1.085140000,0.9038
98.230.219.13,<->,8.182.224.248,0,0,9,1088,9,1088,1.084754000,0.2481
215.158.238.120,<->,131.144.113.193,9,4215,0,0,9,4215,1.082793000,0.7588
140.218.109.36,<->,136.25.188.242,0,0,9,1613,9,1613,1.078397000,0.2122
98.129.85.211,<->,97.4.157.23,9,4860,0,0,9,4860,1.076932000,0.1240
215.158.238.66,<->,98.166.239.42,9,1821,0,0,9,1821,1.073768000,0.2012
215.158.239.146,<->,111.151.237.153,9,3882,0,0,9,3882,1.072949000,0.2610
215.158.103.203,<->,89.193.125.208,9,6087,0,0,9,6087,1.070612000,0.6396
213.186.52.118,<->,144.85.170.208,0,0,9,892,9,892,1.069136000,0.5855
133.178.226.80,<->,111.150.34.244,9,2978,0,0,9,2978,1.058219000,0.7734
50.224.76.235,<->,50.163.8.133,9,5979,0,0,9,5979,1.055919000,0.7018
136.25.189.42,<->,96.156.169.237,9,9714,0,0,9,9714,1.052259000,0.8302
139.47.193.207,<->,101.224.89.168,0,0,9,6915,9,6915,1.047579000,0.0380
136.25.189.80,<->,29.212.180.200,9,4199,0,0,9,4199,1.045561000,0.8272
215.158.239.92,<->,199.20.4.55,9,2925,0,0,9,2925,1.041409000,0.8300
215.158.239.94,<->,113.23.66.254,9,1837,0,0,9,1837,1.038006000,0.1392
144.232.207.109,<->,8.252.221.171,0,0,9,2270,9,2270,1.030182000,0.4845
144.85.170.208,<->,91.69.181.137,9,907,0,0,9,907,1.020374000,0.3668
207.57.68.206,<->,136.25.188.255,0,0,9,3584,9,3584,1.019379000,0.7016
136.25.189.41,<->,96.156.169.205,9,7047,0,0,9,7047,1.018216000,0.4459
145.221.38.45,<->,8.182.226.42,0,0,9,1012,9,1012,1.013671000,0.6845
215.158.238.83,<->,198.204.76.253,9,1517,0,0,9,1517,1.008141000,0.5681
205.127.108.113,<->,101.224.89.153,0,0,9,6017,9,6017,0.995184000,0.8480
204.187.57.196,<->,136.25.188.253,0,0,9,516,9,516,0.993125000,0.0002
136.25.189.80,<->,118.20.100.91,9,5036,0,0,9,5036,0.992922000,0.9612
122.158.179.43,<->,8.252.223.153,0,0,9,1491,9,1491,0.990519000,0.4860
215.158.239.86,<->,106.188.253.167,9,3508,0,0,9,3508,0.987366000,0.5778
8.252.221.97,<->,8.240.125.171,9,1364,0,0,9,1364,0.985460000,0.9964
215.158.239.56,<->,142.254.254.20,9,2004,0,0,9,2004,0.981467000,0.4361
133.178.226.29,<->,29.211.122.247,9,1837,0,0,9,1837,0.977246000,0.1130
145.71.120.152,<->,80.42.173.35,0,0,9,504,9,504,0.975843000,0.2049
215.158.238.132,<->,126.219.196.185,9,1597,0,0,9,1597,0.973445000,0.5623
195.14.220.180,<->,136.25.188.52,0,0,9,699,9,699,0.961051000,0.8946
215.158.238.64,<->,122.158.49.151,9,3858,0,0,9,3858,0.959998000,1.0065
144.85.170.208,<->,98.87.146.78,9,1119,0,0,9,1119,0.959422000,0.1558
195.70.247.95,<->,136.25.188.46,0,0,9,504,9,504,0.958632000,0.9050
136.25.189.92,<->,96.156.169.209,9,11391,0,0,9,11391,0.957061000,0.0070
199.83.33.28,<->,8.52.134.46,0,0,9,3524,9,3524,0.955791000,0.9811
136.25.188.44,<->,69.31.238.52,9,3090,0,0,9,3090,0.951179000,0.9583
136.25.188.252,<->,83.226.197.42,9,2759,0,0,9,2759,0.950611000,0.6701
101.126.191.157,<->,8.20.81.14,9,5876,0,0,9,5876,0.949415000,0.2316
213.186.52.80,<->,144.85.170.208,0,0,9,899,9,899,0.949203000,0.2111
192.204.151.81,<->,136.25.188.161,0,0,9,1857,9,1857,0.943677000,0.5555
195.7.77.1,<->,136.25.188.197,0,0,9,2644,9,2644,0.943112000,0.8632
215.158.239.28,<->,120.155.14.151,9,3317,0,0,9,3317,0.939460000,0.4803
136.139.59.117,<->,136.25.189.88,0,0,9,3122,9,3122,0.934514000,0.9579
197.113.99.253,<->,136.25.188.254,0,0,9,862,9,862,0.928735000,0.8906
93.181.154.60,<->,92.27.219.143,0,0,9,1130,9,1130,0.927638000,0.7974
197.113.99.253,<->,136.25.188.239,0,0,9,830,9,830,0.926710000,0.9197
158.192.3.5,<->,133.178.226.28,0,0,9,1629,9,1629,0.925744000,0.1750
136.25.189.46,<->,96.156.169.253,9,4599,0,0,9,4599,0.916925000,0.9869
142.248.4.138,<->,136.25.188.176,0,0,9,943,9,943,0.915273000,0.9735
129.225.3.123,<->,89.183.104.188,0,0,9,4726,9,4726,0.914817000,0.1707
220.55.98.90,<->,197.158.1.206,9,896,0,0,9,896,0.910244000,0.4504
199.12.99.193,<->,8.252.222.237,0,0,9,1519,9,1519,0.910227000,1.0338
220.28.73.211,<->,136.25.188.192,0,0,9,12291,9,12291,0.907713000,0.0000
215.158.239.48,<->,199.106.16.251,9,1644,0,0,9,1644,0.901067000,1.0705
111.147.128.43,<->,27.187.159.112,9,6636,0,0,9,6636,0.891562000,0.6113
206.103.215.203,<->,136.25.189.82,0,0,9,2135,9,2135,0.886169000,0.3881
111.230.154.167,<->,50.224.76.235,0,0,9,3551,9,3551,0.883001000,0.2017
215.158.239.56,<->,196.240.171.72,9,1332,0,0,9,1332,0.874813000,0.1485
109.222.242.54,<->,53.83.54.62,9,7597,0,0,9,7597,0.872630000,0.2902
197.113.64.252,<->,136.25.188.241,0,0,9,1356,9,1356,0.868419000,1.0308
215.158.239.50,<->,199.20.28.255,9,550,0,0,9,550,0.866286000,0.0198
204.184.113.58,<->,136.25.188.243,0,0,9,612,9,612,0.865937000,0.3500
101.70.121.9,<->,53.188.60.137,9,4733,0,0,9,4733,0.865903000,0.2547
213.186.61.87,<->,144.85.170.254,0,0,9,1205,9,1205,0.861481000,0.3074
66.59.16.129,<->,8.252.221.230,0,0,9,2728,9,2728,0.856866000,1.0335
133.178.226.37,<->,118.20.114.94,9,1805,0,0,9,1805,0.846686000,0.4290
136.25.189.12,<->,98.28.95.85,9,6625,0,0,9,6625,0.846263000,1.1281
215.158.61.243,<->,8.176.8.252,0,0,9,3813,9,3813,0.846007000,0.6844
136.25.189.33,<->,126.219.194.74,9,5532,0,0,9,5532,0.845433000,1.1422
225.3.225.27,<->,92.27.27.174,0,0,9,13122,9,13122,0.843434000,1.0925
215.158.239.97,<->,207.236.94.93,9,1584,0,0,9,1584,0.842603000,0.9865
231.138.232.202,<->,136.25.188.174,0,0,9,5207,9,5207,0.840158000,0.9002
142.227.194.228,<->,136.25.188.196,0,0,9,1008,9,1008,0.836048000,0.9512
251.122.143.50,<->,50.224.76.234,0,0,9,2612,9,2612,0.835845000,0.5079
215.158.195.26,<->,122.158.69.2,9,10008,0,0,9,10008,0.835458000,0.1893
133.178.226.70,<->,106.188.228.1,9,2583,0,0,9,2583,0.828247000,0.7202
136.25.188.194,<->,98.219.126.140,9,12376,0,0,9,12376,0.823431000,0.0000
192.171.32.145,<->,133.178.227.79,0,0,9,2524,9,2524,0.817664000,0.7423
215.158.238.223,<->,33.209.219.19,9,2524,0,0,9,2524,0.817001000,0.4727
215.158.239.77,<->,199.20.30.206,9,2379,0,0,9,2379,0.815517000,0.8388
215.158.238.105,<->,206.103.215.229,9,1661,0,0,9,1661,0.810915000,0.0949
215.158.239.49,<->,196.106.38.147,9,2105,0,0,9,2105,0.810405000,1.0229
199.51.26.249,<->,136.25.188.198,0,0,9,2092,9,2092,0.806559000,1.0629
205.148.107.77,<->,192.64.244.21,0,0,9,630,9,630,0.804052000,0.5400
142.229.81.165,<->,136.25.188.225,0,0,9,1353,9,1353,0.801503000,0.2302
215.158.127.59,<->,8.176.8.85,0,0,9,11282,9,11282,0.797741000,0.1125
17.214.234.252,<->,8.52.189.207,0,0,9,860,9,860,0.797399000,0.1131
245.61.110.58,<->,8.20.87.153,0,0,9,1238,9,1238,0.790522000,0.6578
60.101.122.126,<->,8.252.222.49,0,0,9,1249,9,1249,0.789355000,0.4946
17.41.129.123,<->,8.52.142.60,0,0,9,710,9,710,0.786431000,0.9602
215.158.238.123,<->,131.1.195.223,9,1896,0,0,9,1896,0.785904000,0.5033
199.121.38.130,<->,136.25.188.254,0,0,9,1653,9,1653,0.785635000,1.0699
243.117.93.179,<->,80.38.62.152,0,0,9,1446,9,1446,0.781433000,0.2807
215.158.61.193,<->,8.176.8.104,0,0,9,12255,9,12255,0.780576000,0.9871
215.158.140.93,<->,113.23.101.164,9,1829,0,0,9,1829,0.779197000,0.1110
195.124.95.2,<->,136.25.188.177,0,0,9,1229,9,1229,0.772676000,0.9202
215.158.238.66,<->,114.146.74.212,9,1693,0,0,9,1693,0.768356000,0.1484
215.158.239.57,<->,199.20.28.194,9,1229,0,0,9,1229,0.766698000,0.4495
136.25.189.0,<->,133.146.0.252,9,4071,0,0,9,4071,0.765656000,0.8604
215.158.239.97,<->,196.107.81.60,9,450,0,0,9,450,0.759968000,0.0016
215.158.239.104,<->,97.95.162.108,9,3106,0,0,9,3106,0.756901000,1.1885
215.158.239.96,<->,194.251.68.138,9,2047,0,0,9,2047,0.756695000,0.5100
215.158.238.47,<->,33.209.217.238,9,3024,0,0,9,3024,0.756550000,0.7022
207.62.177.82,<->,136.25.188.46,0,0,9,1413,9,1413,0.752824000,0.9929
247.136.229.231,<->,8.55.119.58,9,5145,0,0,9,5145,0.741701000,0.1710
144.85.170.254,<->,139.128.103.160,9,1195,0,0,9,1195,0.741630000,0.1300
215.158.238.92,<->,33.209.217.245,9,3538,0,0,9,3538,0.738408000,1.2071
215.158.239.56,<->,196.94.181.75,9,1079,0,0,9,1079,0.738304000,0.8200
215.158.239.95,<->,199.78.183.177,9,504,0,0,9,504,0.737613000,0.2600
249.101.194.241,<->,53.244.240.5,9,4032,0,0,9,4032,0.737280000,0.6011
136.25.189.33,<->,96.156.169.49,9,5708,0,0,9,5708,0.733597000,1.1740
50.224.76.234,<->,48.129.152.119,9,2268,0,0,9,2268,0.727494000,0.3934
231.140.133.104,<->,215.158.239.84,0,0,9,1390,9,1390,0.724237000,0.6186
145.118.59.20,<->,92.27.27.170,0,0,9,3756,9,3756,0.723517000,0.2166
192.62.162.66,<->,50.224.105.36,0,0,9,564,9,564,0.722273000,1.2735
207.173.181.66,<->,136.25.188.44,0,0,9,504,9,504,0.721611000,1.0000
215.158.239.84,<->,199.20.7.48,9,516,0,0,9,516,0.720383000,0.9998
215.158.239.79,<->,199.20.29.22,9,2017,0,0,9,2017,0.719029000,1.0099
207.101.155.58,<->,8.182.226.78,0,0,9,743,9,743,0.717890000,0.9835
246.253.217.173,<->,143.76.143.45,9,2391,0,0,9,2391,0.717692000,0.4645
198.206.114.227,<->,99.75.71.96,0,0,9,3813,9,3813,0.706552000,0.4546
215.158.238.189,<->,122.158.245.7,9,2835,0,0,9,2835,0.705957000,1.2014
218.56.156.55,<->,215.158.140.172,0,0,9,1607,9,1607,0.704820000,0.0442
207.173.44.120,<->,136.25.188.209,0,0,9,1213,9,1213,0.704140000,0.8694
215.158.239.76,<->,195.13.248.126,9,1682,0,0,9,1682,0.703086000,0.8818
215.158.238.198,<->,131.219.110.169,9,3567,0,0,9,3567,0.700750000,1.2376
215.158.239.49,<->,207.114.241.57,9,1975,0,0,9,1975,0.699294000,0.8893
92.168.217.244,<->,50.136.158.33,9,504,0,0,9,504,0.697742000,1.2587
231.143.102.160,<->,136.25.188.243,0,0,9,1548,9,1548,0.693866000,1.0112
204.185.23.179,<->,136.25.188.53,0,0,9,612,9,612,0.690243000,0.9969
136.25.188.175,<->,35.77.19.118,9,1905,0,0,9,1905,0.684135000,1.3153
215.158.239.50,<->,199.39.194.53,9,854,0,0,9,854,0.680336000,0.7413
139.241.64.230,<->,6.73.247.75,0,0,9,9442,9,9442,0.677753000,0.0877
159.137.249.250,<->,104.208.190.89,9,1840,0,0,9,1840,0.676197000,0.9710
215.158.238.83,<->,111.151.70.52,9,1677,0,0,9,1677,0.673273000,0.7942
194.237.103.36,<->,136.25.188.226,0,0,9,1343,9,1343,0.667328000,0.7288
215.158.238.135,<->,38.104.11.106,9,2722,0,0,9,2722,0.666943000,0.4980
136.25.188.52,<->,112.235.95.73,9,2946,0,0,9,2946,0.666384000,0.9303
215.158.239.58,<->,199.82.248.236,9,552,0,0,9,552,0.663456000,1.3031
199.120.153.238,<->,136.25.188.52,0,0,9,957,9,957,0.662274000,1.0271
204.18.234.172,<->,50.223.3.228,0,0,9,456,9,456,0.658969000,1.2021
143.76.137.81,<->,8.182.241.177,0,0,9,1532,9,1532,0.657569000,1.2241
136.25.189.88,<->,29.211.93.22,9,4263,0,0,9,4263,0.656412000,1.1562
136.25.188.223,<->,38.104.11.54,9,1853,0,0,9,1853,0.646540000,0.2466
215.158.239.57,<->,196.91.186.38,9,1268,0,0,9,1268,0.642985000,0.5598
199.100.197.88,<->,50.223.3.228,0,0,9,450,9,450,0.641144000,1.2803
199.39.149.173,<->,136.25.188.226,0,0,9,2077,9,2077,0.640938000,0.4811
215.158.239.70,<->,133.146.0.197,9,5340,0,0,9,5340,0.639562000,1.1710
133.178.227.79,<->,61.72.108.162,9,2994,0,0,9,2994,0.634842000,1.1958
136.25.189.0,<->,96.156.169.203,9,5372,0,0,9,5372,0.631220000,1.0526
136.25.189.83,<->,106.188.253.181,9,4557,0,0,9,4557,0.629655000,1.0997
215.158.239.77,<->,142.221.50.164,9,2019,0,0,9,2019,0.627645000,0.8612
144.93.20.73,<->,109.222.231.140,0,0,9,5302,9,5302,0.626950000,0.2437
247.136.226.117,<->,129.16.253.244,9,6444,0,0,9,6444,0.626829000,0.3205
215.158.239.224,<->,137.107.106.110,9,6322,0,0,9,6322,0.626281000,0.8621
192.247.239.13,<->,8.220.190.86,0,0,9,2220,9,2220,0.622258000,1.0598
136.25.188.224,<->,111.31.101.206,9,1206,0,0,9,1206,0.620931000,0.1248
89.158.50.248,<->,48.53.141.23,0,0,9,8981,9,8981,0.620636000,1.1253
89.183.104.247,<->,66.13.105.220,9,585,0,0,9,585,0.620326000,1.0263
108.41.82.75,<->,8.220.190.86,0,0,9,2168,9,2168,0.619989000,1.3708
204.60.25.85,<->,136.25.188.227,0,0,9,1717,9,1717,0.611549000,1.2914
133.178.226.29,<->,118.20.108.91,9,1581,0,0,9,1581,0.611054000,0.2174
215.158.239.179,<->,8.191.15.133,9,1241,0,0,9,1241,0.610431000,0.0262
196.148.124.252,<->,143.20.35.28,9,4714,0,0,9,4714,0.605780000,0.9142
215.158.239.84,<->,199.106.51.143,9,1973,0,0,9,1973,0.600104000,0.9100
133.178.226.29,<->,65.27.220.208,9,2890,0,0,9,2890,0.598142000,1.0321
215.158.239.57,<->,207.239.53.40,9,826,0,0,9,826,0.596075000,0.8000
215.158.239.79,<->,215.158.44.209,9,5468,0,0,9,5468,0.595439000,1.1043
215.158.239.70,<->,215.158.44.209,9,5196,0,0,9,5196,0.594275000,1.0122
138.126.75.74,<->,136.25.188.172,0,0,9,3010,9,3010,0.591351000,0.5703
139.241.56.46,<->,99.74.87.215,0,0,9,5041,9,5041,0.590075000,0.1534
215.158.239.99,<->,199.20.31.38,9,504,0,0,9,504,0.590024000,1.0036
215.158.239.6,<->,96.135.154.126,9,4660,0,0,9,4660,0.587420000,0.7574
17.26.173.37,<->,8.53.7.195,0,0,9,2110,9,2110,0.584340000,0.5958
215.158.239.99,<->,199.20.29.99,9,2684,0,0,9,2684,0.583669000,1.3999
136.25.188.197,<->,131.1.253.251,9,3282,0,0,9,3282,0.583561000,1.0133
215.158.238.72,<->,104.3.168.212,9,5420,0,0,9,5420,0.583505000,1.3029
195.54.69.148,<->,136.25.188.242,0,0,9,504,9,504,0.581305000,0.0145
204.20.159.71,<->,136.25.188.253,0,0,9,1639,9,1639,0.575565000,1.1773
218.4.171.168,<->,8.192.173.161,9,1004,0,0,9,1004,0.569266000,0.9660
127.168.165.134,<->,8.176.8.225,0,0,9,1228,9,1228,0.564357000,1.3904
215.158.239.93,<->,199.20.31.136,9,2072,0,0,9,2072,0.563140000,1.0588
133.178.226.90,<->,131.1.195.230,9,6031,0,0,9,6031,0.562535000,1.3244
139.160.226.203,<->,136.25.189.12,0,0,9,4279,9,4279,0.561691000,0.7406
207.188.201.33,<->,136.25.188.209,0,0,9,450,9,450,0.559600000,0.1827
215.158.239.96,<->,204.2.2.173,9,891,0,0,9,891,0.559237000,1.1986
136.25.189.21,<->,96.156.169.207,9,11114,0,0,9,11114,0.556648000,0.6466
148.211.214.186,<->,139.47.239.40,0,0,9,913,9,913,0.550848000,1.2341
215.158.239.35,<->,122.158.246.197,9,3309,0,0,9,3309,0.549542000,0.8477
195.70.125.179,<->,136.25.188.238,0,0,9,3155,9,3155,0.548864000,1.2792
145.76.225.245,<->,80.27.158.226,0,0,9,1658,9,1658,0.546891000,0.9313
129.225.132.224,<->,129.225.131.135,9,2011,0,0,9,2011,0.545178000,1.4117
215.158.61.202,<->,8.176.8.186,0,0,9,8279,9,8279,0.542435000,1.1535
215.158.238.81,<->,131.1.253.250,9,4231,0,0,9,4231,0.542175000,1.3849
220.20.200.127,<->,144.83.60.153,9,5182,0,0,9,5182,0.541022000,0.1556
215.158.239.99,<->,195.81.49.78,9,1431,0,0,9,1431,0.538711000,1.1387
100.230.151.30,<->,80.27.153.11,0,0,9,1924,9,1924,0.533465000,0.7031
215.158.239.5,<->,8.255.92.81,9,1482,0,0,9,1482,0.532285000,0.0485
195.54.101.116,<->,136.25.188.255,0,0,9,2010,9,2010,0.531831000,1.2550
207.60.253.45,<->,136.25.188.209,0,0,9,738,9,738,0.531733000,0.4946
199.39.121.249,<->,136.25.188.198,0,0,9,450,9,450,0.531281000,1.4059
192.227.190.234,<->,136.25.188.174,0,0,9,5127,9,5127,0.531027000,1.3943
133.178.227.41,<->,106.188.245.227,9,1885,0,0,9,1885,0.529476000,0.0972
215.158.239.57,<->,142.244.45.63,9,1656,0,0,9,1656,0.529110000,0.4388
204.187.158.159,<->,136.25.188.53,0,0,9,612,9,612,0.527245000,1.4376
195.13.224.150,<->,136.25.188.196,0,0,9,1249,9,1249,0.525739000,0.7019
215.158.239.96,<->,199.20.5.87,9,2772,0,0,9,2772,0.524224000,1.2192
215.158.238.132,<->,126.219.60.201,9,504,0,0,9,504,0.517169000,0.0629
98.101.92.196,<->,8.183.25.25,0,0,9,1208,9,1208,0.516409000,0.2784
136.25.188.226,<->,57.199.250.198,9,1789,0,0,9,1789,0.516074000,0.2681
215.158.239.48,<->,194.237.127.175,9,2069,0,0,9,2069,0.515409000,0.6857
249.229.108.126,<->,144.75.218.95,0,0,9,1042,9,1042,0.514118000,0.2155
215.158.239.92,<->,142.236.129.128,9,1346,0,0,9,1346,0.513152000,0.6080
235.253.220.218,<->,215.158.140.75,0,0,9,2709,9,2709,0.509934000,0.9343
133.178.227.249,<->,8.35.106.108,9,7927,0,0,9,7927,0.509590000,0.7320
215.158.239.57,<->,195.15.42.68,9,1682,0,0,9,1682,0.509311000,1.1772
148.190.126.34,<->,133.178.227.57,0,0,9,4175,9,4175,0.506196000,1.1488
143.227.108.20,<->,136.25.188.242,0,0,9,4055,9,4055,0.504262000,1.1426
204.200.40.49,<->,136.25.188.198,0,0,9,1658,9,1658,0.502100000,0.9568
199.32.227.43,<->,136.25.188.52,0,0,9,1314,9,1314,0.501416000,0.3471
215.158.239.78,<->,29.209.59.173,9,4135,0,0,9,4135,0.499263000,0.9387
205.127.108.113,<->,33.233.141.41,0,0,9,6475,9,6475,0.495949000,0.6544
195.7.218.163,<->,136.25.188.196,0,0,9,774,9,774,0.494998000,1.2709
213.186.61.123,<->,144.85.170.208,0,0,9,907,9,907,0.492500000,0.7763
196.27.106.162,<->,50.223.3.228,0,0,9,450,9,450,0.491630000,1.2947
215.158.239.48,<->,143.42.138.19,9,1669,0,0,9,1669,0.490632000,0.9397
133.178.226.173,<->,133.146.0.36,9,10091,0,0,9,10091,0.486989000,1.1430
215.158.239.48,<->,199.20.28.56,9,1253,0,0,9,1253,0.483602000,1.4889
144.76.43.245,<->,80.56.78.128,0,0,9,954,9,954,0.482413000,1.4667
148.26.113.3,<->,136.25.189.2,0,0,9,1789,9,1789,0.479566000,0.1935
199.68.36.213,<->,136.25.188.54,0,0,9,450,9,450,0.477891000,0.1910
215.158.238.198,<->,192.224.20.231,9,1496,0,0,9,1496,0.469671000,0.0327
136.25.189.13,<->,133.224.119.35,9,4679,0,0,9,4679,0.469045000,1.1072
199.14.179.172,<->,136.25.188.255,0,0,9,3029,9,3029,0.468783000,0.9640
204.62.23.163,<->,136.25.188.252,0,0,9,504,9,504,0.463972000,0.4403
136.25.189.77,<->,96.156.169.162,9,5932,0,0,9,5932,0.463660000,1.4040
136.139.59.124,<->,136.25.188.223,0,0,9,2882,9,2882,0.460965000,1.4524
215.158.238.135,<->,192.227.190.234,9,3858,0,0,9,3858,0.458569000,1.2436
215.158.239.92,<->,199.20.30.149,9,2019,0,0,9,2019,0.458193000,1.5196
246.253.157.31,<->,198.105.44.83,9,4782,0,0,9,4782,0.458163000,1.4564
133.178.226.77,<->,57.210.107.8,9,3218,0,0,9,3218,0.456819000,0.6768
136.25.188.48,<->,100.224.202.184,9,9805,0,0,9,9805,0.456304000,1.0878
196.89.167.0,<->,136.25.188.222,0,0,9,1165,9,1165,0.451861000,0.2759
132.152.154.122,<->,8.52.154.216,0,0,9,3168,9,3168,0.450979000,0.2811
223.114.173.152,<->,8.252.221.222,0,0,9,840,9,840,0.450298000,0.9154
215.158.61.145,<->,136.25.189.210,0,0,9,8353,9,8353,0.449299000,1.5266
205.127.108.114,<->,111.20.168.155,0,0,9,2678,9,2678,0.448887000,1.2156
215.158.239.57,<->,120.154.71.22,9,5452,0,0,9,5452,0.446986000,1.5392
249.101.203.62,<->,54.69.79.171,9,2316,0,0,9,2316,0.439504000,0.8894
133.178.226.90,<->,96.155.60.194,9,5276,0,0,9,5276,0.439044000,0.5077
149.163.134.234,<->,133.178.227.76,0,0,9,3570,9,3570,0.437675000,1.4847
207.57.85.248,<->,136.25.188.52,0,0,9,1624,9,1624,0.432773000,0.8819
133.178.226.31,<->,114.25.48.34,9,2994,0,0,9,2994,0.430791000,1.4631
215.158.140.206,<->,8.222.7.187,9,4402,0,0,9,4402,0.429770000,1.4428
136.25.188.192,<->,56.51.205.162,9,10071,0,0,9,10071,0.428444000,0.5982
215.158.238.133,<->,8.217.44.52,9,1693,0,0,9,1693,0.424226000,0.5489
215.158.239.167,<->,105.119.200.175,9,3296,0,0,9,3296,0.423217000,0.8462
213.221.90.199,<->,144.85.170.254,0,0,9,905,9,905,0.417378000,0.2698
215.158.238.82,<->,126.219.194.140,9,2930,0,0,9,2930,0.417056000,1.1784
215.158.239.58,<->,204.226.116.227,9,1912,0,0,9,1912,0.416521000,0.5110
148.224.137.73,<->,136.25.188.172,0,0,9,3114,9,3114,0.412643000,1.0218
215.158.238.115,<->,122.159.245.164,9,4407,0,0,9,4407,0.411633000,1.5849
89.183.109.84,<->,53.230.56.250,9,4523,0,0,9,4523,0.408495000,0.4166
215.158.239.57,<->,29.214.109.128,9,5420,0,0,9,5420,0.407116000,1.5317
215.158.239.84,<->,8.215.68.90,9,4295,0,0,9,4295,0.404944000,1.4405
195.39.82.25,<->,8.182.241.177,0,0,9,450,9,450,0.403663000,0.1877
92.27.219.44,<->,53.214.117.99,9,4731,0,0,9,4731,0.403486000,0.0294
136.25.188.53,<->,120.154.221.228,9,684,0,0,9,684,0.401772000,1.5068
29.212.202.59,<->,8.252.223.106,0,0,9,1629,9,1629,0.401148000,0.1804
142.229.125.36,<->,136.25.188.163,0,0,9,549,9,549,0.400173000,0.0155
136.25.189.83,<->,106.188.253.136,9,5292,0,0,9,5292,0.397940000,1.5122
139.241.56.117,<->,102.50.62.113,0,0,9,11705,9,11705,0.394754000,1.5015
142.236.192.151,<->,136.25.188.220,0,0,9,1590,9,1590,0.394738000,0.5082
202.178.8.203,<->,98.190.109.178,0,0,9,1431,9,1431,0.393646000,0.8046
199.73.130.216,<->,136.25.188.241,0,0,9,828,9,828,0.393181000,1.5157
199.33.64.236,<->,136.25.188.238,0,0,9,923,9,923,0.393172000,0.8170
231.141.47.67,<->,215.158.239.70,0,0,9,1531,9,1531,0.385058000,1.2564
215.158.238.72,<->,197.125.126.186,9,5468,0,0,9,5468,0.384212000,1.5744
100.95.37.92,<->,53.195.188.234,9,5366,0,0,9,5366,0.383046000,1.5817
199.83.239.160,<->,136.25.188.176,0,0,9,2858,9,2858,0.382535000,1.4120
221.102.56.46,<->,6.75.141.235,0,0,9,1127,9,1127,0.382375000,0.1192
215.158.239.56,<->,196.91.200.82,9,652,0,0,9,652,0.380814000,0.2110
215.158.239.79,<->,29.211.228.250,9,4424,0,0,9,4424,0.377629000,0.7975
197.113.47.114,<->,0.195.210.14,0,0,9,1447,9,1447,0.376469000,1.1488
246.253.217.173,<->,197.33.123.67,9,2243,0,0,9,2243,0.375362000,0.6163
8.252.223.175,<->,8.240.116.198,9,4725,0,0,9,4725,0.372825000,1.5574
142.191.168.149,<->,136.25.188.199,0,0,9,2190,9,2190,0.372638000,0.4014
215.158.61.183,<->,8.176.8.189,0,0,9,7772,9,7772,0.371719000,1.4356
215.158.239.79,<->,199.20.29.183,9,1589,0,0,9,1589,0.371174000,1.5296
192.229.42.210,<->,133.178.227.249,0,0,9,7959,9,7959,0.370033000,1.3848
220.39.233.170,<->,215.158.238.96,0,0,9,4423,9,4423,0.368955000,0.8564
215.158.238.96,<->,149.99.92.11,9,1741,0,0,9,1741,0.367243000,0.1072
231.143.125.51,<->,136.25.188.226,0,0,9,1393,9,1393,0.364463000,0.5199
144.85.170.254,<->,91.69.185.225,9,898,0,0,9,898,0.362290000,0.1763
215.158.238.148,<->,111.151.70.36,9,3074,0,0,9,3074,0.361788000,1.1435
142.209.105.143,<->,136.25.188.175,0,0,9,695,9,695,0.360516000,1.3440
215.158.238.143,<->,131.36.198.58,9,3058,0,0,9,3058,0.360410000,0.4254
207.239.182.114,<->,136.25.188.227,0,0,9,888,9,888,0.360068000,1.4852
204.63.29.181,<->,136.25.188.222,0,0,9,2100,9,2100,0.359202000,1.0781
215.158.239.113,<->,129.222.39.54,9,2361,0,0,9,2361,0.358314000,1.1454
215.158.239.102,<->,131.78.56.2,9,4458,0,0,9,4458,0.353152000,0.3145
235.42.34.20,<->,215.158.238.105,0,0,9,1629,9,1629,0.352896000,0.2623
215.158.239.56,<->,207.63.2.86,9,1127,0,0,9,1127,0.352662000,1.6424
50.224.76.235,<->,48.129.85.217,9,5847,0,0,9,5847,0.349740000,0.2957
246.253.253.171,<->,111.151.239.176,9,11552,0,0,9,11552,0.348753000,0.0003
136.25.189.82,<->,29.214.73.131,9,5644,0,0,9,5644,0.347757000,1.6346
215.158.238.241,<->,8.190.217.40,9,4673,0,0,9,4673,0.344068000,1.3549
204.187.27.239,<->,136.25.188.178,0,0,9,2048,9,2048,0.341099000,0.8297
193.78.140.154,<->,92.162.253.253,0,0,9,12146,9,12146,0.339435000,0.0009
199.122.61.247,<->,136.25.188.54,0,0,9,760,9,760,0.335387000,0.8718
204.200.50.92,<->,50.223.3.228,0,0,9,474,9,474,0.335108000,1.5233
215.158.238.133,<->,104.3.163.39,9,3182,0,0,9,3182,0.333031000,1.0060
202.33.253.123,<->,136.25.188.52,0,0,9,2242,9,2242,0.329944000,1.0191
215.158.140.92,<->,113.20.94.212,9,1487,0,0,9,1487,0.329365000,0.2202
192.67.167.86,<->,92.18.173.95,9,705,0,0,9,705,0.327427000,1.1326
207.61.233.15,<->,136.25.188.236,0,0,9,1672,9,1672,0.325657000,1.2426
215.158.239.1,<->,96.135.154.115,9,9793,0,0,9,9793,0.325612000,0.1730
101.70.126.82,<->,53.196.115.48,9,894,0,0,9,894,0.324555000,1.0586
197.113.99.241,<->,136.25.188.163,0,0,9,2926,9,2926,0.324517000,1.4196
50.145.71.12,<->,48.54.99.146,0,0,9,3639,9,3639,0.322775000,1.4587
136.25.188.211,<->,69.132.194.107,9,1821,0,0,9,1821,0.322048000,0.3919
195.55.188.47,<->,136.25.188.255,0,0,9,5647,9,5647,0.321766000,1.5091
144.85.170.208,<->,98.87.147.161,9,1172,0,0,9,1172,0.321578000,1.5534
215.158.239.92,<->,96.156.169.193,9,4375,0,0,9,4375,0.320532000,1.4844
199.84.182.44,<->,0.195.210.46,0,0,9,2946,9,2946,0.320313000,0.6929
8.252.222.176,<->,4.122.108.18,9,552,0,0,9,552,0.319780000,1.5706
215.158.239.95,<->,143.99.65.116,9,504,0,0,9,504,0.315785000,0.3100
197.113.64.196,<->,136.25.188.176,0,0,9,2030,9,2030,0.314969000,1.1790
215.158.239.97,<->,195.41.90.111,9,738,0,0,9,738,0.312701000,0.5071
246.254.97.228,<->,27.11.61.128,9,12620,0,0,9,12620,0.312686000,0.0001
215.158.238.92,<->,143.20.121.130,9,1709,0,0,9,1709,0.312119000,1.0932
215.158.140.60,<->,193.39.68.230,9,3879,0,0,9,3879,0.311837000,1.3615
215.158.239.96,<->,195.81.3.160,9,650,0,0,9,650,0.309509000,1.3794
109.1.57.207,<->,50.224.76.235,0,0,9,978,9,978,0.309061000,0.0851
122.143.169.253,<->,92.27.219.201,0,0,9,12485,9,12485,0.303954000,0.8233
215.158.238.132,<->,212.70.217.102,9,1613,0,0,9,1613,0.303905000,0.0426
215.158.239.51,<->,204.1.195.91,9,1578,0,0,9,1578,0.302287000,0.4750
215.158.238.135,<->,131.1.195.220,9,2013,0,0,9,2013,0.302207000,0.4281
215.158.239.68,<->,196.92.128.113,9,613,0,0,9,613,0.301011000,1.2408
215.158.61.182,<->,8.176.8.251,0,0,9,6926,9,6926,0.300709000,1.5417
215.158.238.73,<->,119.168.0.144,9,1789,0,0,9,1789,0.297716000,0.1624
136.25.189.60,<->,96.156.169.207,9,7708,0,0,9,7708,0.297192000,1.2912
80.27.159.28,<->,74.87.133.36,9,3063,0,0,9,3063,0.297066000,1.4284
142.209.105.143,<->,136.25.188.220,0,0,9,695,9,695,0.296690000,1.4392
215.158.238.45,<->,8.222.96.7,9,3362,0,0,9,3362,0.296102000,1.2599
136.25.189.77,<->,96.156.169.150,9,4343,0,0,9,4343,0.296072000,1.0264
89.183.104.226,<->,33.57.78.122,9,460,0,0,9,460,0.295883000,1.1236
136.25.188.222,<->,113.23.104.220,9,2968,0,0,9,2968,0.293978000,1.1262
136.25.189.82,<->,126.219.194.60,9,4333,0,0,9,4333,0.292044000,0.7841
139.163.96.127,<->,136.172.251.149,9,456,0,0,9,456,0.291579000,1.7030
144.85.170.208,<->,98.87.147.122,9,1652,0,0,9,1652,0.291278000,0.1388
139.36.120.80,<->,8.176.8.247,0,0,9,9192,9,9192,0.289845000,0.1837
136.25.188.254,<->,8.252.210.250,9,2962,0,0,9,2962,0.287989000,1.6338
215.158.238.133,<->,122.158.49.131,9,4855,0,0,9,4855,0.286441000,1.6206
139.163.8.98,<->,129.13.175.55,9,504,0,0,9,504,0.285739000,1.5998
136.139.59.124,<->,136.25.188.211,0,0,9,2024,9,2024,0.283599000,0.9358
133.178.226.28,<->,8.255.92.234,9,3202,0,0,9,3202,0.283103000,1.0345
138.98.157.180,<->,33.250.67.227,9,1044,0,0,9,1044,0.282285000,1.5657
215.158.238.33,<->,76.100.108.201,9,2091,0,0,9,2091,0.278865000,1.6401
204.185.109.210,<->,136.25.188.252,0,0,9,1441,9,1441,0.278641000,0.7212
133.178.226.197,<->,80.47.33.42,9,11046,0,0,9,11046,0.277492000,1.1175
215.158.238.33,<->,192.204.170.200,9,4247,0,0,9,4247,0.275632000,1.6966
143.76.170.0,<->,8.182.239.190,0,0,9,866,9,866,0.273348000,0.5705
207.61.46.18,<->,136.25.188.177,0,0,9,1381,9,1381,0.272272000,1.6259
8.252.222.46,<->,4.121.199.141,9,600,0,0,9,600,0.271951000,0.1554
204.56.0.132,<->,136.25.188.252,0,0,9,504,9,504,0.268636000,0.2551
142.167.138.160,<->,136.25.188.255,0,0,9,1997,9,1997,0.265512000,1.0902
142.206.47.119,<->,136.25.188.198,0,0,9,1448,9,1448,0.265241000,1.6862
215.158.239.97,<->,196.95.71.23,9,504,0,0,9,504,0.264987000,0.2592
80.42.175.248,<->,57.37.120.78,9,1201,0,0,9,1201,0.263080000,1.0566
215.158.61.191,<->,8.176.8.238,0,0,9,8724,9,8724,0.259586000,1.6037
197.81.82.50,<->,0.195.210.46,0,0,9,1832,9,1832,0.258808000,1.4289
205.14.77.10,<->,192.64.210.220,0,0,9,470,9,470,0.256921000,1.4843
204.61.43.101,<->,136.25.188.253,0,0,9,1206,9,1206,0.256809000,0.3419
133.178.227.19,<->,113.23.101.149,9,2487,0,0,9,2487,0.254891000,1.6608
192.226.161.54,<->,136.25.188.53,0,0,9,2930,9,2930,0.253867000,1.0940
143.79.26.120,<->,136.25.188.178,0,0,9,802,9,802,0.253298000,0.8394
133.178.226.29,<->,131.1.253.226,9,1821,0,0,9,1821,0.252541000,0.3117
204.200.63.211,<->,136.25.188.178,0,0,9,2073,9,2073,0.252208000,0.3425
215.158.239.56,<->,196.94.181.221,9,504,0,0,9,504,0.251722000,0.6799
215.158.140.76,<->,33.221.186.163,9,2804,0,0,9,2804,0.251017000,1.7453
215.158.238.190,<->,114.94.161.244,9,3791,0,0,9,3791,0.250690000,1.5863
231.142.212.15,<->,215.158.239.84,0,0,9,962,9,962,0.248332000,0.4945
204.185.30.5,<->,136.25.188.253,0,0,9,1431,9,1431,0.246761000,1.5042
215.158.239.113,<->,129.222.39.232,9,2175,0,0,9,2175,0.245782000,1.0664
204.63.102.223,<->,136.25.188.226,0,0,9,1213,9,1213,0.245078000,0.9811
215.158.239.69,<->,8.255.92.165,9,3106,0,0,9,3106,0.241819000,0.4454
142.228.131.149,<->,136.25.188.55,0,0,9,1347,9,1347,0.241616000,1.0174
215.158.238.148,<->,140.174.80.146,9,540,0,0,9,540,0.240954000,0.2368
133.178.227.215,<->,69.31.239.89,9,1200,0,0,9,1200,0.240585000,0.4134
194.234.232.255,<->,136.25.188.178,0,0,9,1253,9,1253,0.238424000,0.9867
215.158.61.242,<->,8.176.8.210,0,0,9,12497,9,12497,0.238378000,0.1052
204.62.176.229,<->,136.25.188.196,0,0,9,864,9,864,0.238329000,1.7396
195.5.229.8,<->,136.25.188.198,0,0,9,450,9,450,0.238253000,0.4182
215.158.238.104,<->,143.227.108.26,9,2786,0,0,9,2786,0.236533000,1.4685
215.158.239.49,<->,196.88.18.102,9,2032,0,0,9,2032,0.236149000,0.7386
89.204.235.110,<->,50.224.91.41,0,0,9,1861,9,1861,0.233026000,0.2331
100.255.145.206,<->,50.224.108.163,0,0,9,1066,9,1066,0.230236000,0.3125
139.163.81.178,<->,111.165.2.153,9,450,0,0,9,450,0.228923000,1.3906
215.158.239.76,<->,194.232.71.226,9,2615,0,0,9,2615,0.226529000,1.7680
196.247.79.182,<->,136.25.188.196,0,0,9,2018,9,2018,0.226332000,0.4973
133.178.226.83,<->,96.155.60.201,9,6405,0,0,9,6405,0.225816000,1.7461
215.158.238.135,<->,120.154.221.217,9,1677,0,0,9,1677,0.224599000,0.6525
136.25.189.94,<->,96.156.169.216,9,10931,0,0,9,10931,0.222722000,1.0141
221.102.56.46,<->,192.67.185.2,0,0,9,1986,9,1986,0.221491000,0.1178
100.228.42.94,<->,17.136.21.53,9,5710,0,0,9,5710,0.219455000,0.9336
136.25.188.52,<->,113.23.20.242,9,2962,0,0,9,2962,0.216242000,1.6722
215.158.239.94,<->,207.115.122.109,9,5401,0,0,9,5401,0.214750000,1.6211
221.102.56.69,<->,220.80.167.246,0,0,9,996,9,996,0.212436000,0.1188
221.102.56.46,<->,192.64.112.18,0,0,9,1221,9,1221,0.209712000,0.1638
215.158.238.75,<->,29.213.218.185,9,1927,0,0,9,1927,0.206353000,1.1477
139.246.60.47,<->,8.43.211.17,0,0,9,1519,9,1519,0.204369000,0.2148
50.224.82.18,<->,50.16.165.49,9,450,0,0,9,450,0.204336000,1.5537
140.139.8.104,<->,100.228.42.193,0,0,9,1584,9,1584,0.203903000,1.3215
215.202.174.58,<->,215.158.239.78,0,0,9,504,9,504,0.203489000,0.0010
215.158.238.66,<->,142.234.196.200,9,3106,0,0,9,3106,0.203360000,1.5354
207.60.130.22,<->,136.25.188.174,0,0,9,1988,9,1988,0.203243000,0.4711
139.163.96.127,<->,78.117.234.181,9,480,0,0,9,480,0.202549000,1.6592
136.25.188.242,<->,122.159.68.137,9,1517,0,0,9,1517,0.202418000,0.1292
204.3.58.133,<->,136.25.188.222,0,0,9,504,9,504,0.201904000,0.5059
215.158.239.96,<->,199.20.7.146,9,927,0,0,9,927,0.199099000,1.0979
247.136.136.53,<->,110.2.33.25,9,2847,0,0,9,2847,0.198831000,1.7713
215.158.238.80,<->,113.23.20.251,9,3090,0,0,9,3090,0.198202000,1.2964
155.132.50.123,<->,139.163.96.127,0,0,9,492,9,492,0.193887000,1.7083
136.25.188.161,<->,121.189.159.24,9,1773,0,0,9,1773,0.193441000,1.6644
133.178.226.101,<->,80.47.185.14,9,1560,0,0,9,1560,0.191113000,0.7688
139.163.68.55,<->,100.241.191.24,9,451,0,0,9,451,0.191012000,1.6605
132.216.159.29,<->,92.162.253.30,0,0,9,3297,9,3297,0.189901000,0.1974
8.252.221.204,<->,4.122.166.119,9,852,0,0,9,852,0.187619000,0.8560
148.55.210.200,<->,136.25.189.47,0,0,9,3090,9,3090,0.187162000,0.3451
215.158.140.14,<->,215.158.61.145,9,8450,0,0,9,8450,0.186206000,1.4622
133.178.227.16,<->,131.144.114.243,9,3739,0,0,9,3739,0.184449000,1.0289
207.57.242.46,<->,136.25.188.239,0,0,9,1368,9,1368,0.183541000,0.8293
117.5.250.34,<->,8.183.25.124,0,0,9,806,9,806,0.183408000,0.5574
199.122.181.24,<->,136.25.188.209,0,0,9,504,9,504,0.182555000,0.1797
136.25.189.1,<->,29.212.199.236,9,4471,0,0,9,4471,0.180153000,1.7560
143.159.235.195,<->,89.183.104.232,0,0,9,7498,9,7498,0.178429000,0.3526
215.158.239.48,<->,196.92.210.132,9,541,0,0,9,541,0.177574000,0.5799
139.163.8.98,<->,96.154.112.41,9,504,0,0,9,504,0.177557000,1.5834
215.158.239.95,<->,199.20.28.15,9,1549,0,0,9,1549,0.177519000,0.3406
220.39.233.198,<->,136.25.188.160,0,0,9,3154,9,3154,0.176394000,0.4830
215.158.239.97,<->,199.20.30.155,9,1746,0,0,9,1746,0.176272000,0.8303
97.126.18.95,<->,56.114.235.120,9,7528,0,0,9,7528,0.175914000,0.4912
215.158.239.49,<->,199.20.29.83,9,1455,0,0,9,1455,0.174127000,0.4500
136.25.189.0,<->,116.106.46.120,9,4123,0,0,9,4123,0.173941000,1.5287
17.27.56.184,<->,8.220.176.253,0,0,9,687,9,687,0.173692000,1.6665
149.224.8.170,<->,97.198.98.32,0,0,9,504,9,504,0.171149000,1.6996
139.163.96.101,<->,117.37.34.199,9,1324,0,0,9,1324,0.170270000,0.9999
215.158.238.104,<->,113.23.111.138,9,504,0,0,9,504,0.169698000,1.5400
215.158.238.66,<->,8.191.6.219,9,504,0,0,9,504,0.166383000,0.0040
136.25.188.198,<->,33.209.217.194,9,6153,0,0,9,6153,0.166113000,1.4389
252.36.152.95,<->,8.252.222.48,0,0,9,1505,9,1505,0.165797000,1.7085
204.154.176.209,<->,8.52.172.21,0,0,9,913,9,913,0.163770000,1.5107
215.158.239.59,<->,96.156.169.148,9,5436,0,0,9,5436,0.163008000,1.1602
205.127.108.114,<->,33.233.141.2,0,0,9,3169,9,3169,0.162237000,1.3894
221.102.56.46,<->,98.129.24.188,0,0,9,1954,9,1954,0.162061000,0.1145
50.224.76.235,<->,29.91.23.23,9,2929,0,0,9,2929,0.160770000,0.4142
199.120.243.214,<->,136.25.188.177,0,0,9,1531,9,1531,0.159637000,1.2971
215.158.238.75,<->,65.27.228.222,9,2794,0,0,9,2794,0.158247000,1.4583
221.196.123.105,<->,136.25.188.226,0,0,9,692,9,692,0.157415000,1.6800
139.163.111.125,<->,80.43.233.211,9,504,0,0,9,504,0.156735000,1.6523
205.127.108.114,<->,33.233.141.10,0,0,9,2768,9,2768,0.155978000,1.7407
207.191.135.206,<->,136.25.188.163,0,0,9,1303,9,1303,0.155147000,0.5818
133.178.226.56,<->,98.219.126.175,9,10746,0,0,9,10746,0.151867000,0.9851
133.178.227.4,<->,133.56.180.93,9,3414,0,0,9,3414,0.151515000,1.4049
215.158.239.93,<->,196.240.220.57,9,1333,0,0,9,1333,0.150450000,0.3471
207.191.252.173,<->,136.25.188.237,0,0,9,612,9,612,0.148728000,1.1893
215.158.238.135,<->,38.104.11.27,9,2830,0,0,9,2830,0.148527000,0.9647
138.98.233.218,<->,136.150.64.133,9,504,0,0,9,504,0.148510000,1.7236
199.32.203.17,<->,136.25.188.174,0,0,9,1213,9,1213,0.148100000,0.6888
215.158.238.80,<->,91.57.173.62,9,3122,0,0,9,3122,0.148026000,0.7012
136.25.188.173,<->,57.160.181.249,9,4231,0,0,9,4231,0.147724000,1.5972
133.178.227.16,<->,104.3.168.27,9,2994,0,0,9,2994,0.147213000,0.8759
142.207.123.49,<->,136.25.188.163,0,0,9,803,9,803,0.145767000,1.7261
215.158.239.147,<->,69.132.159.42,9,9148,0,0,9,9148,0.145222000,1.7839
193.39.70.95,<->,133.178.226.28,0,0,9,2926,9,2926,0.144368000,0.6525
215.158.239.68,<->,204.226.53.66,9,1965,0,0,9,1965,0.142115000,0.4640
215.158.238.132,<->,29.211.6.19,9,2676,0,0,9,2676,0.141516000,1.2590
139.194.75.189,<->,8.220.178.203,0,0,9,1530,9,1530,0.141402000,1.5971
196.89.213.141,<->,136.25.188.236,0,0,9,1495,9,1495,0.139913000,0.3153
215.158.238.114,<->,192.226.161.157,9,1821,0,0,9,1821,0.139862000,1.4023
95.246.207.44,<->,8.252.221.198,0,0,9,688,9,688,0.139694000,0.0133
247.118.160.185,<->,8.182.248.147,0,0,9,818,9,818,0.139065000,0.1650
215.158.238.134,<->,91.57.173.26,9,2942,0,0,9,2942,0.138268000,1.8254
207.88.93.23,<->,133.178.226.90,0,0,9,516,9,516,0.137844000,0.0003
213.186.52.86,<->,144.85.170.254,0,0,9,905,9,905,0.137110000,0.1691
195.15.128.31,<->,136.25.188.163,0,0,9,450,9,450,0.136623000,0.8640
212.164.136.25,<->,56.96.128.220,9,552,0,0,9,552,0.135941000,1.6031
215.158.239.56,<->,194.234.144.120,9,1468,0,0,9,1468,0.134118000,0.2516
127.85.113.94,<->,80.40.7.81,0,0,9,528,9,528,0.133154000,1.4017
149.250.115.54,<->,136.25.188.237,0,0,9,2898,9,2898,0.131444000,0.7856
136.25.189.30,<->,106.188.253.228,9,5806,0,0,9,5806,0.130352000,1.2929
133.178.226.90,<->,65.27.228.196,9,4239,0,0,9,4239,0.129548000,1.6092
204.61.161.93,<->,136.25.188.163,0,0,9,1499,9,1499,0.129362000,0.9888
142.244.7.242,<->,136.25.188.173,0,0,9,2010,9,2010,0.128253000,0.8222
235.67.254.158,<->,92.27.219.28,0,0,9,468,9,468,0.126578000,1.7587
215.158.238.92,<->,48.131.156.16,9,1917,0,0,9,1917,0.126377000,1.4227
221.102.113.220,<->,139.254.211.64,9,3522,0,0,9,3522,0.126028000,0.7777
195.109.106.227,<->,50.223.3.228,0,0,9,492,9,492,0.125525000,1.6302
142.249.37.52,<->,136.25.188.177,0,0,9,2000,9,2000,0.124864000,0.4545
156.142.96.154,<->,8.252.221.198,0,0,9,492,9,492,0.124265000,1.4156
136.25.188.221,<->,57.210.107.42,9,2962,0,0,9,2962,0.123792000,0.4719
215.158.238.45,<->,8.252.210.160,9,2994,0,0,9,2994,0.123362000,1.7923
133.178.226.18,<->,104.3.168.202,9,5068,0,0,9,5068,0.122796000,1.5568
199.121.19.55,<->,136.25.188.196,0,0,9,1963,9,1963,0.122200000,0.9707
136.25.188.236,<->,57.160.181.181,9,6036,0,0,9,6036,0.122132000,1.2251
8.52.235.143,<->,4.7.144.163,9,1416,0,0,9,1416,0.120368000,1.8165
136.25.188.175,<->,126.219.194.142,9,4597,0,0,9,4597,0.120277000,1.7148
111.20.172.70,<->,33.233.141.120,0,0,9,1337,9,1337,0.119657000,1.0048
136.25.188.177,<->,100.224.202.151,9,5150,0,0,9,5150,0.119645000,0.4083
215.158.239.57,<->,195.55.52.16,9,1053,0,0,9,1053,0.118731000,1.6495
111.20.172.70,<->,101.224.89.134,0,0,9,1147,9,1147,0.117913000,1.0060
213.186.52.9,<->,144.85.170.254,0,0,9,864,9,864,0.117820000,0.4773
138.98.233.218,<->,135.72.119.243,9,450,0,0,9,450,0.117245000,1.6522
207.173.31.171,<->,136.25.188.160,0,0,9,2882,9,2882,0.116521000,1.4301
111.20.172.70,<->,33.233.141.80,0,0,9,1116,9,1116,0.115960000,1.0033
215.158.239.56,<->,199.20.28.57,9,1358,0,0,9,1358,0.115720000,0.9700
111.20.172.70,<->,33.233.141.28,0,0,9,1204,9,1204,0.114617000,1.0074
139.241.56.102,<->,98.128.108.168,0,0,9,12887,9,12887,0.111610000,1.8599
215.158.239.78,<->,195.54.70.232,9,778,0,0,9,778,0.111507000,0.2974
207.87.58.96,<->,136.25.188.176,0,0,9,618,9,618,0.111323000,0.3799
199.70.22.129,<->,136.25.188.178,0,0,9,456,9,456,0.111109000,0.3932
195.42.224.23,<->,136.25.188.225,0,0,9,1811,9,1811,0.111075000,0.6643
207.58.86.149,<->,136.25.188.237,0,0,9,1352,9,1352,0.110841000,1.2011
199.117.255.5,<->,50.223.3.228,0,0,9,450,9,450,0.110412000,1.8321
215.158.239.56,<->,196.92.131.60,9,676,0,0,9,676,0.110244000,1.7700
136.25.189.15,<->,116.106.46.75,9,5757,0,0,9,5757,0.110217000,1.8151
91.100.184.81,<->,80.38.33.27,0,0,9,450,9,450,0.109908000,1.6602
207.236.166.125,<->,136.25.188.198,0,0,9,870,9,870,0.109585000,1.5458
192.204.123.43,<->,136.25.189.2,0,0,9,6913,9,6913,0.109053000,1.8158
133.178.226.38,<->,122.159.245.156,9,4087,0,0,9,4087,0.108703000,1.1417
199.32.200.84,<->,136.25.188.222,0,0,9,504,9,504,0.108072000,0.0288
139.163.20.162,<->,89.154.151.249,9,651,0,0,9,651,0.107769000,0.1329
111.20.172.70,<->,33.233.141.123,0,0,9,1267,9,1267,0.107616000,1.0018
205.127.108.115,<->,33.233.141.72,0,0,9,3537,9,3537,0.107184000,1.0310
142.228.19.170,<->,136.25.188.242,0,0,9,594,9,594,0.106488000,0.3068
115.85.162.14,<->,50.224.76.230,0,0,9,1153,9,1153,0.106040000,0.1384
143.29.160.151,<->,80.38.22.80,0,0,9,1184,9,1184,0.104632000,0.3201
111.20.172.70,<->,33.233.141.59,0,0,9,1279,9,1279,0.104369000,1.0115
136.114.101.93,<->,136.25.188.234,0,0,9,8386,9,8386,0.102913000,0.0856
138.98.183.177,<->,38.176.218.98,9,702,0,0,9,702,0.102460000,1.6935
215.158.238.135,<->,104.3.168.215,9,4231,0,0,9,4231,0.101467000,1.8904
231.140.218.120,<->,215.158.239.92,0,0,9,504,9,504,0.099068000,0.0177
202.124.181.75,<->,8.252.221.236,0,0,9,540,9,540,0.096876000,0.1982
112.208.147.230,<->,89.183.110.72,0,0,9,6344,9,6344,0.096468000,0.7631
111.20.172.70,<->,33.233.141.102,0,0,9,1266,9,1266,0.095885000,1.0013
58.247.146.175,<->,8.252.221.221,0,0,9,490,9,490,0.095819000,1.8213
133.178.226.90,<->,104.3.168.203,9,4327,0,0,9,4327,0.094688000,1.0956
192.65.150.36,<->,139.241.56.117,9,13103,0,0,9,13103,0.094618000,1.8573
143.155.227.57,<->,136.25.188.243,0,0,9,516,9,516,0.094279000,0.1653
139.163.96.94,<->,74.172.105.164,9,450,0,0,9,450,0.094246000,1.8080
215.158.239.84,<->,199.20.28.235,9,586,0,0,9,586,0.092373000,1.0397
215.158.239.34,<->,215.158.127.158,9,2803,0,0,9,2803,0.091821000,1.8324
75.214.182.135,<->,8.252.221.236,0,0,9,1282,9,1282,0.091469000,1.6569
215.158.238.67,<->,122.158.49.246,9,1613,0,0,9,1613,0.089647000,0.5538
239.66.236.172,<->,97.198.98.33,0,0,9,504,9,504,0.089336000,1.7501
215.158.140.93,<->,8.240.116.171,9,3632,0,0,9,3632,0.088425000,0.4830
215.158.238.135,<->,80.47.111.11,9,504,0,0,9,504,0.087313000,0.0012
195.111.12.217,<->,50.223.3.228,0,0,9,498,9,498,0.087296000,1.2319
215.158.238.107,<->,192.224.21.33,9,1661,0,0,9,1661,0.087239000,0.0607
132.100.128.134,<->,97.198.98.50,0,0,9,504,9,504,0.086300000,1.8750
138.98.233.218,<->,120.44.60.6,9,450,0,0,9,450,0.086115000,1.7536
146.188.134.161,<->,89.183.109.119,0,0,9,1747,9,1747,0.084953000,1.8960
101.70.110.204,<->,98.192.184.91,9,1236,0,0,9,1236,0.084626000,1.8099
143.89.70.129,<->,136.25.188.198,0,0,9,504,9,504,0.082467000,0.0168
133.178.226.14,<->,111.150.186.207,9,2797,0,0,9,2797,0.082399000,0.4531
131.22.119.229,<->,92.162.253.145,0,0,9,11200,9,11200,0.081486000,0.2162
115.51.254.30,<->,92.27.219.171,0,0,9,3290,9,3290,0.081420000,1.4692
133.178.227.2,<->,48.129.132.244,9,2738,0,0,9,2738,0.078969000,1.9059
144.87.249.132,<->,8.182.226.78,0,0,9,2601,9,2601,0.078770000,0.3998
139.163.27.106,<->,17.114.182.234,9,450,0,0,9,450,0.077850000,1.8258
132.200.108.136,<->,129.224.112.221,0,0,9,631,9,631,0.076397000,1.6984
215.158.239.69,<->,106.188.253.154,9,6037,0,0,9,6037,0.076092000,1.8766
232.31.73.213,<->,220.55.174.143,0,0,9,470,9,470,0.075010000,1.8901
80.41.28.151,<->,50.145.65.73,9,1299,0,0,9,1299,0.074800000,1.0095
133.178.227.27,<->,8.222.213.12,9,2577,0,0,9,2577,0.074540000,0.8552
215.158.140.175,<->,96.143.113.148,9,2266,0,0,9,2266,0.074004000,1.8509
215.158.239.22,<->,96.135.154.158,9,10077,0,0,9,10077,0.072675000,1.1813
92.27.202.201,<->,35.56.98.42,0,0,9,504,9,504,0.070228000,1.8488
132.168.196.110,<->,53.209.92.194,9,3955,0,0,9,3955,0.070132000,0.4305
207.191.134.246,<->,136.25.188.226,0,0,9,1542,9,1542,0.069690000,0.5607
136.25.189.57,<->,29.214.73.171,9,4215,0,0,9,4215,0.069052000,1.8832
133.178.227.41,<->,29.211.6.95,9,2667,0,0,9,2667,0.068583000,1.2516
215.158.239.32,<->,215.158.127.169,9,5379,0,0,9,5379,0.068558000,1.8483
136.25.188.174,<->,41.142.21.110,9,677,0,0,9,677,0.068098000,0.8382
215.158.238.92,<->,8.190.216.221,9,3266,0,0,9,3266,0.067996000,1.8791
142.220.239.211,<->,136.25.188.163,0,0,9,1327,9,1327,0.067383000,0.7897
215.158.238.72,<->,116.106.60.162,9,2930,0,0,9,2930,0.066591000,1.4633
199.111.145.20,<->,8.182.136.217,0,0,9,462,9,462,0.066535000,1.8412
235.253.220.244,<->,136.25.189.80,0,0,9,4231,9,4231,0.066435000,1.6837
136.25.188.221,<->,131.144.114.210,9,5164,0,0,9,5164,0.064379000,1.9157
220.38.84.245,<->,215.158.239.78,0,0,9,3298,9,3298,0.064030000,1.4077
144.75.81.88,<->,100.228.42.163,0,0,9,3704,9,3704,0.063652000,1.6891
137.46.171.56,<->,8.52.187.43,0,0,9,450,9,450,0.061376000,0.0094
153.169.238.176,<->,139.163.96.94,0,0,9,450,9,450,0.061208000,1.8293
132.168.196.110,<->,54.43.249.8,9,664,0,0,9,664,0.059626000,1.6930
215.158.238.188,<->,29.214.109.153,9,3639,0,0,9,3639,0.059557000,1.2268
133.178.226.38,<->,116.106.60.170,9,1661,0,0,9,1661,0.058900000,1.2021
246.108.91.178,<->,145.252.114.80,0,0,9,1062,9,1062,0.058778000,0.6709
133.178.227.16,<->,126.219.102.41,9,3679,0,0,9,3679,0.058623000,0.8105
215.158.238.97,<->,120.154.221.233,9,4135,0,0,9,4135,0.057728000,1.2794
114.83.250.187,<->,35.56.97.251,0,0,9,1053,9,1053,0.057670000,1.5045
215.158.239.58,<->,195.71.169.2,9,504,0,0,9,504,0.056090000,0.1295
192.204.170.200,<->,136.25.188.221,0,0,9,1789,9,1789,0.054861000,0.3328
215.158.238.66,<->,122.158.179.40,9,2882,0,0,9,2882,0.054051000,1.1414
215.158.239.41,<->,29.214.205.37,9,3420,0,0,9,3420,0.053424000,1.3331
215.158.238.73,<->,80.47.111.26,9,1789,0,0,9,1789,0.052287000,1.5199
195.68.244.170,<->,136.25.188.54,0,0,9,2029,9,2029,0.051872000,1.8589
140.28.153.237,<->,139.163.96.94,0,0,9,486,9,486,0.051507000,1.8665
133.178.226.29,<->,112.235.95.73,9,4279,0,0,9,4279,0.050668000,1.9413
197.113.99.127,<->,136.25.188.174,0,0,9,1299,9,1299,0.050090000,0.7109
197.113.99.189,<->,136.25.188.253,0,0,9,1965,9,1965,0.050064000,1.1190
136.25.189.15,<->,96.135.155.31,9,4263,0,0,9,4263,0.049410000,1.6791
195.5.10.118,<->,136.25.188.55,0,0,9,1232,9,1232,0.048486000,0.2106
136.25.189.24,<->,98.219.126.175,9,8241,0,0,9,8241,0.047420000,0.5420
139.163.96.127,<->,66.58.21.15,9,482,0,0,9,482,0.046587000,1.8510
220.39.233.203,<->,215.158.238.72,0,0,9,4263,9,4263,0.046537000,1.3997
136.25.188.105,<->,132.43.156.81,9,2207,0,0,9,2207,0.045652000,1.9332
148.26.113.23,<->,136.25.189.46,0,0,9,5564,9,5564,0.044977000,1.7612
218.85.24.6,<->,97.198.121.79,0,0,9,768,9,768,0.043047000,0.3677
139.241.56.116,<->,100.95.6.205,0,0,9,13103,9,13103,0.041520000,1.8413
82.237.235.84,<->,56.114.235.120,9,4722,0,0,9,4722,0.041128000,0.2442
215.158.238.241,<->,192.171.32.152,9,1493,0,0,9,1493,0.040418000,0.7791
144.71.47.61,<->,113.123.6.230,9,450,0,0,9,450,0.039393000,0.3142
143.89.100.97,<->,136.25.188.225,0,0,9,450,9,450,0.038040000,1.7769
223.114.56.179,<->,8.252.221.198,0,0,9,476,9,476,0.037790000,1.9176
143.44.155.67,<->,136.25.188.237,0,0,9,504,9,504,0.036460000,0.0351
136.25.188.44,<->,111.151.70.36,9,2898,0,0,9,2898,0.036410000,1.5039
156.135.149.235,<->,8.252.222.70,0,0,9,504,9,504,0.036320000,0.0029
215.158.239.68,<->,207.114.54.210,9,1321,0,0,9,1321,0.034244000,1.4009
204.184.251.51,<->,136.25.188.220,0,0,9,1839,9,1839,0.032513000,1.9194
215.158.239.99,<->,199.14.81.132,9,545,0,0,9,545,0.031283000,0.2873
192.67.174.99,<->,0.204.192.239,9,1104,0,0,9,1104,0.029522000,1.9274
133.178.227.41,<->,133.56.180.57,9,4791,0,0,9,4791,0.029266000,1.1258
133.178.226.14,<->,96.155.60.234,9,3638,0,0,9,3638,0.028589000,0.5126
159.13.141.83,<->,53.167.130.195,9,7135,0,0,9,7135,0.028469000,0.3458
136.181.52.165,<->,8.192.161.247,9,6201,0,0,9,6201,0.027612000,0.3071
142.207.121.123,<->,136.25.188.175,0,0,9,958,9,958,0.027230000,1.0018
215.158.238.80,<->,120.154.221.217,9,2786,0,0,9,2786,0.026750000,1.9217
215.158.238.143,<->,8.42.43.43,9,4407,0,0,9,4407,0.024641000,0.7360
142.237.200.133,<->,136.25.188.254,0,0,9,504,9,504,0.023887000,1.2058
215.158.140.76,<->,126.207.73.82,9,2553,0,0,9,2553,0.022859000,0.9279
215.158.239.153,<->,29.211.224.147,9,504,0,0,9,504,0.021591000,0.0001
133.178.227.1,<->,8.240.116.202,9,2626,0,0,9,2626,0.021377000,1.8946
111.172.229.29,<->,50.224.49.211,0,0,9,504,9,504,0.021246000,1.9086
241.5.27.212,<->,133.178.226.28,0,0,9,504,9,504,0.020456000,0.0003
195.124.60.10,<->,136.25.188.175,0,0,9,2055,9,2055,0.019702000,1.1998
145.57.196.106,<->,50.224.61.156,0,0,9,504,9,504,0.018010000,0.7133
199.72.27.78,<->,136.25.188.174,0,0,9,468,9,468,0.017942000,0.3340
122.245.156.85,<->,50.224.76.230,0,0,9,939,9,939,0.017785000,0.2119
50.224.76.235,<->,6.72.205.67,9,5112,0,0,9,5112,0.017718000,0.1877
207.173.176.5,<->,136.25.188.176,0,0,9,564,9,564,0.016004000,1.1597
197.161.241.164,<->,136.25.188.196,0,0,9,2381,9,2381,0.015937000,1.2787
136.25.189.13,<->,56.28.207.200,9,4615,0,0,9,4615,0.015813000,1.7304
137.24.196.227,<->,89.183.110.72,0,0,9,5493,9,5493,0.015744000,0.8353
215.158.239.59,<->,29.212.180.235,9,3975,0,0,9,3975,0.015665000,1.7471
221.196.122.154,<->,138.98.250.39,0,0,9,504,9,504,0.015263000,1.7802
113.188.212.241,<->,101.224.204.158,0,0,9,1334,9,1334,0.015176000,0.1244
215.158.140.60,<->,131.1.195.58,9,2492,0,0,9,2492,0.015146000,0.9923
145.237.135.90,<->,137.21.23.210,0,0,9,474,9,474,0.014085000,1.5051
94.194.119.154,<->,8.252.221.198,0,0,9,616,9,616,0.013053000,1.9637
215.158.61.191,<->,8.176.8.218,0,0,9,8055,9,8055,0.012998000,1.7206
210.221.109.17,<->,122.253.169.56,9,13230,0,0,9,13230,0.012630000,1.9863
195.40.113.212,<->,136.25.188.53,0,0,9,656,9,656,0.012443000,0.8896
139.241.56.117,<->,80.41.8.158,0,0,9,13103,9,13103,0.012204000,1.8588
220.60.81.139,<->,136.25.189.34,0,0,9,5404,9,5404,0.011826000,0.8084
143.227.65.146,<->,133.178.226.31,0,0,9,5148,9,5148,0.010183000,1.9843
111.20.168.123,<->,92.160.6.109,9,1509,0,0,9,1509,0.009771000,0.0610
109.222.210.155,<->,54.69.66.184,9,2311,0,0,9,2311,0.009675000,0.8948
215.158.238.243,<->,192.171.32.152,9,1533,0,0,9,1533,0.009325000,1.5908
195.51.165.90,<->,8.182.227.180,0,0,9,1904,9,1904,0.009227000,1.1691
195.5.85.38,<->,136.25.188.163,0,0,9,456,9,456,0.009177000,0.4252
111.20.172.70,<->,111.20.168.22,0,0,9,1110,9,1110,0.008912000,1.9910
136.25.188.255,<->,60.166.83.101,9,2021,0,0,9,2021,0.008692000,1.9513
221.102.56.69,<->,80.42.206.154,0,0,9,996,9,996,0.008141000,0.1562
133.178.226.37,<->,8.222.7.23,9,2850,0,0,9,2850,0.007421000,0.4358
215.158.239.49,<->,199.20.31.103,9,1237,0,0,9,1237,0.007368000,1.2408
215.158.239.56,<->,199.20.31.143,9,573,0,0,9,573,0.007242000,1.8896
204.89.62.223,<->,50.223.3.228,0,0,9,480,9,480,0.006940000,1.4936
204.200.38.141,<->,136.25.188.198,0,0,9,626,9,626,0.006843000,1.0804
197.113.99.80,<->,136.25.188.255,0,0,9,504,9,504,0.005784000,0.2695
133.178.226.49,<->,116.106.35.196,9,1980,0,0,9,1980,0.005459000,0.7158
215.158.239.58,<->,204.226.17.29,9,1504,0,0,9,1504,0.003987000,0.5983
136.139.59.84,<->,133.178.226.29,0,0,9,1821,9,1821,0.003100000,0.7926
196.89.216.223,<->,136.25.188.209,0,0,9,948,9,948,0.001682000,0.4451
215.158.239.107,<->,215.158.61.202,9,8094,0,0,9,8094,0.001549000,1.7873
196.206.136.251,<->,136.25.188.225,0,0,9,545,9,545,0.000219000,0.4789
215.158.239.96,<->,204.227.213.195,9,1414,0,0,9,1414,0.000174000,0.2055
215.158.239.25,<->,96.135.154.141,8,10360,0,0,8,10360,1.910627000,0.0242
125.223.119.32,<->,100.228.42.100,0,0,8,9674,8,9674,1.887866000,0.0975
136.25.189.29,<->,96.156.169.150,8,2015,0,0,8,2015,1.876225000,0.0632
215.158.238.187,<->,98.219.126.175,8,9338,0,0,8,9338,1.871083000,0.0110
215.158.30.229,<->,8.252.222.136,0,0,8,4742,8,4742,1.868802000,0.1130
144.85.170.254,<->,136.18.96.216,8,1199,0,0,8,1199,1.835795000,0.0921
215.158.61.224,<->,136.25.189.214,0,0,8,4806,8,4806,1.831002000,0.1083
215.158.239.32,<->,80.47.228.196,8,1841,0,0,8,1841,1.821577000,0.0337
133.178.227.14,<->,57.160.181.188,8,1512,0,0,8,1512,1.806073000,0.1257
222.65.25.133,<->,89.74.85.198,8,4666,0,0,8,4666,1.794091000,0.1585
136.25.188.177,<->,92.48.92.132,8,772,0,0,8,772,1.791521000,0.2048
132.70.176.15,<->,109.222.205.202,0,0,8,4837,8,4837,1.780105000,0.1781
221.102.56.69,<->,129.1.92.242,0,0,8,940,8,940,1.766548000,0.0784
210.231.140.55,<->,109.1.37.80,0,0,8,4968,8,4968,1.766444000,0.2260
215.158.238.96,<->,33.97.221.154,8,1557,0,0,8,1557,1.766359000,0.1654
100.124.212.248,<->,56.121.35.245,0,0,8,4354,8,4354,1.765369000,0.0946
108.39.30.89,<->,50.224.76.235,0,0,8,2090,8,2090,1.761040000,0.1242
50.224.76.248,<->,8.35.106.90,8,864,0,0,8,864,1.742229000,0.0640
215.158.239.59,<->,196.108.254.251,8,560,0,0,8,560,1.734536000,0.0911
136.25.188.226,<->,131.2.115.214,8,1589,0,0,8,1589,1.733526000,0.2213
195.55.225.205,<->,136.25.188.253,0,0,8,448,8,448,1.728575000,0.1141
220.28.104.193,<->,133.178.227.21,0,0,8,7147,8,7147,1.717210000,0.1903
136.181.33.175,<->,111.151.239.49,8,4780,0,0,8,4780,1.716193000,0.2544
246.253.253.170,<->,233.145.251.148,8,3527,0,0,8,3527,1.715467000,0.1745
8.55.211.213,<->,6.72.19.178,0,0,8,940,8,940,1.712358000,0.1202
97.39.76.162,<->,8.52.134.194,0,0,8,760,8,760,1.711599000,0.1472
215.158.238.251,<->,123.166.47.57,8,1525,0,0,8,1525,1.696590000,0.1904
136.25.188.160,<->,41.158.141.108,8,1229,0,0,8,1229,1.694365000,0.3013
221.102.56.46,<->,192.65.102.184,0,0,8,5063,8,5063,1.689281000,0.3046
133.178.226.225,<->,111.151.142.130,8,448,0,0,8,448,1.683545000,0.0003
204.200.40.15,<->,136.25.188.163,0,0,8,774,8,774,1.682723000,0.3081
100.206.95.178,<->,80.27.153.136,0,0,8,1968,8,1968,1.677032000,0.2179
247.136.248.229,<->,14.30.152.10,8,1462,0,0,8,1462,1.675389000,0.2641
231.141.44.225,<->,136.25.188.227,0,0,8,1587,8,1587,1.673993000,0.3080
215.158.239.114,<->,111.151.237.141,8,9704,0,0,8,9704,1.673453000,0.1783
143.155.227.33,<->,136.25.188.179,0,0,8,1589,8,1589,1.667681000,0.2567
215.158.238.94,<->,125.216.33.188,8,1717,0,0,8,1717,1.657993000,0.2134
215.158.238.105,<->,69.132.194.168,8,1605,0,0,8,1605,1.656854000,0.2400
231.136.200.213,<->,136.25.188.220,0,0,8,1019,8,1019,1.655857000,0.2693
133.178.227.76,<->,57.199.251.51,8,1781,0,0,8,1781,1.644466000,0.2033
8.182.235.164,<->,6.26.243.228,8,556,0,0,8,556,1.636563000,0.3181
8.222.49.195,<->,6.73.247.55,0,0,8,11061,8,11061,1.633361000,0.0001
199.81.208.250,<->,136.25.188.163,0,0,8,2306,8,2306,1.629905000,0.3086
143.135.166.237,<->,136.25.188.177,0,0,8,2011,8,2011,1.623704000,0.3718
215.110.27.82,<->,8.220.189.234,0,0,8,1099,8,1099,1.620611000,0.1128
215.158.238.65,<->,131.1.253.248,8,1620,0,0,8,1620,1.620307000,0.1166
215.158.239.95,<->,145.13.164.194,8,4815,0,0,8,4815,1.615421000,0.1741
221.102.143.189,<->,218.4.187.23,0,0,8,5542,8,5542,1.612482000,0.2425
199.39.128.219,<->,136.25.188.237,0,0,8,690,8,690,1.607748000,0.3907
215.158.239.93,<->,199.20.105.87,8,1595,0,0,8,1595,1.602694000,0.3110
100.228.42.99,<->,83.192.117.230,8,1636,0,0,8,1636,1.595095000,0.1619
222.65.18.206,<->,132.128.61.54,8,4672,0,0,8,4672,1.589201000,0.3951
215.158.238.45,<->,38.206.161.73,8,448,0,0,8,448,1.578877000,0.0020
220.28.65.9,<->,215.158.238.218,0,0,8,9332,8,9332,1.576313000,0.3228
159.223.99.45,<->,8.52.185.129,0,0,8,1618,8,1618,1.571911000,0.3732
205.72.167.142,<->,50.224.76.248,0,0,8,4793,8,4793,1.571591000,0.2721
139.163.26.146,<->,101.85.186.19,8,1135,0,0,8,1135,1.567249000,0.3719
199.15.202.72,<->,136.25.188.174,0,0,8,1768,8,1768,1.558378000,0.4034
218.111.161.49,<->,8.220.186.82,0,0,8,784,8,784,1.554400000,0.1921
197.147.61.143,<->,8.20.87.187,0,0,8,672,8,672,1.552555000,0.4292
97.240.249.56,<->,97.126.28.102,0,0,8,461,8,461,1.551838000,0.1807
215.158.239.240,<->,215.158.3.190,8,981,0,0,8,981,1.545465000,0.1102
100.228.42.114,<->,17.128.64.29,8,9248,0,0,8,9248,1.544916000,0.2477
142.227.218.120,<->,136.25.188.178,0,0,8,1141,8,1141,1.538702000,0.2932
221.102.143.189,<->,192.64.73.86,0,0,8,6876,8,6876,1.536617000,0.1670
246.253.235.153,<->,112.11.94.153,8,896,0,0,8,896,1.536490000,0.4488
215.158.238.97,<->,116.99.180.189,8,1765,0,0,8,1765,1.534939000,0.2945
48.17.51.91,<->,8.252.222.60,0,0,8,887,8,887,1.531487000,0.3341
138.98.204.211,<->,119.45.190.118,8,4101,0,0,8,4101,1.529283000,0.4132
143.72.126.147,<->,136.25.188.174,0,0,8,1692,8,1692,1.525804000,0.4712
215.158.61.183,<->,8.176.8.240,0,0,8,6731,8,6731,1.524489000,0.3950
196.88.102.214,<->,136.25.188.196,0,0,8,1320,8,1320,1.523911000,0.4591
204.61.154.98,<->,136.25.188.209,0,0,8,1586,8,1586,1.520034000,0.4046
195.43.54.218,<->,136.25.188.198,0,0,8,1981,8,1981,1.518775000,0.3613
6.145.165.95,<->,0.195.210.46,0,0,8,1685,8,1685,1.516564000,0.4394
215.158.238.200,<->,80.56.91.244,8,8896,0,0,8,8896,1.513717000,0.0001
133.135.217.174,<->,129.6.83.11,0,0,8,1035,8,1035,1.509753000,0.1148
113.170.119.63,<->,100.228.42.165,0,0,8,400,8,400,1.500404000,0.4059
215.158.238.51,<->,129.222.36.178,8,9036,0,0,8,9036,1.499614000,0.0194
218.111.223.222,<->,8.220.186.82,0,0,8,784,8,784,1.494535000,0.2373
213.186.61.127,<->,144.85.170.208,0,0,8,833,8,833,1.485471000,0.2209
89.183.107.124,<->,35.62.70.58,8,670,0,0,8,670,1.483530000,0.2880
204.200.166.123,<->,136.25.188.236,0,0,8,1189,8,1189,1.481881000,0.2396
207.236.206.13,<->,136.25.188.177,0,0,8,1087,8,1087,1.481278000,0.4672
99.73.144.173,<->,98.57.212.245,8,4045,0,0,8,4045,1.480392000,0.2767
136.128.35.206,<->,8.176.8.87,0,0,8,768,8,768,1.480153000,0.0619
199.121.73.3,<->,136.25.188.198,0,0,8,1278,8,1278,1.477504000,0.4907
215.158.239.92,<->,204.61.154.98,8,1590,0,0,8,1590,1.476679000,0.4282
215.158.239.109,<->,192.205.38.182,8,5282,0,0,8,5282,1.471990000,0.1465
100.93.217.200,<->,0.195.202.28,8,1013,0,0,8,1013,1.471291000,0.3243
143.135.89.129,<->,136.25.188.163,0,0,8,400,8,400,1.462067000,0.0104
215.158.239.94,<->,194.199.200.31,8,1405,0,0,8,1405,1.455465000,0.5185
136.192.242.76,<->,8.182.251.218,0,0,8,656,8,656,1.454637000,0.3525
220.28.114.114,<->,98.236.254.203,0,0,8,677,8,677,1.452847000,0.1488
195.61.150.70,<->,50.223.3.228,0,0,8,594,8,594,1.452758000,0.4956
215.158.239.95,<->,196.0.149.119,8,494,0,0,8,494,1.452387000,0.0780
132.250.195.43,<->,80.41.223.29,0,0,8,800,8,800,1.452225000,0.1935
215.158.140.230,<->,57.23.23.220,8,924,0,0,8,924,1.449605000,0.3018
199.39.215.192,<->,136.25.188.176,0,0,8,2797,8,2797,1.446573000,0.4812
207.93.67.87,<->,0.195.210.14,0,0,8,600,8,600,1.445275000,0.5432
142.252.87.59,<->,136.25.188.222,0,0,8,774,8,774,1.444972000,0.5500
221.102.56.69,<->,80.41.82.212,0,0,8,940,8,940,1.444908000,0.1159
215.158.238.67,<->,80.47.111.74,8,1557,0,0,8,1557,1.440523000,0.1365
215.158.239.32,<->,106.188.156.206,8,1877,0,0,8,1877,1.435189000,0.1149
204.200.37.4,<->,136.25.188.220,0,0,8,1238,8,1238,1.434529000,0.4037
215.158.140.230,<->,83.225.209.236,8,968,0,0,8,968,1.424343000,0.5282
215.158.238.148,<->,215.158.199.155,8,1589,0,0,8,1589,1.423250000,0.0907
210.220.219.150,<->,53.231.144.47,8,5069,0,0,8,5069,1.422536000,0.3129
220.80.203.35,<->,8.45.162.111,8,11765,0,0,8,11765,1.418011000,0.0001
139.163.163.252,<->,133.178.227.70,0,0,8,2613,8,2613,1.416921000,0.5830
136.41.13.4,<->,110.69.249.11,8,497,0,0,8,497,1.416436000,0.1166
111.146.197.80,<->,53.245.126.39,8,6458,0,0,8,6458,1.414629000,0.4834
199.68.157.24,<->,136.25.188.220,0,0,8,1289,8,1289,1.411881000,0.2587
215.158.239.43,<->,128.95.93.135,8,2122,0,0,8,2122,1.409766000,0.1018
221.102.56.69,<->,102.83.27.68,0,0,8,940,8,940,1.409231000,0.4618
92.175.127.21,<->,8.43.217.33,0,0,8,660,8,660,1.407096000,0.5044
192.65.64.48,<->,8.55.211.213,8,940,0,0,8,940,1.406632000,0.0804
143.72.76.146,<->,136.25.188.198,0,0,8,1974,8,1974,1.405441000,0.5819
195.14.91.226,<->,136.25.188.46,0,0,8,774,8,774,1.401316000,0.4359
50.56.250.249,<->,8.52.154.216,0,0,8,3319,8,3319,1.399498000,0.2920
195.6.249.196,<->,136.25.188.163,0,0,8,774,8,774,1.395493000,0.4461
143.72.66.34,<->,136.25.188.239,0,0,8,1293,8,1293,1.393713000,0.6021
240.222.50.211,<->,0.195.210.46,0,0,8,2322,8,2322,1.391939000,0.5730
207.11.112.165,<->,8.252.222.161,0,0,8,1269,8,1269,1.390453000,0.5918
143.76.140.114,<->,8.182.235.164,0,0,8,671,8,671,1.387777000,0.4961
143.134.201.119,<->,136.25.188.208,0,0,8,1644,8,1644,1.386718000,0.4692
136.25.189.15,<->,29.209.59.245,8,4223,0,0,8,4223,1.380557000,0.5704
215.158.238.209,<->,131.1.194.253,8,1477,0,0,8,1477,1.380499000,0.2829
221.102.56.69,<->,109.1.61.117,0,0,8,940,8,940,1.378606000,0.1931
108.47.155.125,<->,8.52.222.23,0,0,8,787,8,787,1.377359000,0.1512
232.31.72.55,<->,111.147.205.186,0,0,8,8744,8,8744,1.377133000,0.6159
215.158.239.92,<->,204.0.209.194,8,774,0,0,8,774,1.377129000,0.5298
50.51.215.141,<->,8.52.168.247,0,0,8,903,8,903,1.373540000,0.3378
97.203.33.81,<->,8.183.25.124,0,0,8,1391,8,1391,1.373343000,0.4440
97.126.4.233,<->,54.53.182.18,8,3113,0,0,8,3113,1.372995000,0.6141
142.206.79.4,<->,136.25.188.162,0,0,8,911,8,911,1.370372000,0.4856
133.178.226.7,<->,120.20.132.54,8,1717,0,0,8,1717,1.367052000,0.2678
215.158.140.205,<->,8.222.7.186,8,3480,0,0,8,3480,1.352238000,0.2937
246.254.97.109,<->,139.33.175.144,8,7836,0,0,8,7836,1.346321000,0.0945
136.25.188.223,<->,131.173.115.91,8,2143,0,0,8,2143,1.338347000,0.3686
133.178.227.1,<->,56.51.205.196,8,1535,0,0,8,1535,1.330157000,0.0992
195.13.65.235,<->,136.25.188.55,0,0,8,1286,8,1286,1.319918000,0.2908
133.178.227.244,<->,122.158.179.154,8,5734,0,0,8,5734,1.318108000,0.6386
149.254.114.188,<->,136.25.188.44,0,0,8,1685,8,1685,1.315635000,0.3215
207.236.200.105,<->,136.25.188.239,0,0,8,816,8,816,1.315447000,0.6024
233.97.213.17,<->,129.6.83.11,0,0,8,1035,8,1035,1.306872000,0.4512
101.70.112.204,<->,8.235.17.153,8,3635,0,0,8,3635,1.301650000,0.2675
215.158.239.56,<->,199.20.29.26,8,2800,0,0,8,2800,1.301350000,0.5600
139.161.104.0,<->,133.178.227.245,0,0,8,2442,8,2442,1.301102000,0.2358
215.158.239.50,<->,207.191.112.39,8,774,0,0,8,774,1.299991000,0.5998
248.80.123.25,<->,133.32.39.0,0,0,8,2363,8,2363,1.291900000,0.2201
215.158.239.95,<->,199.20.28.183,8,1193,0,0,8,1193,1.289045000,0.7104
148.55.210.207,<->,133.178.226.31,0,0,8,1749,8,1749,1.288520000,0.3577
215.158.239.79,<->,195.71.91.68,8,1755,0,0,8,1755,1.282675000,0.7022
136.25.189.196,<->,129.222.39.32,8,3570,0,0,8,3570,1.280990000,0.0441
142.244.238.65,<->,136.25.188.220,0,0,8,1591,8,1591,1.280320000,0.4872
195.41.26.226,<->,136.25.188.53,0,0,8,774,8,774,1.273567000,0.5653
215.158.238.64,<->,143.155.227.57,8,1493,0,0,8,1493,1.273409000,0.1795
215.158.239.56,<->,195.55.190.198,8,751,0,0,8,751,1.262448000,0.3863
215.158.238.96,<->,27.178.41.49,8,1621,0,0,8,1621,1.261858000,0.2559
215.158.239.79,<->,199.20.4.197,8,1223,0,0,8,1223,1.257739000,0.7290
132.208.234.82,<->,8.204.66.217,8,6854,0,0,8,6854,1.256734000,0.3676
60.100.46.134,<->,8.252.221.236,0,0,8,1941,8,1941,1.255951000,0.7369
143.53.111.161,<->,136.25.188.220,0,0,8,1242,8,1242,1.255534000,0.3933
102.44.70.160,<->,92.162.253.45,0,0,8,6530,8,6530,1.248866000,0.0571
207.59.36.194,<->,136.25.188.226,0,0,8,2036,8,2036,1.231867000,0.5553
220.60.81.189,<->,215.158.239.69,0,0,8,5444,8,5444,1.219719000,0.6999
50.49.114.191,<->,8.52.181.95,0,0,8,1153,8,1153,1.214287000,0.5640
133.178.226.30,<->,133.73.194.20,8,1717,0,0,8,1717,1.214200000,0.0318
136.25.188.160,<->,124.72.95.5,8,1621,0,0,8,1621,1.208776000,0.2230
132.168.197.211,<->,109.108.154.250,8,2401,0,0,8,2401,1.207783000,0.3220
91.231.220.149,<->,6.228.14.212,0,0,8,1920,8,1920,1.206117000,0.1798
195.7.154.98,<->,136.25.188.175,0,0,8,448,8,448,1.204626000,0.7842
204.200.35.204,<->,136.25.188.225,0,0,8,901,8,901,1.198807000,0.6369
215.158.239.92,<->,142.248.16.154,8,3431,0,0,8,3431,1.197265000,0.5520
136.25.188.225,<->,48.129.133.31,8,1733,0,0,8,1733,1.193157000,0.4282
215.158.140.60,<->,149.163.129.149,8,1542,0,0,8,1542,1.190546000,0.1358
65.26.119.20,<->,50.224.76.248,0,0,8,1168,8,1168,1.188627000,0.4201
215.158.238.139,<->,139.163.161.34,8,1805,0,0,8,1805,1.188351000,0.7949
215.158.239.94,<->,8.33.226.42,8,1749,0,0,8,1749,1.188319000,0.0990
136.181.52.227,<->,0.195.216.193,8,493,0,0,8,493,1.183771000,0.0663
133.178.226.90,<->,112.235.95.27,8,4555,0,0,8,4555,1.182735000,0.7884
136.129.30.3,<->,50.224.76.248,0,0,8,4548,8,4548,1.177919000,0.0854
247.136.159.39,<->,144.72.193.201,8,5026,0,0,8,5026,1.176503000,0.1477
197.113.99.181,<->,136.25.188.198,0,0,8,1002,8,1002,1.172010000,0.7998
199.8.51.240,<->,50.224.96.57,0,0,8,432,8,432,1.166533000,0.7616
144.64.136.137,<->,27.15.11.177,8,850,0,0,8,850,1.165557000,0.3006
221.102.56.69,<->,220.81.26.217,0,0,8,940,8,940,1.164032000,0.2470
129.138.248.137,<->,8.252.222.157,0,0,8,498,8,498,1.161045000,0.2098
199.53.131.207,<->,136.25.188.220,0,0,8,2017,8,2017,1.156844000,0.8420
215.158.140.75,<->,215.158.6.200,8,2951,0,0,8,2951,1.153446000,0.7887
6.145.170.142,<->,0.195.210.44,0,0,8,723,8,723,1.152586000,0.3018
129.104.156.61,<->,8.52.178.59,0,0,8,984,8,984,1.150915000,0.4631
215.158.239.87,<->,196.90.186.239,8,774,0,0,8,774,1.149059000,0.6497
215.158.239.56,<->,199.20.31.142,8,1858,0,0,8,1858,1.148583000,0.7199
215.158.239.203,<->,137.107.106.106,8,5453,0,0,8,5453,1.142358000,0.3095
215.158.239.43,<->,112.220.206.100,8,3332,0,0,8,3332,1.140039000,0.6418
215.158.238.142,<->,100.224.138.248,8,1973,0,0,8,1973,1.139839000,0.2454
195.70.7.128,<->,136.25.188.255,0,0,8,907,8,907,1.137535000,0.5262
207.173.189.193,<->,136.25.188.255,0,0,8,1002,8,1002,1.136987000,0.7986
207.239.153.240,<->,136.25.188.242,0,0,8,2036,8,2036,1.136646000,0.6362
215.158.238.220,<->,156.165.37.94,8,1435,0,0,8,1435,1.136049000,0.2148
249.101.227.124,<->,98.57.212.245,8,4045,0,0,8,4045,1.134745000,0.1922
207.53.41.19,<->,50.223.3.228,0,0,8,430,8,430,1.133815000,0.7051
136.25.189.1,<->,8.255.92.165,8,5108,0,0,8,5108,1.132176000,0.5767
157.127.139.203,<->,8.252.221.223,0,0,8,722,8,722,1.131961000,0.6130
215.158.238.196,<->,149.163.129.232,8,1781,0,0,8,1781,1.130200000,0.1625
89.216.125.234,<->,53.229.32.4,8,5737,0,0,8,5737,1.129886000,0.2721
220.20.200.163,<->,131.69.188.185,8,5496,0,0,8,5496,1.127903000,0.6876
215.158.239.78,<->,199.20.29.115,8,774,0,0,8,774,1.126427000,0.6400
109.1.15.105,<->,100.124.212.251,8,4826,0,0,8,4826,1.114233000,0.1748
143.42.29.66,<->,136.25.188.255,0,0,8,1408,8,1408,1.106123000,0.6199
119.163.235.139,<->,50.224.76.235,0,0,8,1272,8,1272,1.096485000,0.2609
100.218.114.30,<->,8.252.221.171,0,0,8,2002,8,2002,1.093082000,0.8441
204.200.42.226,<->,136.25.188.178,0,0,8,1045,8,1045,1.092805000,0.3197
143.173.13.198,<->,133.178.227.41,0,0,8,1797,8,1797,1.081187000,0.1887
215.158.239.0,<->,215.158.127.166,8,6781,0,0,8,6781,1.080171000,0.3804
231.140.186.73,<->,215.158.239.51,0,0,8,974,8,974,1.077827000,0.8938
215.158.239.50,<->,195.83.1.113,8,1866,0,0,8,1866,1.076031000,0.8001
199.33.121.209,<->,136.25.188.222,0,0,8,786,8,786,1.073339000,0.8308
251.24.86.2,<->,8.252.222.148,0,0,8,1142,8,1142,1.073225000,0.2262
138.127.224.225,<->,33.233.141.2,0,0,8,1936,8,1936,1.070473000,0.0056
98.230.220.243,<->,8.183.25.124,0,0,8,743,8,743,1.064565000,0.7636
215.158.238.75,<->,104.3.168.215,8,5524,0,0,8,5524,1.062002000,0.9230
38.132.114.46,<->,8.252.222.134,0,0,8,2241,8,2241,1.059707000,0.8127
195.7.56.194,<->,136.25.188.162,0,0,8,1093,8,1093,1.059671000,0.9250
220.28.85.14,<->,136.25.189.54,0,0,8,10495,8,10495,1.051744000,0.0001
215.158.238.106,<->,126.219.132.251,8,4335,0,0,8,4335,1.049419000,0.9074
215.158.58.190,<->,99.74.145.29,0,0,8,11156,8,11156,1.047911000,0.0001
192.67.163.217,<->,146.234.133.196,8,3666,0,0,8,3666,1.047580000,0.7441
80.42.168.235,<->,14.30.152.112,8,1398,0,0,8,1398,1.041561000,0.2200
95.245.224.255,<->,0.195.210.42,0,0,8,1620,8,1620,1.037418000,0.4413
215.158.238.122,<->,143.155.231.4,8,1585,0,0,8,1585,1.036261000,0.6742
215.158.239.56,<->,199.33.137.8,8,1949,0,0,8,1949,1.030959000,0.7953
136.25.188.226,<->,69.132.194.94,8,2730,0,0,8,2730,1.028298000,0.7756
143.52.24.56,<->,136.25.188.54,0,0,8,448,8,448,1.027769000,0.1271
132.119.136.62,<->,8.31.37.175,0,0,8,1432,8,1432,1.023376000,0.2540
133.178.226.224,<->,106.188.254.181,8,2046,0,0,8,2046,1.022741000,0.5770
215.158.239.56,<->,195.55.212.4,8,1309,0,0,8,1309,1.020668000,0.9321
199.36.28.158,<->,99.75.109.64,0,0,8,992,8,992,1.014426000,0.7294
195.55.30.239,<->,136.25.188.173,0,0,8,1407,8,1407,1.013432000,0.9281
204.56.73.236,<->,136.25.188.253,0,0,8,1419,8,1419,1.011534000,0.5908
109.222.233.60,<->,54.37.85.146,8,4108,0,0,8,4108,1.010139000,0.4616
133.178.227.1,<->,8.220.54.219,8,1503,0,0,8,1503,1.009942000,0.2675
197.113.99.143,<->,136.25.188.174,0,0,8,811,8,811,1.006912000,0.9111
195.55.178.184,<->,136.25.188.174,0,0,8,1397,8,1397,1.005777000,0.9347
215.158.238.133,<->,158.192.3.223,8,2890,0,0,8,2890,1.001901000,0.9699
129.236.114.39,<->,33.233.141.0,0,0,8,1700,8,1700,1.001650000,0.8464
136.25.188.196,<->,112.220.206.88,8,1717,0,0,8,1717,1.001270000,0.2945
215.158.239.95,<->,142.207.210.79,8,1168,0,0,8,1168,1.000091000,0.5610
195.77.121.207,<->,8.20.87.206,0,0,8,1800,8,1800,0.999604000,0.4331
199.68.20.34,<->,136.25.188.252,0,0,8,1116,8,1116,0.995476000,0.7593
199.72.43.25,<->,136.25.188.160,0,0,8,1763,8,1763,0.994159000,0.9039
220.28.108.254,<->,136.25.189.94,0,0,8,893,8,893,0.993095000,0.1899
133.178.226.30,<->,122.158.49.233,8,2954,0,0,8,2954,0.989156000,0.7365
136.25.188.34,<->,80.57.208.13,8,6675,0,0,8,6675,0.988644000,0.6487
133.178.226.28,<->,113.20.94.98,8,1493,0,0,8,1493,0.987989000,0.2017
215.158.61.242,<->,8.176.8.109,0,0,8,10865,8,10865,0.984680000,0.5107
215.158.239.97,<->,199.122.9.216,8,862,0,0,8,862,0.983869000,0.6546
111.20.172.70,<->,111.20.168.139,0,0,8,1016,8,1016,0.979436000,1.0123
215.158.239.192,<->,145.116.223.93,8,9221,0,0,8,9221,0.978505000,0.3492
215.158.239.58,<->,199.20.31.106,8,1364,0,0,8,1364,0.978385000,0.6006
220.55.119.126,<->,198.146.28.33,8,2256,0,0,8,2256,0.977024000,0.2837
215.158.239.69,<->,142.228.81.169,8,1658,0,0,8,1658,0.973323000,0.7371
199.68.128.197,<->,136.25.188.198,0,0,8,448,8,448,0.971641000,0.0148
136.25.188.46,<->,122.159.245.144,8,4095,0,0,8,4095,0.966394000,0.9741
139.193.141.139,<->,109.0.52.150,8,1599,0,0,8,1599,0.960003000,0.1921
215.158.239.94,<->,207.236.116.111,8,1315,0,0,8,1315,0.953885000,0.2648
136.25.188.226,<->,113.23.104.221,8,2842,0,0,8,2842,0.949285000,0.8591
215.158.239.95,<->,142.237.138.17,8,800,0,0,8,800,0.946483000,0.6435
144.85.170.254,<->,17.90.66.204,8,1143,0,0,8,1143,0.944760000,0.0603
215.158.239.49,<->,126.219.191.92,8,4239,0,0,8,4239,0.940378000,0.4521
215.158.239.49,<->,207.56.150.97,8,1173,0,0,8,1173,0.939363000,0.4342
220.20.200.80,<->,144.83.60.153,8,4774,0,0,8,4774,0.938108000,0.1496
215.158.238.68,<->,106.188.183.76,8,8707,0,0,8,8707,0.937797000,0.3805
215.158.238.107,<->,129.175.139.42,8,1781,0,0,8,1781,0.936976000,0.0616
199.73.39.165,<->,136.25.188.53,0,0,8,512,8,512,0.936665000,0.9371
215.158.238.65,<->,192.227.190.231,8,3674,0,0,8,3674,0.933249000,0.4662
199.83.56.50,<->,136.25.188.53,0,0,8,1588,8,1588,0.931243000,0.9905
197.189.26.143,<->,92.27.219.235,0,0,8,422,8,422,0.930748000,0.3822
207.92.48.95,<->,8.182.248.147,0,0,8,903,8,903,0.922182000,0.8463
252.98.138.253,<->,159.57.90.68,8,4926,0,0,8,4926,0.921037000,0.1576
197.113.99.143,<->,136.25.188.227,0,0,8,1562,8,1562,0.920098000,0.8871
215.158.239.239,<->,210.231.140.46,8,928,0,0,8,928,0.918577000,0.0348
199.71.75.181,<->,136.25.188.237,0,0,8,1219,8,1219,0.914891000,0.1736
216.184.2.255,<->,136.25.189.15,0,0,8,5460,8,5460,0.913050000,0.6186
215.158.238.50,<->,129.222.36.167,8,4934,0,0,8,4934,0.912620000,0.2051
195.14.76.224,<->,136.25.188.208,0,0,8,1224,8,1224,0.911521000,0.5109
215.158.239.49,<->,199.79.10.208,8,774,0,0,8,774,0.911213000,0.7797
136.25.189.57,<->,126.219.194.54,8,4499,0,0,8,4499,0.911160000,0.7940
136.25.188.47,<->,80.47.111.87,8,2794,0,0,8,2794,0.907928000,0.8527
144.87.235.222,<->,109.127.101.16,8,5891,0,0,8,5891,0.905563000,0.3011
196.89.219.234,<->,136.25.188.163,0,0,8,1951,8,1951,0.901159000,1.0207
215.158.239.105,<->,215.158.61.183,8,7290,0,0,8,7290,0.899523000,0.9860
215.158.239.77,<->,204.227.246.253,8,1542,0,0,8,1542,0.899455000,0.4840
215.158.239.113,<->,129.222.36.103,8,3057,0,0,8,3057,0.897563000,1.0484
92.181.155.55,<->,8.204.53.229,8,940,0,0,8,940,0.897515000,0.8580
215.158.239.95,<->,199.79.138.142,8,2757,0,0,8,2757,0.896338000,0.9502
142.253.114.3,<->,136.25.188.177,0,0,8,796,8,796,0.895512000,0.9959
195.7.234.210,<->,136.25.188.163,0,0,8,1654,8,1654,0.893186000,0.5788
215.158.239.95,<->,199.20.29.86,8,1972,0,0,8,1972,0.891246000,1.0800
220.20.200.248,<->,118.45.59.45,8,11198,0,0,8,11198,0.889545000,0.1781
195.71.87.219,<->,136.25.188.241,0,0,8,1834,8,1834,0.887839000,0.7150
204.61.12.222,<->,136.25.188.220,0,0,8,1596,8,1596,0.887032000,0.8180
215.158.239.85,<->,199.20.28.7,8,460,0,0,8,460,0.884780000,0.6000
215.158.239.7,<->,29.211.5.208,8,3234,0,0,8,3234,0.881832000,0.5772
224.148.1.28,<->,210.231.140.55,8,1218,0,0,8,1218,0.881186000,0.0643
194.232.229.200,<->,136.25.188.173,0,0,8,657,8,657,0.878364000,0.8067
215.158.239.81,<->,98.219.126.140,8,7220,0,0,8,7220,0.876072000,1.0098
136.25.188.225,<->,95.90.181.60,8,784,0,0,8,784,0.874488000,0.8067
134.21.115.23,<->,109.1.40.226,0,0,8,1093,8,1093,0.873528000,0.8604
215.158.238.104,<->,143.155.227.54,8,1541,0,0,8,1541,0.871789000,0.2897
215.158.238.66,<->,148.55.210.231,8,1733,0,0,8,1733,0.870065000,0.5314
215.158.239.56,<->,199.20.28.255,8,500,0,0,8,500,0.869597000,0.0007
136.25.188.168,<->,100.224.202.185,8,6050,0,0,8,6050,0.866560000,0.6793
215.158.238.135,<->,149.99.94.68,8,2714,0,0,8,2714,0.866273000,1.1334
195.55.83.63,<->,136.25.188.175,0,0,8,1291,8,1291,0.862862000,0.5332
192.204.123.54,<->,136.25.189.15,0,0,8,5396,8,5396,0.860482000,1.0938
221.102.56.69,<->,80.41.118.73,0,0,8,956,8,956,0.855186000,0.6447
105.201.225.210,<->,50.224.89.243,0,0,8,1519,8,1519,0.853708000,0.8882
136.25.189.17,<->,133.146.0.244,8,4127,0,0,8,4127,0.846433000,1.0393
215.158.239.87,<->,199.106.45.168,8,774,0,0,8,774,0.844930000,0.9277
215.158.140.231,<->,8.240.116.198,8,2562,0,0,8,2562,0.842891000,0.3823
200.174.198.138,<->,53.231.94.127,8,5010,0,0,8,5010,0.842475000,0.9318
249.115.166.202,<->,8.52.189.207,0,0,8,1402,8,1402,0.841119000,0.1778
142.206.79.97,<->,136.25.188.44,0,0,8,887,8,887,0.837192000,0.6982
215.158.239.49,<->,199.20.29.184,8,1197,0,0,8,1197,0.836021000,0.6898
215.158.239.58,<->,143.135.7.140,8,472,0,0,8,472,0.834957000,0.8157
50.224.76.235,<->,48.129.148.191,8,1538,0,0,8,1538,0.834060000,0.5390
195.127.190.87,<->,136.25.188.163,0,0,8,400,8,400,0.831931000,0.2310
215.158.239.56,<->,207.58.26.197,8,400,0,0,8,400,0.831538000,1.1001
215.158.239.56,<->,204.226.21.168,8,894,0,0,8,894,0.829828000,0.7903
204.60.205.115,<->,136.25.188.198,0,0,8,616,8,616,0.824541000,0.5006
136.18.96.155,<->,8.182.226.78,0,0,8,1124,8,1124,0.817930000,0.3278
207.236.238.63,<->,136.25.188.239,0,0,8,1368,8,1368,0.815781000,0.0932
215.158.239.56,<->,199.20.30.216,8,2687,0,0,8,2687,0.809987000,1.0999
143.134.6.217,<->,136.25.188.46,0,0,8,685,8,685,0.807399000,1.0154
220.28.85.14,<->,136.25.188.166,0,0,8,9897,8,9897,0.807073000,0.9127
215.158.239.77,<->,143.129.23.71,8,1435,0,0,8,1435,0.805386000,0.7715
229.45.205.24,<->,124.148.1.107,8,5849,0,0,8,5849,0.802699000,0.7692
204.60.25.85,<->,136.25.188.55,0,0,8,875,8,875,0.801409000,1.0500
54.37.220.84,<->,48.52.227.200,0,0,8,502,8,502,0.799261000,1.1120
92.27.219.22,<->,18.203.68.39,8,432,0,0,8,432,0.798312000,0.4649
195.125.10.35,<->,136.25.188.174,0,0,8,1153,8,1153,0.796026000,0.8029
200.175.155.31,<->,53.149.17.194,8,5567,0,0,8,5567,0.795637000,1.0424
212.164.143.229,<->,110.216.9.53,8,1294,0,0,8,1294,0.794810000,0.3856
215.158.239.56,<->,199.20.31.6,8,774,0,0,8,774,0.794600000,0.9804
195.14.10.115,<->,136.25.188.236,0,0,8,1680,8,1680,0.793450000,0.6372
144.85.170.208,<->,91.69.181.170,8,1163,0,0,8,1163,0.790860000,0.1944
109.127.101.16,<->,99.73.230.108,0,0,8,6009,8,6009,0.790616000,0.2034
215.158.239.33,<->,8.222.7.154,8,2560,0,0,8,2560,0.790304000,0.6760
247.118.176.109,<->,8.182.227.5,0,0,8,696,8,696,0.789955000,0.4090
99.252.99.88,<->,50.224.68.190,0,0,8,895,8,895,0.789045000,0.4100
231.143.163.19,<->,136.25.188.198,0,0,8,460,8,460,0.788900000,0.9198
215.158.239.75,<->,139.163.161.48,8,9002,0,0,8,9002,0.787112000,0.2325
231.193.152.174,<->,98.236.194.252,0,0,8,466,8,466,0.785333000,0.1364
213.38.254.205,<->,8.55.211.213,8,940,0,0,8,940,0.780730000,0.0983
159.133.254.197,<->,89.183.104.156,0,0,8,7836,8,7836,0.775465000,0.9993
215.158.238.210,<->,100.50.96.239,8,2794,0,0,8,2794,0.772267000,0.5024
136.25.189.1,<->,133.56.180.50,8,4143,0,0,8,4143,0.766040000,0.8079
133.178.226.30,<->,38.104.11.116,8,1765,0,0,8,1765,0.765557000,0.4279
199.111.50.105,<->,8.182.243.89,0,0,8,1371,8,1371,0.765261000,0.9044
143.76.142.162,<->,8.182.241.177,0,0,8,1387,8,1387,0.764682000,0.4363
92.27.27.145,<->,72.150.20.100,8,416,0,0,8,416,0.764186000,1.1100
215.158.238.115,<->,131.173.115.66,8,2986,0,0,8,2986,0.764069000,0.6210
215.158.239.92,<->,199.20.31.211,8,400,0,0,8,400,0.762798000,0.7864
206.195.202.254,<->,99.72.225.71,0,0,8,8228,8,8228,0.760458000,1.0814
215.158.238.188,<->,8.50.170.249,8,2609,0,0,8,2609,0.758700000,0.7748
215.158.61.243,<->,8.176.8.210,0,0,8,7197,8,7197,0.758515000,0.4330
50.224.76.235,<->,6.73.186.38,8,4985,0,0,8,4985,0.757844000,0.2182
215.158.239.56,<->,199.20.28.181,8,448,0,0,8,448,0.754892000,1.0000
215.158.239.117,<->,215.158.61.191,8,7354,0,0,8,7354,0.754200000,1.1030
215.158.239.79,<->,142.236.171.98,8,1197,0,0,8,1197,0.753205000,0.9663
215.158.239.113,<->,129.222.39.189,8,3075,0,0,8,3075,0.751681000,0.0641
213.186.52.92,<->,144.85.170.254,0,0,8,841,8,841,0.750702000,0.1326
210.158.44.41,<->,89.143.163.60,8,11788,0,0,8,11788,0.747968000,0.0001
136.25.189.86,<->,98.219.126.175,8,2265,0,0,8,2265,0.744951000,0.7008
215.158.239.92,<->,207.114.77.109,8,748,0,0,8,748,0.742848000,1.0201
199.73.184.38,<->,136.25.188.175,0,0,8,1157,8,1157,0.742159000,0.2761
215.158.239.78,<->,196.94.129.219,8,1638,0,0,8,1638,0.740374000,1.1197
246.253.253.211,<->,204.90.4.135,8,1016,0,0,8,1016,0.739532000,1.0465
215.158.238.98,<->,122.159.30.34,8,448,0,0,8,448,0.736180000,0.8705
139.163.96.94,<->,67.198.113.139,8,438,0,0,8,438,0.733835000,1.2060
116.141.153.149,<->,50.224.61.172,0,0,8,448,8,448,0.731146000,1.1393
143.20.132.182,<->,136.25.188.196,0,0,8,1090,8,1090,0.728058000,1.2647
136.25.188.55,<->,8.42.43.90,8,4223,0,0,8,4223,0.723217000,1.0867
198.226.166.140,<->,136.25.189.59,0,0,8,3018,8,3018,0.720509000,0.4744
215.158.239.92,<->,29.212.198.180,8,5460,0,0,8,5460,0.716492000,0.8121
129.92.116.90,<->,50.239.49.97,8,5865,0,0,8,5865,0.708741000,0.1931
207.56.104.108,<->,136.25.188.54,0,0,8,1588,8,1588,0.708370000,1.2496
199.98.18.235,<->,8.252.222.176,0,0,8,1256,8,1256,0.707846000,0.9574
215.158.239.87,<->,195.5.208.153,8,1154,0,0,8,1154,0.707345000,0.9072
105.201.225.210,<->,50.224.89.241,0,0,8,1519,8,1519,0.704217000,1.1716
215.158.238.236,<->,8.222.213.18,8,3509,0,0,8,3509,0.700204000,1.0802
92.162.253.204,<->,91.243.255.6,8,8277,0,0,8,8277,0.698071000,0.1247
220.28.65.9,<->,133.178.227.30,0,0,8,909,8,909,0.694035000,0.1443
215.158.239.95,<->,199.20.30.109,8,1083,0,0,8,1083,0.687079000,0.7589
50.224.77.123,<->,38.177.142.212,8,418,0,0,8,418,0.686150000,1.2742
215.158.238.24,<->,113.92.151.99,8,1610,0,0,8,1610,0.685886000,0.3498
133.178.226.38,<->,104.3.161.71,8,2774,0,0,8,2774,0.683649000,1.0739
215.158.239.42,<->,29.211.5.165,8,3379,0,0,8,3379,0.682178000,0.2900
215.158.239.85,<->,192.204.123.11,8,2666,0,0,8,2666,0.681331000,0.9907
199.71.8.221,<->,136.25.188.252,0,0,8,1594,8,1594,0.679318000,1.3173
100.203.255.93,<->,50.224.61.172,0,0,8,448,8,448,0.676188000,0.8452
136.128.35.207,<->,8.176.8.87,0,0,8,768,8,768,0.675939000,0.0845
215.158.61.202,<->,136.25.189.243,0,0,8,7481,8,7481,0.671606000,0.4961
215.158.238.243,<->,8.40.50.57,8,2826,0,0,8,2826,0.667296000,1.1771
54.39.125.87,<->,48.53.110.16,0,0,8,5567,8,5567,0.665978000,0.9283
143.134.70.126,<->,136.25.188.241,0,0,8,1319,8,1319,0.665762000,0.2591
101.70.123.83,<->,8.222.7.16,8,4783,0,0,8,4783,0.662564000,0.3536
215.158.239.79,<->,196.107.122.156,8,1286,0,0,8,1286,0.661028000,1.0542
139.163.6.161,<->,115.233.224.12,8,916,0,0,8,916,0.659101000,1.1764
144.85.170.208,<->,111.216.99.92,8,1083,0,0,8,1083,0.658524000,0.1005
215.158.238.97,<->,80.47.228.219,8,2922,0,0,8,2922,0.658291000,0.8858
215.158.238.123,<->,80.57.141.60,8,1573,0,0,8,1573,0.653166000,0.0468
97.203.12.51,<->,8.182.227.35,0,0,8,1042,8,1042,0.651448000,0.5689
207.92.35.41,<->,8.182.227.180,0,0,8,789,8,789,0.649713000,0.4932
221.102.56.69,<->,102.81.131.138,0,0,8,940,8,940,0.649312000,0.1658
193.4.105.60,<->,50.224.76.248,0,0,8,2471,8,2471,0.644736000,0.3302
197.107.201.140,<->,136.25.188.225,0,0,8,1477,8,1477,0.641638000,0.9648
203.215.176.177,<->,124.42.185.84,8,1053,0,0,8,1053,0.640986000,0.8882
136.25.189.16,<->,131.144.115.231,8,3002,0,0,8,3002,0.640914000,1.0804
215.158.238.250,<->,33.221.186.163,8,3642,0,0,8,3642,0.638726000,1.3196
215.158.61.145,<->,136.25.188.43,0,0,8,6280,8,6280,0.637202000,1.2626
238.110.17.82,<->,50.224.76.235,0,0,8,4743,8,4743,0.636388000,0.2283
215.158.239.93,<->,201.211.113.180,8,2858,0,0,8,2858,0.634907000,0.6073
136.25.188.178,<->,104.3.168.213,8,5316,0,0,8,5316,0.634487000,0.9646
215.158.238.199,<->,8.219.186.172,8,5018,0,0,8,5018,0.633274000,1.3259
215.158.239.58,<->,199.20.30.1,8,2025,0,0,8,2025,0.632834000,1.1901
220.55.88.152,<->,106.4.62.248,8,965,0,0,8,965,0.631434000,0.3376
133.178.227.19,<->,133.56.180.42,8,4180,0,0,8,4180,0.630767000,0.9993
195.41.100.177,<->,136.25.188.236,0,0,8,1587,8,1587,0.630288000,1.3055
98.128.107.99,<->,8.55.211.213,8,940,0,0,8,940,0.629973000,0.2067
136.25.188.166,<->,100.224.202.178,8,1798,0,0,8,1798,0.628289000,1.1213
136.25.188.243,<->,8.227.55.87,8,464,0,0,8,464,0.623241000,0.0708
215.158.239.49,<->,197.128.83.90,8,752,0,0,8,752,0.623022000,1.0460
215.158.238.83,<->,65.27.220.196,8,2682,0,0,8,2682,0.619903000,1.1901
215.158.239.222,<->,215.158.61.182,8,6245,0,0,8,6245,0.618716000,0.7531
101.64.89.82,<->,8.252.223.146,0,0,8,5412,8,5412,0.616373000,0.6015
215.158.140.229,<->,197.133.131.168,8,3604,0,0,8,3604,0.615957000,1.2232
252.98.139.114,<->,27.11.66.245,8,6538,0,0,8,6538,0.614397000,0.3672
50.224.96.155,<->,38.241.61.209,8,448,0,0,8,448,0.614231000,0.1043
204.3.189.5,<->,136.25.188.242,0,0,8,2099,8,2099,0.612545000,0.0591
133.178.227.2,<->,133.56.180.50,8,4735,0,0,8,4735,0.612255000,0.9679
215.202.174.56,<->,136.25.189.59,0,0,8,2068,8,2068,0.610331000,1.0517
210.209.251.211,<->,192.64.215.193,0,0,8,1272,8,1272,0.609752000,0.1316
109.119.141.179,<->,92.162.253.91,0,0,8,6070,8,6070,0.606967000,0.0877
215.158.239.96,<->,196.94.82.101,8,1930,0,0,8,1930,0.604832000,0.3608
215.158.238.221,<->,131.144.114.248,8,2513,0,0,8,2513,0.603161000,1.3069
215.158.238.251,<->,8.42.42.138,8,2520,0,0,8,2520,0.602996000,1.0018
139.60.197.151,<->,136.25.188.198,0,0,8,701,8,701,0.602398000,0.3489
220.28.65.9,<->,133.178.226.8,0,0,8,9664,8,9664,0.600807000,0.1122
246.254.97.230,<->,111.151.239.173,8,1316,0,0,8,1316,0.600778000,0.1304
215.158.61.195,<->,8.176.8.232,0,0,8,4599,8,4599,0.588256000,0.4300
17.2.12.81,<->,8.220.176.253,0,0,8,856,8,856,0.587481000,0.6738
159.70.47.29,<->,144.86.146.31,0,0,8,5832,8,5832,0.583962000,0.3364
136.25.189.17,<->,6.29.108.87,8,2079,0,0,8,2079,0.582991000,0.2169
221.102.56.69,<->,6.75.204.162,0,0,8,940,8,940,0.582920000,0.1154
136.25.189.14,<->,56.28.207.202,8,4399,0,0,8,4399,0.581895000,0.4594
216.184.2.234,<->,136.25.189.32,0,0,8,1510,8,1510,0.579791000,0.0972
231.142.100.123,<->,136.25.188.53,0,0,8,1291,8,1291,0.573705000,1.0873
144.85.170.208,<->,91.69.185.131,8,851,0,0,8,851,0.571870000,0.1268
207.173.96.90,<->,136.25.188.255,0,0,8,928,8,928,0.570499000,1.2873
130.77.154.37,<->,0.195.210.42,0,0,8,1071,8,1071,0.570490000,0.4369
136.25.188.197,<->,131.36.198.48,8,6159,0,0,8,6159,0.570150000,1.1727
215.158.239.113,<->,129.222.39.153,8,1687,0,0,8,1687,0.570135000,1.0611
75.214.229.4,<->,8.252.221.230,0,0,8,1204,8,1204,0.569838000,1.3597
133.178.226.30,<->,122.158.49.180,8,2854,0,0,8,2854,0.569233000,0.2725
215.158.238.115,<->,131.144.114.216,8,2778,0,0,8,2778,0.568560000,1.3526
215.158.238.120,<->,118.20.87.79,8,1749,0,0,8,1749,0.567272000,0.2651
204.187.18.61,<->,136.25.188.224,0,0,8,1014,8,1014,0.563251000,1.0097
215.158.239.51,<->,68.124.221.168,8,5332,0,0,8,5332,0.561268000,1.4280
196.245.104.127,<->,136.25.188.45,0,0,8,448,8,448,0.561128000,0.1592
215.158.239.16,<->,145.13.164.245,8,3648,0,0,8,3648,0.560647000,0.2679
220.28.108.254,<->,215.158.239.47,0,0,8,909,8,909,0.557033000,0.2080
215.158.238.104,<->,140.173.227.38,8,1705,0,0,8,1705,0.556457000,0.5088
215.158.238.107,<->,86.151.231.8,8,1765,0,0,8,1765,0.555468000,0.2628
133.178.227.2,<->,69.150.169.225,8,2563,0,0,8,2563,0.554348000,0.9937
133.178.227.27,<->,61.35.22.228,8,2537,0,0,8,2537,0.551069000,1.4414
215.158.239.79,<->,199.106.51.143,8,1985,0,0,8,1985,0.550460000,0.3713
194.232.126.2,<->,136.25.188.177,0,0,8,1732,8,1732,0.549284000,1.3455
215.158.239.79,<->,199.20.28.59,8,1255,0,0,8,1255,0.547559000,1.2968
215.158.239.6,<->,158.166.175.250,8,3632,0,0,8,3632,0.542028000,0.5688
139.193.141.194,<->,113.144.87.156,8,2737,0,0,8,2737,0.538280000,0.2968
215.158.239.113,<->,129.222.36.154,8,3083,0,0,8,3083,0.536749000,1.0474
215.158.140.241,<->,8.40.51.98,8,2419,0,0,8,2419,0.535943000,1.3114
17.240.3.26,<->,8.220.188.138,0,0,8,1001,8,1001,0.534833000,0.1502
8.182.228.191,<->,6.133.203.187,8,861,0,0,8,861,0.531229000,0.3920
136.25.188.163,<->,8.255.92.213,8,3066,0,0,8,3066,0.530933000,1.1848
215.158.239.92,<->,199.20.28.132,8,1620,0,0,8,1620,0.525595000,1.0386
143.42.151.21,<->,136.25.188.198,0,0,8,448,8,448,0.522372000,0.0251
231.140.169.145,<->,136.25.188.238,0,0,8,1627,8,1627,0.522009000,0.8399
136.25.189.12,<->,133.146.0.169,8,1765,0,0,8,1765,0.521268000,0.0682
200.164.0.16,<->,8.252.221.237,0,0,8,418,8,418,0.520200000,1.3170
196.206.177.77,<->,136.25.188.243,0,0,8,448,8,448,0.518244000,1.2010
246.253.253.170,<->,210.231.140.55,8,1081,0,0,8,1081,0.517703000,0.0796
215.158.238.125,<->,100.224.166.115,8,2248,0,0,8,2248,0.512064000,1.4113
199.118.237.13,<->,50.223.3.228,0,0,8,418,8,418,0.510182000,1.3324
222.254.247.163,<->,210.220.219.181,0,0,8,4447,8,4447,0.509613000,1.4512
114.196.95.169,<->,92.27.27.169,0,0,8,416,8,416,0.506954000,0.9205
215.158.239.48,<->,196.88.42.114,8,1975,0,0,8,1975,0.495848000,1.3897
129.224.112.252,<->,97.242.126.200,8,550,0,0,8,550,0.495801000,0.7794
136.25.188.254,<->,8.188.227.39,8,2810,0,0,8,2810,0.492714000,1.4458
136.25.188.53,<->,29.214.64.161,8,2822,0,0,8,2822,0.490705000,1.0662
192.227.190.232,<->,133.178.226.38,0,0,8,3690,8,3690,0.489126000,0.5379
215.158.238.47,<->,112.220.206.117,8,2730,0,0,8,2730,0.485710000,1.4637
156.161.212.226,<->,8.252.222.175,0,0,8,1851,8,1851,0.479617000,1.0176
215.158.238.80,<->,80.47.111.87,8,2778,0,0,8,2778,0.477260000,0.9264
139.163.71.197,<->,119.223.130.3,8,680,0,0,8,680,0.476528000,1.0847
136.25.189.33,<->,8.215.68.54,8,4751,0,0,8,4751,0.474883000,0.6238
197.125.126.184,<->,136.25.188.54,0,0,8,2922,8,2922,0.473823000,0.9670
133.178.226.61,<->,126.219.132.237,8,4251,0,0,8,4251,0.473818000,1.1742
215.158.238.104,<->,115.140.139.149,8,1853,0,0,8,1853,0.472440000,0.7570
93.181.154.1,<->,50.224.49.212,0,0,8,484,8,484,0.471969000,1.0131
215.158.61.182,<->,8.176.8.210,0,0,8,6967,8,6967,0.471708000,0.4168
136.119.203.229,<->,136.25.188.29,0,0,8,738,8,738,0.466611000,0.0478
136.25.189.81,<->,120.154.131.21,8,5438,0,0,8,5438,0.465754000,1.4996
215.158.239.56,<->,199.20.29.135,8,768,0,0,8,768,0.465680000,1.0101
136.25.189.15,<->,96.156.169.160,8,3547,0,0,8,3547,0.462876000,1.2053
142.205.49.233,<->,136.25.188.225,0,0,8,1519,8,1519,0.461097000,1.4082
247.136.221.242,<->,133.73.194.45,8,1729,0,0,8,1729,0.459425000,0.7366
242.22.195.14,<->,100.228.42.92,0,0,8,7254,8,7254,0.457345000,0.4800
146.249.226.43,<->,8.252.221.204,0,0,8,548,8,548,0.454672000,0.1113
220.28.114.28,<->,215.158.238.124,0,0,8,11295,8,11295,0.454201000,0.0001
215.158.140.83,<->,8.220.54.202,8,1490,0,0,8,1490,0.452659000,0.1124
94.192.15.50,<->,8.252.222.63,0,0,8,560,8,560,0.452175000,1.4340
215.158.239.85,<->,29.212.180.168,8,2906,0,0,8,2906,0.451621000,1.1116
204.186.166.56,<->,136.25.188.176,0,0,8,1185,8,1185,0.451276000,0.5005
89.183.104.115,<->,33.57.74.182,8,580,0,0,8,580,0.449949000,1.5172
133.178.226.90,<->,131.144.113.160,8,4047,0,0,8,4047,0.449837000,1.1085
215.158.140.76,<->,29.214.211.22,8,3474,0,0,8,3474,0.449780000,1.5241
215.158.238.85,<->,8.255.1.161,8,2144,0,0,8,2144,0.448939000,0.5823
136.25.189.77,<->,120.155.8.89,8,4079,0,0,8,4079,0.446353000,1.2364
215.158.239.79,<->,196.92.170.76,8,553,0,0,8,553,0.443764000,0.2200
215.158.238.135,<->,131.144.114.210,8,4047,0,0,8,4047,0.442843000,1.3853
221.102.56.69,<->,192.67.115.110,0,0,8,940,8,940,0.440906000,0.0988
143.129.222.110,<->,136.25.188.252,0,0,8,448,8,448,0.439318000,1.3862
197.106.106.211,<->,8.182.253.233,0,0,8,811,8,811,0.438906000,0.4909
215.158.239.70,<->,29.209.59.173,8,3066,0,0,8,3066,0.438025000,0.9315
215.158.239.78,<->,199.20.23.22,8,496,0,0,8,496,0.436835000,1.5599
195.85.122.92,<->,80.42.160.193,0,0,8,808,8,808,0.436564000,1.5072
142.166.44.184,<->,136.25.188.255,0,0,8,2064,8,2064,0.436195000,0.3505
92.27.219.169,<->,88.152.222.126,8,422,0,0,8,422,0.433901000,1.4975
139.163.96.127,<->,64.135.130.13,8,412,0,0,8,412,0.432539000,1.2873
204.130.125.5,<->,8.252.222.223,0,0,8,603,8,603,0.429893000,1.0639
136.25.189.15,<->,29.211.93.5,8,3919,0,0,8,3919,0.429271000,1.0075
133.178.226.38,<->,106.188.251.218,8,1918,0,0,8,1918,0.427929000,1.3829
231.142.170.225,<->,215.158.239.96,0,0,8,1401,8,1401,0.426517000,1.2337
221.102.56.69,<->,192.64.225.2,0,0,8,940,8,940,0.425725000,0.1340
133.178.227.73,<->,133.56.180.94,8,7860,0,0,8,7860,0.424264000,1.4708
128.110.138.173,<->,8.252.222.211,0,0,8,1573,8,1573,0.424165000,0.1372
215.158.61.242,<->,136.25.188.29,0,0,8,6945,8,6945,0.423279000,1.5263
98.23.121.95,<->,89.183.104.115,0,0,8,580,8,580,0.420844000,1.5213
92.27.128.248,<->,89.183.104.115,0,0,8,580,8,580,0.420748000,1.5231
148.184.76.108,<->,0.195.210.42,0,0,8,738,8,738,0.420739000,0.4389
215.158.239.32,<->,29.212.196.37,8,3492,0,0,8,3492,0.419670000,0.4489
215.158.238.251,<->,131.144.116.202,8,448,0,0,8,448,0.418913000,0.0026
142.177.128.44,<->,50.224.76.234,0,0,8,1672,8,1672,0.418847000,0.3671
215.158.239.78,<->,126.219.194.74,8,3149,0,0,8,3149,0.416951000,0.4158
215.158.238.251,<->,131.144.116.5,8,3481,0,0,8,3481,0.415880000,1.5541
92.27.59.105,<->,89.183.104.115,0,0,8,580,8,580,0.415430000,1.5211
232.31.229.85,<->,139.163.41.64,0,0,8,950,8,950,0.412126000,0.5923
247.136.217.189,<->,125.16.198.1,8,464,0,0,8,464,0.411759000,1.4831
195.126.20.79,<->,136.25.188.163,0,0,8,406,8,406,0.410456000,1.2724
215.158.239.87,<->,33.209.219.82,8,2405,0,0,8,2405,0.409883000,0.1248
98.23.101.117,<->,92.27.219.130,0,0,8,580,8,580,0.407961000,1.5166
142.252.185.121,<->,136.25.188.46,0,0,8,1827,8,1827,0.405841000,0.6206
142.255.126.163,<->,98.236.194.252,0,0,8,400,8,400,0.405572000,1.3345
142.220.26.164,<->,136.25.188.225,0,0,8,1214,8,1214,0.405470000,1.4151
98.230.219.5,<->,8.183.25.124,0,0,8,791,8,791,0.404278000,0.7256
215.158.238.135,<->,113.92.151.107,8,3071,0,0,8,3071,0.401527000,0.9467
195.15.142.186,<->,136.25.188.227,0,0,8,2033,8,2033,0.399813000,1.4580
204.56.65.237,<->,136.25.188.177,0,0,8,572,8,572,0.399365000,1.5562
215.158.238.104,<->,141.39.23.74,8,1685,0,0,8,1685,0.398982000,0.4058
207.173.190.202,<->,136.25.188.45,0,0,8,1427,8,1427,0.398009000,1.5606
139.163.96.127,<->,123.88.0.110,8,418,0,0,8,418,0.392920000,1.5830
139.241.56.102,<->,100.182.136.77,0,0,8,11647,8,11647,0.391892000,1.5060
133.178.227.214,<->,8.240.125.163,8,1192,0,0,8,1192,0.391031000,1.5850
144.85.170.208,<->,98.87.147.134,8,1099,0,0,8,1099,0.386456000,0.2680
215.158.238.133,<->,8.255.92.246,8,1461,0,0,8,1461,0.385452000,0.0428
136.25.188.227,<->,35.77.32.33,8,439,0,0,8,439,0.383733000,0.1465
109.221.142.67,<->,50.224.76.235,0,0,8,4669,8,4669,0.382078000,0.6120
215.158.239.85,<->,199.20.29.10,8,808,0,0,8,808,0.380382000,0.9197
193.123.127.223,<->,89.183.104.115,0,0,8,580,8,580,0.379229000,1.5197
215.158.61.189,<->,8.176.8.208,0,0,8,5150,8,5150,0.378926000,1.3438
136.25.188.179,<->,117.155.166.218,8,1653,0,0,8,1653,0.374964000,0.1461
215.158.239.71,<->,80.56.79.22,8,4191,0,0,8,4191,0.374542000,0.6598
210.229.230.22,<->,40.213.154.114,8,670,0,0,8,670,0.374249000,1.6250
215.158.239.93,<->,194.199.194.70,8,1514,0,0,8,1514,0.372862000,0.6018
54.39.125.87,<->,48.53.186.231,0,0,8,5552,8,5552,0.371649000,0.9605
17.21.42.126,<->,8.52.169.61,0,0,8,1903,8,1903,0.371276000,0.1614
215.158.239.49,<->,199.20.6.231,8,1293,0,0,8,1293,0.369775000,0.7696
142.191.1.22,<->,136.25.188.45,0,0,8,1285,8,1285,0.364859000,0.4146
215.158.239.4,<->,122.158.53.40,8,3523,0,0,8,3523,0.362962000,1.0460
133.178.226.30,<->,131.36.198.58,8,3449,0,0,8,3449,0.362387000,0.5961
215.158.239.93,<->,195.13.229.91,8,448,0,0,8,448,0.360867000,0.0102
207.12.103.185,<->,92.27.27.176,0,0,8,451,8,451,0.360372000,1.3911
98.23.101.117,<->,92.27.219.180,0,0,8,580,8,580,0.360203000,1.5196
98.23.101.117,<->,92.27.219.44,0,0,8,580,8,580,0.358682000,1.5216
215.158.238.133,<->,111.151.70.20,8,1733,0,0,8,1733,0.357760000,0.3724
111.147.75.105,<->,53.251.227.246,8,4815,0,0,8,4815,0.357253000,0.7077
199.39.190.65,<->,136.25.188.163,0,0,8,400,8,400,0.356074000,0.1525
207.56.101.49,<->,136.25.188.163,0,0,8,700,8,700,0.355633000,0.7128
136.25.189.38,<->,96.156.169.219,8,7032,0,0,8,7032,0.354922000,1.1140
215.158.238.115,<->,41.141.97.75,8,4056,0,0,8,4056,0.354565000,0.9044
215.158.239.101,<->,129.222.39.189,8,3175,0,0,8,3175,0.354022000,1.0517
238.118.110.215,<->,230.117.156.104,8,444,0,0,8,444,0.353500000,1.2956
207.236.202.212,<->,136.25.188.162,0,0,8,448,8,448,0.352959000,0.0246
133.178.226.28,<->,111.151.238.104,8,2682,0,0,8,2682,0.349517000,0.4666
109.1.26.46,<->,53.245.246.100,8,1420,0,0,8,1420,0.348934000,1.5897
136.25.188.179,<->,69.150.169.137,8,2826,0,0,8,2826,0.345327000,1.5632
215.158.238.64,<->,38.104.11.27,8,3290,0,0,8,3290,0.344614000,1.4119
215.158.238.106,<->,111.150.186.225,8,3018,0,0,8,3018,0.343975000,0.6622
215.158.140.163,<->,192.170.210.225,8,10413,0,0,8,10413,0.343524000,0.0003
139.163.17.164,<->,102.246.159.231,8,455,0,0,8,455,0.340546000,1.5402
133.178.226.60,<->,114.25.48.78,8,2774,0,0,8,2774,0.340430000,1.1254
119.71.114.135,<->,92.27.219.137,0,0,8,6256,8,6256,0.340111000,1.5634
195.41.100.177,<->,136.25.188.254,0,0,8,400,8,400,0.339851000,0.1697
138.121.99.24,<->,8.220.185.56,0,0,8,811,8,811,0.339563000,0.0885
215.158.239.56,<->,207.114.162.108,8,2977,0,0,8,2977,0.338755000,0.2496
139.241.56.105,<->,98.129.32.167,0,0,8,11647,8,11647,0.338230000,1.6453
215.158.238.115,<->,119.196.23.52,8,4063,0,0,8,4063,0.338004000,1.4984
143.10.115.110,<->,136.25.188.252,0,0,8,400,8,400,0.335574000,0.0148
204.89.43.243,<->,50.223.3.228,0,0,8,400,8,400,0.334804000,1.4810
136.25.188.197,<->,29.214.108.91,8,4207,0,0,8,4207,0.334118000,1.5876
193.123.127.211,<->,89.183.104.115,0,0,8,580,8,580,0.332491000,1.5205
69.128.138.24,<->,53.213.63.93,8,1076,0,0,8,1076,0.331995000,1.6646
142.236.211.60,<->,136.25.188.199,0,0,8,1141,8,1141,0.331552000,0.3604
93.183.125.243,<->,92.162.253.128,0,0,8,7275,8,7275,0.329172000,0.2932
215.158.239.76,<->,199.72.194.213,8,751,0,0,8,751,0.328005000,1.4011
105.203.241.189,<->,50.224.76.248,0,0,8,4813,8,4813,0.327959000,0.4423
215.158.239.79,<->,195.42.42.140,8,862,0,0,8,862,0.324999000,1.1959
54.36.196.172,<->,48.53.246.158,0,0,8,5906,8,5906,0.324369000,0.9444
204.185.114.163,<->,136.25.188.163,0,0,8,544,8,544,0.324051000,1.1994
215.158.238.236,<->,140.174.84.9,8,1442,0,0,8,1442,0.323770000,0.2622
110.92.154.194,<->,50.224.49.195,0,0,8,448,8,448,0.321190000,1.5364
98.23.101.117,<->,92.27.27.162,0,0,8,580,8,580,0.320704000,1.6440
210.224.219.234,<->,100.94.222.86,0,0,8,586,8,586,0.320426000,1.4988
98.23.101.117,<->,89.183.104.147,0,0,8,580,8,580,0.320199000,1.5179
136.25.189.59,<->,125.216.43.7,8,4511,0,0,8,4511,0.319054000,1.0629
136.25.189.80,<->,29.211.5.251,8,4239,0,0,8,4239,0.317529000,0.8654
195.5.173.153,<->,136.25.188.199,0,0,8,1674,8,1674,0.316698000,0.6206
204.200.32.214,<->,136.25.188.162,0,0,8,1032,8,1032,0.316415000,0.4320
133.178.226.14,<->,96.155.60.192,8,3575,0,0,8,3575,0.315279000,0.9462
129.236.114.39,<->,101.224.89.252,0,0,8,8883,8,8883,0.313075000,1.5333
249.85.37.11,<->,8.20.87.32,0,0,8,5432,8,5432,0.312310000,0.1881
215.158.239.97,<->,199.20.30.241,8,448,0,0,8,448,0.309778000,0.0500
194.232.233.141,<->,136.25.188.238,0,0,8,1594,8,1594,0.309013000,1.5648
136.139.59.102,<->,136.25.188.160,0,0,8,3002,8,3002,0.308056000,1.6384
215.158.239.48,<->,199.20.7.72,8,400,0,0,8,400,0.306680000,0.3894
98.23.101.117,<->,92.27.219.174,0,0,8,580,8,580,0.305811000,1.5212
102.41.217.28,<->,92.27.218.131,0,0,8,408,8,408,0.305595000,1.6890
136.25.189.29,<->,29.213.219.87,8,4548,0,0,8,4548,0.304983000,1.5438
215.158.238.142,<->,131.1.253.248,8,448,0,0,8,448,0.304351000,0.0616
215.158.239.79,<->,199.20.28.169,8,448,0,0,8,448,0.303296000,0.0601
215.158.239.50,<->,29.212.198.169,8,4207,0,0,8,4207,0.302871000,1.5579
215.158.239.41,<->,8.191.15.28,8,2275,0,0,8,2275,0.301907000,0.0301
215.158.239.5,<->,131.95.192.249,8,3313,0,0,8,3313,0.300800000,1.1099
245.207.109.18,<->,8.252.222.177,0,0,8,777,8,777,0.299958000,0.5152
215.158.238.119,<->,100.224.166.122,8,6856,0,0,8,6856,0.299449000,1.1158
136.128.35.207,<->,133.178.226.191,0,0,8,2150,8,2150,0.298905000,0.0540
192.65.40.174,<->,8.55.211.213,8,952,0,0,8,952,0.296358000,0.6053
215.158.238.98,<->,29.213.219.69,8,1493,0,0,8,1493,0.292653000,0.2298
204.187.246.61,<->,136.25.188.55,0,0,8,1335,8,1335,0.292168000,1.5299
215.158.61.191,<->,8.176.8.102,0,0,8,10026,8,10026,0.288917000,1.5080
204.130.148.78,<->,0.195.210.46,0,0,8,4014,8,4014,0.288050000,1.6423
131.69.188.185,<->,92.162.253.153,0,0,8,7224,8,7224,0.285868000,0.0008
80.27.157.205,<->,75.92.225.243,8,1036,0,0,8,1036,0.285518000,0.4312
194.244.172.173,<->,8.182.226.78,0,0,8,2562,8,2562,0.282313000,0.6210
143.95.254.8,<->,136.25.188.253,0,0,8,683,8,683,0.277008000,0.9534
136.25.188.174,<->,122.158.49.137,8,3290,0,0,8,3290,0.276121000,1.2059
144.85.170.254,<->,91.69.185.128,8,838,0,0,8,838,0.276099000,0.1657
133.178.226.90,<->,96.155.60.244,8,3838,0,0,8,3838,0.275266000,0.1176
145.11.91.233,<->,50.224.76.235,0,0,8,4780,8,4780,0.275062000,0.2536
133.178.226.49,<->,57.107.26.56,8,1598,0,0,8,1598,0.274017000,0.2419
215.158.239.69,<->,196.107.149.137,8,2141,0,0,8,2141,0.272464000,0.4599
215.158.239.19,<->,111.151.239.10,8,3338,0,0,8,3338,0.272284000,0.7231
100.182.180.3,<->,50.224.88.92,0,0,8,400,8,400,0.271778000,1.5939
215.158.239.78,<->,204.226.23.172,8,1313,0,0,8,1313,0.270871000,0.1697
215.158.239.79,<->,196.0.112.179,8,501,0,0,8,501,0.270316000,0.5302
215.158.238.148,<->,111.150.186.207,8,1573,0,0,8,1573,0.269115000,0.2449
136.25.189.1,<->,96.156.169.169,8,3242,0,0,8,3242,0.268674000,1.4365
136.25.189.88,<->,29.212.198.133,8,3050,0,0,8,3050,0.265526000,0.7322
220.28.108.254,<->,136.25.189.42,0,0,8,909,8,909,0.264538000,0.2162
196.23.12.134,<->,138.98.157.82,0,0,8,1262,8,1262,0.262106000,1.6681
91.231.223.58,<->,89.183.104.115,0,0,8,580,8,580,0.260216000,1.5233
98.23.101.117,<->,92.27.219.35,0,0,8,580,8,580,0.258734000,1.5233
98.23.120.68,<->,89.183.104.115,0,0,8,580,8,580,0.258530000,1.5212
36.116.252.253,<->,8.252.221.230,0,0,8,1513,8,1513,0.257624000,1.5665
247.136.207.173,<->,53.75.73.51,8,6268,0,0,8,6268,0.256725000,0.3978
215.158.61.202,<->,136.25.188.43,0,0,8,10403,8,10403,0.253977000,0.6080
133.178.227.73,<->,133.56.180.25,8,3596,0,0,8,3596,0.253375000,1.6736
215.158.239.96,<->,199.20.31.121,8,806,0,0,8,806,0.252720000,1.4801
138.126.206.116,<->,50.224.49.195,0,0,8,448,8,448,0.250719000,1.6390
215.158.238.75,<->,38.104.11.38,8,2906,0,0,8,2906,0.248761000,1.3925
136.25.188.210,<->,131.144.114.229,8,4047,0,0,8,4047,0.245850000,1.7389
215.158.239.69,<->,56.161.218.52,8,4335,0,0,8,4335,0.245491000,1.1731
143.72.76.181,<->,136.25.188.220,0,0,8,1408,8,1408,0.244965000,0.7034
142.166.44.1,<->,136.25.188.252,0,0,8,1335,8,1335,0.244400000,0.9892
215.158.61.195,<->,8.176.8.205,0,0,8,6649,8,6649,0.243187000,1.6245
253.66.34.47,<->,8.52.171.120,0,0,8,1049,8,1049,0.242892000,0.1782
215.158.239.70,<->,72.23.6.0,8,4351,0,0,8,4351,0.242446000,1.7563
98.23.121.73,<->,89.183.104.115,0,0,8,580,8,580,0.241193000,1.5200
215.158.239.56,<->,194.237.63.165,8,726,0,0,8,726,0.240132000,1.7276
215.158.238.45,<->,29.214.71.108,8,2954,0,0,8,2954,0.237647000,0.3573
215.158.238.66,<->,112.220.206.117,8,5819,0,0,8,5819,0.237308000,0.7389
215.158.239.51,<->,196.92.185.188,8,1786,0,0,8,1786,0.235143000,1.6199
156.150.157.10,<->,139.163.96.127,0,0,8,448,8,448,0.235032000,1.2072
215.158.239.56,<->,199.20.31.224,8,1367,0,0,8,1367,0.234101000,1.3996
215.158.238.45,<->,140.19.166.218,8,524,0,0,8,524,0.233578000,0.2547
122.133.20.241,<->,89.183.104.233,0,0,8,2330,8,2330,0.232347000,1.5873
136.25.189.196,<->,129.222.39.101,8,5652,0,0,8,5652,0.232219000,0.8487
215.158.58.203,<->,6.73.247.85,0,0,8,8485,8,8485,0.232113000,0.0882
199.14.189.217,<->,136.25.188.253,0,0,8,484,8,484,0.231485000,0.7741
215.158.238.95,<->,122.159.245.154,8,2970,0,0,8,2970,0.229671000,1.6350
53.160.64.136,<->,48.53.33.96,0,0,8,6499,8,6499,0.228181000,0.9487
215.158.239.57,<->,207.213.175.95,8,544,0,0,8,544,0.227228000,0.5599
120.83.21.34,<->,92.27.27.164,0,0,8,4057,8,4057,0.226690000,1.7036
142.206.65.185,<->,136.25.188.198,0,0,8,1416,8,1416,0.225306000,1.5881
220.84.223.153,<->,139.163.111.125,0,0,8,400,8,400,0.223792000,1.7395
195.7.72.61,<->,136.25.188.198,0,0,8,448,8,448,0.222617000,0.0554
136.25.189.80,<->,126.219.194.73,8,6234,0,0,8,6234,0.221638000,1.6321
215.158.239.50,<->,199.20.28.202,8,493,0,0,8,493,0.221401000,0.2399
215.158.239.96,<->,199.20.29.69,8,544,0,0,8,544,0.220238000,1.1452
139.241.56.105,<->,99.75.239.150,0,0,8,11647,8,11647,0.219460000,1.6275
149.163.129.230,<->,136.25.189.77,0,0,8,1518,8,1518,0.216075000,0.1286
142.221.254.70,<->,136.25.188.242,0,0,8,2236,8,2236,0.215897000,1.4288
136.25.188.175,<->,8.222.212.21,8,2810,0,0,8,2810,0.214339000,1.7641
145.7.22.231,<->,100.228.42.103,0,0,8,2360,8,2360,0.213357000,1.4967
192.64.202.30,<->,38.84.41.144,8,434,0,0,8,434,0.213320000,1.3750
113.191.253.140,<->,89.183.104.150,0,0,8,1294,8,1294,0.211114000,0.6676
215.158.239.6,<->,8.241.236.218,8,1976,0,0,8,1976,0.209103000,0.2756
215.158.239.93,<->,196.106.35.205,8,1476,0,0,8,1476,0.208692000,1.4808
215.158.239.95,<->,199.20.7.105,8,448,0,0,8,448,0.208615000,0.2592
136.25.189.80,<->,29.214.109.165,8,5508,0,0,8,5508,0.207736000,1.6171
222.244.160.90,<->,8.52.188.77,0,0,8,456,8,456,0.206199000,0.9889
136.25.188.247,<->,100.224.202.178,8,1798,0,0,8,1798,0.204905000,1.2346
129.92.115.211,<->,54.61.210.137,8,9831,0,0,8,9831,0.204880000,1.5257
199.51.212.209,<->,136.25.188.240,0,0,8,400,8,400,0.204308000,1.6297
239.66.218.254,<->,139.163.41.64,0,0,8,836,8,836,0.201569000,1.6895
215.158.238.123,<->,131.1.195.244,8,1763,0,0,8,1763,0.200782000,1.5016
202.33.14.128,<->,136.25.188.54,0,0,8,493,8,493,0.198899000,0.0300
136.25.189.15,<->,29.212.199.45,8,4543,0,0,8,4543,0.198247000,1.2412
133.178.226.90,<->,113.23.104.221,8,3018,0,0,8,3018,0.198244000,0.2640
215.158.239.78,<->,29.213.219.54,8,2698,0,0,8,2698,0.197997000,0.5951
50.224.76.234,<->,30.179.242.210,8,448,0,0,8,448,0.195748000,0.0198
196.245.48.251,<->,136.25.188.225,0,0,8,774,8,774,0.194950000,1.7799
156.135.162.22,<->,8.252.221.204,0,0,8,1212,8,1212,0.192750000,1.5960
98.23.121.66,<->,89.183.104.115,0,0,8,580,8,580,0.192426000,1.5245
136.25.189.32,<->,131.144.115.105,8,2954,0,0,8,2954,0.191033000,1.8025
143.13.34.70,<->,136.25.188.241,0,0,8,412,8,412,0.190984000,0.7698
121.52.54.249,<->,92.27.219.169,0,0,8,11760,8,11760,0.188894000,1.7060
133.178.227.70,<->,126.219.132.168,8,3564,0,0,8,3564,0.188601000,1.3074
215.158.238.107,<->,156.165.37.84,8,472,0,0,8,472,0.188313000,0.2278
215.158.238.83,<->,113.23.104.247,8,3839,0,0,8,3839,0.187876000,1.6471
203.9.191.7,<->,97.198.98.222,0,0,8,400,8,400,0.187285000,1.7102
204.200.49.111,<->,136.25.188.196,0,0,8,1650,8,1650,0.186147000,0.4720
215.158.140.241,<->,112.93.136.122,8,2530,0,0,8,2530,0.185384000,1.2701
149.163.129.242,<->,136.25.189.45,0,0,8,4255,8,4255,0.184511000,1.4484
215.158.238.101,<->,100.224.166.163,8,2247,0,0,8,2247,0.183924000,1.5141
215.158.239.95,<->,207.213.60.85,8,1184,0,0,8,1184,0.183712000,0.4952
249.101.107.180,<->,53.213.93.115,8,5675,0,0,8,5675,0.183410000,0.2038
231.142.170.225,<->,215.158.239.95,0,0,8,800,8,800,0.182888000,1.5411
215.158.238.75,<->,126.219.194.148,8,2986,0,0,8,2986,0.182190000,1.3064
136.25.188.235,<->,100.224.202.143,8,4507,0,0,8,4507,0.181760000,1.2291
54.59.122.154,<->,48.53.175.153,0,0,8,872,8,872,0.181521000,1.7507
215.158.239.85,<->,199.20.30.190,8,460,0,0,8,460,0.180018000,0.0511
196.207.60.156,<->,136.25.188.226,0,0,8,1293,8,1293,0.179634000,1.4791
142.227.162.22,<->,136.25.188.255,0,0,8,448,8,448,0.179205000,0.5186
207.162.188.43,<->,8.182.226.78,0,0,8,1801,8,1801,0.177983000,0.6874
136.25.189.57,<->,96.156.169.235,8,4367,0,0,8,4367,0.177597000,1.4992
136.25.189.13,<->,126.219.49.42,8,1445,0,0,8,1445,0.177381000,0.5222
215.158.239.85,<->,199.52.42.146,8,1327,0,0,8,1327,0.176346000,0.9303
94.194.28.102,<->,8.252.221.197,0,0,8,436,8,436,0.174048000,0.9534
136.98.166.244,<->,8.220.200.124,0,0,8,744,8,744,0.173894000,0.3598
223.115.183.103,<->,8.252.222.49,0,0,8,807,8,807,0.173829000,0.9197
135.254.169.163,<->,50.224.108.129,0,0,8,605,8,605,0.173356000,0.7298
133.252.163.90,<->,80.41.46.191,0,0,8,1034,8,1034,0.172619000,1.8271
215.158.238.133,<->,113.23.104.203,8,2730,0,0,8,2730,0.171109000,0.9859
203.215.188.184,<->,124.42.185.84,8,894,0,0,8,894,0.170507000,0.7077
80.27.157.212,<->,75.94.224.161,8,2340,0,0,8,2340,0.168189000,0.6870
204.60.182.77,<->,136.25.188.241,0,0,8,448,8,448,0.168152000,0.0180
139.33.175.144,<->,111.146.238.44,0,0,8,7949,8,7949,0.167203000,0.1030
215.158.239.68,<->,199.20.31.14,8,509,0,0,8,509,0.166691000,1.3700
215.158.239.87,<->,143.53.71.163,8,400,0,0,8,400,0.166512000,0.0178
199.72.102.100,<->,136.25.188.253,0,0,8,609,8,609,0.165779000,0.4329
136.25.189.1,<->,61.35.70.244,8,4351,0,0,8,4351,0.164496000,1.6224
215.158.239.77,<->,199.32.102.1,8,1362,0,0,8,1362,0.162584000,0.9791
215.158.238.106,<->,57.210.104.75,8,448,0,0,8,448,0.161961000,0.0005
215.158.61.243,<->,8.176.8.182,0,0,8,9676,8,9676,0.161807000,1.5886
92.162.253.36,<->,27.199.161.199,8,4252,0,0,8,4252,0.160885000,0.3937
215.158.238.201,<->,100.216.78.145,8,893,0,0,8,893,0.160797000,0.1434
159.23.227.171,<->,127.159.185.21,8,824,0,0,8,824,0.160599000,0.7897
241.75.192.120,<->,50.224.88.109,0,0,8,401,8,401,0.160400000,1.6403
142.191.1.22,<->,136.25.188.46,0,0,8,1285,8,1285,0.160120000,0.6058
142.241.138.177,<->,136.25.188.175,0,0,8,400,8,400,0.157980000,0.0175
136.25.189.14,<->,29.211.228.251,8,4127,0,0,8,4127,0.156678000,1.4179
144.232.206.91,<->,89.183.104.115,0,0,8,580,8,580,0.156611000,1.5190
215.158.239.97,<->,204.0.245.159,8,552,0,0,8,552,0.156261000,0.4187
118.202.255.160,<->,80.41.15.57,0,0,8,902,8,902,0.155734000,1.5684
98.236.235.68,<->,91.69.185.161,8,448,0,0,8,448,0.155604000,1.6499
215.158.238.251,<->,148.190.126.56,8,2422,0,0,8,2422,0.155526000,1.6118
136.25.189.32,<->,113.23.66.228,8,3967,0,0,8,3967,0.154600000,1.7449
139.160.226.173,<->,136.25.189.17,0,0,8,3338,8,3338,0.154512000,1.6365
143.45.0.148,<->,133.178.226.31,0,0,8,3130,8,3130,0.154146000,0.5955
129.16.253.232,<->,89.216.125.35,0,0,8,5160,8,5160,0.154043000,0.1445
204.56.13.140,<->,136.25.188.243,0,0,8,400,8,400,0.152014000,0.1919
104.158.138.181,<->,89.183.104.172,0,0,8,2320,8,2320,0.151781000,0.5711
224.93.235.38,<->,80.27.157.12,0,0,8,4285,8,4285,0.148089000,1.7450
8.220.176.253,<->,6.74.212.63,8,712,0,0,8,712,0.147204000,0.3361
145.180.135.157,<->,136.25.188.36,0,0,8,1887,8,1887,0.146974000,1.7062
215.158.140.76,<->,131.144.116.231,8,2632,0,0,8,2632,0.146797000,1.3341
195.55.67.217,<->,136.25.188.46,0,0,8,1216,8,1216,0.145905000,1.4613
197.113.99.126,<->,136.25.188.177,0,0,8,485,8,485,0.145548000,1.5694
215.158.238.93,<->,122.158.51.85,8,2762,0,0,8,2762,0.145295000,1.1669
139.163.20.253,<->,107.122.179.146,8,448,0,0,8,448,0.144818000,1.8423
224.93.235.37,<->,80.27.157.204,0,0,8,2974,8,2974,0.143697000,1.4447
112.30.234.122,<->,92.168.217.244,0,0,8,448,8,448,0.143587000,0.4547
202.178.8.238,<->,144.71.46.171,0,0,8,400,8,400,0.142991000,0.0044
246.253.145.192,<->,69.132.3.185,8,6251,0,0,8,6251,0.142034000,1.3326
194.218.10.143,<->,8.182.248.147,0,0,8,762,8,762,0.141827000,0.5195
142.208.98.90,<->,136.25.188.198,0,0,8,806,8,806,0.137825000,1.6767
204.185.121.63,<->,136.25.188.52,0,0,8,532,8,532,0.135283000,0.3897
248.239.188.96,<->,243.49.81.33,8,9551,0,0,8,9551,0.135163000,0.0297
246.253.212.143,<->,207.177.131.98,8,2344,0,0,8,2344,0.134282000,0.7737
143.227.65.233,<->,133.178.227.27,0,0,8,448,8,448,0.133569000,0.0015
136.25.189.80,<->,29.212.198.200,8,3919,0,0,8,3919,0.133002000,1.2987
92.26.154.123,<->,14.94.93.84,0,0,8,2408,8,2408,0.129475000,0.4672
144.232.206.55,<->,89.183.104.115,0,0,8,580,8,580,0.128872000,1.5214
95.245.210.54,<->,8.252.221.196,0,0,8,444,8,444,0.128864000,1.6386
143.22.109.149,<->,8.182.226.78,0,0,8,1012,8,1012,0.128484000,0.7970
215.158.61.195,<->,8.176.8.226,0,0,8,7325,8,7325,0.128138000,1.7327
215.158.238.64,<->,27.178.41.18,8,1573,0,0,8,1573,0.126315000,0.2226
192.67.175.129,<->,115.250.95.90,8,11012,0,0,8,11012,0.126234000,0.0043
215.158.239.96,<->,199.20.29.28,8,1185,0,0,8,1185,0.125341000,0.9200
215.158.239.87,<->,29.213.219.92,8,4507,0,0,8,4507,0.125238000,1.3431
142.184.174.1,<->,50.223.3.228,0,0,8,448,8,448,0.124974000,0.8897
215.158.239.50,<->,195.126.199.229,8,833,0,0,8,833,0.124085000,1.8252
215.158.238.113,<->,76.100.108.235,8,1797,0,0,8,1797,0.123061000,0.3455
111.181.100.149,<->,56.114.235.120,8,4752,0,0,8,4752,0.122285000,0.2007
98.87.117.122,<->,50.224.49.195,0,0,8,472,8,472,0.121786000,1.6799
136.25.189.57,<->,29.211.165.22,8,2746,0,0,8,2746,0.120479000,1.1717
145.10.79.84,<->,139.163.111.125,0,0,8,448,8,448,0.119874000,1.7183
133.178.227.16,<->,8.53.216.133,8,3855,0,0,8,3855,0.119314000,1.3642
136.25.188.196,<->,30.73.99.38,8,2005,0,0,8,2005,0.118758000,1.5714
98.23.101.117,<->,92.27.27.142,0,0,8,580,8,580,0.118529000,1.5177
142.241.242.212,<->,136.25.188.177,0,0,8,879,8,879,0.117270000,0.8308
215.158.61.193,<->,8.176.8.210,0,0,8,10154,8,10154,0.116942000,0.2606
89.183.104.170,<->,18.202.108.16,8,434,0,0,8,434,0.116772000,1.8168
99.187.125.121,<->,8.20.87.5,0,0,8,1489,8,1489,0.116028000,0.3791
143.52.58.245,<->,136.25.188.163,0,0,8,400,8,400,0.115920000,0.1557
141.61.66.157,<->,80.27.155.70,0,0,8,1598,8,1598,0.115891000,1.1874
94.18.162.201,<->,8.252.221.222,0,0,8,536,8,536,0.114176000,1.7000
133.178.226.14,<->,99.192.168.150,8,1751,0,0,8,1751,0.113658000,0.1325
111.20.172.70,<->,33.233.141.19,0,0,8,1112,8,1112,0.111631000,1.0003
215.158.239.49,<->,199.20.30.50,8,568,0,0,8,568,0.111170000,1.8200
215.158.239.85,<->,199.20.5.196,8,400,0,0,8,400,0.111127000,0.5493
133.178.226.30,<->,29.211.122.180,8,2650,0,0,8,2650,0.110699000,0.2649
133.178.227.27,<->,113.23.101.149,8,2380,0,0,8,2380,0.110202000,1.0964
67.174.85.223,<->,8.252.222.135,0,0,8,1389,8,1389,0.108875000,1.0732
215.158.239.50,<->,204.2.177.117,8,1417,0,0,8,1417,0.108655000,0.4200
204.65.221.83,<->,50.223.3.228,0,0,8,448,8,448,0.108330000,1.7499
220.55.78.167,<->,119.53.54.165,8,734,0,0,8,734,0.108169000,1.2820
139.241.56.105,<->,99.72.168.169,0,0,8,11647,8,11647,0.107825000,1.7463
133.178.226.29,<->,69.132.194.22,8,1525,0,0,8,1525,0.107435000,0.2372
133.178.226.38,<->,104.3.161.84,8,448,0,0,8,448,0.107213000,0.0011
192.226.161.53,<->,136.25.188.55,0,0,8,1605,8,1605,0.107054000,1.8849
111.20.172.70,<->,33.233.141.24,0,0,8,952,8,952,0.106753000,1.0041
111.20.172.70,<->,101.224.89.154,0,0,8,709,8,709,0.106704000,0.9927
109.81.202.72,<->,32.167.157.157,8,576,0,0,8,576,0.106486000,1.7255
215.158.61.183,<->,136.25.189.196,0,0,8,7690,8,7690,0.104926000,1.3919
215.158.140.204,<->,6.73.247.7,8,4317,0,0,8,4317,0.103598000,0.7000
246.108.92.97,<->,139.193.141.139,0,0,8,1209,8,1209,0.102878000,0.1565
207.59.47.50,<->,136.25.188.55,0,0,8,448,8,448,0.102622000,0.0569
195.70.106.235,<->,92.27.219.171,0,0,8,844,8,844,0.102563000,0.8865
249.101.116.54,<->,206.243.231.162,8,6271,0,0,8,6271,0.102436000,0.0859
111.20.172.70,<->,101.224.89.161,0,0,8,911,8,911,0.102257000,1.0131
111.20.172.70,<->,101.224.89.145,0,0,8,890,8,890,0.102097000,1.0091
111.20.172.70,<->,33.233.141.88,0,0,8,1281,8,1281,0.101943000,1.0033
98.23.101.117,<->,92.27.219.165,0,0,8,580,8,580,0.101084000,1.5174
136.25.188.211,<->,29.214.108.168,8,5919,0,0,8,5919,0.100405000,0.9513
144.232.206.54,<->,89.183.104.115,0,0,8,580,8,580,0.099994000,1.5188
129.243.217.199,<->,80.27.157.224,0,0,8,782,8,782,0.099042000,0.8521
95.245.97.64,<->,8.252.221.237,0,0,8,436,8,436,0.097602000,1.0687
215.158.239.49,<->,8.50.171.159,8,4367,0,0,8,4367,0.096900000,1.4536
246.253.198.51,<->,198.168.8.29,8,882,0,0,8,882,0.095120000,0.7913
220.50.242.203,<->,215.158.239.104,0,0,8,530,8,530,0.095031000,0.0248
97.190.201.137,<->,8.37.220.169,8,6994,0,0,8,6994,0.094966000,0.1092
195.69.137.250,<->,136.25.188.53,0,0,8,1253,8,1253,0.093932000,0.3887
92.27.219.217,<->,6.248.194.160,8,8220,0,0,8,8220,0.093467000,1.8423
36.123.55.203,<->,8.20.87.33,0,0,8,1138,8,1138,0.093401000,0.5936
195.59.178.76,<->,50.223.3.228,0,0,8,412,8,412,0.091884000,1.8943
207.172.108.124,<->,136.25.188.210,0,0,8,806,8,806,0.091814000,1.6597
54.37.67.188,<->,48.52.130.221,0,0,8,448,8,448,0.090155000,1.7527
8.182.251.218,<->,6.26.250.106,8,2644,0,0,8,2644,0.089877000,1.4351
220.28.85.14,<->,215.158.238.252,0,0,8,9738,8,9738,0.089711000,0.0451
93.181.135.106,<->,92.27.27.171,0,0,8,400,8,400,0.089306000,1.9067
231.142.127.224,<->,215.158.239.85,0,0,8,958,8,958,0.088940000,0.2305
139.241.56.117,<->,102.51.218.25,0,0,8,10249,8,10249,0.088925000,1.6688
139.241.56.117,<->,100.93.223.40,0,0,8,10249,8,10249,0.088803000,1.6689
146.224.108.82,<->,8.252.221.222,0,0,8,536,8,536,0.087461000,1.4238
204.187.194.236,<->,136.25.188.198,0,0,8,448,8,448,0.087414000,0.0200
215.158.238.105,<->,131.144.114.216,8,4191,0,0,8,4191,0.087349000,1.6899
215.158.239.17,<->,8.241.236.231,8,448,0,0,8,448,0.085798000,0.0002
204.95.174.57,<->,50.223.3.228,0,0,8,400,8,400,0.084046000,1.8544
149.163.129.230,<->,136.25.189.82,0,0,8,4271,8,4271,0.083944000,0.7610
215.158.239.93,<->,142.166.44.108,8,839,0,0,8,839,0.083538000,1.4594
215.158.238.250,<->,29.214.109.128,8,2519,0,0,8,2519,0.082691000,1.0269
215.158.239.92,<->,192.224.21.22,8,5268,0,0,8,5268,0.080927000,1.8897
111.20.172.70,<->,101.224.89.243,0,0,8,918,8,918,0.080919000,1.0100
215.158.238.72,<->,113.23.104.203,8,1717,0,0,8,1717,0.080667000,1.3701
220.55.103.28,<->,127.170.16.85,8,435,0,0,8,435,0.079976000,1.4674
111.234.192.242,<->,50.224.88.107,0,0,8,448,8,448,0.079407000,1.5151
215.158.238.92,<->,8.190.216.201,8,5620,0,0,8,5620,0.079225000,1.5934
215.158.238.64,<->,8.179.43.53,8,1637,0,0,8,1637,0.079074000,1.7433
139.163.20.252,<->,128.23.88.100,8,400,0,0,8,400,0.077163000,1.8217
210.209.251.211,<->,111.147.248.65,0,0,8,6027,8,6027,0.077117000,0.2201
98.23.101.117,<->,89.183.104.169,0,0,8,580,8,580,0.076178000,1.5210
111.20.172.70,<->,111.20.168.2,0,0,8,931,8,931,0.075077000,0.9956
215.158.239.50,<->,199.20.31.12,8,1308,0,0,8,1308,0.074959000,0.4002
136.25.189.34,<->,119.196.23.3,8,2954,0,0,8,2954,0.074913000,1.4157
192.67.163.192,<->,145.95.195.20,8,1143,0,0,8,1143,0.074314000,1.7145
136.25.189.59,<->,96.156.169.169,8,4555,0,0,8,4555,0.074306000,1.8643
246.253.253.213,<->,199.36.180.76,8,400,0,0,8,400,0.074230000,1.7722
136.25.189.28,<->,118.20.100.187,8,2890,0,0,8,2890,0.074191000,1.9016
199.70.95.222,<->,136.25.188.45,0,0,8,2130,8,2130,0.073204000,0.5015
220.20.200.114,<->,193.86.109.21,8,9158,0,0,8,9158,0.071503000,0.0001
195.13.225.220,<->,136.25.188.209,0,0,8,1332,8,1332,0.071145000,0.2877
111.20.172.70,<->,101.224.89.133,0,0,8,1056,8,1056,0.071131000,1.0033
136.25.188.236,<->,112.235.95.73,8,2954,0,0,8,2954,0.070874000,1.3319
199.15.206.213,<->,136.25.188.253,0,0,8,448,8,448,0.070326000,0.1572
195.7.73.125,<->,136.25.188.175,0,0,8,1397,8,1397,0.070274000,0.3032
136.181.39.230,<->,0.195.216.244,8,5382,0,0,8,5382,0.067632000,0.6639
210.229.230.20,<->,42.124.194.93,8,512,0,0,8,512,0.067085000,0.7860
198.206.117.169,<->,100.95.71.86,0,0,8,4337,8,4337,0.065483000,0.5718
136.25.188.243,<->,131.144.114.229,8,3935,0,0,8,3935,0.063757000,1.7272
215.158.140.92,<->,61.35.70.32,8,448,0,0,8,448,0.063682000,0.0017
231.142.45.225,<->,136.25.188.238,0,0,8,406,8,406,0.063286000,0.8893
136.25.189.83,<->,120.154.131.22,8,4587,0,0,8,4587,0.063252000,0.9450
215.158.239.100,<->,53.231.162.97,8,5351,0,0,8,5351,0.063155000,0.0877
136.25.189.57,<->,126.219.191.5,8,3935,0,0,8,3935,0.063051000,0.7340
98.67.143.20,<->,54.58.99.60,8,4202,0,0,8,4202,0.062846000,1.1026
215.158.239.79,<->,199.20.4.233,8,448,0,0,8,448,0.062714000,1.6810
204.185.84.230,<->,136.25.188.252,0,0,8,1968,8,1968,0.061745000,1.4299
123.228.59.190,<->,80.42.159.46,0,0,8,442,8,442,0.061483000,1.4096
111.11.29.157,<->,8.182.139.197,0,0,8,5095,8,5095,0.060358000,0.2816
200.174.203.233,<->,53.201.72.62,8,5775,0,0,8,5775,0.059482000,1.5734
93.181.154.49,<->,89.183.104.191,0,0,8,404,8,404,0.059163000,0.7744
215.158.239.70,<->,199.20.5.96,8,448,0,0,8,448,0.058961000,1.8200
136.25.189.82,<->,119.196.23.24,8,2970,0,0,8,2970,0.058927000,1.4314
223.176.234.185,<->,139.163.96.94,0,0,8,400,8,400,0.058479000,1.8583
140.145.218.202,<->,133.178.226.29,0,0,8,1557,8,1557,0.057995000,0.2391
220.28.108.254,<->,136.25.189.7,0,0,8,10940,8,10940,0.057873000,0.1427
92.27.219.142,<->,42.204.158.155,8,9820,0,0,8,9820,0.057683000,1.4833
159.23.224.231,<->,108.130.220.37,8,407,0,0,8,407,0.057377000,1.7443
215.158.239.95,<->,199.122.98.84,8,448,0,0,8,448,0.056901000,0.1715
196.242.4.14,<->,136.25.188.177,0,0,8,1076,8,1076,0.056354000,1.4400
199.121.2.158,<->,136.25.188.242,0,0,8,448,8,448,0.055943000,0.9253
215.158.238.83,<->,119.168.0.132,8,2698,0,0,8,2698,0.055753000,0.8707
139.241.56.105,<->,100.94.110.169,0,0,8,10248,8,10248,0.053508000,1.6360
143.206.95.244,<->,0.195.210.33,0,0,8,529,8,529,0.053477000,0.1788
197.107.12.45,<->,136.25.188.173,0,0,8,1470,8,1470,0.052256000,0.4976
215.158.239.56,<->,199.52.227.183,8,1077,0,0,8,1077,0.051245000,0.5006
94.194.69.2,<->,8.252.221.205,0,0,8,824,8,824,0.050510000,1.8485
139.163.96.94,<->,66.80.139.78,8,400,0,0,8,400,0.050412000,1.5023
136.25.189.1,<->,29.212.199.244,8,5568,0,0,8,5568,0.049904000,1.8989
98.23.101.117,<->,89.183.104.160,0,0,8,580,8,580,0.049805000,1.5235
195.5.1.74,<->,136.25.188.46,0,0,8,1093,8,1093,0.049090000,0.4716
133.178.226.19,<->,57.160.181.244,8,2986,0,0,8,2986,0.048153000,1.0638
215.158.239.50,<->,199.20.29.122,8,1291,0,0,8,1291,0.047873000,0.7200
139.163.114.105,<->,0.62.55.153,8,448,0,0,8,448,0.047706000,1.7578
215.158.61.189,<->,8.176.8.192,0,0,8,5007,8,5007,0.046609000,0.7674
17.143.206.194,<->,8.220.179.115,0,0,8,800,8,800,0.046215000,0.2394
97.198.98.50,<->,8.20.34.210,8,448,0,0,8,448,0.045438000,1.7600
215.158.239.76,<->,204.0.137.89,8,496,0,0,8,496,0.045203000,1.3403
215.158.239.56,<->,207.213.193.72,8,1387,0,0,8,1387,0.044732000,0.2080
59.141.77.202,<->,8.252.221.221,0,0,8,448,8,448,0.044494000,1.0744
239.66.58.12,<->,138.98.204.211,0,0,8,6734,8,6734,0.044261000,0.3206
215.158.140.231,<->,29.211.6.151,8,448,0,0,8,448,0.043516000,0.0020
136.139.59.106,<->,136.25.188.253,0,0,8,1665,8,1665,0.042972000,1.1747
215.158.239.79,<->,207.167.192.102,8,766,0,0,8,766,0.042789000,1.6100
215.158.239.70,<->,196.107.137.250,8,1134,0,0,8,1134,0.042584000,1.9390
54.36.191.119,<->,48.54.254.104,0,0,8,411,8,411,0.041918000,1.7590
133.178.226.61,<->,91.57.173.52,8,2870,0,0,8,2870,0.041769000,0.4611
215.158.238.133,<->,57.210.107.11,8,1761,0,0,8,1761,0.041435000,0.8355
136.25.189.29,<->,112.220.198.100,8,2826,0,0,8,2826,0.040874000,1.2823
204.186.184.137,<->,136.25.188.197,0,0,8,1908,8,1908,0.039667000,0.7984
215.158.238.80,<->,192.227.190.245,8,1781,0,0,8,1781,0.039167000,1.4424
136.25.189.58,<->,96.156.169.162,8,5183,0,0,8,5183,0.038478000,1.8380
139.241.56.39,<->,133.178.227.252,0,0,8,448,8,448,0.038430000,0.0427
215.158.239.93,<->,29.209.59.214,8,3999,0,0,8,3999,0.038047000,1.9253
143.54.161.12,<->,8.20.87.153,0,0,8,959,8,959,0.036338000,0.8578
132.168.198.135,<->,53.84.112.203,8,448,0,0,8,448,0.034934000,1.9551
215.158.239.96,<->,195.6.45.207,8,724,0,0,8,724,0.034884000,0.9899
144.85.170.254,<->,97.22.63.173,8,1107,0,0,8,1107,0.034645000,0.2481
101.123.185.203,<->,8.55.208.173,8,7892,0,0,8,7892,0.034257000,0.1461
207.173.145.117,<->,136.25.188.174,0,0,8,448,8,448,0.034066000,0.2005
215.158.238.241,<->,18.202.90.165,8,2576,0,0,8,2576,0.033095000,1.7400
139.241.56.102,<->,100.182.138.165,0,0,8,10249,8,10249,0.032581000,1.6805
142.206.47.119,<->,136.25.188.163,0,0,8,1400,8,1400,0.032469000,1.5396
204.187.169.249,<->,136.25.188.199,0,0,8,448,8,448,0.032348000,0.2400
215.158.238.72,<->,122.159.245.165,8,4143,0,0,8,4143,0.031986000,1.3069
215.158.238.95,<->,105.101.188.41,8,448,0,0,8,448,0.031488000,1.8576
139.241.56.102,<->,109.1.26.47,0,0,8,11647,8,11647,0.031175000,1.9501
136.25.189.59,<->,68.124.221.157,8,4591,0,0,8,4591,0.031159000,1.6994
215.158.239.97,<->,194.234.131.165,8,1466,0,0,8,1466,0.031012000,0.3040
136.25.189.81,<->,96.156.169.203,8,3370,0,0,8,3370,0.030882000,1.2136
91.100.191.45,<->,80.38.33.27,0,0,8,400,8,400,0.030842000,1.6773
215.158.238.132,<->,38.104.11.43,8,2874,0,0,8,2874,0.030720000,1.5027
215.158.61.182,<->,8.176.8.208,0,0,8,4687,8,4687,0.030701000,1.4009
215.158.61.182,<->,8.176.8.178,0,0,8,3992,8,3992,0.030409000,1.4117
136.25.188.255,<->,57.210.107.1,8,2842,0,0,8,2842,0.030029000,1.5840
128.156.218.12,<->,50.224.76.235,0,0,8,1535,8,1535,0.029929000,0.4184
139.241.56.117,<->,6.74.85.210,0,0,8,11647,8,11647,0.029429000,1.9501
205.91.181.210,<->,92.27.219.247,0,0,8,411,8,411,0.029259000,1.6724
50.223.3.229,<->,27.199.226.18,8,650,0,0,8,650,0.029068000,1.4504
195.65.68.177,<->,50.223.3.228,0,0,8,430,8,430,0.027381000,1.6722
136.25.189.31,<->,120.154.131.7,8,1685,0,0,8,1685,0.027207000,0.8312
136.25.189.12,<->,29.212.199.220,8,4207,0,0,8,4207,0.026941000,1.8230
58.60.3.50,<->,8.252.221.230,0,0,8,814,8,814,0.026833000,1.1183
223.5.149.102,<->,139.163.96.94,0,0,8,424,8,424,0.026735000,1.9558
136.25.189.57,<->,113.92.151.23,8,3066,0,0,8,3066,0.026566000,1.2276
215.158.238.74,<->,106.188.251.194,8,4077,0,0,8,4077,0.026552000,1.9731
215.158.238.45,<->,29.211.228.177,8,544,0,0,8,544,0.026374000,0.0028
196.114.29.145,<->,8.252.222.163,0,0,8,442,8,442,0.026163000,1.7708
230.72.92.160,<->,8.238.225.188,0,0,8,8000,8,8000,0.025560000,1.3849
210.158.44.13,<->,127.206.193.79,8,9303,0,0,8,9303,0.025448000,0.2938
220.28.109.52,<->,136.25.188.56,0,0,8,6841,8,6841,0.025339000,1.7017
215.158.30.187,<->,8.252.222.54,0,0,8,8426,8,8426,0.025157000,0.2362
215.158.140.60,<->,61.35.124.249,8,1729,0,0,8,1729,0.024136000,1.9037
195.12.156.38,<->,136.25.188.225,0,0,8,1564,8,1564,0.023911000,0.9461
204.184.137.104,<->,136.25.188.177,0,0,8,448,8,448,0.023745000,1.2796
215.158.239.57,<->,194.232.157.23,8,448,0,0,8,448,0.022922000,0.7204
153.111.155.23,<->,8.252.221.198,0,0,8,820,8,820,0.022631000,1.9288
247.136.217.189,<->,38.69.117.31,8,1293,0,0,8,1293,0.022554000,1.6044
136.25.189.17,<->,96.156.169.220,8,4303,0,0,8,4303,0.021567000,0.7126
215.158.239.70,<->,196.88.157.175,8,1362,0,0,8,1362,0.020785000,1.0846
215.158.239.100,<->,91.40.201.100,8,1450,0,0,8,1450,0.020573000,1.4070
139.163.0.100,<->,103.144.81.187,8,448,0,0,8,448,0.019978000,1.5482
215.158.239.97,<->,196.94.109.52,8,448,0,0,8,448,0.019594000,0.5208
136.25.189.78,<->,106.188.253.229,8,4852,0,0,8,4852,0.019474000,1.6563
136.25.189.29,<->,6.15.207.213,8,2986,0,0,8,2986,0.019414000,1.2888
98.87.146.212,<->,50.224.49.211,0,0,8,448,8,448,0.017765000,1.6399
215.158.23.26,<->,192.229.40.29,8,6567,0,0,8,6567,0.017629000,0.0243
215.158.238.64,<->,131.144.114.218,8,2918,0,0,8,2918,0.017503000,1.7606
136.25.188.45,<->,122.159.245.165,8,3999,0,0,8,3999,0.017491000,1.7801
215.158.239.97,<->,207.115.186.252,8,1185,0,0,8,1185,0.016967000,1.3391
215.158.239.99,<->,204.61.81.143,8,1390,0,0,8,1390,0.016268000,0.2821
106.23.130.104,<->,8.52.243.47,0,0,8,3072,8,3072,0.016167000,0.2476
197.125.126.181,<->,136.25.188.224,0,0,8,4095,8,4095,0.016003000,1.8082
195.4.211.93,<->,136.25.188.254,0,0,8,406,8,406,0.014867000,0.2604
215.158.239.86,<->,195.42.52.167,8,1953,0,0,8,1953,0.014387000,0.7352
17.228.210.76,<->,8.220.190.86,0,0,8,1868,8,1868,0.014114000,0.5185
98.87.179.235,<->,50.224.103.227,0,0,8,448,8,448,0.013891000,1.8576
98.87.178.109,<->,50.224.103.227,0,0,8,448,8,448,0.013705000,1.8570
69.128.140.233,<->,54.38.66.136,8,896,0,0,8,896,0.013078000,1.7513
144.87.238.55,<->,144.87.235.175,0,0,8,1193,8,1193,0.012317000,0.1703
215.158.239.93,<->,8.222.98.137,8,4527,0,0,8,4527,0.011991000,1.0566
92.27.59.73,<->,89.183.104.115,0,0,8,580,8,580,0.011387000,1.5225
247.136.145.168,<->,112.236.172.67,8,424,0,0,8,424,0.011348000,1.9498
109.91.119.23,<->,14.73.201.149,0,0,8,400,8,400,0.011292000,0.0056
102.88.200.8,<->,50.224.76.235,0,0,8,448,8,448,0.011215000,0.0208
205.106.31.29,<->,192.67.170.200,0,0,8,411,8,411,0.010564000,1.8747
195.7.72.61,<->,136.25.188.45,0,0,8,1281,8,1281,0.010322000,0.6050
89.183.104.130,<->,75.94.225.251,8,10344,0,0,8,10344,0.008654000,1.9745
133.178.227.16,<->,133.56.180.15,8,5413,0,0,8,5413,0.008573000,1.9833
203.145.18.130,<->,8.20.87.237,0,0,8,952,8,952,0.008320000,0.0665
215.158.239.70,<->,199.20.31.1,8,534,0,0,8,534,0.008016000,0.2600
136.25.189.81,<->,96.150.228.235,8,5284,0,0,8,5284,0.007171000,1.7205
215.158.140.195,<->,8.222.7.154,8,4341,0,0,8,4341,0.006470000,1.7232
215.158.239.40,<->,8.241.236.203,8,448,0,0,8,448,0.005992000,0.0005
215.158.238.176,<->,8.219.185.40,8,3855,0,0,8,3855,0.005964000,1.2599
139.163.16.218,<->,131.69.246.79,8,448,0,0,8,448,0.005418000,0.1352
196.29.247.64,<->,50.224.97.203,0,0,8,400,8,400,0.005014000,0.0987
136.25.188.163,<->,38.104.11.41,8,3202,0,0,8,3202,0.005007000,1.5438
136.25.189.57,<->,118.20.100.90,8,3366,0,0,8,3366,0.004750000,1.9678
204.200.39.239,<->,136.25.188.254,0,0,8,400,8,400,0.003225000,0.1344
143.193.10.182,<->,8.183.25.25,0,0,8,689,8,689,0.003110000,0.5451
144.85.170.254,<->,91.69.185.180,8,1149,0,0,8,1149,0.003007000,1.3168
215.158.238.133,<->,29.212.43.247,8,2714,0,0,8,2714,0.002431000,1.9358
215.158.239.68,<->,199.73.48.129,8,1935,0,0,8,1935,0.001779000,1.2693
215.158.140.75,<->,29.214.109.175,8,4429,0,0,8,4429,0.001598000,1.8523
215.158.239.56,<->,199.20.28.175,8,950,0,0,8,950,0.001376000,1.8795
111.20.172.70,<->,33.233.141.53,0,0,8,1036,8,1036,0.001231000,1.9980
204.21.243.229,<->,136.25.188.227,0,0,8,448,8,448,0.001128000,0.1628
92.27.27.154,<->,33.57.78.108,8,410,0,0,8,410,0.000241000,1.6836
215.158.239.40,<->,139.161.104.245,8,1519,0,0,8,1519,0.000102000,0.3467
136.25.188.32,<->,56.97.186.61,7,392,0,0,7,392,1.996208000,0.0002
215.158.140.195,<->,8.222.7.170,7,4030,0,0,7,4030,1.966883000,0.0304
195.6.220.152,<->,136.25.188.243,0,0,7,392,7,392,1.948267000,0.0145
136.25.189.193,<->,53.231.140.114,7,4914,0,0,7,4914,1.917131000,0.0590
246.254.97.109,<->,56.114.235.120,7,4760,0,0,7,4760,1.893862000,0.0917
215.158.239.69,<->,199.20.4.195,7,492,0,0,7,492,1.890849000,0.0606
215.158.238.6,<->,192.229.42.133,7,2473,0,0,7,2473,1.884932000,0.0998
50.224.49.195,<->,6.210.144.102,7,512,0,0,7,512,1.852449000,0.1199
132.187.73.3,<->,8.182.139.197,0,0,7,2354,7,2354,1.838038000,0.1557
136.18.9.161,<->,8.182.136.210,0,0,7,766,7,766,1.831993000,0.1631
129.236.114.39,<->,101.224.89.253,0,0,7,9029,7,9029,1.826748000,0.0001
129.236.114.39,<->,101.224.89.153,0,0,7,8791,7,8791,1.822342000,0.0001
215.158.61.191,<->,8.176.8.176,0,0,7,6173,7,6173,1.818756000,0.1115
139.241.64.237,<->,136.25.188.195,0,0,7,7857,7,7857,1.804720000,0.0710
196.88.147.90,<->,136.25.188.241,0,0,7,350,7,350,1.794988000,0.1483
133.178.227.24,<->,33.209.219.58,7,1773,0,0,7,1773,1.791729000,0.1319
215.158.238.105,<->,148.26.113.8,7,1533,0,0,7,1533,1.790972000,0.1770
139.33.175.144,<->,8.228.215.157,0,0,7,5642,7,5642,1.784511000,0.1011
139.241.115.221,<->,29.211.214.254,0,0,7,582,7,582,1.780564000,0.0321
133.8.10.153,<->,33.233.141.231,0,0,7,7729,7,7729,1.778198000,0.0248
215.158.238.196,<->,29.211.6.169,7,1442,0,0,7,1442,1.776780000,0.1203
143.95.233.162,<->,136.25.188.225,0,0,7,1677,7,1677,1.746802000,0.2388
97.148.162.246,<->,50.224.76.235,0,0,7,4720,7,4720,1.741839000,0.1668
192.64.245.110,<->,100.124.212.156,7,4754,0,0,7,4754,1.740051000,0.1755
96.115.136.205,<->,8.52.222.23,0,0,7,668,7,668,1.721918000,0.2708
136.25.189.196,<->,111.42.25.254,7,904,0,0,7,904,1.714714000,0.1242
221.102.143.189,<->,109.1.3.195,0,0,7,6820,7,6820,1.713712000,0.2206
132.49.149.137,<->,53.231.66.33,7,4875,0,0,7,4875,1.710752000,0.1488
102.83.194.212,<->,8.55.224.156,7,3406,0,0,7,3406,1.706688000,0.1909
215.158.239.70,<->,195.54.56.187,7,392,0,0,7,392,1.697693000,0.0288
88.11.96.99,<->,50.224.76.234,0,0,7,3761,7,3761,1.693293000,0.1771
215.158.234.168,<->,133.178.227.255,0,0,7,2882,7,2882,1.693019000,0.0699
215.158.239.76,<->,196.89.113.76,7,641,0,0,7,641,1.689991000,0.2151
215.158.238.70,<->,0.195.237.14,7,9068,0,0,7,9068,1.689329000,0.0346
246.254.97.229,<->,93.181.148.199,7,6273,0,0,7,6273,1.689315000,0.3084
221.102.143.189,<->,192.65.66.76,0,0,7,6820,7,6820,1.689272000,0.1538
109.1.43.8,<->,8.55.195.24,7,5460,0,0,7,5460,1.686955000,0.1696
136.25.189.28,<->,123.166.46.212,7,1613,0,0,7,1613,1.686460000,0.2072
215.158.239.95,<->,194.251.120.44,7,2734,0,0,7,2734,1.677754000,0.3203
136.25.188.238,<->,100.174.69.226,7,1645,0,0,7,1645,1.673222000,0.2990
142.221.120.6,<->,136.25.188.225,0,0,7,1283,7,1283,1.669156000,0.3053
222.65.16.220,<->,132.216.20.184,7,4934,0,0,7,4934,1.667444000,0.1213
195.15.237.131,<->,136.25.188.55,0,0,7,628,7,628,1.660427000,0.3319
89.204.33.10,<->,8.182.244.19,0,0,7,930,7,930,1.658373000,0.0754
133.178.227.1,<->,113.23.101.149,7,1425,0,0,7,1425,1.656718000,0.3018
215.158.140.76,<->,29.214.109.138,7,1419,0,0,7,1419,1.644720000,0.2788
139.163.26.238,<->,121.244.93.67,7,527,0,0,7,527,1.644158000,0.2658
215.158.239.58,<->,196.94.72.151,7,2149,0,0,7,2149,1.643776000,0.3399
50.224.76.235,<->,6.74.204.201,7,3717,0,0,7,3717,1.638089000,0.0880
109.29.240.65,<->,8.20.87.155,0,0,7,1076,7,1076,1.636718000,0.3543
221.196.123.141,<->,138.98.230.215,0,0,7,843,7,843,1.627731000,0.2997
133.178.226.29,<->,129.175.139.60,7,1557,0,0,7,1557,1.624508000,0.0528
144.108.64.184,<->,136.129.100.124,0,0,7,633,7,633,1.623810000,0.3460
192.67.130.147,<->,8.45.162.111,7,3760,0,0,7,3760,1.620092000,0.1646
138.121.99.24,<->,8.220.186.239,0,0,7,576,7,576,1.605725000,0.1588
56.114.235.120,<->,35.56.101.154,0,0,7,3556,7,3556,1.603842000,0.2037
121.77.99.114,<->,80.42.131.27,0,0,7,716,7,716,1.596521000,0.3508
143.68.134.50,<->,136.25.188.55,0,0,7,626,7,626,1.587983000,0.3910
143.135.48.53,<->,136.25.188.252,0,0,7,946,7,946,1.586266000,0.4005
97.43.55.64,<->,50.223.3.230,0,0,7,725,7,725,1.576795000,0.3459
210.44.4.36,<->,8.220.204.234,0,0,7,796,7,796,1.575258000,0.2928
215.158.238.223,<->,8.50.171.191,7,1725,0,0,7,1725,1.569523000,0.1092
139.193.141.143,<->,18.51.113.202,7,2186,0,0,7,2186,1.567633000,0.2881
137.21.23.50,<->,111.150.207.132,7,392,0,0,7,392,1.564956000,0.0330
111.20.172.118,<->,33.233.141.42,0,0,7,6154,7,6154,1.561326000,0.0087
205.37.248.20,<->,136.25.189.82,0,0,7,2023,7,2023,1.559440000,0.3998
98.10.80.228,<->,8.220.200.124,0,0,7,680,7,680,1.557882000,0.2890
215.158.239.78,<->,194.251.142.248,7,752,0,0,7,752,1.557396000,0.3475
195.14.150.149,<->,136.25.188.242,0,0,7,1885,7,1885,1.556166000,0.3275
215.158.239.79,<->,195.15.186.168,7,584,0,0,7,584,1.550208000,0.4237
137.47.232.19,<->,8.220.176.253,0,0,7,848,7,848,1.546544000,0.2830
246.254.97.103,<->,210.209.251.211,7,3209,0,0,7,3209,1.544644000,0.1245
119.119.7.60,<->,0.195.210.46,0,0,7,2825,7,2825,1.541013000,0.3904
195.124.173.115,<->,136.25.188.177,0,0,7,392,7,392,1.538471000,0.2007
215.158.239.49,<->,194.237.64.106,7,616,0,0,7,616,1.538166000,0.4464
205.127.108.114,<->,33.233.141.67,0,0,7,4774,7,4774,1.537226000,0.4496
215.158.103.203,<->,54.69.96.25,7,1967,0,0,7,1967,1.524832000,0.3677
136.25.189.32,<->,29.211.165.20,7,3218,0,0,7,3218,1.524118000,0.4614
215.158.239.93,<->,199.20.28.127,7,1500,0,0,7,1500,1.523348000,0.4702
136.25.189.82,<->,29.209.59.172,7,1980,0,0,7,1980,1.522445000,0.4086
247.136.186.211,<->,100.230.5.11,7,5988,0,0,7,5988,1.521597000,0.1935
243.117.93.143,<->,220.55.100.127,0,0,7,1649,7,1649,1.520348000,0.2582
215.158.61.202,<->,8.176.8.206,0,0,7,7394,7,7394,1.519447000,0.3024
8.52.173.195,<->,8.3.219.162,7,715,0,0,7,715,1.515760000,0.1501
100.80.61.12,<->,50.224.76.234,0,0,7,3929,7,3929,1.515254000,0.1471
209.91.247.57,<->,8.53.4.16,0,0,7,802,7,802,1.509983000,0.2235
140.79.209.148,<->,8.252.222.62,0,0,7,604,7,604,1.507096000,0.3443
153.111.172.30,<->,8.252.222.223,0,0,7,350,7,350,1.504063000,0.4417
133.178.226.19,<->,50.218.56.234,7,1517,0,0,7,1517,1.503614000,0.1838
8.252.223.120,<->,8.222.6.215,7,2431,0,0,7,2431,1.500926000,0.4803
215.158.238.176,<->,126.219.246.238,7,1581,0,0,7,1581,1.499275000,0.2144
215.158.239.70,<->,199.20.31.73,7,1237,0,0,7,1237,1.496888000,0.2796
215.158.61.183,<->,8.176.8.97,0,0,7,2229,7,2229,1.493719000,0.2557
195.7.64.30,<->,136.25.188.54,0,0,7,1429,7,1429,1.493665000,0.4149
103.237.231.113,<->,8.52.185.185,0,0,7,1087,7,1087,1.493116000,0.3515
207.175.169.16,<->,136.25.188.45,0,0,7,594,7,594,1.491723000,0.4704
195.71.67.80,<->,136.25.188.209,0,0,7,538,7,538,1.482064000,0.4154
215.158.239.24,<->,96.135.154.156,7,7566,0,0,7,7566,1.481708000,0.1985
246.254.97.112,<->,53.214.86.130,7,4546,0,0,7,4546,1.480229000,0.3111
136.139.59.102,<->,136.25.188.174,0,0,7,1645,7,1645,1.477266000,0.1590
215.158.239.0,<->,53.246.26.228,7,7574,0,0,7,7574,1.475173000,0.1448
249.101.106.130,<->,53.214.109.118,7,5114,0,0,7,5114,1.474991000,0.5047
213.221.90.175,<->,144.85.170.208,0,0,7,790,7,790,1.474944000,0.3834
215.158.239.29,<->,8.255.92.123,7,1436,0,0,7,1436,1.472353000,0.0843
215.158.239.56,<->,195.54.40.211,7,1899,0,0,7,1899,1.470914000,0.5100
142.220.234.65,<->,136.25.188.222,0,0,7,350,7,350,1.468476000,0.5142
215.158.239.56,<->,196.107.74.19,7,1936,0,0,7,1936,1.465414000,0.4805
215.158.239.48,<->,207.60.142.129,7,584,0,0,7,584,1.459440000,0.4162
128.94.114.51,<->,8.52.189.18,0,0,7,706,7,706,1.458282000,0.3511
215.158.238.148,<->,192.228.30.102,7,2734,0,0,7,2734,1.457472000,0.4597
248.239.131.180,<->,8.45.168.98,7,4357,0,0,7,4357,1.452936000,0.4457
197.113.64.168,<->,136.25.188.178,0,0,7,584,7,584,1.445389000,0.5326
136.25.189.30,<->,120.154.131.20,7,3081,0,0,7,3081,1.444352000,0.4330
198.226.166.143,<->,133.178.226.30,0,0,7,1469,7,1469,1.438205000,0.0949
243.123.125.57,<->,92.162.252.17,0,0,7,6178,7,6178,1.431759000,0.4148
207.57.139.22,<->,136.25.188.222,0,0,7,2076,7,2076,1.431480000,0.5670
215.158.238.241,<->,38.104.11.171,7,2571,0,0,7,2571,1.431145000,0.4315
53.196.208.123,<->,8.228.213.135,0,0,7,522,7,522,1.425441000,0.3698
246.254.97.113,<->,210.231.140.55,7,1776,0,0,7,1776,1.422917000,0.0748
215.158.238.142,<->,126.219.132.237,7,4179,0,0,7,4179,1.420740000,0.5079
144.83.115.202,<->,98.236.251.68,0,0,7,517,7,517,1.417550000,0.1621
215.158.140.178,<->,135.243.190.251,7,1589,0,0,7,1589,1.416698000,0.4588
215.158.60.32,<->,133.178.226.213,0,0,7,663,7,663,1.415462000,0.0575
231.140.53.86,<->,215.158.239.95,0,0,7,1907,7,1907,1.412184000,0.5788
43.55.252.156,<->,8.252.221.230,0,0,7,798,7,798,1.407463000,0.5366
143.68.190.19,<->,136.25.188.52,0,0,7,1682,7,1682,1.406973000,0.4564
114.205.133.225,<->,50.224.76.234,0,0,7,3562,7,3562,1.406616000,0.4241
253.103.78.162,<->,136.25.188.162,0,0,7,1741,7,1741,1.406330000,0.0431
132.44.144.167,<->,50.224.76.248,0,0,7,4031,7,4031,1.402960000,0.0971
215.158.239.96,<->,142.166.51.22,7,838,0,0,7,838,1.402616000,0.5157
215.158.238.190,<->,29.211.165.88,7,2444,0,0,7,2444,1.401981000,0.4565
215.158.239.101,<->,133.146.0.44,7,5069,0,0,7,5069,1.396298000,0.2504
197.113.64.202,<->,136.25.188.53,0,0,7,2732,7,2732,1.395640000,0.5020
192.64.246.197,<->,33.78.194.97,7,1261,0,0,7,1261,1.391083000,0.5201
58.169.247.106,<->,0.195.210.42,0,0,7,1633,7,1633,1.388777000,0.4459
129.26.244.132,<->,103.244.181.234,7,491,0,0,7,491,1.388086000,0.3511
246.253.169.113,<->,97.223.4.2,7,4611,0,0,7,4611,1.382301000,0.1978
109.113.90.155,<->,8.182.245.152,0,0,7,1004,7,1004,1.379222000,0.0483
143.230.72.6,<->,8.20.87.153,0,0,7,2632,7,2632,1.369578000,0.3120
204.21.157.87,<->,136.25.188.177,0,0,7,756,7,756,1.367915000,0.5805
215.158.239.87,<->,196.94.15.50,7,584,0,0,7,584,1.360213000,0.5602
199.14.159.50,<->,136.25.188.227,0,0,7,1908,7,1908,1.357238000,0.5688
216.184.1.109,<->,8.252.222.144,0,0,7,3550,7,3550,1.349700000,0.1497
53.68.24.5,<->,48.54.74.255,0,0,7,6568,7,6568,1.343517000,0.2951
215.158.239.29,<->,215.158.127.148,7,3421,0,0,7,3421,1.341967000,0.4548
252.98.138.179,<->,50.224.34.245,7,5798,0,0,7,5798,1.337774000,0.0496
133.178.227.16,<->,8.240.116.53,7,1557,0,0,7,1557,1.337042000,0.0340
142.179.40.120,<->,50.224.76.234,0,0,7,1813,7,1813,1.336615000,0.3537
245.227.234.71,<->,8.182.241.177,0,0,7,1232,7,1232,1.334921000,0.2226
215.158.61.189,<->,8.176.8.197,0,0,7,4716,7,4716,1.332633000,0.4170
215.158.238.72,<->,80.47.111.88,7,2722,0,0,7,2722,1.331748000,0.5510
195.126.170.15,<->,136.25.188.45,0,0,7,1899,7,1899,1.328554000,0.5639
196.89.250.4,<->,136.25.188.209,0,0,7,2710,7,2710,1.323704000,0.4807
215.158.239.77,<->,199.20.31.68,7,976,0,0,7,976,1.321222000,0.6005
195.125.44.203,<->,136.25.188.252,0,0,7,1255,7,1255,1.318397000,0.2164
114.76.96.142,<->,92.162.253.161,0,0,7,5451,7,5451,1.316829000,0.2182
50.224.76.235,<->,33.245.207.237,7,4019,0,0,7,4019,1.312960000,0.3671
215.158.238.66,<->,140.19.166.161,7,1577,0,0,7,1577,1.312749000,0.5242
215.158.238.82,<->,29.211.228.69,7,1457,0,0,7,1457,1.310785000,0.2695
220.28.65.9,<->,215.158.238.145,0,0,7,7690,7,7690,1.310519000,0.1432
215.158.140.83,<->,72.23.148.226,7,1721,0,0,7,1721,1.308357000,0.2709
215.158.239.51,<->,199.20.28.212,7,734,0,0,7,734,1.302533000,0.6199
93.191.36.129,<->,50.224.106.182,0,0,7,714,7,714,1.301361000,0.4312
215.158.239.56,<->,196.168.46.78,7,964,0,0,7,964,1.298790000,0.5903
215.158.239.4,<->,8.191.15.80,7,1855,0,0,7,1855,1.296685000,0.0181
196.246.129.115,<->,136.25.188.52,0,0,7,492,7,492,1.296247000,0.0227
215.158.238.66,<->,8.222.96.15,7,2946,0,0,7,2946,1.287307000,0.4330
197.113.99.127,<->,136.25.188.255,0,0,7,584,7,584,1.279582000,0.5907
153.245.144.109,<->,80.27.154.138,0,0,7,1313,7,1313,1.278740000,0.5520
129.148.0.173,<->,50.224.76.234,0,0,7,3645,7,3645,1.278219000,0.5104
196.18.58.20,<->,8.20.87.187,0,0,7,708,7,708,1.271965000,0.6686
215.158.239.55,<->,136.114.101.94,7,7538,0,0,7,7538,1.271570000,0.1966
215.158.239.7,<->,145.13.164.170,7,1956,0,0,7,1956,1.269331000,0.2166
195.7.129.174,<->,136.25.188.45,0,0,7,696,7,696,1.268911000,0.6551
247.136.212.254,<->,122.105.68.11,7,1568,0,0,7,1568,1.268876000,0.3284
17.39.170.244,<->,8.220.205.216,0,0,7,770,7,770,1.263590000,0.4569
136.18.143.186,<->,8.183.25.124,0,0,7,1579,7,1579,1.258420000,0.1266
204.154.15.251,<->,8.182.243.89,0,0,7,1217,7,1217,1.256543000,0.5622
148.129.19.217,<->,136.25.188.162,0,0,7,1581,7,1581,1.251772000,0.2291
144.83.112.140,<->,50.224.108.188,0,0,7,645,7,645,1.249078000,0.1465
142.207.160.227,<->,136.25.188.226,0,0,7,1758,7,1758,1.246741000,0.6633
80.38.61.113,<->,38.177.158.149,7,396,0,0,7,396,1.243432000,0.6191
215.158.238.135,<->,131.144.113.168,7,4007,0,0,7,4007,1.241419000,0.6565
136.181.39.147,<->,0.195.216.195,7,540,0,0,7,540,1.239457000,0.2640
87.9.72.93,<->,80.42.175.248,0,0,7,364,7,364,1.239198000,0.5001
92.168.217.191,<->,50.136.179.8,7,920,0,0,7,920,1.238958000,0.3010
143.128.183.153,<->,136.25.188.176,0,0,7,584,7,584,1.238204000,0.7576
215.158.239.70,<->,195.43.186.225,7,584,0,0,7,584,1.236757000,0.6642
196.89.117.145,<->,136.25.188.178,0,0,7,608,7,608,1.235931000,0.5233
215.158.238.107,<->,148.26.113.31,7,1533,0,0,7,1533,1.234031000,0.1805
204.3.43.12,<->,136.25.188.255,0,0,7,806,7,806,1.232111000,0.7200
215.158.239.84,<->,199.20.30.168,7,1117,0,0,7,1117,1.227392000,0.6990
215.158.239.92,<->,195.43.186.225,7,584,0,0,7,584,1.226083000,0.6879
215.158.238.247,<->,215.158.43.49,7,894,0,0,7,894,1.223616000,0.2138
215.158.61.145,<->,8.176.8.196,0,0,7,3987,7,3987,1.222595000,0.7231
215.158.239.94,<->,199.20.30.63,7,584,0,0,7,584,1.217614000,0.4206
215.158.140.60,<->,158.192.3.71,7,1426,0,0,7,1426,1.216651000,0.1194
215.158.238.114,<->,113.23.20.93,7,2898,0,0,7,2898,1.215023000,0.6687
89.155.243.15,<->,50.224.89.243,0,0,7,1142,7,1142,1.213154000,0.1076
196.148.120.203,<->,57.144.209.128,7,736,0,0,7,736,1.213007000,0.7423
215.158.238.75,<->,112.220.206.107,7,1453,0,0,7,1453,1.210097000,0.1038
61.111.29.59,<->,8.252.222.38,0,0,7,1847,7,1847,1.208574000,0.6200
195.124.253.80,<->,136.25.188.209,0,0,7,486,7,486,1.204627000,0.7006
197.113.99.161,<->,136.25.188.225,0,0,7,493,7,493,1.204494000,0.1836
215.158.239.69,<->,142.248.16.154,7,2188,0,0,7,2188,1.204129000,0.7947
142.208.46.74,<->,136.25.188.238,0,0,7,1243,7,1243,1.201262000,0.6184
215.158.238.198,<->,61.35.124.188,7,1421,0,0,7,1421,1.198980000,0.2708
215.158.238.82,<->,192.228.30.102,7,1661,0,0,7,1661,1.198672000,0.0314
197.106.84.211,<->,8.182.248.147,0,0,7,853,7,853,1.197980000,0.7202
136.25.188.196,<->,8.227.55.83,7,590,0,0,7,590,1.188304000,0.0361
215.158.238.66,<->,143.88.15.53,7,1645,0,0,7,1645,1.181839000,0.3361
234.182.161.104,<->,215.158.140.188,0,0,7,723,7,723,1.180012000,0.0573
221.102.108.186,<->,217.11.190.192,7,1112,0,0,7,1112,1.170468000,0.1030
207.60.106.93,<->,136.25.188.224,0,0,7,1408,7,1408,1.167419000,0.7152
215.158.238.132,<->,113.23.117.86,7,1581,0,0,7,1581,1.165875000,0.1160
193.21.29.216,<->,89.183.104.177,0,0,7,5668,7,5668,1.165848000,0.1491
215.158.239.87,<->,29.211.93.15,7,743,0,0,7,743,1.165463000,0.7371
215.158.238.105,<->,106.188.251.218,7,2878,0,0,7,2878,1.161276000,0.7036
53.148.239.43,<->,48.54.67.114,0,0,7,7323,7,7323,1.161020000,0.3709
220.80.200.232,<->,158.14.42.202,7,498,0,0,7,498,1.160523000,0.8296
195.13.130.115,<->,136.25.188.197,0,0,7,600,7,600,1.159682000,0.3856
215.158.239.4,<->,29.212.196.25,7,1996,0,0,7,1996,1.152290000,0.1600
133.178.227.2,<->,133.56.180.15,7,4111,0,0,7,4111,1.149891000,0.8394
215.158.238.176,<->,131.144.116.5,7,1693,0,0,7,1693,1.149834000,0.2542
132.123.44.18,<->,8.222.6.255,7,7110,0,0,7,7110,1.149685000,0.0294
207.58.249.78,<->,136.25.188.54,0,0,7,600,7,600,1.146809000,0.5989
215.158.238.95,<->,212.70.75.25,7,1449,0,0,7,1449,1.144712000,0.0628
215.158.239.86,<->,199.20.29.30,7,1238,0,0,7,1238,1.140697000,0.3700
142.206.47.119,<->,136.25.188.209,0,0,7,838,7,838,1.139145000,0.8545
136.25.189.34,<->,6.15.207.97,7,2786,0,0,7,2786,1.138749000,0.5846
92.168.217.244,<->,50.136.137.231,7,392,0,0,7,392,1.137759000,0.6674
215.158.239.48,<->,199.20.29.228,7,392,0,0,7,392,1.137157000,0.7206
197.113.99.169,<->,136.25.188.226,0,0,7,417,7,417,1.134982000,0.6599
207.231.197.31,<->,8.252.222.62,0,0,7,584,7,584,1.134942000,0.4092
215.158.61.182,<->,136.25.188.37,0,0,7,5651,7,5651,1.132538000,0.6653
215.158.238.33,<->,112.220.206.126,7,4135,0,0,7,4135,1.131520000,0.7758
97.193.135.46,<->,8.182.239.159,0,0,7,987,7,987,1.128750000,0.3933
215.158.239.56,<->,199.15.113.204,7,1889,0,0,7,1889,1.127575000,0.6110
215.158.238.133,<->,113.23.14.165,7,1581,0,0,7,1581,1.121928000,0.3899
133.178.227.76,<->,8.222.6.193,7,2542,0,0,7,2542,1.121906000,0.4003
111.199.225.227,<->,0.195.210.44,0,0,7,578,7,578,1.120614000,0.1415
133.178.226.198,<->,56.97.187.106,7,496,0,0,7,496,1.120279000,0.8579
215.158.239.254,<->,111.151.109.35,7,392,0,0,7,392,1.120044000,0.0002
129.224.112.252,<->,97.242.126.187,7,458,0,0,7,458,1.115275000,0.3284
220.55.100.127,<->,220.20.202.53,7,1665,0,0,7,1665,1.114408000,0.3070
199.14.202.207,<->,136.25.188.255,0,0,7,1901,7,1901,1.114040000,0.6401
143.129.49.132,<->,136.25.188.253,0,0,7,1908,7,1908,1.112425000,0.6210
246.254.97.104,<->,210.231.140.55,7,1184,0,0,7,1184,1.112218000,0.0797
136.25.189.82,<->,131.144.113.41,7,2882,0,0,7,2882,1.111086000,0.7702
129.224.112.252,<->,92.160.15.146,7,541,0,0,7,541,1.109436000,0.0050
215.158.239.93,<->,196.105.53.59,7,362,0,0,7,362,1.104322000,0.7194
203.212.93.0,<->,8.52.182.119,0,0,7,594,7,594,1.102808000,0.3420
136.25.188.237,<->,57.160.181.203,7,1613,0,0,7,1613,1.100014000,0.1242
195.41.210.241,<->,136.25.188.44,0,0,7,586,7,586,1.099187000,0.4762
133.178.226.19,<->,119.196.23.52,7,2642,0,0,7,2642,1.099138000,0.8964
196.246.195.215,<->,136.25.188.54,0,0,7,2127,7,2127,1.093750000,0.7202
215.158.238.45,<->,33.209.219.8,7,1341,0,0,7,1341,1.086247000,0.1332
125.197.1.201,<->,50.224.76.234,0,0,7,4092,7,4092,1.081747000,0.5497
143.42.211.228,<->,136.25.188.198,0,0,7,958,7,958,1.077123000,0.5677
144.75.218.95,<->,17.61.6.229,7,593,0,0,7,593,1.074177000,0.3764
215.158.140.229,<->,8.220.54.107,7,1421,0,0,7,1421,1.073307000,0.1138
142.227.132.130,<->,136.25.188.197,0,0,7,584,7,584,1.069867000,0.6320
143.10.249.236,<->,136.25.188.55,0,0,7,1202,7,1202,1.068771000,0.3471
143.13.154.154,<->,136.25.188.54,0,0,7,696,7,696,1.063527000,0.6460
215.158.140.229,<->,148.190.126.41,7,1720,0,0,7,1720,1.061581000,0.3649
220.20.200.37,<->,193.81.55.4,7,7283,0,0,7,7283,1.060849000,0.1174
215.158.238.66,<->,192.228.30.102,7,1545,0,0,7,1545,1.060438000,0.1471
215.158.239.56,<->,207.191.86.23,7,594,0,0,7,594,1.059397000,0.9297
101.238.103.86,<->,8.49.69.111,7,4646,0,0,7,4646,1.053545000,0.1337
17.143.241.23,<->,8.220.202.4,0,0,7,633,7,633,1.049287000,0.7555
207.58.248.0,<->,136.25.188.253,0,0,7,1902,7,1902,1.049233000,0.8180
147.58.211.46,<->,8.252.221.217,0,0,7,4360,7,4360,1.047458000,0.1504
204.2.36.142,<->,136.25.188.220,0,0,7,604,7,604,1.047122000,0.9205
204.186.230.242,<->,136.25.188.255,0,0,7,504,7,504,1.046137000,0.0813
144.122.240.217,<->,144.108.64.184,7,481,0,0,7,481,1.043337000,0.0138
210.229.230.19,<->,113.176.55.114,7,448,0,0,7,448,1.042077000,0.8212
215.158.239.51,<->,199.14.128.40,7,699,0,0,7,699,1.036917000,0.7337
231.142.98.50,<->,215.158.239.68,0,0,7,1218,7,1218,1.035400000,0.3984
144.122.240.192,<->,144.108.64.184,7,462,0,0,7,462,1.034341000,0.0132
215.158.140.241,<->,18.202.90.175,7,3509,0,0,7,3509,1.034166000,0.6673
207.21.26.26,<->,8.182.250.65,0,0,7,1489,7,1489,1.033052000,0.9187
144.94.162.244,<->,144.85.170.254,0,0,7,392,7,392,1.032601000,0.7472
215.158.239.93,<->,199.20.28.18,7,1907,0,0,7,1907,1.030045000,0.9119
215.158.239.78,<->,196.94.238.66,7,946,0,0,7,946,1.027127000,0.7818
194.232.225.22,<->,136.25.188.238,0,0,7,1243,7,1243,1.020292000,0.8098
215.158.239.95,<->,142.254.68.249,7,603,0,0,7,603,1.017100000,0.5671
215.158.239.93,<->,142.207.222.204,7,3519,0,0,7,3519,1.015465000,0.7845
133.178.226.71,<->,29.213.219.85,7,2718,0,0,7,2718,1.013542000,0.8197
215.158.238.83,<->,33.239.214.176,7,1533,0,0,7,1533,1.013077000,0.3663
111.151.231.56,<->,8.252.221.167,0,0,7,515,7,515,1.012463000,0.0517
137.194.151.102,<->,50.224.76.235,0,0,7,4943,7,4943,1.011325000,0.1240
129.187.1.212,<->,109.1.84.196,0,0,7,5889,7,5889,1.010116000,0.1928
215.158.239.49,<->,204.21.11.235,7,1906,0,0,7,1906,1.008862000,0.6674
215.158.238.64,<->,57.210.107.8,7,1597,0,0,7,1597,1.008685000,0.1238
133.178.227.57,<->,131.22.233.138,7,2487,0,0,7,2487,1.006022000,0.8931
50.224.76.235,<->,29.154.146.144,7,2767,0,0,7,2767,1.001760000,0.2111
207.236.29.192,<->,136.25.188.238,0,0,7,603,7,603,1.000377000,0.6795
199.21.175.243,<->,50.223.3.228,0,0,7,356,7,356,0.999275000,0.8063
195.15.145.21,<->,136.25.188.178,0,0,7,1083,7,1083,0.998264000,0.9799
108.41.117.69,<->,97.198.98.78,0,0,7,350,7,350,0.997364000,0.2066
215.158.238.126,<->,98.219.126.140,7,7962,0,0,7,7962,0.996489000,0.0328
215.158.239.69,<->,199.20.30.239,7,1133,0,0,7,1133,0.996342000,0.3090
215.158.239.19,<->,192.170.245.245,7,1521,0,0,7,1521,0.995863000,0.0313
136.25.188.47,<->,8.191.15.7,7,1677,0,0,7,1677,0.994438000,0.1094
142.228.58.200,<->,136.25.188.163,0,0,7,806,7,806,0.990646000,0.6644
215.158.238.112,<->,29.213.216.255,7,1565,0,0,7,1565,0.988123000,0.5344
215.158.239.57,<->,199.20.5.30,7,392,0,0,7,392,0.986345000,0.7596
136.25.189.139,<->,111.150.207.71,7,392,0,0,7,392,0.983419000,0.0233
215.158.239.97,<->,199.20.5.47,7,392,0,0,7,392,0.982689000,0.2499
50.224.105.38,<->,4.240.196.22,7,476,0,0,7,476,0.981499000,0.0149
111.20.172.70,<->,33.233.141.31,0,0,7,902,7,902,0.981099000,1.0094
136.25.189.88,<->,133.224.119.35,7,4311,0,0,7,4311,0.979273000,0.7597
159.137.162.213,<->,117.11.138.106,7,932,0,0,7,932,0.978790000,0.7133
145.200.63.211,<->,133.178.226.186,0,0,7,5662,7,5662,0.978261000,0.4865
200.19.78.155,<->,0.195.210.42,0,0,7,785,7,785,0.976640000,0.8796
195.215.92.47,<->,50.223.3.228,0,0,7,577,7,577,0.975723000,0.3199
17.232.218.163,<->,8.220.200.124,0,0,7,2051,7,2051,0.968954000,0.4901
215.158.239.50,<->,199.20.31.197,7,946,0,0,7,946,0.959458000,0.9798
133.178.226.7,<->,111.150.186.222,7,2770,0,0,7,2770,0.959414000,0.5288
136.25.189.82,<->,69.132.46.139,7,3815,0,0,7,3815,0.956081000,0.8814
99.162.77.146,<->,53.201.37.127,7,978,0,0,7,978,0.954782000,0.2364
199.73.240.168,<->,92.27.194.147,0,0,7,590,7,590,0.954145000,0.4292
120.36.99.226,<->,80.42.185.56,0,0,7,706,7,706,0.952134000,1.0407
132.168.198.53,<->,53.149.113.147,7,2613,0,0,7,2613,0.951871000,0.3541
215.158.239.121,<->,215.158.61.203,7,7599,0,0,7,7599,0.951238000,0.6036
129.224.112.252,<->,97.242.126.176,7,460,0,0,7,460,0.948988000,0.4484
215.158.239.76,<->,196.111.216.182,7,1070,0,0,7,1070,0.944331000,1.0202
206.195.129.169,<->,144.86.146.31,0,0,7,4254,7,4254,0.944052000,0.6142
215.158.239.56,<->,199.14.14.243,7,1881,0,0,7,1881,0.943476000,0.7525
215.158.239.6,<->,122.29.158.180,7,3376,0,0,7,3376,0.939740000,0.8552
204.200.39.80,<->,136.25.188.220,0,0,7,1227,7,1227,0.939148000,0.7504
124.41.84.151,<->,92.162.253.148,0,0,7,4353,7,4353,0.936982000,0.4823
199.50.173.206,<->,136.25.188.199,0,0,7,1129,7,1129,0.936132000,0.2520
136.25.189.83,<->,96.156.169.244,7,4503,0,0,7,4503,0.934043000,1.0438
50.224.88.92,<->,46.37.168.70,7,392,0,0,7,392,0.928308000,0.6480
136.25.189.202,<->,129.222.39.156,7,2734,0,0,7,2734,0.928077000,1.0500
207.117.213.69,<->,8.182.227.180,0,0,7,676,7,676,0.921870000,0.7117
215.158.238.120,<->,158.253.43.167,7,1517,0,0,7,1517,0.919318000,0.2488
207.190.47.234,<->,136.25.188.225,0,0,7,492,7,492,0.916067000,0.1599
133.178.226.80,<->,8.191.15.4,7,1533,0,0,7,1533,0.915054000,0.0287
215.158.239.79,<->,199.20.31.18,7,437,0,0,7,437,0.914880000,0.0098
142.236.234.77,<->,136.25.188.175,0,0,7,1899,7,1899,0.908211000,0.7162
143.13.34.41,<->,136.25.188.209,0,0,7,621,7,621,0.896650000,0.4686
116.238.52.134,<->,89.183.104.227,0,0,7,8426,7,8426,0.894742000,1.0975
249.101.238.146,<->,53.69.55.165,7,2242,0,0,7,2242,0.894601000,0.5223
207.191.120.221,<->,136.25.188.162,0,0,7,392,7,392,0.889901000,0.8410
129.225.134.223,<->,129.225.132.84,0,0,7,3761,7,3761,0.889515000,0.0827
215.158.239.58,<->,207.115.154.92,7,428,0,0,7,428,0.889509000,1.0601
136.25.188.173,<->,8.179.43.83,7,1677,0,0,7,1677,0.888419000,0.4085
50.224.108.164,<->,17.94.133.141,7,502,0,0,7,502,0.885812000,0.1384
215.158.238.141,<->,42.226.3.118,7,1597,0,0,7,1597,0.880258000,0.3220
139.161.104.168,<->,136.25.188.48,0,0,7,10521,7,10521,0.877435000,0.0001
136.25.188.44,<->,76.100.108.197,7,2994,0,0,7,2994,0.870149000,0.4631
215.158.238.120,<->,141.23.229.105,7,1677,0,0,7,1677,0.869263000,0.3489
69.103.113.149,<->,8.252.222.134,0,0,7,1115,7,1115,0.868934000,0.4546
246.254.97.229,<->,111.20.62.72,7,8118,0,0,7,8118,0.868500000,0.0893
215.158.239.86,<->,199.20.28.255,7,444,0,0,7,444,0.868282000,0.0006
159.13.238.91,<->,54.92.199.224,7,668,0,0,7,668,0.868146000,0.2286
98.212.218.241,<->,50.224.76.248,0,0,7,5406,7,5406,0.868128000,0.0895
195.55.64.153,<->,136.25.188.45,0,0,7,1117,7,1117,0.864416000,0.4527
215.158.239.84,<->,199.39.88.51,7,1147,0,0,7,1147,0.864300000,1.0688
231.142.7.60,<->,215.158.239.56,0,0,7,626,7,626,0.864167000,0.8001
138.4.84.225,<->,54.69.65.183,7,2489,0,0,7,2489,0.861640000,0.9356
210.208.242.230,<->,144.87.235.222,0,0,7,6261,7,6261,0.860173000,0.1457
215.158.239.77,<->,143.129.21.247,7,1789,0,0,7,1789,0.859319000,0.6307
136.25.188.179,<->,113.23.104.247,7,1565,0,0,7,1565,0.858145000,0.3419
204.58.108.39,<->,136.25.188.53,0,0,7,580,7,580,0.857388000,0.5142
215.158.239.76,<->,207.188.189.118,7,476,0,0,7,476,0.855550000,1.0802
199.122.184.238,<->,8.52.228.29,0,0,7,5005,7,5005,0.854386000,0.5889
69.128.138.177,<->,53.201.72.62,7,5282,0,0,7,5282,0.850617000,0.7704
143.52.171.63,<->,136.25.188.226,0,0,7,696,7,696,0.849133000,0.6488
215.158.238.216,<->,100.216.78.145,7,6136,0,0,7,6136,0.848628000,0.3110
215.158.239.48,<->,207.166.18.232,7,438,0,0,7,438,0.848518000,0.9015
133.178.226.60,<->,57.210.104.163,7,1389,0,0,7,1389,0.845774000,0.1250
215.158.238.74,<->,122.158.49.195,7,2674,0,0,7,2674,0.845213000,1.0159
215.158.238.236,<->,99.168.151.235,7,452,0,0,7,452,0.843861000,0.0884
133.178.227.76,<->,38.51.98.247,7,2369,0,0,7,2369,0.840329000,0.5973
215.158.238.95,<->,120.20.132.2,7,1741,0,0,7,1741,0.837940000,0.2600
133.178.226.227,<->,8.47.189.8,7,977,0,0,7,977,0.836995000,0.0577
215.201.190.253,<->,8.183.25.124,0,0,7,648,7,648,0.836823000,0.6907
215.158.238.66,<->,113.23.104.223,7,2866,0,0,7,2866,0.836635000,0.8019
158.253.43.167,<->,133.178.226.38,0,0,7,1677,7,1677,0.834622000,0.2664
196.240.242.55,<->,136.25.188.209,0,0,7,695,7,695,0.834556000,0.9609
231.136.253.109,<->,136.25.188.255,0,0,7,620,7,620,0.834356000,1.0300
133.178.226.77,<->,131.36.198.24,7,1549,0,0,7,1549,0.830330000,0.2139
215.158.140.228,<->,17.254.181.11,7,901,0,0,7,901,0.825982000,0.3991
215.158.61.209,<->,99.74.27.190,0,0,7,6190,7,6190,0.818940000,0.1205
215.158.239.125,<->,100.224.141.71,7,2666,0,0,7,2666,0.817573000,0.2050
133.178.226.28,<->,29.213.216.255,7,1645,0,0,7,1645,0.814374000,0.2340
215.158.239.97,<->,195.83.176.83,7,1910,0,0,7,1910,0.811115000,0.9591
215.158.239.56,<->,195.70.174.238,7,1224,0,0,7,1224,0.808317000,0.3375
204.143.20.66,<->,8.182.250.65,0,0,7,885,7,885,0.801041000,0.3896
143.134.13.218,<->,136.25.188.255,0,0,7,664,7,664,0.800916000,0.6859
133.178.227.245,<->,8.61.93.39,7,6605,0,0,7,6605,0.800730000,0.0405
215.158.239.51,<->,207.228.238.180,7,2734,0,0,7,2734,0.800626000,0.9116
144.83.112.137,<->,133.54.17.198,0,0,7,517,7,517,0.799531000,0.1652
215.158.239.28,<->,8.191.6.216,7,3469,0,0,7,3469,0.799306000,0.7700
140.29.6.161,<->,8.252.222.30,0,0,7,989,7,989,0.796435000,0.6567
215.158.238.106,<->,104.3.161.26,7,2962,0,0,7,2962,0.790460000,1.0692
142.244.205.46,<->,136.25.188.163,0,0,7,1101,7,1101,0.790419000,0.5604
133.178.226.29,<->,29.214.108.122,7,2834,0,0,7,2834,0.790083000,0.4836
136.25.188.209,<->,99.83.81.70,7,692,0,0,7,692,0.789156000,0.2495
246.254.97.228,<->,8.20.81.65,7,2400,0,0,7,2400,0.788478000,0.9250
207.191.232.222,<->,136.25.188.225,0,0,7,628,7,628,0.784360000,1.0592
17.254.108.35,<->,8.220.178.198,0,0,7,1001,7,1001,0.781415000,0.2508
215.158.239.49,<->,196.109.46.20,7,566,0,0,7,566,0.780870000,0.8406
234.182.161.111,<->,97.126.31.73,0,0,7,701,7,701,0.780436000,0.3074
215.158.239.56,<->,195.126.170.210,7,461,0,0,7,461,0.779248000,0.5627
215.158.239.49,<->,196.0.126.245,7,1234,0,0,7,1234,0.778256000,0.5100
215.158.238.82,<->,143.155.227.59,7,1541,0,0,7,1541,0.773864000,0.5408
133.178.226.29,<->,114.143.139.170,7,1309,0,0,7,1309,0.773087000,0.1303
136.25.188.210,<->,29.214.108.104,7,2866,0,0,7,2866,0.769403000,1.0371
195.55.71.205,<->,136.25.188.227,0,0,7,504,7,504,0.767631000,0.4011
204.200.48.192,<->,136.25.188.54,0,0,7,685,7,685,0.764096000,0.4120
215.158.239.30,<->,131.95.192.159,7,3193,0,0,7,3193,0.763779000,0.6296
137.44.245.179,<->,97.126.15.237,0,0,7,5132,7,5132,0.761076000,0.1088
215.158.238.95,<->,158.192.3.233,7,2834,0,0,7,2834,0.759035000,1.1698
136.25.188.44,<->,112.220.206.22,7,1437,0,0,7,1437,0.756455000,0.1271
215.158.238.66,<->,120.154.186.218,7,2754,0,0,7,2754,0.755271000,1.1964
215.158.238.97,<->,57.247.184.208,7,2690,0,0,7,2690,0.753659000,1.0659
198.100.2.208,<->,89.183.104.167,0,0,7,706,7,706,0.753297000,1.2116
207.60.142.207,<->,136.25.188.225,0,0,7,695,7,695,0.752575000,1.1666
215.158.239.49,<->,199.20.5.88,7,1937,0,0,7,1937,0.750227000,1.1599
195.111.92.218,<->,50.223.3.228,0,0,7,350,7,350,0.749133000,1.1073
215.158.239.95,<->,196.91.79.179,7,710,0,0,7,710,0.748720000,0.7201
207.239.139.212,<->,136.25.188.176,0,0,7,1286,7,1286,0.738238000,0.0342
136.25.188.144,<->,122.159.241.253,7,3391,0,0,7,3391,0.737870000,0.1987
133.178.227.41,<->,61.35.124.201,7,1721,0,0,7,1721,0.733378000,0.5357
215.158.239.57,<->,207.167.232.63,7,946,0,0,7,946,0.730229000,0.5901
142.203.97.220,<->,50.223.3.228,0,0,7,368,7,368,0.728957000,1.0847
136.25.188.239,<->,72.8.163.72,7,946,0,0,7,946,0.728236000,0.5781
215.158.61.145,<->,8.176.8.102,0,0,7,5704,7,5704,0.727390000,0.3293
252.98.149.1,<->,54.69.73.125,7,2558,0,0,7,2558,0.726722000,0.6083
196.16.241.32,<->,50.223.3.228,0,0,7,350,7,350,0.725001000,1.1119
195.5.187.59,<->,136.25.188.253,0,0,7,1252,7,1252,0.723184000,0.3111
136.25.189.0,<->,61.35.70.229,7,2962,0,0,7,2962,0.720062000,0.9799
205.185.247.66,<->,50.224.76.234,0,0,7,2624,7,2624,0.718973000,0.9801
204.200.55.40,<->,136.25.188.163,0,0,7,1223,7,1223,0.717967000,0.2915
215.158.239.84,<->,199.20.30.205,7,1381,0,0,7,1381,0.717052000,0.9579
199.20.6.240,<->,0.195.210.42,0,0,7,1021,7,1021,0.716767000,1.2599
136.25.188.197,<->,131.36.198.33,7,4466,0,0,7,4466,0.716183000,1.1439
215.158.238.250,<->,192.227.190.8,7,1709,0,0,7,1709,0.715932000,0.0738
97.168.64.3,<->,91.40.109.42,7,2285,0,0,7,2285,0.715710000,0.2754
136.25.189.33,<->,126.219.194.18,7,3012,0,0,7,3012,0.713266000,0.4502
215.158.239.93,<->,199.122.173.231,7,1377,0,0,7,1377,0.712945000,1.1001
8.220.190.86,<->,6.101.47.183,7,1153,0,0,7,1153,0.708091000,0.2104
194.234.241.111,<->,136.25.188.199,0,0,7,442,7,442,0.707297000,1.0942
195.12.112.179,<->,136.25.188.238,0,0,7,1033,7,1033,0.704076000,1.0200
215.158.239.96,<->,195.43.255.92,7,786,0,0,7,786,0.697878000,0.7958
215.158.239.49,<->,199.20.29.238,7,480,0,0,7,480,0.697057000,0.0803
80.42.131.23,<->,8.150.48.252,7,6501,0,0,7,6501,0.696601000,0.3969
215.158.61.193,<->,8.176.8.183,0,0,7,9353,7,9353,0.696342000,1.1460
215.158.239.87,<->,199.20.31.153,7,724,0,0,7,724,0.694822000,0.9508
133.178.227.19,<->,128.194.247.52,7,1450,0,0,7,1450,0.694013000,0.8580
223.120.123.230,<->,8.252.221.205,0,0,7,1158,7,1158,0.690583000,1.3047
215.158.239.79,<->,142.236.94.74,7,1626,0,0,7,1626,0.690357000,0.5890
146.249.227.135,<->,8.252.221.221,0,0,7,476,7,476,0.689724000,0.1738
195.71.149.220,<->,136.25.188.198,0,0,7,1303,7,1303,0.686318000,1.0645
158.192.3.219,<->,136.25.188.44,0,0,7,1485,7,1485,0.684416000,0.2014
195.55.70.223,<->,136.25.188.174,0,0,7,1906,7,1906,0.682665000,0.8331
200.174.31.245,<->,53.167.74.78,7,5605,0,0,7,5605,0.681665000,1.2421
103.14.185.79,<->,35.56.100.182,0,0,7,1586,7,1586,0.674880000,1.3183
148.190.126.57,<->,133.178.227.79,0,0,7,1757,7,1757,0.673335000,0.1617
195.68.30.94,<->,136.25.188.197,0,0,7,548,7,548,0.672857000,0.2589
199.70.30.146,<->,136.25.188.162,0,0,7,1236,7,1236,0.671700000,0.3493
204.185.194.201,<->,136.25.188.52,0,0,7,392,7,392,0.670281000,1.1411
221.102.143.189,<->,218.4.165.98,0,0,7,3470,7,3470,0.669314000,0.1591
133.178.227.14,<->,123.166.46.215,7,2535,0,0,7,2535,0.669202000,1.0369
215.158.239.50,<->,199.14.85.95,7,696,0,0,7,696,0.668854000,0.5898
144.83.112.140,<->,98.236.243.160,0,0,7,377,7,377,0.664196000,0.2134
136.25.189.80,<->,113.92.151.56,7,3042,0,0,7,3042,0.661584000,0.6640
109.214.186.222,<->,50.224.76.248,0,0,7,4609,7,4609,0.660945000,0.2685
133.54.26.17,<->,117.130.224.251,7,378,0,0,7,378,0.657870000,0.9060
246.254.97.113,<->,139.33.175.144,7,6456,0,0,7,6456,0.657784000,0.0878
215.158.140.17,<->,80.57.208.180,7,2945,0,0,7,2945,0.655049000,0.4183
17.34.58.13,<->,8.220.235.114,0,0,7,1711,7,1711,0.654649000,0.7766
215.158.239.84,<->,199.20.29.231,7,468,0,0,7,468,0.654165000,0.1004
215.158.239.59,<->,204.227.243.73,7,954,0,0,7,954,0.646807000,0.6013
207.175.175.219,<->,136.25.188.163,0,0,7,476,7,476,0.645982000,0.3003
196.89.226.191,<->,136.25.188.196,0,0,7,1919,7,1919,0.645603000,1.2469
142.182.132.200,<->,136.25.188.252,0,0,7,1269,7,1269,0.645385000,0.3238
215.158.58.222,<->,99.74.27.25,0,0,7,5724,7,5724,0.645308000,0.4458
143.129.169.210,<->,136.25.188.162,0,0,7,453,7,453,0.642526000,0.3040
136.25.188.162,<->,119.168.0.145,7,2978,0,0,7,2978,0.642364000,1.3282
133.178.226.30,<->,106.188.252.218,7,2610,0,0,7,2610,0.639053000,0.6982
215.158.140.92,<->,100.50.96.201,7,1550,0,0,7,1550,0.637002000,0.2619
215.158.239.79,<->,195.126.110.249,7,696,0,0,7,696,0.636717000,1.0355
197.113.99.109,<->,136.25.188.253,0,0,7,437,7,437,0.636601000,0.0191
136.25.188.167,<->,100.216.78.145,7,8429,0,0,7,8429,0.636280000,0.0928
139.163.96.101,<->,136.98.131.10,7,641,0,0,7,641,0.636119000,1.1803
136.25.189.33,<->,98.28.95.85,7,3879,0,0,7,3879,0.633655000,0.6923
215.158.238.142,<->,131.1.195.244,7,3063,0,0,7,3063,0.630354000,1.3214
194.234.166.133,<->,136.25.188.54,0,0,7,1424,7,1424,0.626100000,1.1548
215.158.238.133,<->,29.211.186.218,7,2834,0,0,7,2834,0.624231000,1.2621
146.249.227.139,<->,8.252.221.236,0,0,7,772,7,772,0.624124000,1.2797
136.25.188.55,<->,8.220.51.229,7,1549,0,0,7,1549,0.620492000,0.2812
215.158.239.93,<->,199.20.28.67,7,1053,0,0,7,1053,0.619107000,1.1398
215.158.239.48,<->,207.213.143.199,7,1276,0,0,7,1276,0.618239000,0.4387
215.158.238.177,<->,140.174.85.245,7,392,0,0,7,392,0.617965000,0.0006
92.66.73.171,<->,50.224.76.248,0,0,7,3434,7,3434,0.617709000,0.1341
204.185.190.247,<->,136.25.188.225,0,0,7,1582,7,1582,0.616446000,1.3805
139.36.120.117,<->,99.74.26.144,0,0,7,7582,7,7582,0.616025000,0.0643
205.127.108.113,<->,33.233.141.64,0,0,7,4132,7,4132,0.614491000,1.3630
215.158.239.97,<->,199.20.30.36,7,1181,0,0,7,1181,0.611902000,1.1408
215.158.238.223,<->,131.219.110.180,7,1757,0,0,7,1757,0.607724000,0.1025
215.158.238.133,<->,113.23.20.92,7,2706,0,0,7,2706,0.607673000,0.9926
144.85.170.208,<->,98.87.145.92,7,416,0,0,7,416,0.607456000,1.2064
215.158.238.221,<->,33.209.217.41,7,1444,0,0,7,1444,0.606748000,0.2626
111.150.186.1,<->,80.27.156.242,0,0,7,1012,7,1012,0.604637000,0.3354
215.158.238.105,<->,141.162.130.246,7,1421,0,0,7,1421,0.602578000,0.2378
215.158.239.59,<->,118.20.100.89,7,4071,0,0,7,4071,0.601078000,1.3703
215.158.239.32,<->,106.188.214.42,7,1887,0,0,7,1887,0.596191000,0.2882
145.170.226.128,<->,8.183.25.25,0,0,7,712,7,712,0.590699000,0.3932
136.25.189.32,<->,38.104.11.60,7,2962,0,0,7,2962,0.590577000,0.6118
136.25.189.77,<->,96.156.169.252,7,2909,0,0,7,2909,0.589751000,0.9036
215.158.239.37,<->,96.135.154.147,7,6604,0,0,7,6604,0.586626000,0.2512
215.158.238.111,<->,145.116.209.80,7,1308,0,0,7,1308,0.585449000,0.1849
207.63.43.133,<->,136.25.188.255,0,0,7,1232,7,1232,0.583987000,0.9867
136.25.189.0,<->,96.156.169.168,7,3310,0,0,7,3310,0.583404000,0.4294
136.25.189.202,<->,129.222.36.164,7,5367,0,0,7,5367,0.581718000,0.6593
215.158.239.93,<->,199.20.29.220,7,468,0,0,7,468,0.579900000,0.0707
192.64.247.113,<->,8.45.162.111,7,4357,0,0,7,4357,0.579507000,0.3188
133.178.226.29,<->,29.213.219.30,7,1565,0,0,7,1565,0.578894000,0.1297
215.158.239.17,<->,80.57.141.171,7,1488,0,0,7,1488,0.576873000,0.0307
215.158.140.207,<->,136.193.48.243,7,1829,0,0,7,1829,0.572714000,0.3409
133.178.227.16,<->,61.72.108.214,7,2435,0,0,7,2435,0.570431000,1.4064
136.25.189.63,<->,96.156.169.224,7,4823,0,0,7,4823,0.568666000,0.8398
215.158.239.95,<->,199.20.28.170,7,1909,0,0,7,1909,0.568177000,1.2998
215.158.239.79,<->,199.70.221.36,7,1217,0,0,7,1217,0.566913000,0.3301
222.152.113.238,<->,136.25.188.253,0,0,7,362,7,362,0.566686000,0.3932
142.247.209.45,<->,136.25.188.243,0,0,7,1597,7,1597,0.562474000,1.0876
215.158.239.56,<->,199.20.7.119,7,2732,0,0,7,2732,0.561767000,0.7910
80.40.17.186,<->,22.249.18.74,7,9674,0,0,7,9674,0.559013000,0.0000
215.158.238.97,<->,80.47.111.74,7,2610,0,0,7,2610,0.558221000,1.2250
156.135.202.220,<->,50.223.3.230,0,0,7,827,7,827,0.554449000,1.3941
136.25.189.16,<->,106.188.253.155,7,3991,0,0,7,3991,0.554026000,0.7211
6.145.171.103,<->,0.195.210.44,0,0,7,711,7,711,0.554014000,0.2259
246.254.97.112,<->,132.128.61.12,7,5189,0,0,7,5189,0.552316000,0.2265
136.25.189.76,<->,96.156.169.229,7,3522,0,0,7,3522,0.551544000,1.4441
8.182.244.237,<->,6.242.29.210,7,1739,0,0,7,1739,0.550474000,1.4449
194.237.143.124,<->,136.25.188.222,0,0,7,1144,7,1144,0.547346000,1.3699
239.66.119.155,<->,159.137.235.224,0,0,7,784,7,784,0.546784000,0.9501
142.227.67.136,<->,136.25.188.198,0,0,7,621,7,621,0.544348000,1.2588
196.246.182.145,<->,136.25.188.176,0,0,7,722,7,722,0.543407000,1.0759
136.25.188.45,<->,6.25.234.209,7,692,0,0,7,692,0.542125000,0.2841
215.158.238.148,<->,29.213.195.62,7,2978,0,0,7,2978,0.539760000,1.4378
215.158.239.99,<->,196.108.135.169,7,602,0,0,7,602,0.538378000,1.3606
92.27.219.245,<->,33.57.79.34,7,9772,0,0,7,9772,0.535881000,0.8001
133.178.226.76,<->,38.20.151.87,7,1565,0,0,7,1565,0.534973000,0.7765
142.249.254.11,<->,136.25.188.196,0,0,7,779,7,779,0.533680000,0.7377
143.155.227.43,<->,133.178.226.37,0,0,7,1641,7,1641,0.533393000,1.1744
80.41.248.41,<->,8.35.106.58,7,4827,0,0,7,4827,0.531717000,0.3655
195.85.180.58,<->,8.252.222.28,0,0,7,931,7,931,0.530094000,1.1135
143.68.254.229,<->,136.25.188.198,0,0,7,1532,7,1532,0.529675000,0.9459
203.215.2.29,<->,42.204.12.30,7,3656,0,0,7,3656,0.529034000,1.3760
136.25.189.13,<->,118.20.100.66,7,4103,0,0,7,4103,0.526219000,1.4433
207.61.73.235,<->,136.25.188.241,0,0,7,686,7,686,0.524974000,1.1021
195.40.9.209,<->,136.25.188.243,0,0,7,1101,7,1101,0.524227000,0.9066
215.158.239.113,<->,129.222.36.182,7,2696,0,0,7,2696,0.523645000,1.0443
136.25.189.39,<->,96.156.169.164,7,6860,0,0,7,6860,0.522625000,0.2800
215.158.238.123,<->,114.166.219.43,7,392,0,0,7,392,0.521298000,0.0019
215.158.238.98,<->,33.209.217.237,7,2941,0,0,7,2941,0.520395000,0.9242
136.25.188.38,<->,56.19.241.86,7,10321,0,0,7,10321,0.515893000,0.0001
136.25.188.44,<->,29.214.64.169,7,1709,0,0,7,1709,0.515678000,0.2907
215.158.239.56,<->,207.61.237.77,7,686,0,0,7,686,0.514746000,0.8486
159.137.249.250,<->,114.243.233.92,7,742,0,0,7,742,0.514664000,1.4314
122.213.95.243,<->,50.224.76.235,0,0,7,1457,7,1457,0.512276000,0.1463
215.158.238.133,<->,114.166.219.43,7,1485,0,0,7,1485,0.509147000,0.3489
144.83.112.139,<->,133.54.17.198,0,0,7,585,7,585,0.505499000,0.1343
215.158.239.92,<->,199.20.31.236,7,1902,0,0,7,1902,0.504349000,1.4510
121.41.16.213,<->,92.27.219.194,0,0,7,2668,7,2668,0.504148000,1.0020
149.96.171.91,<->,136.25.189.45,0,0,7,2834,7,2834,0.503021000,0.6944
224.148.53.203,<->,132.118.97.71,7,3498,0,0,7,3498,0.502058000,0.2983
204.184.220.17,<->,136.25.188.176,0,0,7,1275,7,1275,0.500194000,0.5044
136.181.42.94,<->,0.195.216.193,7,4933,0,0,7,4933,0.498766000,1.4327
215.158.238.81,<->,8.240.117.16,7,1453,0,0,7,1453,0.494171000,0.6951
215.158.239.78,<->,199.20.31.244,7,1113,0,0,7,1113,0.492289000,1.4199
136.25.189.77,<->,114.25.48.20,7,4151,0,0,7,4151,0.491211000,1.2299
215.158.239.87,<->,143.44.174.59,7,908,0,0,7,908,0.490634000,0.2267
215.158.140.231,<->,126.219.102.25,7,392,0,0,7,392,0.488875000,0.0021
202.33.79.78,<->,136.25.188.179,0,0,7,1166,7,1166,0.488845000,1.4301
215.158.140.76,<->,119.196.23.70,7,1384,0,0,7,1384,0.487969000,0.1256
224.250.56.88,<->,97.126.31.75,0,0,7,8312,7,8312,0.485385000,0.2546
196.247.213.16,<->,136.25.188.45,0,0,7,450,7,450,0.482646000,0.1198
132.249.70.11,<->,53.86.225.211,7,2838,0,0,7,2838,0.481754000,1.1032
204.186.166.56,<->,136.25.188.242,0,0,7,1117,7,1117,0.481260000,0.7800
76.179.37.77,<->,8.252.222.95,0,0,7,633,7,633,0.480051000,0.3204
215.158.239.248,<->,122.159.122.92,7,498,0,0,7,498,0.477911000,0.4210
197.125.126.214,<->,136.25.189.78,0,0,7,4231,7,4231,0.477164000,1.4826
197.113.99.18,<->,136.25.188.54,0,0,7,1377,7,1377,0.477108000,1.3805
106.22.92.216,<->,8.52.166.232,0,0,7,796,7,796,0.474654000,0.2395
215.158.61.183,<->,8.176.8.248,0,0,7,1511,7,1511,0.474605000,1.5086
215.158.238.221,<->,68.231.10.150,7,3543,0,0,7,3543,0.474334000,1.3652
149.133.163.104,<->,89.183.110.72,0,0,7,4359,7,4359,0.473238000,0.3020
192.67.94.121,<->,112.208.20.177,7,1099,0,0,7,1099,0.472723000,1.4487
215.158.239.76,<->,199.20.31.181,7,1244,0,0,7,1244,0.472625000,0.5399
92.27.27.178,<->,92.12.187.214,7,451,0,0,7,451,0.471034000,1.3340
136.25.188.172,<->,8.222.212.22,7,2674,0,0,7,2674,0.470731000,0.2949
136.25.188.202,<->,56.97.186.150,7,9094,0,0,7,9094,0.468772000,0.0001
204.200.53.204,<->,136.25.188.173,0,0,7,944,7,944,0.467619000,0.2676
204.60.9.111,<->,136.25.188.226,0,0,7,575,7,575,0.467591000,0.0097
136.25.188.193,<->,100.224.202.178,7,2192,0,0,7,2192,0.467528000,1.3923
194.205.112.171,<->,136.25.188.255,0,0,7,2994,7,2994,0.463266000,0.8108
220.28.108.254,<->,215.158.238.91,0,0,7,8642,7,8642,0.462701000,0.0053
207.51.228.37,<->,8.252.222.39,0,0,7,392,7,392,0.460941000,0.1911
215.158.238.107,<->,104.154.137.193,7,1661,0,0,7,1661,0.460887000,0.1401
141.125.139.129,<->,8.252.221.206,0,0,7,428,7,428,0.459357000,0.4622
215.158.238.236,<->,126.219.132.231,7,1385,0,0,7,1385,0.457317000,0.1469
215.158.238.133,<->,113.106.118.9,7,1517,0,0,7,1517,0.453686000,0.1600
139.36.119.79,<->,136.25.189.209,0,0,7,4448,7,4448,0.452922000,0.3580
136.25.188.237,<->,48.131.156.26,7,1693,0,0,7,1693,0.451730000,0.3622
136.25.189.14,<->,114.150.180.156,7,2012,0,0,7,2012,0.451699000,0.5789
56.8.135.115,<->,8.182.226.78,0,0,7,706,7,706,0.448581000,0.1370
136.25.188.198,<->,50.18.121.78,7,722,0,0,7,722,0.446754000,0.2783
215.158.238.40,<->,100.224.166.161,7,2191,0,0,7,2191,0.439930000,1.3175
136.25.188.220,<->,8.42.43.36,7,2978,0,0,7,2978,0.435961000,0.4428
195.15.140.54,<->,136.25.188.53,0,0,7,1337,7,1337,0.433391000,0.1094
215.158.61.192,<->,8.252.222.248,0,0,7,2220,7,2220,0.433315000,1.1181
202.33.241.209,<->,136.25.188.254,0,0,7,2645,7,2645,0.431117000,1.3009
203.114.99.122,<->,136.25.188.52,0,0,7,1353,7,1353,0.430923000,0.1397
100.120.38.6,<->,92.27.194.38,0,0,7,3038,7,3038,0.430798000,1.1661
136.25.189.46,<->,113.92.151.54,7,2962,0,0,7,2962,0.430517000,1.3638
195.42.102.7,<->,136.25.188.222,0,0,7,696,7,696,0.428325000,0.8525
194.232.97.10,<->,136.25.188.254,0,0,7,958,7,958,0.427639000,0.9635
36.123.55.193,<->,8.20.87.7,0,0,7,793,7,793,0.426266000,0.5777
136.25.188.226,<->,80.47.111.75,7,392,0,0,7,392,0.425706000,0.0043
109.222.217.220,<->,53.231.222.144,7,932,0,0,7,932,0.421903000,0.2797
215.158.239.97,<->,196.0.101.103,7,1133,0,0,7,1133,0.420617000,0.2502
215.158.238.81,<->,122.159.245.165,7,742,0,0,7,742,0.420541000,1.3105
215.158.239.51,<->,199.20.31.197,7,464,0,0,7,464,0.415042000,0.5408
207.62.165.29,<->,136.25.188.175,0,0,7,420,7,420,0.415013000,0.7071
144.87.238.89,<->,8.182.244.237,0,0,7,722,7,722,0.411439000,0.3930
215.158.238.148,<->,69.132.194.95,7,1717,0,0,7,1717,0.411388000,0.6981
220.2.207.125,<->,8.220.184.183,0,0,7,1221,7,1221,0.409296000,0.1144
129.16.253.232,<->,91.251.118.203,0,0,7,1374,7,1374,0.409169000,0.0950
148.238.148.147,<->,89.183.110.72,0,0,7,4127,7,4127,0.408033000,0.4331
215.158.238.92,<->,136.139.59.107,7,3847,0,0,7,3847,0.406712000,1.4563
218.147.52.201,<->,8.176.40.207,0,0,7,1191,7,1191,0.406430000,0.1080
220.20.200.29,<->,144.83.60.153,7,5891,0,0,7,5891,0.405259000,1.2537
195.13.183.230,<->,136.25.188.176,0,0,7,468,7,468,0.405247000,0.4081
136.25.189.18,<->,56.161.218.61,7,3911,0,0,7,3911,0.401367000,1.3742
192.227.190.11,<->,133.178.226.70,0,0,7,3938,7,3938,0.400829000,1.5384
204.18.14.27,<->,50.223.3.228,0,0,7,350,7,350,0.399044000,1.5409
136.25.189.80,<->,33.209.219.102,7,4130,0,0,7,4130,0.397962000,1.2558
215.158.238.83,<->,131.144.114.230,7,4023,0,0,7,4023,0.395947000,1.5598
89.183.104.189,<->,83.7.230.68,7,1731,0,0,7,1731,0.390351000,1.2315
207.61.74.42,<->,136.25.188.176,0,0,7,946,7,946,0.388534000,0.4214
195.214.29.232,<->,50.223.3.228,0,0,7,576,7,576,0.388460000,0.4046
142.247.230.225,<->,136.25.188.242,0,0,7,392,7,392,0.388211000,0.0087
100.110.29.161,<->,92.27.219.36,0,0,7,484,7,484,0.387310000,1.0680
246.253.253.113,<->,210.209.251.211,7,3531,0,0,7,3531,0.384967000,0.1715
246.254.97.230,<->,139.33.174.12,7,896,0,0,7,896,0.384452000,0.1036
215.158.239.6,<->,96.135.154.151,7,3834,0,0,7,3834,0.382613000,1.0784
96.143.113.148,<->,8.52.222.23,0,0,7,1715,7,1715,0.382353000,0.3576
222.65.22.201,<->,8.49.69.111,7,4842,0,0,7,4842,0.381921000,0.0805
215.158.239.99,<->,113.23.66.200,7,3170,0,0,7,3170,0.379996000,0.3582
207.61.147.23,<->,136.25.188.226,0,0,7,1712,7,1712,0.377271000,0.5876
215.158.238.105,<->,29.214.73.156,7,2290,0,0,7,2290,0.375321000,1.0185
136.25.189.30,<->,96.156.169.195,7,3510,0,0,7,3510,0.374267000,0.9239
215.158.239.78,<->,196.106.168.39,7,464,0,0,7,464,0.371384000,0.9504
196.247.220.182,<->,136.25.188.174,0,0,7,584,7,584,0.371096000,0.5800
215.158.239.58,<->,199.20.30.123,7,850,0,0,7,850,0.370470000,1.6099
215.158.239.49,<->,199.20.31.199,7,742,0,0,7,742,0.369267000,1.0302
215.158.239.56,<->,196.109.86.160,7,684,0,0,7,684,0.367391000,0.9001
215.158.239.92,<->,199.122.248.201,7,946,0,0,7,946,0.366582000,0.5926
215.158.239.50,<->,195.43.176.39,7,474,0,0,7,474,0.365969000,1.0628
136.25.188.47,<->,122.158.52.199,7,1565,0,0,7,1565,0.364309000,0.2114
111.150.207.179,<->,99.74.87.227,0,0,7,392,7,392,0.364183000,0.0397
136.25.188.163,<->,84.223.184.252,7,696,0,0,7,696,0.359701000,1.4279
204.186.200.254,<->,136.25.188.243,0,0,7,392,7,392,0.359472000,1.1572
144.83.60.153,<->,92.162.253.59,0,0,7,4730,7,4730,0.357765000,0.1203
133.178.226.71,<->,69.31.239.13,7,1456,0,0,7,1456,0.354566000,0.3516
136.25.188.226,<->,112.220.206.107,7,2288,0,0,7,2288,0.353796000,1.6170
48.129.133.22,<->,8.252.222.241,0,0,7,2882,7,2882,0.351994000,1.5077
8.182.224.87,<->,6.20.24.119,7,1542,0,0,7,1542,0.351889000,1.0014
204.200.39.123,<->,136.25.188.252,0,0,7,958,7,958,0.351170000,0.3875
143.184.194.248,<->,92.27.27.172,0,0,7,724,7,724,0.348918000,1.5672
215.158.238.67,<->,122.158.49.149,7,2237,0,0,7,2237,0.348847000,1.1797
196.204.59.224,<->,136.25.188.238,0,0,7,626,7,626,0.348607000,1.4600
215.158.238.134,<->,144.253.73.100,7,2977,0,0,7,2977,0.347387000,0.8673
215.158.239.96,<->,196.106.28.64,7,392,0,0,7,392,0.347012000,0.1019
48.19.239.25,<->,8.252.222.156,0,0,7,702,7,702,0.346427000,0.8557
215.158.238.139,<->,97.174.232.252,7,2189,0,0,7,2189,0.345302000,1.5121
215.158.239.84,<->,38.104.11.27,7,2914,0,0,7,2914,0.344284000,0.8596
215.158.140.172,<->,99.124.164.35,7,1195,0,0,7,1195,0.343671000,1.0942
136.18.189.12,<->,98.236.235.93,0,0,7,392,7,392,0.341621000,1.6113
195.5.111.87,<->,136.25.188.222,0,0,7,1233,7,1233,0.338363000,0.4172
136.25.189.202,<->,129.222.39.124,7,1371,0,0,7,1371,0.337731000,0.0664
144.87.238.91,<->,8.182.241.94,0,0,7,1422,7,1422,0.336505000,0.0472
215.158.238.66,<->,29.214.73.149,7,1421,0,0,7,1421,0.335496000,0.2207
197.113.99.91,<->,136.25.188.253,0,0,7,450,7,450,0.331708000,0.3905
136.25.188.162,<->,8.222.212.22,7,3022,0,0,7,3022,0.330229000,0.5518
199.121.63.52,<->,136.25.188.220,0,0,7,2166,7,2166,0.328680000,1.4812
144.85.170.248,<->,91.69.185.190,7,1262,0,0,7,1262,0.327410000,1.6703
215.158.238.45,<->,192.226.161.103,7,1677,0,0,7,1677,0.327004000,1.0624
54.36.85.60,<->,48.53.125.245,0,0,7,5674,7,5674,0.326145000,1.2694
215.158.239.19,<->,125.84.52.247,7,1859,0,0,7,1859,0.325638000,0.2186
215.158.239.70,<->,199.20.30.79,7,1240,0,0,7,1240,0.324132000,1.1706
215.158.238.190,<->,148.190.126.56,7,3688,0,0,7,3688,0.323730000,1.6482
143.94.164.184,<->,136.25.188.176,0,0,7,1179,7,1179,0.320435000,1.4258
207.57.54.142,<->,136.25.188.236,0,0,7,392,7,392,0.317779000,0.0244
142.236.138.104,<->,136.25.188.162,0,0,7,476,7,476,0.317230000,1.4331
120.126.50.203,<->,50.224.76.248,0,0,7,4514,7,4514,0.315047000,0.4832
215.158.238.149,<->,6.116.14.42,7,2946,0,0,7,2946,0.314142000,1.1622
246.253.253.170,<->,0.195.197.23,7,4017,0,0,7,4017,0.314071000,0.5428
215.158.239.79,<->,196.89.124.85,7,1339,0,0,7,1339,0.311643000,0.9480
215.158.239.76,<->,8.249.253.226,7,2818,0,0,7,2818,0.310843000,1.0711
215.158.239.76,<->,199.20.7.11,7,2687,0,0,7,2687,0.310832000,1.5400
215.158.238.135,<->,57.199.250.198,7,1693,0,0,7,1693,0.308680000,0.2987
139.163.96.127,<->,6.96.25.153,7,362,0,0,7,362,0.308627000,1.0622
136.25.188.237,<->,48.129.132.228,7,1437,0,0,7,1437,0.307991000,0.2202
72.157.196.58,<->,0.195.210.8,0,0,7,756,7,756,0.306468000,0.2092
215.158.61.242,<->,136.25.188.34,0,0,7,8434,7,8434,0.305991000,0.9735
111.20.40.252,<->,109.222.250.37,0,0,7,1142,7,1142,0.305034000,0.6855
136.25.188.224,<->,111.151.70.52,7,1677,0,0,7,1677,0.304372000,0.1165
132.128.61.37,<->,109.1.26.128,0,0,7,4542,7,4542,0.304350000,0.1949
197.113.99.237,<->,136.25.188.226,0,0,7,1960,7,1960,0.303843000,1.5403
199.82.159.149,<->,136.25.188.163,0,0,7,544,7,544,0.301737000,1.3184
207.173.101.95,<->,136.25.188.160,0,0,7,1149,7,1149,0.301630000,1.1403
128.204.120.234,<->,108.134.98.139,0,0,7,1273,7,1273,0.301581000,1.4254
215.158.238.95,<->,199.71.90.68,7,2658,0,0,7,2658,0.301123000,0.6047
192.224.21.33,<->,133.178.226.28,0,0,7,2962,7,2962,0.300502000,0.8492
215.158.239.92,<->,207.63.144.128,7,4060,0,0,7,4060,0.300342000,1.4005
125.196.62.17,<->,89.183.104.167,0,0,7,10199,7,10199,0.298389000,0.5393
149.17.149.6,<->,89.153.90.223,0,0,7,428,7,428,0.298353000,1.0138
215.158.239.51,<->,194.232.15.33,7,1235,0,0,7,1235,0.298031000,0.5208
158.186.77.27,<->,89.183.104.171,0,0,7,895,7,895,0.297116000,1.5056
133.178.226.7,<->,113.23.104.220,7,742,0,0,7,742,0.296035000,1.4639
215.158.239.50,<->,118.20.100.122,7,5244,0,0,7,5244,0.295335000,1.2687
215.158.61.145,<->,136.25.188.37,0,0,7,2280,7,2280,0.293329000,1.6374
199.51.165.49,<->,136.25.188.174,0,0,7,696,7,696,0.292296000,0.8567
215.158.239.49,<->,126.219.191.24,7,5084,0,0,7,5084,0.289616000,1.0817
204.187.230.96,<->,136.25.188.55,0,0,7,556,7,556,0.289599000,0.8249
215.158.238.64,<->,30.249.194.149,7,392,0,0,7,392,0.289587000,0.1369
238.110.17.81,<->,50.224.76.235,0,0,7,4105,7,4105,0.289518000,0.2117
136.25.189.30,<->,8.33.226.56,7,3927,0,0,7,3927,0.288431000,1.6108
98.230.212.157,<->,8.182.253.100,0,0,7,987,7,987,0.287293000,0.2546
103.18.19.214,<->,50.224.49.195,0,0,7,428,7,428,0.287030000,1.3529
136.25.189.14,<->,96.156.169.222,7,3746,0,0,7,3746,0.287021000,0.9656
207.60.155.192,<->,136.25.188.253,0,0,7,1101,7,1101,0.283888000,1.1808
108.35.240.113,<->,8.52.136.119,0,0,7,902,7,902,0.283533000,0.3489
111.147.173.53,<->,53.214.245.11,7,586,0,0,7,586,0.282671000,1.0475
192.182.154.158,<->,50.224.49.196,0,0,7,392,7,392,0.281955000,1.5812
215.158.238.221,<->,106.188.253.229,7,2414,0,0,7,2414,0.281785000,1.2265
215.158.238.241,<->,192.171.32.145,7,2595,0,0,7,2595,0.276740000,0.8660
129.236.114.39,<->,33.233.141.39,0,0,7,8176,7,8176,0.275074000,0.0011
196.245.75.18,<->,136.25.188.208,0,0,7,1422,7,1422,0.274981000,1.1389
245.157.29.59,<->,0.195.210.14,0,0,7,488,7,488,0.273190000,1.6141
220.28.73.211,<->,215.158.239.88,0,0,7,7655,7,7655,0.271830000,0.3866
17.255.107.2,<->,8.220.191.251,0,0,7,901,7,901,0.271200000,0.0559
248.232.242.136,<->,92.27.219.61,0,0,7,1771,7,1771,0.270964000,1.5584
195.69.233.232,<->,136.25.188.196,0,0,7,988,7,988,0.269830000,1.6892
137.46.169.48,<->,50.224.105.44,0,0,7,392,7,392,0.266180000,1.5877
215.158.239.86,<->,113.23.14.217,7,4007,0,0,7,4007,0.266155000,1.4666
215.158.239.56,<->,142.182.53.83,7,695,0,0,7,695,0.265565000,1.3984
136.25.188.238,<->,116.121.217.57,7,688,0,0,7,688,0.265311000,0.6378
215.158.239.115,<->,215.158.61.182,7,4356,0,0,7,4356,0.264680000,1.2720
139.172.72.143,<->,8.52.189.207,0,0,7,713,7,713,0.264351000,0.1560
50.224.76.235,<->,17.12.130.178,7,3284,0,0,7,3284,0.263475000,0.0525
136.25.188.163,<->,131.144.113.189,7,3911,0,0,7,3911,0.263350000,1.4352
100.218.98.18,<->,8.252.221.171,0,0,7,3475,7,3475,0.261634000,1.3225
215.158.239.92,<->,142.191.249.107,7,392,0,0,7,392,0.261119000,0.0309
200.174.176.10,<->,54.37.9.160,7,6447,0,0,7,6447,0.260610000,0.9594
215.158.238.198,<->,192.226.161.87,7,1424,0,0,7,1424,0.260110000,0.2558
215.158.238.134,<->,126.219.101.252,7,392,0,0,7,392,0.259733000,0.0016
136.25.188.106,<->,17.153.122.93,7,1204,0,0,7,1204,0.259581000,1.3637
102.81.45.53,<->,92.27.219.129,0,0,7,1059,7,1059,0.258793000,0.1443
93.181.154.76,<->,92.27.219.217,0,0,7,360,7,360,0.256097000,0.5170
199.68.225.45,<->,136.25.188.198,0,0,7,437,7,437,0.255266000,0.0148
215.158.238.32,<->,197.103.151.87,7,1565,0,0,7,1565,0.253981000,0.2376
159.25.67.144,<->,8.182.252.86,0,0,7,914,7,914,0.252770000,0.2825
136.25.188.44,<->,126.219.247.16,7,2802,0,0,7,2802,0.251613000,0.4664
142.191.121.7,<->,136.25.188.255,0,0,7,752,7,752,0.250957000,1.5270
220.39.233.201,<->,215.158.238.115,0,0,7,1613,7,1613,0.248837000,1.1682
212.164.136.31,<->,17.9.174.108,7,392,0,0,7,392,0.248727000,1.7243
215.158.239.8,<->,96.135.154.132,7,3974,0,0,7,3974,0.245980000,1.4378
220.28.114.28,<->,215.158.238.85,0,0,7,8481,7,8481,0.244087000,0.0358
194.233.15.136,<->,136.25.188.226,0,0,7,1932,7,1932,0.243929000,1.2781
138.121.99.24,<->,8.220.190.86,0,0,7,1546,7,1546,0.242752000,0.4287
215.158.238.142,<->,126.219.132.252,7,1549,0,0,7,1549,0.242240000,0.3095
247.136.145.189,<->,42.98.175.99,7,588,0,0,7,588,0.238575000,1.6072
136.25.188.47,<->,119.196.23.40,7,1565,0,0,7,1565,0.237701000,0.2205
225.120.222.185,<->,215.158.238.122,0,0,7,2930,7,2930,0.237269000,1.6818
220.50.242.203,<->,136.25.188.34,0,0,7,3537,7,3537,0.232695000,1.2078
215.158.238.95,<->,111.150.34.250,7,1549,0,0,7,1549,0.232569000,0.2063
204.63.54.230,<->,136.25.188.196,0,0,7,1243,7,1243,0.231923000,1.6604
215.158.239.93,<->,207.63.122.56,7,1020,0,0,7,1020,0.231738000,0.6497
143.207.41.138,<->,50.223.3.228,0,0,7,392,7,392,0.231680000,1.7297
215.158.239.84,<->,196.109.217.85,7,462,0,0,7,462,0.231234000,1.2600
136.25.188.45,<->,113.23.104.203,7,1677,0,0,7,1677,0.226729000,1.1083
142.208.70.147,<->,136.25.188.241,0,0,7,386,7,386,0.226726000,0.4027
133.178.227.27,<->,18.202.90.200,7,3451,0,0,7,3451,0.225893000,1.5706
133.178.227.2,<->,89.86.110.233,7,1424,0,0,7,1424,0.225383000,0.0967
215.158.239.76,<->,207.190.173.163,7,405,0,0,7,405,0.225210000,1.1597
215.158.238.83,<->,131.144.113.216,7,2738,0,0,7,2738,0.225088000,0.8940
80.27.157.15,<->,69.175.101.3,7,2262,0,0,7,2262,0.223543000,0.7893
215.158.238.148,<->,111.151.70.20,7,2690,0,0,7,2690,0.223498000,1.6960
133.178.227.24,<->,126.219.132.211,7,392,0,0,7,392,0.223336000,0.0006
215.158.49.10,<->,29.211.214.254,0,0,7,560,7,560,0.223269000,0.0110
231.139.15.225,<->,136.25.188.55,0,0,7,1235,7,1235,0.222683000,0.4679
215.158.238.132,<->,33.209.217.212,7,4551,0,0,7,4551,0.222155000,1.5109
139.241.56.117,<->,102.51.187.203,0,0,7,10191,7,10191,0.221009000,1.6798
139.163.96.101,<->,135.81.38.138,7,735,0,0,7,735,0.219096000,0.9975
215.158.239.97,<->,199.20.30.153,7,1129,0,0,7,1129,0.218893000,0.7682
215.158.238.83,<->,122.159.245.168,7,4071,0,0,7,4071,0.217746000,1.3477
199.38.118.82,<->,136.25.188.209,0,0,7,1494,7,1494,0.217554000,1.6154
136.25.188.198,<->,57.160.181.180,7,5746,0,0,7,5746,0.217086000,1.7632
103.186.250.103,<->,50.224.49.195,0,0,7,350,7,350,0.216497000,1.6063
215.158.239.58,<->,196.91.6.241,7,428,0,0,7,428,0.215994000,1.7199
192.67.144.149,<->,68.227.84.215,7,5980,0,0,7,5980,0.215681000,1.7445
136.25.188.209,<->,112.220.206.107,7,1421,0,0,7,1421,0.215678000,0.1155
215.158.238.83,<->,143.227.65.227,7,2738,0,0,7,2738,0.214696000,1.1347
142.253.191.143,<->,136.25.188.252,0,0,7,964,7,964,0.214512000,1.6921
231.140.4.123,<->,215.158.239.97,0,0,7,392,7,392,0.214236000,0.1631
136.25.189.82,<->,68.124.221.149,7,3010,0,0,7,3010,0.213576000,1.2678
202.178.8.72,<->,80.38.21.150,0,0,7,350,7,350,0.213380000,0.0001
145.116.209.4,<->,136.25.188.167,0,0,7,7063,7,7063,0.213281000,0.0236
215.158.239.49,<->,145.13.164.209,7,5308,0,0,7,5308,0.210266000,1.3928
215.158.140.60,<->,106.188.253.138,7,3458,0,0,7,3458,0.209939000,0.9629
97.126.112.237,<->,53.86.85.35,7,4624,0,0,7,4624,0.208476000,0.9027
215.158.239.57,<->,207.213.14.202,7,1892,0,0,7,1892,0.207691000,0.7818
215.158.239.84,<->,194.199.218.18,7,556,0,0,7,556,0.207525000,0.4090
215.158.140.83,<->,131.219.230.219,7,2396,0,0,7,2396,0.206242000,1.1400
215.158.239.96,<->,199.20.29.106,7,1370,0,0,7,1370,0.205982000,0.7002
215.158.238.75,<->,112.235.116.36,7,392,0,0,7,392,0.205497000,0.0556
201.136.143.24,<->,136.25.188.220,0,0,7,2946,7,2946,0.204429000,1.3603
229.42.120.192,<->,139.163.96.94,0,0,7,350,7,350,0.203977000,1.7410
133.178.226.28,<->,128.194.247.212,7,2690,0,0,7,2690,0.202151000,1.3123
136.25.188.160,<->,69.31.238.203,7,1677,0,0,7,1677,0.201739000,1.7751
229.61.242.186,<->,92.27.219.181,0,0,7,364,7,364,0.200962000,1.7017
99.115.52.80,<->,8.220.179.94,0,0,7,2078,7,2078,0.200305000,0.0684
144.74.36.234,<->,137.19.242.61,0,0,7,707,7,707,0.199518000,1.5915
216.184.1.90,<->,136.25.188.201,0,0,7,2990,7,2990,0.197127000,0.5506
133.178.227.36,<->,133.56.180.35,7,2817,0,0,7,2817,0.195135000,1.5883
215.158.239.84,<->,126.219.194.82,7,3057,0,0,7,3057,0.194582000,0.3851
215.158.239.57,<->,196.1.222.152,7,1391,0,0,7,1391,0.192934000,0.8204
215.158.239.79,<->,196.107.72.172,7,561,0,0,7,561,0.192800000,1.7190
119.70.121.138,<->,92.27.27.161,0,0,7,379,7,379,0.191419000,1.6643
215.158.238.92,<->,131.144.114.211,7,2818,0,0,7,2818,0.190798000,1.6908
197.113.88.116,<->,144.86.150.79,0,0,7,975,7,975,0.189541000,1.5142
94.192.15.227,<->,8.252.222.44,0,0,7,544,7,544,0.189521000,0.7454
215.158.238.99,<->,33.209.219.44,7,404,0,0,7,404,0.189133000,0.0683
133.178.227.57,<->,126.219.102.8,7,1431,0,0,7,1431,0.188954000,0.2065
215.158.238.67,<->,112.220.206.117,7,1613,0,0,7,1613,0.188860000,1.3209
97.126.46.193,<->,89.86.111.206,7,5778,0,0,7,5778,0.188854000,1.7696
215.158.238.120,<->,112.220.206.117,7,4007,0,0,7,4007,0.188469000,1.7149
231.140.184.139,<->,215.158.239.68,0,0,7,611,7,611,0.187638000,1.4056
195.54.147.188,<->,136.25.188.54,0,0,7,1101,7,1101,0.187456000,0.8665
231.143.109.135,<->,136.25.188.52,0,0,7,892,7,892,0.187103000,1.0914
215.158.239.94,<->,194.237.65.93,7,823,0,0,7,823,0.186359000,0.5021
148.26.113.236,<->,133.178.227.27,0,0,7,1373,7,1373,0.185892000,1.2848
215.158.239.78,<->,199.20.22.94,7,350,0,0,7,350,0.184553000,0.5098
215.158.238.221,<->,29.211.122.244,7,1391,0,0,7,1391,0.183776000,0.9259
207.6.70.159,<->,8.182.139.197,0,0,7,1048,7,1048,0.183542000,0.4881
196.207.51.126,<->,136.25.188.243,0,0,7,1251,7,1251,0.183079000,0.6190
142.228.23.76,<->,136.25.188.255,0,0,7,520,7,520,0.182940000,1.2112
246.253.253.5,<->,53.69.91.156,7,4801,0,0,7,4801,0.181951000,0.4156
159.251.165.170,<->,159.137.237.227,0,0,7,350,7,350,0.181797000,1.7161
215.158.238.134,<->,61.35.124.191,7,1533,0,0,7,1533,0.179180000,1.5752
143.53.209.117,<->,136.25.188.220,0,0,7,696,7,696,0.177683000,1.4135
215.158.239.95,<->,196.106.37.250,7,1973,0,0,7,1973,0.177210000,0.9100
194.169.242.51,<->,92.27.27.158,0,0,7,364,7,364,0.176923000,1.4980
125.216.43.101,<->,8.252.222.241,0,0,7,1693,7,1693,0.176353000,0.2439
133.178.227.76,<->,8.53.216.92,7,2507,0,0,7,2507,0.176081000,1.8039
207.88.56.84,<->,8.52.168.247,0,0,7,350,7,350,0.175206000,1.1443
137.170.13.106,<->,82.237.234.119,0,0,7,1403,7,1403,0.174879000,1.5909
111.147.123.1,<->,53.167.23.222,7,1698,0,0,7,1698,0.174808000,1.7115
195.69.87.202,<->,136.25.188.239,0,0,7,1026,7,1026,0.174250000,1.6914
215.158.238.105,<->,158.192.3.233,7,1565,0,0,7,1565,0.171872000,1.2234
215.158.239.33,<->,149.96.60.149,7,2987,0,0,7,2987,0.171770000,1.7597
215.158.239.96,<->,196.104.132.152,7,392,0,0,7,392,0.171736000,0.0814
142.227.132.171,<->,136.25.188.54,0,0,7,1234,7,1234,0.170166000,0.2101
215.158.61.193,<->,8.176.8.188,0,0,7,7318,7,7318,0.167670000,1.7477
215.158.140.206,<->,133.20.250.202,7,2033,0,0,7,2033,0.167602000,1.0451
215.158.238.82,<->,104.3.169.46,7,1581,0,0,7,1581,0.167286000,1.6103
195.43.114.8,<->,136.25.188.55,0,0,7,1423,7,1423,0.166613000,0.2828
192.67.128.184,<->,144.91.199.50,7,8751,0,0,7,8751,0.165742000,1.1464
80.27.153.42,<->,79.61.207.242,7,2683,0,0,7,2683,0.165578000,1.1204
142.227.56.211,<->,136.25.188.176,0,0,7,1871,7,1871,0.164437000,1.5475
207.65.185.133,<->,50.223.3.228,0,0,7,452,7,452,0.164343000,1.5363
146.249.226.233,<->,8.252.222.173,0,0,7,595,7,595,0.163732000,0.6402
136.25.189.80,<->,133.146.0.182,7,4183,0,0,7,4183,0.162874000,1.6732
215.158.140.83,<->,48.129.132.249,7,3673,0,0,7,3673,0.162395000,1.8132
215.158.239.49,<->,199.20.31.76,7,1101,0,0,7,1101,0.161150000,0.1902
215.158.61.145,<->,8.176.8.194,0,0,7,4783,7,4783,0.160146000,1.2663
215.158.239.95,<->,142.207.217.218,7,914,0,0,7,914,0.159334000,1.3651
215.158.239.69,<->,199.20.30.137,7,1252,0,0,7,1252,0.158631000,0.2999
195.55.219.201,<->,136.25.188.253,0,0,7,482,7,482,0.158455000,0.7130
113.22.2.222,<->,100.228.42.100,0,0,7,1048,7,1048,0.157883000,0.3870
215.158.140.83,<->,29.214.211.23,7,2372,0,0,7,2372,0.157513000,1.2877
136.25.188.162,<->,131.144.113.188,7,2866,0,0,7,2866,0.157393000,0.7567
92.27.219.189,<->,33.57.78.125,7,1047,0,0,7,1047,0.155879000,0.4781
97.126.24.146,<->,54.43.168.35,7,362,0,0,7,362,0.154980000,1.2810
215.158.239.96,<->,196.92.118.173,7,1392,0,0,7,1392,0.154881000,1.7108
143.20.162.20,<->,136.25.188.53,0,0,7,2789,7,2789,0.152796000,0.9643
200.10.139.22,<->,8.252.221.196,0,0,7,535,7,535,0.152567000,0.9194
215.158.239.96,<->,196.93.124.105,7,1478,0,0,7,1478,0.152307000,1.5203
215.158.239.69,<->,65.27.228.181,7,2834,0,0,7,2834,0.152174000,1.5554
101.70.115.232,<->,53.161.31.120,7,3175,0,0,7,3175,0.150726000,0.1757
215.158.239.93,<->,199.15.43.224,7,1214,0,0,7,1214,0.150301000,1.1839
204.60.28.147,<->,136.25.188.222,0,0,7,392,7,392,0.149236000,1.7096
210.158.44.246,<->,121.79.36.182,7,5063,0,0,7,5063,0.148541000,0.3525
215.158.239.95,<->,199.20.30.137,7,492,0,0,7,492,0.148524000,0.1511
215.158.239.93,<->,199.20.5.124,7,1080,0,0,7,1080,0.148374000,1.7248
136.25.189.46,<->,126.219.194.60,7,4391,0,0,7,4391,0.147974000,0.4790
133.178.227.76,<->,114.171.18.232,7,392,0,0,7,392,0.147737000,0.0005
139.246.60.47,<->,8.250.152.93,0,0,7,3602,7,3602,0.143040000,0.9481
215.158.238.104,<->,80.47.111.11,7,2866,0,0,7,2866,0.141997000,0.9456
215.158.238.99,<->,57.199.251.51,7,392,0,0,7,392,0.141497000,0.0014
144.75.218.246,<->,132.200.124.228,7,1352,0,0,7,1352,0.140683000,1.5070
207.178.51.137,<->,50.224.96.57,0,0,7,376,7,376,0.140585000,0.5791
251.21.231.243,<->,109.222.225.140,0,0,7,9828,7,9828,0.140574000,1.8390
243.148.62.228,<->,0.195.210.42,0,0,7,506,7,506,0.139430000,1.6502
195.14.253.27,<->,136.25.188.236,0,0,7,392,7,392,0.137329000,0.1833
215.158.239.57,<->,199.20.28.155,7,392,0,0,7,392,0.136915000,0.6704
195.13.64.188,<->,136.25.188.252,0,0,7,624,7,624,0.136807000,0.6768
136.25.188.52,<->,8.252.210.250,7,3911,0,0,7,3911,0.136790000,1.2950
247.136.136.13,<->,127.93.47.235,7,394,0,0,7,394,0.136755000,1.1362
215.158.239.95,<->,199.20.30.159,7,392,0,0,7,392,0.136275000,0.0600
148.60.121.245,<->,133.178.226.19,0,0,7,1565,7,1565,0.136085000,0.7046
215.158.239.95,<->,195.5.192.89,7,894,0,0,7,894,0.135841000,0.8269
136.25.189.45,<->,29.211.93.15,7,2546,0,0,7,2546,0.135020000,1.6013
215.158.239.57,<->,133.146.0.75,7,4359,0,0,7,4359,0.134232000,1.6385
215.158.238.148,<->,113.20.94.112,7,1533,0,0,7,1533,0.132305000,1.3949
246.253.168.245,<->,131.0.89.188,7,4622,0,0,7,4622,0.130100000,0.3234
136.25.188.175,<->,122.158.49.128,7,3362,0,0,7,3362,0.129889000,1.7510
215.158.238.148,<->,113.23.104.246,7,2578,0,0,7,2578,0.128959000,1.6741
197.113.99.166,<->,136.25.188.220,0,0,7,392,7,392,0.128944000,1.6613
196.30.154.72,<->,50.223.3.228,0,0,7,380,7,380,0.128863000,0.9474
215.158.238.123,<->,149.99.92.107,7,2690,0,0,7,2690,0.128716000,1.8710
215.158.239.79,<->,204.2.2.173,7,626,0,0,7,626,0.127884000,1.8644
215.158.238.32,<->,112.235.95.7,7,4471,0,0,7,4471,0.127785000,1.6333
136.25.189.7,<->,0.195.237.14,7,9106,0,0,7,9106,0.125983000,0.0001
136.138.112.251,<->,136.25.188.241,0,0,7,1533,7,1533,0.125762000,1.6508
215.158.238.64,<->,126.219.132.253,7,1677,0,0,7,1677,0.124714000,1.7491
215.158.238.82,<->,38.70.89.11,7,392,0,0,7,392,0.124347000,0.0622
133.178.226.31,<->,113.23.104.221,7,2802,0,0,7,2802,0.123849000,0.2473
215.158.239.51,<->,196.93.164.219,7,1168,0,0,7,1168,0.123599000,1.3025
215.158.61.189,<->,8.176.8.106,0,0,7,4862,7,4862,0.123291000,1.5799
199.39.201.36,<->,136.25.188.243,0,0,7,392,7,392,0.122846000,0.0529
215.158.238.85,<->,100.224.166.163,7,2191,0,0,7,2191,0.122530000,1.5626
139.163.96.94,<->,74.169.213.180,7,350,0,0,7,350,0.122007000,1.3791
8.252.222.37,<->,4.122.53.95,7,537,0,0,7,537,0.120432000,0.5799
136.25.189.32,<->,29.212.199.58,7,4023,0,0,7,4023,0.120353000,1.7922
98.236.235.234,<->,46.44.136.192,7,392,0,0,7,392,0.119129000,1.7706
215.158.238.143,<->,122.159.245.149,7,2834,0,0,7,2834,0.117591000,1.7995
215.158.140.241,<->,131.144.115.154,7,2517,0,0,7,2517,0.116505000,1.8833
200.174.195.130,<->,54.58.101.87,7,392,0,0,7,392,0.116007000,1.8044
111.20.172.70,<->,33.233.141.94,0,0,7,882,7,882,0.115257000,1.0016
215.158.239.95,<->,196.89.59.150,7,1351,0,0,7,1351,0.115184000,0.4247
215.158.238.126,<->,100.224.166.122,7,2051,0,0,7,2051,0.115104000,1.3803
204.0.235.242,<->,136.25.188.45,0,0,7,481,7,481,0.114434000,1.1617
111.20.172.70,<->,33.233.141.96,0,0,7,879,7,879,0.113889000,1.0029
57.133.55.41,<->,50.224.76.248,0,0,7,4291,7,4291,0.112248000,0.1944
110.2.24.238,<->,80.41.14.90,0,0,7,826,7,826,0.111417000,0.6738
111.20.172.70,<->,111.20.168.12,0,0,7,866,7,866,0.111186000,1.0071
202.33.255.254,<->,136.25.188.240,0,0,7,1254,7,1254,0.110895000,1.3589
215.158.239.50,<->,196.90.43.112,7,1335,0,0,7,1335,0.110205000,1.8205
239.66.110.113,<->,203.215.177.29,0,0,7,967,7,967,0.109845000,1.8244
142.255.77.184,<->,136.25.188.55,0,0,7,392,7,392,0.109775000,0.1217
207.56.188.98,<->,136.25.188.226,0,0,7,1263,7,1263,0.109437000,0.3289
139.241.56.102,<->,80.40.51.71,0,0,7,10191,7,10191,0.109114000,1.6699
207.92.143.135,<->,8.252.222.197,0,0,7,368,7,368,0.108739000,1.6142
246.253.253.215,<->,195.0.105.61,7,491,0,0,7,491,0.108447000,1.8802
111.20.172.70,<->,33.233.141.84,0,0,7,1012,7,1012,0.107831000,1.0042
136.25.189.82,<->,106.188.253.233,7,4167,0,0,7,4167,0.107161000,1.6460
111.20.172.70,<->,33.233.141.52,0,0,7,759,7,759,0.105886000,0.9993
89.183.104.148,<->,29.135.81.110,7,1055,0,0,7,1055,0.105726000,0.6587
92.168.217.138,<->,88.1.113.142,7,392,0,0,7,392,0.104591000,1.0280
215.158.239.6,<->,8.222.7.169,7,1625,0,0,7,1625,0.103704000,0.2936
194.232.231.194,<->,92.27.194.147,0,0,7,611,7,611,0.102145000,0.3903
215.158.61.209,<->,8.252.222.250,0,0,7,2803,7,2803,0.102096000,0.9076
111.20.172.70,<->,111.20.168.27,0,0,7,878,7,878,0.101806000,1.0042
111.20.172.70,<->,33.233.141.97,0,0,7,911,7,911,0.100757000,1.0060
156.164.19.175,<->,92.27.219.217,0,0,7,10290,7,10290,0.099651000,1.6660
215.158.239.48,<->,196.93.125.195,7,404,0,0,7,404,0.099097000,0.2100
92.181.56.219,<->,59.36.39.14,7,626,0,0,7,626,0.098990000,1.0025
215.158.239.77,<->,199.20.28.61,7,404,0,0,7,404,0.098972000,0.0901
215.158.239.51,<->,8.249.253.232,7,1709,0,0,7,1709,0.098690000,1.6417
205.127.108.114,<->,101.224.89.251,0,0,7,3882,7,3882,0.098377000,0.5341
215.158.239.34,<->,111.151.239.84,7,2258,0,0,7,2258,0.098197000,0.0322
215.158.61.242,<->,8.176.8.186,0,0,7,6351,7,6351,0.098142000,1.8367
215.158.238.198,<->,149.250.115.73,7,3462,0,0,7,3462,0.097852000,1.7944
198.154.155.94,<->,50.224.76.230,0,0,7,1003,7,1003,0.097503000,1.1636
101.70.120.140,<->,53.245.67.247,7,350,0,0,7,350,0.096931000,1.7906
125.50.212.165,<->,80.40.9.90,0,0,7,364,7,364,0.096842000,1.6101
136.25.188.47,<->,8.42.43.66,7,1689,0,0,7,1689,0.096475000,1.4609
99.247.166.141,<->,50.224.49.195,0,0,7,392,7,392,0.096412000,1.6304
193.39.70.0,<->,136.25.188.52,0,0,7,392,7,392,0.096379000,0.0026
58.202.32.58,<->,8.252.221.204,0,0,7,752,7,752,0.095472000,1.0270
215.158.239.96,<->,142.209.141.104,7,437,0,0,7,437,0.095268000,0.0613
136.25.188.44,<->,111.151.70.41,7,1581,0,0,7,1581,0.094839000,0.8662
80.38.53.9,<->,0.34.37.102,7,350,0,0,7,350,0.094420000,0.1358
215.158.239.93,<->,199.20.28.242,7,1011,0,0,7,1011,0.093397000,0.7302
205.127.108.113,<->,33.233.141.12,0,0,7,2287,7,2287,0.092408000,1.2282
145.89.107.138,<->,98.236.235.93,0,0,7,392,7,392,0.092135000,1.6380
133.178.226.90,<->,112.235.95.26,7,2802,0,0,7,2802,0.091425000,0.5936
111.20.172.70,<->,111.20.168.141,0,0,7,857,7,857,0.091194000,1.0123
197.113.99.98,<->,136.25.188.46,0,0,7,1251,7,1251,0.090947000,1.8995
139.241.56.117,<->,99.75.233.204,0,0,7,10192,7,10192,0.090836000,1.6669
139.241.56.116,<->,100.92.203.223,0,0,7,10191,7,10191,0.090250000,1.6680
215.158.239.78,<->,98.28.95.84,7,3783,0,0,7,3783,0.089556000,1.7195
89.155.44.123,<->,8.182.251.151,0,0,7,656,7,656,0.088253000,1.3439
95.247.11.76,<->,8.252.221.199,0,0,7,386,7,386,0.088075000,1.9003
215.158.61.193,<->,8.176.8.255,0,0,7,8724,7,8724,0.086601000,0.8677
139.163.96.94,<->,65.67.221.104,7,350,0,0,7,350,0.086457000,1.4718
215.158.239.85,<->,113.23.100.182,7,2786,0,0,7,2786,0.086389000,1.0717
204.187.32.184,<->,136.25.188.252,0,0,7,1284,7,1284,0.085516000,1.7701
204.130.115.164,<->,133.178.227.40,0,0,7,392,7,392,0.085312000,0.0010
221.102.143.189,<->,192.67.90.143,0,0,7,3406,7,3406,0.084510000,0.2069
139.241.56.117,<->,99.72.90.7,0,0,7,10192,7,10192,0.084317000,1.6698
136.25.189.59,<->,29.211.228.215,7,3879,0,0,7,3879,0.083952000,0.7977
136.25.189.59,<->,29.212.180.215,7,1533,0,0,7,1533,0.083223000,0.2283
133.178.227.19,<->,133.56.180.83,7,2994,0,0,7,2994,0.082506000,0.9436
215.158.140.83,<->,131.144.114.248,7,2448,0,0,7,2448,0.082437000,1.8728
207.92.19.255,<->,50.223.3.228,0,0,7,350,7,350,0.081980000,1.8912
215.158.239.32,<->,106.188.184.104,7,2125,0,0,7,2125,0.081626000,0.2626
136.25.189.13,<->,29.212.199.201,7,3010,0,0,7,3010,0.081130000,1.3606
215.158.239.123,<->,215.158.61.243,7,2789,0,0,7,2789,0.080914000,1.2534
195.60.3.120,<->,50.223.3.228,0,0,7,392,7,392,0.079896000,1.7331
149.56.162.236,<->,89.183.104.175,0,0,7,3820,7,3820,0.078621000,1.3834
215.158.140.93,<->,126.219.102.25,7,1373,0,0,7,1373,0.078162000,1.2466
215.158.239.94,<->,29.212.199.221,7,2866,0,0,7,2866,0.077890000,1.8763
145.57.58.33,<->,139.163.8.98,0,0,7,350,7,350,0.077478000,1.7252
136.25.188.255,<->,29.214.108.100,7,2898,0,0,7,2898,0.077198000,0.5127
204.88.227.198,<->,50.223.3.228,0,0,7,368,7,368,0.076260000,1.7302
139.241.56.117,<->,102.83.62.25,0,0,7,10191,7,10191,0.076242000,1.6697
139.163.68.55,<->,8.140.176.33,7,350,0,0,7,350,0.075905000,1.6406
215.158.239.84,<->,142.236.209.44,7,989,0,0,7,989,0.075787000,0.2147
159.152.159.41,<->,139.163.8.98,0,0,7,350,7,350,0.074563000,1.7045
192.204.170.214,<->,136.25.188.162,0,0,7,2978,7,2978,0.071725000,1.9009
215.158.239.70,<->,199.20.29.39,7,456,0,0,7,456,0.071117000,0.2444
141.223.202.226,<->,139.163.7.243,0,0,7,350,7,350,0.070597000,1.8986
112.220.206.101,<->,8.252.223.115,0,0,7,2941,7,2941,0.070252000,1.8333
111.147.134.174,<->,111.27.191.10,7,350,0,0,7,350,0.069715000,1.0362
215.158.239.70,<->,131.144.115.228,7,2850,0,0,7,2850,0.069527000,1.5819
105.106.112.147,<->,50.224.76.234,0,0,7,5050,7,5050,0.068303000,0.4429
99.162.77.146,<->,54.37.35.195,7,4171,0,0,7,4171,0.068238000,0.7345
199.31.24.248,<->,50.223.3.228,0,0,7,362,7,362,0.068039000,1.7792
215.158.239.70,<->,42.97.54.116,7,2898,0,0,7,2898,0.067420000,0.5768
200.174.209.92,<->,53.201.72.62,7,5286,0,0,7,5286,0.067231000,1.2762
54.37.81.137,<->,48.52.146.190,0,0,7,446,7,446,0.067008000,1.7272
89.153.90.193,<->,35.55.57.164,7,844,0,0,7,844,0.066921000,1.7191
215.158.238.221,<->,130.165.253.35,7,3798,0,0,7,3798,0.065770000,1.8645
215.158.140.207,<->,98.249.65.6,7,751,0,0,7,751,0.064727000,0.3548
158.194.83.2,<->,98.236.235.93,0,0,7,392,7,392,0.064123000,1.8673
215.158.239.79,<->,120.154.71.23,7,2974,0,0,7,2974,0.063938000,1.0410
218.4.168.32,<->,8.49.69.216,7,5122,0,0,7,5122,0.063638000,0.3377
99.92.11.156,<->,8.52.133.71,0,0,7,350,7,350,0.063187000,0.2435
144.54.85.141,<->,136.25.188.173,0,0,7,840,7,840,0.062088000,1.7401
215.158.238.132,<->,122.158.51.86,7,2722,0,0,7,2722,0.061666000,1.7865
111.20.172.70,<->,33.233.141.30,0,0,7,911,7,911,0.060314000,1.0220
215.158.140.231,<->,195.65.1.180,7,392,0,0,7,392,0.060069000,0.0015
100.161.107.233,<->,99.75.195.84,0,0,7,5748,7,5748,0.059816000,0.3918
196.146.72.101,<->,8.181.37.222,7,8658,0,0,7,8658,0.059566000,0.0003
103.250.23.108,<->,80.40.50.197,0,0,7,793,7,793,0.059447000,0.5408
129.236.111.48,<->,129.224.112.252,0,0,7,535,7,535,0.059411000,0.0134
149.212.48.173,<->,80.40.16.228,0,0,7,368,7,368,0.058545000,1.7135
143.68.179.58,<->,136.25.188.198,0,0,7,392,7,392,0.058231000,0.0153
136.25.189.33,<->,96.156.169.200,7,4439,0,0,7,4439,0.058089000,1.1140
220.39.29.77,<->,99.74.87.201,0,0,7,568,7,568,0.057807000,1.9325
249.101.105.144,<->,27.11.127.87,7,1033,0,0,7,1033,0.057692000,0.7505
136.25.189.77,<->,122.216.233.153,7,1693,0,0,7,1693,0.057525000,0.1758
203.48.63.129,<->,0.195.210.46,0,0,7,2298,7,2298,0.057445000,1.0680
106.149.180.120,<->,92.27.219.232,0,0,7,8108,7,8108,0.056660000,1.6215
142.43.185.21,<->,8.20.87.206,0,0,7,1544,7,1544,0.056597000,1.2685
136.25.188.254,<->,106.188.236.202,7,1565,0,0,7,1565,0.056130000,0.1493
97.27.254.35,<->,8.52.249.97,0,0,7,7926,7,7926,0.056112000,1.9155
215.158.239.70,<->,204.58.49.172,7,2127,0,0,7,2127,0.055354000,1.8068
113.192.25.253,<->,92.27.219.32,0,0,7,700,7,700,0.055166000,1.7685
142.253.81.150,<->,136.25.188.198,0,0,7,1101,7,1101,0.055160000,0.4432
69.103.121.183,<->,8.252.222.62,0,0,7,978,7,978,0.054149000,0.5888
215.158.239.87,<->,204.56.124.43,7,695,0,0,7,695,0.052886000,0.6911
109.214.180.166,<->,8.52.189.207,0,0,7,707,7,707,0.051537000,0.2437
117.35.5.6,<->,92.27.219.150,0,0,7,6309,7,6309,0.051068000,1.6493
215.158.140.172,<->,8.222.7.181,7,4087,0,0,7,4087,0.050436000,1.9460
130.173.241.227,<->,50.224.76.234,0,0,7,350,7,350,0.050370000,0.0690
215.158.239.57,<->,204.3.233.160,7,492,0,0,7,492,0.050354000,0.0002
216.103.79.133,<->,50.224.49.195,0,0,7,350,7,350,0.050101000,1.6798
215.158.239.95,<->,196.1.176.218,7,392,0,0,7,392,0.049701000,1.1800
196.245.114.205,<->,136.25.188.225,0,0,7,404,7,404,0.049573000,0.5763
215.158.239.57,<->,204.1.250.252,7,1208,0,0,7,1208,0.049239000,1.3960
133.135.201.113,<->,129.6.83.6,0,0,7,1535,7,1535,0.048689000,0.5126
215.158.239.49,<->,207.228.254.5,7,1334,0,0,7,1334,0.048347000,0.5190
215.158.239.56,<->,199.20.28.86,7,2445,0,0,7,2445,0.047927000,1.6590
217.184.226.130,<->,139.163.17.164,0,0,7,350,7,350,0.047850000,1.7232
152.100.10.249,<->,139.163.96.94,0,0,7,350,7,350,0.046749000,1.9354
146.149.77.200,<->,8.252.221.236,0,0,7,758,7,758,0.045564000,1.8026
138.98.250.43,<->,22.5.178.18,7,392,0,0,7,392,0.045046000,1.5988
215.158.238.121,<->,8.222.109.106,7,416,0,0,7,416,0.044377000,1.8724
215.158.239.79,<->,199.20.28.197,7,592,0,0,7,592,0.044347000,1.8996
192.67.143.126,<->,144.253.55.185,7,10191,0,0,7,10191,0.044206000,1.6800
8.182.235.164,<->,6.242.52.183,7,848,0,0,7,848,0.043873000,1.4662
136.25.188.173,<->,133.103.34.36,7,977,0,0,7,977,0.043607000,0.6858
192.204.170.201,<->,136.25.188.44,0,0,7,2786,7,2786,0.043478000,1.9312
215.158.238.243,<->,8.192.205.90,7,1384,0,0,7,1384,0.043118000,1.8066
136.25.188.198,<->,131.1.232.133,7,2194,0,0,7,2194,0.042743000,0.3107
136.25.189.87,<->,56.28.207.196,7,8227,0,0,7,8227,0.042685000,0.4254
215.158.239.50,<->,196.90.95.190,7,1803,0,0,7,1803,0.042633000,1.6396
111.40.65.206,<->,50.224.121.236,0,0,7,410,7,410,0.042485000,0.3274
159.57.90.68,<->,97.149.91.221,0,0,7,4880,7,4880,0.041157000,0.2184
133.178.227.19,<->,29.211.228.168,7,416,0,0,7,416,0.041069000,0.0012
144.85.170.254,<->,98.87.146.17,7,392,0,0,7,392,0.040972000,1.8595
92.168.217.200,<->,50.136.162.200,7,647,0,0,7,647,0.040548000,0.3560
136.25.188.237,<->,99.192.168.153,7,4039,0,0,7,4039,0.039628000,1.0415
204.186.236.140,<->,136.25.188.227,0,0,7,464,7,464,0.039270000,1.6949
80.27.155.20,<->,66.245.119.19,7,4559,0,0,7,4559,0.039239000,1.2681
215.158.239.56,<->,199.15.8.170,7,2451,0,0,7,2451,0.038052000,1.1541
139.241.56.117,<->,6.72.35.95,0,0,7,10191,7,10191,0.036487000,1.6802
215.158.239.50,<->,143.135.157.252,7,1015,0,0,7,1015,0.035503000,0.8055
213.21.35.45,<->,8.220.201.55,0,0,7,1229,7,1229,0.034869000,0.3771
247.136.189.52,<->,139.241.56.117,7,10191,0,0,7,10191,0.034828000,1.6803
111.20.172.70,<->,101.224.89.158,0,0,7,822,7,822,0.034050000,1.9614
222.76.103.134,<->,106.5.208.176,7,2150,0,0,7,2150,0.033995000,1.6846
192.67.143.126,<->,144.253.55.184,7,10192,0,0,7,10192,0.033070000,1.6800
215.158.239.97,<->,207.63.195.37,7,472,0,0,7,472,0.033008000,0.4526
143.23.240.237,<->,136.25.188.222,0,0,7,1033,7,1033,0.032379000,0.8783
50.224.76.235,<->,29.220.119.83,7,5304,0,0,7,5304,0.031953000,0.3094
210.209.251.211,<->,111.147.160.100,0,0,7,6000,7,6000,0.031413000,0.1463
215.158.239.77,<->,207.61.17.38,7,695,0,0,7,695,0.029587000,1.5926
229.70.141.158,<->,139.163.71.245,0,0,7,368,7,368,0.029389000,1.7692
159.137.162.213,<->,112.9.227.40,7,953,0,0,7,953,0.028892000,0.6906
143.227.65.185,<->,133.178.226.18,0,0,7,2722,7,2722,0.028243000,1.7222
215.158.238.176,<->,140.174.84.229,7,392,0,0,7,392,0.027929000,0.0021
133.178.226.28,<->,126.219.58.56,7,1533,0,0,7,1533,0.026464000,0.5344
215.158.140.228,<->,97.125.210.250,7,1465,0,0,7,1465,0.026439000,0.3298
146.224.6.9,<->,8.252.222.38,0,0,7,607,7,607,0.024086000,0.3411
136.25.189.90,<->,96.156.169.212,7,392,0,0,7,392,0.022891000,0.0013
54.37.5.99,<->,48.53.38.95,0,0,7,3648,7,3648,0.022113000,1.1230
220.82.24.60,<->,198.196.222.46,7,1214,0,0,7,1214,0.020597000,1.9193
215.158.238.132,<->,105.193.33.72,7,392,0,0,7,392,0.019802000,0.0016
195.15.42.188,<->,136.25.188.253,0,0,7,1282,7,1282,0.019545000,0.6770
215.158.140.231,<->,131.144.116.10,7,3485,0,0,7,3485,0.019022000,1.8338
127.86.88.161,<->,80.41.12.225,0,0,7,1241,7,1241,0.018838000,0.4874
215.158.239.79,<->,199.20.31.125,7,1270,0,0,7,1270,0.018192000,0.8100
99.187.125.122,<->,8.20.87.10,0,0,7,6548,7,6548,0.017982000,0.0229
220.28.85.14,<->,136.25.189.24,0,0,7,3606,7,3606,0.017140000,0.1462
207.173.69.109,<->,136.25.188.209,0,0,7,660,7,660,0.016618000,1.1589
215.158.238.33,<->,8.190.216.221,7,3010,0,0,7,3010,0.016427000,1.8609
215.158.239.229,<->,145.180.135.157,7,1228,0,0,7,1228,0.014634000,1.4858
143.132.21.98,<->,136.25.188.178,0,0,7,350,7,350,0.014534000,1.1028
136.25.189.15,<->,126.219.190.168,7,1871,0,0,7,1871,0.014462000,0.5685
17.41.75.11,<->,8.220.200.124,0,0,7,694,7,694,0.014199000,0.5219
195.5.201.107,<->,136.25.188.45,0,0,7,1221,7,1221,0.013922000,1.1297
196.248.235.165,<->,50.223.3.228,0,0,7,350,7,350,0.013818000,1.7507
252.98.135.226,<->,106.5.211.7,7,506,0,0,7,506,0.012781000,1.2225
215.158.239.76,<->,199.20.31.88,7,1920,0,0,7,1920,0.012569000,1.7760
139.33.175.144,<->,97.126.106.44,0,0,7,9022,7,9022,0.012501000,0.1640
111.20.172.70,<->,101.224.89.225,0,0,7,852,7,852,0.010975000,1.9865
215.158.239.92,<->,207.191.103.111,7,630,0,0,7,630,0.010952000,1.2504
215.158.140.92,<->,126.219.246.166,7,2438,0,0,7,2438,0.010061000,0.6953
196.87.7.181,<->,136.25.188.253,0,0,7,453,7,453,0.009819000,0.2197
215.158.239.76,<->,192.224.21.49,7,4039,0,0,7,4039,0.009098000,1.0568
80.40.56.250,<->,68.71.78.234,7,440,0,0,7,440,0.008231000,1.8704
215.158.238.149,<->,142.234.196.187,7,2994,0,0,7,2994,0.007557000,1.7877
133.54.43.73,<->,66.58.73.31,7,392,0,0,7,392,0.007396000,0.4800
215.158.239.50,<->,142.207.238.136,7,392,0,0,7,392,0.007392000,1.9427
195.4.240.84,<->,136.25.188.198,0,0,7,350,7,350,0.007058000,0.0340
159.23.130.167,<->,133.178.226.60,0,0,7,392,7,392,0.006833000,0.0003
89.204.29.47,<->,8.182.226.78,0,0,7,2219,7,2219,0.006527000,0.5241
215.158.238.95,<->,120.154.221.233,7,2882,0,0,7,2882,0.005938000,1.8298
195.6.148.119,<->,136.25.188.209,0,0,7,389,7,389,0.005391000,0.9398
239.66.110.113,<->,203.215.177.36,0,0,7,791,7,791,0.005369000,1.9024
231.140.171.197,<->,215.158.239.49,0,0,7,1343,7,1343,0.004918000,0.3444
215.158.239.85,<->,204.3.95.160,7,763,0,0,7,763,0.003597000,1.8101
98.236.206.251,<->,84.202.238.91,7,1757,0,0,7,1757,0.003551000,1.9400
215.158.239.50,<->,195.14.19.52,7,350,0,0,7,350,0.003469000,0.1296
195.42.218.20,<->,136.25.188.222,0,0,7,368,7,368,0.002537000,0.3223
215.158.239.95,<->,196.95.88.122,7,392,0,0,7,392,0.002514000,0.0401
195.13.143.222,<->,136.25.188.55,0,0,7,476,7,476,0.002472000,0.0488
215.158.239.56,<->,199.20.31.20,7,440,0,0,7,440,0.001651000,1.0916
192.204.170.235,<->,133.178.227.79,0,0,7,2664,7,2664,0.001438000,1.8655
139.163.96.127,<->,106.224.58.59,7,362,0,0,7,362,0.001178000,1.8100
142.244.103.49,<->,136.25.188.176,0,0,7,392,7,392,0.001108000,0.0158
215.158.239.56,<->,195.83.43.138,7,392,0,0,7,392,0.000426000,0.0599
111.20.172.70,<->,33.233.141.83,0,0,7,1004,7,1004,0.000282000,1.9978
215.158.34.122,<->,8.252.222.181,0,0,7,8226,7,8226,0.000224000,0.0053
215.158.6.215,<->,133.178.227.76,0,0,7,2549,7,2549,0.000044000,0.9797
102.232.21.59,<->,8.49.69.216,6,4560,0,0,6,4560,1.961088000,0.0381
143.20.129.111,<->,136.25.188.253,0,0,6,400,6,400,1.958031000,0.0162
8.55.223.68,<->,6.228.54.9,0,0,6,4490,6,4490,1.956352000,0.0384
215.158.238.96,<->,192.224.20.32,6,1621,0,0,6,1621,1.952342000,0.0373
215.158.238.163,<->,126.219.234.254,6,336,0,0,6,336,1.946713000,0.0001
202.33.86.90,<->,136.25.188.209,0,0,6,412,6,412,1.942494000,0.0000
215.158.239.99,<->,199.106.249.160,6,412,0,0,6,412,1.942407000,0.0001
136.25.188.234,<->,56.51.205.162,6,6821,0,0,6,6821,1.936775000,0.0081
142.236.24.52,<->,136.25.188.177,0,0,6,412,6,412,1.934623000,0.0169
215.158.61.192,<->,8.176.8.179,0,0,6,4635,6,4635,1.918252000,0.0311
133.8.10.153,<->,33.233.141.116,0,0,6,7838,6,7838,1.914357000,0.0001
215.158.2.9,<->,133.178.226.247,0,0,6,1125,6,1125,1.913238000,0.0548
196.88.7.49,<->,136.25.188.237,0,0,6,412,6,412,1.912209000,0.0044
233.169.19.77,<->,136.25.188.199,0,0,6,908,6,908,1.903766000,0.0587
136.25.188.235,<->,133.56.180.20,6,5749,0,0,6,5749,1.896533000,0.0768
231.136.241.241,<->,136.25.188.241,0,0,6,400,6,400,1.885194000,0.0800
136.25.189.52,<->,96.156.169.224,6,6668,0,0,6,6668,1.882468000,0.0723
202.33.44.121,<->,136.25.188.178,0,0,6,412,6,412,1.878822000,0.0037
195.5.131.126,<->,136.25.188.160,0,0,6,400,6,400,1.877772000,0.0130
89.204.117.248,<->,8.182.252.86,0,0,6,837,6,837,1.874757000,0.0476
101.71.1.223,<->,50.224.76.234,0,0,6,5049,6,5049,1.871019000,0.0763
204.200.39.243,<->,136.25.188.255,0,0,6,400,6,400,1.869896000,0.0098
234.182.161.111,<->,97.126.31.66,0,0,6,671,6,671,1.868315000,0.0776
215.158.239.48,<->,196.90.192.14,6,412,0,0,6,412,1.865805000,0.1203
136.25.188.209,<->,50.150.173.171,6,349,0,0,6,349,1.861441000,0.0274
109.222.252.103,<->,109.57.161.32,6,5552,0,0,6,5552,1.860529000,0.1108
215.158.238.51,<->,129.222.36.146,6,3062,0,0,6,3062,1.857796000,0.0275
132.249.70.208,<->,98.197.185.18,6,492,0,0,6,492,1.855719000,0.0418
246.254.97.104,<->,210.209.251.214,6,886,0,0,6,886,1.848691000,0.0782
247.136.159.39,<->,136.152.91.130,6,3980,0,0,6,3980,1.838953000,0.0774
192.224.20.57,<->,136.25.188.140,0,0,6,1557,6,1557,1.837580000,0.0618
215.158.238.93,<->,99.192.168.160,6,666,0,0,6,666,1.830024000,0.1169
215.158.239.87,<->,143.42.43.107,6,441,0,0,6,441,1.828450000,0.0178
136.25.189.43,<->,98.219.126.140,6,2387,0,0,6,2387,1.820891000,0.1631
136.25.188.199,<->,61.34.33.254,6,412,0,0,6,412,1.820848000,0.0019
127.106.219.2,<->,0.195.210.46,0,0,6,597,6,597,1.819588000,0.1677
143.44.28.196,<->,136.25.188.199,0,0,6,412,6,412,1.818349000,0.0158
26.223.52.82,<->,8.220.190.86,0,0,6,1046,6,1046,1.815161000,0.0439
215.158.239.86,<->,196.1.105.243,6,412,0,0,6,412,1.806732000,0.0400
199.71.10.244,<->,136.25.188.238,0,0,6,1227,6,1227,1.806550000,0.0708
133.178.226.28,<->,124.72.94.156,6,1525,0,0,6,1525,1.798407000,0.1472
144.72.193.17,<->,101.70.109.51,0,0,6,4241,6,4241,1.790865000,0.1848
158.199.107.170,<->,50.224.76.234,0,0,6,4771,6,4771,1.789185000,0.1954
221.102.56.46,<->,192.65.60.185,0,0,6,4844,6,4844,1.788866000,0.1695
215.158.238.95,<->,158.85.46.218,6,1545,0,0,6,1545,1.788765000,0.1651
136.25.189.6,<->,56.28.207.205,6,6619,0,0,6,6619,1.786905000,0.0043
195.55.112.191,<->,136.25.188.241,0,0,6,400,6,400,1.783628000,0.0088
213.186.52.88,<->,144.85.170.254,0,0,6,1048,6,1048,1.780699000,0.1117
192.228.30.207,<->,133.178.227.208,0,0,6,3647,6,3647,1.778140000,0.1610
215.158.238.73,<->,8.223.224.32,6,1621,0,0,6,1621,1.776198000,0.1587
133.178.226.83,<->,96.155.60.247,6,1884,0,0,6,1884,1.773436000,0.0525
215.158.239.85,<->,196.91.210.189,6,336,0,0,6,336,1.769721000,0.0002
215.158.238.135,<->,91.57.173.44,6,2810,0,0,6,2810,1.769008000,0.2196
202.33.49.188,<->,136.25.188.225,0,0,6,400,6,400,1.767344000,0.0071
215.158.239.69,<->,126.219.194.6,6,3032,0,0,6,3032,1.766847000,0.1918
146.193.46.105,<->,8.252.222.158,0,0,6,412,6,412,1.763310000,0.0012
215.158.140.92,<->,106.188.253.183,6,1365,0,0,6,1365,1.754353000,0.1466
220.28.73.211,<->,136.25.189.86,0,0,6,4381,6,4381,1.752410000,0.0556
246.254.97.113,<->,53.160.140.123,6,933,0,0,6,933,1.751896000,0.1213
215.158.239.48,<->,199.20.29.23,6,400,0,0,6,400,1.746266000,0.0101
215.158.238.117,<->,0.195.237.14,6,8330,0,0,6,8330,1.746090000,0.0000
215.158.103.203,<->,33.3.89.166,6,4497,0,0,6,4497,1.738763000,0.1509
239.66.236.28,<->,129.92.117.130,0,0,6,5483,6,5483,1.732279000,0.1446
207.188.231.68,<->,136.25.188.198,0,0,6,885,6,885,1.731286000,0.2500
109.222.241.232,<->,54.53.96.198,6,3701,0,0,6,3701,1.728624000,0.2028
215.201.26.177,<->,8.182.226.78,0,0,6,1334,6,1334,1.722526000,0.1742
215.158.61.182,<->,136.25.188.43,0,0,6,6133,6,6133,1.721037000,0.1368
133.54.43.69,<->,117.0.70.118,6,1063,0,0,6,1063,1.720806000,0.1091
143.89.225.230,<->,136.25.188.238,0,0,6,400,6,400,1.715661000,0.0089
221.102.56.69,<->,102.81.152.248,0,0,6,828,6,828,1.714350000,0.2317
215.158.238.132,<->,100.224.138.212,6,1905,0,0,6,1905,1.710650000,0.1687
145.23.212.61,<->,80.40.0.124,0,0,6,808,6,808,1.707783000,0.1454
199.69.131.82,<->,136.25.188.243,0,0,6,339,6,339,1.706391000,0.0489
158.192.3.218,<->,136.25.188.52,0,0,6,1509,6,1509,1.705713000,0.2280
125.223.103.24,<->,100.228.42.100,0,0,6,5698,6,5698,1.702920000,0.2003
215.158.239.48,<->,196.89.228.182,6,412,0,0,6,412,1.696914000,0.0350
136.62.175.106,<->,8.35.106.46,6,3797,0,0,6,3797,1.696734000,0.0815
121.116.91.122,<->,8.31.37.173,0,0,6,551,6,551,1.691831000,0.2980
247.152.218.158,<->,50.224.76.234,0,0,6,4631,6,4631,1.691410000,0.2561
136.25.189.202,<->,129.222.39.114,6,2834,0,0,6,2834,1.689866000,0.0457
120.47.187.252,<->,80.38.40.56,0,0,6,740,6,740,1.688715000,0.3062
204.187.17.69,<->,136.25.188.222,0,0,6,1176,6,1176,1.688371000,0.2897
89.141.10.60,<->,8.52.223.84,0,0,6,656,6,656,1.686241000,0.2998
143.10.40.48,<->,136.25.188.241,0,0,6,412,6,412,1.685724000,0.0086
145.26.83.1,<->,8.220.202.4,0,0,6,623,6,623,1.684724000,0.2437
220.243.198.21,<->,8.252.222.107,0,0,6,896,6,896,1.683164000,0.0959
249.101.225.116,<->,105.122.151.32,6,3740,0,0,6,3740,1.681689000,0.2763
197.113.99.238,<->,136.25.188.176,0,0,6,400,6,400,1.677396000,0.0500
159.137.162.213,<->,6.210.129.148,6,888,0,0,6,888,1.672922000,0.2181
195.71.83.109,<->,136.25.188.198,0,0,6,412,6,412,1.672173000,0.0888
215.158.239.68,<->,143.128.41.197,6,349,0,0,6,349,1.659054000,0.3086
215.158.238.80,<->,113.106.118.20,6,1477,0,0,6,1477,1.658276000,0.1843
93.147.56.233,<->,50.224.76.235,0,0,6,4972,6,4972,1.656893000,0.2839
129.224.112.252,<->,97.242.126.184,6,390,0,0,6,390,1.648320000,0.3290
111.146.238.243,<->,54.36.97.247,6,3596,0,0,6,3596,1.648246000,0.2470
243.117.83.26,<->,220.55.100.127,0,0,6,925,6,925,1.648214000,0.2463
195.5.131.126,<->,136.25.188.53,0,0,6,400,6,400,1.636505000,0.0075
215.158.61.202,<->,8.176.8.196,0,0,6,6565,6,6565,1.635789000,0.0090
207.57.222.125,<->,136.25.188.253,0,0,6,400,6,400,1.631077000,0.0116
32.236.164.211,<->,8.52.133.228,0,0,6,2007,6,2007,1.624825000,0.2646
213.21.35.44,<->,8.220.176.253,0,0,6,633,6,633,1.623617000,0.1013
143.14.0.13,<->,50.224.76.230,0,0,6,1897,6,1897,1.621862000,0.3126
231.142.37.135,<->,136.25.188.178,0,0,6,1000,6,1000,1.621724000,0.2943
136.25.188.175,<->,112.220.206.63,6,2762,0,0,6,2762,1.616639000,0.3726
215.158.61.145,<->,8.176.8.248,0,0,6,6357,6,6357,1.614681000,0.1790
215.158.238.66,<->,131.1.253.251,6,1610,0,0,6,1610,1.613701000,0.3772
215.158.238.23,<->,131.1.194.204,6,1749,0,0,6,1749,1.612005000,0.1263
204.200.54.97,<->,136.25.188.198,0,0,6,636,6,636,1.611073000,0.3104
199.32.113.255,<->,136.25.188.198,0,0,6,412,6,412,1.609705000,0.0086
198.230.205.140,<->,144.71.44.80,0,0,6,523,6,523,1.609537000,0.2839
195.71.94.186,<->,136.25.188.253,0,0,6,424,6,424,1.609508000,0.0887
196.148.134.124,<->,144.83.112.139,6,529,0,0,6,529,1.609088000,0.0931
215.158.238.104,<->,64.152.12.41,6,1653,0,0,6,1653,1.608758000,0.2490
133.178.226.19,<->,115.140.139.154,6,1589,0,0,6,1589,1.607533000,0.1228
133.178.226.30,<->,56.102.22.9,6,1861,0,0,6,1861,1.601232000,0.1479
120.101.247.61,<->,50.224.76.248,0,0,6,4728,6,4728,1.600956000,0.3387
136.181.43.173,<->,8.45.162.111,6,4133,0,0,6,4133,1.599124000,0.1450
133.32.39.1,<->,80.47.188.76,6,543,0,0,6,543,1.597931000,0.0537
143.227.65.253,<->,133.178.227.14,0,0,6,1509,6,1509,1.596521000,0.2552
215.158.239.96,<->,194.199.197.57,6,349,0,0,6,349,1.596138000,0.1972
136.25.188.161,<->,131.178.248.230,6,1461,0,0,6,1461,1.595550000,0.1042
17.136.211.157,<->,8.220.200.124,0,0,6,630,6,630,1.593723000,0.1484
136.25.189.27,<->,98.219.126.140,6,6028,0,0,6,6028,1.592925000,0.0403
215.158.239.43,<->,122.158.239.9,6,1790,0,0,6,1790,1.590849000,0.1165
111.150.207.168,<->,8.252.221.194,0,0,6,380,6,380,1.586612000,0.2952
215.158.239.56,<->,207.166.123.127,6,1852,0,0,6,1852,1.583625000,0.4117
246.45.209.210,<->,202.178.8.198,6,508,0,0,6,508,1.581628000,0.3948
215.158.239.79,<->,195.54.48.175,6,560,0,0,6,560,1.581196000,0.4071
133.178.227.138,<->,8.191.15.138,6,2927,0,0,6,2927,1.581194000,0.0797
215.158.239.58,<->,142.166.245.240,6,400,0,0,6,400,1.580055000,0.0120
143.132.167.177,<->,136.25.188.199,0,0,6,1208,6,1208,1.576575000,0.3097
142.220.118.197,<->,136.25.188.177,0,0,6,752,6,752,1.572243000,0.4229
205.127.108.113,<->,33.233.141.66,0,0,6,4173,6,4173,1.570024000,0.3417
139.163.161.48,<->,136.25.188.170,0,0,6,5498,6,5498,1.569063000,0.3301
221.102.121.24,<->,192.195.91.232,6,493,0,0,6,493,1.567829000,0.1072
245.161.127.146,<->,8.252.222.187,0,0,6,1838,6,1838,1.566437000,0.3326
144.85.170.208,<->,91.69.185.225,6,1039,0,0,6,1039,1.565561000,0.0814
215.158.238.83,<->,212.70.217.103,6,1621,0,0,6,1621,1.564282000,0.0385
143.10.103.63,<->,136.25.188.52,0,0,6,349,6,349,1.563018000,0.2316
144.86.235.98,<->,17.61.199.251,6,508,0,0,6,508,1.560444000,0.1198
139.192.40.145,<->,8.52.181.50,0,0,6,866,6,866,1.559321000,0.1488
213.221.90.185,<->,144.85.170.208,0,0,6,1054,6,1054,1.558601000,0.1288
215.158.140.241,<->,33.209.213.40,6,1363,0,0,6,1363,1.557022000,0.1253
215.158.239.84,<->,195.14.209.14,6,1847,0,0,6,1847,1.555619000,0.3263
215.158.239.85,<->,199.69.64.14,6,400,0,0,6,400,1.555562000,0.0091
215.158.61.243,<->,136.25.188.29,0,0,6,6581,6,6581,1.555108000,0.0665
250.109.247.154,<->,80.27.158.247,0,0,6,3594,6,3594,1.554881000,0.3636
231.140.2.184,<->,136.25.188.253,0,0,6,400,6,400,1.549852000,0.0139
220.55.100.127,<->,220.20.202.59,6,1609,0,0,6,1609,1.549799000,0.2088
215.158.239.48,<->,204.226.127.49,6,412,0,0,6,412,1.548228000,0.0037
199.55.76.187,<->,8.183.25.124,0,0,6,638,6,638,1.547626000,0.3231
195.14.125.36,<->,136.25.188.54,0,0,6,349,6,349,1.544720000,0.2250
215.158.238.110,<->,100.120.38.6,6,3183,0,0,6,3183,1.542599000,0.4519
142.236.202.155,<->,136.25.188.241,0,0,6,1877,6,1877,1.541963000,0.3961
143.43.102.227,<->,136.25.188.53,0,0,6,412,6,412,1.541462000,0.0151
194.232.165.130,<->,136.25.188.177,0,0,6,400,6,400,1.539654000,0.0155
203.116.243.174,<->,0.195.210.42,0,0,6,336,6,336,1.539431000,0.1000
204.123.43.210,<->,8.252.222.134,0,0,6,572,6,572,1.538777000,0.3103
215.158.239.96,<->,143.94.246.7,6,349,0,0,6,349,1.537215000,0.2207
215.158.61.189,<->,8.176.8.224,0,0,6,3510,6,3510,1.532851000,0.1191
133.178.226.235,<->,113.23.114.102,6,433,0,0,6,433,1.530681000,0.4329
133.178.226.78,<->,102.225.141.21,6,1381,0,0,6,1381,1.529988000,0.0401
192.204.170.200,<->,136.25.188.254,0,0,6,1253,6,1253,1.522563000,0.3361
215.158.238.64,<->,131.1.253.247,6,3351,0,0,6,3351,1.522353000,0.4219
215.158.239.32,<->,215.158.127.163,6,1865,0,0,6,1865,1.521877000,0.1800
213.186.61.2,<->,144.85.170.246,0,0,6,1220,6,1220,1.521277000,0.1484
215.158.140.231,<->,212.70.75.35,6,1369,0,0,6,1369,1.518307000,0.2214
207.6.93.204,<->,8.220.178.73,0,0,6,716,6,716,1.517057000,0.3254
136.25.189.196,<->,129.222.39.203,6,2690,0,0,6,2690,1.514790000,0.0426
54.38.47.227,<->,48.54.241.97,0,0,6,4976,6,4976,1.514423000,0.2857
215.158.239.86,<->,199.20.6.122,6,400,0,0,6,400,1.512559000,0.0600
142.208.121.211,<->,136.25.188.177,0,0,6,432,6,432,1.510276000,0.4707
199.14.252.25,<->,136.25.188.174,0,0,6,412,6,412,1.507867000,0.0177
215.158.239.96,<->,207.166.94.75,6,1187,0,0,6,1187,1.507499000,0.4200
215.158.238.82,<->,148.55.210.208,6,1637,0,0,6,1637,1.507347000,0.2686
132.249.70.169,<->,82.195.35.35,6,3939,0,0,6,3939,1.506539000,0.1311
207.190.91.156,<->,136.25.188.255,0,0,6,412,6,412,1.506012000,0.0172
139.163.5.140,<->,130.137.174.13,6,368,0,0,6,368,1.505164000,0.2968
215.158.239.79,<->,199.20.30.208,6,412,0,0,6,412,1.503636000,0.0934
144.85.170.254,<->,91.69.185.245,6,1332,0,0,6,1332,1.503273000,0.0923
199.121.245.90,<->,136.25.188.225,0,0,6,1853,6,1853,1.502260000,0.3674
129.31.169.113,<->,8.183.25.124,0,0,6,355,6,355,1.501824000,0.0837
69.240.78.251,<->,8.252.222.30,0,0,6,397,6,397,1.501530000,0.2399
215.158.239.244,<->,215.158.129.100,6,442,0,0,6,442,1.501084000,0.1559
199.73.77.249,<->,136.25.188.242,0,0,6,1289,6,1289,1.500462000,0.4418
215.158.239.49,<->,207.115.125.111,6,406,0,0,6,406,1.499625000,0.3402
192.170.179.5,<->,133.32.39.0,0,0,6,543,6,543,1.497887000,0.0385
245.161.124.44,<->,8.252.222.60,0,0,6,1523,6,1523,1.497533000,0.3572
136.25.188.104,<->,8.182.121.167,6,3073,0,0,6,3073,1.496464000,0.1805
204.187.4.191,<->,136.25.188.176,0,0,6,1849,6,1849,1.495525000,0.3299
133.178.227.208,<->,8.42.42.194,6,3690,0,0,6,3690,1.494185000,0.1546
142.255.40.85,<->,136.25.188.52,0,0,6,527,6,527,1.493862000,0.4849
133.178.227.41,<->,133.73.194.4,6,2912,0,0,6,2912,1.490457000,0.1903
215.158.239.50,<->,199.20.30.209,6,412,0,0,6,412,1.489803000,0.1298
199.71.111.4,<->,136.25.188.252,0,0,6,300,6,300,1.487415000,0.2141
215.158.238.121,<->,8.252.210.251,6,1557,0,0,6,1557,1.487265000,0.1728
8.252.222.51,<->,4.122.15.27,6,412,0,0,6,412,1.486243000,0.0023
210.220.219.153,<->,53.189.253.207,6,4026,0,0,6,4026,1.484671000,0.3636
195.13.253.215,<->,136.25.188.239,0,0,6,412,6,412,1.484600000,0.0086
225.120.222.235,<->,133.178.226.29,0,0,6,1269,6,1269,1.483923000,0.4987
82.248.207.148,<->,8.220.239.48,0,0,6,862,6,862,1.482650000,0.0751
133.178.226.213,<->,115.162.222.216,6,433,0,0,6,433,1.479562000,0.3245
111.199.225.0,<->,0.195.210.44,0,0,6,551,6,551,1.474788000,0.3097
196.88.23.127,<->,136.25.188.226,0,0,6,412,6,412,1.474528000,0.0065
194.234.181.28,<->,136.25.188.226,0,0,6,400,6,400,1.474494000,0.0510
143.134.96.189,<->,136.25.188.222,0,0,6,456,6,456,1.473854000,0.4255
199.52.224.192,<->,136.25.188.241,0,0,6,400,6,400,1.471772000,0.0097
221.102.123.190,<->,133.40.208.180,6,413,0,0,6,413,1.471247000,0.2648
215.158.239.59,<->,195.49.13.174,6,421,0,0,6,421,1.469913000,0.0198
48.131.159.6,<->,8.252.223.106,0,0,6,1470,6,1470,1.469478000,0.3113
207.61.254.156,<->,136.25.188.178,0,0,6,908,6,908,1.465909000,0.4285
225.41.137.39,<->,50.224.76.235,0,0,6,1680,6,1680,1.462323000,0.5237
139.47.239.85,<->,80.32.150.19,6,2277,0,0,6,2277,1.461527000,0.4601
215.158.61.191,<->,8.176.8.196,0,0,6,6349,6,6349,1.460626000,0.5065
195.5.82.217,<->,136.25.188.178,0,0,6,890,6,890,1.454197000,0.5321
111.147.192.122,<->,54.41.253.68,6,407,0,0,6,407,1.454009000,0.0921
215.158.61.189,<->,136.25.189.222,0,0,6,6293,6,6293,1.451362000,0.0054
215.158.239.113,<->,129.222.36.79,6,2290,0,0,6,2290,1.450254000,0.0420
214.80.63.214,<->,139.163.66.167,0,0,6,1362,6,1362,1.448327000,0.2203
136.25.189.15,<->,72.23.194.213,6,3066,0,0,6,3066,1.446982000,0.4915
93.181.154.111,<->,92.27.219.197,0,0,6,310,6,310,1.446517000,0.5439
144.85.170.249,<->,98.87.145.159,6,1093,0,0,6,1093,1.445339000,0.2425
220.20.200.193,<->,159.70.46.125,6,2680,0,0,6,2680,1.444993000,0.0567
203.215.162.177,<->,124.42.185.84,6,884,0,0,6,884,1.442925000,0.4958
196.89.255.151,<->,136.25.188.225,0,0,6,349,6,349,1.442379000,0.3908
199.50.155.121,<->,136.25.188.253,0,0,6,412,6,412,1.440615000,0.0236
143.227.65.186,<->,136.25.188.160,0,0,6,1477,6,1477,1.440576000,0.2416
129.138.248.177,<->,8.252.222.60,0,0,6,637,6,637,1.439446000,0.3057
202.178.8.84,<->,108.134.108.232,0,0,6,635,6,635,1.439179000,0.4604
148.224.137.67,<->,136.25.188.237,0,0,6,2954,6,2954,1.436505000,0.5087
8.183.25.25,<->,6.133.204.253,6,1008,0,0,6,1008,1.435912000,0.5580
142.228.165.119,<->,136.25.188.253,0,0,6,1402,6,1402,1.435641000,0.4208
136.25.188.199,<->,122.158.245.107,6,2874,0,0,6,2874,1.431958000,0.4808
231.140.199.133,<->,136.25.188.226,0,0,6,412,6,412,1.429868000,0.0086
136.25.189.12,<->,29.211.228.198,6,3318,0,0,6,3318,1.429476000,0.3284
143.44.75.225,<->,136.25.188.225,0,0,6,349,6,349,1.425570000,0.3441
207.61.112.76,<->,136.25.188.255,0,0,6,312,6,312,1.420277000,0.2720
109.119.182.243,<->,8.182.136.236,0,0,6,502,6,502,1.419555000,0.0465
139.163.26.146,<->,122.222.214.178,6,678,0,0,6,678,1.419535000,0.4921
109.119.182.246,<->,8.182.136.236,0,0,6,502,6,502,1.417301000,0.0460
109.119.182.230,<->,8.182.136.236,0,0,6,506,6,506,1.417145000,0.0490
129.95.133.231,<->,8.193.83.40,0,0,6,1364,6,1364,1.415510000,0.1286
215.158.239.57,<->,199.20.29.252,6,412,0,0,6,412,1.413090000,0.1436
215.158.239.81,<->,100.216.78.145,6,7453,0,0,6,7453,1.409437000,0.0000
133.178.226.196,<->,8.47.121.21,6,440,0,0,6,440,1.406405000,0.4768
17.61.227.235,<->,8.220.176.253,0,0,6,764,6,764,1.403943000,0.1167
136.25.188.45,<->,112.235.95.11,6,2730,0,0,6,2730,1.402051000,0.5538
222.4.209.41,<->,159.137.162.213,0,0,6,882,6,882,1.399521000,0.4760
159.137.162.213,<->,110.66.204.9,6,882,0,0,6,882,1.398447000,0.4839
215.158.238.96,<->,64.152.12.87,6,1557,0,0,6,1557,1.397269000,0.3642
215.158.239.97,<->,143.20.71.152,6,641,0,0,6,641,1.396880000,0.3726
159.137.162.213,<->,92.180.14.181,6,890,0,0,6,890,1.396673000,0.5517
138.98.210.200,<->,99.170.109.141,6,389,0,0,6,389,1.396503000,0.0939
195.124.253.91,<->,136.25.188.46,0,0,6,338,6,338,1.395182000,0.4200
215.158.239.78,<->,199.106.152.222,6,412,0,0,6,412,1.393577000,0.0381
144.83.112.139,<->,50.224.108.188,0,0,6,467,6,467,1.393333000,0.0876
215.158.239.87,<->,142.166.51.22,6,456,0,0,6,456,1.393258000,0.4538
142.247.198.125,<->,136.25.188.242,0,0,6,1839,6,1839,1.391013000,0.5759
247.136.236.145,<->,8.209.235.29,6,3830,0,0,6,3830,1.390211000,0.2376
207.60.89.10,<->,136.25.188.174,0,0,6,548,6,548,1.386643000,0.5571
93.95.33.184,<->,50.224.76.235,0,0,6,733,6,733,1.386620000,0.2968
207.173.191.9,<->,92.27.194.147,0,0,6,545,6,545,1.384934000,0.6003
136.25.189.202,<->,129.222.39.208,6,2044,0,0,6,2044,1.384663000,0.1169
133.178.227.76,<->,111.150.39.23,6,1400,0,0,6,1400,1.378354000,0.2438
136.139.59.124,<->,136.25.188.222,0,0,6,349,6,349,1.378290000,0.0664
215.158.127.244,<->,8.252.223.142,0,0,6,1365,6,1365,1.376881000,0.2931
136.11.64.218,<->,8.53.2.189,0,0,6,499,6,499,1.374275000,0.0681
215.158.239.113,<->,129.222.39.229,6,3756,0,0,6,3756,1.372783000,0.1772
215.158.238.81,<->,148.55.210.213,6,1637,0,0,6,1637,1.372511000,0.2983
215.158.238.81,<->,131.144.113.168,6,1493,0,0,6,1493,1.372191000,0.2782
215.158.239.58,<->,196.106.117.138,6,412,0,0,6,412,1.372006000,0.0499
232.31.124.106,<->,220.55.66.44,0,0,6,447,6,447,1.371281000,0.3464
215.158.239.99,<->,199.20.30.36,6,412,0,0,6,412,1.369946000,0.0101
220.20.200.33,<->,98.23.99.94,6,450,0,0,6,450,1.365726000,0.1089
215.158.238.90,<->,98.219.126.140,6,7929,0,0,6,7929,1.362955000,0.0000
111.199.225.115,<->,0.195.210.46,0,0,6,5110,6,5110,1.357211000,0.2739
53.201.77.67,<->,48.54.100.170,0,0,6,4978,6,4978,1.355995000,0.3144
215.158.239.76,<->,199.70.23.5,6,412,0,0,6,412,1.354815000,0.0438
199.15.219.0,<->,136.25.188.45,0,0,6,400,6,400,1.354749000,0.0158
204.58.165.79,<->,136.25.188.174,0,0,6,400,6,400,1.351593000,0.0244
215.158.239.79,<->,199.20.5.204,6,1847,0,0,6,1847,1.350773000,0.5871
215.158.238.141,<->,38.104.11.60,6,1705,0,0,6,1705,1.349082000,0.2245
215.158.239.56,<->,194.251.126.128,6,349,0,0,6,349,1.347681000,0.1945
215.158.238.115,<->,142.234.196.161,6,2906,0,0,6,2906,1.346988000,0.6488
96.58.68.79,<->,8.220.178.166,0,0,6,1831,6,1831,1.346039000,0.2161
136.25.188.211,<->,131.173.115.86,6,1653,0,0,6,1653,1.345826000,0.2778
143.132.20.174,<->,136.25.188.225,0,0,6,312,6,312,1.344584000,0.2713
199.122.164.167,<->,136.25.188.44,0,0,6,400,6,400,1.340671000,0.0101
195.4.206.58,<->,136.25.188.225,0,0,6,1206,6,1206,1.338150000,0.3100
139.33.175.144,<->,8.30.98.249,0,0,6,3038,6,3038,1.337717000,0.1147
142.254.7.206,<->,136.25.188.177,0,0,6,357,6,357,1.337595000,0.6121
142.182.62.124,<->,136.25.188.175,0,0,6,906,6,906,1.336566000,0.5521
215.158.239.115,<->,215.158.61.193,6,6693,0,0,6,6693,1.334162000,0.0087
213.221.90.240,<->,144.85.170.208,0,0,6,728,6,728,1.333066000,0.1251
207.64.65.44,<->,50.223.3.230,0,0,6,671,6,671,1.330590000,0.5645
215.158.239.84,<->,106.188.253.129,6,2666,0,0,6,2666,1.330413000,0.5387
89.204.235.110,<->,50.224.91.34,0,0,6,1662,6,1662,1.329488000,0.0721
142.236.219.73,<->,136.25.188.225,0,0,6,1045,6,1045,1.329068000,0.2601
144.85.170.254,<->,91.69.185.193,6,723,0,0,6,723,1.328578000,0.0870
215.158.239.93,<->,196.104.91.110,6,312,0,0,6,312,1.328576000,0.6642
215.158.239.69,<->,199.20.31.208,6,392,0,0,6,392,1.327879000,0.2176
199.50.123.48,<->,136.25.188.252,0,0,6,349,6,349,1.326212000,0.2460
199.38.234.35,<->,136.25.188.177,0,0,6,412,6,412,1.324960000,0.0093
199.14.239.58,<->,136.25.188.239,0,0,6,424,6,424,1.323361000,0.1838
144.93.22.181,<->,100.95.206.96,0,0,6,3220,6,3220,1.318493000,0.5733
215.158.140.185,<->,8.222.7.155,6,3136,0,0,6,3136,1.316337000,0.2633
142.255.65.48,<->,136.25.188.223,0,0,6,1022,6,1022,1.315450000,0.6108
215.158.61.189,<->,136.25.188.36,0,0,6,1623,6,1623,1.314929000,0.3758
136.25.188.254,<->,116.99.180.215,6,2794,0,0,6,2794,1.312838000,0.5562
215.158.239.77,<->,142.255.141.124,6,1841,0,0,6,1841,1.311873000,0.4616
132.200.62.217,<->,132.20.222.234,6,385,0,0,6,385,1.311821000,0.1653
215.158.239.252,<->,8.47.189.76,6,442,0,0,6,442,1.310146000,0.0515
133.178.227.252,<->,91.57.169.11,6,1046,0,0,6,1046,1.309579000,0.0539
216.184.2.78,<->,99.74.27.13,0,0,6,6933,6,6933,1.305549000,0.6243
215.158.239.93,<->,199.20.31.160,6,558,0,0,6,558,1.305530000,0.5697
215.158.239.79,<->,199.50.121.111,6,1838,0,0,6,1838,1.302204000,0.5728
202.33.52.234,<->,136.25.188.174,0,0,6,412,6,412,1.301215000,0.0000
125.223.127.183,<->,100.228.42.100,0,0,6,3026,6,3026,1.300684000,0.3195
215.158.239.56,<->,199.122.164.218,6,646,0,0,6,646,1.295302000,0.7024
207.3.186.105,<->,8.52.178.37,0,0,6,1149,6,1149,1.294773000,0.5508
204.187.74.11,<->,136.25.188.160,0,0,6,412,6,412,1.293685000,0.0001
133.178.227.19,<->,97.243.113.38,6,1392,0,0,6,1392,1.293681000,0.1576
207.59.187.85,<->,136.25.188.222,0,0,6,1334,6,1334,1.292967000,0.6643
215.158.238.73,<->,8.190.217.127,6,1493,0,0,6,1493,1.291142000,0.0355
215.158.239.96,<->,196.168.46.78,6,908,0,0,6,908,1.289717000,0.5525
215.158.238.25,<->,113.92.151.99,6,1797,0,0,6,1797,1.288201000,0.1131
199.68.247.252,<->,136.25.188.252,0,0,6,349,6,349,1.288078000,0.2783
142.253.110.56,<->,136.25.188.196,0,0,6,349,6,349,1.287429000,0.2391
192.227.190.235,<->,136.25.188.211,0,0,6,1781,6,1781,1.287091000,0.1405
195.5.158.232,<->,136.25.188.163,0,0,6,1754,6,1754,1.287050000,0.6030
139.193.141.137,<->,42.52.125.46,6,360,0,0,6,360,1.286128000,0.2000
246.253.253.170,<->,8.35.106.56,6,568,0,0,6,568,1.284446000,0.1951
202.33.125.147,<->,136.25.188.174,0,0,6,412,6,412,1.283021000,0.0070
215.158.239.56,<->,199.14.155.81,6,1876,0,0,6,1876,1.282396000,0.5430
197.107.44.87,<->,136.25.188.174,0,0,6,412,6,412,1.281467000,0.3010
133.178.226.76,<->,57.210.107.36,6,552,0,0,6,552,1.278872000,0.5032
80.27.153.164,<->,74.182.187.210,6,1355,0,0,6,1355,1.277696000,0.4707
199.38.206.172,<->,136.25.188.220,0,0,6,1225,6,1225,1.276531000,0.5334
215.158.61.145,<->,8.176.8.180,0,0,6,6661,6,6661,1.276377000,0.0703
136.25.189.62,<->,100.216.78.145,6,7620,0,0,6,7620,1.275860000,0.2868
144.85.170.254,<->,91.69.185.154,6,1050,0,0,6,1050,1.275245000,0.1435
136.25.188.237,<->,48.131.158.246,6,1621,0,0,6,1621,1.274273000,0.2590
215.158.239.49,<->,196.107.168.131,6,312,0,0,6,312,1.273715000,0.6752
215.158.239.87,<->,199.20.31.208,6,400,0,0,6,400,1.272169000,0.1602
224.9.40.222,<->,100.228.42.205,0,0,6,5002,6,5002,1.271172000,0.0528
215.158.239.97,<->,196.104.65.18,6,448,0,0,6,448,1.265978000,0.0197
252.98.135.226,<->,106.5.211.8,6,450,0,0,6,450,1.265502000,0.1582
133.178.226.30,<->,8.191.6.90,6,1541,0,0,6,1541,1.263243000,0.0829
144.87.238.91,<->,8.182.253.40,0,0,6,1877,6,1877,1.262479000,0.0596
90.240.204.138,<->,54.37.53.245,6,3690,0,0,6,3690,1.261963000,0.5614
8.182.244.196,<->,6.117.57.68,6,675,0,0,6,675,1.260192000,0.2111
204.187.230.47,<->,136.25.188.225,0,0,6,1857,6,1857,1.259903000,0.6198
207.232.222.142,<->,133.54.28.143,0,0,6,652,6,652,1.255103000,0.3848
92.168.217.198,<->,0.47.243.72,6,595,0,0,6,595,1.253178000,0.1663
220.40.166.218,<->,133.178.226.28,0,0,6,1461,6,1461,1.248230000,0.7349
196.89.228.87,<->,136.25.188.255,0,0,6,1636,6,1636,1.245814000,0.5237
215.158.239.76,<->,196.91.196.237,6,1203,0,0,6,1203,1.245508000,0.7511
199.69.182.51,<->,136.25.188.53,0,0,6,645,6,645,1.245475000,0.7193
215.158.238.99,<->,115.140.139.149,6,1537,0,0,6,1537,1.243432000,0.2244
215.158.238.82,<->,122.159.31.168,6,1397,0,0,6,1397,1.241458000,0.1351
195.70.205.28,<->,136.25.188.236,0,0,6,933,6,933,1.241442000,0.4875
207.62.182.244,<->,136.25.188.252,0,0,6,400,6,400,1.238388000,0.0115
143.135.8.163,<->,136.25.188.163,0,0,6,400,6,400,1.237961000,0.0156
197.107.44.87,<->,136.25.188.209,0,0,6,412,6,412,1.237947000,0.3425
139.148.27.43,<->,8.182.239.241,0,0,6,1032,6,1032,1.236760000,0.3669
215.158.239.239,<->,129.175.139.243,6,4869,0,0,6,4869,1.230436000,0.6541
142.241.142.229,<->,136.25.188.174,0,0,6,1845,6,1845,1.229229000,0.6801
159.137.162.213,<->,126.100.242.174,6,882,0,0,6,882,1.228943000,0.7024
105.163.53.213,<->,80.41.26.51,0,0,6,368,6,368,1.228894000,0.3346
215.158.238.107,<->,206.103.249.181,6,1589,0,0,6,1589,1.227076000,0.1054
192.171.32.183,<->,136.25.189.15,0,0,6,2506,6,2506,1.227069000,0.5589
246.253.253.213,<->,199.9.96.56,6,4184,0,0,6,4184,1.224267000,0.6385
231.142.229.46,<->,136.25.188.222,0,0,6,412,6,412,1.223927000,0.0180
195.40.118.199,<->,136.25.188.226,0,0,6,1562,6,1562,1.223858000,0.5189
193.10.94.23,<->,136.25.188.162,0,0,6,1557,6,1557,1.221528000,0.2955
215.158.239.1,<->,96.135.154.141,6,6798,0,0,6,6798,1.220773000,0.0068
215.158.239.76,<->,195.71.91.68,6,2565,0,0,6,2565,1.220097000,0.6531
195.5.152.124,<->,136.25.188.237,0,0,6,646,6,646,1.218462000,0.5833
141.118.203.106,<->,8.252.221.236,0,0,6,1576,6,1576,1.214615000,0.6966
207.61.68.151,<->,136.25.188.174,0,0,6,2275,6,2275,1.214417000,0.5706
148.240.82.247,<->,0.195.210.46,0,0,6,528,6,528,1.214127000,0.5346
143.134.33.39,<->,136.25.188.177,0,0,6,868,6,868,1.213324000,0.5903
159.137.162.213,<->,110.240.17.32,6,882,0,0,6,882,1.211459000,0.3382
133.178.226.197,<->,56.97.187.17,6,440,0,0,6,440,1.207920000,0.0565
215.158.239.97,<->,195.81.3.132,6,1839,0,0,6,1839,1.207459000,0.6000
196.246.202.18,<->,136.25.188.177,0,0,6,1016,6,1016,1.206050000,0.7399
132.200.62.137,<->,132.200.51.75,6,2437,0,0,6,2437,1.205570000,0.3079
215.158.61.183,<->,8.176.8.104,0,0,6,6405,6,6405,1.204475000,0.0862
101.70.96.209,<->,54.42.178.167,6,613,0,0,6,613,1.203022000,0.4421
215.158.238.83,<->,38.104.11.27,6,1461,0,0,6,1461,1.202566000,0.2728
210.158.44.59,<->,91.231.212.165,6,4602,0,0,6,4602,1.200600000,0.2149
142.229.12.248,<->,136.25.188.163,0,0,6,1881,6,1881,1.200363000,0.5463
133.178.227.6,<->,129.80.130.60,6,5306,0,0,6,5306,1.200139000,0.0612
215.158.239.92,<->,48.131.157.39,6,1637,0,0,6,1637,1.199765000,0.2567
215.158.239.77,<->,65.27.220.201,6,2778,0,0,6,2778,1.199003000,0.7776
159.137.162.213,<->,125.220.197.150,6,882,0,0,6,882,1.198916000,0.6280
215.158.239.79,<->,195.43.148.38,6,349,0,0,6,349,1.198751000,0.2710
215.158.238.236,<->,29.211.165.35,6,1396,0,0,6,1396,1.197388000,0.1211
215.158.239.69,<->,207.166.98.166,6,1849,0,0,6,1849,1.194190000,0.7501
50.16.84.105,<->,8.52.182.85,0,0,6,663,6,663,1.192041000,0.1357
215.158.239.34,<->,8.219.187.244,6,1245,0,0,6,1245,1.191620000,0.2793
145.89.249.42,<->,50.224.76.230,0,0,6,1128,6,1128,1.191500000,0.1636
215.158.239.56,<->,196.93.119.213,6,336,0,0,6,336,1.191169000,0.6379
199.82.203.26,<->,136.25.188.199,0,0,6,594,6,594,1.187906000,0.3930
136.25.189.88,<->,96.156.169.230,6,3162,0,0,6,3162,1.187699000,0.7396
215.158.239.86,<->,204.226.36.140,6,412,0,0,6,412,1.186293000,0.0018
136.25.188.55,<->,116.107.47.34,6,1509,0,0,6,1509,1.185493000,0.2187
202.33.252.100,<->,136.25.188.179,0,0,6,424,6,424,1.178727000,0.0592
17.96.223.98,<->,8.220.191.251,0,0,6,1090,6,1090,1.177801000,0.7864
196.245.4.133,<->,136.25.188.220,0,0,6,1552,6,1552,1.177283000,0.8207
192.227.190.25,<->,8.252.223.175,0,0,6,2555,6,2555,1.177249000,0.4646
204.200.33.245,<->,136.25.188.196,0,0,6,636,6,636,1.174742000,0.7266
215.158.239.96,<->,196.106.141.2,6,1853,0,0,6,1853,1.171906000,0.6009
198.230.46.183,<->,159.137.162.213,0,0,6,890,6,890,1.170210000,0.7538
199.121.94.233,<->,136.25.188.176,0,0,6,596,6,596,1.170165000,0.3099
215.158.239.92,<->,199.20.29.151,6,1882,0,0,6,1882,1.167085000,0.7109
215.201.227.68,<->,8.182.233.43,0,0,6,639,6,639,1.165321000,0.3480
136.25.188.225,<->,91.57.162.216,6,1557,0,0,6,1557,1.163269000,0.1354
129.225.132.224,<->,129.225.131.138,6,909,0,0,6,909,1.163263000,0.1508
215.158.239.86,<->,195.83.248.246,6,412,0,0,6,412,1.162582000,0.0100
136.25.188.50,<->,0.195.253.228,6,6417,0,0,6,6417,1.161905000,0.0125
215.158.238.143,<->,113.23.117.86,6,1509,0,0,6,1509,1.161345000,0.1078
199.15.18.41,<->,136.25.188.238,0,0,6,412,6,412,1.161317000,0.0148
199.82.190.234,<->,136.25.188.176,0,0,6,349,6,349,1.160727000,0.6159
215.158.239.79,<->,199.82.190.234,6,349,0,0,6,349,1.159803000,0.4730
144.85.170.254,<->,91.69.181.209,6,732,0,0,6,732,1.159585000,0.0848
136.25.189.77,<->,96.156.169.244,6,3138,0,0,6,3138,1.159272000,0.1686
159.137.162.213,<->,29.157.49.25,6,882,0,0,6,882,1.158847000,0.6093
215.158.239.85,<->,199.69.65.114,6,436,0,0,6,436,1.156566000,0.6056
136.25.189.202,<->,129.222.39.213,6,3010,0,0,6,3010,1.154536000,0.0407
215.158.61.243,<->,8.176.8.245,0,0,6,7923,6,7923,1.154181000,0.0175
136.25.188.52,<->,112.220.206.117,6,1381,0,0,6,1381,1.152762000,0.1096
215.158.238.95,<->,131.36.198.57,6,1693,0,0,6,1693,1.152657000,0.1018
202.33.126.121,<->,136.25.188.209,0,0,6,412,6,412,1.152522000,0.0020
215.158.239.48,<->,207.228.230.155,6,412,0,0,6,412,1.151452000,0.0080
215.158.239.51,<->,199.20.4.30,6,1879,0,0,6,1879,1.151325000,0.5840
192.76.122.50,<->,89.183.104.179,0,0,6,2310,6,2310,1.149180000,0.3095
146.149.83.187,<->,8.252.221.198,0,0,6,1049,6,1049,1.146891000,0.7950
215.158.239.244,<->,112.235.86.193,6,442,0,0,6,442,1.145985000,0.2794
215.158.239.87,<->,199.20.30.2,6,1866,0,0,6,1866,1.144923000,0.6111
66.47.82.31,<->,8.252.222.134,0,0,6,400,6,400,1.144759000,0.0116
215.158.140.11,<->,215.158.61.145,6,6357,0,0,6,6357,1.143384000,0.0026
215.158.239.57,<->,196.104.174.247,6,635,0,0,6,635,1.143356000,0.0595
204.3.40.131,<->,136.25.188.174,0,0,6,349,6,349,1.142162000,0.4028
195.42.108.172,<->,136.25.188.243,0,0,6,349,6,349,1.138435000,0.2636
215.158.239.78,<->,195.55.11.216,6,343,0,0,6,343,1.138229000,0.2240
133.90.61.177,<->,8.220.186.82,0,0,6,657,6,657,1.135666000,0.2261
215.158.61.195,<->,8.176.8.202,0,0,6,7503,6,7503,1.135133000,0.1831
132.222.168.39,<->,67.225.231.172,6,336,0,0,6,336,1.134644000,0.5710
216.144.222.136,<->,215.158.140.144,0,0,6,1689,6,1689,1.133755000,0.1161
143.79.216.80,<->,136.25.188.176,0,0,6,1578,6,1578,1.132604000,0.6314
199.82.179.248,<->,136.25.188.242,0,0,6,400,6,400,1.131057000,0.0172
207.172.206.228,<->,136.25.188.237,0,0,6,670,6,670,1.130834000,0.6492
215.158.239.76,<->,199.82.190.234,6,349,0,0,6,349,1.130751000,0.4491
143.79.216.80,<->,136.25.188.46,0,0,6,349,6,349,1.130196000,0.3114
194.233.57.116,<->,136.25.188.255,0,0,6,1854,6,1854,1.129354000,0.7208
215.158.30.165,<->,8.252.222.130,0,0,6,5162,6,5162,1.127592000,0.2745
133.178.227.76,<->,131.144.114.248,6,2407,0,0,6,2407,1.126291000,0.3933
221.196.122.208,<->,136.25.188.163,0,0,6,1564,6,1564,1.125547000,0.4792
199.80.80.167,<->,136.25.188.174,0,0,6,336,6,336,1.123104000,0.1816
195.13.251.5,<->,136.25.188.220,0,0,6,488,6,488,1.120864000,0.5058
199.14.3.9,<->,136.25.188.255,0,0,6,312,6,312,1.119737000,0.2193
215.158.239.113,<->,129.222.39.37,6,3362,0,0,6,3362,1.117197000,0.0496
207.63.43.133,<->,136.25.188.44,0,0,6,570,6,570,1.116638000,0.6845
215.158.239.95,<->,207.60.47.4,6,1838,0,0,6,1838,1.114803000,0.7502
215.158.239.94,<->,204.226.53.177,6,412,0,0,6,412,1.112271000,0.0033
199.32.195.137,<->,136.25.188.238,0,0,6,400,6,400,1.109701000,0.0089
92.27.27.169,<->,48.109.246.250,6,311,0,0,6,311,1.109572000,0.8818
192.226.161.17,<->,133.178.226.29,0,0,6,1477,6,1477,1.108919000,0.3889
207.173.149.81,<->,136.25.188.176,0,0,6,1355,6,1355,1.108883000,0.7999
143.155.227.59,<->,133.178.226.38,0,0,6,349,6,349,1.107624000,0.2127
215.158.239.70,<->,142.182.49.179,6,705,0,0,6,705,1.107335000,0.4581
215.158.239.56,<->,199.20.6.208,6,1562,0,0,6,1562,1.106063000,0.7999
195.126.25.205,<->,136.25.188.236,0,0,6,349,6,349,1.104843000,0.2701
136.25.189.13,<->,96.156.169.223,6,3347,0,0,6,3347,1.103942000,0.7192
195.14.65.48,<->,136.25.188.174,0,0,6,400,6,400,1.102480000,0.0612
197.161.240.141,<->,136.25.188.239,0,0,6,400,6,400,1.102227000,0.0202
204.186.0.10,<->,136.25.188.175,0,0,6,360,6,360,1.101571000,0.0007
133.178.227.2,<->,80.57.141.65,6,1413,0,0,6,1413,1.100866000,0.0303
142.167.167.81,<->,136.25.188.242,0,0,6,312,6,312,1.096737000,0.2404
159.137.162.213,<->,112.30.205.142,6,882,0,0,6,882,1.096468000,0.7883
143.155.227.54,<->,136.25.188.211,0,0,6,1665,6,1665,1.096139000,0.2914
133.178.227.12,<->,8.222.212.106,6,2859,0,0,6,2859,1.095629000,0.1845
159.137.162.213,<->,117.56.163.126,6,882,0,0,6,882,1.094539000,0.6256
215.158.61.202,<->,136.25.188.36,0,0,6,6469,6,6469,1.094513000,0.8361
109.222.238.4,<->,54.43.164.11,6,407,0,0,6,407,1.094478000,0.2478
215.158.239.68,<->,196.94.240.56,6,336,0,0,6,336,1.093583000,0.8422
66.47.82.31,<->,8.252.222.46,0,0,6,412,6,412,1.092013000,0.0000
97.126.4.255,<->,27.10.94.12,6,357,0,0,6,357,1.090415000,0.6384
133.178.226.29,<->,42.226.3.118,6,1541,0,0,6,1541,1.089296000,0.3788
202.33.125.70,<->,136.25.188.252,0,0,6,412,6,412,1.088372000,0.0078
136.25.188.174,<->,56.161.218.52,6,1429,0,0,6,1429,1.087757000,0.1602
215.158.239.84,<->,195.55.60.139,6,1006,0,0,6,1006,1.087437000,0.3479
215.158.239.84,<->,194.202.251.104,6,412,0,0,6,412,1.085405000,0.0804
133.178.226.213,<->,112.235.95.84,6,440,0,0,6,440,1.082094000,0.3150
207.193.32.90,<->,8.182.227.180,0,0,6,350,6,350,1.079117000,0.2285
215.158.239.50,<->,212.70.75.102,6,2778,0,0,6,2778,1.078107000,0.3897
142.206.165.64,<->,136.25.188.236,0,0,6,343,6,343,1.077270000,0.3540
215.158.239.58,<->,195.49.202.115,6,1857,0,0,6,1857,1.073131000,0.7005
143.10.30.30,<->,136.25.188.227,0,0,6,1847,6,1847,1.072953000,0.7479
204.61.10.56,<->,136.25.188.252,0,0,6,400,6,400,1.072113000,0.0100
136.25.188.179,<->,32.183.36.102,6,2842,0,0,6,2842,1.071203000,0.4247
215.158.140.93,<->,8.53.216.49,6,2423,0,0,6,2423,1.069847000,0.6654
215.158.239.85,<->,204.0.178.84,6,1852,0,0,6,1852,1.068900000,0.9297
215.158.238.66,<->,126.219.190.136,6,336,0,0,6,336,1.068196000,0.0046
144.71.40.160,<->,64.163.196.59,6,684,0,0,6,684,1.065455000,0.3879
133.178.226.60,<->,57.210.107.27,6,3919,0,0,6,3919,1.064772000,0.7932
199.122.116.222,<->,136.25.188.45,0,0,6,1077,6,1077,1.062238000,0.2631
196.89.168.66,<->,136.25.188.45,0,0,6,1006,6,1006,1.061949000,0.4048
144.85.170.208,<->,91.69.181.159,6,1057,0,0,6,1057,1.059270000,0.1334
122.216.233.89,<->,8.252.223.153,0,0,6,1322,6,1322,1.058995000,0.4632
215.158.239.76,<->,204.61.75.214,6,349,0,0,6,349,1.058088000,0.2471
207.60.59.8,<->,136.25.188.220,0,0,6,997,6,997,1.056848000,0.5674
220.39.233.181,<->,215.158.238.135,0,0,6,2730,6,2730,1.056542000,0.6016
159.137.162.213,<->,122.202.251.213,6,882,0,0,6,882,1.054227000,0.6012
215.158.239.99,<->,196.109.32.244,6,1226,0,0,6,1226,1.052475000,0.9200
215.158.239.92,<->,195.14.225.55,6,349,0,0,6,349,1.051343000,0.7820
80.28.254.2,<->,8.52.243.38,0,0,6,1310,6,1310,1.048376000,0.1082
215.158.238.107,<->,57.3.89.196,6,2538,0,0,6,2538,1.045861000,0.9044
199.8.48.120,<->,50.223.3.228,0,0,6,306,6,306,1.045657000,0.9280
215.158.239.92,<->,195.83.120.106,6,412,0,0,6,412,1.045293000,0.0201
142.247.210.85,<->,136.25.188.225,0,0,6,349,6,349,1.044431000,0.3021
158.192.3.232,<->,136.25.188.227,0,0,6,2842,6,2842,1.044355000,0.3559
207.58.116.86,<->,136.25.188.209,0,0,6,1870,6,1870,1.039969000,0.6269
207.239.101.2,<->,136.25.188.239,0,0,6,400,6,400,1.038798000,0.1490
215.158.239.85,<->,199.20.4.62,6,1848,0,0,6,1848,1.038747000,0.8196
213.221.90.194,<->,80.38.10.112,0,0,6,2187,6,2187,1.038359000,0.8153
204.56.128.71,<->,136.25.188.175,0,0,6,412,6,412,1.036608000,0.0089
204.185.250.72,<->,136.25.188.220,0,0,6,336,6,336,1.034249000,0.8241
136.25.189.77,<->,0.34.21.24,6,1637,0,0,6,1637,1.033619000,0.0927
207.61.157.223,<->,136.25.188.243,0,0,6,412,6,412,1.033521000,0.0128
132.18.67.31,<->,99.72.163.119,0,0,6,3405,6,3405,1.032672000,0.0978
215.158.238.169,<->,80.47.184.252,6,459,0,0,6,459,1.029922000,0.0503
207.59.3.222,<->,136.25.188.252,0,0,6,412,6,412,1.029438000,0.0086
215.158.239.86,<->,125.84.55.32,6,2938,0,0,6,2938,1.028929000,0.7159
143.68.90.47,<->,136.25.188.177,0,0,6,400,6,400,1.026112000,0.0165
111.199.238.96,<->,0.195.210.33,0,0,6,648,6,648,1.023721000,0.1690
215.158.239.201,<->,192.226.44.75,6,1063,0,0,6,1063,1.023094000,0.1524
215.158.239.33,<->,106.188.214.41,6,1741,0,0,6,1741,1.022862000,0.1064
159.137.162.213,<->,122.211.242.222,6,882,0,0,6,882,1.022290000,0.4432
136.25.189.80,<->,8.222.58.218,6,2650,0,0,6,2650,1.022163000,0.5691
215.158.238.92,<->,8.220.51.219,6,1589,0,0,6,1589,1.021816000,0.3756
204.200.35.204,<->,136.25.188.46,0,0,6,799,6,799,1.021264000,0.5952
195.71.179.70,<->,136.25.188.220,0,0,6,400,6,400,1.021050000,0.0184
195.5.142.153,<->,136.25.188.177,0,0,6,914,6,914,1.020184000,0.7827
215.158.238.74,<->,215.158.3.27,6,1477,0,0,6,1477,1.016030000,0.0321
215.158.140.14,<->,192.224.146.99,6,1500,0,0,6,1500,1.016028000,0.6203
215.158.238.123,<->,201.211.112.213,6,336,0,0,6,336,1.015260000,0.0727
75.145.6.49,<->,8.252.221.236,0,0,6,1624,6,1624,1.014072000,0.8468
215.158.239.6,<->,106.188.184.74,6,3190,0,0,6,3190,1.013936000,0.6387
50.224.80.67,<->,27.2.162.82,6,1000,0,0,6,1000,1.012055000,0.4786
197.113.99.140,<->,136.25.188.178,0,0,6,400,6,400,1.010954000,0.1201
136.25.189.33,<->,113.92.151.72,6,3001,0,0,6,3001,1.010890000,0.7684
127.70.144.165,<->,50.224.76.235,0,0,6,808,6,808,1.008087000,0.3637
196.240.255.160,<->,136.25.188.45,0,0,6,400,6,400,1.006906000,0.0097
80.40.43.150,<->,8.209.235.29,6,2289,0,0,6,2289,1.006857000,0.0872
50.224.76.248,<->,6.75.72.161,6,773,0,0,6,773,1.006216000,0.1420
202.33.35.129,<->,136.25.188.52,0,0,6,412,6,412,1.005651000,0.0027
111.146.208.32,<->,54.53.138.166,6,1674,0,0,6,1674,1.002450000,0.9137
231.140.220.234,<->,136.25.188.178,0,0,6,1841,6,1841,1.002313000,0.7184
142.240.181.149,<->,136.25.188.226,0,0,6,400,6,400,1.002006000,0.0087
111.20.172.70,<->,101.224.89.162,0,0,6,784,6,784,1.001236000,0.9917
133.178.226.214,<->,29.211.199.33,6,433,0,0,6,433,1.000456000,0.3142
221.102.121.97,<->,98.230.207.210,6,1487,0,0,6,1487,0.999528000,0.4529
215.158.239.60,<->,98.219.126.175,6,3355,0,0,6,3355,0.999088000,0.9448
215.158.238.106,<->,27.22.184.75,6,1637,0,0,6,1637,0.998756000,0.2688
215.158.239.215,<->,69.31.238.17,6,4312,0,0,6,4312,0.997866000,0.3314
129.236.73.9,<->,33.233.141.41,0,0,6,1488,6,1488,0.997306000,0.2712
199.68.128.197,<->,136.25.188.163,0,0,6,336,6,336,0.996492000,0.7669
204.187.57.196,<->,136.25.188.173,0,0,6,424,6,424,0.993389000,0.7964
109.208.21.233,<->,97.126.119.191,0,0,6,4694,6,4694,0.992857000,0.3178
215.158.239.92,<->,196.91.200.82,6,1893,0,0,6,1893,0.991446000,0.7494
111.20.172.70,<->,101.224.89.224,0,0,6,949,6,949,0.991406000,1.0036
202.33.35.129,<->,136.25.188.174,0,0,6,412,6,412,0.990715000,0.0026
215.158.239.19,<->,96.135.154.151,6,336,0,0,6,336,0.988837000,0.1349
142.228.58.200,<->,136.25.188.222,0,0,6,1256,6,1256,0.988500000,0.8359
215.158.239.56,<->,142.241.242.229,6,349,0,0,6,349,0.987895000,0.7273
143.23.190.146,<->,136.25.188.174,0,0,6,2525,6,2525,0.987061000,0.9997
111.20.172.70,<->,33.233.141.29,0,0,6,943,6,943,0.986838000,1.0024
215.158.239.50,<->,199.20.6.38,6,400,0,0,6,400,0.985929000,0.0083
143.23.190.146,<->,136.25.188.160,0,0,6,646,6,646,0.982975000,0.9496
196.112.115.171,<->,0.195.210.46,0,0,6,1615,6,1615,0.982075000,0.6353
142.167.93.109,<->,136.25.188.196,0,0,6,589,6,589,0.981721000,0.8859
210.194.224.134,<->,8.53.7.199,0,0,6,639,6,639,0.981314000,0.4011
192.224.21.43,<->,136.25.189.34,0,0,6,2714,6,2714,0.980582000,0.5781
142.191.237.192,<->,136.25.188.255,0,0,6,349,6,349,0.980384000,0.2543
215.158.140.19,<->,215.158.61.242,6,3298,0,0,6,3298,0.980333000,0.0646
239.71.80.162,<->,136.25.188.53,0,0,6,368,6,368,0.978298000,0.4304
195.7.227.153,<->,136.25.188.238,0,0,6,894,6,894,0.976247000,0.9998
101.195.32.10,<->,8.220.190.86,0,0,6,862,6,862,0.973411000,0.6034
231.136.198.109,<->,215.158.239.76,0,0,6,594,6,594,0.970552000,0.9141
136.25.188.172,<->,112.220.206.116,6,1413,0,0,6,1413,0.970503000,0.2079
142.244.253.29,<->,136.25.188.238,0,0,6,2445,6,2445,0.970126000,0.0397
145.161.90.199,<->,8.252.222.149,0,0,6,412,6,412,0.969204000,0.0019
142.236.202.186,<->,136.25.188.225,0,0,6,1074,6,1074,0.967866000,0.4201
247.152.220.29,<->,50.224.76.235,0,0,6,1695,6,1695,0.967597000,0.2385
215.158.238.104,<->,69.132.194.169,6,2634,0,0,6,2634,0.966473000,0.6736
215.158.239.84,<->,199.20.5.105,6,1855,0,0,6,1855,0.966260000,0.7168
133.178.226.233,<->,115.162.222.164,6,440,0,0,6,440,0.963040000,0.3202
221.102.143.189,<->,218.4.169.120,0,0,6,506,6,506,0.962854000,0.5376
215.158.238.83,<->,131.144.113.214,6,2682,0,0,6,2682,0.961572000,0.8626
204.21.74.155,<->,136.25.188.177,0,0,6,646,6,646,0.960734000,0.8040
133.178.226.18,<->,65.27.220.208,6,2570,0,0,6,2570,0.960216000,0.9634
143.76.154.165,<->,8.182.252.44,0,0,6,953,6,953,0.956010000,0.3249
133.178.226.199,<->,115.162.222.218,6,433,0,0,6,433,0.954888000,0.3189
138.37.223.61,<->,8.182.244.237,0,0,6,637,6,637,0.953611000,0.3547
142.207.145.245,<->,136.25.188.54,0,0,6,349,6,349,0.953143000,0.2502
48.17.34.134,<->,8.252.221.198,0,0,6,704,6,704,0.952616000,0.8284
200.174.28.185,<->,54.36.8.171,6,827,0,0,6,827,0.952150000,0.3677
141.35.182.149,<->,8.252.221.207,0,0,6,2666,6,2666,0.952049000,0.6860
17.113.90.104,<->,8.220.200.124,0,0,6,300,6,300,0.950832000,0.0370
66.60.3.88,<->,0.195.210.42,0,0,6,2849,6,2849,0.950425000,0.6398
142.191.195.31,<->,136.25.188.236,0,0,6,452,6,452,0.949054000,0.5386
111.150.207.54,<->,97.126.31.66,0,0,6,380,6,380,0.948914000,0.1833
139.163.5.140,<->,105.131.197.161,6,648,0,0,6,648,0.948705000,0.4225
221.102.123.190,<->,98.131.227.91,6,413,0,0,6,413,0.945805000,0.0705
195.55.150.21,<->,136.25.188.176,0,0,6,412,6,412,0.944754000,0.0099
215.158.239.69,<->,199.20.4.22,6,336,0,0,6,336,0.944612000,0.5805
215.158.238.241,<->,61.35.124.183,6,2481,0,0,6,2481,0.944288000,0.9819
112.145.110.132,<->,50.224.89.243,0,0,6,3284,6,3284,0.943941000,0.5199
215.158.239.17,<->,8.241.236.249,6,1840,0,0,6,1840,0.943621000,0.1146
207.191.203.53,<->,136.25.188.46,0,0,6,400,6,400,0.942119000,0.0148
98.128.137.56,<->,8.52.171.120,0,0,6,2681,6,2681,0.941838000,0.3063
143.94.97.133,<->,50.224.76.230,0,0,6,4294,6,4294,0.941368000,0.3087
143.53.82.167,<->,136.25.188.253,0,0,6,1326,6,1326,0.940233000,0.6991
215.158.58.252,<->,99.74.27.36,0,0,6,7832,6,7832,0.939836000,0.0001
215.158.35.200,<->,133.178.227.253,0,0,6,4920,6,4920,0.938963000,0.3155
215.158.239.5,<->,120.155.14.71,6,1924,0,0,6,1924,0.938602000,0.2217
215.158.238.141,<->,136.139.59.106,6,1381,0,0,6,1381,0.938439000,0.1242
204.90.88.30,<->,50.224.75.114,0,0,6,2692,6,2692,0.936823000,0.4750
199.69.238.231,<->,136.25.188.198,0,0,6,1029,6,1029,0.934612000,0.3362
136.25.189.45,<->,8.222.98.123,6,3034,0,0,6,3034,0.934018000,0.5865
136.25.188.178,<->,59.158.77.214,6,349,0,0,6,349,0.933010000,0.4482
207.61.42.201,<->,136.25.188.176,0,0,6,349,6,349,0.931701000,0.3496
111.199.236.40,<->,0.195.210.44,0,0,6,607,6,607,0.929518000,0.2899
144.85.170.254,<->,91.69.185.208,6,1032,0,0,6,1032,0.928938000,0.2068
199.39.120.46,<->,136.25.188.225,0,0,6,1179,6,1179,0.928076000,0.2316
215.158.239.49,<->,199.20.31.212,6,324,0,0,6,324,0.926595000,0.2279
199.80.24.87,<->,136.25.188.253,0,0,6,300,6,300,0.925946000,0.2280
17.24.139.9,<->,8.220.190.86,0,0,6,868,6,868,0.925917000,0.5445
252.98.135.226,<->,106.5.211.6,6,450,0,0,6,450,0.922387000,0.1539
142.247.202.219,<->,136.25.188.198,0,0,6,1850,6,1850,0.917845000,0.8566
136.25.189.32,<->,96.156.169.157,6,3178,0,0,6,3178,0.916240000,0.7564
133.56.201.50,<->,8.52.189.221,0,0,6,1271,6,1271,0.915425000,0.1481
199.14.188.91,<->,136.25.188.160,0,0,6,376,6,376,0.915240000,0.4545
215.158.61.145,<->,8.176.8.244,0,0,6,6149,6,6149,0.914384000,0.0316
231.143.10.120,<->,136.25.188.253,0,0,6,412,6,412,0.913022000,0.0401
201.77.155.3,<->,8.220.178.246,0,0,6,557,6,557,0.912969000,1.0591
215.158.239.69,<->,199.106.231.197,6,412,0,0,6,412,0.912441000,0.0022
144.76.43.246,<->,80.56.78.128,0,0,6,622,6,622,0.906443000,1.0000
199.121.6.22,<->,136.25.188.253,0,0,6,412,6,412,0.905990000,0.0145
129.224.112.252,<->,97.242.126.195,6,410,0,0,6,410,0.904598000,0.3305
80.40.4.150,<->,0.195.221.196,6,1573,0,0,6,1573,0.904405000,0.6278
136.25.188.45,<->,116.106.60.158,6,2650,0,0,6,2650,0.904190000,0.7411
133.178.226.198,<->,29.211.110.77,6,433,0,0,6,433,0.902192000,0.3182
143.89.244.135,<->,136.25.188.209,0,0,6,412,6,412,0.902102000,0.0142
138.98.203.225,<->,38.143.105.155,6,665,0,0,6,665,0.899797000,0.8614
118.169.95.80,<->,92.27.234.215,0,0,6,441,6,441,0.899620000,0.6384
215.158.239.113,<->,129.222.39.155,6,3281,0,0,6,3281,0.897563000,0.5948
215.158.238.67,<->,8.191.6.101,6,1525,0,0,6,1525,0.897199000,0.0339
215.158.239.85,<->,194.199.215.226,6,400,0,0,6,400,0.892590000,0.0013
143.53.114.13,<->,136.25.188.227,0,0,6,917,6,917,0.892374000,0.8771
215.158.239.4,<->,8.255.92.83,6,1376,0,0,6,1376,0.892312000,0.0317
91.248.126.109,<->,8.52.134.9,0,0,6,1184,6,1184,0.892223000,0.6829
215.158.239.44,<->,136.114.101.94,6,4954,0,0,6,4954,0.891302000,0.6832
215.158.238.81,<->,197.125.108.20,6,1653,0,0,6,1653,0.889332000,0.2498
215.158.238.104,<->,120.154.221.231,6,4047,0,0,6,4047,0.888854000,1.0946
215.158.239.49,<->,207.191.228.135,6,1844,0,0,6,1844,0.887652000,0.6587
215.158.239.85,<->,196.104.123.133,6,1852,0,0,6,1852,0.887636000,1.1003
231.140.129.63,<->,136.25.188.175,0,0,6,412,6,412,0.886546000,0.0145
215.158.61.203,<->,136.25.188.38,0,0,6,4734,6,4734,0.882487000,1.0389
215.158.239.57,<->,199.20.29.60,6,424,0,0,6,424,0.880492000,0.0299
202.178.8.69,<->,144.64.139.43,0,0,6,564,6,564,0.878693000,0.5057
143.132.196.96,<->,136.25.188.52,0,0,6,1226,6,1226,0.878243000,0.0380
197.81.94.173,<->,136.25.188.226,0,0,6,412,6,412,0.878026000,0.0053
144.85.170.208,<->,91.69.185.186,6,1072,0,0,6,1072,0.877695000,0.1000
215.158.238.73,<->,112.220.206.22,6,1509,0,0,6,1509,0.876487000,0.1912
215.158.238.82,<->,57.210.107.16,6,2410,0,0,6,2410,0.875869000,0.8044
215.158.238.81,<->,113.92.151.118,6,2487,0,0,6,2487,0.875262000,1.0154
215.158.140.92,<->,68.231.10.151,6,2493,0,0,6,2493,0.874328000,1.0682
144.87.238.89,<->,8.182.227.233,0,0,6,784,6,784,0.874229000,0.0779
215.158.58.201,<->,99.74.27.23,0,0,6,3619,6,3619,0.874027000,0.2597
132.18.67.28,<->,109.222.201.157,0,0,6,1935,6,1935,0.873765000,0.0644
193.39.70.11,<->,133.178.226.28,0,0,6,2602,6,2602,0.872933000,0.7475
159.137.162.213,<->,113.225.205.88,6,882,0,0,6,882,0.872880000,0.5961
231.143.10.120,<->,136.25.188.241,0,0,6,412,6,412,0.870281000,0.0701
58.164.139.137,<->,0.195.210.42,0,0,6,300,6,300,0.866925000,1.1078
215.158.61.203,<->,136.25.189.202,0,0,6,3566,6,3566,0.866215000,0.8235
159.137.162.213,<->,50.72.52.215,6,882,0,0,6,882,0.865296000,0.4341
215.158.238.45,<->,122.216.233.104,6,1477,0,0,6,1477,0.863092000,0.3121
129.224.112.252,<->,97.242.126.202,6,397,0,0,6,397,0.862429000,0.3261
215.158.61.242,<->,8.176.8.197,0,0,6,6426,6,6426,0.860678000,0.4556
215.158.238.106,<->,140.174.80.153,6,1525,0,0,6,1525,0.860360000,0.2472
204.184.88.31,<->,136.25.188.220,0,0,6,424,6,424,0.860000000,0.0597
215.158.140.204,<->,6.15.196.155,6,3019,0,0,6,3019,0.855590000,0.9299
221.163.96.13,<->,80.41.23.81,0,0,6,3268,6,3268,0.854051000,0.0366
204.248.216.149,<->,0.195.210.46,0,0,6,1315,6,1315,0.853700000,1.0019
50.224.76.248,<->,29.128.174.25,6,5518,0,0,6,5518,0.853187000,0.5898
17.30.176.93,<->,8.220.206.230,0,0,6,490,6,490,0.851376000,0.1554
144.78.84.179,<->,144.70.14.37,0,0,6,709,6,709,0.850812000,0.1278
215.158.239.50,<->,199.121.172.138,6,921,0,0,6,921,0.849944000,0.5770
58.169.177.64,<->,0.195.210.33,0,0,6,312,6,312,0.843350000,1.0720
215.158.239.97,<->,199.20.28.166,6,400,0,0,6,400,0.842200000,0.0641
50.224.76.235,<->,29.95.75.90,6,4270,0,0,6,4270,0.840855000,0.2567
215.158.238.106,<->,8.189.240.232,6,1541,0,0,6,1541,0.840287000,0.1375
215.158.239.70,<->,199.20.28.92,6,1925,0,0,6,1925,0.840282000,0.9178
204.131.36.178,<->,0.195.210.33,0,0,6,412,6,412,0.840256000,0.0016
132.168.196.9,<->,33.240.77.13,6,745,0,0,6,745,0.839124000,1.1391
215.158.239.58,<->,199.20.28.199,6,348,0,0,6,348,0.837887000,0.4200
143.129.159.243,<->,136.25.188.197,0,0,6,348,6,348,0.834470000,0.4440
123.129.29.201,<->,33.233.141.78,0,0,6,324,6,324,0.834433000,1.1394
204.58.218.182,<->,136.25.188.177,0,0,6,349,6,349,0.831377000,0.2104
196.89.182.152,<->,136.25.188.242,0,0,6,1280,6,1280,0.831282000,0.5514
215.158.61.182,<->,136.25.189.221,0,0,6,2938,6,2938,0.830784000,1.1420
215.158.239.76,<->,196.109.46.20,6,516,0,0,6,516,0.830662000,0.8201
215.158.239.7,<->,29.214.74.201,6,3245,0,0,6,3245,0.830486000,0.7861
215.158.239.94,<->,196.1.17.216,6,436,0,0,6,436,0.829682000,0.3598
199.80.3.106,<->,136.25.188.162,0,0,6,349,6,349,0.829578000,0.2110
220.20.200.58,<->,144.83.60.153,6,5609,0,0,6,5609,0.829149000,0.2846
143.23.214.138,<->,136.25.188.243,0,0,6,647,6,647,0.826639000,0.8404
101.117.57.49,<->,92.27.219.56,0,0,6,1310,6,1310,0.823245000,0.9827
251.24.170.13,<->,8.182.248.147,0,0,6,797,6,797,0.823198000,0.7327
215.158.58.169,<->,6.73.247.85,0,0,6,3012,6,3012,0.821914000,0.7817
199.32.191.131,<->,136.25.188.209,0,0,6,400,6,400,0.821142000,0.0305
215.158.239.78,<->,199.20.30.94,6,363,0,0,6,363,0.820163000,0.5405
133.178.227.24,<->,126.219.194.55,6,2461,0,0,6,2461,0.818334000,0.8897
94.110.153.201,<->,8.252.222.204,0,0,6,2506,6,2506,0.817424000,0.9190
144.83.60.153,<->,92.162.253.96,0,0,6,5366,6,5366,0.816739000,0.7626
215.158.239.84,<->,196.88.121.14,6,465,0,0,6,465,0.816112000,0.8500
106.5.211.78,<->,99.160.108.248,0,0,6,1256,6,1256,0.813523000,1.1551
136.25.188.162,<->,126.219.132.210,6,3034,0,0,6,3034,0.811911000,0.5549
195.70.50.11,<->,136.25.188.176,0,0,6,453,6,453,0.811633000,1.0484
215.158.238.148,<->,131.1.195.235,6,3056,0,0,6,3056,0.807911000,1.1536
215.158.238.149,<->,114.25.48.55,6,1509,0,0,6,1509,0.806076000,0.1832
215.158.239.94,<->,207.236.113.233,6,300,0,0,6,300,0.804845000,0.0413
215.158.238.45,<->,192.227.190.232,6,1637,0,0,6,1637,0.804259000,0.1632
215.158.238.49,<->,129.222.36.70,6,1809,0,0,6,1809,0.803259000,1.1085
215.158.239.48,<->,207.114.77.109,6,868,0,0,6,868,0.802998000,1.1401
136.25.189.82,<->,131.144.113.60,6,2682,0,0,6,2682,0.802631000,0.8162
8.252.221.221,<->,4.123.161.8,6,420,0,0,6,420,0.801203000,1.0216
228.23.166.29,<->,50.224.61.172,0,0,6,336,6,336,0.799812000,1.1570
215.158.238.223,<->,29.211.228.202,6,1452,0,0,6,1452,0.799609000,0.1282
215.158.239.96,<->,194.199.215.226,6,412,0,0,6,412,0.799489000,0.0112
127.79.24.44,<->,50.224.76.235,0,0,6,1817,6,1817,0.798102000,0.3234
149.238.84.58,<->,0.195.210.42,0,0,6,953,6,953,0.796429000,0.5996
212.70.75.122,<->,136.25.188.211,0,0,6,1493,6,1493,0.795608000,0.0725
144.85.170.248,<->,98.87.144.220,6,1081,0,0,6,1081,0.794730000,0.2238
215.158.239.78,<->,131.144.113.62,6,2826,0,0,6,2826,0.793399000,0.5775
215.158.238.106,<->,126.148.130.18,6,1429,0,0,6,1429,0.792539000,0.1384
197.113.64.135,<->,136.25.188.174,0,0,6,300,6,300,0.789412000,0.2734
194.194.188.83,<->,50.224.76.235,0,0,6,1197,6,1197,0.789285000,0.7582
159.137.162.213,<->,125.194.251.186,6,882,0,0,6,882,0.787527000,0.7027
215.158.239.58,<->,199.20.31.155,6,1028,0,0,6,1028,0.786127000,1.0699
97.80.226.250,<->,8.182.251.47,0,0,6,587,6,587,0.786000000,0.3432
84.14.137.3,<->,8.43.215.120,0,0,6,597,6,597,0.785526000,1.0687
215.158.239.57,<->,204.226.34.131,6,318,0,0,6,318,0.785495000,0.1571
215.158.239.56,<->,199.20.31.153,6,542,0,0,6,542,0.785386000,1.0286
6.145.164.225,<->,0.195.210.44,0,0,6,551,6,551,0.785356000,0.4680
127.255.90.89,<->,92.162.253.155,0,0,6,4908,6,4908,0.785270000,0.1303
210.231.140.55,<->,109.1.30.25,0,0,6,1096,6,1096,0.782994000,0.1216
215.158.238.9,<->,113.23.101.99,6,1589,0,0,6,1589,0.782120000,0.1361
17.3.51.127,<->,8.220.176.253,0,0,6,604,6,604,0.781943000,0.8059
199.39.125.225,<->,136.25.188.176,0,0,6,1045,6,1045,0.779682000,0.3009
215.158.238.99,<->,149.99.92.107,6,1509,0,0,6,1509,0.778489000,0.1013
215.158.61.202,<->,8.176.8.110,0,0,6,3662,6,3662,0.776605000,1.0860
215.158.239.77,<->,207.213.183.113,6,412,0,0,6,412,0.776542000,0.0001
215.158.238.190,<->,122.159.123.19,6,3523,0,0,6,3523,0.774782000,1.0521
133.178.226.19,<->,111.150.186.232,6,2858,0,0,6,2858,0.774044000,0.8667
196.112.113.236,<->,8.252.222.142,0,0,6,595,6,595,0.773121000,0.8045
143.201.216.203,<->,50.224.76.230,0,0,6,670,6,670,0.773089000,0.6922
133.178.226.37,<->,131.144.114.210,6,4255,0,0,6,4255,0.771659000,1.0325
133.178.226.200,<->,65.26.114.236,6,440,0,0,6,440,0.771214000,0.4122
207.190.82.188,<->,136.25.188.254,0,0,6,312,6,312,0.770702000,0.3050
136.25.189.13,<->,120.154.71.7,6,3903,0,0,6,3903,0.769294000,1.0126
109.222.222.94,<->,50.236.255.219,6,2662,0,0,6,2662,0.769216000,0.1355
215.202.174.52,<->,136.25.189.45,0,0,6,2810,6,2810,0.767350000,0.4991
204.35.186.89,<->,50.223.3.228,0,0,6,510,6,510,0.766904000,0.6080
143.135.57.101,<->,8.52.222.199,0,0,6,770,6,770,0.765769000,0.6724
133.178.227.15,<->,8.191.14.1,6,1691,0,0,6,1691,0.764743000,0.0490
133.178.227.57,<->,8.192.205.0,6,3427,0,0,6,3427,0.763894000,1.1932
133.178.226.198,<->,125.84.55.74,6,440,0,0,6,440,0.763299000,0.3240
215.158.239.77,<->,142.249.122.150,6,349,0,0,6,349,0.763234000,0.3548
215.158.239.96,<->,204.0.145.195,6,336,0,0,6,336,0.763084000,0.6850
215.158.239.92,<->,199.20.31.109,6,1955,0,0,6,1955,0.761701000,0.3997
140.20.120.150,<->,0.195.210.42,0,0,6,973,6,973,0.761579000,0.5437
215.158.238.110,<->,100.224.166.163,6,1686,0,0,6,1686,0.756315000,1.1641
215.158.239.58,<->,207.114.231.138,6,412,0,0,6,412,0.756059000,0.0705
247.136.188.124,<->,125.37.185.34,6,300,0,0,6,300,0.753453000,1.0232
133.178.226.201,<->,113.23.114.107,6,440,0,0,6,440,0.751571000,0.3647
215.158.238.80,<->,113.23.104.203,6,349,0,0,6,349,0.749818000,0.1534
207.61.62.32,<->,136.25.188.177,0,0,6,400,6,400,0.749735000,0.0086
142.252.164.112,<->,136.25.188.241,0,0,6,636,6,636,0.749300000,1.1272
53.244.110.182,<->,48.53.107.207,0,0,6,448,6,448,0.746343000,0.5828
136.25.188.242,<->,113.23.40.36,6,336,0,0,6,336,0.740775000,0.0656
123.129.29.205,<->,101.224.89.165,0,0,6,324,6,324,0.738859000,1.1420
204.200.50.182,<->,136.25.188.242,0,0,6,963,6,963,0.738663000,0.7822
215.158.239.71,<->,122.159.245.45,6,3887,0,0,6,3887,0.737875000,1.2566
133.244.28.233,<->,124.55.36.171,6,656,0,0,6,656,0.736296000,0.6185
215.158.239.79,<->,106.188.253.230,6,4240,0,0,6,4240,0.732699000,1.2513
215.158.239.34,<->,33.209.213.2,6,1928,0,0,6,1928,0.729631000,0.1199
195.55.27.178,<->,136.25.188.174,0,0,6,349,6,349,0.728963000,0.1846
123.129.29.205,<->,101.224.89.151,0,0,6,324,6,324,0.728746000,1.1479
133.178.227.24,<->,8.50.171.253,6,1653,0,0,6,1653,0.728507000,0.0948
215.158.238.115,<->,131.144.114.208,6,3791,0,0,6,3791,0.727589000,1.2494
196.89.28.2,<->,136.25.188.175,0,0,6,1177,6,1177,0.725979000,0.3700
89.183.106.29,<->,42.44.75.221,6,2326,0,0,6,2326,0.724384000,0.3408
195.42.58.202,<->,136.25.188.54,0,0,6,965,6,965,0.722243000,0.4427
129.224.112.252,<->,97.242.126.182,6,389,0,0,6,389,0.722126000,0.3360
136.25.188.198,<->,131.36.198.43,6,1716,0,0,6,1716,0.719181000,0.4768
215.158.239.207,<->,111.42.21.89,6,6126,0,0,6,6126,0.719043000,0.0311
129.224.112.252,<->,97.242.126.194,6,400,0,0,6,400,0.717855000,0.3341
215.158.239.97,<->,199.20.7.56,6,412,0,0,6,412,0.716122000,0.0002
75.214.216.204,<->,8.252.221.197,0,0,6,2077,6,2077,0.715133000,0.4834
195.40.165.103,<->,136.25.188.45,0,0,6,412,6,412,0.714876000,0.0135
56.189.215.197,<->,8.52.171.236,0,0,6,577,6,577,0.714280000,0.0796
215.158.238.254,<->,215.158.43.18,6,836,0,0,6,836,0.712051000,0.1632
215.158.239.40,<->,8.241.236.118,6,3416,0,0,6,3416,0.710618000,0.4467
215.158.61.195,<->,8.176.8.242,0,0,6,6789,6,6789,0.710263000,0.0006
136.25.189.1,<->,114.25.48.63,6,3775,0,0,6,3775,0.707844000,0.8605
207.62.18.101,<->,136.25.188.241,0,0,6,1873,6,1873,0.707833000,0.9683
142.227.97.183,<->,136.25.188.222,0,0,6,400,6,400,0.706644000,0.0089
215.158.239.56,<->,207.188.31.83,6,412,0,0,6,412,0.705460000,0.0699
8.220.176.253,<->,6.101.63.48,6,776,0,0,6,776,0.704146000,1.0461
195.55.212.125,<->,136.25.188.209,0,0,6,950,6,950,0.703294000,0.2840
215.158.239.78,<->,195.83.97.243,6,412,0,0,6,412,0.701688000,0.0363
136.25.188.179,<->,113.23.104.221,6,1557,0,0,6,1557,0.701566000,0.3113
109.222.238.4,<->,53.231.222.55,6,1320,0,0,6,1320,0.701490000,1.2258
118.32.15.68,<->,89.183.104.145,0,0,6,8376,6,8376,0.699326000,1.1014
197.161.164.190,<->,136.25.188.253,0,0,6,312,6,312,0.695296000,0.2144
123.129.29.201,<->,33.233.141.118,0,0,6,324,6,324,0.694683000,1.1412
111.20.168.186,<->,27.127.249.118,6,324,0,0,6,324,0.694352000,1.1737
247.136.142.34,<->,14.30.152.74,6,5148,0,0,6,5148,0.692780000,0.6184
54.59.25.47,<->,48.53.104.85,0,0,6,2335,6,2335,0.692468000,0.9654
221.102.126.240,<->,220.21.27.234,6,491,0,0,6,491,0.691270000,1.2298
159.137.162.213,<->,122.212.51.57,6,1170,0,0,6,1170,0.685842000,0.6880
200.175.136.51,<->,53.214.124.109,6,2157,0,0,6,2157,0.685318000,1.1195
215.158.238.65,<->,143.20.121.150,6,1461,0,0,6,1461,0.683091000,1.1683
89.155.218.186,<->,8.182.226.78,0,0,6,906,6,906,0.681364000,0.9383
123.129.29.204,<->,111.20.168.191,0,0,6,324,6,324,0.680236000,1.1399
145.255.249.236,<->,80.38.60.123,0,0,6,1239,6,1239,0.678901000,0.0418
86.194.118.34,<->,0.195.210.24,0,0,6,651,6,651,0.674528000,1.2589
42.197.80.101,<->,20.194.211.253,0,0,6,848,6,848,0.672956000,0.0712
137.132.207.124,<->,132.49.148.23,0,0,6,5120,6,5120,0.672113000,0.7609
110.85.216.27,<->,89.183.104.137,0,0,6,1230,6,1230,0.672089000,0.7339
159.137.162.213,<->,117.49.144.192,6,882,0,0,6,882,0.669134000,0.6038
142.228.94.214,<->,136.25.188.163,0,0,6,1067,6,1067,0.668076000,1.0215
86.135.118.11,<->,8.252.222.23,0,0,6,412,6,412,0.667822000,0.0061
215.158.3.139,<->,8.176.8.206,0,0,6,1791,6,1791,0.667402000,0.4798
215.158.238.209,<->,119.196.23.20,6,1424,0,0,6,1424,0.666688000,0.2265
215.158.239.56,<->,199.20.31.134,6,532,0,0,6,532,0.664495000,1.1299
215.158.239.93,<->,199.20.6.34,6,336,0,0,6,336,0.662977000,0.7184
215.158.239.50,<->,98.28.95.86,6,2922,0,0,6,2922,0.660130000,0.9089
142.252.182.152,<->,136.25.188.178,0,0,6,336,6,336,0.653689000,0.0589
101.87.213.152,<->,100.228.42.72,0,0,6,1498,6,1498,0.653668000,0.7885
207.59.144.70,<->,91.231.195.125,0,0,6,360,6,360,0.652928000,0.9022
136.25.189.29,<->,106.188.253.230,6,3088,0,0,6,3088,0.651175000,0.9426
215.158.239.248,<->,139.163.167.61,6,435,0,0,6,435,0.650938000,0.0840
69.103.229.5,<->,8.252.222.159,0,0,6,436,6,436,0.650365000,0.0006
136.25.188.44,<->,91.247.40.52,6,2149,0,0,6,2149,0.649901000,0.4332
142.247.209.45,<->,136.25.188.176,0,0,6,924,6,924,0.648255000,1.1159
196.89.74.120,<->,136.25.188.163,0,0,6,349,6,349,0.647893000,0.2140
215.158.239.50,<->,112.220.198.105,6,2730,0,0,6,2730,0.646304000,0.3029
207.172.230.55,<->,136.25.188.196,0,0,6,408,6,408,0.644427000,0.8581
215.158.239.50,<->,143.44.248.149,6,1059,0,0,6,1059,0.643977000,0.3970
133.178.226.3,<->,100.120.38.6,6,2415,0,0,6,2415,0.643411000,0.7289
215.158.238.123,<->,29.214.66.254,6,1445,0,0,6,1445,0.643165000,0.1089
195.6.38.82,<->,136.25.188.252,0,0,6,424,6,424,0.642449000,0.0077
215.158.238.65,<->,112.220.206.117,6,2917,0,0,6,2917,0.642314000,1.2897
213.186.59.241,<->,144.85.170.254,0,0,6,1017,6,1017,0.641223000,1.0610
136.25.189.15,<->,29.211.93.23,6,3999,0,0,6,3999,0.640141000,1.1753
220.49.55.254,<->,133.32.39.251,0,0,6,544,6,544,0.639825000,0.0462
204.185.167.224,<->,136.25.188.196,0,0,6,360,6,360,0.635830000,0.4206
215.158.239.59,<->,199.20.28.157,6,412,0,0,6,412,0.634908000,0.0401
136.25.188.166,<->,96.155.61.55,6,5546,0,0,6,5546,0.633836000,0.4068
220.28.104.193,<->,136.25.189.40,0,0,6,7658,6,7658,0.633524000,0.0000
215.158.239.76,<->,199.20.30.82,6,412,0,0,6,412,0.633036000,0.1006
215.158.239.56,<->,199.20.30.122,6,320,0,0,6,320,0.632839000,1.2275
215.158.238.81,<->,42.226.3.106,6,2922,0,0,6,2922,0.632661000,0.5662
148.46.100.128,<->,50.224.76.234,0,0,6,1930,6,1930,0.632394000,0.6100
215.158.239.70,<->,8.215.68.72,6,4127,0,0,6,4127,0.631431000,1.0381
139.60.197.151,<->,136.25.188.222,0,0,6,595,6,595,0.630716000,0.3188
136.25.188.160,<->,111.151.70.36,6,3871,0,0,6,3871,0.630669000,1.3576
230.156.223.131,<->,8.252.222.174,0,0,6,412,6,412,0.628718000,0.0058
133.178.226.70,<->,131.144.116.40,6,2810,0,0,6,2810,0.628639000,0.8666
215.158.238.82,<->,131.144.113.190,6,1509,0,0,6,1509,0.628284000,1.2369
109.222.197.2,<->,54.49.231.97,6,813,0,0,6,813,0.627962000,0.1966
215.158.239.93,<->,204.226.53.177,6,412,0,0,6,412,0.625411000,0.0017
136.25.188.252,<->,132.128.123.251,6,586,0,0,6,586,0.623786000,0.2977
220.28.115.46,<->,136.25.188.235,0,0,6,6623,6,6623,0.612856000,0.0031
133.8.10.9,<->,8.182.227.18,0,0,6,1524,6,1524,0.612469000,0.4976
158.85.62.60,<->,133.178.226.197,0,0,6,433,6,433,0.612305000,0.3504
144.75.218.235,<->,99.168.7.150,6,846,0,0,6,846,0.611779000,0.6927
246.253.132.241,<->,119.231.234.34,6,448,0,0,6,448,0.611676000,0.9205
215.158.239.95,<->,207.188.25.110,6,312,0,0,6,312,0.611170000,0.0508
231.143.159.131,<->,136.25.188.162,0,0,6,412,6,412,0.609311000,0.0192
136.25.188.224,<->,131.144.114.210,6,3903,0,0,6,3903,0.609037000,1.2584
8.182.244.237,<->,6.20.49.254,6,627,0,0,6,627,0.608805000,0.3958
6.145.170.85,<->,0.195.210.44,0,0,6,507,6,507,0.607679000,0.1476
215.158.238.84,<->,98.219.126.175,6,6249,0,0,6,6249,0.607085000,0.0158
142.228.58.200,<->,136.25.188.198,0,0,6,1256,6,1256,0.605705000,1.2979
111.189.106.149,<->,50.224.88.92,0,0,6,336,6,336,0.604755000,1.0242
136.25.189.12,<->,116.106.46.73,6,3855,0,0,6,3855,0.603952000,1.1794
197.113.99.218,<->,136.25.188.238,0,0,6,412,6,412,0.602922000,0.0010
215.158.239.57,<->,89.80.251.11,6,4095,0,0,6,4095,0.601975000,0.9829
159.178.76.115,<->,8.52.189.207,0,0,6,715,6,715,0.601967000,0.0629
143.206.95.198,<->,0.195.210.33,0,0,6,306,6,306,0.601356000,1.3270
149.91.110.39,<->,92.27.219.52,0,0,6,974,6,974,0.600815000,0.9301
204.61.131.48,<->,8.52.182.119,0,0,6,324,6,324,0.600240000,1.2413
195.124.8.54,<->,136.25.188.227,0,0,6,696,6,696,0.600054000,0.8587
199.48.57.141,<->,8.252.222.36,0,0,6,412,6,412,0.599899000,0.0000
215.158.238.135,<->,197.103.151.86,6,2858,0,0,6,2858,0.599835000,0.8573
207.188.205.95,<->,136.25.188.174,0,0,6,868,6,868,0.599584000,0.5310
195.13.70.1,<->,136.25.188.177,0,0,6,348,6,348,0.598143000,0.4026
142.236.198.16,<->,136.25.188.209,0,0,6,306,6,306,0.597969000,0.7261
143.43.208.90,<->,136.25.188.255,0,0,6,432,6,432,0.597397000,1.0763
144.85.170.208,<->,91.69.185.208,6,1037,0,0,6,1037,0.596954000,0.2151
215.158.239.92,<->,207.236.231.93,6,1116,0,0,6,1116,0.595306000,1.3979
98.232.172.226,<->,6.133.244.165,6,746,0,0,6,746,0.592687000,0.1041
144.71.42.15,<->,105.200.46.248,6,711,0,0,6,711,0.592330000,0.2949
144.85.170.254,<->,91.69.181.217,6,1008,0,0,6,1008,0.592067000,0.1165
22.61.14.243,<->,8.220.234.165,0,0,6,691,6,691,0.592046000,0.1223
215.158.239.49,<->,195.80.132.108,6,349,0,0,6,349,0.591893000,0.4000
136.25.189.85,<->,129.175.139.162,6,4741,0,0,6,4741,0.590578000,0.0058
215.158.238.76,<->,139.163.161.50,6,1234,0,0,6,1234,0.589117000,0.3884
215.158.239.100,<->,215.158.61.193,6,2878,0,0,6,2878,0.587698000,0.7196
213.221.90.194,<->,144.85.170.208,0,0,6,1059,6,1059,0.586302000,0.1345
220.55.77.155,<->,105.201.86.202,6,526,0,0,6,526,0.585996000,0.3497
133.41.83.22,<->,98.236.194.252,0,0,6,300,6,300,0.585461000,1.2157
143.42.53.127,<->,136.25.188.222,0,0,6,806,6,806,0.585322000,0.3582
239.66.240.179,<->,144.86.146.31,0,0,6,4002,6,4002,0.584479000,0.2310
136.25.189.14,<->,113.23.14.192,6,2778,0,0,6,2778,0.584288000,0.4793
215.158.239.76,<->,194.202.158.24,6,605,0,0,6,605,0.582360000,1.3300
215.158.238.107,<->,128.123.91.51,6,2634,0,0,6,2634,0.581153000,1.2408
242.43.134.86,<->,8.220.190.86,0,0,6,912,6,912,0.580547000,0.1130
194.232.222.255,<->,136.25.188.239,0,0,6,1045,6,1045,0.580486000,0.4280
231.141.51.137,<->,215.158.239.84,0,0,6,336,6,336,0.580391000,0.0234
215.158.238.81,<->,113.23.104.246,6,1883,0,0,6,1883,0.579265000,1.2880
136.25.188.210,<->,122.158.245.153,6,2842,0,0,6,2842,0.578778000,0.7195
215.158.239.210,<->,106.188.184.103,6,7845,0,0,6,7845,0.575220000,0.0000
215.158.239.68,<->,199.20.31.109,6,343,0,0,6,343,0.575213000,0.3208
143.43.38.70,<->,136.25.188.174,0,0,6,1061,6,1061,0.574938000,0.3912
215.158.239.94,<->,131.144.115.229,6,2938,0,0,6,2938,0.574923000,0.8764
109.1.0.79,<->,68.227.114.13,6,336,0,0,6,336,0.573376000,1.1501
139.193.141.139,<->,136.99.104.229,6,3880,0,0,6,3880,0.570740000,1.0803
215.158.239.94,<->,29.209.59.247,6,2874,0,0,6,2874,0.567744000,0.4038
215.158.239.49,<->,199.20.28.187,6,360,0,0,6,360,0.567662000,0.4791
215.158.238.45,<->,129.175.139.72,6,2754,0,0,6,2754,0.564265000,1.2160
143.89.17.109,<->,136.25.188.253,0,0,6,300,6,300,0.563968000,0.3850
215.158.239.95,<->,207.61.246.164,6,993,0,0,6,993,0.562880000,0.5992
207.188.104.86,<->,136.25.188.222,0,0,6,349,6,349,0.562664000,0.3112
133.178.227.57,<->,69.150.168.218,6,1337,0,0,6,1337,0.560402000,0.4044
215.158.239.49,<->,199.20.7.119,6,1856,0,0,6,1856,0.560196000,0.8105
215.158.239.57,<->,195.54.65.95,6,690,0,0,6,690,0.560184000,1.4031
196.247.213.16,<->,136.25.188.52,0,0,6,400,6,400,0.559321000,0.0436
156.165.37.86,<->,136.25.189.90,0,0,6,2682,6,2682,0.558821000,1.3189
195.71.51.137,<->,136.25.188.252,0,0,6,1539,6,1539,0.558541000,0.4020
133.178.227.24,<->,68.231.26.212,6,2540,0,0,6,2540,0.557690000,0.7316
132.200.63.92,<->,132.200.62.136,0,0,6,3087,6,3087,0.555822000,0.1940
136.25.188.174,<->,98.166.239.41,6,1605,0,0,6,1605,0.555774000,0.1786
207.74.57.14,<->,8.252.222.7,0,0,6,3524,6,3524,0.555570000,1.0667
215.158.238.66,<->,113.23.104.213,6,2762,0,0,6,2762,0.555220000,0.4827
223.115.93.132,<->,8.252.222.23,0,0,6,412,6,412,0.553109000,0.0012
215.158.238.135,<->,126.219.190.163,6,3327,0,0,6,3327,0.552701000,1.3110
215.158.238.45,<->,148.129.19.94,6,1637,0,0,6,1637,0.552357000,0.3108
136.25.188.46,<->,92.57.203.84,6,412,0,0,6,412,0.550951000,0.0025
215.158.238.120,<->,104.3.161.52,6,1557,0,0,6,1557,0.550069000,0.2288
195.68.143.220,<->,136.25.188.44,0,0,6,342,6,342,0.544555000,0.5362
215.158.239.58,<->,194.203.106.186,6,1362,0,0,6,1362,0.544257000,1.3400
133.178.226.29,<->,131.36.198.34,6,1398,0,0,6,1398,0.541664000,0.5255
142.254.64.146,<->,136.25.188.163,0,0,6,400,6,400,0.541429000,1.3413
215.158.239.244,<->,145.234.107.201,6,442,0,0,6,442,0.537106000,0.0778
199.123.182.73,<->,136.25.188.54,0,0,6,412,6,412,0.536687000,0.0115
133.178.226.90,<->,111.151.239.86,6,2906,0,0,6,2906,0.535742000,0.6277
215.158.140.83,<->,8.53.217.116,6,2353,0,0,6,2353,0.534791000,1.1246
195.68.143.220,<->,136.25.188.177,0,0,6,342,6,342,0.534531000,0.5257
138.126.75.90,<->,136.25.188.221,0,0,6,2746,6,2746,0.534292000,0.6488
136.25.189.57,<->,126.219.194.27,6,3967,0,0,6,3967,0.532483000,1.0154
97.193.1.108,<->,8.52.226.56,0,0,6,625,6,625,0.531618000,0.3239
199.32.189.22,<->,136.25.188.178,0,0,6,400,6,400,0.529266000,0.0344
136.25.188.178,<->,131.144.113.189,6,2666,0,0,6,2666,0.527762000,0.9262
196.245.77.91,<->,136.25.188.176,0,0,6,1231,6,1231,0.526180000,1.4100
133.178.226.28,<->,8.241.236.64,6,2442,0,0,6,2442,0.526034000,0.5137
148.21.212.169,<->,136.25.189.88,0,0,6,4063,6,4063,0.524783000,1.4669
73.94.145.187,<->,0.195.210.42,0,0,6,730,6,730,0.524529000,0.4543
215.158.239.78,<->,126.219.49.136,6,1637,0,0,6,1637,0.522462000,0.2143
213.186.61.53,<->,144.85.170.254,0,0,6,1319,6,1319,0.522422000,0.3982
136.25.189.18,<->,96.156.169.182,6,2794,0,0,6,2794,0.521534000,1.1015
204.2.222.151,<->,136.25.188.209,0,0,6,488,6,488,0.520679000,0.9464
215.158.239.58,<->,199.68.125.89,6,412,0,0,6,412,0.519600000,0.0113
133.178.227.250,<->,8.191.15.151,6,4570,0,0,6,4570,0.515679000,0.0879
136.25.189.77,<->,61.35.70.234,6,3855,0,0,6,3855,0.513777000,0.9197
133.178.226.203,<->,106.188.156.220,6,336,0,0,6,336,0.513015000,0.9990
199.38.118.206,<->,136.25.188.237,0,0,6,412,6,412,0.511305000,0.0160
220.20.200.30,<->,144.83.60.153,6,2704,0,0,6,2704,0.510544000,1.4115
215.158.239.85,<->,196.92.199.220,6,1045,0,0,6,1045,0.509827000,0.4599
135.253.11.54,<->,133.178.226.30,0,0,6,1605,6,1605,0.509268000,0.1511
135.204.166.170,<->,133.178.227.198,0,0,6,816,6,816,0.508972000,1.1240
143.89.63.84,<->,136.25.188.176,0,0,6,606,6,606,0.508830000,1.2986
159.112.9.198,<->,145.16.10.145,0,0,6,362,6,362,0.508763000,1.4883
143.252.64.234,<->,129.224.112.252,0,0,6,420,6,420,0.507997000,1.3755
215.158.239.78,<->,196.93.124.62,6,1061,0,0,6,1061,0.507636000,0.8457
194.233.59.201,<->,136.25.188.163,0,0,6,1881,6,1881,0.507276000,1.2799
99.251.218.97,<->,50.224.49.195,0,0,6,336,6,336,0.505566000,1.4582
118.234.243.5,<->,92.27.27.160,0,0,6,330,6,330,0.505506000,1.1784
92.27.219.44,<->,38.102.71.20,6,348,0,0,6,348,0.503413000,1.4292
199.69.16.7,<->,136.25.188.46,0,0,6,400,6,400,0.501788000,0.0197
215.158.238.209,<->,215.158.6.213,6,1637,0,0,6,1637,0.500822000,0.2144
215.158.239.48,<->,199.20.5.165,6,381,0,0,6,381,0.499845000,0.6395
207.63.14.182,<->,136.25.188.226,0,0,6,412,6,412,0.498032000,0.0143
205.127.108.114,<->,33.233.141.3,0,0,6,4170,6,4170,0.497314000,0.3524
215.158.238.135,<->,38.206.2.171,6,1301,0,0,6,1301,0.497054000,0.3566
192.224.20.76,<->,133.178.227.138,0,0,6,3381,6,3381,0.495697000,0.4565
215.158.239.99,<->,194.251.125.110,6,349,0,0,6,349,0.488712000,0.2267
215.158.239.49,<->,199.20.6.213,6,527,0,0,6,527,0.488410000,0.3699
215.158.239.49,<->,199.20.31.241,6,312,0,0,6,312,0.488180000,0.3671
133.178.226.61,<->,106.188.252.235,6,1477,0,0,6,1477,0.487788000,0.1520
215.158.238.47,<->,56.161.218.55,6,1669,0,0,6,1669,0.486345000,0.2843
136.25.188.250,<->,100.224.202.146,6,1686,0,0,6,1686,0.485689000,1.3988
215.158.140.92,<->,148.26.113.122,6,2510,0,0,6,2510,0.479084000,1.2129
215.158.238.141,<->,106.188.251.194,6,2877,0,0,6,2877,0.475848000,0.5312
199.80.148.235,<->,136.25.188.160,0,0,6,343,6,343,0.475764000,0.2282
215.158.239.69,<->,142.244.40.14,6,306,0,0,6,306,0.474146000,0.4740
30.177.88.204,<->,8.252.221.222,0,0,6,300,6,300,0.474101000,0.0201
144.85.170.208,<->,91.69.181.135,6,1045,0,0,6,1045,0.473533000,0.1271
50.224.76.234,<->,38.12.28.107,6,3048,0,0,6,3048,0.472761000,0.6451
215.158.239.79,<->,199.20.30.59,6,1718,0,0,6,1718,0.471608000,0.0587
203.236.63.34,<->,136.25.188.241,0,0,6,349,6,349,0.471445000,0.2572
136.25.189.80,<->,96.156.169.163,6,1797,0,0,6,1797,0.468275000,0.1154
196.247.87.19,<->,136.25.188.252,0,0,6,349,6,349,0.468152000,0.5001
213.186.52.112,<->,144.85.170.254,0,0,6,1172,6,1172,0.467869000,0.8768
204.186.155.189,<->,136.25.188.208,0,0,6,438,6,438,0.467234000,1.2798
195.14.252.131,<->,136.25.188.239,0,0,6,412,6,412,0.466993000,0.0086
148.186.207.40,<->,136.25.188.160,0,0,6,1493,6,1493,0.466451000,0.4056
143.129.189.14,<->,136.25.188.225,0,0,6,343,6,343,0.466292000,0.3173
215.158.239.49,<->,207.115.105.22,6,396,0,0,6,396,0.465448000,1.4844
159.137.162.213,<->,50.72.253.151,6,882,0,0,6,882,0.463517000,0.3920
215.158.238.45,<->,120.155.14.75,6,1457,0,0,6,1457,0.461230000,0.4047
215.158.52.228,<->,144.95.104.75,6,300,0,0,6,300,0.460967000,1.3092
200.174.222.130,<->,54.38.66.95,6,9024,0,0,6,9024,0.458001000,0.7304
136.25.188.236,<->,108.47.170.254,6,412,0,0,6,412,0.457982000,0.0055
215.158.239.70,<->,199.20.29.230,6,384,0,0,6,384,0.457619000,0.6997
215.158.239.49,<->,207.191.194.245,6,412,0,0,6,412,0.456764000,0.0096
129.16.253.244,<->,6.74.201.153,0,0,6,4021,6,4021,0.456082000,0.1337
215.158.239.92,<->,196.104.200.133,6,1242,0,0,6,1242,0.455386000,0.5506
133.24.118.119,<->,92.27.27.174,0,0,6,4732,6,4732,0.454327000,0.8795
195.14.151.159,<->,136.25.188.222,0,0,6,678,6,678,0.454318000,0.8254
199.61.238.80,<->,50.224.76.234,0,0,6,1795,6,1795,0.453707000,0.2800
136.18.96.147,<->,8.182.253.209,0,0,6,300,6,300,0.450166000,0.0557
195.54.103.39,<->,136.25.188.227,0,0,6,1014,6,1014,0.449985000,0.8733
215.158.239.86,<->,199.20.28.26,6,412,0,0,6,412,0.444351000,0.0099
159.137.162.213,<->,121.124.232.8,6,882,0,0,6,882,0.443515000,0.8182
218.4.181.154,<->,133.0.57.72,6,5496,0,0,6,5496,0.443000000,0.0605
215.158.239.68,<->,196.109.111.47,6,1562,0,0,6,1562,0.441560000,0.6504
101.224.89.146,<->,27.127.249.118,6,324,0,0,6,324,0.441188000,1.1718
215.158.239.76,<->,196.91.254.208,6,1370,0,0,6,1370,0.440433000,1.2797
215.158.239.51,<->,199.20.5.41,6,590,0,0,6,590,0.438783000,1.3619
101.70.119.191,<->,91.42.125.111,6,336,0,0,6,336,0.437801000,1.0471
220.20.200.117,<->,131.45.239.178,6,3302,0,0,6,3302,0.437719000,0.2271
215.158.239.56,<->,199.20.31.112,6,393,0,0,6,393,0.437284000,0.2200
215.158.238.148,<->,8.252.253.167,6,336,0,0,6,336,0.436149000,0.0681
207.191.153.44,<->,136.25.188.255,0,0,6,528,6,528,0.434741000,1.0094
195.71.188.138,<->,136.25.188.209,0,0,6,1045,6,1045,0.434620000,0.1670
199.70.73.92,<->,136.25.188.210,0,0,6,1658,6,1658,0.433448000,1.3579
215.158.238.64,<->,111.150.34.233,6,2906,0,0,6,2906,0.432906000,1.2294
215.158.239.51,<->,199.20.63.99,6,1141,0,0,6,1141,0.431850000,1.0168
152.19.29.118,<->,145.16.82.40,0,0,6,6285,6,6285,0.427783000,1.4378
144.85.170.208,<->,91.69.181.254,6,722,0,0,6,722,0.426723000,0.1333
92.162.46.53,<->,8.43.220.205,0,0,6,432,6,432,0.426511000,0.0855
215.158.239.77,<->,199.20.31.28,6,400,0,0,6,400,0.423432000,0.0399
215.158.238.72,<->,8.42.43.88,6,1525,0,0,6,1525,0.423265000,0.1642
195.68.106.161,<->,136.25.188.163,0,0,6,1428,6,1428,0.422398000,1.2400
69.103.57.90,<->,8.252.222.63,0,0,6,412,6,412,0.422161000,0.0023
197.125.126.184,<->,136.25.188.172,0,0,6,3002,6,3002,0.420650000,0.7951
133.178.226.71,<->,29.211.176.199,6,1285,0,0,6,1285,0.419179000,0.0992
139.163.17.164,<->,103.182.183.111,6,300,0,0,6,300,0.417939000,1.5363
215.158.238.92,<->,42.226.3.104,6,2762,0,0,6,2762,0.416044000,1.3293
215.158.238.69,<->,98.219.126.175,6,8195,0,0,6,8195,0.415257000,0.0000
108.39.122.228,<->,89.183.104.152,0,0,6,830,6,830,0.415202000,1.5390
246.253.217.179,<->,111.88.67.179,6,786,0,0,6,786,0.414968000,0.3744
199.38.230.44,<->,136.25.188.241,0,0,6,1045,6,1045,0.414395000,0.3803
129.5.109.106,<->,111.20.168.184,0,0,6,324,6,324,0.413459000,1.2557
215.158.239.71,<->,120.154.131.7,6,2666,0,0,6,2666,0.412692000,1.4475
215.158.238.107,<->,99.192.168.153,6,2924,0,0,6,2924,0.411831000,0.1628
199.70.25.8,<->,136.25.188.210,0,0,6,334,6,334,0.410894000,0.8463
246.254.97.230,<->,54.55.44.79,6,4147,0,0,6,4147,0.410839000,0.2931
203.212.38.184,<->,139.163.96.101,0,0,6,951,6,951,0.409165000,1.4518
192.176.58.4,<->,136.25.188.209,0,0,6,412,6,412,0.408614000,0.0153
123.129.29.205,<->,111.20.168.190,0,0,6,324,6,324,0.407921000,1.1429
144.85.170.254,<->,98.87.147.61,6,336,0,0,6,336,0.404040000,0.7870
215.158.239.48,<->,195.96.140.134,6,412,0,0,6,412,0.402938000,0.0100
146.200.165.115,<->,0.195.210.42,0,0,6,412,6,412,0.402197000,0.0022
199.39.215.192,<->,136.25.188.196,0,0,6,1178,6,1178,0.401915000,0.2310
197.113.64.188,<->,136.25.188.46,0,0,6,412,6,412,0.399942000,0.0891
144.86.151.96,<->,8.16.244.137,6,603,0,0,6,603,0.397957000,0.0744
139.163.26.238,<->,27.11.188.105,6,438,0,0,6,438,0.397466000,0.4080
204.21.111.107,<->,136.25.188.236,0,0,6,563,6,563,0.397426000,0.1629
207.191.183.130,<->,136.25.188.196,0,0,6,1181,6,1181,0.396705000,0.3965
207.190.19.146,<->,136.25.188.173,0,0,6,336,6,336,0.395473000,0.0071
69.246.45.220,<->,8.252.222.148,0,0,6,312,6,312,0.392539000,0.2075
53.213.167.52,<->,48.54.32.146,0,0,6,2553,6,2553,0.391232000,1.3785
215.158.239.77,<->,195.81.10.41,6,1061,0,0,6,1061,0.390217000,0.2690
215.158.239.94,<->,29.213.219.93,6,2986,0,0,6,2986,0.389634000,1.2764
215.158.239.70,<->,199.20.30.130,6,1938,0,0,6,1938,0.389001000,1.6081
127.168.165.134,<->,8.176.8.232,0,0,6,916,6,916,0.388133000,0.2890
142.191.110.27,<->,136.25.188.236,0,0,6,1178,6,1178,0.387736000,0.3566
213.186.52.51,<->,144.85.170.254,0,0,6,1053,6,1053,0.386607000,0.1527
215.158.238.120,<->,113.23.21.215,6,349,0,0,6,349,0.386579000,0.1436
199.55.245.48,<->,8.252.222.172,0,0,6,1460,6,1460,0.386473000,0.5548
207.86.141.69,<->,8.20.87.153,0,0,6,1101,6,1101,0.386396000,0.3665
126.82.139.21,<->,80.40.24.143,0,0,6,406,6,406,0.385460000,1.5464
123.215.22.204,<->,80.42.189.6,0,0,6,2430,6,2430,0.384704000,1.5623
215.158.239.70,<->,196.93.60.100,6,412,0,0,6,412,0.384407000,0.0800
215.158.239.84,<->,199.20.29.49,6,336,0,0,6,336,0.383315000,0.0480
215.158.239.56,<->,199.20.29.20,6,396,0,0,6,396,0.382708000,1.3200
195.70.94.211,<->,50.224.76.234,0,0,6,900,6,900,0.382359000,0.5484
206.23.120.250,<->,80.40.10.148,0,0,6,944,6,944,0.381866000,0.4606
57.144.20.230,<->,0.195.210.42,0,0,6,1355,6,1355,0.381540000,0.3780
215.158.239.93,<->,207.190.52.97,6,349,0,0,6,349,0.380346000,0.2487
215.158.239.95,<->,131.144.115.74,6,3066,0,0,6,3066,0.380271000,1.4899
215.158.239.99,<->,199.50.4.111,6,1096,0,0,6,1096,0.378155000,1.5762
111.20.168.180,<->,27.127.250.105,6,324,0,0,6,324,0.377843000,1.1726
139.79.15.85,<->,50.224.49.195,0,0,6,336,6,336,0.376483000,1.5360
215.158.239.92,<->,199.20.31.54,6,518,0,0,6,518,0.375925000,0.0802
199.32.132.206,<->,136.25.188.220,0,0,6,436,6,436,0.375489000,0.8640
215.158.238.188,<->,8.219.184.85,6,1331,0,0,6,1331,0.375087000,0.0467
194.237.188.20,<->,136.25.188.198,0,0,6,412,6,412,0.374615000,0.0147
215.158.239.97,<->,199.20.31.203,6,1302,0,0,6,1302,0.374479000,1.6001
204.187.220.47,<->,136.25.188.45,0,0,6,2393,6,2393,0.373273000,1.5896
143.132.101.223,<->,136.25.188.178,0,0,6,1363,6,1363,0.371865000,1.4201
98.236.90.167,<->,8.37.194.3,6,4690,0,0,6,4690,0.371203000,0.2864
215.158.140.149,<->,122.158.69.2,6,6672,0,0,6,6672,0.370604000,1.0881
215.158.239.94,<->,207.114.153.94,6,412,0,0,6,412,0.368701000,0.0280
142.208.120.204,<->,136.25.188.198,0,0,6,412,6,412,0.368474000,0.0096
138.121.99.24,<->,8.220.186.82,0,0,6,445,6,445,0.368273000,1.5417
141.182.238.203,<->,8.252.221.223,0,0,6,560,6,560,0.368235000,1.0991
111.20.168.175,<->,92.160.6.243,6,324,0,0,6,324,0.368080000,1.0689
218.147.52.203,<->,8.176.40.207,0,0,6,680,6,680,0.368003000,0.2035
50.51.186.123,<->,8.220.189.156,0,0,6,930,6,930,0.366863000,0.2568
237.115.193.115,<->,139.163.8.98,0,0,6,300,6,300,0.365996000,1.3917
136.25.189.77,<->,56.161.218.36,6,4191,0,0,6,4191,0.365475000,0.9559
139.163.96.103,<->,104.240.21.99,6,1247,0,0,6,1247,0.365353000,1.4211
215.158.239.93,<->,207.57.53.201,6,336,0,0,6,336,0.364263000,0.0528
139.193.141.139,<->,122.252.95.229,6,3892,0,0,6,3892,0.364206000,1.3686
136.25.189.33,<->,33.209.219.117,6,3946,0,0,6,3946,0.364038000,0.6229
120.245.102.20,<->,92.27.219.209,0,0,6,356,6,356,0.363299000,1.2498
142.227.195.244,<->,136.25.188.46,0,0,6,530,6,530,0.360675000,0.1105
215.158.140.93,<->,72.23.148.203,6,1431,0,0,6,1431,0.360539000,0.2699
112.208.20.177,<->,98.128.126.190,0,0,6,1321,6,1321,0.360423000,1.0584
215.158.238.177,<->,106.188.245.188,6,2346,0,0,6,2346,0.358476000,1.0913
199.68.172.237,<->,136.25.188.252,0,0,6,306,6,306,0.357248000,0.3541
215.158.238.241,<->,131.144.115.155,6,3428,0,0,6,3428,0.356432000,1.5543
199.14.90.176,<->,136.25.188.163,0,0,6,412,6,412,0.356201000,0.0160
109.222.208.65,<->,54.43.5.17,6,419,0,0,6,419,0.356031000,0.1055
159.137.162.213,<->,110.43.86.177,6,882,0,0,6,882,0.353061000,0.4142
195.20.147.230,<->,50.223.3.228,0,0,6,551,6,551,0.352937000,1.6416
143.135.255.175,<->,136.25.188.177,0,0,6,856,6,856,0.352542000,0.5131
136.123.45.60,<->,8.52.183.96,0,0,6,413,6,413,0.351896000,0.2508
89.183.104.255,<->,78.49.6.7,6,329,0,0,6,329,0.351341000,1.5686
215.158.239.86,<->,199.20.29.240,6,997,0,0,6,997,0.351300000,0.4001
97.11.164.237,<->,53.214.115.253,6,1326,0,0,6,1326,0.349436000,0.6792
215.158.238.134,<->,122.158.51.54,6,2554,0,0,6,2554,0.349424000,1.0758
197.7.112.170,<->,50.223.3.228,0,0,6,472,6,472,0.348779000,0.2104
215.158.239.96,<->,194.199.198.183,6,343,0,0,6,343,0.348483000,0.1972
136.25.188.223,<->,80.47.111.107,6,2490,0,0,6,2490,0.348379000,1.5918
122.159.34.215,<->,8.252.222.204,0,0,6,336,6,336,0.347481000,0.0294
250.108.93.107,<->,159.137.162.213,0,0,6,882,6,882,0.347169000,0.9677
204.200.36.160,<->,136.25.188.225,0,0,6,1225,6,1225,0.346304000,0.2812
215.158.238.104,<->,113.23.104.203,6,2698,0,0,6,2698,0.346041000,1.0866
215.158.239.94,<->,199.20.7.211,6,336,0,0,6,336,0.345762000,0.1999
138.98.250.43,<->,91.69.185.184,6,336,0,0,6,336,0.343017000,1.5987
205.247.108.183,<->,92.27.27.160,0,0,6,306,6,306,0.342539000,0.4573
204.61.232.46,<->,136.25.188.53,0,0,6,400,6,400,0.341174000,0.0089
215.158.239.95,<->,194.186.217.194,6,349,0,0,6,349,0.338116000,0.1880
215.158.239.57,<->,207.190.142.170,6,416,0,0,6,416,0.336857000,0.6399
215.158.239.204,<->,8.235.72.34,6,1356,0,0,6,1356,0.335672000,1.2414
195.54.71.167,<->,136.25.188.227,0,0,6,400,6,400,0.335653000,0.0093
134.240.212.232,<->,50.224.76.234,0,0,6,2920,6,2920,0.332548000,0.6144
144.85.170.254,<->,91.69.185.155,6,1044,0,0,6,1044,0.332106000,0.1511
143.155.227.54,<->,136.25.188.254,0,0,6,1413,6,1413,0.331707000,0.1782
215.158.239.99,<->,199.20.28.97,6,2042,0,0,6,2042,0.331030000,0.3299
141.97.0.44,<->,8.252.221.239,0,0,6,300,6,300,0.329782000,0.0011
204.187.30.12,<->,136.25.188.175,0,0,6,388,6,388,0.329605000,1.6200
198.146.28.67,<->,138.98.237.239,0,0,6,1644,6,1644,0.329167000,0.3074
199.69.142.235,<->,136.25.188.222,0,0,6,349,6,349,0.328543000,0.5992
143.252.64.224,<->,129.224.112.252,0,0,6,404,6,404,0.328182000,1.4281
90.240.218.98,<->,54.38.43.164,6,3799,0,0,6,3799,0.326963000,0.5269
202.33.49.114,<->,136.25.188.162,0,0,6,412,6,412,0.326898000,0.0389
215.158.239.77,<->,195.127.43.47,6,913,0,0,6,913,0.325491000,0.6600
53.69.57.132,<->,48.52.86.232,0,0,6,1683,6,1683,0.325140000,0.9824
220.28.115.46,<->,136.25.189.92,0,0,6,2515,6,2515,0.323906000,0.1633
133.178.227.14,<->,61.35.70.34,6,2541,0,0,6,2541,0.322510000,1.4317
215.158.239.78,<->,6.15.207.74,6,3775,0,0,6,3775,0.322421000,0.8315
215.158.238.99,<->,27.22.184.74,6,2666,0,0,6,2666,0.321845000,1.5932
215.158.239.95,<->,199.20.31.7,6,400,0,0,6,400,0.321393000,0.4000
215.158.238.115,<->,139.160.226.175,6,1509,0,0,6,1509,0.321133000,0.1473
215.158.238.81,<->,205.227.96.20,6,1349,0,0,6,1349,0.321065000,0.1555
136.25.189.22,<->,100.216.78.145,6,5930,0,0,6,5930,0.320998000,0.0104
142.236.26.159,<->,136.25.188.198,0,0,6,1239,6,1239,0.320719000,1.5634
8.182.237.144,<->,6.21.254.23,6,793,0,0,6,793,0.320709000,0.1823
215.158.238.243,<->,8.190.217.127,6,2428,0,0,6,2428,0.319000000,0.9346
201.205.10.52,<->,144.88.76.44,0,0,6,710,6,710,0.318897000,0.4273
69.128.84.108,<->,53.201.139.195,6,3095,0,0,6,3095,0.318797000,1.1957
123.129.29.202,<->,33.233.141.13,0,0,6,324,6,324,0.318114000,1.1397
136.18.5.209,<->,8.182.227.209,0,0,6,3558,6,3558,0.316841000,1.3401
215.158.238.97,<->,29.211.186.197,6,1557,0,0,6,1557,0.316746000,0.2336
215.158.239.81,<->,159.215.65.184,6,5018,0,0,6,5018,0.315805000,0.0027
138.98.250.39,<->,46.44.48.106,6,336,0,0,6,336,0.315597000,1.6470
80.41.11.154,<->,53.148.181.151,6,4767,0,0,6,4767,0.314619000,1.4491
199.122.48.39,<->,136.25.188.163,0,0,6,312,6,312,0.314290000,1.2241
220.55.108.80,<->,137.44.153.229,6,569,0,0,6,569,0.313831000,0.1899
204.185.95.242,<->,136.25.188.225,0,0,6,336,6,336,0.311879000,0.1600
207.86.243.25,<->,8.252.222.221,0,0,6,400,6,400,0.311871000,0.0001
204.200.44.157,<->,136.25.188.209,0,0,6,412,6,412,0.311493000,0.0082
207.173.163.97,<->,136.25.188.197,0,0,6,408,6,408,0.309625000,1.4821
200.175.111.169,<->,53.68.106.76,6,1935,0,0,6,1935,0.309524000,0.8643
144.232.206.17,<->,8.252.223.194,0,0,6,1258,6,1258,0.309325000,1.4657
215.158.238.176,<->,69.150.168.252,6,1541,0,0,6,1541,0.308462000,0.2424
215.158.238.135,<->,29.212.194.181,6,1477,0,0,6,1477,0.308424000,0.2459
215.158.127.47,<->,8.176.8.83,0,0,6,6916,6,6916,0.307307000,1.3476
221.196.91.242,<->,144.85.170.254,0,0,6,384,6,384,0.307032000,1.5203
215.158.239.95,<->,199.106.230.90,6,312,0,0,6,312,0.305831000,0.0149
215.158.239.84,<->,143.68.145.136,6,1029,0,0,6,1029,0.304136000,0.4104
215.158.238.67,<->,126.219.132.197,6,1637,0,0,6,1637,0.303955000,0.7146
136.25.188.175,<->,131.1.195.220,6,1684,0,0,6,1684,0.303569000,1.0894
215.158.238.141,<->,131.144.114.208,6,4111,0,0,6,4111,0.302516000,1.4882
200.174.97.6,<->,53.167.31.71,6,336,0,0,6,336,0.301888000,1.5284
212.164.143.185,<->,100.211.112.235,6,300,0,0,6,300,0.301706000,1.5130
43.55.242.82,<->,8.252.221.204,0,0,6,726,6,726,0.301232000,0.5779
134.0.214.2,<->,89.183.104.136,0,0,6,715,6,715,0.301122000,1.5767
215.158.239.76,<->,199.78.34.73,6,336,0,0,6,336,0.301118000,0.3605
215.158.239.61,<->,100.224.166.115,6,6690,0,0,6,6690,0.300366000,0.1022
97.198.108.251,<->,94.25.145.181,6,300,0,0,6,300,0.299761000,1.5896
206.198.8.43,<->,92.27.219.237,0,0,6,4644,6,4644,0.299520000,1.2484
142.223.185.59,<->,136.25.188.177,0,0,6,400,6,400,0.299430000,0.0101
130.206.82.110,<->,50.224.76.235,0,0,6,2661,6,2661,0.297399000,0.1804
133.178.227.16,<->,106.188.228.2,6,3002,0,0,6,3002,0.296656000,1.3917
215.158.238.223,<->,8.222.6.193,6,2405,0,0,6,2405,0.296368000,0.1392
197.113.99.171,<->,136.25.188.243,0,0,6,531,6,531,0.295881000,1.1809
235.253.220.227,<->,133.178.227.16,0,0,6,1653,6,1653,0.294045000,0.2020
215.158.140.75,<->,113.23.66.41,6,3485,0,0,6,3485,0.293870000,1.0168
215.158.140.229,<->,29.211.6.183,6,3440,0,0,6,3440,0.291720000,1.4599
212.70.217.68,<->,136.25.188.241,0,0,6,1509,6,1509,0.291187000,0.1532
127.107.255.141,<->,89.183.104.238,0,0,6,8538,6,8538,0.290255000,1.1034
215.158.238.33,<->,192.204.170.197,6,1637,0,0,6,1637,0.288444000,0.2575
142.191.85.69,<->,136.25.188.222,0,0,6,981,6,981,0.288070000,0.6395
222.42.48.66,<->,50.224.49.195,0,0,6,348,6,348,0.287822000,1.1811
220.55.96.175,<->,93.147.226.157,6,391,0,0,6,391,0.284392000,0.2724
215.158.239.48,<->,194.203.230.244,6,412,0,0,6,412,0.283811000,0.0100
207.239.108.249,<->,136.25.188.163,0,0,6,336,6,336,0.282789000,0.1936
197.103.151.87,<->,136.25.188.44,0,0,6,1909,6,1909,0.282618000,0.2547
255.29.52.48,<->,97.168.79.200,0,0,6,1032,6,1032,0.281333000,1.4849
143.155.227.33,<->,133.178.226.90,0,0,6,349,6,349,0.281325000,0.2105
215.158.132.36,<->,133.32.39.1,0,0,6,506,6,506,0.280963000,0.0576
136.25.188.211,<->,76.100.108.240,6,1593,0,0,6,1593,0.280412000,0.6430
199.32.116.94,<->,136.25.188.226,0,0,6,349,6,349,0.279367000,0.2555
205.127.108.114,<->,33.233.141.229,0,0,6,4206,6,4206,0.279194000,0.3424
17.6.117.77,<->,8.220.188.138,0,0,6,493,6,493,0.279082000,0.0776
53.161.123.40,<->,48.53.106.244,0,0,6,4976,6,4976,0.279049000,0.3363
215.158.239.49,<->,196.108.121.89,6,306,0,0,6,306,0.278390000,0.1479
204.62.84.238,<->,136.25.188.198,0,0,6,1864,6,1864,0.277935000,1.6600
215.158.238.83,<->,111.150.34.246,6,1601,0,0,6,1601,0.277509000,0.4729
215.158.238.66,<->,143.155.227.33,6,349,0,0,6,349,0.277057000,0.2199
133.178.227.24,<->,8.222.2.38,6,3492,0,0,6,3492,0.276115000,1.5377
215.158.234.99,<->,91.51.217.98,0,0,6,3407,6,3407,0.276088000,0.1887
202.33.241.197,<->,136.25.188.252,0,0,6,400,6,400,0.275370000,0.0400
129.236.73.9,<->,101.224.89.249,0,0,6,1488,6,1488,0.273341000,0.3531
144.85.170.254,<->,91.69.181.255,6,1037,0,0,6,1037,0.271399000,0.0873
215.158.61.202,<->,8.176.8.202,0,0,6,7579,6,7579,0.271247000,0.1880
142.247.218.79,<->,136.25.188.175,0,0,6,1413,6,1413,0.267402000,1.2608
249.101.100.85,<->,210.209.251.211,6,2228,0,0,6,2228,0.267342000,0.4166
220.20.200.29,<->,193.2.24.169,6,5176,0,0,6,5176,0.266890000,0.3979
215.158.239.77,<->,143.68.145.136,6,1045,0,0,6,1045,0.262739000,0.5269
204.200.48.116,<->,136.25.188.198,0,0,6,652,6,652,0.262666000,1.3118
199.111.88.50,<->,8.182.241.177,0,0,6,1181,6,1181,0.262110000,0.8570
202.33.231.178,<->,136.25.188.225,0,0,6,300,6,300,0.261348000,0.0002
136.25.188.255,<->,69.31.238.193,6,336,0,0,6,336,0.259769000,0.0534
192.64.222.13,<->,93.161.230.56,6,348,0,0,6,348,0.259752000,1.5003
113.5.147.22,<->,111.147.92.14,0,0,6,4806,6,4806,0.258919000,1.1392
194.237.117.52,<->,136.25.188.243,0,0,6,412,6,412,0.258713000,0.0086
142.237.201.159,<->,136.25.188.241,0,0,6,412,6,412,0.258516000,0.0559
215.158.238.67,<->,106.188.183.106,6,1854,0,0,6,1854,0.256965000,1.3371
136.25.188.255,<->,29.214.108.128,6,3078,0,0,6,3078,0.256864000,0.9611
215.158.239.87,<->,204.2.140.38,6,1224,0,0,6,1224,0.255024000,1.5799
204.200.37.77,<->,136.25.188.177,0,0,6,400,6,400,0.253989000,0.0192
136.25.188.47,<->,8.222.212.22,6,1493,0,0,6,1493,0.253602000,0.0292
215.158.239.101,<->,215.158.42.215,6,1764,0,0,6,1764,0.253399000,0.4223
246.253.168.231,<->,104.134.162.189,6,868,0,0,6,868,0.249636000,0.7742
133.178.226.29,<->,8.252.213.40,6,1461,0,0,6,1461,0.249613000,0.0349
215.158.140.229,<->,119.196.23.70,6,2359,0,0,6,2359,0.248544000,1.2788
136.25.188.242,<->,61.72.108.214,6,1493,0,0,6,1493,0.248022000,0.1821
215.158.239.93,<->,212.70.75.122,6,3951,0,0,6,3951,0.247614000,1.5973
215.158.239.113,<->,215.158.61.36,6,1707,0,0,6,1707,0.247430000,0.0474
215.158.239.195,<->,98.28.95.171,6,2946,0,0,6,2946,0.246954000,0.1027
94.192.105.48,<->,8.252.222.157,0,0,6,412,6,412,0.242477000,0.0042
192.182.132.149,<->,50.224.49.195,0,0,6,300,6,300,0.242285000,1.7552
210.158.44.46,<->,145.255.183.195,6,1852,0,0,6,1852,0.242274000,0.0831
215.158.239.86,<->,199.20.30.215,6,412,0,0,6,412,0.241797000,0.1099
246.254.97.113,<->,231.255.221.242,6,4354,0,0,6,4354,0.240871000,0.0627
86.198.146.244,<->,0.195.210.24,0,0,6,336,6,336,0.238473000,0.8994
231.143.135.132,<->,136.25.188.239,0,0,6,396,6,396,0.238467000,0.1300
111.147.134.209,<->,54.58.49.91,6,670,0,0,6,670,0.238462000,1.7550
204.2.41.205,<->,136.25.188.54,0,0,6,1172,6,1172,0.236864000,0.6196
201.211.113.181,<->,136.25.189.1,0,0,6,1445,6,1445,0.236576000,0.8146
80.42.141.64,<->,8.177.1.203,6,7299,0,0,6,7299,0.235513000,0.0166
136.25.189.77,<->,29.211.228.213,6,2943,0,0,6,2943,0.235066000,0.4440
215.158.239.87,<->,120.154.131.7,6,4444,0,0,6,4444,0.234048000,1.0770
247.136.208.249,<->,221.102.56.69,6,1764,0,0,6,1764,0.233134000,1.6612
215.158.238.177,<->,197.125.88.37,6,2398,0,0,6,2398,0.233115000,1.7475
136.25.188.163,<->,29.211.186.214,6,2762,0,0,6,2762,0.232458000,1.5565
92.160.6.243,<->,33.233.141.118,0,0,6,324,6,324,0.231702000,1.0614
144.85.170.208,<->,91.69.181.227,6,1043,0,0,6,1043,0.230243000,0.3128
142.253.143.16,<->,136.25.188.197,0,0,6,952,6,952,0.229752000,1.3213
136.25.188.209,<->,41.169.88.140,6,421,0,0,6,421,0.229634000,0.0100
221.102.143.189,<->,100.94.173.92,0,0,6,676,6,676,0.228865000,1.7446
207.118.244.179,<->,50.223.3.228,0,0,6,318,6,318,0.228633000,1.6478
138.98.250.43,<->,6.71.43.154,6,336,0,0,6,336,0.228050000,1.5096
215.158.239.58,<->,204.226.121.155,6,349,0,0,6,349,0.226964000,0.1977
159.137.162.213,<->,108.0.246.252,6,882,0,0,6,882,0.226566000,0.4925
215.158.239.79,<->,199.20.28.40,6,336,0,0,6,336,0.226273000,0.0904
136.25.189.1,<->,96.156.169.221,6,2922,0,0,6,2922,0.225377000,1.4669
159.137.162.213,<->,105.105.201.106,6,882,0,0,6,882,0.225277000,0.6048
224.213.241.43,<->,138.98.250.39,0,0,6,336,6,336,0.224732000,1.5995
215.158.239.223,<->,215.158.61.243,6,3317,0,0,6,3317,0.224086000,1.2842
215.158.239.48,<->,207.60.69.60,6,336,0,0,6,336,0.223768000,0.0145
138.79.143.196,<->,98.108.20.240,0,0,6,2275,6,2275,0.223363000,0.9292
215.158.239.57,<->,199.20.7.45,6,400,0,0,6,400,0.222391000,0.2806
95.247.103.183,<->,8.252.221.238,0,0,6,336,6,336,0.222323000,0.6751
141.134.142.200,<->,133.178.227.79,0,0,6,2368,6,2368,0.220640000,1.6269
195.12.100.232,<->,136.25.188.176,0,0,6,742,6,742,0.220274000,0.6722
215.158.239.48,<->,196.105.127.143,6,412,0,0,6,412,0.218792000,0.0812
138.98.250.43,<->,92.89.210.252,6,336,0,0,6,336,0.218751000,1.5505
199.70.201.244,<->,136.25.188.53,0,0,6,381,6,381,0.218595000,1.4800
215.158.238.81,<->,113.23.104.203,6,1573,0,0,6,1573,0.217386000,0.8309
204.200.52.198,<->,136.25.188.44,0,0,6,1256,6,1256,0.216497000,0.2359
213.186.52.49,<->,144.85.170.208,0,0,6,1363,6,1363,0.215488000,0.0826
136.129.20.230,<->,75.94.112.195,6,964,0,0,6,964,0.214878000,1.1429
196.88.17.105,<->,136.25.188.236,0,0,6,1006,6,1006,0.214428000,0.4287
136.25.188.223,<->,131.144.114.209,6,2682,0,0,6,2682,0.213886000,1.5300
215.158.239.218,<->,159.137.139.233,6,6909,0,0,6,6909,0.213843000,0.1708
109.222.214.21,<->,54.52.53.28,6,2235,0,0,6,2235,0.212693000,1.0341
136.25.189.15,<->,96.156.169.246,6,3322,0,0,6,3322,0.212226000,1.0001
207.172.142.203,<->,136.25.188.177,0,0,6,384,6,384,0.212202000,1.5049
199.122.3.251,<->,136.25.188.175,0,0,6,559,6,559,0.211979000,0.7374
215.158.239.48,<->,196.94.117.227,6,348,0,0,6,348,0.211641000,1.6000
215.158.238.64,<->,42.226.3.107,6,1557,0,0,6,1557,0.210818000,1.2787
139.163.163.252,<->,133.178.227.2,0,0,6,3723,6,3723,0.209271000,1.2894
142.244.102.123,<->,136.25.188.178,0,0,6,412,6,412,0.208094000,0.0086
215.158.238.133,<->,112.220.206.107,6,2410,0,0,6,2410,0.207193000,1.4096
143.128.55.116,<->,136.25.188.236,0,0,6,616,6,616,0.207182000,1.4778
207.173.36.178,<->,136.25.188.177,0,0,6,336,6,336,0.206723000,0.8793
215.158.61.202,<->,8.176.8.241,0,0,6,2863,6,2863,0.206677000,1.6316
145.16.34.73,<->,54.69.65.112,6,555,0,0,6,555,0.206657000,1.1404
143.68.164.76,<->,136.25.188.241,0,0,6,1005,6,1005,0.206377000,0.5769
215.158.140.165,<->,89.134.6.42,6,3617,0,0,6,3617,0.206020000,0.8031
215.158.239.84,<->,199.20.28.104,6,3360,0,0,6,3360,0.202943000,1.7613
136.25.188.220,<->,69.150.168.218,6,1637,0,0,6,1637,0.202825000,0.4385
159.137.162.213,<->,38.90.68.83,6,882,0,0,6,882,0.202534000,1.1664
129.5.109.106,<->,33.233.141.14,0,0,6,324,6,324,0.202447000,1.7137
197.62.72.127,<->,91.231.195.145,0,0,6,1808,6,1808,0.201507000,1.2580
207.53.5.50,<->,50.223.3.228,0,0,6,318,6,318,0.201314000,1.6958
138.43.230.96,<->,136.25.188.44,0,0,6,412,6,412,0.201073000,0.0006
215.158.239.78,<->,207.59.202.119,6,336,0,0,6,336,0.200187000,0.0249
197.113.64.236,<->,136.25.188.222,0,0,6,674,6,674,0.200114000,1.7400
215.158.239.77,<->,196.1.169.142,6,1214,0,0,6,1214,0.199807000,0.8784
215.158.239.56,<->,199.20.30.244,6,336,0,0,6,336,0.198751000,0.0301
133.178.227.27,<->,133.56.180.21,6,4117,0,0,6,4117,0.198302000,0.9236
136.25.189.5,<->,100.216.78.145,6,5124,0,0,6,5124,0.196821000,0.3549
215.158.239.95,<->,29.211.5.250,6,2890,0,0,6,2890,0.196644000,0.8572
215.158.239.40,<->,8.190.216.249,6,1823,0,0,6,1823,0.196435000,1.0737
215.158.239.76,<->,199.71.175.124,6,1045,0,0,6,1045,0.195790000,0.3563
142.249.130.203,<->,136.25.188.255,0,0,6,949,6,949,0.194574000,0.2927
205.227.96.9,<->,136.25.189.0,0,0,6,2037,6,2037,0.194532000,0.2722
220.39.233.53,<->,215.158.238.209,0,0,6,1383,6,1383,0.194084000,0.2187
136.25.189.28,<->,114.25.48.60,6,2666,0,0,6,2666,0.192392000,1.6073
215.158.239.50,<->,195.54.60.2,6,1045,0,0,6,1045,0.192081000,1.4598
215.158.239.17,<->,139.161.104.228,6,2766,0,0,6,2766,0.191839000,1.7827
110.66.177.183,<->,50.224.49.195,0,0,6,300,6,300,0.190872000,1.7200
133.178.227.76,<->,8.57.163.136,6,372,0,0,6,372,0.190042000,0.4920
136.25.189.33,<->,104.154.137.0,6,2842,0,0,6,2842,0.189798000,1.1565
215.158.239.70,<->,156.165.37.73,6,2890,0,0,6,2890,0.188958000,1.0966
215.158.239.92,<->,142.207.250.149,6,636,0,0,6,636,0.187370000,0.7088
215.158.239.87,<->,207.115.17.112,6,694,0,0,6,694,0.187364000,1.4024
143.68.192.161,<->,136.25.188.53,0,0,6,349,6,349,0.187354000,0.2492
215.158.238.82,<->,198.204.76.246,6,1637,0,0,6,1637,0.187007000,1.6526
215.158.239.51,<->,194.250.210.175,6,554,0,0,6,554,0.187004000,0.2667
195.17.159.17,<->,136.25.188.254,0,0,6,1621,6,1621,0.186990000,0.2788
215.158.238.106,<->,104.154.137.221,6,2858,0,0,6,2858,0.186978000,1.7127
195.7.51.31,<->,136.25.188.226,0,0,6,300,6,300,0.186486000,1.2495
215.158.140.75,<->,114.94.161.226,6,1340,0,0,6,1340,0.185798000,0.4155
199.33.90.170,<->,136.25.188.199,0,0,6,412,6,412,0.184533000,0.0293
215.158.239.244,<->,112.235.95.53,6,435,0,0,6,435,0.183934000,0.3229
223.136.135.149,<->,92.27.219.222,0,0,6,924,6,924,0.183810000,1.4380
199.51.129.216,<->,136.25.188.163,0,0,6,1438,6,1438,0.183056000,1.1514
215.158.239.57,<->,199.20.28.99,6,360,0,0,6,360,0.182316000,1.7299
215.158.238.67,<->,125.216.43.100,6,336,0,0,6,336,0.182038000,0.0010
133.178.227.62,<->,133.56.180.19,6,6257,0,0,6,6257,0.180605000,0.1715
215.158.238.104,<->,143.227.65.147,6,2778,0,0,6,2778,0.178968000,1.5177
205.186.128.193,<->,8.220.239.41,0,0,6,1409,6,1409,0.178795000,0.2184
229.96.187.56,<->,92.27.219.205,0,0,6,3232,6,3232,0.177495000,1.6759
215.158.239.82,<->,129.175.139.13,6,4986,0,0,6,4986,0.176480000,0.0540
215.158.238.123,<->,122.158.51.91,6,336,0,0,6,336,0.175898000,0.0028
215.158.238.113,<->,118.20.114.86,6,1541,0,0,6,1541,0.174945000,0.9667
204.3.4.64,<->,136.25.188.176,0,0,6,336,6,336,0.174261000,0.0536
247.136.136.112,<->,110.61.185.178,6,668,0,0,6,668,0.171202000,0.1939
136.25.189.80,<->,29.209.59.217,6,4031,0,0,6,4031,0.170742000,1.7727
203.212.63.74,<->,8.220.234.4,0,0,6,462,6,462,0.170499000,0.5266
204.139.17.54,<->,8.182.224.248,0,0,6,753,6,753,0.169248000,1.3021
199.15.37.187,<->,136.25.188.222,0,0,6,2857,6,2857,0.169181000,1.7944
215.158.239.217,<->,215.158.61.191,6,3661,0,0,6,3661,0.168570000,1.0870
50.224.118.88,<->,27.11.131.168,6,344,0,0,6,344,0.168345000,1.6331
142.190.158.21,<->,136.25.188.163,0,0,6,348,6,348,0.168297000,0.9693
215.158.239.57,<->,195.80.82.72,6,804,0,0,6,804,0.168004000,0.7297
136.25.188.47,<->,61.72.108.203,6,1637,0,0,6,1637,0.167960000,0.5994
76.11.5.51,<->,35.56.100.173,0,0,6,592,6,592,0.166865000,1.5834
98.129.94.194,<->,8.49.114.128,6,676,0,0,6,676,0.166654000,1.7076
215.158.239.93,<->,114.25.48.22,6,4031,0,0,6,4031,0.165314000,1.1551
215.158.239.19,<->,118.20.114.94,6,1865,0,0,6,1865,0.163734000,0.2181
215.158.238.95,<->,6.73.9.210,6,336,0,0,6,336,0.163593000,0.0011
215.158.239.59,<->,56.161.218.55,6,3018,0,0,6,3018,0.163275000,1.3568
149.96.53.43,<->,136.25.188.221,0,0,6,2570,6,2570,0.163023000,0.7297
92.168.217.252,<->,50.136.156.119,6,336,0,0,6,336,0.160879000,1.5534
216.184.2.194,<->,136.25.189.57,0,0,6,3887,6,3887,0.160761000,1.1799
111.147.91.47,<->,59.150.58.129,6,350,0,0,6,350,0.160573000,0.9235
133.178.227.20,<->,133.56.180.27,6,3033,0,0,6,3033,0.160197000,1.7837
143.10.206.6,<->,136.25.188.163,0,0,6,630,6,630,0.160158000,0.8862
215.158.239.48,<->,195.49.29.14,6,1061,0,0,6,1061,0.159443000,0.7924
133.54.17.198,<->,127.73.171.5,6,348,0,0,6,348,0.158492000,0.4781
142.228.70.111,<->,136.25.188.222,0,0,6,336,6,336,0.158299000,0.0099
215.158.61.203,<->,8.176.8.244,0,0,6,4657,6,4657,0.158063000,1.1778
158.85.50.66,<->,133.178.227.1,0,0,6,3563,6,3563,0.157927000,1.7765
215.158.140.83,<->,106.188.244.183,6,2374,0,0,6,2374,0.157402000,1.3700
215.158.238.83,<->,140.174.80.67,6,1685,0,0,6,1685,0.157390000,0.4361
215.158.239.87,<->,204.2.250.243,6,336,0,0,6,336,0.156049000,0.0574
93.181.154.89,<->,92.27.219.16,0,0,6,306,6,306,0.155815000,1.7274
215.158.238.75,<->,80.47.111.90,6,1653,0,0,6,1653,0.155064000,0.7084
92.27.27.167,<->,78.46.58.206,6,300,0,0,6,300,0.155036000,1.3398
142.252.79.72,<->,136.25.188.163,0,0,6,412,6,412,0.153363000,0.0093
136.25.189.17,<->,8.255.92.150,6,2842,0,0,6,2842,0.153221000,0.9038
215.158.239.49,<->,199.122.128.102,6,428,0,0,6,428,0.152271000,0.6123
139.163.96.94,<->,48.101.57.141,6,300,0,0,6,300,0.151279000,1.6014
195.22.149.116,<->,50.223.3.228,0,0,6,336,6,336,0.150891000,1.7975
215.158.239.84,<->,143.42.11.29,6,336,0,0,6,336,0.150428000,0.1392
89.139.247.130,<->,50.224.72.13,0,0,6,1171,6,1171,0.149997000,1.5391
133.178.226.19,<->,8.188.227.39,6,1477,0,0,6,1477,0.149445000,0.1871
95.247.132.72,<->,8.252.222.45,0,0,6,472,6,472,0.146961000,0.4697
199.116.164.175,<->,50.223.3.228,0,0,6,520,6,520,0.146414000,0.4041
136.25.188.163,<->,119.196.23.69,6,1605,0,0,6,1605,0.146193000,1.5644
98.87.117.143,<->,50.224.49.195,0,0,6,336,6,336,0.146132000,1.5763
200.174.199.230,<->,53.200.182.229,6,682,0,0,6,682,0.146027000,0.6159
215.158.239.77,<->,207.166.149.157,6,1877,0,0,6,1877,0.145849000,1.6621
215.158.238.250,<->,29.214.108.55,6,1363,0,0,6,1363,0.144280000,0.1388
215.158.61.191,<->,8.176.8.195,0,0,6,4851,6,4851,0.143995000,0.7882
212.164.136.25,<->,110.50.71.231,6,336,0,0,6,336,0.141443000,1.5924
207.13.138.222,<->,92.27.27.158,0,0,6,312,6,312,0.140128000,1.5675
215.158.140.75,<->,201.211.112.233,6,1333,0,0,6,1333,0.139987000,1.3730
195.40.159.240,<->,136.25.188.177,0,0,6,306,6,306,0.139225000,0.3706
215.158.239.57,<->,106.188.253.173,6,3138,0,0,6,3138,0.139115000,1.4407
249.115.166.204,<->,8.220.176.253,0,0,6,1551,6,1551,0.137102000,0.5789
215.158.239.51,<->,199.20.4.160,6,349,0,0,6,349,0.136961000,1.5204
192.170.144.68,<->,136.62.164.0,0,0,6,4235,6,4235,0.136401000,0.2041
207.173.68.4,<->,136.25.188.197,0,0,6,1099,6,1099,0.136344000,0.6493
246.253.134.208,<->,30.199.160.255,6,520,0,0,6,520,0.136334000,1.3200
215.158.239.41,<->,215.158.127.162,6,2402,0,0,6,2402,0.135264000,0.1753
136.25.189.34,<->,29.211.5.230,6,2762,0,0,6,2762,0.134686000,1.2594
215.158.239.93,<->,29.211.228.247,6,3007,0,0,6,3007,0.134450000,0.4709
215.158.239.93,<->,199.20.31.194,6,336,0,0,6,336,0.134278000,0.0597
143.135.41.182,<->,136.25.188.224,0,0,6,640,6,640,0.132977000,0.8216
68.75.18.110,<->,8.252.221.238,0,0,6,336,6,336,0.132636000,0.2025
204.200.53.149,<->,136.25.188.45,0,0,6,372,6,372,0.131713000,0.0128
201.211.197.225,<->,139.193.141.207,0,0,6,774,6,774,0.129420000,0.3499
215.158.239.97,<->,207.166.149.157,6,1877,0,0,6,1877,0.128746000,1.6385
142.208.205.70,<->,136.25.188.226,0,0,6,639,6,639,0.128632000,0.7838
196.119.216.12,<->,50.223.3.228,0,0,6,520,6,520,0.128159000,0.9248
215.158.239.32,<->,140.218.109.20,6,1789,0,0,6,1789,0.128015000,0.2451
215.158.140.231,<->,100.50.96.248,6,2505,0,0,6,2505,0.127828000,1.8143
254.70.166.176,<->,192.64.195.164,0,0,6,334,6,334,0.125269000,1.7735
239.66.236.172,<->,139.163.20.162,0,0,6,336,6,336,0.124302000,1.6110
109.116.109.141,<->,56.121.40.147,0,0,6,396,6,396,0.123895000,1.6967
111.20.168.185,<->,27.127.250.105,6,324,0,0,6,324,0.123588000,1.1789
69.103.121.183,<->,8.252.222.28,0,0,6,1030,6,1030,0.123242000,0.5581
111.150.187.125,<->,8.252.223.143,0,0,6,2282,6,2282,0.122492000,1.2053
143.155.227.33,<->,136.25.188.173,0,0,6,348,6,348,0.122250000,0.0008
111.20.172.70,<->,101.224.89.128,0,0,6,797,6,797,0.122025000,1.0148
207.87.175.71,<->,8.182.237.144,0,0,6,879,6,879,0.121834000,0.4892
97.203.5.146,<->,8.182.244.237,0,0,6,842,6,842,0.121664000,0.0379
132.216.159.4,<->,92.162.253.42,0,0,6,801,6,801,0.121087000,0.0675
133.178.227.7,<->,133.56.180.36,6,3036,0,0,6,3036,0.120976000,1.5945
104.14.70.23,<->,92.27.219.251,0,0,6,5928,6,5928,0.120841000,0.7686
199.33.198.154,<->,136.25.188.227,0,0,6,349,6,349,0.118761000,0.2587
215.158.239.84,<->,196.90.225.22,6,336,0,0,6,336,0.118532000,1.7210
215.158.238.65,<->,91.57.173.52,6,1669,0,0,6,1669,0.118383000,1.7004
215.158.239.87,<->,204.0.223.83,6,1983,0,0,6,1983,0.117583000,1.7400
35.61.123.109,<->,8.252.223.146,0,0,6,378,6,378,0.117443000,1.1337
111.20.172.70,<->,33.233.141.90,0,0,6,689,6,689,0.116839000,0.9987
215.158.238.73,<->,113.23.104.221,6,2538,0,0,6,2538,0.116821000,1.8026
139.163.17.129,<->,100.28.44.153,6,1404,0,0,6,1404,0.116739000,1.6510
215.158.238.66,<->,143.155.226.245,6,1525,0,0,6,1525,0.116715000,1.7007
215.158.238.121,<->,112.220.206.22,6,349,0,0,6,349,0.116579000,0.1166
111.20.172.70,<->,33.233.141.93,0,0,6,850,6,850,0.116113000,1.0071
127.124.233.209,<->,98.236.235.218,0,0,6,336,6,336,0.115991000,1.7962
215.158.239.49,<->,142.190.173.110,6,349,0,0,6,349,0.115664000,0.2796
136.25.188.174,<->,132.145.244.236,6,300,0,0,6,300,0.115437000,0.6704
215.158.238.220,<->,69.150.169.168,6,2335,0,0,6,2335,0.115193000,1.7071
89.86.110.221,<->,8.252.223.153,0,0,6,1375,6,1375,0.115013000,0.1278
142.249.42.81,<->,136.25.188.177,0,0,6,829,6,829,0.114703000,1.8221
215.158.140.241,<->,131.2.115.212,6,1332,0,0,6,1332,0.114582000,1.2347
223.115.66.128,<->,8.252.222.149,0,0,6,646,6,646,0.114579000,0.5262
215.158.239.56,<->,143.89.225.38,6,364,0,0,6,364,0.113962000,0.1590
201.192.179.46,<->,139.163.96.127,0,0,6,312,6,312,0.113584000,1.3888
138.98.250.39,<->,136.127.67.67,6,300,0,0,6,300,0.112829000,1.5980
111.20.172.70,<->,101.224.89.247,0,0,6,842,6,842,0.112813000,1.0042
136.25.188.196,<->,69.31.238.54,6,2730,0,0,6,2730,0.112280000,1.7102
207.74.180.209,<->,50.223.3.228,0,0,6,300,6,300,0.112013000,1.8231
204.56.107.102,<->,136.25.188.45,0,0,6,412,6,412,0.111927000,0.0086
215.158.238.99,<->,122.158.51.62,6,2858,0,0,6,2858,0.111677000,0.6960
196.22.172.46,<->,98.236.194.252,0,0,6,300,6,300,0.111582000,1.1299
215.158.238.95,<->,131.144.113.193,6,2650,0,0,6,2650,0.111449000,0.4782
196.89.228.140,<->,136.25.188.241,0,0,6,412,6,412,0.111425000,0.0136
133.178.226.38,<->,32.183.36.100,6,2794,0,0,6,2794,0.111376000,0.5336
140.20.190.103,<->,80.27.159.28,0,0,6,1946,6,1946,0.111324000,0.7727
108.156.21.132,<->,50.224.49.195,0,0,6,336,6,336,0.111190000,1.7415
111.20.172.70,<->,111.20.168.8,0,0,6,801,6,801,0.111169000,1.0042
195.68.164.36,<->,136.25.188.238,0,0,6,412,6,412,0.111039000,0.0800
133.178.226.215,<->,131.31.253.219,6,433,0,0,6,433,0.110858000,0.3245
215.158.239.57,<->,199.20.31.216,6,396,0,0,6,396,0.110421000,0.0093
111.20.172.70,<->,33.233.141.27,0,0,6,797,6,797,0.109156000,0.9982
207.238.20.126,<->,136.25.188.254,0,0,6,593,6,593,0.108829000,1.8387
111.20.172.70,<->,101.224.89.144,0,0,6,768,6,768,0.108675000,1.0047
136.25.189.78,<->,8.249.253.227,6,2890,0,0,6,2890,0.108363000,1.5462
220.243.198.21,<->,8.252.222.85,0,0,6,896,6,896,0.108305000,0.1402
136.25.189.11,<->,96.156.169.251,6,6500,0,0,6,6500,0.108284000,1.2504
215.158.238.72,<->,112.220.206.63,6,1541,0,0,6,1541,0.108254000,0.5938
142.207.119.24,<->,136.25.188.242,0,0,6,346,6,346,0.107632000,0.4580
138.98.250.39,<->,17.214.49.156,6,336,0,0,6,336,0.107449000,1.5982
75.31.146.58,<->,8.252.221.204,0,0,6,1104,6,1104,0.107290000,1.4630
199.120.132.194,<->,136.25.188.209,0,0,6,488,6,488,0.106956000,0.8731
215.158.239.34,<->,126.219.142.46,6,1855,0,0,6,1855,0.106896000,1.7877
133.178.227.40,<->,133.56.180.39,6,4220,0,0,6,4220,0.106656000,1.1721
202.178.8.212,<->,97.127.83.152,0,0,6,594,6,594,0.106655000,0.8609
111.20.172.70,<->,33.233.141.103,0,0,6,795,6,795,0.105906000,1.0082
195.15.166.92,<->,136.25.188.177,0,0,6,343,6,343,0.105802000,0.1835
215.158.140.87,<->,111.15.121.170,6,1957,0,0,6,1957,0.105401000,0.1491
82.151.22.161,<->,50.224.49.195,0,0,6,300,6,300,0.104466000,1.7281
202.178.9.232,<->,133.32.2.73,0,0,6,723,6,723,0.103824000,0.8503
215.158.239.92,<->,207.60.61.97,6,1180,0,0,6,1180,0.102033000,0.3015
215.158.140.75,<->,159.137.139.1,6,2504,0,0,6,2504,0.101682000,1.2586
215.158.239.86,<->,192.204.123.60,6,4031,0,0,6,4031,0.101627000,1.8724
215.158.238.66,<->,89.86.110.85,6,2714,0,0,6,2714,0.101305000,1.4462
111.20.172.70,<->,33.233.141.61,0,0,6,909,6,909,0.101170000,1.0048
194.232.226.8,<->,136.25.188.255,0,0,6,336,6,336,0.101132000,0.0441
221.102.56.69,<->,80.40.10.250,0,0,6,574,6,574,0.100994000,1.0163
202.77.250.77,<->,8.252.222.148,0,0,6,412,6,412,0.100651000,0.2072
111.20.172.70,<->,111.20.168.58,0,0,6,776,6,776,0.100594000,1.0036
195.14.32.123,<->,136.25.188.163,0,0,6,381,6,381,0.099888000,0.0113
215.158.238.134,<->,50.218.56.251,6,2682,0,0,6,2682,0.099868000,1.2152
215.158.238.188,<->,8.50.170.174,6,2543,0,0,6,2543,0.099745000,1.1052
205.188.191.243,<->,92.27.219.168,0,0,6,312,6,312,0.099703000,1.6822
215.158.238.134,<->,111.150.187.55,6,1525,0,0,6,1525,0.099007000,0.9778
215.158.239.79,<->,196.93.238.83,6,396,0,0,6,396,0.098210000,1.7195
204.58.72.112,<->,136.25.188.53,0,0,6,456,6,456,0.098092000,1.7939
215.158.239.30,<->,106.188.184.73,6,3239,0,0,6,3239,0.097697000,0.3335
207.201.68.244,<->,92.27.194.147,0,0,6,714,6,714,0.097417000,0.4880
215.158.239.76,<->,195.49.74.143,6,336,0,0,6,336,0.097235000,1.3364
220.55.112.205,<->,139.181.243.246,6,1292,0,0,6,1292,0.096460000,0.1763
144.83.112.140,<->,108.134.90.45,0,0,6,645,6,645,0.095813000,0.0939
142.236.244.148,<->,136.25.188.198,0,0,6,1839,6,1839,0.095759000,1.3561
215.158.238.135,<->,134.172.158.198,6,2730,0,0,6,2730,0.095459000,0.9419
196.233.198.226,<->,8.182.226.78,0,0,6,2182,6,2182,0.094950000,1.4783
215.158.239.84,<->,199.20.5.115,6,894,0,0,6,894,0.094948000,1.6890
156.138.132.220,<->,139.163.96.94,0,0,6,300,6,300,0.093628000,1.6021
149.161.10.42,<->,50.224.76.248,0,0,6,2738,6,2738,0.091855000,0.3566
111.20.172.70,<->,111.20.168.20,0,0,6,880,6,880,0.090531000,1.0002
133.178.226.61,<->,113.23.104.213,6,2682,0,0,6,2682,0.090293000,0.7623
103.151.148.107,<->,50.224.49.195,0,0,6,336,6,336,0.090269000,1.7401
74.141.177.167,<->,8.252.221.198,0,0,6,746,6,746,0.089887000,0.4584
215.158.239.92,<->,199.122.164.167,6,348,0,0,6,348,0.089632000,0.4218
88.202.152.49,<->,50.224.76.234,0,0,6,2252,6,2252,0.089603000,1.0357
215.158.238.134,<->,143.155.227.33,6,348,0,0,6,348,0.088457000,0.0011
215.158.239.101,<->,129.222.39.139,6,1271,0,0,6,1271,0.088357000,1.0237
215.158.239.57,<->,207.114.216.97,6,348,0,0,6,348,0.088092000,0.0406
199.57.193.8,<->,50.223.3.228,0,0,6,521,6,521,0.088016000,0.4224
136.25.188.209,<->,84.242.68.243,6,336,0,0,6,336,0.087944000,0.0097
69.246.61.13,<->,8.252.223.162,0,0,6,479,6,479,0.087940000,0.8101
133.178.226.19,<->,29.209.59.183,6,336,0,0,6,336,0.087827000,0.0621
111.20.172.70,<->,111.20.168.143,0,0,6,826,6,826,0.087604000,1.0004
215.158.61.145,<->,8.176.8.242,0,0,6,1622,6,1622,0.087465000,1.0249
148.244.145.59,<->,91.231.194.125,0,0,6,516,6,516,0.087165000,1.5172
215.158.238.64,<->,197.125.126.250,6,2874,0,0,6,2874,0.086776000,1.8128
136.25.189.32,<->,96.156.169.234,6,2950,0,0,6,2950,0.086709000,0.2646
215.158.239.56,<->,199.121.37.140,6,1180,0,0,6,1180,0.085925000,0.3607
120.165.195.197,<->,98.236.194.252,0,0,6,300,6,300,0.085757000,1.1123
111.20.172.70,<->,33.233.141.104,0,0,6,718,6,718,0.085303000,1.0103
111.20.172.70,<->,111.20.168.14,0,0,6,881,6,881,0.085263000,1.0049
202.163.117.156,<->,89.183.104.145,0,0,6,5928,6,5928,0.083990000,1.8356
133.178.227.79,<->,106.188.253.64,6,3508,0,0,6,3508,0.083793000,1.7502
215.158.239.56,<->,196.106.170.112,6,336,0,0,6,336,0.083427000,0.0170
231.140.0.41,<->,215.158.239.97,0,0,6,336,6,336,0.083390000,0.0185
215.158.239.56,<->,199.20.31.247,6,412,0,0,6,412,0.083254000,0.0002
111.20.172.70,<->,33.233.141.121,0,0,6,752,6,752,0.083176000,1.0063
136.25.188.176,<->,29.214.108.191,6,3650,0,0,6,3650,0.082577000,0.5803
215.158.238.64,<->,131.1.195.248,6,1493,0,0,6,1493,0.081320000,0.1234
215.158.239.87,<->,199.20.31.216,6,392,0,0,6,392,0.080578000,0.8300
215.158.239.50,<->,29.214.73.149,6,4159,0,0,6,4159,0.080330000,1.7077
207.172.190.167,<->,136.25.188.252,0,0,6,424,6,424,0.080285000,0.0605
100.228.42.160,<->,17.202.109.191,6,1394,0,0,6,1394,0.079147000,0.2052
102.254.104.31,<->,97.198.108.233,0,0,6,493,6,493,0.078269000,0.0990
215.158.61.189,<->,8.176.8.191,0,0,6,1455,6,1455,0.077996000,1.8957
215.158.238.99,<->,57.227.83.247,6,336,0,0,6,336,0.077298000,0.0007
221.102.56.69,<->,102.83.220.113,0,0,6,598,6,598,0.076493000,0.5346
215.158.238.82,<->,122.159.245.148,6,2602,0,0,6,2602,0.076276000,1.0205
215.158.238.67,<->,111.151.70.36,6,1445,0,0,6,1445,0.076239000,1.4372
215.158.239.49,<->,195.13.221.3,6,306,0,0,6,306,0.075618000,0.3692
215.158.239.79,<->,196.91.170.107,6,336,0,0,6,336,0.075200000,1.9197
139.163.96.94,<->,64.255.183.180,6,300,0,0,6,300,0.075062000,1.5980
218.188.29.5,<->,80.27.158.227,0,0,6,627,6,627,0.075011000,1.0295
144.72.193.17,<->,100.94.73.184,0,0,6,4257,6,4257,0.074833000,0.3816
100.224.23.128,<->,89.183.104.181,0,0,6,1039,6,1039,0.074736000,1.2188
243.117.125.59,<->,220.55.100.127,0,0,6,1931,6,1931,0.074551000,0.2107
120.159.169.25,<->,50.224.76.230,0,0,6,781,6,781,0.074435000,0.2621
152.40.47.154,<->,8.252.222.143,0,0,6,1022,6,1022,0.074307000,1.8059
215.158.239.96,<->,199.20.4.94,6,336,0,0,6,336,0.073935000,0.6710
215.158.239.97,<->,142.221.13.37,6,349,0,0,6,349,0.073716000,0.2604
200.10.103.173,<->,8.252.222.46,0,0,6,397,6,397,0.073706000,0.1681
136.25.189.57,<->,96.156.169.221,6,2938,0,0,6,2938,0.073133000,1.2646
215.158.239.87,<->,196.94.43.209,6,416,0,0,6,416,0.072103000,1.2396
205.127.108.113,<->,33.233.141.5,0,0,6,1551,6,1551,0.072081000,1.2938
215.158.239.54,<->,133.56.180.20,6,7509,0,0,6,7509,0.071909000,0.0186
239.36.168.170,<->,80.27.153.2,0,0,6,3326,6,3326,0.071423000,0.3902
220.83.118.213,<->,106.5.208.193,6,2327,0,0,6,2327,0.071361000,1.5865
120.148.82.112,<->,50.224.93.77,0,0,6,300,6,300,0.071042000,0.1743
159.137.162.213,<->,117.20.151.128,6,882,0,0,6,882,0.069284000,0.6877
111.20.172.70,<->,111.20.168.1,0,0,6,744,6,744,0.069045000,0.9948
93.181.154.108,<->,92.27.219.145,0,0,6,306,6,306,0.068923000,0.9544
215.158.239.41,<->,29.214.74.170,6,1733,0,0,6,1733,0.068809000,0.1536
221.102.143.189,<->,102.83.9.113,0,0,6,336,6,336,0.068796000,1.5180
215.33.49.54,<->,8.52.187.0,0,0,6,2018,6,2018,0.068730000,0.2779
136.25.189.0,<->,65.27.228.251,6,2810,0,0,6,2810,0.068715000,1.8634
215.158.140.60,<->,8.40.51.176,6,1369,0,0,6,1369,0.068689000,1.9002
159.23.226.13,<->,112.11.52.165,6,333,0,0,6,333,0.068630000,1.8055
215.158.239.79,<->,194.232.14.77,6,890,0,0,6,890,0.068160000,1.0503
215.158.239.50,<->,57.236.82.214,6,2662,0,0,6,2662,0.068017000,1.2984
89.183.104.185,<->,33.245.119.91,6,348,0,0,6,348,0.067468000,1.7681
116.106.60.148,<->,8.252.222.211,0,0,6,2746,6,2746,0.067060000,1.6990
215.158.239.59,<->,116.106.46.57,6,2998,0,0,6,2998,0.066487000,1.2323
138.121.99.24,<->,8.220.239.30,0,0,6,804,6,804,0.066264000,1.8010
66.47.8.106,<->,8.252.221.197,0,0,6,312,6,312,0.066155000,1.7777
207.11.121.84,<->,8.252.222.39,0,0,6,306,6,306,0.065711000,0.2157
192.67.179.47,<->,116.252.55.192,6,336,0,0,6,336,0.064877000,1.8449
215.158.238.45,<->,158.178.187.53,6,1493,0,0,6,1493,0.064474000,0.1419
215.158.238.81,<->,112.164.79.42,6,1461,0,0,6,1461,0.064077000,0.0960
204.185.247.124,<->,136.25.188.177,0,0,6,1064,6,1064,0.063813000,1.6198
199.110.184.40,<->,50.223.3.228,0,0,6,300,6,300,0.063797000,1.6631
159.137.162.213,<->,117.39.53.205,6,882,0,0,6,882,0.063563000,0.6200
133.178.226.197,<->,106.188.254.175,6,433,0,0,6,433,0.062858000,0.2710
69.31.238.221,<->,8.176.8.220,0,0,6,5653,6,5653,0.062406000,0.2448
136.25.188.45,<->,114.25.48.35,6,336,0,0,6,336,0.062152000,0.0005
145.110.157.4,<->,50.223.3.228,0,0,6,510,6,510,0.062045000,0.1970
215.158.239.87,<->,207.228.147.30,6,437,0,0,6,437,0.059720000,0.1678
111.20.172.70,<->,33.233.141.91,0,0,6,941,6,941,0.058438000,1.0653
215.158.239.57,<->,199.20.63.97,6,330,0,0,6,330,0.058361000,0.6238
199.72.36.168,<->,136.25.188.198,0,0,6,400,6,400,0.058292000,0.0155
215.158.239.32,<->,8.252.214.213,6,1778,0,0,6,1778,0.058248000,1.4570
195.43.118.8,<->,136.25.188.178,0,0,6,349,6,349,0.057998000,0.2252
215.158.239.58,<->,195.80.42.180,6,606,0,0,6,606,0.057720000,1.9300
215.158.239.49,<->,207.115.73.228,6,408,0,0,6,408,0.057451000,1.7102
196.240.180.180,<->,136.25.188.252,0,0,6,1165,6,1165,0.056303000,0.2929
144.85.169.211,<->,101.70.101.4,0,0,6,7176,6,7176,0.056277000,1.2122
97.182.34.181,<->,8.220.178.166,0,0,6,1181,6,1181,0.056170000,1.4174
159.137.234.218,<->,144.83.115.203,6,591,0,0,6,591,0.055359000,0.1033
197.107.200.103,<->,136.25.188.253,0,0,6,1373,6,1373,0.054002000,1.9344
95.245.73.153,<->,8.252.221.230,0,0,6,702,6,702,0.053791000,1.0957
111.20.172.70,<->,33.233.141.25,0,0,6,749,6,749,0.052817000,1.9416
97.198.108.230,<->,89.204.73.235,6,336,0,0,6,336,0.050744000,1.6175
215.158.238.6,<->,207.201.134.57,6,3307,0,0,6,3307,0.050587000,1.2329
192.64.204.221,<->,105.133.26.208,6,368,0,0,6,368,0.049910000,0.7931
231.142.233.199,<->,136.25.188.252,0,0,6,569,6,569,0.049889000,0.3520
205.175.197.160,<->,139.163.68.55,0,0,6,343,6,343,0.049807000,1.7502
215.158.239.51,<->,199.20.30.57,6,397,0,0,6,397,0.049629000,1.6228
247.136.130.61,<->,193.51.144.204,6,1028,0,0,6,1028,0.049281000,0.5190
202.77.250.77,<->,8.252.222.175,0,0,6,412,6,412,0.049128000,0.2715
139.163.5.140,<->,121.166.170.76,6,696,0,0,6,696,0.047685000,0.3261
141.204.123.255,<->,136.25.188.105,0,0,6,760,6,760,0.047390000,1.6834
111.20.172.70,<->,101.224.89.132,0,0,6,756,6,756,0.047128000,1.9519
139.163.68.55,<->,136.114.236.221,6,300,0,0,6,300,0.046006000,1.5466
136.25.188.175,<->,126.219.194.132,6,2441,0,0,6,2441,0.044942000,0.0964
136.25.189.80,<->,38.104.11.1,6,2986,0,0,6,2986,0.044887000,1.8532
204.62.56.8,<->,136.25.188.178,0,0,6,1378,6,1378,0.044399000,0.4196
215.158.140.241,<->,122.159.123.91,6,2565,0,0,6,2565,0.043570000,1.2808
215.158.238.75,<->,119.196.23.9,6,2682,0,0,6,2682,0.043440000,1.0990
137.129.42.9,<->,53.200.236.124,6,1855,0,0,6,1855,0.043216000,0.7959
53.181.160.213,<->,8.228.215.154,0,0,6,497,6,497,0.043196000,0.2209
195.7.75.221,<->,136.25.188.198,0,0,6,306,6,306,0.042504000,0.2279
69.103.121.183,<->,8.252.222.151,0,0,6,875,6,875,0.042205000,0.4302
142.236.26.141,<->,136.25.188.162,0,0,6,306,6,306,0.041832000,0.7272
192.67.181.42,<->,124.22.107.37,6,457,0,0,6,457,0.041485000,0.4471
229.42.112.119,<->,98.236.235.93,0,0,6,336,6,336,0.039916000,1.6702
53.203.244.195,<->,48.53.80.15,0,0,6,557,6,557,0.038612000,1.1554
215.158.238.134,<->,120.154.221.203,6,2810,0,0,6,2810,0.037689000,0.6870
215.158.239.58,<->,199.20.29.229,6,424,0,0,6,424,0.037168000,0.2250
92.27.219.36,<->,60.99.160.252,6,4566,0,0,6,4566,0.037116000,1.8688
126.198.202.200,<->,108.134.118.34,0,0,6,996,6,996,0.036560000,0.4763
143.135.144.121,<->,136.25.188.222,0,0,6,300,6,300,0.036160000,1.6562
133.178.227.41,<->,131.144.112.235,6,3540,0,0,6,3540,0.036064000,1.5790
215.158.239.79,<->,199.20.30.173,6,336,0,0,6,336,0.035818000,0.0694
247.136.208.15,<->,0.195.206.242,6,3536,0,0,6,3536,0.035375000,0.0010
136.25.189.59,<->,72.23.194.229,6,4463,0,0,6,4463,0.034859000,1.7935
215.158.239.93,<->,196.91.186.38,6,1864,0,0,6,1864,0.034662000,1.5099
215.158.239.70,<->,207.213.62.211,6,336,0,0,6,336,0.034435000,0.0278
245.244.35.4,<->,8.182.227.180,0,0,6,625,6,625,0.034166000,0.3637
215.158.238.59,<->,122.158.245.7,6,336,0,0,6,336,0.033569000,0.0013
82.249.191.12,<->,50.224.76.60,0,0,6,300,6,300,0.033485000,1.8943
215.158.239.95,<->,196.90.101.132,6,336,0,0,6,336,0.033400000,0.8224
222.65.17.30,<->,89.90.104.87,6,2190,0,0,6,2190,0.033352000,0.3588
129.225.135.192,<->,129.225.132.224,0,0,6,827,6,827,0.032831000,0.0294
133.178.226.30,<->,8.252.253.235,6,1477,0,0,6,1477,0.031789000,0.1585
73.64.209.124,<->,8.252.222.80,0,0,6,472,6,472,0.030430000,0.0697
215.158.239.56,<->,204.61.158.70,6,306,0,0,6,306,0.029987000,0.4628
136.25.189.31,<->,8.33.226.56,6,1637,0,0,6,1637,0.029316000,1.4912
136.25.188.208,<->,113.23.104.247,6,1771,0,0,6,1771,0.028060000,1.9620
215.202.174.56,<->,215.158.239.78,0,0,6,2458,6,2458,0.027163000,1.6768
215.158.239.69,<->,142.207.228.57,6,336,0,0,6,336,0.027125000,0.0109
215.158.239.58,<->,207.62.22.34,6,1112,0,0,6,1112,0.026383000,1.8678
215.158.239.57,<->,207.213.233.200,6,412,0,0,6,412,0.026188000,0.0502
142.191.245.48,<->,136.25.188.254,0,0,6,1040,6,1040,0.025767000,0.7066
205.89.143.65,<->,50.224.76.234,0,0,6,1214,6,1214,0.025364000,0.3348
69.128.79.174,<->,53.68.31.204,6,1509,0,0,6,1509,0.024351000,0.2877
215.158.238.63,<->,56.1.238.152,6,5087,0,0,6,5087,0.024315000,0.1100
136.25.188.217,<->,100.224.202.157,6,1686,0,0,6,1686,0.023548000,0.8935
215.158.239.95,<->,29.214.73.85,6,2906,0,0,6,2906,0.023044000,1.2272
136.25.189.0,<->,96.156.169.162,6,3066,0,0,6,3066,0.022417000,1.2505
138.121.99.24,<->,8.220.176.253,0,0,6,601,6,601,0.021061000,0.0753
54.36.97.247,<->,6.95.7.197,0,0,6,3500,6,3500,0.019745000,0.2553
144.85.170.254,<->,91.69.185.232,6,1030,0,0,6,1030,0.019322000,0.0833
8.252.221.236,<->,4.120.147.110,6,708,0,0,6,708,0.019158000,1.5475
215.158.61.189,<->,136.25.189.214,0,0,6,6837,6,6837,0.019008000,0.7332
6.145.169.208,<->,0.195.210.44,0,0,6,618,6,618,0.018450000,0.6199
215.158.61.145,<->,8.176.8.215,0,0,6,4283,6,4283,0.017153000,1.7432
145.129.249.172,<->,138.98.233.50,0,0,6,1483,6,1483,0.016385000,1.9518
89.183.109.28,<->,35.55.57.164,6,726,0,0,6,726,0.015777000,1.8754
142.208.11.158,<->,136.25.188.162,0,0,6,1204,6,1204,0.015402000,0.2170
215.158.239.49,<->,195.43.77.167,6,429,0,0,6,429,0.014623000,1.6799
50.224.80.64,<->,50.118.122.183,6,1897,0,0,6,1897,0.014473000,1.4459
195.71.168.154,<->,136.25.188.237,0,0,6,814,6,814,0.014238000,1.7914
142.190.111.118,<->,136.25.188.255,0,0,6,1384,6,1384,0.014035000,0.8884
192.170.241.202,<->,8.252.222.235,0,0,6,459,6,459,0.014001000,0.3912
215.158.239.56,<->,194.250.222.108,6,540,0,0,6,540,0.013651000,0.5385
213.221.90.202,<->,144.85.170.248,0,0,6,336,6,336,0.013585000,0.3304
117.4.7.176,<->,111.146.152.238,0,0,6,980,6,980,0.013532000,0.2636
192.170.241.167,<->,8.252.221.164,0,0,6,697,6,697,0.012211000,1.8423
215.158.140.76,<->,131.1.194.203,6,1321,0,0,6,1321,0.011829000,1.2807
215.158.140.178,<->,8.222.7.184,6,3164,0,0,6,3164,0.011602000,1.9739
69.246.46.252,<->,8.252.222.28,0,0,6,381,6,381,0.011200000,0.0057
136.25.189.16,<->,8.50.171.213,6,4031,0,0,6,4031,0.010786000,1.6925
136.128.19.81,<->,111.146.189.12,0,0,6,4365,6,4365,0.009322000,0.7381
207.22.234.156,<->,0.195.210.46,0,0,6,1567,6,1567,0.009237000,1.7865
215.158.239.51,<->,142.241.248.211,6,300,0,0,6,300,0.009178000,1.1550
159.137.162.213,<->,117.128.121.205,6,1094,0,0,6,1094,0.008789000,1.0742
143.72.83.44,<->,136.25.188.198,0,0,6,662,6,662,0.007369000,1.8303
215.158.140.205,<->,8.222.7.168,6,3101,0,0,6,3101,0.007050000,1.9781
215.158.239.35,<->,118.20.114.90,6,1744,0,0,6,1744,0.006874000,0.9891
215.158.238.67,<->,122.158.51.53,6,1541,0,0,6,1541,0.006763000,1.6233
215.158.238.241,<->,104.3.168.55,6,1374,0,0,6,1374,0.005485000,0.2413
142.227.69.84,<->,136.25.188.46,0,0,6,300,6,300,0.005261000,0.0212
143.94.157.36,<->,136.25.188.197,0,0,6,372,6,372,0.005109000,0.6909
54.59.122.154,<->,48.53.143.192,0,0,6,1034,6,1034,0.004712000,1.1353
199.73.78.21,<->,136.25.188.174,0,0,6,888,6,888,0.004476000,0.2174
246.253.253.210,<->,196.20.252.209,6,990,0,0,6,990,0.004442000,1.7291
207.172.14.128,<->,136.25.188.236,0,0,6,1857,6,1857,0.004095000,1.4590
136.139.59.106,<->,136.25.188.254,0,0,6,2790,6,2790,0.003121000,1.1982
199.15.20.3,<->,136.25.188.252,0,0,6,336,6,336,0.002990000,0.1833
117.128.153.245,<->,92.27.219.178,0,0,6,4692,6,4692,0.002881000,1.7458
215.158.127.230,<->,8.252.223.161,0,0,6,348,6,348,0.002581000,0.0287
145.192.64.35,<->,8.52.183.20,0,0,6,1376,6,1376,0.002297000,0.2828
195.15.212.35,<->,136.25.188.54,0,0,6,336,6,336,0.001406000,0.0841
215.158.239.70,<->,207.190.56.68,6,336,0,0,6,336,0.001292000,0.0506
204.2.4.234,<->,136.25.188.178,0,0,6,400,6,400,0.000979000,0.0086
108.8.186.194,<->,101.235.70.72,0,0,6,1717,6,1717,0.000844000,0.4848
231.140.176.221,<->,136.25.188.178,0,0,6,381,6,381,0.000798000,0.0379
143.128.150.39,<->,136.25.188.176,0,0,6,312,6,312,0.000725000,0.2728
136.25.189.29,<->,106.188.253.129,6,4094,0,0,6,4094,0.000463000,1.1720
133.178.226.7,<->,112.235.95.24,6,2634,0,0,6,2634,0.000245000,0.8708
197.113.99.50,<->,136.25.188.253,0,0,6,373,6,373,0.000214000,1.6003
215.158.238.67,<->,131.1.195.247,6,1605,0,0,6,1605,0.000124000,0.4800
210.95.218.219,<->,50.224.103.30,0,0,6,539,6,539,0.000041000,0.1130
204.200.61.119,<->,136.25.188.163,0,0,5,356,5,356,1.995420000,0.0041
215.158.239.121,<->,215.158.61.195,5,6397,0,0,5,6397,1.989172000,0.0000
215.158.239.121,<->,215.158.61.193,5,6445,0,0,5,6445,1.986626000,0.0000
215.158.61.203,<->,8.176.8.94,0,0,5,6317,5,6317,1.976102000,0.0000
199.39.41.121,<->,136.25.188.209,0,0,5,356,5,356,1.973176000,0.0108
204.187.124.135,<->,136.25.188.199,0,0,5,356,5,356,1.965138000,0.0101
215.158.239.99,<->,196.89.246.79,5,344,0,0,5,344,1.962030000,0.0118
207.60.85.200,<->,136.25.188.209,0,0,5,365,5,365,1.960993000,0.0094
215.158.61.193,<->,8.176.8.251,0,0,5,6189,5,6189,1.954317000,0.0000
136.25.188.209,<->,17.140.118.35,5,365,0,0,5,365,1.953280000,0.0080
204.200.63.83,<->,136.25.188.46,0,0,5,356,5,356,1.953242000,0.0001
199.72.101.125,<->,136.25.188.174,0,0,5,356,5,356,1.950869000,0.0132
194.252.68.61,<->,0.195.210.33,0,0,5,356,5,356,1.949192000,0.0133
144.83.60.153,<->,92.162.253.84,0,0,5,4378,5,4378,1.947963000,0.0287
215.158.239.79,<->,196.88.180.76,5,356,0,0,5,356,1.942077000,0.0076
80.40.57.225,<->,8.45.162.111,5,3785,0,0,5,3785,1.941784000,0.0431
215.158.61.182,<->,8.176.8.102,0,0,5,2117,5,2117,1.933103000,0.0589
194.254.226.57,<->,8.252.222.156,0,0,5,356,5,356,1.924748000,0.0071
207.59.238.132,<->,136.25.188.52,0,0,5,356,5,356,1.917543000,0.0091
195.54.108.162,<->,136.25.188.162,0,0,5,356,5,356,1.913482000,0.0074
251.98.38.228,<->,50.224.76.234,0,0,5,985,5,985,1.910473000,0.0781
199.80.3.58,<->,136.25.188.253,0,0,5,356,5,356,1.904761000,0.0083
215.158.239.93,<->,196.1.204.70,5,356,0,0,5,356,1.903033000,0.0191
215.158.61.203,<->,136.25.189.214,0,0,5,6237,5,6237,1.899690000,0.0000
195.15.170.142,<->,136.25.188.241,0,0,5,356,5,356,1.898693000,0.0074
204.61.83.193,<->,136.25.188.44,0,0,5,356,5,356,1.898179000,0.0113
143.53.255.61,<->,136.25.188.225,0,0,5,356,5,356,1.898065000,0.0081
221.102.56.69,<->,109.0.216.133,0,0,5,3989,5,3989,1.896482000,0.0396
207.20.191.116,<->,8.252.222.208,0,0,5,356,5,356,1.894773000,0.0026
143.12.234.77,<->,136.25.188.174,0,0,5,356,5,356,1.893033000,0.0187
194.234.203.239,<->,136.25.188.236,0,0,5,356,5,356,1.892866000,0.0180
215.158.239.58,<->,199.20.28.27,5,2107,0,0,5,2107,1.886435000,0.0358
215.158.239.7,<->,8.241.236.193,5,1640,0,0,5,1640,1.886041000,0.1117
133.178.226.214,<->,129.175.139.144,5,377,0,0,5,377,1.885452000,0.0819
145.208.183.77,<->,136.25.188.52,0,0,5,459,5,459,1.881451000,0.0775
109.222.242.225,<->,53.190.20.59,5,4151,0,0,5,4151,1.878022000,0.0482
215.158.239.41,<->,8.190.216.220,5,1550,0,0,5,1550,1.877042000,0.0369
253.220.0.66,<->,136.25.188.226,0,0,5,1302,5,1302,1.875761000,0.0992
215.158.239.68,<->,196.91.35.67,5,350,0,0,5,350,1.875312000,0.0800
215.158.61.183,<->,8.176.8.245,0,0,5,5290,5,5290,1.872470000,0.0173
215.158.239.84,<->,195.81.26.243,5,450,0,0,5,450,1.869125000,0.0992
207.61.72.59,<->,136.25.188.242,0,0,5,356,5,356,1.867977000,0.0123
223.176.113.234,<->,8.252.222.36,0,0,5,356,5,356,1.863682000,0.0000
195.41.195.238,<->,136.25.188.238,0,0,5,356,5,356,1.861203000,0.0286
109.222.220.98,<->,54.52.243.230,5,471,0,0,5,471,1.860818000,0.1070
98.23.97.118,<->,8.176.60.254,0,0,5,771,5,771,1.857091000,0.1412
199.39.76.4,<->,136.25.188.196,0,0,5,356,5,356,1.856533000,0.0077
204.184.217.171,<->,136.25.188.198,0,0,5,356,5,356,1.854062000,0.0503
98.219.117.2,<->,80.38.56.244,0,0,5,1069,5,1069,1.852991000,0.0767
192.229.43.38,<->,133.178.227.245,0,0,5,5221,5,5221,1.851745000,0.0318
89.216.124.13,<->,54.54.1.89,5,509,0,0,5,509,1.851484000,0.0908
192.64.222.89,<->,159.57.90.83,5,3663,0,0,5,3663,1.849482000,0.0961
215.158.239.57,<->,195.81.52.214,5,365,0,0,5,365,1.844701000,0.0101
223.176.113.234,<->,8.252.222.141,0,0,5,356,5,356,1.843129000,0.0087
215.158.239.77,<->,207.228.117.16,5,356,0,0,5,356,1.842828000,0.0001
159.224.178.58,<->,8.53.3.36,0,0,5,526,5,526,1.836941000,0.1040
8.183.25.25,<->,6.133.238.200,5,514,0,0,5,514,1.836583000,0.1000
97.209.105.200,<->,80.40.36.227,0,0,5,1034,5,1034,1.832974000,0.1261
215.158.239.113,<->,129.222.36.56,5,2019,0,0,5,2019,1.831102000,0.0265
136.25.189.94,<->,96.156.169.226,5,4959,0,0,5,4959,1.829748000,0.0044
144.85.170.208,<->,56.189.215.197,5,656,0,0,5,656,1.823801000,0.0515
199.82.242.44,<->,136.25.188.242,0,0,5,356,5,356,1.820736000,0.0086
145.252.124.87,<->,89.155.136.36,5,2928,0,0,5,2928,1.820264000,0.1237
210.209.251.211,<->,144.87.235.222,0,0,5,702,5,702,1.819489000,0.0851
235.103.58.112,<->,144.85.170.244,0,0,5,280,5,280,1.818195000,0.0018
143.148.100.254,<->,0.195.210.46,0,0,5,356,5,356,1.817407000,0.0258
97.168.79.200,<->,0.195.216.193,5,314,0,0,5,314,1.811839000,0.1758
215.158.239.68,<->,199.20.5.132,5,356,0,0,5,356,1.807096000,0.1802
204.62.152.26,<->,136.25.188.253,0,0,5,356,5,356,1.806338000,0.0070
215.158.239.85,<->,199.20.30.24,5,256,0,0,5,256,1.805929000,0.0510
207.172.164.74,<->,136.25.188.175,0,0,5,356,5,356,1.805223000,0.1600
212.164.143.230,<->,100.120.38.110,5,1552,0,0,5,1552,1.799566000,0.1316
17.24.139.9,<->,8.220.188.50,0,0,5,619,5,619,1.796284000,0.0624
199.71.72.160,<->,136.25.188.198,0,0,5,250,5,250,1.794592000,0.1803
98.248.253.162,<->,50.224.76.234,0,0,5,1209,5,1209,1.790948000,0.0561
17.61.232.100,<->,8.220.202.4,0,0,5,512,5,512,1.789687000,0.1292
136.25.188.253,<->,126.219.196.166,5,1293,0,0,5,1293,1.787881000,0.1269
143.132.153.33,<->,136.25.188.46,0,0,5,299,5,299,1.785020000,0.1877
215.158.61.182,<->,8.176.8.105,0,0,5,6109,5,6109,1.783965000,0.0000
199.52.87.66,<->,136.25.188.198,0,0,5,356,5,356,1.783359000,0.0106
204.3.142.141,<->,136.25.188.241,0,0,5,356,5,356,1.783183000,0.0059
215.158.238.133,<->,91.57.173.25,5,3026,0,0,5,3026,1.781447000,0.1746
143.42.198.52,<->,136.25.188.177,0,0,5,356,5,356,1.780924000,0.0031
111.168.45.61,<->,8.220.200.124,0,0,5,433,5,433,1.773694000,0.0985
252.152.59.8,<->,215.158.239.17,0,0,5,471,5,471,1.773275000,0.1217
215.158.238.67,<->,32.183.36.250,5,1581,0,0,5,1581,1.772233000,0.1989
136.25.189.202,<->,129.222.39.98,5,2545,0,0,5,2545,1.771858000,0.0237
215.158.238.246,<->,215.158.43.0,5,557,0,0,5,557,1.771179000,0.0353
227.23.167.28,<->,92.27.194.249,0,0,5,555,5,555,1.769034000,0.0120
109.1.37.80,<->,100.230.5.7,5,2983,0,0,5,2983,1.768350000,0.1691
215.158.238.250,<->,126.219.191.4,5,2357,0,0,5,2357,1.766467000,0.2147
246.253.253.99,<->,139.33.175.151,5,1297,0,0,5,1297,1.766018000,0.1148
6.145.152.249,<->,0.195.210.44,0,0,5,471,5,471,1.764471000,0.1319
221.102.56.69,<->,80.40.58.69,0,0,5,534,5,534,1.763329000,0.2120
204.186.197.47,<->,136.25.188.177,0,0,5,356,5,356,1.763163000,0.0398
195.124.102.68,<->,136.25.188.252,0,0,5,356,5,356,1.763120000,0.0244
215.158.239.35,<->,8.222.7.187,5,2402,0,0,5,2402,1.763061000,0.2303
215.158.239.92,<->,199.20.30.64,5,356,0,0,5,356,1.761079000,0.0401
136.25.188.196,<->,8.42.43.48,5,1549,0,0,5,1549,1.760331000,0.2177
215.158.238.216,<->,215.158.43.17,5,506,0,0,5,506,1.755920000,0.0357
246.253.235.153,<->,131.36.182.198,5,2923,0,0,5,2923,1.754635000,0.1891
215.158.239.48,<->,199.20.28.12,5,356,0,0,5,356,1.751194000,0.0001
129.224.112.221,<->,97.242.126.176,5,331,0,0,5,331,1.749624000,0.2196
220.55.123.87,<->,27.11.149.50,5,506,0,0,5,506,1.749478000,0.2378
142.253.91.82,<->,136.25.188.254,0,0,5,356,5,356,1.746832000,0.0084
142.240.211.219,<->,136.25.188.176,0,0,5,356,5,356,1.744881000,0.0001
215.158.239.93,<->,207.228.190.99,5,280,0,0,5,280,1.743615000,0.2404
143.94.165.210,<->,136.25.188.252,0,0,5,356,5,356,1.743154000,0.0074
233.97.214.206,<->,129.6.83.6,0,0,5,705,5,705,1.742733000,0.2195
204.20.227.37,<->,136.25.188.222,0,0,5,420,5,420,1.741474000,0.2300
215.158.238.135,<->,126.219.196.185,5,1485,0,0,5,1485,1.740830000,0.1507
215.158.239.76,<->,194.199.210.94,5,356,0,0,5,356,1.730005000,0.0002
231.136.241.241,<->,136.25.188.236,0,0,5,356,5,356,1.726356000,0.0800
136.25.188.255,<->,126.219.132.226,5,1581,0,0,5,1581,1.726263000,0.2325
133.178.226.233,<->,111.151.142.165,5,280,0,0,5,280,1.725315000,0.0002
136.25.188.242,<->,126.219.19.53,5,1421,0,0,5,1421,1.723266000,0.2469
215.158.239.101,<->,129.222.39.121,5,2580,0,0,5,2580,1.723050000,0.0259
215.158.238.198,<->,114.94.161.171,5,1325,0,0,5,1325,1.721458000,0.1961
133.178.227.208,<->,8.50.169.192,5,3426,0,0,5,3426,1.721144000,0.0968
145.255.180.193,<->,144.75.218.235,0,0,5,875,5,875,1.720958000,0.1493
220.28.108.254,<->,215.158.238.136,0,0,5,5378,5,5378,1.720910000,0.0321
215.158.61.242,<->,8.176.8.180,0,0,5,6093,5,6093,1.716881000,0.0000
99.187.125.121,<->,8.20.87.33,0,0,5,895,5,895,1.716265000,0.1502
215.158.238.95,<->,80.47.111.74,5,1261,0,0,5,1261,1.715621000,0.1430
144.83.60.153,<->,92.162.253.28,0,0,5,3970,5,3970,1.713160000,0.1481
215.158.239.99,<->,196.107.142.49,5,464,0,0,5,464,1.712806000,0.2796
215.158.239.77,<->,207.63.63.196,5,293,0,0,5,293,1.712643000,0.2143
201.136.143.22,<->,136.25.188.178,0,0,5,1680,5,1680,1.712642000,0.2489
215.158.140.235,<->,122.158.176.235,5,7496,0,0,5,7496,1.712289000,0.0135
207.57.241.1,<->,136.25.188.54,0,0,5,356,5,356,1.711896000,0.0084
204.200.63.204,<->,136.25.188.177,0,0,5,563,5,563,1.711273000,0.2464
215.158.238.113,<->,8.220.51.247,5,1661,0,0,5,1661,1.709651000,0.2619
119.159.22.233,<->,92.162.253.39,0,0,5,532,5,532,1.709568000,0.1917
8.182.253.40,<->,6.133.212.101,5,902,0,0,5,902,1.706986000,0.1206
100.252.218.26,<->,100.228.42.160,0,0,5,2242,5,2242,1.705922000,0.1996
199.82.220.118,<->,136.25.188.252,0,0,5,356,5,356,1.702684000,0.0155
133.178.226.212,<->,122.158.176.156,5,7496,0,0,5,7496,1.702169000,0.0135
136.25.189.18,<->,29.209.59.187,5,1380,0,0,5,1380,1.700054000,0.2976
157.127.180.7,<->,8.252.222.23,0,0,5,476,5,476,1.698715000,0.2657
97.80.236.157,<->,8.182.226.78,0,0,5,2601,5,2601,1.698299000,0.0764
138.80.112.237,<->,8.220.186.61,0,0,5,599,5,599,1.696663000,0.2215
231.140.159.96,<->,136.25.188.252,0,0,5,356,5,356,1.692466000,0.0149
142.241.15.104,<->,136.25.188.226,0,0,5,344,5,344,1.687998000,0.0064
215.158.61.242,<->,136.25.188.43,0,0,5,6077,5,6077,1.687529000,0.0000
215.158.238.135,<->,120.154.226.156,5,1469,0,0,5,1469,1.687311000,0.2695
133.178.227.250,<->,80.57.208.189,5,3216,0,0,5,3216,1.686889000,0.1374
109.1.54.101,<->,80.243.150.152,5,944,0,0,5,944,1.684804000,0.2015
215.158.239.97,<->,194.251.115.79,5,380,0,0,5,380,1.682253000,0.0138
139.163.120.42,<->,125.204.20.202,5,968,0,0,5,968,1.682016000,0.2474
215.158.239.48,<->,199.20.30.169,5,356,0,0,5,356,1.680392000,0.0002
215.158.239.68,<->,204.227.216.39,5,356,0,0,5,356,1.679057000,0.0012
199.83.48.197,<->,136.25.188.45,0,0,5,356,5,356,1.678585000,0.0079
247.136.154.185,<->,27.178.95.28,5,2033,0,0,5,2033,1.677011000,0.1665
139.33.174.178,<->,111.147.174.227,0,0,5,2988,5,2988,1.672163000,0.0978
215.158.239.59,<->,199.106.50.216,5,268,0,0,5,268,1.671483000,0.1438
136.25.188.237,<->,122.158.49.139,5,1513,0,0,5,1513,1.670164000,0.2977
221.196.90.92,<->,8.53.3.201,0,0,5,581,5,581,1.668115000,0.2909
79.20.57.135,<->,8.252.222.31,0,0,5,356,5,356,1.660992000,0.0042
100.81.104.145,<->,50.224.76.235,0,0,5,1087,5,1087,1.658529000,0.1621
142.220.162.20,<->,136.25.188.241,0,0,5,347,5,347,1.655788000,0.2163
215.158.238.81,<->,143.155.227.40,5,1341,0,0,5,1341,1.655700000,0.2832
215.158.239.95,<->,196.92.93.79,5,356,0,0,5,356,1.654423000,0.0900
8.183.25.25,<->,6.20.45.74,5,482,0,0,5,482,1.654136000,0.2685
139.193.141.139,<->,102.248.56.155,5,3696,0,0,5,3696,1.653858000,0.2830
215.158.140.93,<->,158.85.50.154,5,2830,0,0,5,2830,1.653199000,0.3390
215.158.239.48,<->,143.13.168.8,5,250,0,0,5,250,1.651477000,0.1781
148.23.229.100,<->,133.178.226.7,0,0,5,1661,5,1661,1.647454000,0.2389
215.158.61.202,<->,136.25.188.34,0,0,5,1571,5,1571,1.647242000,0.1798
195.127.208.96,<->,136.25.188.220,0,0,5,356,5,356,1.646412000,0.0039
247.136.144.152,<->,158.19.152.110,5,810,0,0,5,810,1.645297000,0.2335
17.34.35.51,<->,8.220.239.84,0,0,5,1096,5,1096,1.642574000,0.1471
220.55.72.171,<->,220.20.206.160,5,1630,0,0,5,1630,1.640967000,0.1934
202.162.40.142,<->,8.252.222.49,0,0,5,356,5,356,1.638555000,0.0095
221.102.56.69,<->,192.66.145.107,0,0,5,3989,5,3989,1.635665000,0.0436
220.55.113.112,<->,139.254.119.163,5,805,0,0,5,805,1.635021000,0.3246
204.61.231.227,<->,136.25.188.55,0,0,5,934,5,934,1.634610000,0.3569
215.158.238.81,<->,146.10.166.74,5,1389,0,0,5,1389,1.634056000,0.2112
133.178.226.173,<->,111.151.139.138,5,7496,0,0,5,7496,1.629522000,0.0139
215.158.140.241,<->,29.212.42.227,5,1269,0,0,5,1269,1.626968000,0.2963
215.158.238.133,<->,111.150.34.246,5,1661,0,0,5,1661,1.626500000,0.2097
215.158.239.56,<->,196.95.87.139,5,356,0,0,5,356,1.623081000,0.0500
112.28.115.238,<->,89.183.104.173,0,0,5,260,5,260,1.622756000,0.3769
246.253.253.208,<->,142.225.12.35,5,566,0,0,5,566,1.622547000,0.3016
235.42.34.23,<->,136.25.188.173,0,0,5,1549,5,1549,1.621561000,0.2113
243.144.227.33,<->,50.224.76.234,0,0,5,4392,5,4392,1.620967000,0.2011
133.178.226.60,<->,131.36.198.32,5,1549,0,0,5,1549,1.620518000,0.1775
203.215.162.183,<->,124.42.185.84,5,875,0,0,5,875,1.620297000,0.2568
207.88.64.72,<->,133.178.226.77,0,0,5,1581,5,1581,1.620192000,0.3568
142.190.67.102,<->,136.25.188.196,0,0,5,856,5,856,1.618500000,0.3708
133.178.227.242,<->,111.151.237.189,5,3481,0,0,5,3481,1.618106000,0.1631
215.158.140.172,<->,98.249.65.9,5,3279,0,0,5,3279,1.617899000,0.2688
229.45.57.252,<->,97.243.220.36,5,705,0,0,5,705,1.617022000,0.2795
207.56.170.177,<->,136.25.188.255,0,0,5,356,5,356,1.616465000,0.0072
215.158.238.251,<->,8.221.197.170,5,1309,0,0,5,1309,1.606293000,0.1317
215.158.239.11,<->,96.135.154.142,5,7256,0,0,5,7256,1.605644000,0.0001
90.240.120.21,<->,53.203.133.145,5,5060,0,0,5,5060,1.603547000,0.3701
142.240.36.44,<->,136.25.188.176,0,0,5,356,5,356,1.602806000,0.0075
215.158.239.58,<->,196.0.149.119,5,356,0,0,5,356,1.601484000,0.0115
199.70.39.110,<->,136.25.188.236,0,0,5,504,5,504,1.600702000,0.3979
215.158.238.133,<->,111.150.186.207,5,280,0,0,5,280,1.599956000,0.0679
159.137.162.213,<->,105.81.55.121,5,832,0,0,5,832,1.599602000,0.3604
215.158.239.58,<->,199.20.28.7,5,1150,0,0,5,1150,1.597493000,0.3799
136.25.188.162,<->,29.214.71.116,5,1421,0,0,5,1421,1.597298000,0.2947
136.25.189.13,<->,119.168.0.26,5,1581,0,0,5,1581,1.596420000,0.1407
141.253.224.227,<->,50.224.76.235,0,0,5,4636,5,4636,1.595077000,0.3956
8.252.221.239,<->,4.120.222.43,5,292,0,0,5,292,1.593073000,0.3383
220.185.228.201,<->,89.183.104.148,0,0,5,402,5,402,1.592872000,0.4056
111.147.220.188,<->,54.36.179.214,5,3701,0,0,5,3701,1.592330000,0.1438
215.158.239.57,<->,199.20.28.118,5,356,0,0,5,356,1.592226000,0.0001
133.178.227.1,<->,133.56.180.40,5,4109,0,0,5,4109,1.587027000,0.2945
249.101.117.219,<->,97.110.90.37,5,350,0,0,5,350,1.584389000,0.1122
111.147.87.240,<->,53.245.70.29,5,3819,0,0,5,3819,1.583099000,0.2153
215.158.238.65,<->,126.219.196.169,5,1485,0,0,5,1485,1.579660000,0.3393
109.1.54.101,<->,101.143.64.164,5,1046,0,0,5,1046,1.578396000,0.2726
215.158.239.95,<->,195.97.145.102,5,1244,0,0,5,1244,1.576335000,0.0611
215.158.239.87,<->,199.72.93.129,5,950,0,0,5,950,1.575569000,0.3578
135.255.67.82,<->,8.252.222.45,0,0,5,350,5,350,1.573666000,0.0050
80.53.58.243,<->,8.52.222.23,0,0,5,562,5,562,1.571964000,0.1203
133.178.227.255,<->,29.211.122.31,5,1005,0,0,5,1005,1.571858000,0.1080
50.54.40.210,<->,8.220.176.253,0,0,5,679,5,679,1.570783000,0.0621
199.15.202.72,<->,136.25.188.198,0,0,5,475,5,475,1.567148000,0.4080
136.25.188.254,<->,38.104.11.40,5,1549,0,0,5,1549,1.563323000,0.2653
95.245.108.6,<->,8.252.221.236,0,0,5,1757,5,1757,1.563186000,0.3017
231.142.111.219,<->,136.25.188.196,0,0,5,350,5,350,1.562760000,0.0074
195.5.39.197,<->,136.25.188.254,0,0,5,773,5,773,1.561746000,0.3642
215.158.239.78,<->,199.20.6.69,5,356,0,0,5,356,1.560168000,0.0001
99.252.190.185,<->,92.27.27.174,0,0,5,292,5,292,1.560040000,0.1119
195.12.100.132,<->,136.25.188.196,0,0,5,479,5,479,1.559306000,0.4385
231.142.68.126,<->,136.25.188.253,0,0,5,356,5,356,1.559210000,0.0081
136.25.188.226,<->,41.161.48.147,5,365,0,0,5,365,1.558268000,0.0096
144.85.170.208,<->,98.87.144.89,5,613,0,0,5,613,1.555231000,0.1157
220.20.200.139,<->,141.131.213.24,5,4442,0,0,5,4442,1.554787000,0.1934
215.158.239.84,<->,199.20.6.49,5,340,0,0,5,340,1.552468000,0.3410
204.2.251.130,<->,136.25.188.163,0,0,5,356,5,356,1.551030000,0.0081
194.233.172.245,<->,136.25.188.209,0,0,5,420,5,420,1.550185000,0.1597
215.158.239.108,<->,215.158.61.145,5,3525,0,0,5,3525,1.549383000,0.1727
215.158.239.105,<->,215.158.61.193,5,6781,0,0,5,6781,1.549033000,0.0000
215.158.239.96,<->,194.237.111.30,5,635,0,0,5,635,1.547581000,0.3373
196.17.190.33,<->,50.224.76.234,0,0,5,1342,5,1342,1.546706000,0.3297
207.172.10.45,<->,136.25.188.174,0,0,5,356,5,356,1.546374000,0.0500
199.38.230.175,<->,136.25.188.220,0,0,5,356,5,356,1.545927000,0.0138
240.117.25.98,<->,50.224.76.235,0,0,5,670,5,670,1.544772000,0.2480
195.40.127.204,<->,136.25.188.163,0,0,5,950,5,950,1.543642000,0.4457
195.71.77.53,<->,136.25.188.176,0,0,5,1972,5,1972,1.543371000,0.4489
136.25.189.202,<->,129.222.39.91,5,2824,0,0,5,2824,1.541272000,0.0258
139.161.104.7,<->,133.178.227.134,0,0,5,2674,5,2674,1.540264000,0.2150
133.178.226.29,<->,96.155.60.212,5,1890,0,0,5,1890,1.540085000,0.0671
159.137.139.210,<->,136.25.188.152,0,0,5,280,5,280,1.538055000,0.0001
215.158.239.50,<->,204.226.96.57,5,356,0,0,5,356,1.537345000,0.0117
133.178.226.90,<->,131.1.195.221,5,2963,0,0,5,2963,1.537220000,0.2553
216.144.221.244,<->,215.158.140.205,0,0,5,622,5,622,1.537103000,0.1315
215.158.61.203,<->,8.176.8.176,0,0,5,6221,5,6221,1.536957000,0.0000
136.25.188.254,<->,80.93.220.12,5,954,0,0,5,954,1.535959000,0.0895
142.236.92.247,<->,136.25.188.209,0,0,5,356,5,356,1.535195000,0.0074
133.54.17.198,<->,89.183.98.97,5,784,0,0,5,784,1.532015000,0.2329
152.139.166.235,<->,80.27.157.236,0,0,5,380,5,380,1.529752000,0.3170
243.117.116.114,<->,144.86.144.224,0,0,5,2073,5,2073,1.527472000,0.4533
215.158.239.51,<->,196.90.101.128,5,356,0,0,5,356,1.527380000,0.0200
139.160.226.234,<->,136.25.188.236,0,0,5,1453,5,1453,1.526192000,0.2547
199.15.241.133,<->,136.25.188.253,0,0,5,1219,5,1219,1.526126000,0.0081
207.59.232.88,<->,136.25.188.239,0,0,5,356,5,356,1.525321000,0.0089
111.146.226.14,<->,111.5.197.195,5,604,0,0,5,604,1.525280000,0.0448
50.224.76.235,<->,50.105.237.70,5,972,0,0,5,972,1.525154000,0.0846
142.208.234.171,<->,136.25.188.160,0,0,5,344,5,344,1.523502000,0.0096
196.200.78.52,<->,8.252.222.178,0,0,5,356,5,356,1.522857000,0.0130
89.183.110.72,<->,0.70.165.139,5,1068,0,0,5,1068,1.522598000,0.2104
133.178.227.24,<->,29.211.122.238,5,2738,0,0,5,2738,1.517853000,0.3958
152.40.191.96,<->,8.252.222.174,0,0,5,365,5,365,1.517351000,0.0067
253.182.227.8,<->,215.158.238.95,0,0,5,1309,5,1309,1.517167000,0.1209
215.158.239.84,<->,199.70.185.46,5,365,0,0,5,365,1.516414000,0.0145
142.227.97.23,<->,50.224.76.234,0,0,5,764,5,764,1.516403000,0.3276
210.209.251.211,<->,111.146.143.217,0,0,5,1772,5,1772,1.513497000,0.1393
215.158.239.25,<->,96.135.154.112,5,5036,0,0,5,5036,1.511396000,0.0068
144.72.194.209,<->,137.137.124.27,0,0,5,859,5,859,1.510411000,0.0814
133.178.227.40,<->,102.225.141.57,5,1317,0,0,5,1317,1.510188000,0.0460
204.63.248.181,<->,136.25.188.222,0,0,5,472,5,472,1.509487000,0.4896
195.4.8.199,<->,136.25.188.240,0,0,5,356,5,356,1.509064000,0.0095
142.248.88.198,<->,136.25.188.253,0,0,5,485,5,485,1.508609000,0.4885
204.3.28.135,<->,136.25.188.178,0,0,5,356,5,356,1.505081000,0.0071
224.129.13.57,<->,8.182.226.78,0,0,5,1051,5,1051,1.503171000,0.1695
215.158.61.202,<->,8.176.8.224,0,0,5,6109,5,6109,1.502824000,0.0000
136.18.239.217,<->,8.183.25.25,0,0,5,845,5,845,1.502396000,0.1396
124.47.116.59,<->,50.224.76.235,0,0,5,835,5,835,1.497765000,0.3867
196.89.25.19,<->,136.25.188.255,0,0,5,479,5,479,1.493955000,0.4587
143.135.128.30,<->,136.25.188.238,0,0,5,356,5,356,1.489035000,0.0138
199.69.174.156,<->,136.25.188.225,0,0,5,344,5,344,1.488312000,0.1446
215.158.239.70,<->,135.229.0.214,5,1597,0,0,5,1597,1.488201000,0.3922
129.236.114.39,<->,111.20.168.209,0,0,5,5681,5,5681,1.487503000,0.0001
215.158.239.86,<->,199.20.31.29,5,356,0,0,5,356,1.487040000,0.0399
204.200.46.104,<->,136.25.188.209,0,0,5,475,5,475,1.486457000,0.3834
96.190.6.207,<->,92.27.219.190,0,0,5,891,5,891,1.486242000,0.3097
93.66.55.106,<->,80.40.25.242,0,0,5,715,5,715,1.485566000,0.4768
220.20.200.157,<->,132.216.159.4,5,1490,0,0,5,1490,1.483499000,0.3791
142.227.65.64,<->,50.224.76.234,0,0,5,865,5,865,1.483357000,0.4305
215.158.239.56,<->,199.82.184.226,5,475,0,0,5,475,1.481433000,0.5152
215.158.239.4,<->,158.166.175.243,5,3217,0,0,5,3217,1.480792000,0.2768
133.178.227.57,<->,122.159.123.36,5,1300,0,0,5,1300,1.479080000,0.3016
136.25.188.179,<->,113.23.7.55,5,1405,0,0,5,1405,1.478801000,0.3704
215.158.140.161,<->,29.211.199.33,5,565,0,0,5,565,1.478312000,0.2367
80.27.159.59,<->,72.151.67.12,5,3133,0,0,5,3133,1.477458000,0.2965
17.199.106.163,<->,8.220.179.94,0,0,5,867,5,867,1.476493000,0.1942
143.128.25.212,<->,136.25.188.46,0,0,5,879,5,879,1.475049000,0.2649
215.158.238.133,<->,156.181.149.245,5,1565,0,0,5,1565,1.474945000,0.3380
142.255.136.94,<->,136.25.188.178,0,0,5,356,5,356,1.474321000,0.0074
136.25.188.163,<->,122.158.51.60,5,1469,0,0,5,1469,1.473842000,0.2905
215.158.239.56,<->,199.20.30.110,5,299,0,0,5,299,1.473385000,0.4002
119.86.172.235,<->,50.224.76.234,0,0,5,2139,5,2139,1.473340000,0.2556
192.226.161.38,<->,136.25.188.255,0,0,5,1421,5,1421,1.473210000,0.4565
215.201.235.99,<->,8.182.230.13,0,0,5,408,5,408,1.471646000,0.1618
215.158.239.79,<->,199.20.30.110,5,299,0,0,5,299,1.470713000,0.4002
215.158.61.243,<->,8.176.8.105,0,0,5,6301,5,6301,1.470351000,0.0000
215.158.238.64,<->,122.158.49.195,5,1293,0,0,5,1293,1.470320000,0.5030
246.253.253.169,<->,139.33.174.178,5,2924,0,0,5,2924,1.469925000,0.0615
159.137.162.213,<->,29.134.123.217,5,832,0,0,5,832,1.467943000,0.5317
215.158.61.195,<->,136.25.188.34,0,0,5,6077,5,6077,1.466549000,0.0000
91.231.192.88,<->,89.219.78.245,5,689,0,0,5,689,1.465803000,0.2924
196.89.25.19,<->,136.25.188.252,0,0,5,479,5,479,1.464894000,0.4364
216.144.221.249,<->,215.158.140.221,0,0,5,392,5,392,1.464890000,0.0884
214.85.253.103,<->,50.224.76.235,0,0,5,1449,5,1449,1.464645000,0.5275
215.158.239.97,<->,199.20.29.185,5,274,0,0,5,274,1.464173000,0.4999
215.158.239.50,<->,199.38.118.52,5,356,0,0,5,356,1.461054000,0.0171
195.126.187.28,<->,136.25.188.46,0,0,5,344,5,344,1.460251000,0.0120
204.61.36.1,<->,136.25.188.226,0,0,5,356,5,356,1.459730000,0.0077
145.192.66.138,<->,8.52.181.95,0,0,5,853,5,853,1.459183000,0.2118
194.233.169.234,<->,136.25.188.176,0,0,5,356,5,356,1.455927000,0.0387
133.178.227.2,<->,122.216.233.219,5,1312,0,0,5,1312,1.453519000,0.1067
109.222.249.251,<->,89.6.224.186,5,282,0,0,5,282,1.453279000,0.3316
139.160.227.45,<->,133.178.227.208,0,0,5,3634,5,3634,1.451665000,0.0514
199.81.38.70,<->,136.25.188.253,0,0,5,474,5,474,1.451416000,0.4832
215.158.239.49,<->,194.251.113.103,5,356,0,0,5,356,1.451376000,0.0020
135.243.190.251,<->,8.220.176.253,0,0,5,1304,5,1304,1.449725000,0.5301
215.158.239.56,<->,194.251.73.223,5,356,0,0,5,356,1.447631000,0.0013
215.158.238.143,<->,29.212.198.151,5,1533,0,0,5,1533,1.447322000,0.2235
215.158.61.202,<->,136.25.189.194,0,0,5,6285,5,6285,1.445947000,0.0000
203.212.35.24,<->,50.224.76.230,0,0,5,1443,5,1443,1.445056000,0.3447
215.158.239.69,<->,126.219.194.181,5,2818,0,0,5,2818,1.444869000,0.2194
197.113.99.244,<->,136.25.188.227,0,0,5,262,5,262,1.444393000,0.5189
129.78.115.95,<->,116.96.63.23,5,1237,0,0,5,1237,1.443663000,0.2442
204.185.255.78,<->,136.25.188.238,0,0,5,356,5,356,1.443094000,0.0406
149.109.218.105,<->,92.27.219.205,0,0,5,641,5,641,1.442759000,0.4678
133.178.227.50,<->,80.57.141.64,5,1597,0,0,5,1597,1.441950000,0.0394
133.178.226.227,<->,29.212.206.231,5,856,0,0,5,856,1.441568000,0.1936
136.25.188.175,<->,122.159.245.149,5,2530,0,0,5,2530,1.440913000,0.4918
199.71.235.42,<->,136.25.188.53,0,0,5,394,5,394,1.440053000,0.3267
199.121.73.3,<->,136.25.188.253,0,0,5,1110,5,1110,1.439230000,0.4084
145.48.251.10,<->,133.178.227.247,0,0,5,2509,5,2509,1.436354000,0.1482
196.206.223.55,<->,136.25.188.163,0,0,5,950,5,950,1.435360000,0.5399
215.158.239.94,<->,199.20.28.182,5,1968,0,0,5,1968,1.434400000,0.5097
142.241.137.131,<->,136.25.188.174,0,0,5,356,5,356,1.434381000,0.0215
142.190.238.181,<->,136.25.188.241,0,0,5,356,5,356,1.432692000,0.0076
215.158.140.165,<->,8.222.7.187,5,3201,0,0,5,3201,1.431591000,0.5541
225.222.118.180,<->,8.220.176.253,0,0,5,499,5,499,1.431532000,0.0402
144.86.150.8,<->,112.3.174.85,5,1542,0,0,5,1542,1.429785000,0.2410
143.128.24.209,<->,136.25.188.255,0,0,5,250,5,250,1.429532000,0.3663
99.187.125.121,<->,8.20.87.10,0,0,5,1123,5,1123,1.429153000,0.0767
220.20.202.153,<->,129.78.117.164,0,0,5,862,5,862,1.428868000,0.2154
115.139.125.51,<->,50.224.76.230,0,0,5,903,5,903,1.428227000,0.1809
215.158.239.92,<->,106.188.253.182,5,2722,0,0,5,2722,1.425794000,0.3496
207.239.173.59,<->,136.25.188.178,0,0,5,1119,5,1119,1.425210000,0.2515
215.158.239.68,<->,204.226.7.236,5,1925,0,0,5,1925,1.425142000,0.4640
133.40.211.1,<->,8.252.222.160,0,0,5,356,5,356,1.425083000,0.0027
215.158.127.165,<->,8.252.222.139,0,0,5,5057,5,5057,1.424558000,0.0106
142.190.113.150,<->,136.25.188.163,0,0,5,356,5,356,1.424382000,0.0114
215.158.239.232,<->,100.244.13.26,5,315,0,0,5,315,1.424298000,0.0250
98.217.53.146,<->,50.224.76.234,0,0,5,1330,5,1330,1.423056000,0.1257
8.183.25.124,<->,6.104.173.172,5,921,0,0,5,921,1.422288000,0.0778
215.158.239.95,<->,199.20.29.254,5,299,0,0,5,299,1.421591000,0.2291
212.100.244.206,<->,8.52.128.75,0,0,5,999,5,999,1.420678000,0.0709
215.158.239.78,<->,196.93.146.104,5,356,0,0,5,356,1.420471000,0.0002
222.42.150.75,<->,50.224.76.235,0,0,5,1237,5,1237,1.420141000,0.2222
133.178.226.30,<->,113.23.113.198,5,1469,0,0,5,1469,1.418243000,0.1799
215.158.239.51,<->,118.20.100.139,5,2674,0,0,5,2674,1.416635000,0.3862
92.162.219.33,<->,80.38.36.175,0,0,5,1454,5,1454,1.416572000,0.2255
215.158.61.242,<->,99.74.26.188,0,0,5,910,5,910,1.415803000,0.0848
215.158.238.66,<->,212.70.217.70,5,1437,0,0,5,1437,1.415664000,0.0428
56.114.235.120,<->,8.228.216.50,0,0,5,2891,5,2891,1.412659000,0.1384
149.163.134.231,<->,133.178.227.2,0,0,5,1269,5,1269,1.409252000,0.4682
195.42.29.225,<->,136.25.188.253,0,0,5,356,5,356,1.406731000,0.0071
215.158.238.133,<->,42.97.54.26,5,1309,0,0,5,1309,1.406565000,0.1971
220.39.21.52,<->,133.32.39.1,0,0,5,479,5,479,1.406548000,0.0501
142.206.27.11,<->,136.25.188.220,0,0,5,1295,5,1295,1.404864000,0.0518
215.158.239.113,<->,129.222.39.125,5,2304,0,0,5,2304,1.403804000,0.0250
207.58.104.155,<->,136.25.188.53,0,0,5,1939,5,1939,1.403413000,0.5441
142.207.18.52,<->,136.25.188.254,0,0,5,356,5,356,1.401691000,0.0072
215.158.239.58,<->,196.93.154.19,5,356,0,0,5,356,1.399721000,0.0497
207.172.128.52,<->,136.25.188.162,0,0,5,350,5,350,1.397256000,0.0302
215.158.140.92,<->,149.163.129.215,5,2370,0,0,5,2370,1.395540000,0.5392
194.232.2.136,<->,136.25.188.242,0,0,5,980,5,980,1.395517000,0.5203
245.161.124.43,<->,8.252.222.150,0,0,5,459,5,459,1.393099000,0.5224
111.150.186.232,<->,8.252.222.237,0,0,5,1437,5,1437,1.392758000,0.2165
215.158.61.189,<->,8.176.8.245,0,0,5,6413,5,6413,1.392405000,0.0000
117.46.137.244,<->,50.224.76.234,0,0,5,1405,5,1405,1.388221000,0.2179
58.51.34.135,<->,8.252.222.46,0,0,5,344,5,344,1.388197000,0.1962
143.128.216.164,<->,136.25.188.220,0,0,5,299,5,299,1.387967000,0.3646
215.158.239.96,<->,196.89.113.76,5,1464,0,0,5,1464,1.387933000,0.5967
99.187.125.121,<->,8.20.87.8,0,0,5,1241,5,1241,1.387676000,0.2044
215.158.239.33,<->,57.210.104.228,5,1776,0,0,5,1776,1.386062000,0.1280
221.102.143.189,<->,98.128.162.225,0,0,5,295,5,295,1.384598000,0.0902
136.25.188.44,<->,57.184.236.82,5,1533,0,0,5,1533,1.382693000,0.2533
207.236.179.85,<->,136.25.188.253,0,0,5,356,5,356,1.381396000,0.0081
215.158.238.23,<->,111.151.71.52,5,1533,0,0,5,1533,1.380873000,0.1105
142.190.159.28,<->,136.25.188.198,0,0,5,856,5,856,1.379124000,0.4094
136.25.188.173,<->,133.167.148.155,5,799,0,0,5,799,1.378974000,0.2445
249.101.84.219,<->,54.61.53.169,5,524,0,0,5,524,1.377967000,0.2041
215.158.239.29,<->,61.34.126.202,5,1677,0,0,5,1677,1.377962000,0.2429
206.158.155.251,<->,139.193.141.139,0,0,5,2077,5,2077,1.377160000,0.1681
143.132.54.239,<->,136.25.188.226,0,0,5,356,5,356,1.376275000,0.0165
122.223.218.50,<->,50.224.76.235,0,0,5,740,5,740,1.373347000,0.3215
231.140.2.184,<->,136.25.188.45,0,0,5,356,5,356,1.373222000,0.0074
245.161.124.43,<->,8.252.222.163,0,0,5,459,5,459,1.372760000,0.5443
246.253.145.63,<->,143.102.51.178,5,545,0,0,5,545,1.370463000,0.5623
215.158.238.209,<->,8.42.42.148,5,1629,0,0,5,1629,1.368384000,0.2494
149.251.213.181,<->,8.252.222.227,0,0,5,1565,5,1565,1.366473000,0.1164
215.158.239.50,<->,199.20.31.238,5,834,0,0,5,834,1.365314000,0.1992
195.77.33.211,<->,50.224.76.230,0,0,5,1665,5,1665,1.361770000,0.3459
215.158.239.69,<->,199.20.31.18,5,311,0,0,5,311,1.360175000,0.0110
156.165.33.55,<->,133.178.226.30,0,0,5,1269,5,1269,1.358278000,0.4700
8.252.223.145,<->,8.222.6.193,5,1294,0,0,5,1294,1.357016000,0.0345
136.25.189.1,<->,29.211.93.15,5,497,0,0,5,497,1.356794000,0.5749
194.237.47.251,<->,136.25.188.220,0,0,5,356,5,356,1.352277000,0.0071
136.25.189.78,<->,72.23.6.46,5,1437,0,0,5,1437,1.352237000,0.3201
131.82.121.131,<->,50.224.76.235,0,0,5,1094,5,1094,1.351475000,0.2326
215.158.239.79,<->,199.20.30.180,5,356,0,0,5,356,1.346491000,0.0001
215.158.238.73,<->,119.196.23.70,5,1469,0,0,5,1469,1.345452000,0.1287
215.158.238.92,<->,56.1.237.75,5,1293,0,0,5,1293,1.344542000,0.0355
197.113.99.232,<->,136.25.188.54,0,0,5,950,5,950,1.344433000,0.5299
203.114.24.27,<->,136.25.188.197,0,0,5,1001,5,1001,1.344301000,0.4200
8.252.221.236,<->,4.122.187.30,5,658,0,0,5,658,1.344282000,0.5216
207.236.236.149,<->,136.25.188.238,0,0,5,356,5,356,1.343155000,0.0074
194.210.255.197,<->,80.42.168.206,0,0,5,269,5,269,1.340762000,0.0396
223.142.180.204,<->,92.27.219.196,0,0,5,250,5,250,1.340426000,0.1479
204.184.43.115,<->,136.25.188.222,0,0,5,356,5,356,1.334567000,0.0802
215.158.238.134,<->,57.227.77.108,5,1481,0,0,5,1481,1.334017000,0.2118
133.178.226.38,<->,131.144.114.228,5,2910,0,0,5,2910,1.332847000,0.5079
231.143.89.81,<->,136.25.188.54,0,0,5,356,5,356,1.331929000,0.4996
136.129.94.157,<->,6.145.166.196,5,646,0,0,5,646,1.318289000,0.4895
143.184.79.238,<->,8.52.222.23,0,0,5,579,5,579,1.317102000,0.4607
132.250.195.43,<->,6.138.238.145,0,0,5,411,5,411,1.316178000,0.2154
132.216.20.76,<->,101.235.78.20,0,0,5,913,5,913,1.315831000,0.0834
143.134.97.211,<->,136.25.188.197,0,0,5,365,5,365,1.315019000,0.0079
192.64.217.166,<->,142.174.218.147,5,318,0,0,5,318,1.314979000,0.3615
139.244.182.238,<->,8.220.239.132,0,0,5,842,5,842,1.314229000,0.0467
130.146.158.154,<->,89.216.124.92,0,0,5,679,5,679,1.314161000,0.3571
204.187.20.114,<->,136.25.188.174,0,0,5,350,5,350,1.310493000,0.0796
199.50.55.20,<->,136.25.188.177,0,0,5,356,5,356,1.309767000,0.0070
202.33.236.140,<->,136.25.188.179,0,0,5,921,5,921,1.309735000,0.5200
215.158.239.99,<->,199.20.30.171,5,356,0,0,5,356,1.309531000,0.0090
99.187.125.121,<->,8.20.87.2,0,0,5,1241,5,1241,1.309505000,0.0978
215.158.238.144,<->,139.163.161.32,5,1629,0,0,5,1629,1.307529000,0.3184
207.60.43.197,<->,136.25.188.54,0,0,5,950,5,950,1.306785000,0.6146
192.67.175.59,<->,132.18.67.26,5,3306,0,0,5,3306,1.305483000,0.3314
215.158.239.121,<->,215.158.61.243,5,6765,0,0,5,6765,1.305480000,0.0000
136.129.92.245,<->,98.231.104.72,5,411,0,0,5,411,1.305013000,0.3558
215.158.239.84,<->,204.226.125.255,5,365,0,0,5,365,1.304044000,0.0027
215.158.238.109,<->,0.195.237.14,5,5298,0,0,5,5298,1.302910000,0.0259
139.36.120.118,<->,8.176.8.80,0,0,5,3431,5,3431,1.301737000,0.0190
231.142.16.195,<->,136.25.188.196,0,0,5,356,5,356,1.301341000,0.0087
215.158.239.68,<->,196.107.156.179,5,950,0,0,5,950,1.298632000,0.6898
92.27.219.219,<->,33.57.74.146,5,256,0,0,5,256,1.297414000,0.5411
197.113.99.244,<->,136.25.188.243,0,0,5,950,5,950,1.292235000,0.6590
215.158.239.40,<->,138.126.75.62,5,1405,0,0,5,1405,1.291326000,0.2631
215.158.238.148,<->,57.210.107.36,5,1565,0,0,5,1565,1.290655000,0.1395
215.158.239.252,<->,8.255.95.184,5,288,0,0,5,288,1.288639000,0.0499
215.158.239.95,<->,199.20.28.85,5,299,0,0,5,299,1.288298000,0.2102
207.92.234.133,<->,8.182.253.169,0,0,5,1298,5,1298,1.288125000,0.5721
136.25.188.199,<->,8.179.43.54,5,1517,0,0,5,1517,1.288097000,0.3037
197.4.13.58,<->,133.178.226.61,0,0,5,1597,5,1597,1.287864000,0.2984
133.178.227.41,<->,29.211.165.26,5,1577,0,0,5,1577,1.287220000,0.1165
133.178.227.41,<->,80.57.141.107,5,1525,0,0,5,1525,1.285761000,0.0409
148.55.210.198,<->,136.25.188.254,0,0,5,1405,5,1405,1.284686000,0.1839
215.158.238.92,<->,8.241.236.66,5,1405,0,0,5,1405,1.283410000,0.1190
215.158.239.48,<->,199.20.6.6,5,356,0,0,5,356,1.281278000,0.0145
195.41.80.183,<->,136.25.188.45,0,0,5,356,5,356,1.281234000,0.0123
204.152.117.163,<->,50.224.76.234,0,0,5,1301,5,1301,1.280250000,0.5220
8.176.8.218,<->,8.35.106.184,5,1666,0,0,5,1666,1.280186000,0.2691
220.60.81.134,<->,136.25.189.59,0,0,5,2738,5,2738,1.279109000,0.3674
204.186.201.218,<->,136.25.188.174,0,0,5,356,5,356,1.277740000,0.1800
199.12.122.149,<->,136.25.188.211,0,0,5,467,5,467,1.277094000,0.6027
215.158.238.92,<->,143.155.227.33,5,1373,0,0,5,1373,1.276802000,0.2769
115.59.77.95,<->,92.27.27.150,0,0,5,260,5,260,1.276471000,0.1579
198.253.49.109,<->,92.27.27.184,0,0,5,572,5,572,1.275038000,0.3821
132.249.70.195,<->,92.26.137.227,5,1327,0,0,5,1327,1.271836000,0.0884
215.158.140.74,<->,210.209.188.196,5,880,0,0,5,880,1.270595000,0.0730
133.178.226.77,<->,126.219.194.151,5,2578,0,0,5,2578,1.269581000,0.6475
215.158.238.212,<->,215.158.43.51,5,747,0,0,5,747,1.268788000,0.2117
139.207.175.72,<->,50.224.76.235,0,0,5,1336,5,1336,1.268032000,0.1624
200.174.157.158,<->,54.59.92.175,5,1031,0,0,5,1031,1.265745000,0.5583
192.64.195.196,<->,50.51.14.51,5,937,0,0,5,937,1.264564000,0.5041
192.64.217.166,<->,33.123.162.14,5,314,0,0,5,314,1.264225000,0.3063
215.158.140.83,<->,158.85.50.93,5,2473,0,0,5,2473,1.264031000,0.6363
128.150.111.92,<->,50.224.76.230,0,0,5,700,5,700,1.263803000,0.2913
231.143.91.67,<->,136.25.188.225,0,0,5,350,5,350,1.260817000,0.0401
215.158.239.84,<->,199.20.29.25,5,307,0,0,5,307,1.260600000,0.7356
194.238.211.78,<->,136.25.188.237,0,0,5,356,5,356,1.258945000,0.0160
142.249.249.55,<->,136.25.188.227,0,0,5,280,5,280,1.258893000,0.0535
215.158.238.113,<->,204.154.223.150,5,1565,0,0,5,1565,1.257531000,0.3786
231.143.112.142,<->,136.25.188.220,0,0,5,459,5,459,1.256559000,0.4892
215.158.238.236,<->,126.219.246.238,5,1341,0,0,5,1341,1.256276000,0.2252
199.69.47.77,<->,136.25.188.225,0,0,5,856,5,856,1.255599000,0.4760
220.39.233.197,<->,133.178.226.61,0,0,5,1581,5,1581,1.255436000,0.2193
253.182.227.8,<->,136.25.188.227,0,0,5,1421,5,1421,1.254626000,0.1752
231.140.125.106,<->,136.25.188.225,0,0,5,356,5,356,1.254212000,0.0170
142.248.216.13,<->,136.25.188.252,0,0,5,350,5,350,1.252268000,0.0099
215.158.2.115,<->,133.178.226.167,0,0,5,2994,5,2994,1.251943000,0.5036
92.27.27.182,<->,57.68.48.112,5,654,0,0,5,654,1.250788000,0.7066
195.13.14.209,<->,136.25.188.252,0,0,5,356,5,356,1.247222000,0.0069
249.229.106.63,<->,8.53.0.43,0,0,5,856,5,856,1.244754000,0.2757
89.155.187.194,<->,8.183.25.124,0,0,5,856,5,856,1.243576000,0.2598
199.59.123.115,<->,50.223.3.228,0,0,5,377,5,377,1.243392000,0.6460
204.200.162.182,<->,136.25.188.240,0,0,5,350,5,350,1.239932000,0.0078
207.62.106.96,<->,136.25.188.45,0,0,5,595,5,595,1.239046000,0.6314
109.1.54.101,<->,92.36.36.224,5,823,0,0,5,823,1.237740000,0.1849
215.158.239.87,<->,199.20.28.159,5,356,0,0,5,356,1.237080000,0.0400
207.236.27.135,<->,136.25.188.53,0,0,5,670,5,670,1.235495000,0.2581
111.150.186.232,<->,8.252.222.176,0,0,5,1501,5,1501,1.234268000,0.3653
215.158.239.28,<->,158.166.175.248,5,3315,0,0,5,3315,1.233356000,0.6624
213.38.237.76,<->,132.128.61.77,5,820,0,0,5,820,1.232291000,0.1034
246.254.97.113,<->,139.33.174.19,5,796,0,0,5,796,1.232154000,0.0862
215.158.239.54,<->,0.195.253.228,5,5820,0,0,5,5820,1.231584000,0.7302
143.94.23.34,<->,50.224.76.234,0,0,5,1063,5,1063,1.225372000,0.2967
144.72.193.17,<->,132.163.8.243,0,0,5,806,5,806,1.224397000,0.2830
195.41.208.229,<->,136.25.188.255,0,0,5,356,5,356,1.222215000,0.0076
207.60.55.165,<->,136.25.188.163,0,0,5,356,5,356,1.220609000,0.0105
215.158.239.96,<->,199.20.100.95,5,856,0,0,5,856,1.220265000,0.3143
248.225.27.2,<->,159.28.252.223,5,375,0,0,5,375,1.219236000,0.3146
133.178.226.30,<->,120.155.8.109,5,1597,0,0,5,1597,1.219210000,0.1286
80.41.234.245,<->,56.13.192.190,5,469,0,0,5,469,1.218956000,0.5022
215.158.239.93,<->,196.95.135.73,5,356,0,0,5,356,1.218954000,0.0082
215.158.239.17,<->,199.82.11.179,5,469,0,0,5,469,1.216269000,0.5357
133.178.226.80,<->,96.155.60.212,5,1827,0,0,5,1827,1.214387000,0.0667
195.41.194.52,<->,136.25.188.44,0,0,5,528,5,528,1.213791000,0.4617
215.158.238.66,<->,57.227.83.251,5,1549,0,0,5,1549,1.210880000,0.1155
136.25.188.255,<->,122.158.49.154,5,1437,0,0,5,1437,1.210141000,0.2304
215.158.140.177,<->,204.251.8.19,5,1721,0,0,5,1721,1.209771000,0.2869
117.41.238.88,<->,50.224.76.230,0,0,5,1664,5,1664,1.208427000,0.2891
142.246.207.135,<->,50.223.3.228,0,0,5,250,5,250,1.208298000,0.7047
247.136.132.111,<->,103.166.36.62,5,938,0,0,5,938,1.206964000,0.4652
192.170.255.220,<->,133.32.39.0,0,0,5,479,5,479,1.206653000,0.0426
133.178.226.78,<->,113.23.104.221,5,496,0,0,5,496,1.206179000,0.7175
139.193.141.132,<->,102.249.125.118,5,812,0,0,5,812,1.205659000,0.6701
195.41.237.25,<->,136.25.188.53,0,0,5,356,5,356,1.203929000,0.0067
136.18.96.45,<->,8.182.226.78,0,0,5,747,5,747,1.202886000,0.3197
207.60.137.185,<->,136.25.188.238,0,0,5,954,5,954,1.202368000,0.4593
215.158.238.82,<->,57.199.250.212,5,1565,0,0,5,1565,1.202254000,0.3320
215.158.239.167,<->,111.151.237.138,5,3631,0,0,5,3631,1.195624000,0.0295
215.158.239.97,<->,195.15.42.68,5,797,0,0,5,797,1.195204000,0.4755
196.21.87.7,<->,50.224.76.234,0,0,5,992,5,992,1.194561000,0.3457
215.158.239.5,<->,96.135.154.155,5,1781,0,0,5,1781,1.194413000,0.2086
215.158.239.95,<->,195.49.254.203,5,950,0,0,5,950,1.190107000,0.5916
126.113.19.141,<->,109.222.250.46,0,0,5,686,5,686,1.188754000,0.5075
133.178.227.79,<->,114.146.74.195,5,1281,0,0,5,1281,1.188729000,0.1399
225.170.68.28,<->,97.198.118.57,0,0,5,657,5,657,1.188655000,0.0483
94.192.158.3,<->,8.252.222.60,0,0,5,356,5,356,1.188343000,0.0053
207.60.199.109,<->,136.25.188.174,0,0,5,1012,5,1012,1.188030000,0.3393
204.58.167.215,<->,136.25.188.175,0,0,5,356,5,356,1.185067000,0.0132
136.25.188.226,<->,112.220.206.24,5,1453,0,0,5,1453,1.184414000,0.1050
215.158.239.57,<->,114.150.180.156,5,1533,0,0,5,1533,1.184143000,0.1867
194.245.232.156,<->,8.252.222.177,0,0,5,356,5,356,1.182623000,0.0176
133.178.226.232,<->,111.151.106.229,5,280,0,0,5,280,1.182300000,0.0002
136.25.188.163,<->,133.167.148.155,5,1332,0,0,5,1332,1.180766000,0.1011
17.116.39.130,<->,8.220.186.82,0,0,5,380,5,380,1.180153000,0.2698
207.63.65.6,<->,136.25.188.176,0,0,5,365,5,365,1.179050000,0.0072
207.236.118.137,<->,136.25.188.252,0,0,5,356,5,356,1.179007000,0.0072
215.158.239.56,<->,196.93.232.240,5,356,0,0,5,356,1.178192000,0.0400
132.128.49.138,<->,35.56.97.244,0,0,5,1211,5,1211,1.177399000,0.0440
142.252.121.142,<->,136.25.188.176,0,0,5,356,5,356,1.174867000,0.0217
143.79.22.132,<->,136.25.188.241,0,0,5,356,5,356,1.172358000,0.0044
249.101.209.15,<->,210.209.251.214,5,2356,0,0,5,2356,1.171944000,0.8161
204.3.28.135,<->,136.25.188.176,0,0,5,356,5,356,1.169712000,0.0076
215.158.140.83,<->,8.240.116.184,5,2320,0,0,5,2320,1.168712000,0.8144
215.158.239.68,<->,199.20.28.200,5,324,0,0,5,324,1.167852000,0.6000
231.141.29.212,<->,136.25.188.178,0,0,5,1118,5,1118,1.167384000,0.7792
142.207.223.34,<->,136.25.188.162,0,0,5,989,5,989,1.165785000,0.4230
101.70.127.229,<->,54.50.224.229,5,2323,0,0,5,2323,1.165331000,0.4770
215.158.61.207,<->,136.25.189.213,0,0,5,681,5,681,1.162554000,0.0560
199.15.34.64,<->,136.25.188.239,0,0,5,1122,5,1122,1.160090000,0.3273
200.175.217.203,<->,53.213.103.24,5,367,0,0,5,367,1.159836000,0.6017
207.40.11.106,<->,50.224.76.234,0,0,5,1264,5,1264,1.158566000,0.6238
215.158.61.202,<->,8.176.8.97,0,0,5,1232,5,1232,1.156833000,0.4521
195.43.145.245,<->,136.25.188.178,0,0,5,356,5,356,1.156731000,0.0080
215.158.238.73,<->,122.158.49.195,5,1485,0,0,5,1485,1.155949000,0.1316
114.183.125.131,<->,50.224.76.235,0,0,5,746,5,746,1.155245000,0.5712
136.25.189.8,<->,96.156.169.210,5,5078,0,0,5,5078,1.154319000,0.0050
133.178.226.227,<->,8.53.216.3,5,1152,0,0,5,1152,1.154306000,0.1998
215.158.238.47,<->,69.31.238.232,5,1581,0,0,5,1581,1.153842000,0.4009
215.158.238.82,<->,100.224.202.8,5,1373,0,0,5,1373,1.152043000,0.0295
241.193.151.100,<->,136.25.188.236,0,0,5,544,5,544,1.151297000,0.1253
92.162.253.44,<->,33.235.244.154,5,3411,0,0,5,3411,1.150479000,0.3122
133.178.226.225,<->,113.24.30.219,5,521,0,0,5,521,1.149928000,0.1990
215.158.239.99,<->,199.106.56.71,5,980,0,0,5,980,1.149109000,0.6104
215.158.238.251,<->,8.222.6.193,5,2372,0,0,5,2372,1.148955000,0.4780
142.229.136.46,<->,136.25.188.178,0,0,5,356,5,356,1.146117000,0.0060
196.206.196.182,<->,136.25.188.174,0,0,5,618,5,618,1.146066000,0.4797
197.113.64.243,<->,136.25.188.253,0,0,5,356,5,356,1.145830000,0.0700
215.158.239.99,<->,199.20.30.57,5,288,0,0,5,288,1.145758000,0.6446
231.142.16.195,<->,136.25.188.252,0,0,5,356,5,356,1.144854000,0.0080
215.158.239.79,<->,143.79.196.178,5,356,0,0,5,356,1.144610000,0.0132
215.158.239.96,<->,195.55.112.133,5,292,0,0,5,292,1.144090000,0.0079
215.158.239.56,<->,199.82.189.142,5,973,0,0,5,973,1.143521000,0.2894
215.158.140.60,<->,8.50.171.255,5,1285,0,0,5,1285,1.141744000,0.1064
195.15.133.115,<->,136.25.188.240,0,0,5,256,5,256,1.139843000,0.7277
220.20.200.172,<->,119.159.22.233,5,549,0,0,5,549,1.139685000,0.1899
133.178.227.27,<->,8.42.42.84,5,2459,0,0,5,2459,1.138770000,0.7357
215.158.238.99,<->,146.14.145.213,5,2722,0,0,5,2722,1.138732000,0.7741
144.85.170.208,<->,91.69.185.132,5,1070,0,0,5,1070,1.138403000,0.1016
215.158.239.92,<->,207.58.11.163,5,2094,0,0,5,2094,1.138289000,0.8605
136.117.39.66,<->,109.1.31.105,0,0,5,4390,5,4390,1.137722000,0.2462
142.167.103.21,<->,136.25.188.53,0,0,5,475,5,475,1.136326000,0.5630
215.158.239.85,<->,196.6.145.214,5,280,0,0,5,280,1.134391000,0.0080
215.158.238.123,<->,112.70.164.59,5,1341,0,0,5,1341,1.132078000,0.1609
220.55.124.143,<->,220.20.198.107,5,1382,0,0,5,1382,1.131033000,0.4392
204.56.12.188,<->,136.25.188.55,0,0,5,356,5,356,1.130576000,0.0088
207.59.253.196,<->,136.25.188.175,0,0,5,491,5,491,1.130422000,0.3860
215.158.239.69,<->,199.20.5.131,5,356,0,0,5,356,1.130051000,0.0790
195.43.33.186,<->,136.25.188.225,0,0,5,356,5,356,1.129460000,0.0064
195.42.86.105,<->,136.25.188.241,0,0,5,475,5,475,1.128617000,0.8401
249.62.176.61,<->,215.158.239.234,0,0,5,3891,5,3891,1.126479000,0.0055
136.25.189.29,<->,133.56.180.50,5,2786,0,0,5,2786,1.124267000,0.3863
136.25.189.15,<->,29.212.198.215,5,2610,0,0,5,2610,1.122685000,0.8421
84.205.227.38,<->,8.252.222.159,0,0,5,860,5,860,1.122297000,0.2937
221.95.117.170,<->,50.224.76.230,0,0,5,1308,5,1308,1.121821000,0.1260
215.158.239.97,<->,196.92.132.96,5,555,0,0,5,555,1.120486000,0.4797
204.60.160.33,<->,136.25.188.199,0,0,5,412,5,412,1.117715000,0.7405
195.70.207.164,<->,136.25.188.163,0,0,5,1124,5,1124,1.116376000,0.5152
215.158.239.99,<->,199.15.220.125,5,459,0,0,5,459,1.113463000,0.3580
215.158.239.95,<->,199.20.29.90,5,459,0,0,5,459,1.111805000,0.8797
119.159.22.233,<->,92.162.253.252,0,0,5,573,5,573,1.111134000,0.1921
204.62.115.169,<->,136.25.188.237,0,0,5,356,5,356,1.109186000,0.0285
98.67.154.211,<->,80.27.153.41,5,1032,0,0,5,1032,1.109153000,0.4908
133.178.227.40,<->,72.23.148.232,5,1270,0,0,5,1270,1.108455000,0.4354
26.223.52.82,<->,8.220.179.94,0,0,5,1055,5,1055,1.108401000,0.2566
231.140.94.203,<->,136.25.188.45,0,0,5,365,5,365,1.107320000,0.0074
207.59.41.142,<->,136.25.188.52,0,0,5,539,5,539,1.106932000,0.4383
144.74.132.71,<->,50.224.76.235,0,0,5,1252,5,1252,1.105641000,0.0514
215.158.239.101,<->,129.222.39.116,5,2500,0,0,5,2500,1.105156000,0.0228
192.171.13.189,<->,8.252.222.18,0,0,5,689,5,689,1.104538000,0.0070
125.9.59.246,<->,109.1.25.177,0,0,5,356,5,356,1.104257000,0.3395
158.55.218.34,<->,50.224.76.235,0,0,5,1325,5,1325,1.103524000,0.2384
109.127.101.16,<->,102.50.64.197,0,0,5,4782,5,4782,1.102667000,0.0831
195.15.133.115,<->,136.25.188.46,0,0,5,256,5,256,1.101049000,0.7633
215.158.239.77,<->,207.57.165.244,5,954,0,0,5,954,1.100039000,0.5479
158.181.11.40,<->,144.87.235.222,0,0,5,1148,5,1148,1.098627000,0.3918
215.158.140.229,<->,195.65.1.168,5,3591,0,0,5,3591,1.098432000,0.8477
215.158.239.56,<->,199.20.7.188,5,356,0,0,5,356,1.098202000,0.0001
197.113.99.146,<->,136.25.188.176,0,0,5,1341,5,1341,1.097708000,0.2804
194.233.86.79,<->,136.25.188.197,0,0,5,350,5,350,1.095194000,0.0601
99.75.228.206,<->,27.11.18.201,5,1820,0,0,5,1820,1.095102000,0.0985
215.158.239.84,<->,96.150.228.214,5,2738,0,0,5,2738,1.095043000,0.8481
215.158.238.67,<->,106.188.183.87,5,1623,0,0,5,1623,1.093482000,0.2915
199.73.176.81,<->,136.25.188.52,0,0,5,299,5,299,1.093443000,0.1794
136.25.189.59,<->,96.156.169.253,5,3042,0,0,5,3042,1.092789000,0.5756
215.158.239.59,<->,199.20.29.237,5,356,0,0,5,356,1.090152000,0.0001
213.186.59.248,<->,139.163.17.164,0,0,5,674,5,674,1.088868000,0.0941
136.25.188.224,<->,112.220.206.15,5,2706,0,0,5,2706,1.086243000,0.8962
215.158.238.120,<->,114.25.48.40,5,2638,0,0,5,2638,1.085538000,0.7716
215.158.239.86,<->,57.236.82.251,5,1865,0,0,5,1865,1.083777000,0.3672
215.158.239.94,<->,126.219.49.93,5,2834,0,0,5,2834,1.082871000,0.5736
199.50.136.7,<->,136.25.188.226,0,0,5,475,5,475,1.080400000,0.5535
197.112.27.111,<->,8.52.222.23,0,0,5,250,5,250,1.080141000,0.7193
139.193.141.139,<->,27.165.241.33,5,739,0,0,5,739,1.078284000,0.8760
143.20.222.208,<->,50.224.76.235,0,0,5,937,5,937,1.076453000,0.3483
111.199.237.23,<->,8.20.87.95,0,0,5,856,5,856,1.076030000,0.2439
192.228.80.165,<->,133.32.39.1,0,0,5,479,5,479,1.074544000,0.0425
97.34.178.244,<->,50.224.102.155,0,0,5,1149,5,1149,1.074022000,0.0732
104.203.8.6,<->,50.224.76.248,0,0,5,897,5,897,1.073223000,0.6506
215.158.239.182,<->,80.47.161.166,5,985,0,0,5,985,1.069788000,0.0490
215.158.239.94,<->,199.20.31.87,5,280,0,0,5,280,1.068755000,0.6999
215.158.239.76,<->,207.115.235.64,5,356,0,0,5,356,1.067560000,0.0001
136.25.189.17,<->,29.213.219.39,5,2626,0,0,5,2626,1.066703000,0.7743
215.158.61.182,<->,8.176.8.179,0,0,5,6397,5,6397,1.063052000,0.0000
215.158.239.58,<->,196.108.189.52,5,337,0,0,5,337,1.059879000,0.1288
50.55.48.215,<->,8.220.191.154,0,0,5,4826,5,4826,1.058280000,0.2403
231.143.236.63,<->,136.25.188.220,0,0,5,434,5,434,1.057584000,0.4399
195.13.137.6,<->,136.25.188.55,0,0,5,950,5,950,1.057033000,0.3894
220.55.72.171,<->,220.20.206.153,5,1503,0,0,5,1503,1.056101000,0.2002
197.113.99.188,<->,136.25.188.242,0,0,5,280,5,280,1.056053000,0.6885
142.244.64.54,<->,136.25.188.222,0,0,5,356,5,356,1.055963000,0.0093
111.199.238.74,<->,8.182.140.228,0,0,5,962,5,962,1.054225000,0.2498
54.58.137.120,<->,48.52.117.46,0,0,5,3179,5,3179,1.052790000,0.2985
142.249.87.206,<->,136.25.188.252,0,0,5,380,5,380,1.048420000,0.0080
195.55.138.16,<->,136.25.188.175,0,0,5,877,5,877,1.046878000,0.1981
215.158.239.86,<->,199.20.4.3,5,1127,0,0,5,1127,1.043582000,0.8602
136.25.188.237,<->,118.20.87.44,5,1453,0,0,5,1453,1.042778000,0.1196
159.240.4.24,<->,8.20.87.92,0,0,5,298,5,298,1.042447000,0.1000
230.60.6.184,<->,92.181.100.74,0,0,5,446,5,446,1.042190000,0.7913
38.132.114.46,<->,8.252.222.60,0,0,5,2290,5,2290,1.039949000,0.8114
50.224.76.230,<->,8.238.181.176,5,768,0,0,5,768,1.039376000,0.4807
215.158.239.96,<->,199.20.7.194,5,328,0,0,5,328,1.036994000,0.7478
145.79.67.241,<->,8.220.178.166,0,0,5,856,5,856,1.036335000,0.0866
194.237.97.184,<->,136.25.188.253,0,0,5,950,5,950,1.035764000,0.4288
136.25.188.161,<->,112.235.95.26,5,2754,0,0,5,2754,1.033685000,0.8728
224.93.235.39,<->,80.27.157.12,0,0,5,2935,5,2935,1.032678000,0.8853
215.158.239.96,<->,199.20.28.226,5,356,0,0,5,356,1.031404000,0.0299
143.155.227.40,<->,136.25.188.161,0,0,5,1437,5,1437,1.031041000,0.6252
194.220.121.53,<->,50.224.76.230,0,0,5,1426,5,1426,1.030572000,0.9024
232.31.155.12,<->,97.198.118.56,0,0,5,632,5,632,1.030358000,0.3564
93.181.154.110,<->,92.27.27.148,0,0,5,296,5,296,1.030319000,0.2942
156.165.37.95,<->,136.25.189.28,0,0,5,2530,5,2530,1.029027000,0.7551
204.186.149.186,<->,136.25.188.220,0,0,5,280,5,280,1.026891000,0.3757
207.191.136.103,<->,136.25.188.46,0,0,5,356,5,356,1.026389000,0.0073
215.158.238.96,<->,197.125.116.102,5,2754,0,0,5,2754,1.025023000,0.8325
247.136.139.37,<->,148.43.230.154,5,255,0,0,5,255,1.024940000,0.8985
100.115.92.199,<->,41.143.115.31,5,527,0,0,5,527,1.021338000,0.2171
218.85.24.6,<->,50.224.76.234,0,0,5,1074,5,1074,1.021222000,0.5305
215.158.239.84,<->,195.83.105.170,5,950,0,0,5,950,1.020977000,0.5270
197.113.64.188,<->,136.25.188.237,0,0,5,1230,5,1230,1.018663000,0.6698
197.113.99.101,<->,136.25.188.222,0,0,5,356,5,356,1.017715000,0.0710
215.158.140.229,<->,131.22.233.146,5,3429,0,0,5,3429,1.017531000,0.8341
136.25.189.4,<->,96.156.169.227,5,5640,0,0,5,5640,1.017443000,0.0873
199.121.242.135,<->,136.25.188.177,0,0,5,299,5,299,1.016329000,0.1736
73.70.219.44,<->,8.252.222.178,0,0,5,1087,5,1087,1.016243000,0.2700
136.25.189.59,<->,69.132.194.94,5,2786,0,0,5,2786,1.015947000,0.5028
192.170.241.167,<->,99.74.27.172,0,0,5,833,5,833,1.014901000,0.0711
200.174.210.169,<->,53.200.100.60,5,295,0,0,5,295,1.011822000,0.5897
192.170.241.103,<->,8.252.222.65,0,0,5,403,5,403,1.011314000,0.0945
243.117.93.112,<->,80.38.36.175,0,0,5,1569,5,1569,1.007801000,0.1861
140.174.84.0,<->,136.25.188.224,0,0,5,1277,5,1277,1.006094000,0.2412
192.67.130.147,<->,8.20.81.7,5,466,0,0,5,466,1.005886000,0.1072
159.137.162.213,<->,112.70.222.21,5,838,0,0,5,838,0.996468000,0.4784
215.158.238.135,<->,139.160.226.230,5,1437,0,0,5,1437,0.996461000,0.1349
215.158.140.241,<->,106.188.228.23,5,2313,0,0,5,2313,0.996100000,0.9397
199.73.47.28,<->,136.25.188.176,0,0,5,356,5,356,0.992712000,0.0069
199.82.216.129,<->,136.25.188.253,0,0,5,356,5,356,0.991458000,0.0074
199.81.215.251,<->,50.224.76.235,0,0,5,1490,5,1490,0.991345000,0.6252
137.46.171.47,<->,8.53.4.241,0,0,5,881,5,881,0.988803000,0.0425
132.128.49.14,<->,35.56.97.244,0,0,5,1212,5,1212,0.986492000,0.0446
107.253.12.221,<->,8.182.251.218,0,0,5,2070,5,2070,0.984560000,0.4341
215.158.238.243,<->,97.243.113.41,5,2389,0,0,5,2389,0.983377000,0.5806
207.173.127.99,<->,136.25.188.160,0,0,5,356,5,356,0.983102000,0.0399
215.158.239.76,<->,207.213.91.147,5,356,0,0,5,356,0.982293000,0.0399
215.158.239.70,<->,196.91.85.7,5,850,0,0,5,850,0.981233000,0.2539
202.33.114.188,<->,136.25.188.220,0,0,5,1148,5,1148,0.980400000,0.2139
215.158.239.96,<->,207.212.129.86,5,459,0,0,5,459,0.980052000,0.3467
243.49.82.173,<->,97.190.208.100,0,0,5,2695,5,2695,0.979600000,0.3750
76.179.15.94,<->,8.252.222.142,0,0,5,954,5,954,0.978579000,0.4768
246.254.97.229,<->,139.33.175.151,5,3004,0,0,5,3004,0.978567000,0.0628
111.20.172.70,<->,111.20.168.156,0,0,5,681,5,681,0.977964000,1.0028
231.142.214.253,<->,215.158.239.94,0,0,5,950,5,950,0.976662000,0.4466
204.60.154.66,<->,136.25.188.198,0,0,5,356,5,356,0.976142000,0.0616
195.126.184.184,<->,136.25.188.197,0,0,5,356,5,356,0.975857000,0.0074
215.158.238.135,<->,131.215.37.53,5,1485,0,0,5,1485,0.975793000,0.2921
199.80.156.77,<->,136.25.188.174,0,0,5,799,5,799,0.974444000,0.5332
215.158.239.93,<->,204.226.46.90,5,356,0,0,5,356,0.973582000,0.0045
220.85.11.250,<->,50.224.76.234,0,0,5,911,5,911,0.973199000,0.1118
143.29.161.66,<->,50.224.76.230,0,0,5,287,5,287,0.972897000,0.1627
215.158.61.191,<->,8.176.8.217,0,0,5,6413,5,6413,0.971909000,0.0000
149.170.238.93,<->,0.195.210.42,0,0,5,812,5,812,0.970038000,0.2930
133.178.227.16,<->,133.56.180.32,5,3138,0,0,5,3138,0.968269000,0.5146
136.25.188.252,<->,56.161.218.62,5,1581,0,0,5,1581,0.966798000,0.0374
215.158.238.114,<->,122.159.245.164,5,1465,0,0,5,1465,0.966195000,0.3208
215.158.238.73,<->,122.158.51.55,5,2850,0,0,5,2850,0.964536000,0.5503
133.32.1.140,<->,115.121.228.207,5,482,0,0,5,482,0.964374000,0.7893
136.25.188.236,<->,80.47.228.213,5,1469,0,0,5,1469,0.963821000,0.1615
92.175.125.222,<->,8.52.189.207,0,0,5,812,5,812,0.963640000,0.1339
202.33.243.69,<->,136.25.188.252,0,0,5,356,5,356,0.963195000,0.0598
92.27.219.143,<->,33.57.78.119,5,256,0,0,5,256,0.963110000,0.5083
215.158.140.185,<->,144.252.156.92,5,1022,0,0,5,1022,0.961791000,0.0432
204.61.36.1,<->,136.25.188.220,0,0,5,356,5,356,0.961474000,0.0091
215.158.239.77,<->,116.106.46.55,5,2651,0,0,5,2651,0.960511000,0.5661
215.158.239.95,<->,56.20.41.3,5,1677,0,0,5,1677,0.959543000,0.0286
203.114.18.211,<->,0.195.210.44,0,0,5,428,5,428,0.958685000,0.3099
199.68.67.230,<->,136.25.188.208,0,0,5,479,5,479,0.958564000,0.4511
206.241.176.49,<->,8.252.222.237,0,0,5,280,5,280,0.956463000,0.8714
199.69.29.140,<->,136.25.188.55,0,0,5,921,5,921,0.955094000,0.5975
215.158.239.99,<->,195.83.168.95,5,1120,0,0,5,1120,0.954884000,0.7103
142.206.25.54,<->,136.25.188.163,0,0,5,340,5,340,0.954036000,0.0665
215.158.238.100,<->,145.116.209.83,5,1188,0,0,5,1188,0.951595000,0.1742
80.27.109.237,<->,8.252.223.213,0,0,5,1781,5,1781,0.951302000,0.2136
116.169.20.76,<->,100.228.42.160,0,0,5,1927,5,1927,0.950005000,0.5979
215.158.239.48,<->,199.20.100.95,5,856,0,0,5,856,0.949027000,0.3133
215.158.239.50,<->,204.0.138.156,5,292,0,0,5,292,0.948795000,0.0605
195.4.91.153,<->,136.25.188.222,0,0,5,350,5,350,0.947582000,0.8420
210.218.99.216,<->,56.120.235.2,5,795,0,0,5,795,0.945568000,0.0873
109.207.237.37,<->,50.224.76.235,0,0,5,1083,5,1083,0.945132000,0.1813
199.73.206.67,<->,136.25.188.254,0,0,5,356,5,356,0.945127000,0.0077
143.44.128.90,<->,136.25.188.53,0,0,5,812,5,812,0.945024000,0.5494
200.179.137.220,<->,8.252.222.208,0,0,5,577,5,577,0.944590000,0.2938
195.124.209.136,<->,136.25.188.253,0,0,5,373,5,373,0.943600000,0.5202
215.158.238.107,<->,143.155.227.54,5,1341,0,0,5,1341,0.942531000,0.1854
109.222.211.206,<->,53.148.173.60,5,504,0,0,5,504,0.940791000,0.7456
133.178.226.111,<->,133.56.180.87,5,1478,0,0,5,1478,0.940289000,0.0282
133.178.227.247,<->,99.74.26.149,5,299,0,0,5,299,0.939910000,0.0309
195.107.225.155,<->,50.224.76.234,0,0,5,1402,5,1402,0.939680000,0.4864
156.165.37.92,<->,136.25.189.34,0,0,5,3170,5,3170,0.939173000,0.5232
133.178.226.19,<->,122.158.179.41,5,1309,0,0,5,1309,0.937742000,0.2712
195.4.91.61,<->,136.25.188.197,0,0,5,856,5,856,0.936868000,0.5258
195.13.84.248,<->,136.25.188.238,0,0,5,475,5,475,0.933203000,0.3725
215.158.239.48,<->,196.108.6.92,5,280,0,0,5,280,0.932919000,1.0009
136.25.188.225,<->,8.220.51.228,5,1533,0,0,5,1533,0.931312000,0.3091
220.39.233.38,<->,215.158.238.142,0,0,5,1373,5,1373,0.931301000,0.2520
206.51.47.69,<->,192.64.217.166,0,0,5,318,5,318,0.930321000,0.3833
204.188.51.36,<->,92.27.194.147,0,0,5,290,5,290,0.930218000,0.5398
204.1.252.23,<->,136.25.188.55,0,0,5,356,5,356,0.929308000,0.0076
246.254.97.113,<->,158.19.152.114,5,738,0,0,5,738,0.928199000,0.2120
251.21.231.243,<->,109.222.230.50,0,0,5,3614,5,3614,0.927070000,0.0591
142.207.110.80,<->,136.25.188.239,0,0,5,250,5,250,0.924364000,0.1431
215.158.239.97,<->,199.20.6.211,5,292,0,0,5,292,0.922933000,0.7824
139.163.96.101,<->,131.94.166.50,5,467,0,0,5,467,0.921626000,1.0442
215.158.61.202,<->,8.176.8.178,0,0,5,6589,5,6589,0.921512000,0.0001
142.207.19.147,<->,136.25.188.252,0,0,5,356,5,356,0.921159000,0.0088
220.20.200.28,<->,119.159.22.233,5,551,0,0,5,551,0.920590000,0.1917
201.192.55.103,<->,80.38.21.161,0,0,5,485,5,485,0.918922000,0.3321
104.246.207.98,<->,50.224.76.234,0,0,5,1643,5,1643,0.918411000,0.3589
215.158.239.48,<->,199.20.28.7,5,356,0,0,5,356,0.916760000,0.0801
215.158.140.229,<->,29.214.211.22,5,2308,0,0,5,2308,0.916096000,1.0049
231.142.234.72,<->,136.25.188.177,0,0,5,356,5,356,0.916011000,0.0076
134.21.177.68,<->,50.224.76.234,0,0,5,3392,5,3392,0.915649000,0.7769
143.129.188.152,<->,136.25.188.177,0,0,5,356,5,356,0.915425000,0.0081
50.224.76.230,<->,18.201.229.119,5,1057,0,0,5,1057,0.915207000,0.5066
136.25.189.12,<->,120.154.131.7,5,2959,0,0,5,2959,0.915040000,0.4355
195.13.84.248,<->,136.25.188.222,0,0,5,475,5,475,0.914628000,0.3540
99.115.52.80,<->,8.220.190.86,0,0,5,756,5,756,0.913272000,0.2861
215.158.239.93,<->,199.20.29.75,5,356,0,0,5,356,0.912451000,0.0300
199.12.122.204,<->,8.252.222.162,0,0,5,356,5,356,0.911713000,0.0003
50.224.76.235,<->,48.130.162.38,5,2097,0,0,5,2097,0.911710000,0.4589
243.49.83.90,<->,129.92.112.143,0,0,5,2694,5,2694,0.910845000,0.3590
223.120.101.156,<->,8.252.222.162,0,0,5,365,5,365,0.910396000,0.0018
215.158.61.145,<->,8.176.8.199,0,0,5,3382,5,3382,0.910361000,0.9943
136.25.189.83,<->,6.15.207.118,5,2718,0,0,5,2718,0.910074000,0.8539
215.158.238.123,<->,205.228.230.88,5,2850,0,0,5,2850,0.907760000,1.0465
204.184.8.254,<->,136.25.188.198,0,0,5,340,5,340,0.907313000,0.1397
215.158.238.32,<->,111.150.34.250,5,1405,0,0,5,1405,0.905277000,0.1795
215.158.61.191,<->,8.176.8.224,0,0,5,6477,5,6477,0.902984000,0.0000
142.236.26.46,<->,136.25.188.197,0,0,5,356,5,356,0.900692000,0.0152
215.158.239.97,<->,195.49.106.73,5,826,0,0,5,826,0.900623000,0.7004
207.206.9.47,<->,50.224.76.235,0,0,5,1626,5,1626,0.900437000,0.3119
136.126.235.34,<->,8.220.198.131,0,0,5,2616,5,2616,0.899539000,0.0851
104.230.210.45,<->,50.224.76.234,0,0,5,1232,5,1232,0.897621000,0.4832
42.230.95.115,<->,39.248.89.73,0,0,5,317,5,317,0.896944000,0.0000
133.178.226.30,<->,128.110.138.182,5,1293,0,0,5,1293,0.896353000,0.9693
100.92.103.47,<->,38.17.171.70,5,869,0,0,5,869,0.896077000,0.9995
222.110.172.72,<->,215.158.140.87,0,0,5,250,5,250,0.895845000,0.1136
215.158.239.79,<->,142.221.177.85,5,356,0,0,5,356,0.893698000,0.0089
133.178.227.247,<->,6.116.13.166,5,2658,0,0,5,2658,0.893591000,0.1307
139.163.34.116,<->,80.56.72.24,5,250,0,0,5,250,0.892396000,0.6759
215.158.238.95,<->,136.139.59.106,5,1533,0,0,5,1533,0.891396000,0.2536
50.224.76.230,<->,6.4.63.97,5,1104,0,0,5,1104,0.889442000,0.2539
213.186.52.50,<->,144.85.170.254,0,0,5,961,5,961,0.889336000,0.0765
80.40.12.180,<->,33.78.85.2,5,277,0,0,5,277,0.889104000,0.1256
192.204.123.61,<->,136.25.189.90,0,0,5,4055,5,4055,0.888665000,1.0560
215.158.239.99,<->,199.20.29.175,5,641,0,0,5,641,0.887818000,1.0503
207.173.126.140,<->,136.25.188.210,0,0,5,950,5,950,0.886762000,0.7700
215.158.103.203,<->,131.74.153.132,5,680,0,0,5,680,0.885595000,0.3918
207.172.177.220,<->,136.25.188.176,0,0,5,280,5,280,0.885078000,0.6814
144.83.60.153,<->,92.162.253.141,0,0,5,5540,5,5540,0.883513000,0.3137
159.42.43.78,<->,35.56.101.235,0,0,5,676,5,676,0.883327000,0.6536
94.185.224.29,<->,8.252.222.174,0,0,5,438,5,438,0.882325000,0.6649
215.158.238.135,<->,8.252.214.133,5,2402,0,0,5,2402,0.881040000,0.5737
212.164.132.228,<->,149.239.15.210,5,3420,0,0,5,3420,0.880054000,0.4298
133.178.227.40,<->,131.144.116.233,5,2353,0,0,5,2353,0.879641000,0.6511
193.122.170.40,<->,133.54.17.135,0,0,5,5122,5,5122,0.879640000,0.9091
145.176.8.235,<->,6.74.197.79,0,0,5,515,5,515,0.879426000,0.0894
133.178.226.30,<->,128.23.84.245,5,2626,0,0,5,2626,0.876284000,1.0469
143.72.73.116,<->,136.25.188.52,0,0,5,356,5,356,0.874966000,0.0237
136.25.188.161,<->,29.213.218.232,5,1389,0,0,5,1389,0.872263000,0.1232
133.172.83.44,<->,8.220.176.253,0,0,5,531,5,531,0.872070000,0.1450
114.182.24.196,<->,50.224.89.241,0,0,5,1462,5,1462,0.870991000,0.6318
215.158.239.50,<->,61.35.124.182,5,1433,0,0,5,1433,0.870313000,0.4885
215.158.238.251,<->,155.197.206.245,5,1280,0,0,5,1280,0.870177000,0.4317
133.178.226.37,<->,122.158.49.131,5,1981,0,0,5,1981,0.867986000,0.2233
204.34.141.202,<->,50.224.76.234,0,0,5,1001,5,1001,0.867510000,0.3042
143.76.172.61,<->,8.182.224.248,0,0,5,697,5,697,0.865213000,0.6242
69.128.115.205,<->,54.36.191.119,5,955,0,0,5,955,0.864773000,0.9893
199.71.109.250,<->,136.25.188.238,0,0,5,292,5,292,0.863302000,1.1355
207.172.243.208,<->,136.25.188.174,0,0,5,352,5,352,0.862851000,1.1000
215.158.239.85,<->,199.20.29.247,5,280,0,0,5,280,0.862147000,0.0000
215.158.239.56,<->,196.94.161.188,5,1793,0,0,5,1793,0.861953000,1.1016
196.146.24.52,<->,97.243.220.36,5,1605,0,0,5,1605,0.860770000,0.2535
95.244.98.18,<->,8.252.222.134,0,0,5,262,5,262,0.859875000,0.1900
195.85.180.83,<->,8.182.229.19,0,0,5,468,5,468,0.859586000,0.4650
111.89.77.172,<->,109.222.241.62,0,0,5,276,5,276,0.859338000,0.0714
195.5.10.118,<->,136.25.188.52,0,0,5,856,5,856,0.858100000,0.4193
84.200.127.223,<->,6.95.3.106,0,0,5,682,5,682,0.856550000,0.6200
215.158.238.243,<->,131.219.110.137,5,1597,0,0,5,1597,0.855928000,0.3345
195.70.125.179,<->,136.25.188.162,0,0,5,517,5,517,0.855744000,0.7537
231.142.35.166,<->,136.25.188.255,0,0,5,356,5,356,0.854153000,0.0133
142.228.78.231,<->,136.25.188.208,0,0,5,1077,5,1077,0.852991000,0.5033
199.47.38.45,<->,8.20.87.153,0,0,5,256,5,256,0.852530000,1.0267
215.158.239.95,<->,199.20.5.71,5,256,0,0,5,256,0.850507000,0.0793
215.158.239.94,<->,204.226.50.127,5,1817,0,0,5,1817,0.850060000,0.9897
215.158.239.34,<->,8.252.214.212,5,1965,0,0,5,1965,0.849712000,0.0789
220.38.84.245,<->,136.25.189.15,0,0,5,2814,5,2814,0.848812000,0.6745
215.158.239.48,<->,199.20.31.118,5,356,0,0,5,356,0.847683000,0.0107
215.158.239.93,<->,196.109.3.213,5,340,0,0,5,340,0.845841000,0.4596
235.253.220.227,<->,215.158.238.54,0,0,5,1645,5,1645,0.843945000,0.1803
136.129.94.157,<->,111.199.227.15,5,648,0,0,5,648,0.843934000,0.3079
125.42.173.70,<->,109.1.54.101,0,0,5,1208,5,1208,0.843715000,0.2996
215.158.239.95,<->,196.92.207.94,5,396,0,0,5,396,0.842323000,1.0007
57.17.145.133,<->,50.224.76.234,0,0,5,1385,5,1385,0.840931000,0.4340
215.158.238.149,<->,38.104.11.118,5,1453,0,0,5,1453,0.840827000,0.2459
215.158.239.79,<->,199.20.30.172,5,426,0,0,5,426,0.839928000,0.0001
215.158.238.58,<->,72.23.148.245,5,2802,0,0,5,2802,0.839816000,1.1414
196.240.242.55,<->,136.25.188.238,0,0,5,487,5,487,0.838818000,0.6990
215.158.239.110,<->,215.158.61.191,5,6174,0,0,5,6174,0.837907000,1.1405
136.25.188.175,<->,57.160.181.198,5,4245,0,0,5,4245,0.837560000,1.0297
89.183.104.188,<->,78.45.228.179,5,276,0,0,5,276,0.837097000,0.7573
215.158.239.94,<->,8.222.98.114,5,2754,0,0,5,2754,0.834030000,0.3800
207.173.241.126,<->,136.25.188.199,0,0,5,356,5,356,0.833383000,0.0078
142.249.90.133,<->,136.25.188.210,0,0,5,356,5,356,0.832727000,0.0511
215.158.239.96,<->,195.83.231.12,5,472,0,0,5,472,0.832605000,0.8422
235.42.35.86,<->,133.178.226.28,0,0,5,1293,5,1293,0.832436000,0.1271
36.123.54.248,<->,8.20.87.10,0,0,5,329,5,329,0.831584000,0.4255
111.151.106.200,<->,97.126.31.84,0,0,5,280,5,280,0.829214000,0.0362
144.87.238.89,<->,8.182.251.151,0,0,5,772,5,772,0.824439000,0.0574
215.158.238.198,<->,69.132.46.135,5,1629,0,0,5,1629,0.822156000,0.3701
215.158.239.40,<->,131.95.192.176,5,1763,0,0,5,1763,0.821931000,0.1313
215.158.239.79,<->,199.20.6.144,5,299,0,0,5,299,0.821347000,0.2790
136.25.189.83,<->,120.154.71.75,5,2770,0,0,5,2770,0.820458000,0.5043
215.158.239.92,<->,8.33.226.52,5,3943,0,0,5,3943,0.820117000,1.1399
157.127.235.73,<->,8.252.221.236,0,0,5,1054,5,1054,0.819931000,1.1015
215.158.140.229,<->,149.163.129.250,5,2259,0,0,5,2259,0.819477000,0.7058
214.85.127.177,<->,50.224.76.235,0,0,5,1204,5,1204,0.819117000,0.3350
215.158.238.47,<->,193.10.94.25,5,1437,0,0,5,1437,0.819029000,0.1638
133.178.227.79,<->,113.143.223.138,5,1269,0,0,5,1269,0.818847000,0.1413
207.100.224.146,<->,0.195.210.44,0,0,5,1644,5,1644,0.818770000,1.1698
215.158.238.223,<->,123.166.46.247,5,2353,0,0,5,2353,0.816437000,1.0481
215.158.239.35,<->,215.158.42.117,5,1159,0,0,5,1159,0.814686000,0.0279
215.158.239.7,<->,106.188.184.106,5,3460,0,0,5,3460,0.814447000,1.0251
215.158.61.193,<->,8.176.8.238,0,0,5,6189,5,6189,0.813550000,0.0000
109.222.231.242,<->,54.51.151.171,5,473,0,0,5,473,0.812456000,0.0898
215.158.239.77,<->,199.72.84.48,5,3435,0,0,5,3435,0.811095000,0.4237
215.158.239.68,<->,195.80.101.217,5,356,0,0,5,356,0.811061000,0.0075
215.158.238.198,<->,113.23.7.195,5,1485,0,0,5,1485,0.809214000,0.3627
215.158.58.252,<->,6.73.247.85,0,0,5,4582,5,4582,0.808660000,0.6581
192.64.228.59,<->,130.238.51.137,5,420,0,0,5,420,0.808044000,0.0636
80.41.4.166,<->,42.104.166.11,5,392,0,0,5,392,0.807883000,0.9749
207.58.89.106,<->,136.25.188.241,0,0,5,808,5,808,0.805675000,0.4674
139.160.226.167,<->,136.25.189.31,0,0,5,2850,5,2850,0.802200000,0.8086
204.63.63.37,<->,136.25.188.54,0,0,5,954,5,954,0.801274000,1.1762
99.187.125.121,<->,8.20.87.11,0,0,5,742,5,742,0.799987000,0.0631
195.14.84.154,<->,136.25.188.55,0,0,5,925,5,925,0.798807000,0.2121
215.158.239.68,<->,207.191.245.10,5,356,0,0,5,356,0.797641000,0.0041
111.199.224.133,<->,0.195.210.44,0,0,5,556,5,556,0.796107000,0.1040
215.158.239.59,<->,204.2.143.155,5,1149,0,0,5,1149,0.795795000,0.5306
109.113.92.170,<->,8.182.227.240,0,0,5,3230,5,3230,0.795456000,0.0975
100.228.42.102,<->,17.43.174.250,5,3917,0,0,5,3917,0.795319000,0.1364
215.158.140.184,<->,38.81.154.202,5,431,0,0,5,431,0.794493000,0.8887
196.89.233.128,<->,136.25.188.236,0,0,5,954,5,954,0.794219000,0.9661
207.191.177.179,<->,136.25.188.160,0,0,5,280,5,280,0.793609000,0.0069
215.158.239.95,<->,194.199.215.226,5,356,0,0,5,356,0.793285000,0.0105
199.68.67.230,<->,136.25.188.222,0,0,5,479,5,479,0.790757000,0.4269
50.224.76.248,<->,42.34.255.152,5,2445,0,0,5,2445,0.788996000,0.2207
136.25.188.255,<->,112.220.206.18,5,1581,0,0,5,1581,0.788199000,0.4626
215.158.238.135,<->,143.155.227.40,5,1517,0,0,5,1517,0.788125000,0.3449
207.58.86.149,<->,136.25.188.52,0,0,5,1127,5,1127,0.787867000,0.4555
98.236.90.61,<->,54.43.51.222,5,363,0,0,5,363,0.786041000,0.0707
215.158.140.229,<->,33.209.217.45,5,2572,0,0,5,2572,0.784662000,0.9657
140.8.232.203,<->,0.195.210.42,0,0,5,356,5,356,0.784174000,0.0865
223.120.101.156,<->,8.252.222.47,0,0,5,365,5,365,0.783256000,0.0041
215.158.61.182,<->,8.176.8.248,0,0,5,6077,5,6077,0.782269000,0.0000
136.25.188.240,<->,30.73.219.65,5,989,0,0,5,989,0.780145000,0.5458
215.158.238.99,<->,29.211.186.197,5,2754,0,0,5,2754,0.778572000,0.1946
142.166.50.219,<->,136.25.188.253,0,0,5,1130,5,1130,0.778422000,0.3297
215.158.140.80,<->,96.156.169.112,5,295,0,0,5,295,0.776102000,0.0407
142.221.144.87,<->,136.25.188.241,0,0,5,356,5,356,0.775896000,0.0236
195.6.242.167,<->,136.25.188.174,0,0,5,250,5,250,0.774359000,0.2942
215.158.239.114,<->,215.158.61.242,5,6189,0,0,5,6189,0.774253000,0.0000
137.47.48.124,<->,97.126.123.108,0,0,5,747,5,747,0.774151000,0.1711
124.126.184.193,<->,100.228.42.160,0,0,5,2162,5,2162,0.773653000,0.6549
215.158.238.133,<->,140.190.33.180,5,1581,0,0,5,1581,0.773556000,0.3474
133.178.227.29,<->,133.56.180.35,5,2385,0,0,5,2385,0.773506000,1.2101
204.185.182.150,<->,136.25.188.174,0,0,5,350,5,350,0.773217000,0.0820
215.110.27.82,<->,8.220.190.86,0,0,5,802,5,802,0.773112000,0.4848
220.28.108.254,<->,136.25.189.8,0,0,5,481,5,481,0.772144000,0.5607
215.158.238.236,<->,29.214.109.164,5,1613,0,0,5,1613,0.772135000,0.3623
218.38.100.178,<->,8.182.226.78,0,0,5,595,5,595,0.772057000,0.4980
215.158.239.76,<->,195.40.116.61,5,356,0,0,5,356,0.770220000,0.0133
215.158.238.72,<->,57.210.107.19,5,1309,0,0,5,1309,0.769896000,0.2517
50.223.3.228,<->,35.55.6.121,5,471,0,0,5,471,0.769189000,0.0470
144.87.238.89,<->,8.182.239.140,0,0,5,667,5,667,0.768570000,0.0643
205.127.108.115,<->,33.233.141.69,0,0,5,519,5,519,0.768357000,0.3764
215.158.238.106,<->,143.155.227.33,5,496,0,0,5,496,0.767893000,0.4361
215.158.239.94,<->,195.4.182.232,5,950,0,0,5,950,0.767562000,0.5522
215.158.239.69,<->,195.55.147.233,5,950,0,0,5,950,0.767006000,0.3166
80.40.55.49,<->,54.44.113.39,5,2302,0,0,5,2302,0.766807000,0.8123
145.116.118.225,<->,53.181.140.67,5,858,0,0,5,858,0.766511000,0.2708
192.204.123.117,<->,136.25.188.237,0,0,5,1325,5,1325,0.765788000,0.4880
215.158.239.57,<->,195.81.120.214,5,356,0,0,5,356,0.762831000,0.0399
215.158.239.59,<->,199.20.30.147,5,293,0,0,5,293,0.760639000,0.9996
133.178.226.19,<->,104.3.168.217,5,2882,0,0,5,2882,0.760287000,0.8676
193.64.253.32,<->,109.222.192.144,0,0,5,5405,5,5405,0.759795000,0.1415
215.158.238.148,<->,137.199.206.4,5,1465,0,0,5,1465,0.759076000,0.2670
215.158.239.97,<->,199.20.30.244,5,299,0,0,5,299,0.758688000,0.2541
210.158.44.191,<->,102.45.233.201,5,385,0,0,5,385,0.756945000,0.0513
215.158.140.92,<->,8.219.184.95,5,2703,0,0,5,2703,0.755021000,1.0196
197.113.99.232,<->,136.25.188.255,0,0,5,1131,5,1131,0.754207000,0.7298
215.158.239.48,<->,196.106.249.180,5,1147,0,0,5,1147,0.753698000,0.3796
215.158.239.95,<->,194.251.130.243,5,836,0,0,5,836,0.752400000,0.3575
215.158.238.133,<->,119.196.23.54,5,2850,0,0,5,2850,0.750032000,1.1236
143.20.132.182,<->,136.25.188.44,0,0,5,936,5,936,0.749727000,0.7147
213.186.59.155,<->,144.85.170.254,0,0,5,1029,5,1029,0.749105000,0.1317
204.200.50.182,<->,136.25.188.243,0,0,5,856,5,856,0.746199000,0.6161
196.246.151.187,<->,136.25.188.173,0,0,5,954,5,954,0.745514000,1.0084
136.25.189.15,<->,106.188.253.229,5,4087,0,0,5,4087,0.744740000,1.0300
215.158.239.48,<->,207.228.187.17,5,1025,0,0,5,1025,0.744054000,0.7699
215.158.239.50,<->,196.90.18.111,5,304,0,0,5,304,0.741500000,0.0006
109.1.21.151,<->,8.45.175.31,5,300,0,0,5,300,0.741424000,0.0607
215.158.238.238,<->,126.219.100.211,5,1308,0,0,5,1308,0.741194000,0.3544
204.60.65.201,<->,136.25.188.174,0,0,5,352,5,352,0.740331000,1.1610
215.158.239.49,<->,120.154.131.23,5,3783,0,0,5,3783,0.739983000,1.1951
210.209.251.211,<->,111.147.85.3,0,0,5,642,5,642,0.739743000,0.1361
215.158.239.78,<->,196.89.91.240,5,1456,0,0,5,1456,0.739687000,1.2455
50.224.76.230,<->,0.246.227.151,5,1459,0,0,5,1459,0.739625000,0.8810
136.25.189.80,<->,114.146.74.248,5,2786,0,0,5,2786,0.739510000,0.9255
143.132.244.132,<->,136.25.188.177,0,0,5,356,5,356,0.739140000,0.0074
197.113.64.190,<->,136.25.188.46,0,0,5,280,5,280,0.736712000,0.0009
125.5.234.225,<->,80.40.61.86,0,0,5,7280,5,7280,0.736508000,1.2615
207.236.26.254,<->,136.25.188.225,0,0,5,856,5,856,0.733648000,0.3518
199.51.154.75,<->,136.25.188.225,0,0,5,356,5,356,0.732576000,0.0079
215.158.238.81,<->,6.73.9.181,5,1453,0,0,5,1453,0.732341000,0.1068
136.25.189.2,<->,29.212.199.233,5,2722,0,0,5,2722,0.730335000,0.7885
199.73.103.114,<->,136.25.188.238,0,0,5,500,5,500,0.730205000,0.7870
215.158.239.48,<->,195.49.133.73,5,1017,0,0,5,1017,0.729117000,0.7695
215.158.239.95,<->,199.20.29.8,5,356,0,0,5,356,0.727967000,0.0194
142.208.56.155,<->,136.25.188.253,0,0,5,356,5,356,0.727029000,0.0091
195.78.220.158,<->,50.224.76.235,0,0,5,1188,5,1188,0.726305000,0.3604
220.50.215.93,<->,89.216.125.215,0,0,5,444,5,444,0.726203000,0.0913
232.31.192.215,<->,97.198.118.56,0,0,5,630,5,630,0.725253000,0.3569
249.101.82.5,<->,139.33.174.178,5,2922,0,0,5,2922,0.723159000,0.1371
215.158.238.223,<->,192.170.245.6,5,1274,0,0,5,1274,0.722534000,0.0789
207.58.76.191,<->,136.25.188.254,0,0,5,909,5,909,0.722127000,0.3313
142.190.51.173,<->,136.25.188.236,0,0,5,256,5,256,0.721807000,0.2900
215.158.239.96,<->,204.1.166.183,5,1005,0,0,5,1005,0.721717000,0.3201
204.63.45.244,<->,136.25.188.253,0,0,5,344,5,344,0.720893000,1.2099
207.63.164.43,<->,136.25.188.52,0,0,5,1205,5,1205,0.719555000,0.9198
133.178.226.77,<->,96.155.60.244,5,1908,0,0,5,1908,0.719048000,0.0656
202.33.56.85,<->,136.25.188.226,0,0,5,954,5,954,0.717795000,0.5186
109.1.9.162,<->,106.5.211.9,5,355,0,0,5,355,0.717409000,0.1880
132.249.70.183,<->,53.94.69.91,5,463,0,0,5,463,0.717167000,0.0469
120.123.160.244,<->,50.224.76.235,0,0,5,1497,5,1497,0.715192000,0.4156
215.158.61.182,<->,8.176.8.207,0,0,5,6429,5,6429,0.714105000,0.0000
17.42.29.117,<->,8.220.181.167,0,0,5,2297,5,2297,0.713010000,0.2530
142.227.103.149,<->,136.25.188.255,0,0,5,356,5,356,0.708753000,0.0118
215.158.239.86,<->,125.84.55.22,5,2738,0,0,5,2738,0.708247000,0.8130
215.158.239.101,<->,129.222.36.87,5,1180,0,0,5,1180,0.708019000,1.0443
80.41.196.234,<->,8.55.224.156,5,377,0,0,5,377,0.707794000,0.0350
215.158.239.87,<->,68.124.221.168,5,2738,0,0,5,2738,0.706357000,0.9462
142.252.114.229,<->,136.25.188.253,0,0,5,356,5,356,0.706148000,0.0124
215.158.239.97,<->,199.20.31.155,5,954,0,0,5,954,0.704805000,1.2327
215.158.239.77,<->,196.105.81.64,5,950,0,0,5,950,0.703587000,0.7400
97.21.115.188,<->,8.220.191.152,0,0,5,1460,5,1460,0.700516000,0.1238
215.158.239.56,<->,194.203.63.134,5,1101,0,0,5,1101,0.700509000,0.2499
136.25.188.46,<->,84.241.240.150,5,429,0,0,5,429,0.700169000,0.4239
207.57.93.217,<->,136.25.188.53,0,0,5,954,5,954,0.700035000,0.4228
204.62.94.45,<->,136.25.188.163,0,0,5,368,5,368,0.699758000,0.3946
255.133.225.112,<->,255.133.225.23,0,0,5,574,5,574,0.699383000,0.9546
143.20.116.126,<->,136.25.188.225,0,0,5,356,5,356,0.697978000,0.0074
143.20.116.126,<->,136.25.188.163,0,0,5,356,5,356,0.697811000,0.0081
159.137.162.213,<->,117.26.161.140,5,832,0,0,5,832,0.696585000,0.7981
136.25.188.177,<->,30.73.135.115,5,299,0,0,5,299,0.695568000,0.6101
204.21.246.104,<->,136.25.188.220,0,0,5,522,5,522,0.693234000,0.7904
126.159.11.10,<->,50.224.76.230,0,0,5,1247,5,1247,0.692784000,0.6189
215.158.238.243,<->,149.250.115.39,5,1405,0,0,5,1405,0.692154000,0.1676
215.158.239.79,<->,196.107.33.2,5,292,0,0,5,292,0.692107000,0.9182
144.90.91.85,<->,92.27.219.163,0,0,5,2936,5,2936,0.691769000,0.1499
199.39.87.91,<->,136.25.188.242,0,0,5,356,5,356,0.691478000,0.0077
215.158.239.58,<->,199.20.28.114,5,342,0,0,5,342,0.690494000,0.2580
58.202.212.54,<->,50.224.76.234,0,0,5,2366,5,2366,0.690305000,0.3664
215.158.238.120,<->,120.154.221.254,5,2674,0,0,5,2674,0.690297000,0.8649
215.158.239.92,<->,207.213.95.31,5,954,0,0,5,954,0.689768000,0.5037
204.35.170.185,<->,50.224.76.230,0,0,5,1127,5,1127,0.689677000,0.3720
215.158.238.104,<->,118.20.87.65,5,1437,0,0,5,1437,0.688900000,0.3076
215.158.239.124,<->,69.31.238.17,5,3336,0,0,5,3336,0.688377000,0.8822
198.206.82.208,<->,111.147.191.15,0,0,5,784,5,784,0.688281000,0.3130
202.33.19.155,<->,136.25.188.236,0,0,5,299,5,299,0.687214000,0.4686
136.25.189.81,<->,61.35.124.194,5,2882,0,0,5,2882,0.687189000,1.2123
220.55.123.87,<->,126.198.67.220,5,492,0,0,5,492,0.686341000,0.2319
196.246.151.187,<->,136.25.188.197,0,0,5,1047,5,1047,0.685761000,0.5223
195.14.253.74,<->,136.25.188.197,0,0,5,950,5,950,0.684447000,0.3929
215.158.238.80,<->,57.210.107.16,5,1533,0,0,5,1533,0.683758000,0.2461
109.222.238.4,<->,8.235.28.201,5,2660,0,0,5,2660,0.683501000,1.0120
142.206.71.150,<->,136.25.188.252,0,0,5,316,5,316,0.681959000,0.0323
215.158.239.96,<->,196.108.241.203,5,950,0,0,5,950,0.681547000,1.2611
142.190.236.212,<->,136.25.188.227,0,0,5,950,5,950,0.681376000,0.5571
159.109.250.48,<->,106.5.211.4,5,355,0,0,5,355,0.680391000,0.1452
215.158.238.92,<->,143.155.227.58,5,1549,0,0,5,1549,0.679692000,0.1861
204.200.61.70,<->,136.25.188.53,0,0,5,1136,5,1136,0.677056000,1.3067
215.158.239.92,<->,29.209.59.215,5,2754,0,0,5,2754,0.674998000,0.9922
232.31.149.177,<->,132.249.70.169,0,0,5,292,5,292,0.674469000,0.2241
204.61.24.8,<->,136.25.188.175,0,0,5,356,5,356,0.674370000,0.0091
215.158.239.92,<->,194.199.212.1,5,368,0,0,5,368,0.673936000,0.1155
215.158.238.190,<->,112.93.136.123,5,1565,0,0,5,1565,0.669355000,0.1684
136.25.189.15,<->,126.219.60.192,5,1565,0,0,5,1565,0.667554000,0.2359
92.27.27.162,<->,32.215.241.105,5,508,0,0,5,508,0.666286000,0.0120
99.72.115.232,<->,8.55.211.213,5,534,0,0,5,534,0.663875000,0.2717
207.57.197.191,<->,136.25.188.160,0,0,5,356,5,356,0.663599000,0.0146
215.158.239.86,<->,196.88.109.62,5,1405,0,0,5,1405,0.663510000,0.5204
207.58.223.94,<->,136.25.188.227,0,0,5,447,5,447,0.662675000,0.1412
215.158.239.50,<->,199.20.30.27,5,262,0,0,5,262,0.662456000,1.2291
99.187.125.121,<->,8.20.87.6,0,0,5,742,5,742,0.661194000,0.0557
246.253.198.51,<->,113.56.138.242,5,2243,0,0,5,2243,0.661064000,0.4468
136.181.50.197,<->,106.176.67.97,5,318,0,0,5,318,0.661010000,0.3953
136.25.188.239,<->,98.195.175.99,5,365,0,0,5,365,0.660681000,0.0021
197.113.99.238,<->,136.25.188.241,0,0,5,356,5,356,0.660039000,0.0500
192.204.170.215,<->,136.25.188.252,0,0,5,1449,5,1449,0.658136000,0.5366
210.221.107.50,<->,8.37.103.65,5,1015,0,0,5,1015,0.657932000,0.8277
143.155.226.123,<->,136.25.188.45,0,0,5,1577,5,1577,0.656701000,0.3012
136.25.189.37,<->,96.156.169.209,5,4186,0,0,5,4186,0.655284000,0.1092
204.184.108.215,<->,136.25.188.253,0,0,5,901,5,901,0.655232000,0.6996
215.158.239.92,<->,199.20.6.199,5,999,0,0,5,999,0.654046000,0.9392
202.33.40.76,<->,136.25.188.220,0,0,5,954,5,954,0.653207000,0.4509
215.158.239.92,<->,195.55.185.12,5,602,0,0,5,602,0.652343000,1.1516
136.25.188.174,<->,8.42.43.36,5,1581,0,0,5,1581,0.650662000,1.1178
207.163.164.201,<->,50.224.76.234,0,0,5,978,5,978,0.649129000,1.3311
215.158.239.92,<->,142.229.173.174,5,356,0,0,5,356,0.648623000,0.0123
142.236.163.250,<->,136.25.188.175,0,0,5,350,5,350,0.648008000,0.0079
195.124.107.127,<->,136.25.188.238,0,0,5,356,5,356,0.647171000,0.0601
143.135.193.209,<->,136.25.188.238,0,0,5,356,5,356,0.647106000,0.0185
204.184.1.23,<->,136.25.188.46,0,0,5,396,5,396,0.646930000,0.7370
215.158.239.85,<->,199.20.28.71,5,1134,0,0,5,1134,0.646659000,0.5101
139.193.141.139,<->,112.7.47.88,5,3590,0,0,5,3590,0.645968000,0.5170
136.25.189.59,<->,38.104.11.17,5,2962,0,0,5,2962,0.645643000,1.2947
126.198.76.241,<->,97.198.118.56,0,0,5,591,5,591,0.642924000,0.3564
215.158.103.203,<->,53.73.20.119,5,440,0,0,5,440,0.642808000,0.2931
131.191.242.144,<->,50.224.76.235,0,0,5,1153,5,1153,0.641753000,0.2841
232.31.192.204,<->,97.198.118.56,0,0,5,612,5,612,0.641416000,0.3562
215.158.239.78,<->,199.79.54.21,5,356,0,0,5,356,0.640863000,0.0006
197.113.99.169,<->,136.25.188.254,0,0,5,280,5,280,0.638047000,0.8798
215.158.238.32,<->,8.249.253.149,5,1389,0,0,5,1389,0.638016000,0.9274
99.187.125.121,<->,8.20.87.3,0,0,5,867,5,867,0.637236000,0.0614
192.228.30.43,<->,133.178.226.28,0,0,5,1389,5,1389,0.635662000,0.0260
215.158.238.190,<->,89.86.110.223,5,1373,0,0,5,1373,0.634771000,0.1073
231.140.187.31,<->,215.158.239.76,0,0,5,813,5,813,0.634067000,0.4255
215.158.239.95,<->,204.226.39.0,5,350,0,0,5,350,0.633542000,0.0308
136.25.189.78,<->,56.161.218.38,5,3010,0,0,5,3010,0.632025000,1.0115
149.163.129.231,<->,136.25.189.78,0,0,5,2594,5,2594,0.631353000,1.3553
215.158.238.123,<->,135.253.11.54,5,1437,0,0,5,1437,0.631308000,0.1458
247.136.177.126,<->,141.46.197.44,5,1483,0,0,5,1483,0.631067000,0.4100
239.66.104.94,<->,97.198.118.56,0,0,5,798,5,798,0.629057000,0.3562
199.82.242.44,<->,136.25.188.209,0,0,5,356,5,356,0.625965000,0.0087
17.88.221.236,<->,8.52.134.29,0,0,5,639,5,639,0.625351000,0.1005
142.220.236.239,<->,136.25.188.178,0,0,5,280,5,280,0.624345000,0.0076
133.178.227.55,<->,133.56.180.52,5,2247,0,0,5,2247,0.624260000,1.1007
140.158.19.100,<->,136.25.188.163,0,0,5,950,5,950,0.623302000,0.8336
215.158.140.75,<->,113.20.94.68,5,1280,0,0,5,1280,0.623256000,0.2009
133.178.226.80,<->,131.144.116.237,5,280,0,0,5,280,0.621742000,0.0400
199.69.133.234,<->,136.25.188.226,0,0,5,356,5,356,0.621280000,0.0074
215.158.239.68,<->,199.20.30.255,5,356,0,0,5,356,0.620846000,0.0708
207.58.113.81,<->,136.25.188.177,0,0,5,1238,5,1238,0.619832000,1.3194
215.158.239.99,<->,199.20.28.83,5,356,0,0,5,356,0.617539000,0.0001
232.31.43.146,<->,97.198.118.56,0,0,5,641,5,641,0.617100000,0.3566
204.187.169.9,<->,136.25.188.220,0,0,5,1129,5,1129,0.616126000,0.1793
195.14.45.24,<->,136.25.188.162,0,0,5,356,5,356,0.615565000,0.0084
215.158.239.41,<->,118.20.114.95,5,1545,0,0,5,1545,0.615275000,0.1478
143.85.248.50,<->,50.223.3.228,0,0,5,402,5,402,0.614933000,0.3216
50.224.76.235,<->,0.241.13.184,5,1481,0,0,5,1481,0.614875000,0.4221
215.158.239.84,<->,142.223.153.67,5,856,0,0,5,856,0.614415000,0.6916
215.158.238.75,<->,57.236.82.245,5,292,0,0,5,292,0.612795000,0.0066
215.158.239.76,<->,207.16.32.235,5,299,0,0,5,299,0.611204000,0.3188
232.31.192.207,<->,97.198.118.56,0,0,5,927,5,927,0.610171000,0.3557
136.25.189.80,<->,56.161.218.54,5,2610,0,0,5,2610,0.609482000,1.1011
195.70.152.61,<->,136.25.188.220,0,0,5,1374,5,1374,0.609069000,1.0588
252.92.25.124,<->,0.195.210.46,0,0,5,3233,5,3233,0.607388000,1.1075
136.25.188.255,<->,132.145.241.230,5,442,0,0,5,442,0.607140000,1.2723
215.158.239.96,<->,199.20.31.74,5,280,0,0,5,280,0.606046000,0.2249
215.158.140.76,<->,57.199.251.39,5,1619,0,0,5,1619,0.606044000,0.3924
102.51.92.163,<->,27.14.47.160,5,463,0,0,5,463,0.605833000,1.2303
194.253.240.189,<->,50.223.3.228,0,0,5,452,5,452,0.605484000,0.3082
215.158.239.48,<->,199.20.29.21,5,699,0,0,5,699,0.605234000,1.1632
53.201.200.21,<->,48.55.88.154,0,0,5,295,5,295,0.604942000,0.5637
148.126.46.235,<->,92.27.27.178,0,0,5,400,5,400,0.603884000,0.7171
195.89.55.198,<->,8.252.222.222,0,0,5,250,5,250,0.603533000,0.8030
136.25.189.80,<->,113.23.66.247,5,1693,0,0,5,1693,0.603102000,0.3139
107.10.167.99,<->,8.52.186.119,0,0,5,590,5,590,0.602756000,0.2039
204.185.76.216,<->,136.25.188.242,0,0,5,280,5,280,0.601155000,0.4393
142.190.119.195,<->,136.25.188.196,0,0,5,350,5,350,0.599590000,0.0144
143.184.207.146,<->,92.27.219.192,0,0,5,290,5,290,0.599440000,0.9188
199.68.69.64,<->,136.25.188.163,0,0,5,1119,5,1119,0.598760000,0.2485
192.204.191.129,<->,133.32.39.0,0,0,5,479,5,479,0.598482000,0.1030
233.225.68.219,<->,111.147.83.94,0,0,5,523,5,523,0.597938000,0.8957
215.158.239.84,<->,204.226.36.241,5,356,0,0,5,356,0.595754000,0.0010
195.22.22.252,<->,50.224.76.234,0,0,5,1159,5,1159,0.595286000,0.6351
215.158.239.93,<->,142.221.28.163,5,280,0,0,5,280,0.594600000,1.0549
192.65.97.145,<->,8.45.175.31,5,373,0,0,5,373,0.593554000,0.7760
50.224.76.235,<->,30.183.186.22,5,2475,0,0,5,2475,0.590143000,0.4399
215.158.239.48,<->,196.92.69.204,5,356,0,0,5,356,0.588711000,0.0001
136.25.189.16,<->,128.23.84.26,5,1549,0,0,5,1549,0.587919000,0.1862
136.25.189.1,<->,121.8.199.20,5,2706,0,0,5,2706,0.587463000,0.2656
215.158.238.241,<->,8.50.171.220,5,1264,0,0,5,1264,0.587211000,0.1482
199.15.22.26,<->,136.25.188.163,0,0,5,365,5,365,0.586025000,0.0074
192.64.210.157,<->,14.30.152.51,5,4104,0,0,5,4104,0.583870000,0.8633
204.61.153.82,<->,136.25.188.46,0,0,5,356,5,356,0.582352000,0.0099
221.102.143.189,<->,192.67.184.152,0,0,5,535,5,535,0.582074000,0.7709
215.158.239.94,<->,199.20.28.106,5,1126,0,0,5,1126,0.581255000,0.5592
8.252.221.198,<->,4.121.146.40,5,1066,0,0,5,1066,0.580452000,1.2922
148.158.222.19,<->,129.224.112.252,0,0,5,339,5,339,0.580088000,1.1773
133.178.227.19,<->,29.211.165.89,5,1269,0,0,5,1269,0.579277000,0.1495
247.236.195.202,<->,133.32.39.0,0,0,5,649,5,649,0.578106000,0.0532
54.36.63.44,<->,48.54.38.89,0,0,5,2715,5,2715,0.577064000,0.3481
215.158.239.86,<->,194.199.196.220,5,356,0,0,5,356,0.576153000,0.0013
144.253.73.232,<->,133.178.227.235,0,0,5,330,5,330,0.576048000,0.0331
129.78.114.107,<->,119.94.225.50,5,726,0,0,5,726,0.572544000,0.0182
128.221.182.45,<->,50.224.76.235,0,0,5,663,5,663,0.571937000,0.2055
215.158.140.162,<->,106.188.254.183,5,448,0,0,5,448,0.571424000,0.1911
195.41.226.218,<->,136.25.188.222,0,0,5,356,5,356,0.570623000,0.0071
199.33.65.22,<->,136.25.188.163,0,0,5,356,5,356,0.569537000,0.0058
197.113.99.185,<->,136.25.188.252,0,0,5,344,5,344,0.567639000,0.1002
17.90.64.205,<->,8.220.200.124,0,0,5,262,5,262,0.567522000,0.0929
194.233.25.163,<->,136.25.188.175,0,0,5,1162,5,1162,0.567329000,1.3606
139.5.113.141,<->,133.32.39.1,0,0,5,413,5,413,0.566363000,0.1656
215.158.140.17,<->,8.42.79.137,5,1270,0,0,5,1270,0.566313000,0.0400
204.200.34.7,<->,136.25.188.53,0,0,5,442,5,442,0.566010000,0.3872
137.69.83.248,<->,8.183.25.124,0,0,5,570,5,570,0.565717000,0.1489
215.158.238.74,<->,192.205.37.235,5,1485,0,0,5,1485,0.562237000,0.0386
199.69.165.34,<->,136.25.188.238,0,0,5,1579,5,1579,0.561930000,0.8352
201.66.169.1,<->,92.27.219.44,0,0,5,280,5,280,0.561892000,1.3095
143.53.71.132,<->,136.25.188.209,0,0,5,356,5,356,0.561688000,0.0138
143.10.172.12,<->,136.25.188.253,0,0,5,356,5,356,0.561560000,0.0130
215.158.238.177,<->,193.39.68.239,5,1299,0,0,5,1299,0.561405000,0.6259
215.158.239.219,<->,111.150.207.132,5,280,0,0,5,280,0.559173000,0.0248
97.126.13.83,<->,54.52.207.31,5,359,0,0,5,359,0.558657000,0.0970
222.103.127.218,<->,80.27.157.12,0,0,5,2440,5,2440,0.556270000,1.2718
215.158.239.51,<->,204.56.169.160,5,299,0,0,5,299,0.554241000,0.5029
220.39.233.24,<->,215.158.140.76,0,0,5,3518,5,3518,0.553632000,0.9234
215.158.239.6,<->,122.159.245.162,5,3160,0,0,5,3160,0.552966000,0.7651
207.62.38.16,<->,136.25.188.241,0,0,5,356,5,356,0.552208000,0.0088
197.113.99.68,<->,136.25.188.162,0,0,5,280,5,280,0.551846000,1.2601
195.40.100.63,<->,136.25.188.210,0,0,5,280,5,280,0.550651000,0.6999
215.158.239.71,<->,120.154.225.209,5,2914,0,0,5,2914,0.550251000,0.9068
215.158.239.76,<->,199.20.28.246,5,365,0,0,5,365,0.550166000,0.4907
207.190.200.196,<->,136.25.188.198,0,0,5,980,5,980,0.549026000,0.3937
145.118.57.252,<->,133.32.39.0,0,0,5,1241,5,1241,0.547964000,0.0641
136.25.188.162,<->,113.23.104.247,5,1501,0,0,5,1501,0.547834000,0.1326
133.178.227.247,<->,99.74.26.148,5,280,0,0,5,280,0.547402000,0.0001
194.237.250.31,<->,136.25.188.238,0,0,5,356,5,356,0.547108000,0.0160
215.158.238.18,<->,8.181.147.46,5,4144,0,0,5,4144,0.544268000,0.0034
142.228.169.94,<->,136.25.188.55,0,0,5,476,5,476,0.543269000,0.7019
207.63.119.212,<->,136.25.188.238,0,0,5,289,5,289,0.540664000,0.2062
89.183.104.145,<->,78.55.252.81,5,404,0,0,5,404,0.540357000,1.1479
215.158.239.58,<->,199.20.29.103,5,356,0,0,5,356,0.539468000,0.0502
215.158.239.50,<->,196.107.166.42,5,356,0,0,5,356,0.538770000,0.0102
207.63.4.200,<->,136.25.188.243,0,0,5,318,5,318,0.538593000,0.7874
215.158.239.93,<->,207.166.174.122,5,356,0,0,5,356,0.537303000,0.0001
204.185.53.33,<->,136.25.188.198,0,0,5,356,5,356,0.536102000,0.4599
200.175.141.134,<->,54.59.66.233,5,717,0,0,5,717,0.535559000,0.6110
220.60.81.132,<->,215.158.239.78,0,0,5,2690,5,2690,0.534779000,0.9736
207.58.103.150,<->,136.25.188.238,0,0,5,1054,5,1054,0.532906000,0.6914
215.158.239.57,<->,114.25.48.33,5,2786,0,0,5,2786,0.532320000,1.1224
144.76.43.242,<->,80.56.78.128,0,0,5,519,5,519,0.532063000,0.6605
215.158.239.95,<->,199.20.29.49,5,950,0,0,5,950,0.531675000,1.0202
143.10.74.23,<->,136.25.188.222,0,0,5,593,5,593,0.531404000,1.3578
84.214.213.150,<->,80.38.62.152,0,0,5,998,5,998,0.530958000,0.2778
215.158.238.104,<->,143.227.65.158,5,2706,0,0,5,2706,0.529416000,1.0872
204.18.77.13,<->,50.224.61.172,0,0,5,250,5,250,0.528315000,1.4368
215.158.239.97,<->,142.236.92.15,5,838,0,0,5,838,0.528109000,1.4491
193.53.171.162,<->,108.134.112.170,0,0,5,475,5,475,0.527232000,1.4013
215.158.239.59,<->,72.23.194.230,5,3186,0,0,5,3186,0.526783000,1.2214
220.20.200.24,<->,144.83.60.153,5,2607,0,0,5,2607,0.526177000,0.6036
215.158.239.79,<->,199.20.6.169,5,280,0,0,5,280,0.524521000,0.3405
133.32.39.1,<->,8.45.242.87,5,479,0,0,5,479,0.522772000,0.1029
36.123.54.247,<->,8.20.87.5,0,0,5,329,5,329,0.522668000,0.4873
204.186.131.68,<->,136.25.188.243,0,0,5,1271,5,1271,0.522261000,0.8617
111.147.200.49,<->,89.207.30.173,5,4230,0,0,5,4230,0.519015000,1.4464
199.82.72.144,<->,136.25.188.174,0,0,5,292,5,292,0.518917000,1.4073
136.25.188.198,<->,131.1.253.245,5,2988,0,0,5,2988,0.518798000,1.2595
215.158.239.253,<->,8.191.135.47,5,523,0,0,5,523,0.516398000,0.1876
215.158.238.80,<->,113.23.104.247,5,1357,0,0,5,1357,0.515361000,0.1261
194.195.244.244,<->,102.51.189.86,0,0,5,328,5,328,0.515267000,1.3054
215.158.239.78,<->,195.15.17.107,5,991,0,0,5,991,0.511698000,0.4584
195.68.93.177,<->,136.25.188.220,0,0,5,834,5,834,0.511345000,1.2197
215.158.238.123,<->,113.23.21.200,5,1437,0,0,5,1437,0.511031000,0.3515
215.158.61.182,<->,8.176.8.201,0,0,5,6189,5,6189,0.510966000,0.0000
144.75.218.241,<->,99.168.7.150,5,693,0,0,5,693,0.510215000,0.9665
53.149.17.194,<->,48.53.234.112,0,0,5,303,5,303,0.509577000,1.4881
215.158.239.93,<->,199.20.6.209,5,356,0,0,5,356,0.509018000,0.0290
199.38.97.99,<->,136.25.188.178,0,0,5,812,5,812,0.508855000,0.6243
194.232.117.36,<->,136.25.188.253,0,0,5,973,5,973,0.508614000,1.1158
138.126.13.23,<->,50.224.76.235,0,0,5,1086,5,1086,0.507663000,0.2105
199.39.246.95,<->,136.25.188.163,0,0,5,344,5,344,0.505240000,0.0059
17.68.77.212,<->,8.220.198.10,0,0,5,250,5,250,0.502356000,0.4288
215.158.239.35,<->,106.188.184.69,5,1811,0,0,5,1811,0.502192000,0.0319
205.81.149.14,<->,92.27.219.139,0,0,5,992,5,992,0.501474000,0.9944
215.158.238.45,<->,141.39.23.85,5,1437,0,0,5,1437,0.501179000,0.3348
132.18.67.30,<->,100.92.68.156,0,0,5,629,5,629,0.500316000,0.2155
215.158.239.35,<->,106.188.214.11,5,1769,0,0,5,1769,0.497488000,0.0965
133.32.39.0,<->,8.193.178.56,5,479,0,0,5,479,0.495678000,0.1028
142.229.37.165,<->,136.25.188.163,0,0,5,250,5,250,0.495535000,0.9680
215.158.239.92,<->,133.224.119.41,5,3863,0,0,5,3863,0.495126000,1.3521
133.178.227.27,<->,111.150.187.176,5,3799,0,0,5,3799,0.494627000,1.4816
204.17.28.74,<->,50.224.76.230,0,0,5,1323,5,1323,0.494448000,0.3679
204.200.63.254,<->,136.25.188.236,0,0,5,356,5,356,0.493517000,0.0448
220.28.73.211,<->,136.25.189.84,0,0,5,4236,5,4236,0.493471000,0.2684
139.163.5.140,<->,42.47.113.167,5,318,0,0,5,318,0.491868000,0.3057
148.26.113.100,<->,133.178.227.70,0,0,5,2279,5,2279,0.491681000,1.3455
194.195.200.120,<->,50.224.76.230,0,0,5,804,5,804,0.490785000,0.4192
215.158.239.56,<->,195.14.36.68,5,293,0,0,5,293,0.489968000,0.6059
215.158.238.41,<->,100.224.166.115,5,1490,0,0,5,1490,0.488684000,1.1289
195.55.52.115,<->,136.25.188.252,0,0,5,314,5,314,0.487843000,0.0059
215.158.238.33,<->,57.199.250.215,5,2754,0,0,5,2754,0.487786000,1.1218
138.126.13.23,<->,50.224.76.230,0,0,5,752,5,752,0.487722000,0.1974
133.32.39.0,<->,8.193.74.162,5,479,0,0,5,479,0.487513000,0.1028
215.158.238.72,<->,112.220.206.107,5,1501,0,0,5,1501,0.486452000,0.1203
215.158.239.56,<->,199.20.28.241,5,1039,0,0,5,1039,0.483719000,0.6010
142.236.21.32,<->,136.25.188.225,0,0,5,1021,5,1021,0.483567000,0.2668
215.158.238.71,<->,100.216.78.145,5,4972,0,0,5,4972,0.482626000,0.0090
17.99.120.221,<->,8.53.4.185,0,0,5,840,5,840,0.480944000,0.0571
204.60.76.43,<->,136.25.188.225,0,0,5,954,5,954,0.480798000,0.7880
144.85.170.208,<->,144.61.1.168,5,784,0,0,5,784,0.480690000,0.0942
215.158.61.145,<->,136.25.188.35,0,0,5,6445,5,6445,0.478955000,0.0000
215.158.239.94,<->,196.90.62.254,5,328,0,0,5,328,0.476953000,1.4627
159.228.245.125,<->,159.137.208.5,0,0,5,1209,5,1209,0.474384000,0.0960
69.22.182.164,<->,50.224.76.234,0,0,5,1127,5,1127,0.473798000,0.6885
92.27.194.117,<->,29.237.9.30,5,2019,0,0,5,2019,0.472639000,0.6002
231.140.19.97,<->,136.25.188.178,0,0,5,250,5,250,0.471863000,0.6097
243.117.82.11,<->,133.54.30.179,0,0,5,250,5,250,0.471173000,0.0460
234.127.80.157,<->,109.222.251.106,0,0,5,311,5,311,0.470397000,0.5273
111.147.87.240,<->,89.205.197.79,5,5411,0,0,5,5411,0.469982000,0.4975
215.158.239.32,<->,149.96.50.9,5,1423,0,0,5,1423,0.468413000,0.0998
136.25.188.230,<->,100.224.202.146,5,1630,0,0,5,1630,0.467579000,0.9583
132.216.20.252,<->,82.237.234.42,0,0,5,760,5,760,0.465834000,0.1158
132.152.144.120,<->,50.224.76.235,0,0,5,1252,5,1252,0.464120000,0.0641
117.38.98.160,<->,50.224.76.230,0,0,5,703,5,703,0.463845000,0.3835
215.158.239.78,<->,207.190.59.41,5,1380,0,0,5,1380,0.463028000,1.4401
142.236.7.253,<->,136.25.188.174,0,0,5,344,5,344,0.462554000,0.0059
215.158.30.50,<->,6.73.247.123,0,0,5,5062,5,5062,0.462056000,0.0063
205.175.193.162,<->,50.224.76.234,0,0,5,807,5,807,0.459660000,0.3272
133.178.226.60,<->,113.23.104.247,5,622,0,0,5,622,0.457492000,1.3359
198.34.203.242,<->,50.224.76.230,0,0,5,1300,5,1300,0.457334000,0.2133
133.178.227.76,<->,29.211.6.132,5,1437,0,0,5,1437,0.456963000,0.1563
133.178.227.62,<->,133.56.180.35,5,2528,0,0,5,2528,0.456918000,1.0771
143.10.39.95,<->,136.25.188.175,0,0,5,462,5,462,0.455127000,1.1765
204.185.57.248,<->,136.25.188.223,0,0,5,703,5,703,0.454836000,0.5696
199.15.139.90,<->,136.25.188.252,0,0,5,856,5,856,0.453584000,0.8005
195.69.235.236,<->,136.25.188.178,0,0,5,1491,5,1491,0.452479000,1.3873
231.140.98.132,<->,215.158.239.56,0,0,5,304,5,304,0.452212000,1.1565
215.158.239.70,<->,199.20.28.46,5,356,0,0,5,356,0.452209000,0.1356
215.158.239.95,<->,196.93.187.114,5,950,0,0,5,950,0.448048000,1.4601
199.111.215.109,<->,8.182.230.205,0,0,5,708,5,708,0.447874000,1.3531
215.158.238.99,<->,118.20.87.7,5,2594,0,0,5,2594,0.446451000,1.4641
232.31.155.21,<->,97.198.118.56,0,0,5,636,5,636,0.445970000,0.3067
215.158.239.92,<->,195.49.37.133,5,438,0,0,5,438,0.444382000,1.3004
142.240.138.78,<->,136.25.188.178,0,0,5,356,5,356,0.443766000,0.0188
207.40.4.22,<->,192.229.210.156,0,0,5,738,5,738,0.443326000,0.3562
199.69.184.152,<->,136.25.188.220,0,0,5,793,5,793,0.442692000,0.8508
215.158.61.191,<->,136.25.188.41,0,0,5,6445,5,6445,0.440768000,0.0000
130.237.156.145,<->,50.224.76.234,0,0,5,2670,5,2670,0.439904000,0.2356
195.15.4.117,<->,136.25.188.53,0,0,5,350,5,350,0.439758000,0.0086
232.31.148.11,<->,97.198.118.56,0,0,5,648,5,648,0.438840000,0.3571
215.158.239.76,<->,199.78.166.34,5,356,0,0,5,356,0.437168000,0.0300
201.211.112.213,<->,133.178.226.28,0,0,5,1309,5,1309,0.435317000,1.5048
136.25.188.34,<->,100.224.141.62,5,3447,0,0,5,3447,0.434759000,0.9624
136.25.189.1,<->,96.156.169.247,5,3122,0,0,5,3122,0.430936000,1.5483
215.158.140.241,<->,144.54.92.44,5,1309,0,0,5,1309,0.430150000,0.0749
156.150.64.253,<->,8.252.222.186,0,0,5,950,5,950,0.427586000,0.3652
215.158.140.175,<->,8.222.7.182,5,3499,0,0,5,3499,0.425301000,1.4582
157.214.169.148,<->,50.224.76.248,0,0,5,250,5,250,0.424908000,0.0247
142.244.125.239,<->,136.25.188.198,0,0,5,356,5,356,0.424170000,0.0076
122.214.20.70,<->,89.183.104.189,0,0,5,910,5,910,0.423501000,1.2385
215.158.140.241,<->,93.39.51.73,5,2255,0,0,5,2255,0.422572000,1.4856
215.158.61.243,<->,8.176.8.215,0,0,5,3609,5,3609,0.422085000,1.3326
144.148.84.204,<->,89.153.90.39,0,0,5,454,5,454,0.421954000,0.8011
143.155.228.1,<->,133.178.226.18,0,0,5,2562,5,2562,0.420657000,1.4840
108.39.251.230,<->,50.224.76.235,0,0,5,1369,5,1369,0.420480000,0.2305
215.158.239.84,<->,199.20.28.148,5,250,0,0,5,250,0.419530000,0.8600
136.139.59.124,<->,136.25.188.178,0,0,5,2546,5,2546,0.417612000,1.1670
232.31.192.217,<->,97.198.118.56,0,0,5,607,5,607,0.416362000,0.3565
215.158.239.76,<->,196.91.232.74,5,973,0,0,5,973,0.415173000,0.7001
221.102.113.114,<->,207.193.113.226,5,250,0,0,5,250,0.414937000,0.6832
142.249.104.17,<->,136.25.188.176,0,0,5,1121,5,1121,0.414486000,0.5378
243.49.83.90,<->,101.126.186.60,0,0,5,2235,5,2235,0.414407000,0.3678
196.247.183.106,<->,136.25.188.238,0,0,5,361,5,361,0.414190000,1.0002
197.81.94.168,<->,136.25.188.239,0,0,5,957,5,957,0.412120000,0.2361
215.158.238.138,<->,0.195.237.14,5,6059,0,0,5,6059,0.412119000,0.0000
136.25.188.56,<->,0.195.253.228,5,2093,0,0,5,2093,0.411917000,0.1448
8.220.189.81,<->,6.101.97.58,5,1546,0,0,5,1546,0.411365000,0.5470
215.158.239.33,<->,8.252.253.180,5,3196,0,0,5,3196,0.409898000,1.2610
215.158.239.85,<->,143.42.144.172,5,429,0,0,5,429,0.409431000,0.9329
215.158.239.58,<->,199.20.29.134,5,356,0,0,5,356,0.408952000,0.0001
79.20.59.166,<->,66.14.88.15,0,0,5,1524,5,1524,0.407189000,1.1885
48.17.210.32,<->,8.252.222.132,0,0,5,365,5,365,0.407105000,0.0069
232.31.155.15,<->,97.198.118.56,0,0,5,626,5,626,0.406797000,0.3569
199.53.111.156,<->,136.25.188.252,0,0,5,356,5,356,0.406075000,0.0132
129.224.112.220,<->,97.242.126.205,5,338,0,0,5,338,0.405900000,0.2216
232.31.192.223,<->,97.198.118.56,0,0,5,764,5,764,0.404732000,0.3560
215.158.140.221,<->,8.222.7.186,5,3167,0,0,5,3167,0.404205000,1.5684
121.205.145.177,<->,92.27.27.99,0,0,5,1148,5,1148,0.404061000,1.2729
215.158.238.105,<->,149.33.103.245,5,280,0,0,5,280,0.402342000,0.0018
200.174.214.9,<->,54.58.183.105,5,4409,0,0,5,4409,0.401832000,0.3551
143.20.222.208,<->,50.224.76.234,0,0,5,1254,5,1254,0.401200000,0.9312
215.158.239.201,<->,192.226.44.66,5,464,0,0,5,464,0.400687000,0.0442
8.252.223.162,<->,8.192.205.86,5,2162,0,0,5,2162,0.400583000,1.4878
215.158.239.86,<->,196.91.49.85,5,1234,0,0,5,1234,0.399544000,1.4796
195.70.242.180,<->,136.25.188.241,0,0,5,356,5,356,0.399075000,0.0079
215.158.239.99,<->,199.82.69.229,5,871,0,0,5,871,0.398776000,1.0814
215.158.239.48,<->,195.83.199.181,5,356,0,0,5,356,0.395937000,0.0424
215.158.239.92,<->,207.62.34.168,5,1832,0,0,5,1832,0.395821000,1.5848
142.236.30.149,<->,136.25.188.177,0,0,5,280,5,280,0.395162000,0.1392
215.158.239.94,<->,194.234.173.124,5,950,0,0,5,950,0.394655000,0.3585
134.12.80.127,<->,92.27.194.117,0,0,5,250,5,250,0.392925000,1.1926
215.158.239.68,<->,199.20.30.170,5,328,0,0,5,328,0.392779000,0.4998
144.87.235.129,<->,137.83.182.35,5,250,0,0,5,250,0.392328000,1.5002
113.169.98.62,<->,50.224.76.230,0,0,5,758,5,758,0.392300000,0.4871
142.254.32.105,<->,136.25.188.178,0,0,5,280,5,280,0.391283000,1.5510
204.200.33.155,<->,136.25.188.55,0,0,5,819,5,819,0.390876000,0.4125
196.246.241.77,<->,136.25.188.178,0,0,5,893,5,893,0.390310000,1.2601
239.66.104.92,<->,97.198.118.56,0,0,5,945,5,945,0.389416000,0.3569
215.158.239.84,<->,196.91.162.27,5,464,0,0,5,464,0.387764000,1.3501
207.172.154.164,<->,136.25.188.177,0,0,5,727,5,727,0.387566000,1.2992
215.158.239.69,<->,196.110.205.219,5,614,0,0,5,614,0.386572000,1.4401
199.121.228.9,<->,136.25.188.175,0,0,5,325,5,325,0.385732000,0.0074
142.229.196.25,<->,136.25.188.241,0,0,5,356,5,356,0.385488000,0.0132
215.158.238.223,<->,126.219.100.188,5,2269,0,0,5,2269,0.385129000,0.8799
204.184.36.140,<->,136.25.188.174,0,0,5,280,5,280,0.384390000,1.4058
89.154.147.189,<->,50.224.120.135,0,0,5,299,5,299,0.384032000,0.0247
204.186.203.185,<->,136.25.188.220,0,0,5,858,5,858,0.383276000,1.1604
232.31.155.11,<->,97.198.118.56,0,0,5,806,5,806,0.381782000,0.3557
194.238.242.251,<->,136.25.188.225,0,0,5,356,5,356,0.381691000,0.0162
232.31.148.13,<->,97.198.118.56,0,0,5,921,5,921,0.380781000,0.3570
133.178.227.255,<->,105.119.200.175,5,989,0,0,5,989,0.380558000,0.2325
204.184.172.218,<->,136.25.188.225,0,0,5,292,5,292,0.379862000,1.5982
232.31.148.12,<->,97.198.118.56,0,0,5,632,5,632,0.379784000,0.4080
144.86.149.153,<->,27.11.31.205,5,451,0,0,5,451,0.379689000,0.2503
204.200.56.84,<->,136.25.188.54,0,0,5,356,5,356,0.379437000,0.0827
215.158.239.86,<->,113.92.151.74,5,3036,0,0,5,3036,0.378304000,0.9983
133.178.226.31,<->,8.191.15.73,5,1581,0,0,5,1581,0.377819000,0.0961
207.61.46.123,<->,136.25.188.242,0,0,5,812,5,812,0.377698000,0.6539
206.199.123.151,<->,139.163.5.140,0,0,5,685,5,685,0.377230000,0.5248
192.224.20.21,<->,136.25.188.221,0,0,5,1437,5,1437,0.377216000,0.1201
204.56.252.49,<->,136.25.188.163,0,0,5,1278,5,1278,0.377157000,1.5438
195.68.3.184,<->,136.25.188.252,0,0,5,846,5,846,0.376994000,1.6000
215.158.239.93,<->,204.2.105.52,5,356,0,0,5,356,0.376960000,0.0169
139.163.34.116,<->,80.56.72.131,5,250,0,0,5,250,0.376900000,1.5329
142.253.228.242,<->,136.25.188.225,0,0,5,281,5,281,0.376500000,0.2418
215.158.239.28,<->,117.155.166.216,5,1420,0,0,5,1420,0.375368000,0.3186
215.158.239.58,<->,199.20.29.41,5,459,0,0,5,459,0.375353000,1.1599
232.31.43.151,<->,97.198.118.56,0,0,5,630,5,630,0.372163000,0.3569
200.175.128.46,<->,53.161.71.169,5,626,0,0,5,626,0.371633000,1.4370
215.158.238.177,<->,113.23.66.35,5,2369,0,0,5,2369,0.371395000,1.4952
136.25.188.44,<->,113.23.21.200,5,2802,0,0,5,2802,0.370838000,0.7826
204.187.86.162,<->,136.25.188.252,0,0,5,1802,5,1802,0.370175000,1.4699
133.32.39.0,<->,8.193.178.40,5,479,0,0,5,479,0.370044000,0.1243
136.25.189.30,<->,96.156.169.163,5,3160,0,0,5,3160,0.370032000,0.1724
204.17.25.212,<->,92.27.234.126,0,0,5,637,5,637,0.369391000,0.8240
136.25.188.105,<->,128.243.151.35,5,1055,0,0,5,1055,0.369315000,1.5177
232.31.108.53,<->,97.198.118.56,0,0,5,629,5,629,0.368919000,0.3566
142.227.45.230,<->,136.25.188.52,0,0,5,356,5,356,0.368862000,0.0139
232.31.43.149,<->,97.198.118.56,0,0,5,639,5,639,0.368653000,0.4075
97.198.98.32,<->,92.181.194.94,5,304,0,0,5,304,0.368287000,1.4940
232.31.241.228,<->,97.198.118.56,0,0,5,763,5,763,0.366822000,0.4076
221.102.143.189,<->,192.65.51.237,0,0,5,295,5,295,0.366800000,0.0701
111.147.242.144,<->,8.18.125.73,5,657,0,0,5,657,0.363280000,0.4342
240.171.83.229,<->,50.224.61.214,0,0,5,280,5,280,0.362738000,1.3074
215.158.239.51,<->,196.94.252.156,5,304,0,0,5,304,0.362166000,1.5099
53.243.12.192,<->,48.52.197.136,0,0,5,4455,5,4455,0.362059000,1.5926
215.158.238.149,<->,100.224.138.251,5,1896,0,0,5,1896,0.361833000,0.2065
215.158.239.120,<->,109.206.125.189,5,770,0,0,5,770,0.361498000,0.1329
200.174.192.92,<->,53.68.248.17,5,711,0,0,5,711,0.361425000,1.4302
89.155.2.203,<->,8.182.226.78,0,0,5,856,5,856,0.360363000,0.9256
111.2.157.67,<->,8.183.25.124,0,0,5,3222,5,3222,0.360031000,0.5819
245.35.100.56,<->,139.163.17.164,0,0,5,250,5,250,0.359976000,1.5558
215.158.239.57,<->,207.63.151.114,5,280,0,0,5,280,0.358693000,0.0300
133.178.226.61,<->,38.206.161.75,5,1505,0,0,5,1505,0.358293000,0.5220
89.204.173.123,<->,80.38.57.225,0,0,5,843,5,843,0.358264000,0.3128
143.13.162.16,<->,136.25.188.54,0,0,5,526,5,526,0.356200000,0.7790
92.27.219.165,<->,88.45.20.228,5,1668,0,0,5,1668,0.354749000,1.0274
91.231.192.190,<->,35.55.57.164,5,603,0,0,5,603,0.354326000,0.9287
215.158.239.49,<->,199.20.29.187,5,826,0,0,5,826,0.353874000,0.5620
133.178.226.37,<->,96.155.60.246,5,1828,0,0,5,1828,0.353687000,0.0663
142.209.68.4,<->,136.25.188.238,0,0,5,1717,5,1717,0.353623000,1.2108
50.224.76.235,<->,29.95.130.169,5,1491,0,0,5,1491,0.353214000,0.2698
207.51.134.215,<->,8.220.178.73,0,0,5,457,5,457,0.352383000,0.5915
196.233.230.61,<->,8.182.139.40,0,0,5,281,5,281,0.351823000,0.4035
215.158.239.95,<->,199.20.5.236,5,942,0,0,5,942,0.351518000,0.7569
133.178.226.30,<->,126.219.190.217,5,2418,0,0,5,2418,0.351266000,0.6971
110.222.166.99,<->,50.224.76.235,0,0,5,796,5,796,0.349461000,0.0929
136.25.189.14,<->,118.20.100.87,5,4231,0,0,5,4231,0.349038000,1.3595
215.158.239.86,<->,196.88.143.131,5,818,0,0,5,818,0.348894000,1.1813
215.158.239.51,<->,196.109.18.222,5,418,0,0,5,418,0.348445000,1.5180
50.224.49.195,<->,6.147.24.100,5,280,0,0,5,280,0.347575000,1.5325
136.25.188.254,<->,113.23.104.215,5,2434,0,0,5,2434,0.346855000,1.5826
215.158.239.58,<->,196.104.231.228,5,950,0,0,5,950,0.346754000,0.6214
215.158.239.111,<->,215.158.61.242,5,5777,0,0,5,5777,0.346500000,1.5649
144.83.60.153,<->,92.162.253.74,0,0,5,4687,5,4687,0.345704000,0.2580
133.178.226.37,<->,6.116.14.11,5,1421,0,0,5,1421,0.345372000,0.1164
215.158.239.49,<->,199.20.28.91,5,356,0,0,5,356,0.344354000,0.1104
215.158.238.177,<->,128.23.167.156,5,1357,0,0,5,1357,0.343266000,0.1401
139.254.214.188,<->,58.132.150.196,5,5469,0,0,5,5469,0.341955000,0.9402
215.158.239.66,<->,56.97.186.37,5,5725,0,0,5,5725,0.341388000,0.0042
194.234.135.124,<->,136.25.188.242,0,0,5,344,5,344,0.340817000,0.0060
200.174.215.121,<->,53.203.244.195,5,706,0,0,5,706,0.340708000,1.5967
229.59.20.107,<->,50.224.49.194,0,0,5,250,5,250,0.340437000,1.5983
141.35.174.83,<->,8.252.221.197,0,0,5,405,5,405,0.339488000,0.3074
133.178.227.41,<->,131.22.233.144,5,3512,0,0,5,3512,0.338621000,1.5785
91.69.181.253,<->,50.224.49.211,0,0,5,280,5,280,0.338021000,1.5931
215.158.239.84,<->,195.13.155.251,5,280,0,0,5,280,0.337452000,0.0059
215.158.239.69,<->,195.41.26.19,5,356,0,0,5,356,0.336904000,0.0113
215.158.239.50,<->,199.20.29.149,5,365,0,0,5,365,0.336658000,0.0094
207.63.57.203,<->,136.25.188.252,0,0,5,340,5,340,0.335867000,0.3779
142.206.19.223,<->,136.25.188.55,0,0,5,268,5,268,0.335333000,0.9946
96.232.239.40,<->,92.27.219.36,0,0,5,254,5,254,0.334705000,0.8175
215.158.239.57,<->,196.90.181.171,5,280,0,0,5,280,0.333882000,0.3403
215.158.239.70,<->,192.204.123.2,5,2850,0,0,5,2850,0.332043000,0.7391
215.158.239.93,<->,195.3.103.218,5,2562,0,0,5,2562,0.331553000,1.3520
215.158.239.76,<->,199.20.7.39,5,280,0,0,5,280,0.331334000,0.0002
136.139.59.124,<->,133.178.226.19,0,0,5,1501,5,1501,0.330559000,0.0645
215.158.239.85,<->,199.20.6.68,5,356,0,0,5,356,0.330254000,0.0001
215.158.239.99,<->,142.207.184.231,5,950,0,0,5,950,0.330072000,0.3309
204.200.42.202,<->,136.25.188.52,0,0,5,957,5,957,0.328895000,0.1358
249.101.121.52,<->,132.18.67.30,5,679,0,0,5,679,0.328508000,0.0977
119.111.182.206,<->,50.224.76.234,0,0,5,2064,5,2064,0.327701000,0.2160
207.86.5.44,<->,50.224.76.235,0,0,5,874,5,874,0.327353000,0.5203
132.18.67.26,<->,109.1.39.1,0,0,5,3527,5,3527,0.327073000,0.0536
133.32.39.1,<->,8.191.1.176,5,479,0,0,5,479,0.327060000,0.0404
215.158.239.48,<->,199.20.4.179,5,1055,0,0,5,1055,0.326102000,0.8399
215.158.239.77,<->,195.83.72.213,5,365,0,0,5,365,0.325081000,0.0091
215.158.140.216,<->,59.158.143.25,5,1750,0,0,5,1750,0.324729000,1.4627
215.158.238.107,<->,89.86.110.10,5,2514,0,0,5,2514,0.324188000,1.0149
195.69.113.239,<->,136.25.188.210,0,0,5,304,5,304,0.324135000,1.6396
207.61.59.172,<->,136.25.188.198,0,0,5,250,5,250,0.323238000,0.2895
133.178.226.61,<->,99.192.168.155,5,1509,0,0,5,1509,0.321660000,0.1095
117.111.232.65,<->,109.1.47.253,0,0,5,329,5,329,0.320665000,1.5687
136.25.189.29,<->,122.251.2.219,5,2706,0,0,5,2706,0.320634000,0.2908
136.25.188.197,<->,112.220.206.107,5,622,0,0,5,622,0.320138000,1.6472
204.200.54.126,<->,136.25.188.226,0,0,5,356,5,356,0.320098000,0.0065
215.158.239.77,<->,29.211.93.23,5,2786,0,0,5,2786,0.319599000,1.0677
141.162.130.245,<->,136.25.188.161,0,0,5,1405,5,1405,0.318284000,0.4537
252.98.180.157,<->,80.27.155.30,5,730,0,0,5,730,0.318186000,0.1816
230.75.129.225,<->,102.83.184.157,0,0,5,483,5,483,0.318152000,0.4537
215.158.238.74,<->,104.3.169.55,5,1261,0,0,5,1261,0.317835000,1.1288
215.158.239.113,<->,129.222.39.145,5,1276,0,0,5,1276,0.314990000,1.0397
145.252.125.198,<->,116.96.63.23,5,593,0,0,5,593,0.312391000,0.2335
199.38.42.23,<->,136.25.188.253,0,0,5,350,5,350,0.312005000,0.0133
132.18.67.31,<->,99.73.141.255,0,0,5,621,5,621,0.311848000,1.2946
144.71.43.13,<->,84.22.240.243,5,1532,0,0,5,1532,0.310885000,0.3826
133.178.226.31,<->,27.178.41.36,5,1465,0,0,5,1465,0.310811000,1.5217
36.123.55.226,<->,8.20.87.32,0,0,5,329,5,329,0.309455000,0.2697
215.158.103.203,<->,124.20.100.129,5,424,0,0,5,424,0.308796000,0.3634
247.136.154.209,<->,38.93.215.114,5,266,0,0,5,266,0.306989000,0.4220
215.158.239.77,<->,196.93.95.245,5,420,0,0,5,420,0.306920000,0.8599
215.158.140.92,<->,140.174.85.75,5,1373,0,0,5,1373,0.306754000,0.7372
136.25.189.45,<->,69.132.241.214,5,2450,0,0,5,2450,0.306001000,1.3463
196.17.240.209,<->,50.224.76.234,0,0,5,1479,5,1479,0.305747000,0.3339
159.137.252.189,<->,38.253.84.123,5,428,0,0,5,428,0.304808000,1.3881
215.158.239.58,<->,199.20.29.38,5,280,0,0,5,280,0.303885000,0.0200
221.102.56.69,<->,98.128.56.58,0,0,5,534,5,534,0.303469000,0.2178
117.155.180.110,<->,99.75.44.80,0,0,5,318,5,318,0.303385000,0.4776
207.179.110.12,<->,50.224.76.234,0,0,5,810,5,810,0.302832000,0.3049
215.158.140.231,<->,113.20.94.221,5,1319,0,0,5,1319,0.302793000,0.1936
136.25.189.59,<->,33.209.219.107,5,2866,0,0,5,2866,0.301975000,0.5270
145.242.126.139,<->,99.167.188.131,5,3289,0,0,5,3289,0.301934000,0.9743
99.170.105.20,<->,89.183.104.139,0,0,5,664,5,664,0.301422000,0.2916
213.221.90.192,<->,144.85.170.208,0,0,5,663,5,663,0.299563000,0.0855
202.33.202.124,<->,136.25.188.240,0,0,5,299,5,299,0.299496000,0.3037
136.25.189.88,<->,133.146.0.217,5,2642,0,0,5,2642,0.299331000,0.5100
215.158.140.241,<->,122.159.123.97,5,280,0,0,5,280,0.298722000,0.0001
231.138.253.229,<->,136.25.188.220,0,0,5,280,5,280,0.298147000,1.3802
194.194.108.97,<->,50.223.3.228,0,0,5,464,5,464,0.295153000,0.3447
192.64.244.21,<->,8.209.235.29,5,2293,0,0,5,2293,0.293998000,0.6928
93.181.154.50,<->,92.27.219.219,0,0,5,256,5,256,0.292259000,0.5400
149.96.133.55,<->,50.224.76.235,0,0,5,1161,5,1161,0.290130000,0.2261
92.27.219.33,<->,4.240.67.99,5,478,0,0,5,478,0.289887000,0.8679
136.25.188.240,<->,8.255.92.246,5,299,0,0,5,299,0.289228000,0.0322
138.5.92.214,<->,97.198.98.33,0,0,5,479,5,479,0.288699000,0.0634
215.158.61.203,<->,136.25.188.43,0,0,5,4183,5,4183,0.288527000,1.4547
17.166.0.253,<->,8.220.200.124,0,0,5,304,5,304,0.288032000,0.7464
199.14.207.55,<->,136.25.188.160,0,0,5,356,5,356,0.287730000,0.0071
215.158.239.96,<->,199.20.29.176,5,356,0,0,5,356,0.286450000,0.0606
145.235.126.55,<->,50.224.76.234,0,0,5,2294,5,2294,0.285162000,0.0548
215.158.61.195,<->,136.25.189.214,0,0,5,6733,5,6733,0.284674000,0.0000
195.13.130.115,<->,136.25.188.173,0,0,5,500,5,500,0.283684000,0.9914
215.158.239.49,<->,69.132.194.97,5,2930,0,0,5,2930,0.283371000,0.7066
134.150.68.36,<->,80.41.35.54,0,0,5,260,5,260,0.282625000,1.6939
194.237.110.86,<->,136.25.188.46,0,0,5,256,5,256,0.282622000,0.2146
207.172.246.75,<->,136.25.188.209,0,0,5,2041,5,2041,0.282449000,0.8400
215.158.239.48,<->,207.115.208.47,5,954,0,0,5,954,0.281258000,0.6408
159.237.239.226,<->,17.61.177.228,5,3814,0,0,5,3814,0.279873000,0.2418
143.155.227.33,<->,136.25.188.220,0,0,5,299,5,299,0.279543000,0.2051
200.174.207.0,<->,53.201.72.62,5,4912,0,0,5,4912,0.279411000,0.0020
215.158.239.93,<->,195.49.82.191,5,280,0,0,5,280,0.279329000,0.6201
215.158.239.93,<->,196.1.79.121,5,280,0,0,5,280,0.278060000,0.5389
110.243.229.235,<->,50.224.49.195,0,0,5,280,5,280,0.277440000,1.6374
215.158.238.74,<->,113.23.21.231,5,1389,0,0,5,1389,0.277138000,0.8756
215.158.239.56,<->,199.20.7.93,5,356,0,0,5,356,0.275317000,0.0100
136.25.188.220,<->,124.72.95.5,5,1469,0,0,5,1469,0.274943000,0.2247
215.158.239.48,<->,199.20.29.35,5,1001,0,0,5,1001,0.274006000,0.3797
207.56.239.111,<->,136.25.188.225,0,0,5,356,5,356,0.273202000,0.0051
136.25.189.33,<->,29.212.199.194,5,2738,0,0,5,2738,0.271407000,0.6967
133.178.226.7,<->,112.220.206.116,5,1501,0,0,5,1501,0.270682000,0.2301
148.132.60.151,<->,92.162.253.217,0,0,5,773,5,773,0.270367000,0.3567
125.210.97.118,<->,98.236.235.93,0,0,5,280,5,280,0.269637000,1.4266
50.224.76.230,<->,6.212.127.225,5,1396,0,0,5,1396,0.269560000,0.1323
215.158.239.76,<->,142.241.37.119,5,983,0,0,5,983,0.269250000,0.9604
215.158.238.94,<->,29.214.71.108,5,1501,0,0,5,1501,0.269200000,0.1283
97.182.1.35,<->,8.220.204.234,0,0,5,917,5,917,0.268234000,0.6798
121.4.83.222,<->,50.224.76.235,0,0,5,1176,5,1176,0.268212000,0.2516
215.158.239.33,<->,33.209.213.0,5,1787,0,0,5,1787,0.267955000,0.1219
61.125.166.13,<->,8.252.222.61,0,0,5,356,5,356,0.267671000,0.0042
199.32.126.132,<->,136.25.188.45,0,0,5,356,5,356,0.267149000,0.0076
215.158.239.49,<->,195.96.152.197,5,954,0,0,5,954,0.265978000,0.4167
215.158.238.95,<->,8.189.240.232,5,1373,0,0,5,1373,0.265975000,0.1446
97.168.79.246,<->,91.40.228.115,5,1432,0,0,5,1432,0.265792000,0.0485
133.178.226.49,<->,38.13.146.55,5,280,0,0,5,280,0.265450000,0.0002
195.68.220.78,<->,136.25.188.55,0,0,5,280,5,280,0.261258000,0.1702
88.1.225.184,<->,8.176.8.48,0,0,5,4445,5,4445,0.259811000,0.3357
215.158.239.77,<->,199.20.28.66,5,404,0,0,5,404,0.258801000,1.4244
195.127.94.67,<->,136.25.188.220,0,0,5,812,5,812,0.258745000,1.0930
195.7.105.250,<->,136.25.188.220,0,0,5,1023,5,1023,0.257949000,0.3634
54.36.178.66,<->,48.52.240.82,0,0,5,1034,5,1034,0.257222000,1.7234
159.137.162.213,<->,38.126.10.50,5,826,0,0,5,826,0.256426000,1.4353
144.87.235.129,<->,137.83.182.31,5,250,0,0,5,250,0.254718000,1.5001
215.158.239.58,<->,196.91.85.207,5,396,0,0,5,396,0.254258000,1.4603
215.158.239.76,<->,199.20.7.125,5,1112,0,0,5,1112,0.253532000,0.5799
215.158.239.79,<->,196.89.239.219,5,950,0,0,5,950,0.253101000,0.7032
215.158.239.76,<->,207.191.122.139,5,356,0,0,5,356,0.252395000,0.0399
204.61.232.46,<->,136.25.188.225,0,0,5,356,5,356,0.252210000,0.0180
136.25.189.0,<->,56.28.207.202,5,1533,0,0,5,1533,0.251718000,0.1369
218.192.127.24,<->,139.163.8.98,0,0,5,276,5,276,0.251265000,0.9822
215.158.238.66,<->,113.23.104.215,5,1421,0,0,5,1421,0.251047000,1.2964
197.107.23.231,<->,136.25.188.175,0,0,5,280,5,280,0.250667000,0.5761
215.158.239.92,<->,204.0.216.219,5,372,0,0,5,372,0.250435000,1.2599
136.25.189.59,<->,8.255.92.169,5,2850,0,0,5,2850,0.250349000,1.5484
218.138.240.252,<->,139.163.17.164,0,0,5,250,5,250,0.249785000,1.5929
215.158.239.84,<->,199.106.134.127,5,363,0,0,5,363,0.249195000,0.2699
136.25.189.17,<->,29.211.93.6,5,2642,0,0,5,2642,0.248755000,1.2370
220.28.85.14,<->,136.25.189.38,0,0,5,3786,5,3786,0.248018000,1.2954
143.13.128.96,<->,136.25.188.253,0,0,5,1229,5,1229,0.247632000,1.6417
215.158.239.96,<->,207.63.146.161,5,356,0,0,5,356,0.247208000,0.0003
215.158.239.56,<->,199.20.31.137,5,356,0,0,5,356,0.246895000,0.0408
136.25.189.29,<->,126.219.194.10,5,3038,0,0,5,3038,0.246136000,0.7928
142.248.146.243,<->,136.25.188.254,0,0,5,468,5,468,0.245799000,0.6863
197.113.98.191,<->,136.25.188.220,0,0,5,274,5,274,0.244707000,0.4199
215.158.239.78,<->,196.108.210.17,5,328,0,0,5,328,0.244702000,1.0250
207.21.15.205,<->,8.252.222.157,0,0,5,580,5,580,0.244635000,0.8644
142.209.202.165,<->,136.25.188.225,0,0,5,280,5,280,0.244179000,0.0516
136.25.188.254,<->,104.3.168.216,5,4007,0,0,5,4007,0.244100000,1.6045
138.98.250.43,<->,98.87.147.199,5,280,0,0,5,280,0.243769000,1.4798
136.25.189.0,<->,120.154.131.37,5,4023,0,0,5,4023,0.243767000,1.3360
98.238.48.43,<->,8.182.244.237,0,0,5,3264,5,3264,0.243342000,1.5569
207.173.199.186,<->,136.25.188.196,0,0,5,380,5,380,0.243206000,0.0283
159.137.226.155,<->,89.183.98.97,5,740,0,0,5,740,0.242324000,0.7572
215.158.61.145,<->,8.176.8.245,0,0,5,6573,5,6573,0.241928000,0.0000
195.14.248.228,<->,136.25.188.238,0,0,5,368,5,368,0.241877000,0.6418
215.158.61.242,<->,8.176.8.211,0,0,5,1483,5,1483,0.241660000,1.7560
117.13.158.151,<->,50.224.76.234,0,0,5,778,5,778,0.241267000,0.2097
112.109.177.35,<->,92.27.219.243,0,0,5,4584,5,4584,0.241158000,1.5808
136.25.189.1,<->,120.154.131.7,5,2812,0,0,5,2812,0.241032000,0.3950
98.236.235.12,<->,88.11.102.250,5,280,0,0,5,280,0.240953000,1.6001
145.170.227.223,<->,8.52.163.19,0,0,5,578,5,578,0.239377000,0.1498
194.237.3.118,<->,136.25.188.46,0,0,5,356,5,356,0.238439000,0.0046
194.237.32.134,<->,136.25.188.225,0,0,5,808,5,808,0.238081000,0.8766
136.25.188.208,<->,131.1.232.163,5,2093,0,0,5,2093,0.237942000,0.3903
142.248.117.198,<->,136.25.188.239,0,0,5,847,5,847,0.237154000,0.5820
215.158.239.92,<->,199.32.187.69,5,314,0,0,5,314,0.237101000,0.1785
215.158.239.49,<->,195.81.38.28,5,356,0,0,5,356,0.236664000,0.0100
8.252.221.205,<->,4.123.114.127,5,668,0,0,5,668,0.236549000,1.6014
133.178.226.31,<->,29.214.108.64,5,2978,0,0,5,2978,0.236318000,0.7343
136.25.189.18,<->,29.212.199.244,5,2770,0,0,5,2770,0.236059000,0.5856
148.186.207.53,<->,136.25.188.197,0,0,5,280,5,280,0.235787000,1.6183
109.1.61.223,<->,92.27.27.143,0,0,5,288,5,288,0.235643000,0.3805
213.221.90.234,<->,138.98.250.43,0,0,5,280,5,280,0.235611000,1.5991
215.158.239.84,<->,199.20.30.50,5,344,0,0,5,344,0.234924000,0.0201
138.98.250.39,<->,129.133.98.212,5,280,0,0,5,280,0.234616000,1.6011
143.42.192.53,<->,136.25.188.227,0,0,5,250,5,250,0.231410000,1.7135
119.159.22.233,<->,92.162.253.161,0,0,5,549,5,549,0.231242000,0.1925
142.248.146.243,<->,136.25.188.252,0,0,5,818,5,818,0.229760000,0.6168
215.158.61.191,<->,8.176.8.216,0,0,5,2843,5,2843,0.229585000,0.7697
250.93.175.38,<->,139.163.96.94,0,0,5,250,5,250,0.228720000,1.7504
195.5.195.237,<->,136.25.188.175,0,0,5,356,5,356,0.227857000,0.0062
148.23.229.9,<->,133.178.226.19,0,0,5,1485,5,1485,0.227663000,0.1365
215.158.239.86,<->,196.90.73.223,5,1488,0,0,5,1488,0.227316000,1.6703
202.33.16.85,<->,136.25.188.177,0,0,5,280,5,280,0.227181000,0.1022
136.25.189.42,<->,96.156.169.238,5,4952,0,0,5,4952,0.226807000,0.0535
195.65.192.81,<->,50.224.76.234,0,0,5,1113,5,1113,0.226251000,1.2623
100.124.212.156,<->,80.41.38.205,0,0,5,498,5,498,0.225170000,0.0645
199.68.238.166,<->,136.25.188.239,0,0,5,356,5,356,0.223919000,0.0103
215.158.238.143,<->,113.23.104.203,5,622,0,0,5,622,0.223542000,0.8932
194.244.41.92,<->,50.224.76.235,0,0,5,1383,5,1383,0.223317000,0.3400
215.158.238.67,<->,131.2.115.245,5,2882,0,0,5,2882,0.222874000,1.6737
76.179.50.153,<->,8.252.221.230,0,0,5,672,5,672,0.222742000,0.4962
89.183.111.155,<->,8.163.116.117,5,588,0,0,5,588,0.222160000,0.0743
142.253.190.145,<->,136.25.188.178,0,0,5,250,5,250,0.221260000,0.0978
215.158.239.85,<->,199.20.29.115,5,950,0,0,5,950,0.221112000,0.5898
215.158.238.80,<->,143.155.227.54,5,1421,0,0,5,1421,0.219466000,0.2874
204.60.0.105,<->,136.25.188.242,0,0,5,340,5,340,0.219393000,1.5609
215.158.238.81,<->,192.227.190.244,5,1949,0,0,5,1949,0.219377000,0.2235
215.158.239.76,<->,199.20.31.158,5,356,0,0,5,356,0.219071000,0.0090
145.10.193.189,<->,50.224.76.234,0,0,5,1200,5,1200,0.217147000,0.1005
215.158.239.94,<->,196.90.2.27,5,280,0,0,5,280,0.216119000,0.0000
215.158.239.56,<->,199.20.30.229,5,299,0,0,5,299,0.215801000,1.4000
193.25.56.161,<->,50.224.76.230,0,0,5,1296,5,1296,0.215609000,1.0779
207.77.77.132,<->,8.252.222.162,0,0,5,980,5,980,0.215055000,0.3301
215.158.239.92,<->,199.106.140.78,5,299,0,0,5,299,0.213553000,0.3799
215.158.239.95,<->,207.191.209.155,5,950,0,0,5,950,0.212798000,0.4728
215.158.140.92,<->,122.158.49.125,5,2265,0,0,5,2265,0.211074000,1.5464
254.119.183.96,<->,138.98.250.43,0,0,5,250,5,250,0.210202000,1.5988
215.158.239.93,<->,207.60.21.172,5,280,0,0,5,280,0.209972000,0.1261
204.21.247.24,<->,136.25.188.252,0,0,5,356,5,356,0.209268000,0.0077
111.150.187.126,<->,8.252.223.146,0,0,5,1357,5,1357,0.208941000,0.8275
220.50.210.22,<->,215.158.239.31,0,0,5,699,5,699,0.208493000,0.2343
202.33.241.197,<->,136.25.188.240,0,0,5,344,5,344,0.207158000,0.0199
215.158.238.123,<->,143.227.65.227,5,1737,0,0,5,1737,0.206890000,0.4093
195.12.232.125,<->,136.25.188.196,0,0,5,356,5,356,0.206734000,0.0086
215.158.239.92,<->,142.249.139.146,5,522,0,0,5,522,0.206701000,0.4541
136.25.189.81,<->,89.80.251.5,5,2722,0,0,5,2722,0.206425000,0.7731
215.158.239.48,<->,199.20.30.82,5,356,0,0,5,356,0.205990000,0.0500
207.63.8.92,<->,136.25.188.243,0,0,5,922,5,922,0.205575000,0.8086
142.239.45.22,<->,8.182.227.180,0,0,5,649,5,649,0.204935000,0.1596
142.191.37.59,<->,136.25.188.236,0,0,5,280,5,280,0.204912000,0.1186
136.25.188.237,<->,112.220.206.107,5,1533,0,0,5,1533,0.204800000,0.0997
142.255.51.0,<->,136.25.188.222,0,0,5,344,5,344,0.203179000,0.0088
192.204.123.20,<->,136.25.189.0,0,0,5,3719,5,3719,0.202356000,1.7441
215.158.239.97,<->,195.49.119.201,5,280,0,0,5,280,0.201694000,1.4991
142.209.138.121,<->,136.25.188.177,0,0,5,274,5,274,0.200333000,1.4721
215.158.239.79,<->,196.90.173.61,5,274,0,0,5,274,0.200296000,1.5600
215.158.61.242,<->,136.25.189.222,0,0,5,6749,5,6749,0.200056000,0.0000
192.226.161.66,<->,133.178.227.70,0,0,5,1629,5,1629,0.199538000,0.4008
204.200.45.252,<->,136.25.188.209,0,0,5,1110,5,1110,0.199457000,0.1468
215.158.239.57,<->,204.0.205.117,5,328,0,0,5,328,0.199428000,1.0005
136.25.189.47,<->,8.215.68.89,5,3010,0,0,5,3010,0.199293000,1.0872
109.1.9.205,<->,104.254.142.11,5,6040,0,0,5,6040,0.199212000,1.7460
215.158.239.97,<->,207.190.37.33,5,280,0,0,5,280,0.198988000,1.4200
215.158.239.99,<->,142.247.228.137,5,1123,0,0,5,1123,0.196904000,0.5354
220.6.92.146,<->,8.182.235.164,0,0,5,478,5,478,0.195866000,0.0571
204.185.153.50,<->,136.25.188.242,0,0,5,1118,5,1118,0.193964000,0.6002
215.158.239.109,<->,215.158.61.182,5,2908,0,0,5,2908,0.193796000,1.7227
136.25.189.30,<->,8.222.58.213,5,2818,0,0,5,2818,0.193454000,0.5879
141.184.244.243,<->,100.228.42.88,0,0,5,3533,5,3533,0.192477000,0.4447
50.224.76.235,<->,38.71.185.219,5,256,0,0,5,256,0.192470000,0.6099
142.168.10.21,<->,80.38.62.79,0,0,5,250,5,250,0.191434000,1.5881
215.158.239.30,<->,8.255.92.65,5,1414,0,0,5,1414,0.191217000,0.0328
215.158.239.56,<->,199.20.29.156,5,618,0,0,5,618,0.191105000,1.4598
92.27.219.149,<->,57.3.164.69,5,7170,0,0,5,7170,0.189244000,0.0520
136.25.188.172,<->,113.23.104.221,5,1485,0,0,5,1485,0.189084000,0.7987
93.181.154.87,<->,92.27.219.249,0,0,5,256,5,256,0.188758000,0.5089
215.158.61.203,<->,8.176.8.183,0,0,5,6354,5,6354,0.187908000,0.0001
133.12.93.126,<->,50.224.61.152,0,0,5,7480,5,7480,0.184936000,1.4384
213.221.90.156,<->,50.224.76.234,0,0,5,982,5,982,0.184464000,0.1061
112.208.20.158,<->,101.238.100.15,0,0,5,1524,5,1524,0.184280000,1.0780
148.226.51.110,<->,50.224.76.230,0,0,5,743,5,743,0.184009000,0.2910
142.255.37.135,<->,136.25.188.225,0,0,5,356,5,356,0.183176000,0.0144
113.173.255.196,<->,92.162.253.115,0,0,5,4981,5,4981,0.182536000,0.1120
215.158.239.99,<->,207.213.103.43,5,1202,0,0,5,1202,0.181925000,0.2601
243.117.82.135,<->,144.86.144.224,0,0,5,1158,5,1158,0.180318000,0.2144
215.158.239.95,<->,194.199.218.39,5,950,0,0,5,950,0.180159000,0.3998
215.158.239.101,<->,129.222.39.218,5,1172,0,0,5,1172,0.179741000,1.0449
149.150.11.46,<->,139.163.5.140,0,0,5,318,5,318,0.177246000,0.2797
117.20.48.130,<->,50.224.76.235,0,0,5,745,5,745,0.177027000,0.2121
136.25.188.252,<->,112.235.95.11,5,1517,0,0,5,1517,0.176683000,0.3918
98.23.105.53,<->,8.252.221.171,0,0,5,875,5,875,0.176419000,0.6082
215.158.238.97,<->,199.63.178.200,5,280,0,0,5,280,0.176395000,0.0018
240.171.101.60,<->,212.164.136.25,0,0,5,280,5,280,0.176224000,1.5938
137.165.179.99,<->,92.162.253.49,0,0,5,6979,5,6979,0.176072000,0.0000
215.158.239.57,<->,199.20.30.202,5,292,0,0,5,292,0.175990000,0.0151
207.160.220.252,<->,0.195.210.35,0,0,5,4549,5,4549,0.175759000,0.8005
215.158.239.49,<->,8.249.253.226,5,2738,0,0,5,2738,0.175464000,0.5451
192.64.217.166,<->,122.109.241.138,5,318,0,0,5,318,0.175437000,0.3918
199.38.230.179,<->,136.25.188.209,0,0,5,793,5,793,0.174800000,0.3472
195.13.185.107,<->,136.25.188.178,0,0,5,356,5,356,0.174027000,0.0074
139.50.219.103,<->,97.198.98.78,0,0,5,250,5,250,0.173969000,1.1110
215.158.239.96,<->,199.20.28.252,5,1055,0,0,5,1055,0.172311000,1.2853
120.118.68.174,<->,50.224.76.234,0,0,5,985,5,985,0.172130000,0.3089
148.190.124.23,<->,133.178.227.79,0,0,5,1326,5,1326,0.171561000,0.1631
215.158.239.48,<->,207.56.159.104,5,610,0,0,5,610,0.170814000,1.6294
215.158.238.141,<->,113.23.117.117,5,1469,0,0,5,1469,0.170713000,1.6237
215.158.239.57,<->,196.93.237.136,5,350,0,0,5,350,0.169902000,0.0408
142.227.132.171,<->,136.25.188.225,0,0,5,1122,5,1122,0.169861000,0.3947
205.20.150.175,<->,109.1.16.10,0,0,5,318,5,318,0.168347000,0.6741
136.25.188.163,<->,8.222.212.22,5,1437,0,0,5,1437,0.168287000,0.1511
136.25.188.52,<->,6.73.9.188,5,2738,0,0,5,2738,0.168219000,1.7544
197.113.99.146,<->,136.25.188.220,0,0,5,797,5,797,0.166626000,1.6499
215.158.239.58,<->,196.89.8.21,5,856,0,0,5,856,0.166577000,0.5015
133.178.227.76,<->,133.56.180.87,5,1564,0,0,5,1564,0.166279000,0.0385
215.158.239.58,<->,204.226.22.61,5,945,0,0,5,945,0.165316000,0.1683
215.158.239.33,<->,114.142.109.166,5,1763,0,0,5,1763,0.165071000,0.1213
136.25.188.254,<->,118.20.87.61,5,280,0,0,5,280,0.164924000,0.0015
146.249.226.127,<->,8.252.222.133,0,0,5,954,5,954,0.164674000,0.4898
223.115.250.102,<->,8.252.221.206,0,0,5,620,5,620,0.164132000,1.2411
206.17.243.41,<->,109.1.54.101,0,0,5,766,5,766,0.162415000,1.3270
223.143.26.18,<->,92.27.27.148,0,0,5,250,5,250,0.162282000,1.4733
215.158.239.34,<->,126.219.102.181,5,1703,0,0,5,1703,0.161689000,1.6292
207.87.58.96,<->,136.25.188.163,0,0,5,394,5,394,0.160400000,0.2435
149.163.129.232,<->,136.25.189.14,0,0,5,2754,5,2754,0.160346000,0.6005
215.158.239.7,<->,118.20.114.86,5,1814,0,0,5,1814,0.159854000,0.1181
207.173.206.252,<->,136.25.188.44,0,0,5,862,5,862,0.159851000,1.5802
139.36.119.127,<->,133.178.226.235,0,0,5,288,5,288,0.159787000,0.0539
215.158.238.133,<->,192.205.37.221,5,1359,0,0,5,1359,0.159738000,0.0330
215.158.239.97,<->,113.92.151.94,5,3041,0,0,5,3041,0.159661000,1.5590
215.158.239.78,<->,196.109.175.222,5,1139,0,0,5,1139,0.159433000,1.6908
215.158.140.206,<->,8.222.7.155,5,2991,0,0,5,2991,0.158490000,1.8218
53.148.20.156,<->,48.53.11.144,0,0,5,4912,5,4912,0.158399000,0.0015
136.25.188.55,<->,111.150.186.246,5,2085,0,0,5,2085,0.158258000,0.3456
149.230.23.62,<->,89.183.104.243,0,0,5,5634,5,5634,0.157956000,1.3013
145.116.118.68,<->,66.13.81.240,5,468,0,0,5,468,0.157906000,0.7463
35.56.97.26,<->,35.55.57.164,5,609,0,0,5,609,0.157656000,0.8018
143.68.58.254,<->,136.25.188.225,0,0,5,280,5,280,0.157553000,0.1060
117.252.133.1,<->,50.224.76.234,0,0,5,1275,5,1275,0.156996000,0.2243
220.20.206.14,<->,129.78.117.164,0,0,5,909,5,909,0.155663000,0.1974
215.158.239.5,<->,57.210.104.235,5,1740,0,0,5,1740,0.155195000,0.1177
215.158.239.95,<->,199.106.66.60,5,365,0,0,5,365,0.155053000,1.7799
133.178.226.90,<->,61.72.108.214,5,1437,0,0,5,1437,0.154739000,1.8303
198.157.156.29,<->,139.163.5.140,0,0,5,619,5,619,0.154646000,0.2200
215.158.238.59,<->,99.192.168.182,5,3011,0,0,5,3011,0.154198000,1.7880
133.178.226.67,<->,133.56.180.93,5,2527,0,0,5,2527,0.153517000,1.6130
215.158.239.42,<->,8.241.236.200,5,2339,0,0,5,2339,0.153089000,0.1233
215.158.61.182,<->,8.176.8.247,0,0,5,6269,5,6269,0.152638000,0.0000
215.158.238.135,<->,113.23.104.215,5,2610,0,0,5,2610,0.152245000,0.6507
204.62.188.165,<->,136.25.188.196,0,0,5,356,5,356,0.152068000,1.4399
199.7.179.250,<->,8.52.222.23,0,0,5,812,5,812,0.151576000,0.4740
143.79.114.100,<->,136.25.188.173,0,0,5,376,5,376,0.151404000,1.6611
195.6.43.35,<->,136.25.188.174,0,0,5,340,5,340,0.150781000,0.6516
136.220.241.83,<->,136.25.188.196,0,0,5,250,5,250,0.150577000,0.0017
98.236.194.252,<->,61.63.234.230,5,268,0,0,5,268,0.150557000,1.6921
136.25.189.82,<->,126.219.191.20,5,1405,0,0,5,1405,0.150167000,0.7445
142.208.39.25,<->,136.25.188.162,0,0,5,356,5,356,0.149745000,0.0116
144.75.218.237,<->,138.127.224.104,5,1595,0,0,5,1595,0.149357000,1.5499
215.158.238.243,<->,131.1.195.27,5,1437,0,0,5,1437,0.149356000,0.1265
133.54.17.207,<->,57.4.50.131,5,436,0,0,5,436,0.149347000,1.4587
215.158.239.57,<->,196.89.72.199,5,250,0,0,5,250,0.148734000,0.0118
247.136.227.198,<->,98.181.20.37,5,1378,0,0,5,1378,0.148459000,0.2708
136.25.188.172,<->,29.214.64.199,5,1581,0,0,5,1581,0.147616000,1.0111
89.183.106.29,<->,42.226.41.119,5,2273,0,0,5,2273,0.147567000,1.1872
215.158.238.9,<->,96.38.231.124,5,3106,0,0,5,3106,0.146936000,1.1585
106.145.155.77,<->,92.27.27.181,0,0,5,433,5,433,0.146727000,0.3695
192.64.211.88,<->,118.85.247.93,5,260,0,0,5,260,0.145952000,1.2755
215.158.61.243,<->,8.176.8.233,0,0,5,6125,5,6125,0.144855000,0.0000
69.128.170.175,<->,6.130.64.218,5,318,0,0,5,318,0.144602000,0.5620
93.151.122.182,<->,50.224.76.234,0,0,5,1527,5,1527,0.144008000,0.4634
100.83.51.93,<->,97.126.113.243,0,0,5,1039,5,1039,0.143415000,1.5451
215.158.239.86,<->,199.20.30.122,5,356,0,0,5,356,0.142613000,0.0303
195.22.148.17,<->,50.224.76.235,0,0,5,927,5,927,0.140727000,0.4421
95.245.183.230,<->,8.252.222.221,0,0,5,324,5,324,0.140543000,0.2965
197.113.99.176,<->,136.25.188.199,0,0,5,280,5,280,0.139885000,0.6100
215.158.239.78,<->,196.94.114.231,5,280,0,0,5,280,0.138051000,1.2214
142.223.165.143,<->,136.25.188.176,0,0,5,863,5,863,0.136955000,1.4267
200.174.192.136,<->,54.37.1.37,5,3446,0,0,5,3446,0.136895000,0.4495
136.25.188.242,<->,126.219.58.56,5,1341,0,0,5,1341,0.136134000,0.1110
215.158.239.87,<->,156.165.37.111,5,2814,0,0,5,2814,0.135874000,1.1766
215.158.61.189,<->,8.176.8.186,0,0,5,4158,5,4158,0.135867000,1.6081
58.50.189.56,<->,0.195.210.8,0,0,5,316,5,316,0.135612000,0.0030
215.158.239.96,<->,199.20.4.111,5,1246,0,0,5,1246,0.135399000,0.2000
215.158.238.251,<->,76.100.141.56,5,3396,0,0,5,3396,0.135109000,1.3277
215.158.238.45,<->,122.159.34.246,5,2594,0,0,5,2594,0.135045000,0.8860
143.134.173.239,<->,136.25.188.45,0,0,5,280,5,280,0.134774000,0.0067
199.90.249.232,<->,50.223.3.228,0,0,5,250,5,250,0.134761000,1.5620
133.178.227.41,<->,8.57.163.136,5,352,0,0,5,352,0.134717000,0.4882
32.233.112.4,<->,8.220.190.86,0,0,5,860,5,860,0.134257000,0.3695
110.65.202.237,<->,50.224.76.235,0,0,5,2742,5,2742,0.133944000,0.4656
143.10.113.121,<->,136.25.188.209,0,0,5,280,5,280,0.133901000,0.0177
142.255.148.143,<->,136.25.188.162,0,0,5,314,5,314,0.131599000,0.0136
220.28.114.28,<->,215.158.239.54,0,0,5,572,5,572,0.131566000,0.0796
215.158.239.93,<->,195.81.124.45,5,356,0,0,5,356,0.130824000,0.0001
204.58.178.191,<->,136.25.188.253,0,0,5,250,5,250,0.129149000,1.1489
106.186.17.103,<->,100.95.2.121,0,0,5,256,5,256,0.129052000,1.3362
138.98.250.39,<->,136.225.134.120,5,250,0,0,5,250,0.128874000,1.5987
206.243.231.162,<->,111.147.176.215,0,0,5,1909,5,1909,0.128572000,0.0944
111.147.102.192,<->,54.69.66.169,5,357,0,0,5,357,0.128024000,0.5598
215.158.238.96,<->,29.214.71.102,5,1597,0,0,5,1597,0.127791000,0.2251
133.178.226.29,<->,119.196.23.41,5,1389,0,0,5,1389,0.127451000,1.1780
112.7.58.75,<->,50.224.76.230,0,0,5,1043,5,1043,0.127319000,0.3528
102.45.233.201,<->,92.162.252.139,0,0,5,385,5,385,0.127178000,0.0609
215.158.239.81,<->,139.69.162.57,5,6157,0,0,5,6157,0.127109000,0.0000
215.158.238.83,<->,139.160.226.200,5,2754,0,0,5,2754,0.126378000,1.8300
36.123.54.244,<->,8.20.87.32,0,0,5,473,5,473,0.126107000,0.4913
215.158.239.77,<->,207.188.56.160,5,1460,0,0,5,1460,0.124880000,1.6790
212.164.136.25,<->,91.69.181.233,5,280,0,0,5,280,0.123867000,1.5990
148.165.26.29,<->,139.193.141.139,0,0,5,2025,5,2025,0.123578000,0.2877
247.136.177.71,<->,42.36.26.179,5,1164,0,0,5,1164,0.123536000,0.8800
199.72.54.141,<->,136.25.188.163,0,0,5,250,5,250,0.123339000,0.0178
98.158.87.56,<->,8.182.250.109,0,0,5,2169,5,2169,0.123175000,0.1580
136.25.189.14,<->,117.155.166.219,5,1501,0,0,5,1501,0.123067000,1.6071
136.25.189.32,<->,120.154.71.4,5,2834,0,0,5,2834,0.121569000,0.6348
239.66.110.113,<->,203.215.177.38,0,0,5,1123,5,1123,0.121253000,1.2278
107.112.199.42,<->,50.224.49.211,0,0,5,250,5,250,0.120625000,1.6003
94.194.24.162,<->,8.252.221.197,0,0,5,352,5,352,0.120588000,0.1847
136.25.188.254,<->,113.23.104.214,5,280,0,0,5,280,0.120405000,0.4444
221.102.56.69,<->,6.74.193.170,0,0,5,520,5,520,0.120078000,0.8622
215.158.239.77,<->,204.3.27.64,5,280,0,0,5,280,0.119272000,0.2392
143.20.20.122,<->,50.224.76.234,0,0,5,1844,5,1844,0.118858000,0.3215
215.158.239.50,<->,199.20.30.198,5,280,0,0,5,280,0.118772000,0.4956
89.183.104.174,<->,78.48.176.130,5,371,0,0,5,371,0.118573000,1.5801
111.147.118.136,<->,53.214.110.173,5,4365,0,0,5,4365,0.118228000,0.0899
194.237.250.14,<->,136.25.188.236,0,0,5,381,5,381,0.117907000,0.4480
215.158.140.202,<->,72.151.67.38,5,448,0,0,5,448,0.116413000,0.2959
215.158.239.85,<->,199.20.31.215,5,1005,0,0,5,1005,0.116148000,0.4390
111.20.172.70,<->,111.20.168.154,0,0,5,587,5,587,0.113913000,1.0066
215.158.239.76,<->,196.106.160.202,5,280,0,0,5,280,0.113772000,0.5100
215.158.140.207,<->,144.114.39.18,5,652,0,0,5,652,0.113340000,0.0401
106.168.190.223,<->,99.72.116.212,0,0,5,613,5,613,0.113074000,1.4438
50.224.76.235,<->,27.153.116.94,5,939,0,0,5,939,0.112140000,0.3703
111.20.172.70,<->,111.20.168.13,0,0,5,561,5,561,0.112079000,1.0031
111.20.172.70,<->,33.233.141.26,0,0,5,702,5,702,0.111477000,0.0099
195.122.196.132,<->,50.223.3.228,0,0,5,256,5,256,0.111427000,0.0960
149.163.134.245,<->,133.178.227.16,0,0,5,280,5,280,0.111383000,0.0001
140.145.218.36,<->,133.178.227.217,0,0,5,672,5,672,0.110957000,0.2170
6.145.150.41,<->,0.195.210.44,0,0,5,653,5,653,0.110709000,1.8260
215.158.238.133,<->,212.70.217.101,5,2754,0,0,5,2754,0.109131000,1.8081
215.158.238.107,<->,48.129.133.48,5,280,0,0,5,280,0.108611000,0.0006
215.158.239.17,<->,8.255.92.117,5,2601,0,0,5,2601,0.108517000,0.9156
142.190.17.168,<->,136.25.188.239,0,0,5,1584,5,1584,0.107635000,1.3888
8.252.222.224,<->,4.123.76.148,5,522,0,0,5,522,0.107264000,0.3109
111.20.172.70,<->,111.20.168.142,0,0,5,728,5,728,0.106959000,0.9976
215.158.239.84,<->,207.63.134.113,5,280,0,0,5,280,0.106849000,1.7822
159.47.115.192,<->,138.98.250.39,0,0,5,250,5,250,0.105189000,1.5977
132.211.48.38,<->,80.40.61.48,0,0,5,255,5,255,0.104937000,1.6993
111.20.172.70,<->,111.20.168.21,0,0,5,706,5,706,0.103646000,0.9996
204.187.124.135,<->,136.25.188.46,0,0,5,356,5,356,0.102705000,0.0098
199.68.218.153,<->,136.25.188.55,0,0,5,1770,5,1770,0.101352000,1.0694
210.220.217.226,<->,54.50.173.203,5,910,0,0,5,910,0.099982000,0.0042
200.174.194.174,<->,54.37.1.37,5,2191,0,0,5,2191,0.099908000,0.3150
215.158.140.87,<->,114.75.170.84,5,355,0,0,5,355,0.099415000,0.1217
8.252.223.175,<->,8.192.205.75,5,2356,0,0,5,2356,0.099107000,1.6111
111.20.172.70,<->,33.233.141.50,0,0,5,760,5,760,0.098940000,0.9945
215.158.239.209,<->,145.234.121.48,5,1507,0,0,5,1507,0.098173000,1.1209
215.158.61.195,<->,8.176.8.225,0,0,5,1827,5,1827,0.098167000,1.3901
204.3.4.64,<->,136.25.188.224,0,0,5,280,5,280,0.097798000,0.0518
220.20.200.56,<->,119.159.22.233,5,590,0,0,5,590,0.097287000,0.2188
231.136.216.8,<->,136.25.188.238,0,0,5,350,5,350,0.097217000,0.0079
129.236.64.94,<->,129.224.112.252,0,0,5,400,5,400,0.097103000,0.0247
195.127.59.18,<->,136.25.188.54,0,0,5,356,5,356,0.096497000,0.0068
215.158.239.50,<->,131.2.102.23,5,3927,0,0,5,3927,0.095897000,1.8895
215.158.238.81,<->,32.183.36.33,5,2594,0,0,5,2594,0.095384000,1.3188
124.31.227.155,<->,50.224.76.234,0,0,5,2069,5,2069,0.095364000,0.1278
220.28.114.28,<->,133.178.227.6,0,0,5,572,5,572,0.094473000,0.0575
215.158.238.123,<->,126.219.196.170,5,1565,0,0,5,1565,0.094306000,0.1195
117.32.177.100,<->,50.224.76.234,0,0,5,1105,5,1105,0.092627000,0.5795
215.158.239.58,<->,199.20.5.176,5,1015,0,0,5,1015,0.091575000,0.5107
215.158.239.56,<->,204.61.244.226,5,590,0,0,5,590,0.091559000,0.6170
215.158.239.56,<->,196.93.226.91,5,950,0,0,5,950,0.090834000,1.3198
231.142.8.154,<->,136.25.188.238,0,0,5,356,5,356,0.090777000,0.0069
207.173.19.189,<->,136.25.188.174,0,0,5,298,5,298,0.090567000,0.3700
111.20.172.70,<->,33.233.141.47,0,0,5,564,5,564,0.090463000,0.9990
215.158.238.73,<->,193.10.94.22,5,280,0,0,5,280,0.090395000,0.0008
133.178.226.19,<->,119.168.0.145,5,1405,0,0,5,1405,0.090295000,0.3453
8.228.221.102,<->,0.48.112.144,5,821,0,0,5,821,0.090139000,1.8292
159.190.89.148,<->,8.182.253.40,0,0,5,1389,5,1389,0.089766000,0.2396
111.20.172.70,<->,33.233.141.81,0,0,5,545,5,545,0.088920000,0.9956
215.158.238.45,<->,112.235.95.75,5,3831,0,0,5,3831,0.087462000,1.8928
94.194.229.217,<->,8.252.222.140,0,0,5,954,5,954,0.087153000,0.2804
215.158.239.70,<->,199.20.29.132,5,942,0,0,5,942,0.086069000,0.3900
215.158.239.58,<->,196.94.143.43,5,356,0,0,5,356,0.085874000,0.0600
92.27.219.39,<->,78.45.201.41,5,519,0,0,5,519,0.085005000,1.5710
92.27.219.215,<->,53.75.225.119,5,5200,0,0,5,5200,0.083908000,0.2623
215.158.238.45,<->,57.227.189.165,5,1549,0,0,5,1549,0.083600000,0.1084
129.236.100.161,<->,129.224.112.252,0,0,5,378,5,378,0.083453000,0.0206
111.20.172.70,<->,101.224.89.136,0,0,5,556,5,556,0.083157000,1.0098
215.158.239.78,<->,194.203.39.243,5,356,0,0,5,356,0.082166000,0.1600
215.158.140.173,<->,83.252.76.100,5,449,0,0,5,449,0.081897000,0.0573
248.239.96.151,<->,8.52.178.59,0,0,5,433,5,433,0.081674000,0.0719
139.163.163.176,<->,133.178.227.40,0,0,5,2469,5,2469,0.081044000,1.1783
195.40.113.60,<->,136.25.188.45,0,0,5,356,5,356,0.080569000,0.0135
148.240.80.52,<->,50.224.76.235,0,0,5,753,5,753,0.079897000,0.1210
213.221.90.140,<->,50.224.49.211,0,0,5,280,5,280,0.078145000,1.6008
192.64.204.68,<->,125.37.55.102,5,888,0,0,5,888,0.077160000,1.1679
197.125.110.221,<->,136.25.189.77,0,0,5,2674,5,2674,0.076955000,1.1795
122.192.58.162,<->,92.27.219.178,0,0,5,5884,5,5884,0.076650000,1.8552
144.75.218.242,<->,99.168.7.150,5,651,0,0,5,651,0.076605000,1.7410
199.50.75.59,<->,136.25.188.254,0,0,5,280,5,280,0.076486000,0.0195
136.25.188.240,<->,113.23.104.247,5,2450,0,0,5,2450,0.076206000,1.1365
111.20.172.70,<->,33.233.141.70,0,0,5,684,5,684,0.075567000,1.1132
195.14.225.61,<->,136.25.188.252,0,0,5,280,5,280,0.075541000,0.0063
139.163.8.98,<->,56.8.154.179,5,250,0,0,5,250,0.074802000,1.5400
197.113.64.180,<->,136.25.188.254,0,0,5,299,5,299,0.074792000,0.2805
136.25.188.53,<->,57.210.107.42,5,1485,0,0,5,1485,0.074413000,0.5173
195.40.32.9,<->,136.25.188.174,0,0,5,292,5,292,0.074311000,0.2240
136.138.112.15,<->,133.178.226.28,0,0,5,1520,5,1520,0.074215000,0.0642
204.184.152.197,<->,136.25.188.243,0,0,5,280,5,280,0.074202000,1.2400
142.174.222.235,<->,102.50.179.199,0,0,5,342,5,342,0.074199000,1.8782
133.178.227.12,<->,133.56.180.22,5,2987,0,0,5,2987,0.073548000,0.2054
215.158.140.83,<->,89.86.110.223,5,280,0,0,5,280,0.072985000,0.0012
136.25.189.1,<->,96.156.169.232,5,2754,0,0,5,2754,0.072900000,1.4940
194.233.169.234,<->,136.25.188.243,0,0,5,280,5,280,0.072752000,0.2810
215.158.238.80,<->,136.138.112.232,5,1581,0,0,5,1581,0.071605000,0.0589
119.128.250.34,<->,50.224.76.248,0,0,5,1432,5,1432,0.071134000,0.7070
125.199.233.239,<->,8.182.230.134,0,0,5,516,5,516,0.070890000,0.3087
200.175.118.228,<->,53.148.90.97,5,1380,0,0,5,1380,0.070726000,1.6224
215.158.239.40,<->,122.29.158.180,5,1683,0,0,5,1683,0.070636000,0.2689
196.119.218.162,<->,50.224.76.235,0,0,5,1325,5,1325,0.070610000,0.6972
215.158.239.77,<->,142.208.41.233,5,932,0,0,5,932,0.069692000,0.2370
136.25.188.55,<->,120.154.221.215,5,1565,0,0,5,1565,0.069485000,0.1622
199.70.213.175,<->,136.25.188.225,0,0,5,356,5,356,0.069416000,0.0059
215.158.239.50,<->,196.91.242.68,5,356,0,0,5,356,0.069405000,0.0400
215.158.239.51,<->,195.49.91.63,5,462,0,0,5,462,0.068949000,0.1806
199.73.34.80,<->,136.25.188.225,0,0,5,356,5,356,0.068273000,0.0530
140.28.153.136,<->,139.163.96.94,0,0,5,250,5,250,0.068158000,1.6098
215.158.239.48,<->,195.13.176.139,5,1005,0,0,5,1005,0.068099000,0.2849
215.158.239.48,<->,142.254.79.79,5,250,0,0,5,250,0.068091000,0.0783
215.158.238.83,<->,113.23.104.220,5,2562,0,0,5,2562,0.067371000,1.3469
215.158.238.74,<->,113.23.104.220,5,2722,0,0,5,2722,0.067306000,0.7905
136.139.59.124,<->,133.178.226.29,0,0,5,280,5,280,0.067090000,0.0007
80.40.50.197,<->,33.198.250.108,5,1250,0,0,5,1250,0.065819000,1.6180
215.158.239.50,<->,207.60.212.34,5,356,0,0,5,356,0.065590000,0.0092
215.158.238.75,<->,112.220.206.116,5,1437,0,0,5,1437,0.065522000,0.1817
215.158.238.9,<->,114.150.180.148,5,1481,0,0,5,1481,0.065456000,0.3415
141.95.30.9,<->,129.224.112.252,0,0,5,375,5,375,0.065295000,1.8118
111.20.172.70,<->,33.233.141.89,0,0,5,644,5,644,0.065259000,1.0264
215.158.239.95,<->,207.115.175.147,5,1054,0,0,5,1054,0.064778000,0.3171
133.178.227.19,<->,29.214.211.55,5,1256,0,0,5,1256,0.064507000,1.1582
133.178.226.28,<->,96.155.60.212,5,1855,0,0,5,1855,0.064218000,0.0639
215.158.239.85,<->,199.20.31.87,5,2073,0,0,5,2073,0.064194000,1.0325
195.54.2.67,<->,136.25.188.54,0,0,5,250,5,250,0.064024000,0.0104
207.204.177.249,<->,50.224.76.234,0,0,5,1389,5,1389,0.063210000,0.4551
215.158.239.95,<->,199.32.175.22,5,842,0,0,5,842,0.063022000,1.7757
215.158.239.33,<->,6.29.97.36,5,280,0,0,5,280,0.062865000,0.0008
135.253.99.85,<->,98.236.235.218,0,0,5,250,5,250,0.062260000,1.7360
215.158.239.50,<->,199.20.7.43,5,1117,0,0,5,1117,0.061688000,1.8344
231.140.229.197,<->,215.158.239.84,0,0,5,429,5,429,0.061552000,0.2935
136.25.189.89,<->,29.213.219.37,5,2722,0,0,5,2722,0.061373000,1.5759
215.158.239.58,<->,199.15.1.33,5,954,0,0,5,954,0.061297000,1.9222
159.137.162.213,<->,112.24.92.10,5,826,0,0,5,826,0.059758000,0.5164
215.158.239.95,<->,194.251.120.248,5,984,0,0,5,984,0.058154000,0.1983
17.5.13.116,<->,8.220.191.251,0,0,5,667,5,667,0.058084000,0.6799
136.25.188.196,<->,131.144.114.209,5,1549,0,0,5,1549,0.058052000,0.5453
140.174.80.101,<->,136.25.188.161,0,0,5,1597,5,1597,0.057892000,1.8920
222.62.112.179,<->,48.53.187.107,0,0,5,600,5,600,0.057882000,1.6202
136.25.189.0,<->,29.211.228.154,5,2863,0,0,5,2863,0.056545000,0.4417
231.143.83.110,<->,136.25.188.53,0,0,5,316,5,316,0.055613000,0.4901
106.186.17.103,<->,100.95.21.226,0,0,5,726,5,726,0.055165000,0.5983
207.239.171.238,<->,136.25.188.198,0,0,5,280,5,280,0.054781000,0.4765
146.249.227.152,<->,8.252.221.221,0,0,5,304,5,304,0.054717000,1.4002
199.52.66.100,<->,136.25.188.178,0,0,5,337,5,337,0.053408000,0.0583
136.25.189.78,<->,96.156.169.221,5,1517,0,0,5,1517,0.053172000,0.8774
196.206.251.113,<->,136.25.188.222,0,0,5,496,5,496,0.052973000,0.0001
138.127.224.225,<->,111.20.168.215,0,0,5,1200,5,1200,0.051636000,0.0116
136.25.188.160,<->,113.23.104.247,5,2546,0,0,5,2546,0.051279000,1.6854
220.26.140.14,<->,133.178.227.108,0,0,5,1190,5,1190,0.050344000,1.4974
159.137.243.168,<->,143.52.91.253,5,775,0,0,5,775,0.050297000,1.6492
129.236.64.99,<->,129.224.112.252,0,0,5,386,5,386,0.050127000,0.0395
215.158.61.183,<->,8.176.8.213,0,0,5,6205,5,6205,0.049838000,0.0001
215.158.239.71,<->,195.6.45.207,5,691,0,0,5,691,0.049441000,0.6600
106.168.190.223,<->,100.94.147.232,0,0,5,2187,5,2187,0.049360000,1.1887
133.178.226.71,<->,29.214.108.190,5,280,0,0,5,280,0.049216000,0.0006
116.111.122.136,<->,101.73.152.237,0,0,5,644,5,644,0.048803000,0.6770
87.1.164.149,<->,8.52.154.162,0,0,5,590,5,590,0.048561000,0.0608
159.70.27.69,<->,144.86.146.31,0,0,5,4321,5,4321,0.048467000,0.0251
195.71.143.161,<->,136.25.188.255,0,0,5,812,5,812,0.048411000,0.3481
79.210.154.10,<->,50.224.76.234,0,0,5,1807,5,1807,0.047822000,0.5590
143.10.203.192,<->,136.25.188.196,0,0,5,812,5,812,0.047714000,0.2795
158.85.50.170,<->,133.178.227.16,0,0,5,1319,5,1319,0.047620000,0.4477
124.41.84.151,<->,92.162.253.131,0,0,5,3860,5,3860,0.047575000,0.1306
195.70.37.130,<->,136.25.188.52,0,0,5,356,5,356,0.047204000,0.0072
197.109.193.7,<->,136.25.188.173,0,0,5,1023,5,1023,0.047056000,0.4801
192.227.190.231,<->,136.25.188.221,0,0,5,1597,5,1597,0.047036000,1.7863
215.158.239.85,<->,207.115.211.93,5,364,0,0,5,364,0.046519000,1.4399
143.132.89.47,<->,136.25.188.175,0,0,5,516,5,516,0.046231000,1.7160
215.158.239.51,<->,199.20.30.210,5,590,0,0,5,590,0.045852000,0.7290
159.137.243.209,<->,127.20.87.202,5,923,0,0,5,923,0.045524000,0.5404
241.14.130.240,<->,80.38.36.113,0,0,5,970,5,970,0.045519000,1.2315
220.28.89.239,<->,97.126.119.92,0,0,5,3521,5,3521,0.045448000,1.3089
220.39.233.169,<->,133.178.226.37,0,0,5,2690,5,2690,0.045310000,1.5616
215.158.239.78,<->,199.79.113.71,5,341,0,0,5,341,0.044818000,1.0798
215.158.239.97,<->,199.20.28.197,5,268,0,0,5,268,0.044635000,1.5799
215.158.239.59,<->,199.20.31.218,5,344,0,0,5,344,0.043939000,1.4799
138.98.250.43,<->,99.154.2.55,5,250,0,0,5,250,0.043174000,1.5982
207.57.142.46,<->,136.25.188.55,0,0,5,256,5,256,0.042606000,0.2966
215.158.238.92,<->,122.158.67.229,5,2594,0,0,5,2594,0.042486000,1.7093
92.27.219.191,<->,33.57.78.105,5,250,0,0,5,250,0.042112000,0.1586
215.158.239.70,<->,196.94.6.49,5,473,0,0,5,473,0.042053000,1.4243
97.126.113.29,<->,53.190.213.15,5,688,0,0,5,688,0.041965000,0.0904
50.224.76.234,<->,38.182.145.45,5,250,0,0,5,250,0.041843000,0.2853
215.158.238.141,<->,112.220.206.22,5,1516,0,0,5,1516,0.041342000,1.0073
43.52.108.187,<->,8.252.221.204,0,0,5,250,5,250,0.040456000,0.0121
198.8.34.104,<->,139.163.5.140,0,0,5,312,5,312,0.039445000,0.2596
215.158.238.80,<->,122.158.51.86,5,2770,0,0,5,2770,0.038116000,1.4636
69.169.12.111,<->,8.238.171.36,0,0,5,250,5,250,0.037433000,1.6221
215.158.239.40,<->,57.210.104.212,5,1628,0,0,5,1628,0.037378000,0.1768
195.68.103.22,<->,136.25.188.175,0,0,5,350,5,350,0.036704000,0.0099
195.55.229.202,<->,136.25.188.177,0,0,5,356,5,356,0.035939000,0.0071
197.109.192.192,<->,136.25.188.254,0,0,5,262,5,262,0.035922000,1.4081
222.78.138.95,<->,50.224.76.234,0,0,5,1383,5,1383,0.035724000,0.0681
196.113.189.197,<->,0.195.210.46,0,0,5,1077,5,1077,0.035667000,1.7978
133.178.226.30,<->,69.31.238.53,5,280,0,0,5,280,0.033622000,0.0762
215.158.239.59,<->,199.20.28.37,5,256,0,0,5,256,0.033230000,0.6000
139.163.1.138,<->,116.229.128.136,5,444,0,0,5,444,0.033168000,0.3629
199.68.100.152,<->,136.25.188.174,0,0,5,356,5,356,0.032330000,0.0118
111.14.244.244,<->,8.182.252.86,0,0,5,250,5,250,0.031830000,1.9602
215.158.238.250,<->,8.219.186.185,5,3040,0,0,5,3040,0.030582000,0.5290
215.158.238.243,<->,120.154.227.160,5,280,0,0,5,280,0.030517000,0.0005
195.55.122.117,<->,136.25.188.46,0,0,5,871,5,871,0.030513000,1.5391
104.142.182.228,<->,102.51.211.141,0,0,5,651,5,651,0.029915000,0.4117
243.117.82.44,<->,129.78.117.164,0,0,5,1173,5,1173,0.029576000,0.2236
53.244.1.12,<->,35.56.101.110,0,0,5,2987,5,2987,0.029534000,1.4240
194.233.73.10,<->,136.25.188.53,0,0,5,292,5,292,0.029485000,0.1653
142.253.200.78,<->,136.25.188.242,0,0,5,1121,5,1121,0.029230000,0.6578
192.67.157.104,<->,119.78.222.103,5,312,0,0,5,312,0.029173000,0.1940
216.103.78.156,<->,50.224.76.234,0,0,5,724,5,724,0.029028000,0.3805
138.127.224.225,<->,33.233.141.41,0,0,5,1199,5,1199,0.028981000,0.0064
136.25.189.81,<->,120.154.131.20,5,2705,0,0,5,2705,0.028782000,1.5103
111.40.71.197,<->,92.27.27.181,0,0,5,753,5,753,0.028755000,0.1369
119.209.96.190,<->,50.224.76.234,0,0,5,1626,5,1626,0.028269000,0.3847
194.192.28.204,<->,50.223.3.228,0,0,5,262,5,262,0.027475000,0.2712
142.208.168.215,<->,136.25.188.163,0,0,5,280,5,280,0.027399000,0.0431
224.93.235.38,<->,80.27.157.15,0,0,5,3117,5,3117,0.026941000,0.2734
99.235.201.88,<->,8.52.226.131,0,0,5,591,5,591,0.026263000,0.7080
215.158.239.99,<->,196.93.134.195,5,483,0,0,5,483,0.025577000,0.4620
194.232.200.149,<->,136.25.188.46,0,0,5,325,5,325,0.024284000,0.1424
136.25.189.0,<->,57.236.82.214,5,2782,0,0,5,2782,0.023594000,1.8376
50.224.76.235,<->,0.245.16.144,5,1095,0,0,5,1095,0.023526000,0.7485
142.244.203.132,<->,136.25.188.255,0,0,5,556,5,556,0.023524000,1.8883
204.186.129.219,<->,136.25.188.225,0,0,5,353,5,353,0.023441000,0.9575
136.25.189.30,<->,122.216.233.184,5,1725,0,0,5,1725,0.023185000,0.2039
199.60.209.85,<->,97.198.117.219,0,0,5,860,5,860,0.023007000,0.2852
199.69.192.47,<->,136.25.188.252,0,0,5,256,5,256,0.022851000,0.9974
136.25.188.243,<->,135.198.115.196,5,812,0,0,5,812,0.022682000,1.6215
215.158.239.93,<->,106.188.253.166,5,3935,0,0,5,3935,0.022401000,1.7136
215.158.239.84,<->,199.20.31.149,5,280,0,0,5,280,0.022095000,0.0196
215.158.140.177,<->,41.157.112.188,5,644,0,0,5,644,0.021659000,0.1449
247.136.252.223,<->,210.209.251.211,5,3158,0,0,5,3158,0.021484000,0.9362
215.158.238.92,<->,148.224.137.77,5,280,0,0,5,280,0.021476000,0.0010
215.158.239.56,<->,199.20.30.116,5,414,0,0,5,414,0.021184000,1.7401
215.158.239.50,<->,29.211.228.234,5,1675,0,0,5,1675,0.020625000,1.8364
95.247.99.31,<->,8.252.221.205,0,0,5,304,5,304,0.020360000,0.3921
215.158.239.56,<->,196.91.53.11,5,280,0,0,5,280,0.020126000,0.7987
215.158.238.83,<->,142.234.196.229,5,1597,0,0,5,1597,0.019829000,0.7135
207.92.60.32,<->,8.252.222.159,0,0,5,262,5,262,0.019086000,0.2052
93.251.237.157,<->,92.27.219.191,0,0,5,513,5,513,0.018371000,0.8637
215.158.239.84,<->,195.6.243.121,5,954,0,0,5,954,0.018240000,1.2963
215.158.239.68,<->,199.20.28.15,5,356,0,0,5,356,0.017974000,0.0001
215.158.239.77,<->,6.15.207.199,5,2610,0,0,5,2610,0.017755000,0.4627
142.241.17.213,<->,136.25.188.239,0,0,5,356,5,356,0.017562000,0.0133
207.172.44.213,<->,136.25.188.176,0,0,5,414,5,414,0.017460000,0.7197
117.158.196.212,<->,100.92.87.46,0,0,5,256,5,256,0.017257000,0.1780
133.178.227.29,<->,133.56.180.46,5,2529,0,0,5,2529,0.016970000,1.5079
143.42.211.61,<->,136.25.188.55,0,0,5,495,5,495,0.016958000,0.7748
136.181.51.228,<->,53.195.228.175,5,2332,0,0,5,2332,0.016901000,1.5374
136.25.189.33,<->,72.23.48.213,5,1565,0,0,5,1565,0.016877000,0.8173
220.28.65.9,<->,136.25.189.26,0,0,5,572,5,572,0.015859000,0.0506
215.158.238.96,<->,142.239.121.93,5,1517,0,0,5,1517,0.015604000,0.1390
94.194.30.83,<->,8.252.221.197,0,0,5,602,5,602,0.015428000,0.6943
215.158.239.92,<->,199.20.7.21,5,950,0,0,5,950,0.014701000,0.7293
252.98.180.173,<->,112.208.20.152,5,256,0,0,5,256,0.014613000,0.3517
246.253.253.215,<->,199.29.48.146,5,250,0,0,5,250,0.013655000,1.1586
215.158.140.92,<->,8.191.7.118,5,1626,0,0,5,1626,0.013408000,0.6753
97.68.226.205,<->,56.61.99.23,5,430,0,0,5,430,0.013396000,1.6978
195.12.76.20,<->,136.25.188.178,0,0,5,250,5,250,0.013197000,0.0648
159.137.162.213,<->,105.111.73.135,5,826,0,0,5,826,0.013168000,0.4645
136.25.189.14,<->,126.219.194.19,5,2864,0,0,5,2864,0.013095000,1.8240
247.136.231.91,<->,110.73.45.161,5,503,0,0,5,503,0.012680000,0.6985
133.178.227.79,<->,8.190.217.116,5,2352,0,0,5,2352,0.012260000,0.7576
204.184.208.155,<->,136.25.188.241,0,0,5,432,5,432,0.012219000,1.0998
133.178.226.14,<->,96.155.60.249,5,3171,0,0,5,3171,0.012209000,0.1446
215.158.239.93,<->,199.20.30.40,5,250,0,0,5,250,0.012117000,0.0200
215.158.239.49,<->,199.20.7.148,5,325,0,0,5,325,0.012030000,0.2100
215.158.44.182,<->,136.25.189.1,0,0,5,1581,5,1581,0.011842000,1.3201
207.58.195.47,<->,136.25.188.252,0,0,5,826,5,826,0.011749000,1.1573
215.158.239.56,<->,199.20.28.64,5,1056,0,0,5,1056,0.011167000,0.2700
143.132.221.128,<->,136.25.188.226,0,0,5,256,5,256,0.010937000,0.6125
207.239.171.238,<->,136.25.188.177,0,0,5,280,5,280,0.010410000,0.5204
215.158.238.95,<->,131.1.195.234,5,3091,0,0,5,3091,0.010277000,1.9027
215.158.239.68,<->,199.38.49.132,5,280,0,0,5,280,0.010201000,0.0062
207.173.179.194,<->,136.25.188.238,0,0,5,280,5,280,0.009718000,1.5603
149.163.129.241,<->,133.178.227.57,0,0,5,1261,5,1261,0.009288000,1.3300
66.217.128.239,<->,50.128.183.47,0,0,5,485,5,485,0.008961000,0.2418
194.210.128.41,<->,8.182.250.65,0,0,5,872,5,872,0.008903000,0.2966
123.92.223.41,<->,50.224.89.243,0,0,5,532,5,532,0.008695000,0.1283
215.158.239.4,<->,215.158.127.163,5,1729,0,0,5,1729,0.008685000,0.2055
136.25.188.174,<->,84.29.116.70,5,250,0,0,5,250,0.008677000,0.5929
207.57.157.50,<->,136.25.188.178,0,0,5,256,5,256,0.008213000,0.7721
215.158.239.84,<->,199.20.5.22,5,280,0,0,5,280,0.008196000,0.3449
195.124.7.219,<->,136.25.188.177,0,0,5,356,5,356,0.007523000,0.0195
195.1.112.76,<->,91.231.193.172,0,0,5,250,5,250,0.007343000,1.9827
215.158.239.95,<->,199.20.28.0,5,299,0,0,5,299,0.007328000,0.2900
215.158.238.45,<->,116.99.180.232,5,1533,0,0,5,1533,0.007124000,1.1344
17.97.197.211,<->,8.220.187.147,0,0,5,1284,5,1284,0.006663000,0.3001
133.178.226.30,<->,111.151.70.65,5,2706,0,0,5,2706,0.006619000,1.6752
207.117.20.8,<->,8.252.222.178,0,0,5,325,5,325,0.006596000,0.0239
215.158.238.121,<->,143.155.227.59,5,476,0,0,5,476,0.006565000,1.5354
149.92.32.188,<->,92.162.253.66,0,0,5,565,5,565,0.006241000,0.2968
215.158.3.131,<->,8.176.8.67,0,0,5,991,5,991,0.005713000,0.6450
215.158.239.56,<->,207.239.59.147,5,1113,0,0,5,1113,0.005573000,1.3369
133.178.226.202,<->,56.28.207.218,5,520,0,0,5,520,0.005310000,0.0909
231.140.159.21,<->,136.25.188.175,0,0,5,299,5,299,0.004823000,0.2751
98.217.2.71,<->,77.41.75.13,5,314,0,0,5,314,0.004788000,1.3341
215.158.239.95,<->,143.89.71.213,5,590,0,0,5,590,0.004300000,0.6172
133.178.226.28,<->,111.151.73.198,5,280,0,0,5,280,0.004279000,0.0762
42.66.86.95,<->,8.220.176.253,0,0,5,773,5,773,0.004263000,0.7332
246.253.132.250,<->,119.127.190.237,5,2008,0,0,5,2008,0.003922000,0.1878
215.158.239.87,<->,199.20.28.132,5,341,0,0,5,341,0.003498000,0.6815
207.200.94.18,<->,8.182.224.87,0,0,5,664,5,664,0.003410000,0.2684
247.136.175.22,<->,56.114.235.120,5,3990,0,0,5,3990,0.003171000,0.1059
215.158.239.69,<->,196.106.64.72,5,588,0,0,5,588,0.003152000,0.5939
195.0.26.234,<->,108.134.126.45,0,0,5,854,5,854,0.002884000,0.2901
249.202.197.9,<->,50.224.88.108,0,0,5,250,5,250,0.002553000,1.7408
192.227.190.20,<->,133.178.227.2,0,0,5,2364,5,2364,0.002088000,1.0857
122.206.38.212,<->,50.224.76.235,0,0,5,740,5,740,0.001980000,0.2311
212.118.48.193,<->,8.52.169.61,0,0,5,275,5,275,0.001880000,0.0675
215.158.239.68,<->,195.55.11.119,5,370,0,0,5,370,0.001075000,0.8041
215.158.146.244,<->,8.252.223.120,0,0,5,433,5,433,0.001016000,1.3149
215.158.239.126,<->,215.158.61.183,5,1730,0,0,5,1730,0.000709000,1.2834
215.158.239.48,<->,194.251.64.62,5,989,0,0,5,989,0.000691000,0.1900
215.158.239.69,<->,199.20.22.89,5,293,0,0,5,293,0.000536000,0.4199
215.158.239.78,<->,199.20.30.216,5,1124,0,0,5,1124,0.000535000,0.4299
215.158.140.201,<->,100.224.132.170,4,4607,0,0,4,4607,1.982755000,0.0000
195.14.37.76,<->,136.25.188.238,0,0,4,239,4,239,1.976425000,0.0034
133.178.226.254,<->,111.150.207.58,4,224,0,0,4,224,1.973443000,0.0228
221.102.143.189,<->,192.65.2.60,0,0,4,4533,4,4533,1.969039000,0.0030
195.55.131.131,<->,136.25.188.238,0,0,4,300,4,300,1.961619000,0.0052
215.158.239.17,<->,212.70.75.59,4,1342,0,0,4,1342,1.960352000,0.0278
136.25.188.174,<->,8.255.92.246,4,249,0,0,4,249,1.958020000,0.0274
249.101.121.157,<->,132.18.67.31,4,2370,0,0,4,2370,1.941983000,0.0572
53.231.92.232,<->,48.52.216.20,0,0,4,4570,4,4570,1.937028000,0.0001
136.25.188.230,<->,80.57.141.216,4,380,0,0,4,380,1.933843000,0.0468
199.122.43.226,<->,136.25.188.176,0,0,4,300,4,300,1.933687000,0.0060
133.178.227.245,<->,111.151.237.171,4,5349,0,0,4,5349,1.933607000,0.0000
215.158.238.79,<->,111.151.109.34,4,224,0,0,4,224,1.931981000,0.0001
196.89.112.5,<->,136.25.188.160,0,0,4,1902,4,1902,1.931553000,0.0185
101.224.182.5,<->,92.162.253.20,0,0,4,506,4,506,1.930762000,0.0675
136.25.188.179,<->,80.47.111.107,4,1285,0,0,4,1285,1.929002000,0.0543
221.102.113.220,<->,100.241.191.26,4,758,0,0,4,758,1.928842000,0.0675
133.178.227.242,<->,8.61.93.30,4,5581,0,0,4,5581,1.926257000,0.0000
99.74.26.158,<->,80.47.188.214,4,4490,0,0,4,4490,1.925629000,0.0013
133.32.39.45,<->,99.72.41.34,4,210,0,0,4,210,1.923946000,0.0682
142.240.226.24,<->,136.25.188.241,0,0,4,264,4,264,1.923843000,0.0049
195.5.64.63,<->,136.25.188.226,0,0,4,200,4,200,1.921632000,0.0061
111.150.207.87,<->,8.252.222.192,0,0,4,224,4,224,1.916442000,0.0001
215.158.140.217,<->,53.231.66.14,4,614,0,0,4,614,1.913858000,0.0775
231.140.235.239,<->,215.158.239.79,0,0,4,298,4,298,1.913358000,0.0114
218.38.100.178,<->,8.182.228.20,0,0,4,2149,4,2149,1.913290000,0.0686
102.232.97.3,<->,8.220.202.79,0,0,4,2775,4,2775,1.903730000,0.0390
133.178.226.37,<->,8.255.92.246,4,249,0,0,4,249,1.899461000,0.0252
91.57.171.43,<->,8.220.200.21,0,0,4,232,4,232,1.898308000,0.0575
215.158.239.47,<->,100.216.78.145,4,393,0,0,4,393,1.897853000,0.0939
192.67.158.190,<->,26.218.94.88,4,3114,0,0,4,3114,1.897260000,0.0676
199.38.61.185,<->,136.25.188.55,0,0,4,991,4,991,1.897187000,0.1024
237.162.205.18,<->,133.54.43.17,0,0,4,200,4,200,1.886770000,0.0043
86.135.211.208,<->,8.252.222.38,0,0,4,200,4,200,1.881956000,0.0044
195.13.254.149,<->,136.25.188.177,0,0,4,1964,4,1964,1.880561000,0.0337
192.229.216.117,<->,100.51.6.159,4,637,0,0,4,637,1.873613000,0.0911
8.55.211.213,<->,6.74.94.24,0,0,4,470,4,470,1.872864000,0.0780
210.220.219.152,<->,53.149.143.243,4,1968,0,0,4,1968,1.872277000,0.0849
192.74.126.53,<->,89.183.104.143,0,0,4,206,4,206,1.870257000,0.1293
215.158.239.57,<->,199.20.6.97,4,1639,0,0,4,1639,1.865586000,0.0707
205.127.108.113,<->,33.233.141.65,0,0,4,3623,4,3623,1.860820000,0.1116
215.158.239.101,<->,129.222.36.66,4,1599,0,0,4,1599,1.859443000,0.1206
215.158.66.184,<->,8.252.221.80,0,0,4,584,4,584,1.859238000,0.0608
197.146.100.87,<->,8.20.87.187,0,0,4,260,4,260,1.858414000,0.0500
195.14.209.131,<->,136.25.188.239,0,0,4,1055,4,1055,1.857438000,0.0059
119.69.154.213,<->,92.27.219.229,0,0,4,4244,4,4244,1.857164000,0.0288
246.253.253.107,<->,56.114.235.120,4,1142,0,0,4,1142,1.851412000,0.0463
215.158.239.84,<->,149.254.114.189,4,1493,0,0,4,1493,1.850601000,0.1417
50.53.52.221,<->,8.220.191.118,0,0,4,2400,4,2400,1.849776000,0.0244
215.158.140.173,<->,83.246.35.0,4,397,0,0,4,397,1.849754000,0.0745
195.14.69.238,<->,136.25.188.226,0,0,4,300,4,300,1.843505000,0.0065
143.79.176.241,<->,136.25.188.52,0,0,4,1813,4,1813,1.842675000,0.0184
143.35.82.200,<->,136.25.188.197,0,0,4,1890,4,1890,1.841583000,0.0207
220.80.242.167,<->,8.55.211.213,4,470,0,0,4,470,1.841097000,0.0821
117.131.120.127,<->,92.27.219.137,0,0,4,2224,4,2224,1.838943000,0.0011
215.158.238.73,<->,8.255.92.246,4,240,0,0,4,240,1.838598000,0.0300
215.158.239.94,<->,120.154.71.21,4,1461,0,0,4,1461,1.838356000,0.1415
215.158.238.50,<->,129.222.39.99,4,2977,0,0,4,2977,1.836859000,0.0265
198.107.230.163,<->,99.73.153.222,0,0,4,498,4,498,1.833386000,0.1595
143.132.139.161,<->,136.25.188.252,0,0,4,300,4,300,1.832583000,0.0160
139.254.213.90,<->,8.5.207.243,4,2512,0,0,4,2512,1.829587000,0.0779
221.102.126.240,<->,139.254.211.64,4,249,0,0,4,249,1.826968000,0.0333
215.158.239.91,<->,98.219.126.175,4,3242,0,0,4,3242,1.826453000,0.1132
17.204.25.210,<->,8.220.184.162,0,0,4,284,4,284,1.825592000,0.1440
8.55.211.213,<->,6.75.211.43,0,0,4,470,4,470,1.824358000,0.0682
111.147.236.79,<->,50.145.81.54,4,250,0,0,4,250,1.823039000,0.0182
110.16.52.39,<->,50.224.76.235,0,0,4,4113,4,4113,1.820046000,0.0228
232.104.124.176,<->,8.52.189.207,0,0,4,412,4,412,1.811028000,0.1717
8.181.147.63,<->,8.52.242.106,0,0,4,232,4,232,1.808497000,0.0444
215.158.239.31,<->,6.230.146.142,4,200,0,0,4,200,1.808080000,0.0661
231.255.222.140,<->,109.1.57.207,0,0,4,1095,4,1095,1.807969000,0.0827
109.126.217.233,<->,8.52.222.23,0,0,4,762,4,762,1.806202000,0.1091
246.254.97.109,<->,54.59.253.241,4,286,0,0,4,286,1.805316000,0.0014
192.65.127.160,<->,8.55.211.213,4,470,0,0,4,470,1.805265000,0.0723
195.7.214.220,<->,136.25.188.52,0,0,4,224,4,224,1.805184000,0.0566
192.204.123.22,<->,136.25.189.29,0,0,4,2730,4,2730,1.803456000,0.1873
215.158.238.115,<->,114.25.48.61,4,1397,0,0,4,1397,1.801830000,0.1747
100.224.138.151,<->,97.126.31.80,0,0,4,232,4,232,1.801547000,0.0885
215.158.238.188,<->,84.203.220.174,4,1211,0,0,4,1211,1.799814000,0.1950
247.136.231.39,<->,231.255.222.140,4,1060,0,0,4,1060,1.798125000,0.1166
8.222.7.155,<->,8.182.233.87,0,0,4,232,4,232,1.798057000,0.0487
142.167.98.245,<->,136.25.188.209,0,0,4,200,4,200,1.797211000,0.0046
136.25.189.34,<->,96.156.169.170,4,1669,0,0,4,1669,1.792119000,0.0922
215.158.140.230,<->,132.220.8.201,4,453,0,0,4,453,1.791776000,0.0596
247.152.222.147,<->,50.224.76.234,0,0,4,2016,4,2016,1.791678000,0.1107
92.180.152.146,<->,92.27.219.231,0,0,4,206,4,206,1.791625000,0.1313
139.241.56.117,<->,99.73.161.228,0,0,4,2272,4,2272,1.789216000,0.0686
192.172.29.39,<->,8.52.131.188,0,0,4,200,4,200,1.787649000,0.1055
136.25.188.224,<->,57.4.201.97,4,1365,0,0,4,1365,1.786851000,0.1736
129.225.132.71,<->,129.225.131.47,4,1222,0,0,4,1222,1.786454000,0.0464
26.223.52.82,<->,8.220.200.124,0,0,4,762,4,762,1.784615000,0.0636
195.14.160.106,<->,136.25.188.209,0,0,4,1121,4,1121,1.782173000,0.1818
215.158.140.231,<->,33.209.213.54,4,1223,0,0,4,1223,1.782166000,0.1230
136.25.189.1,<->,104.154.137.3,4,1397,0,0,4,1397,1.780102000,0.1758
6.145.165.231,<->,0.195.210.44,0,0,4,378,4,378,1.775558000,0.1496
136.25.188.220,<->,99.170.109.13,4,200,0,0,4,200,1.772720000,0.0266
215.158.238.65,<->,158.85.46.247,4,1397,0,0,4,1397,1.770250000,0.1028
133.178.226.60,<->,8.219.186.172,4,1221,0,0,4,1221,1.769837000,0.0576
215.158.238.141,<->,112.220.206.24,4,249,0,0,4,249,1.768747000,0.1045
109.222.221.37,<->,53.239.163.210,4,232,0,0,4,232,1.766756000,0.1493
215.158.238.82,<->,106.188.183.90,4,1767,0,0,4,1767,1.766751000,0.1986
148.35.65.45,<->,50.224.76.234,0,0,4,1120,4,1120,1.766744000,0.1936
215.158.238.40,<->,100.216.78.145,4,3930,0,0,4,3930,1.764510000,0.0158
159.248.57.173,<->,136.25.188.209,0,0,4,232,4,232,1.763158000,0.0378
215.158.209.250,<->,97.126.31.80,0,0,4,232,4,232,1.761988000,0.1186
136.25.188.226,<->,41.154.159.9,4,762,0,0,4,762,1.761888000,0.0408
195.127.213.157,<->,136.25.188.239,0,0,4,249,4,249,1.761569000,0.2375
215.158.239.22,<->,215.158.127.145,4,3435,0,0,4,3435,1.760639000,0.0250
133.178.226.227,<->,113.23.103.185,4,459,0,0,4,459,1.758289000,0.2080
133.178.226.227,<->,8.191.135.35,4,459,0,0,4,459,1.758130000,0.1957
221.102.56.69,<->,109.2.24.130,0,0,4,470,4,470,1.757337000,0.0858
136.250.252.100,<->,8.220.204.62,0,0,4,705,4,705,1.756671000,0.0673
148.229.98.75,<->,50.224.76.235,0,0,4,2044,4,2044,1.755860000,0.1523
131.8.156.179,<->,50.224.76.235,0,0,4,1647,4,1647,1.753494000,0.1348
215.158.61.145,<->,8.176.8.228,0,0,4,3573,4,3573,1.751362000,0.0108
159.248.57.96,<->,136.25.188.227,0,0,4,232,4,232,1.748383000,0.0338
221.102.56.69,<->,192.65.205.59,0,0,4,470,4,470,1.744015000,0.0901
139.163.161.164,<->,8.53.1.5,0,0,4,232,4,232,1.743431000,0.0358
220.20.200.20,<->,144.83.60.153,4,3932,0,0,4,3932,1.742987000,0.1683
207.58.125.127,<->,136.25.188.237,0,0,4,236,4,236,1.742728000,0.0205
207.61.131.146,<->,136.25.188.54,0,0,4,1763,4,1763,1.740665000,0.0174
133.178.227.253,<->,120.155.223.156,4,1764,0,0,4,1764,1.739151000,0.2349
112.220.206.122,<->,100.182.132.40,0,0,4,267,4,267,1.738458000,0.0035
136.25.188.254,<->,8.227.55.97,4,232,0,0,4,232,1.738366000,0.0339
215.158.238.148,<->,112.235.95.22,4,1365,0,0,4,1365,1.738291000,0.2019
136.25.188.255,<->,41.133.132.80,4,200,0,0,4,200,1.738200000,0.0005
195.14.209.131,<->,136.25.188.209,0,0,4,1055,4,1055,1.736421000,0.0179
220.55.112.205,<->,17.200.29.20,4,1192,0,0,4,1192,1.735254000,0.0289
139.9.194.133,<->,136.25.188.176,0,0,4,395,4,395,1.734080000,0.0202
136.25.188.220,<->,69.132.241.187,4,1637,0,0,4,1637,1.728391000,0.2693
97.85.137.195,<->,8.52.187.74,0,0,4,425,4,425,1.727955000,0.1000
192.65.176.17,<->,8.45.172.15,4,1246,0,0,4,1246,1.727291000,0.2622
215.158.238.81,<->,29.212.203.139,4,1253,0,0,4,1253,1.727035000,0.1542
220.20.200.32,<->,131.45.239.178,4,3332,0,0,4,3332,1.726840000,0.1264
143.42.51.210,<->,136.25.188.44,0,0,4,200,4,200,1.725788000,0.0065
215.158.238.75,<->,131.1.195.249,4,1477,0,0,4,1477,1.723061000,0.1761
8.52.223.85,<->,8.3.132.65,4,721,0,0,4,721,1.721762000,0.0479
100.224.243.190,<->,8.53.3.84,0,0,4,232,4,232,1.720968000,0.0459
143.227.65.184,<->,136.25.188.55,0,0,4,1509,4,1509,1.719429000,0.1333
121.252.25.55,<->,56.121.58.220,0,0,4,4008,4,4008,1.718723000,0.1671
139.188.57.145,<->,132.168.197.168,0,0,4,811,4,811,1.718596000,0.1038
142.248.57.243,<->,136.25.188.196,0,0,4,300,4,300,1.718024000,0.0108
221.102.56.69,<->,80.40.30.130,0,0,4,470,4,470,1.717138000,0.0824
146.235.129.205,<->,0.195.210.42,0,0,4,224,4,224,1.711762000,0.1890
215.158.239.182,<->,100.224.243.67,4,381,0,0,4,381,1.711152000,0.0450
215.158.239.78,<->,195.49.87.166,4,269,0,0,4,269,1.710652000,0.1206
215.158.238.83,<->,6.116.31.28,4,1349,0,0,4,1349,1.710543000,0.1747
221.102.56.69,<->,218.4.184.243,0,0,4,470,4,470,1.707403000,0.1023
215.158.239.41,<->,122.159.245.154,4,1691,0,0,4,1691,1.702083000,0.1020
220.55.72.171,<->,92.162.218.10,4,1432,0,0,4,1432,1.702081000,0.2233
133.178.227.24,<->,80.57.141.99,4,1279,0,0,4,1279,1.701551000,0.0322
215.158.238.72,<->,91.57.162.197,4,1509,0,0,4,1509,1.697598000,0.2816
114.76.122.237,<->,101.123.192.247,0,0,4,435,4,435,1.695543000,0.0001
133.73.198.233,<->,8.52.250.99,0,0,4,232,4,232,1.695203000,0.0402
215.158.238.190,<->,8.222.58.187,4,1204,0,0,4,1204,1.694851000,0.1494
215.158.239.95,<->,194.237.63.180,4,723,0,0,4,723,1.694769000,0.2639
215.158.239.84,<->,199.20.31.77,4,224,0,0,4,224,1.689586000,0.0002
133.178.226.61,<->,119.196.23.70,4,1509,0,0,4,1509,1.688044000,0.1257
80.56.91.244,<->,8.252.221.215,0,0,4,4448,4,4448,1.687858000,0.2428
8.181.147.63,<->,8.52.242.107,0,0,4,232,4,232,1.686970000,0.0447
221.102.56.69,<->,192.67.97.23,0,0,4,470,4,470,1.684002000,0.1021
208.122.230.62,<->,89.64.133.48,4,724,0,0,4,724,1.683038000,0.1404
215.158.239.182,<->,149.254.204.166,4,461,0,0,4,461,1.680749000,0.2271
215.158.238.81,<->,8.191.15.11,4,1205,0,0,4,1205,1.680300000,0.0905
221.102.56.69,<->,220.83.80.104,0,0,4,470,4,470,1.679619000,0.0707
246.253.198.51,<->,126.110.94.90,4,202,0,0,4,202,1.678857000,0.2223
97.11.180.6,<->,54.39.188.198,4,648,0,0,4,648,1.678770000,0.2849
133.178.227.27,<->,133.56.180.22,4,2716,0,0,4,2716,1.676215000,0.1162
103.144.40.219,<->,92.27.27.185,0,0,4,236,4,236,1.675716000,0.1560
215.158.239.79,<->,207.62.94.212,4,224,0,0,4,224,1.675224000,0.0439
220.39.53.23,<->,133.178.226.202,0,0,4,232,4,232,1.673874000,0.0467
215.158.238.132,<->,76.100.108.230,4,1541,0,0,4,1541,1.670251000,0.2955
136.25.188.196,<->,131.215.37.50,4,1365,0,0,4,1365,1.665146000,0.2039
133.178.226.37,<->,33.209.217.236,4,1397,0,0,4,1397,1.664889000,0.1247
249.101.218.52,<->,132.18.67.27,4,3063,0,0,4,3063,1.663931000,0.1295
133.178.226.28,<->,106.188.252.187,4,1445,0,0,4,1445,1.663524000,0.1117
133.178.226.29,<->,42.97.54.34,4,1493,0,0,4,1493,1.660962000,0.1904
215.158.140.240,<->,29.212.182.13,4,232,0,0,4,232,1.659839000,0.2363
215.158.239.85,<->,196.1.227.130,4,200,0,0,4,200,1.658293000,0.2200
136.25.188.224,<->,133.8.213.88,4,1349,0,0,4,1349,1.657921000,0.0326
215.158.238.81,<->,126.219.136.109,4,1349,0,0,4,1349,1.656020000,0.1043
215.158.140.87,<->,159.36.239.240,4,786,0,0,4,786,1.652405000,0.1601
17.33.68.18,<->,8.220.176.253,0,0,4,493,4,493,1.651923000,0.0792
215.158.239.93,<->,207.236.241.66,4,348,0,0,4,348,1.651460000,0.2240
109.222.12.64,<->,8.182.139.168,0,0,4,758,4,758,1.651137000,0.1150
136.116.9.155,<->,50.224.76.234,0,0,4,974,4,974,1.650567000,0.1335
143.53.79.89,<->,136.25.188.242,0,0,4,243,4,243,1.647973000,0.2333
218.154.30.233,<->,8.52.187.43,0,0,4,200,4,200,1.646144000,0.0022
215.158.140.230,<->,83.245.80.251,4,247,0,0,4,247,1.645519000,0.0500
196.119.223.27,<->,50.223.3.228,0,0,4,256,4,256,1.644395000,0.2692
215.158.238.73,<->,8.252.214.53,4,1493,0,0,4,1493,1.643461000,0.0645
215.158.239.48,<->,207.236.222.236,4,885,0,0,4,885,1.642578000,0.3075
142.190.251.186,<->,136.25.188.55,0,0,4,200,4,200,1.641948000,0.0074
142.255.42.89,<->,136.25.188.196,0,0,4,300,4,300,1.639571000,0.0060
133.178.226.49,<->,122.159.245.156,4,472,0,0,4,472,1.636232000,0.3072
232.88.132.205,<->,8.220.176.253,0,0,4,914,4,914,1.635903000,0.2768
221.102.56.69,<->,98.129.28.237,0,0,4,470,4,470,1.634505000,0.0792
197.107.73.204,<->,136.25.188.220,0,0,4,300,4,300,1.634049000,0.0023
8.55.211.213,<->,6.74.66.227,0,0,4,470,4,470,1.630464000,0.0709
17.39.170.244,<->,8.220.234.159,0,0,4,690,4,690,1.629736000,0.0281
136.25.188.218,<->,100.224.202.157,4,682,0,0,4,682,1.628816000,0.0434
136.25.188.236,<->,122.159.245.163,4,1509,0,0,4,1509,1.628516000,0.2965
215.158.239.5,<->,6.73.247.151,4,1447,0,0,4,1447,1.627666000,0.0695
192.229.214.69,<->,192.170.179.2,4,232,0,0,4,232,1.627531000,0.0434
152.46.106.237,<->,136.25.189.83,0,0,4,1493,4,1493,1.626848000,0.3186
159.48.29.115,<->,8.220.186.144,0,0,4,206,4,206,1.625912000,0.3115
133.178.227.27,<->,104.3.168.53,4,1265,0,0,4,1265,1.625821000,0.3444
139.249.3.26,<->,92.27.219.195,0,0,4,516,4,516,1.625452000,0.0000
124.42.155.231,<->,50.224.76.248,0,0,4,1032,4,1032,1.623535000,0.3544
200.175.245.165,<->,54.37.5.99,4,2968,0,0,4,2968,1.623104000,0.3057
195.71.62.222,<->,136.25.188.175,0,0,4,425,4,425,1.622893000,0.3536
220.28.114.117,<->,80.38.38.207,0,0,4,450,4,450,1.622579000,0.1125
207.232.233.27,<->,50.223.3.228,0,0,4,447,4,447,1.621904000,0.2868
215.158.238.86,<->,145.116.209.93,4,682,0,0,4,682,1.620669000,0.0635
139.163.20.196,<->,110.223.99.72,4,820,0,0,4,820,1.619456000,0.1252
215.158.140.76,<->,126.219.190.246,4,2302,0,0,4,2302,1.619363000,0.3487
215.158.238.109,<->,145.116.209.82,4,682,0,0,4,682,1.616938000,0.0577
97.193.129.30,<->,8.182.253.233,0,0,4,1036,4,1036,1.616344000,0.2864
143.129.206.106,<->,136.25.188.239,0,0,4,300,4,300,1.615489000,0.0062
133.178.226.37,<->,8.255.92.203,4,1525,0,0,4,1525,1.609235000,0.1268
133.178.226.7,<->,80.47.111.74,4,1333,0,0,4,1333,1.608979000,0.0660
136.25.188.176,<->,30.73.148.141,4,3528,0,0,4,3528,1.600212000,0.2011
38.2.189.242,<->,8.220.176.253,0,0,4,200,4,200,1.599286000,0.2765
144.76.46.38,<->,100.95.88.249,0,0,4,520,4,520,1.596944000,0.0209
80.56.83.69,<->,8.252.223.137,0,0,4,268,4,268,1.596678000,0.1961
136.25.189.81,<->,8.33.226.59,4,1541,0,0,4,1541,1.596248000,0.0935
239.227.117.98,<->,112.208.20.192,4,202,0,0,4,202,1.595571000,0.2540
215.158.238.15,<->,111.150.207.201,4,224,0,0,4,224,1.590840000,0.0001
194.232.107.196,<->,136.25.188.198,0,0,4,300,4,300,1.587245000,0.0032
206.153.192.204,<->,133.32.1.140,0,0,4,2008,4,2008,1.586392000,0.3171
136.25.189.47,<->,100.224.139.148,4,232,0,0,4,232,1.584794000,0.0516
210.220.219.153,<->,53.200.51.77,4,337,0,0,4,337,1.584678000,0.1926
132.49.148.122,<->,56.120.95.192,4,200,0,0,4,200,1.584502000,0.0002
215.158.238.148,<->,113.92.151.118,4,1201,0,0,4,1201,1.583512000,0.1073
145.116.118.171,<->,50.238.216.205,4,820,0,0,4,820,1.583434000,0.1225
129.92.117.26,<->,53.240.224.93,4,369,0,0,4,369,1.582924000,0.1272
210.220.218.130,<->,53.240.183.129,4,412,0,0,4,412,1.582826000,0.2804
142.249.101.48,<->,136.25.188.53,0,0,4,778,4,778,1.581351000,0.4156
221.102.56.69,<->,80.41.212.50,0,0,4,470,4,470,1.580854000,0.0800
199.68.141.31,<->,136.25.188.177,0,0,4,300,4,300,1.580659000,0.0098
133.178.227.14,<->,57.184.236.83,4,1214,0,0,4,1214,1.579713000,0.1753
200.174.191.226,<->,53.69.66.48,4,1806,0,0,4,1806,1.578696000,0.4066
221.98.66.220,<->,215.158.6.192,4,232,0,0,4,232,1.577385000,0.0364
196.251.66.231,<->,0.195.210.42,0,0,4,300,4,300,1.576040000,0.0099
215.158.199.180,<->,8.182.168.84,0,0,4,232,4,232,1.575177000,0.0884
210.226.167.67,<->,53.191.133.250,4,206,0,0,4,206,1.573458000,0.0923
136.25.189.47,<->,8.53.216.111,4,232,0,0,4,232,1.571735000,0.1949
35.63.129.87,<->,8.252.221.171,0,0,4,1621,4,1621,1.570861000,0.0453
133.178.227.16,<->,114.171.18.224,4,1213,0,0,4,1213,1.570584000,0.2961
248.239.155.247,<->,221.102.56.69,4,470,0,0,4,470,1.569738000,0.1128
194.237.59.217,<->,136.25.188.54,0,0,4,200,4,200,1.566385000,0.0044
139.193.141.139,<->,102.240.247.127,4,1856,0,0,4,1856,1.563344000,0.2563
215.158.140.167,<->,8.222.7.180,4,2127,0,0,4,2127,1.562828000,0.3089
136.25.188.253,<->,8.227.55.54,4,232,0,0,4,232,1.562443000,0.0381
192.64.202.25,<->,14.30.152.14,4,1850,0,0,4,1850,1.562214000,0.0436
215.158.140.74,<->,159.137.41.50,4,786,0,0,4,786,1.561121000,0.0897
207.59.81.196,<->,136.25.188.52,0,0,4,249,4,249,1.558765000,0.2264
111.146.215.249,<->,100.226.203.139,4,212,0,0,4,212,1.558672000,0.4021
133.73.194.38,<->,80.40.58.90,0,0,4,1311,4,1311,1.556799000,0.1464
143.155.227.57,<->,136.25.188.44,0,0,4,224,4,224,1.556018000,0.0003
215.158.239.76,<->,194.203.253.208,4,243,0,0,4,243,1.554937000,0.2799
215.158.66.185,<->,133.178.227.200,0,0,4,508,4,508,1.554251000,0.0022
207.188.251.181,<->,136.25.188.254,0,0,4,1026,4,1026,1.553432000,0.3947
246.253.198.51,<->,93.188.223.232,4,202,0,0,4,202,1.552595000,0.3652
142.223.135.254,<->,136.25.188.253,0,0,4,925,4,925,1.552094000,0.0418
159.13.137.179,<->,137.23.166.40,4,958,0,0,4,958,1.550760000,0.1659
142.249.111.35,<->,136.25.188.198,0,0,4,200,4,200,1.549852000,0.0058
215.158.61.202,<->,133.178.226.173,0,0,4,4243,4,4243,1.549114000,0.0151
215.158.239.97,<->,202.33.57.160,4,200,0,0,4,200,1.547430000,0.0000
92.27.219.37,<->,29.143.214.182,4,202,0,0,4,202,1.546977000,0.2520
92.27.219.190,<->,57.212.62.83,4,698,0,0,4,698,1.546831000,0.3329
215.158.140.241,<->,198.204.77.201,4,1925,0,0,4,1925,1.545685000,0.2830
111.66.29.160,<->,92.27.219.151,0,0,4,206,4,206,1.544269000,0.0574
145.176.8.232,<->,80.41.248.200,0,0,4,488,4,488,1.544024000,0.0944
215.158.239.18,<->,8.255.92.88,4,2515,0,0,4,2515,1.543158000,0.2143
149.150.27.239,<->,0.195.210.42,0,0,4,657,4,657,1.542819000,0.1380
92.27.219.218,<->,33.57.74.132,4,206,0,0,4,206,1.542463000,0.2629
215.158.239.58,<->,199.106.118.136,4,1012,0,0,4,1012,1.540884000,0.1532
215.158.239.125,<->,215.158.61.203,4,5002,0,0,4,5002,1.540808000,0.0000
146.149.67.47,<->,8.252.221.199,0,0,4,762,4,762,1.540015000,0.2602
215.158.238.32,<->,148.224.137.67,4,1525,0,0,4,1525,1.539605000,0.3793
200.174.199.250,<->,53.161.180.137,4,225,0,0,4,225,1.537958000,0.0004
215.158.140.195,<->,8.222.7.163,4,1236,0,0,4,1236,1.537649000,0.0571
142.220.108.2,<->,136.25.188.198,0,0,4,1192,4,1192,1.535497000,0.0768
220.38.162.62,<->,215.158.140.181,0,0,4,1594,4,1594,1.533499000,0.3540
143.87.150.3,<->,136.25.188.178,0,0,4,762,4,762,1.531255000,0.4430
212.100.244.206,<->,8.52.182.30,0,0,4,800,4,800,1.530342000,0.0753
159.137.162.213,<->,119.209.91.134,4,782,0,0,4,782,1.529725000,0.3842
215.158.238.32,<->,131.1.195.220,4,1365,0,0,4,1365,1.529662000,0.2190
143.114.150.67,<->,50.224.76.234,0,0,4,1560,4,1560,1.526203000,0.3590
215.158.239.93,<->,195.49.235.110,4,224,0,0,4,224,1.525783000,0.4604
222.254.205.206,<->,97.126.21.248,0,0,4,646,4,646,1.525616000,0.1155
133.178.226.37,<->,131.1.232.91,4,2618,0,0,4,2618,1.525489000,0.4002
241.75.160.2,<->,221.102.113.250,0,0,4,612,4,612,1.525397000,0.3945
143.53.234.215,<->,136.25.188.177,0,0,4,249,4,249,1.525203000,0.3099
215.158.238.221,<->,126.219.60.220,4,1268,0,0,4,1268,1.525133000,0.1763
215.158.238.120,<->,131.173.115.84,4,1541,0,0,4,1541,1.524416000,0.3052
215.158.239.50,<->,196.91.19.171,4,790,0,0,4,790,1.523380000,0.4581
194.253.83.145,<->,50.224.76.235,0,0,4,914,4,914,1.522993000,0.3116
215.158.238.148,<->,80.47.111.88,4,2666,0,0,4,2666,1.520783000,0.2448
207.194.67.34,<->,8.182.235.164,0,0,4,433,4,433,1.520091000,0.3963
120.89.238.112,<->,50.224.76.234,0,0,4,2981,4,2981,1.519664000,0.3881
133.178.226.224,<->,115.162.222.217,4,1572,0,0,4,1572,1.519226000,0.1437
92.32.4.127,<->,8.52.180.110,0,0,4,762,4,762,1.519107000,0.0713
136.25.188.209,<->,131.1.253.209,4,1509,0,0,4,1509,1.517646000,0.1055
215.158.239.30,<->,212.70.75.25,4,1324,0,0,4,1324,1.517328000,0.0303
196.88.212.196,<->,136.25.188.176,0,0,4,300,4,300,1.513600000,0.0094
199.32.127.142,<->,136.25.188.237,0,0,4,200,4,200,1.512984000,0.0042
241.75.192.120,<->,221.102.110.4,0,0,4,745,4,745,1.510904000,0.1090
107.11.233.148,<->,0.195.210.44,0,0,4,374,4,374,1.510724000,0.1316
246.253.157.15,<->,120.246.77.210,4,202,0,0,4,202,1.510462000,0.3962
220.6.163.23,<->,92.27.219.142,0,0,4,740,4,740,1.509367000,0.3400
142.236.68.142,<->,136.25.188.241,0,0,4,212,4,212,1.509258000,0.1879
205.70.194.140,<->,92.27.219.214,0,0,4,236,4,236,1.507660000,0.2800
139.148.142.18,<->,8.182.226.78,0,0,4,607,4,607,1.507360000,0.1949
112.208.20.199,<->,6.72.11.112,0,0,4,206,4,206,1.507306000,0.2502
221.102.56.69,<->,213.38.198.219,0,0,4,470,4,470,1.505863000,0.0800
215.158.238.163,<->,111.150.207.58,4,224,0,0,4,224,1.505360000,0.0001
215.158.239.49,<->,199.122.119.62,4,416,0,0,4,416,1.504596000,0.4951
142.208.46.131,<->,136.25.188.52,0,0,4,218,4,218,1.502667000,0.0052
8.228.216.186,<->,8.149.158.131,4,3918,0,0,4,3918,1.500345000,0.2557
126.198.147.25,<->,100.94.191.192,0,0,4,581,4,581,1.499294000,0.3136
192.64.239.241,<->,149.71.254.200,4,592,0,0,4,592,1.498386000,0.2654
241.5.27.214,<->,215.158.140.75,0,0,4,1240,4,1240,1.497911000,0.0781
98.156.187.247,<->,8.182.226.78,0,0,4,762,4,762,1.497848000,0.0541
131.195.9.102,<->,50.224.76.234,0,0,4,773,4,773,1.496935000,0.4670
136.25.188.221,<->,38.104.11.3,4,224,0,0,4,224,1.496417000,0.0002
215.158.238.64,<->,57.210.107.38,4,2650,0,0,4,2650,1.494913000,0.5006
53.167.135.197,<->,48.52.213.160,0,0,4,2887,4,2887,1.494811000,0.2922
215.158.239.50,<->,199.106.91.244,4,249,0,0,4,249,1.494156000,0.2690
98.101.70.120,<->,8.182.226.78,0,0,4,1722,4,1722,1.493373000,0.2136
92.27.67.44,<->,8.252.221.171,0,0,4,731,4,731,1.491694000,0.4715
132.249.70.157,<->,111.151.237.22,4,366,0,0,4,366,1.488464000,0.0622
252.135.0.205,<->,139.193.141.132,0,0,4,255,4,255,1.487116000,0.0971
129.78.116.178,<->,76.100.65.38,4,780,0,0,4,780,1.486826000,0.4960
215.158.238.176,<->,114.94.161.244,4,2251,0,0,4,2251,1.485971000,0.4059
231.142.111.219,<->,136.25.188.197,0,0,4,300,4,300,1.482979000,0.0058
199.82.249.196,<->,136.25.188.222,0,0,4,300,4,300,1.482948000,0.0093
129.92.116.243,<->,56.121.22.175,4,934,0,0,4,934,1.480945000,0.1007
215.158.239.253,<->,144.253.73.231,4,270,0,0,4,270,1.480388000,0.0500
204.200.46.104,<->,136.25.188.177,0,0,4,762,4,762,1.479828000,0.3083
215.158.238.86,<->,145.116.209.82,4,682,0,0,4,682,1.478176000,0.0612
143.200.139.22,<->,80.38.16.211,0,0,4,690,4,690,1.478172000,0.4026
142.236.127.231,<->,136.25.188.176,0,0,4,223,4,223,1.475527000,0.3390
125.194.72.26,<->,109.1.58.226,0,0,4,354,4,354,1.475149000,0.3900
195.40.190.30,<->,136.25.188.253,0,0,4,1053,4,1053,1.474444000,0.5244
215.158.239.57,<->,199.20.30.110,4,249,0,0,4,249,1.472746000,0.3301
192.227.190.233,<->,133.178.226.18,0,0,4,1573,4,1573,1.472579000,0.0832
109.222.220.98,<->,54.43.249.8,4,307,0,0,4,307,1.471862000,0.0525
136.25.188.220,<->,30.73.92.33,4,224,0,0,4,224,1.470084000,0.0212
195.124.73.231,<->,136.25.188.241,0,0,4,300,4,300,1.466438000,0.1616
207.179.171.123,<->,50.223.3.228,0,0,4,451,4,451,1.465360000,0.3446
8.220.207.68,<->,8.35.106.200,4,232,0,0,4,232,1.464839000,0.0466
111.147.99.157,<->,97.110.90.234,4,200,0,0,4,200,1.464654000,0.1121
159.137.162.213,<->,117.42.71.27,4,782,0,0,4,782,1.461898000,0.4608
220.28.114.119,<->,145.252.118.62,0,0,4,488,4,488,1.461762000,0.1353
220.251.223.94,<->,136.25.188.227,0,0,4,762,4,762,1.461559000,0.0869
231.142.160.21,<->,136.25.188.225,0,0,4,200,4,200,1.460257000,0.2599
136.25.189.29,<->,96.156.169.220,4,1957,0,0,4,1957,1.459872000,0.1021
215.158.61.183,<->,8.176.8.219,0,0,4,3802,4,3802,1.459131000,0.2121
136.214.10.160,<->,92.27.194.249,0,0,4,536,4,536,1.458597000,0.1414
136.129.94.157,<->,111.199.230.0,4,590,0,0,4,590,1.458523000,0.4200
204.1.145.195,<->,136.25.188.225,0,0,4,300,4,300,1.456912000,0.1798
215.158.238.96,<->,29.213.216.233,4,2362,0,0,4,2362,1.456608000,0.4929
95.246.167.198,<->,8.252.221.206,0,0,4,1382,4,1382,1.456324000,0.4653
215.158.239.79,<->,142.252.141.153,4,2560,0,0,4,2560,1.456299000,0.1695
133.178.226.80,<->,33.209.217.222,4,1381,0,0,4,1381,1.454754000,0.1370
215.158.238.82,<->,57.227.83.250,4,1397,0,0,4,1397,1.453892000,0.2519
221.102.56.69,<->,99.75.22.179,0,0,4,470,4,470,1.450006000,0.0610
196.245.45.193,<->,136.25.188.198,0,0,4,249,4,249,1.443170000,0.2002
205.127.108.113,<->,33.233.141.77,0,0,4,956,4,956,1.442819000,0.5256
136.25.188.211,<->,113.20.94.75,4,1477,0,0,4,1477,1.440377000,0.4390
199.72.63.9,<->,136.25.188.177,0,0,4,294,4,294,1.439540000,0.0044
92.27.219.173,<->,82.178.158.143,4,236,0,0,4,236,1.438631000,0.1022
91.57.171.43,<->,8.220.200.17,0,0,4,232,4,232,1.438287000,0.0569
22.62.92.244,<->,8.183.24.109,0,0,4,200,4,200,1.437761000,0.3905
215.158.238.92,<->,113.23.104.247,4,249,0,0,4,249,1.437319000,0.1265
139.163.41.95,<->,105.78.59.95,4,791,0,0,4,791,1.437296000,0.3265
203.48.153.21,<->,8.220.238.62,0,0,4,762,4,762,1.435896000,0.3656
215.158.239.76,<->,207.191.73.225,4,303,0,0,4,303,1.435849000,0.2605
215.158.238.107,<->,122.29.159.87,4,1397,0,0,4,1397,1.435598000,0.1472
196.89.66.253,<->,136.25.188.196,0,0,4,1423,4,1423,1.434855000,0.5505
109.222.241.51,<->,82.195.35.35,4,1269,0,0,4,1269,1.433107000,0.0776
133.178.226.227,<->,29.214.216.96,4,270,0,0,4,270,1.432813000,0.4231
136.25.188.220,<->,122.158.245.90,4,2666,0,0,4,2666,1.431364000,0.3565
215.158.239.181,<->,131.36.66.137,4,460,0,0,4,460,1.429793000,0.1911
215.158.238.83,<->,80.47.111.11,4,249,0,0,4,249,1.429550000,0.0457
97.248.246.50,<->,89.183.104.172,0,0,4,206,4,206,1.429388000,0.1075
199.32.127.142,<->,136.25.188.220,0,0,4,200,4,200,1.427612000,0.0047
112.208.20.199,<->,99.72.22.255,0,0,4,206,4,206,1.427248000,0.3064
204.200.46.119,<->,136.25.188.226,0,0,4,200,4,200,1.426651000,0.0065
136.25.188.211,<->,113.23.20.232,4,1509,0,0,4,1509,1.426016000,0.2124
215.158.239.69,<->,196.108.238.88,4,1075,0,0,4,1075,1.424777000,0.5599
100.115.92.206,<->,97.110.90.36,4,385,0,0,4,385,1.424666000,0.4331
136.139.59.124,<->,136.25.188.172,0,0,4,249,4,249,1.422746000,0.0623
210.220.219.150,<->,53.224.118.41,4,337,0,0,4,337,1.422418000,0.1758
215.158.239.51,<->,195.54.50.33,4,264,0,0,4,264,1.421153000,0.0051
129.1.112.127,<->,8.45.168.98,4,384,0,0,4,384,1.420821000,0.1287
136.25.188.176,<->,8.227.55.27,4,232,0,0,4,232,1.418126000,0.0340
215.158.239.68,<->,199.20.30.99,4,260,0,0,4,260,1.418125000,0.1201
139.185.223.103,<->,97.168.93.121,0,0,4,1139,4,1139,1.417662000,0.1040
222.244.24.203,<->,215.158.238.107,0,0,4,1685,4,1685,1.416521000,0.2355
136.25.188.177,<->,131.1.253.245,4,2985,0,0,4,2985,1.411968000,0.4844
215.158.239.96,<->,143.89.246.104,4,448,0,0,4,448,1.410389000,0.5860
156.181.149.34,<->,136.25.189.81,0,0,4,1381,4,1381,1.410109000,0.3408
144.86.146.31,<->,120.62.81.114,4,1660,0,0,4,1660,1.408457000,0.5173
215.158.238.64,<->,111.151.70.54,4,1541,0,0,4,1541,1.407424000,0.2214
131.45.239.182,<->,92.162.253.141,0,0,4,2471,4,2471,1.406440000,0.1206
215.158.140.184,<->,98.249.65.2,4,334,0,0,4,334,1.405779000,0.0633
136.25.188.226,<->,120.20.132.22,4,1509,0,0,4,1509,1.402966000,0.2478
215.158.239.182,<->,144.253.73.244,4,402,0,0,4,402,1.402944000,0.0493
136.139.59.124,<->,136.25.189.89,0,0,4,249,4,249,1.401997000,0.0516
204.185.2.234,<->,136.25.188.236,0,0,4,1916,4,1916,1.400349000,0.0001
215.158.238.106,<->,138.126.75.36,4,1365,0,0,4,1365,1.399165000,0.5666
136.25.189.47,<->,72.23.194.232,4,2602,0,0,4,2602,1.398551000,0.4538
207.162.137.19,<->,8.182.224.248,0,0,4,575,4,575,1.398128000,0.3264
139.193.141.132,<->,29.223.227.192,4,509,0,0,4,509,1.396862000,0.2356
201.211.112.219,<->,133.178.226.29,0,0,4,1237,4,1237,1.394864000,0.2968
139.163.28.207,<->,89.205.238.165,4,338,0,0,4,338,1.391483000,0.1234
103.156.177.241,<->,89.183.104.165,0,0,4,206,4,206,1.391284000,0.0916
215.158.238.65,<->,125.84.145.37,4,1365,0,0,4,1365,1.383645000,0.4079
215.158.239.87,<->,207.212.47.193,4,1022,0,0,4,1022,1.381783000,0.2038
133.244.28.233,<->,127.255.180.249,4,290,0,0,4,290,1.380226000,0.1182
215.158.239.56,<->,199.122.128.167,4,200,0,0,4,200,1.379194000,0.1900
136.25.188.176,<->,120.20.132.0,4,2641,0,0,4,2641,1.378211000,0.2599
197.107.107.247,<->,8.182.138.11,0,0,4,206,4,206,1.377583000,0.2184
192.227.191.250,<->,133.178.227.208,0,0,4,249,4,249,1.377481000,0.0621
195.54.62.5,<->,136.25.188.220,0,0,4,450,4,450,1.376973000,0.4866
136.25.188.163,<->,57.227.82.203,4,1509,0,0,4,1509,1.372535000,0.2033
215.158.239.57,<->,196.92.47.228,4,1902,0,0,4,1902,1.371958000,0.1804
231.138.130.211,<->,136.25.188.227,0,0,4,249,4,249,1.369154000,0.2028
97.126.114.227,<->,8.232.96.254,4,320,0,0,4,320,1.367987000,0.0838
207.59.201.32,<->,136.25.188.227,0,0,4,864,4,864,1.363759000,0.4707
158.221.127.30,<->,50.224.76.234,0,0,4,200,4,200,1.361093000,0.1634
218.4.180.210,<->,115.80.7.174,4,428,0,0,4,428,1.358539000,0.6279
215.158.238.103,<->,145.116.209.82,4,232,0,0,4,232,1.354776000,0.0566
159.137.162.213,<->,120.246.76.167,4,782,0,0,4,782,1.353254000,0.4960
215.158.239.59,<->,199.72.49.122,4,1051,0,0,4,1051,1.353082000,0.3530
109.222.198.50,<->,53.244.240.3,4,1850,0,0,4,1850,1.353013000,0.3329
153.100.221.208,<->,92.27.219.236,0,0,4,206,4,206,1.352819000,0.5447
195.14.91.226,<->,136.25.188.252,0,0,4,249,4,249,1.349678000,0.1762
215.158.238.32,<->,193.39.70.95,4,1253,0,0,4,1253,1.349318000,0.1651
215.158.239.5,<->,8.222.7.168,4,1303,0,0,4,1303,1.348420000,0.0537
254.70.243.200,<->,109.1.32.164,0,0,4,220,4,220,1.346607000,0.6463
136.25.188.160,<->,131.215.37.28,4,1477,0,0,4,1477,1.346207000,0.2254
204.153.100.136,<->,101.224.204.164,0,0,4,776,4,776,1.345767000,0.6453
215.158.239.79,<->,199.20.29.72,4,212,0,0,4,212,1.345703000,0.2000
231.136.201.225,<->,215.158.239.77,0,0,4,1421,4,1421,1.345685000,0.4367
100.115.92.207,<->,97.110.90.36,4,313,0,0,4,313,1.343484000,0.5575
246.253.253.171,<->,56.114.235.120,4,662,0,0,4,662,1.342347000,0.0509
199.100.160.254,<->,50.223.3.228,0,0,4,200,4,200,1.341660000,0.5287
215.158.238.140,<->,124.52.96.46,4,1461,0,0,4,1461,1.340116000,0.1613
142.166.5.17,<->,136.25.188.175,0,0,4,218,4,218,1.338760000,0.0057
144.85.170.244,<->,139.128.205.252,4,1001,0,0,4,1001,1.338499000,0.0470
111.199.230.0,<->,0.195.210.44,0,0,4,335,4,335,1.335892000,0.1391
215.158.238.82,<->,139.160.226.235,4,1573,0,0,4,1573,1.335407000,0.1281
143.134.250.27,<->,136.25.188.53,0,0,4,212,4,212,1.335227000,0.2878
215.158.239.34,<->,113.93.9.40,4,1366,0,0,4,1366,1.335112000,0.1649
215.158.238.141,<->,131.144.113.168,4,2826,0,0,4,2826,1.331597000,0.5676
243.134.122.0,<->,8.183.25.124,0,0,4,200,4,200,1.330232000,0.0000
215.158.239.92,<->,197.125.108.31,4,2730,0,0,4,2730,1.322535000,0.2509
215.158.238.73,<->,122.158.49.130,4,1932,0,0,4,1932,1.321791000,0.1899
197.113.99.146,<->,136.25.188.243,0,0,4,778,4,778,1.321340000,0.6307
145.31.7.133,<->,92.27.219.135,0,0,4,206,4,206,1.321232000,0.1074
215.158.239.59,<->,106.188.253.173,4,1580,0,0,4,1580,1.320298000,0.2946
207.60.249.92,<->,136.25.188.220,0,0,4,249,4,249,1.318857000,0.3461
116.124.63.20,<->,101.224.206.46,0,0,4,366,4,366,1.316627000,0.4725
142.220.219.246,<->,136.25.188.53,0,0,4,800,4,800,1.316569000,0.6236
8.52.182.119,<->,6.82.175.133,4,427,0,0,4,427,1.315262000,0.1153
215.158.239.93,<->,199.20.7.50,4,243,0,0,4,243,1.314992000,0.3192
136.25.188.253,<->,8.227.55.116,4,232,0,0,4,232,1.314247000,0.0339
215.158.33.177,<->,102.233.98.138,0,0,4,1226,4,1226,1.312992000,0.0598
48.18.199.49,<->,8.252.221.204,0,0,4,599,4,599,1.312917000,0.1363
142.220.219.246,<->,136.25.188.255,0,0,4,800,4,800,1.310666000,0.4514
140.218.109.14,<->,133.178.226.77,0,0,4,2522,4,2522,1.308652000,0.4630
225.120.222.154,<->,136.25.188.221,0,0,4,1365,4,1365,1.308575000,0.2125
196.112.115.9,<->,0.195.210.44,0,0,4,346,4,346,1.308262000,0.5823
136.25.189.12,<->,29.211.93.15,4,473,0,0,4,473,1.307467000,0.3694
239.66.76.150,<->,100.94.91.165,0,0,4,962,4,962,1.305748000,0.2604
215.158.238.82,<->,113.23.104.221,4,249,0,0,4,249,1.304732000,0.1199
158.1.102.101,<->,89.183.104.143,0,0,4,236,4,236,1.304520000,0.5579
207.59.90.13,<->,136.25.188.45,0,0,4,762,4,762,1.303741000,0.5481
143.155.227.40,<->,136.25.188.199,0,0,4,1521,4,1521,1.302129000,0.2637
215.158.239.7,<->,8.252.214.200,4,1791,0,0,4,1791,1.302063000,0.0663
136.25.189.28,<->,120.155.8.110,4,1557,0,0,4,1557,1.300021000,0.2098
133.178.226.90,<->,57.199.250.203,4,1493,0,0,4,1493,1.297189000,0.2983
204.200.42.4,<->,136.25.188.177,0,0,4,300,4,300,1.296016000,0.0016
221.102.56.69,<->,109.2.82.112,0,0,4,470,4,470,1.295625000,0.0752
133.135.214.174,<->,129.6.83.11,0,0,4,5029,4,5029,1.293269000,0.0000
215.158.239.182,<->,29.214.216.64,4,461,0,0,4,461,1.292977000,0.2012
69.246.60.200,<->,8.252.222.48,0,0,4,839,4,839,1.291884000,0.1756
136.25.189.57,<->,8.215.68.83,4,2586,0,0,4,2586,1.291228000,0.5530
192.64.255.44,<->,112.96.179.64,4,276,0,0,4,276,1.290140000,0.5703
215.158.239.50,<->,204.61.83.25,4,218,0,0,4,218,1.287370000,0.0503
109.1.6.108,<->,53.167.10.58,4,562,0,0,4,562,1.287037000,0.5839
215.158.140.184,<->,6.82.175.133,4,381,0,0,4,381,1.286121000,0.1313
247.99.126.230,<->,50.224.89.241,0,0,4,1353,4,1353,1.285966000,0.1159
142.236.24.91,<->,92.27.194.147,0,0,4,424,4,424,1.285839000,0.5634
246.253.132.235,<->,30.199.161.104,4,364,0,0,4,364,1.285672000,0.0440
215.158.238.142,<->,8.220.51.250,4,1333,0,0,4,1333,1.283642000,0.4707
215.158.238.177,<->,29.214.108.56,4,1237,0,0,4,1237,1.283344000,0.3933
192.65.25.7,<->,8.55.211.213,4,470,0,0,4,470,1.281212000,0.0722
143.132.175.227,<->,136.25.188.255,0,0,4,200,4,200,1.280771000,0.2594
215.158.238.188,<->,126.219.132.218,4,1253,0,0,4,1253,1.273375000,0.2830
65.26.112.57,<->,8.252.222.62,0,0,4,300,4,300,1.272274000,0.0005
146.10.166.54,<->,133.178.226.30,0,0,4,1349,4,1349,1.272185000,0.2119
215.158.239.209,<->,96.135.155.50,4,2490,0,0,4,2490,1.271278000,0.0895
144.87.235.222,<->,112.208.20.140,4,206,0,0,4,206,1.271115000,0.2804
117.46.38.40,<->,92.27.219.21,0,0,4,206,4,206,1.270893000,0.2234
195.40.232.172,<->,136.25.188.243,0,0,4,762,4,762,1.270113000,0.4595
215.158.239.85,<->,204.209.60.225,4,224,0,0,4,224,1.269648000,0.6364
103.239.109.158,<->,92.27.219.173,0,0,4,206,4,206,1.268399000,0.0671
195.15.148.23,<->,136.25.188.163,0,0,4,218,4,218,1.267909000,0.0025
144.83.60.153,<->,92.162.253.133,0,0,4,5177,4,5177,1.264266000,0.0000
215.158.238.106,<->,143.155.227.59,4,249,0,0,4,249,1.262933000,0.1669
133.178.226.30,<->,38.104.11.118,4,1301,0,0,4,1301,1.262834000,0.5320
136.25.188.160,<->,29.211.186.215,4,1381,0,0,4,1381,1.262696000,0.2277
215.158.238.135,<->,29.213.195.69,4,1413,0,0,4,1413,1.260394000,0.1183
91.69.181.169,<->,50.224.105.36,0,0,4,622,4,622,1.259752000,0.1260
215.158.239.58,<->,199.20.29.53,4,949,0,0,4,949,1.259176000,0.3098
136.25.188.221,<->,69.31.239.24,4,1349,0,0,4,1349,1.258571000,0.3260
231.142.55.106,<->,215.158.239.56,0,0,4,264,4,264,1.258349000,0.1912
144.87.238.89,<->,8.182.228.189,0,0,4,764,4,764,1.257972000,0.0514
220.28.85.14,<->,133.178.226.41,0,0,4,4549,4,4549,1.257764000,0.0000
215.158.239.50,<->,194.232.252.138,4,249,0,0,4,249,1.255719000,0.3851
204.185.223.182,<->,136.25.188.209,0,0,4,404,4,404,1.255054000,0.2599
215.158.238.89,<->,145.116.209.82,4,232,0,0,4,232,1.253444000,0.0623
246.253.157.15,<->,112.5.73.193,4,200,0,0,4,200,1.252517000,0.2395
215.158.238.120,<->,42.195.144.225,4,249,0,0,4,249,1.252218000,0.1902
143.43.193.213,<->,50.224.76.235,0,0,4,1040,4,1040,1.249247000,0.2712
195.55.49.14,<->,136.25.188.252,0,0,4,297,4,297,1.244857000,0.2944
111.146.249.8,<->,53.149.173.81,4,423,0,0,4,423,1.242672000,0.1632
215.158.239.58,<->,142.191.235.114,4,249,0,0,4,249,1.241526000,0.3779
215.158.238.75,<->,38.104.11.40,4,1653,0,0,4,1653,1.240426000,0.2919
216.184.1.112,<->,136.25.188.165,0,0,4,380,4,380,1.239663000,0.0531
142.223.153.139,<->,136.25.188.160,0,0,4,1127,4,1127,1.236891000,0.0337
215.158.239.215,<->,215.158.61.189,4,4842,0,0,4,4842,1.233864000,0.0001
133.178.226.29,<->,38.104.11.126,4,1413,0,0,4,1413,1.232440000,0.1685
136.25.189.6,<->,96.156.169.219,4,3883,0,0,4,3883,1.231132000,0.0024
215.158.239.56,<->,196.0.105.26,4,297,0,0,4,297,1.229061000,0.5800
215.158.127.57,<->,133.178.226.176,0,0,4,224,4,224,1.228408000,0.0000
35.55.6.217,<->,8.183.25.224,0,0,4,255,4,255,1.228167000,0.0221
221.101.8.226,<->,194.253.94.195,4,608,0,0,4,608,1.227652000,0.6635
111.151.142.165,<->,8.252.221.233,0,0,4,224,4,224,1.225125000,0.0001
215.158.238.132,<->,128.110.138.173,4,1285,0,0,4,1285,1.224421000,0.1314
215.158.238.133,<->,111.150.186.166,4,2634,0,0,4,2634,1.221729000,0.5155
194.237.73.14,<->,136.25.188.44,0,0,4,300,4,300,1.221491000,0.0062
204.187.117.139,<->,136.25.188.198,0,0,4,288,4,288,1.219838000,0.7202
136.25.189.12,<->,68.124.221.169,4,1333,0,0,4,1333,1.218667000,0.2475
195.12.236.137,<->,136.25.188.222,0,0,4,460,4,460,1.217941000,0.7674
215.158.238.45,<->,143.45.0.148,4,1397,0,0,4,1397,1.217632000,0.3519
133.178.226.19,<->,65.27.228.181,4,2874,0,0,4,2874,1.217532000,0.4398
218.154.30.233,<->,8.52.189.207,0,0,4,2592,4,2592,1.216665000,0.4084
94.192.95.250,<->,8.252.221.204,0,0,4,1178,4,1178,1.216614000,0.2910
229.45.205.24,<->,222.20.211.148,4,999,0,0,4,999,1.215539000,0.5604
215.158.238.45,<->,198.226.166.143,4,1509,0,0,4,1509,1.213143000,0.1089
215.158.238.45,<->,146.10.166.72,4,1509,0,0,4,1509,1.212814000,0.2063
204.185.138.81,<->,136.25.188.55,0,0,4,762,4,762,1.211022000,0.6401
142.241.29.174,<->,136.25.188.252,0,0,4,762,4,762,1.209973000,0.4379
136.25.188.248,<->,100.216.78.145,4,5502,0,0,4,5502,1.209730000,0.0000
222.254.247.163,<->,210.220.219.182,0,0,4,1034,4,1034,1.207936000,0.5629
221.102.56.69,<->,192.64.102.83,0,0,4,470,4,470,1.206438000,0.1500
192.64.87.18,<->,8.45.175.127,4,384,0,0,4,384,1.205745000,0.1052
89.11.43.209,<->,80.40.33.172,0,0,4,730,4,730,1.203930000,0.0940
136.25.189.18,<->,118.20.100.120,4,1184,0,0,4,1184,1.202326000,0.1938
139.163.166.118,<->,136.25.188.176,0,0,4,249,4,249,1.202096000,0.0246
136.25.188.178,<->,8.227.55.4,4,232,0,0,4,232,1.201706000,0.0378
215.158.238.81,<->,193.10.94.23,4,1365,0,0,4,1365,1.199401000,0.1502
143.42.24.199,<->,136.25.188.174,0,0,4,300,4,300,1.199357000,0.0056
143.76.153.141,<->,8.182.227.180,0,0,4,402,4,402,1.198784000,0.5565
194.254.134.22,<->,92.27.194.147,0,0,4,424,4,424,1.196481000,0.5240
215.158.239.18,<->,8.255.92.117,4,1201,0,0,4,1201,1.195906000,0.1311
133.178.226.31,<->,112.220.206.88,4,1349,0,0,4,1349,1.194621000,0.2441
215.158.238.107,<->,29.212.195.20,4,1381,0,0,4,1381,1.194259000,0.1351
215.158.239.31,<->,8.252.214.214,4,1726,0,0,4,1726,1.193103000,0.0670
215.158.238.221,<->,148.189.137.55,4,1218,0,0,4,1218,1.192438000,0.2768
97.126.8.42,<->,54.49.112.232,4,3099,0,0,4,3099,1.190936000,0.0936
133.178.226.43,<->,98.219.126.175,4,3242,0,0,4,3242,1.190804000,0.0262
196.114.37.188,<->,50.224.76.234,0,0,4,1398,4,1398,1.190682000,0.4189
112.217.151.120,<->,0.195.210.46,0,0,4,2540,4,2540,1.189698000,0.4694
133.178.226.232,<->,100.224.243.118,4,510,0,0,4,510,1.189638000,0.0448
207.57.22.118,<->,136.25.188.53,0,0,4,212,4,212,1.189210000,0.6640
195.124.156.119,<->,136.25.188.222,0,0,4,200,4,200,1.188775000,0.6811
215.158.238.209,<->,18.202.90.165,4,1275,0,0,4,1275,1.187562000,0.2954
207.236.196.98,<->,136.25.188.225,0,0,4,1137,4,1137,1.185884000,0.0061
215.158.238.143,<->,125.216.43.104,4,1653,0,0,4,1653,1.184459000,0.1956
215.158.238.107,<->,143.20.121.150,4,1349,0,0,4,1349,1.181451000,0.1408
215.158.239.56,<->,207.114.164.244,4,224,0,0,4,224,1.179348000,0.2581
204.56.108.75,<->,136.25.188.160,0,0,4,272,4,272,1.177490000,0.0724
199.73.204.98,<->,136.25.188.211,0,0,4,200,4,200,1.176940000,0.0902
109.1.40.189,<->,53.68.234.251,4,387,0,0,4,387,1.170913000,0.2360
215.158.238.121,<->,194.205.112.170,4,1445,0,0,4,1445,1.168155000,0.1669
246.253.157.15,<->,149.100.161.82,4,206,0,0,4,206,1.165010000,0.2847
215.158.239.59,<->,199.20.29.124,4,224,0,0,4,224,1.163457000,0.3775
50.178.7.140,<->,8.52.222.199,0,0,4,762,4,762,1.162626000,0.0537
8.222.212.2,<->,8.43.183.186,0,0,4,232,4,232,1.162574000,0.0457
215.158.238.221,<->,120.154.227.171,4,1253,0,0,4,1253,1.155298000,0.1460
215.158.239.92,<->,212.70.75.121,4,2666,0,0,4,2666,1.152871000,0.3932
104.209.253.210,<->,50.224.76.248,0,0,4,2670,4,2670,1.152837000,0.7444
215.158.238.143,<->,112.220.206.117,4,1301,0,0,4,1301,1.152552000,0.1176
243.117.107.129,<->,80.38.1.52,0,0,4,1112,4,1112,1.151461000,0.2710
144.85.170.244,<->,98.87.146.252,4,224,0,0,4,224,1.149620000,0.4863
215.158.42.21,<->,136.25.189.221,0,0,4,4917,4,4917,1.149411000,0.0000
215.158.238.133,<->,80.47.111.75,4,1445,0,0,4,1445,1.148824000,0.1506
210.157.223.1,<->,50.224.80.67,0,0,4,583,4,583,1.148275000,0.1362
111.199.228.197,<->,0.195.210.44,0,0,4,335,4,335,1.147641000,0.1209
80.27.155.31,<->,48.105.71.235,4,522,0,0,4,522,1.147029000,0.5789
136.25.188.222,<->,80.47.111.87,4,249,0,0,4,249,1.146526000,0.0567
243.117.83.161,<->,220.55.72.171,0,0,4,220,4,220,1.145006000,0.1002
215.158.239.41,<->,122.159.245.172,4,1724,0,0,4,1724,1.140295000,0.1068
215.158.238.117,<->,145.116.209.82,4,682,0,0,4,682,1.139224000,0.0833
215.158.239.78,<->,199.20.5.104,4,236,0,0,4,236,1.137778000,0.0161
142.229.35.165,<->,136.25.188.176,0,0,4,762,4,762,1.137432000,0.4248
215.158.239.76,<->,199.20.31.9,4,945,0,0,4,945,1.137408000,0.8399
215.158.239.28,<->,98.166.239.60,4,1627,0,0,4,1627,1.136965000,0.0761
133.178.227.79,<->,122.216.233.124,4,1209,0,0,4,1209,1.136267000,0.0932
133.178.227.24,<->,69.150.169.217,4,2271,0,0,4,2271,1.131238000,0.8662
249.176.116.24,<->,224.148.203.58,0,0,4,748,4,748,1.129976000,0.0710
199.50.60.196,<->,136.25.188.242,0,0,4,300,4,300,1.129560000,0.0061
142.207.1.125,<->,136.25.188.162,0,0,4,224,4,224,1.128222000,0.7008
215.158.239.78,<->,196.94.212.182,4,300,0,0,4,300,1.125656000,0.0001
215.158.239.71,<->,113.23.66.197,4,1541,0,0,4,1541,1.125377000,0.1295
80.41.13.153,<->,0.33.170.223,4,822,0,0,4,822,1.125249000,0.0017
215.158.140.172,<->,107.118.3.253,4,637,0,0,4,637,1.123421000,0.1040
143.79.26.245,<->,136.25.188.242,0,0,4,727,4,727,1.123420000,0.3200
195.71.54.220,<->,136.25.188.176,0,0,4,260,4,260,1.121982000,0.8731
33.98.183.45,<->,8.20.87.153,0,0,4,1306,4,1306,1.121781000,0.5675
148.23.229.53,<->,136.25.188.44,0,0,4,2826,4,2826,1.120826000,0.7238
144.75.218.242,<->,138.127.225.15,4,1050,0,0,4,1050,1.120352000,0.6390
133.178.227.57,<->,106.188.253.166,4,1212,0,0,4,1212,1.119798000,0.2971
80.27.155.117,<->,56.7.53.161,4,791,0,0,4,791,1.117299000,0.0951
221.102.143.189,<->,6.73.198.167,0,0,4,303,4,303,1.116771000,0.0445
215.158.140.233,<->,131.141.218.103,4,644,0,0,4,644,1.116445000,0.7302
215.158.238.223,<->,72.23.148.249,4,1605,0,0,4,1605,1.113194000,0.3085
220.39.29.160,<->,215.158.239.120,0,0,4,320,4,320,1.112775000,0.0260
215.158.239.87,<->,199.69.190.94,4,775,0,0,4,775,1.112602000,0.1835
158.192.3.236,<->,136.25.188.160,0,0,4,1525,4,1525,1.110463000,0.2116
53.214.117.149,<->,48.53.179.147,0,0,4,596,4,596,1.110392000,0.3019
221.102.105.64,<->,199.12.99.193,4,240,0,0,4,240,1.109178000,0.6462
139.181.79.30,<->,111.151.139.218,4,224,0,0,4,224,1.108552000,0.0001
99.162.77.146,<->,53.161.230.230,4,477,0,0,4,477,1.108520000,0.5818
215.158.239.71,<->,80.56.79.89,4,2871,0,0,4,2871,1.108464000,0.7914
220.39.174.124,<->,215.158.238.209,0,0,4,1289,4,1289,1.107147000,0.1064
111.88.201.74,<->,8.220.176.253,0,0,4,224,4,224,1.106772000,0.0587
215.158.239.95,<->,199.69.190.94,4,775,0,0,4,775,1.105781000,0.1978
111.151.106.218,<->,8.252.222.202,0,0,4,224,4,224,1.101850000,0.0001
207.78.233.227,<->,92.27.194.147,0,0,4,425,4,425,1.100481000,0.6352
136.25.189.31,<->,119.196.23.21,4,1509,0,0,4,1509,1.100038000,0.1191
136.25.188.224,<->,113.23.104.246,4,249,0,0,4,249,1.097668000,0.1222
215.158.239.57,<->,199.20.30.163,4,249,0,0,4,249,1.095770000,0.2095
136.25.189.12,<->,120.155.8.71,4,1861,0,0,4,1861,1.095510000,0.1263
215.158.238.86,<->,100.224.166.122,4,1124,0,0,4,1124,1.094330000,0.5824
144.83.60.153,<->,92.162.253.75,0,0,4,3183,4,3183,1.094177000,0.6282
112.208.20.199,<->,102.50.212.36,0,0,4,206,4,206,1.093260000,0.2778
251.24.86.2,<->,8.252.222.239,0,0,4,243,4,243,1.092781000,0.2351
133.178.226.30,<->,131.1.253.248,4,1396,0,0,4,1396,1.091653000,0.8397
196.202.71.116,<->,92.27.194.147,0,0,4,425,4,425,1.090944000,0.5953
231.143.38.12,<->,136.25.188.226,0,0,4,296,4,296,1.090187000,0.9000
215.158.239.94,<->,116.106.46.57,4,2775,0,0,4,2775,1.089644000,0.7266
111.20.172.70,<->,33.233.141.56,0,0,4,481,4,481,1.087217000,0.0078
199.68.132.109,<->,136.25.188.254,0,0,4,762,4,762,1.086713000,0.4571
128.108.35.102,<->,8.52.179.237,0,0,4,619,4,619,1.083505000,0.5087
50.224.61.172,<->,50.204.192.140,4,224,0,0,4,224,1.083399000,0.0059
220.28.104.193,<->,215.158.140.89,0,0,4,393,4,393,1.082964000,0.1389
143.53.129.99,<->,136.25.188.54,0,0,4,1419,4,1419,1.082397000,0.8332
136.25.189.14,<->,98.166.239.34,4,1621,0,0,4,1621,1.081524000,0.0688
111.150.187.196,<->,8.252.223.176,0,0,4,1219,4,1219,1.080319000,0.3683
113.2.177.77,<->,50.224.76.235,0,0,4,747,4,747,1.078864000,0.1886
243.117.92.129,<->,80.38.54.70,0,0,4,1568,4,1568,1.078522000,0.1724
224.93.235.38,<->,80.27.157.204,0,0,4,4228,4,4228,1.077186000,0.7838
102.232.21.245,<->,56.114.235.120,4,2863,0,0,4,2863,1.075851000,0.1057
142.240.51.65,<->,136.25.188.222,0,0,4,249,4,249,1.075700000,0.5036
111.20.172.70,<->,101.224.89.138,0,0,4,451,4,451,1.075461000,0.0053
146.249.226.104,<->,8.252.222.157,0,0,4,249,4,249,1.074651000,0.2612
215.158.239.56,<->,199.32.234.249,4,228,0,0,4,228,1.074160000,0.3748
100.192.167.54,<->,8.52.222.23,0,0,4,200,4,200,1.072443000,0.0249
194.211.72.44,<->,8.52.168.63,0,0,4,427,4,427,1.070221000,0.3127
221.102.56.69,<->,6.74.97.41,0,0,4,470,4,470,1.069613000,0.0967
215.158.239.78,<->,196.108.19.79,4,2122,0,0,4,2122,1.068977000,0.0003
142.244.99.151,<->,136.25.188.198,0,0,4,300,4,300,1.068398000,0.0058
195.40.102.168,<->,136.25.188.198,0,0,4,827,4,827,1.067610000,0.6793
255.133.192.196,<->,255.133.192.20,4,393,0,0,4,393,1.064734000,0.3030
215.158.239.78,<->,136.139.59.126,4,2698,0,0,4,2698,1.063519000,0.4281
215.158.239.74,<->,0.195.237.14,4,4724,0,0,4,4724,1.063400000,0.8960
138.127.224.225,<->,101.224.89.178,0,0,4,980,4,980,1.063352000,0.0052
195.40.102.168,<->,136.25.188.173,0,0,4,827,4,827,1.063092000,0.6105
115.119.97.98,<->,50.224.89.243,0,0,4,300,4,300,1.062967000,0.1629
215.158.238.104,<->,139.160.226.230,4,1397,0,0,4,1397,1.062254000,0.0279
133.178.227.1,<->,106.188.228.2,4,1573,0,0,4,1573,1.061696000,0.1170
143.155.227.59,<->,136.25.188.221,0,0,4,444,4,444,1.061583000,0.1741
215.158.239.50,<->,6.73.247.53,4,1541,0,0,4,1541,1.061455000,0.0277
133.178.226.30,<->,61.34.184.198,4,1413,0,0,4,1413,1.057961000,0.2560
207.190.25.69,<->,136.25.188.237,0,0,4,200,4,200,1.057018000,0.0067
136.25.189.34,<->,96.156.169.169,4,1802,0,0,4,1802,1.055504000,0.1193
221.102.56.69,<->,98.128.109.60,0,0,4,470,4,470,1.055353000,0.0680
145.13.160.155,<->,8.52.171.120,0,0,4,762,4,762,1.054670000,0.0617
215.158.239.79,<->,199.20.4.232,4,200,0,0,4,200,1.053712000,0.1492
215.158.239.78,<->,195.55.155.189,4,249,0,0,4,249,1.052345000,0.7601
145.242.126.139,<->,53.94.218.235,4,780,0,0,4,780,1.051878000,0.2864
215.158.238.41,<->,111.150.207.206,4,224,0,0,4,224,1.051848000,0.0001
207.61.68.151,<->,136.25.188.176,0,0,4,762,4,762,1.050158000,0.5768
195.125.11.138,<->,136.25.188.238,0,0,4,540,4,540,1.048563000,0.8027
132.212.185.37,<->,80.42.130.198,0,0,4,1066,4,1066,1.047922000,0.2445
204.58.165.79,<->,136.25.188.160,0,0,4,312,4,312,1.043003000,0.5918
108.134.126.133,<->,100.206.91.45,4,517,0,0,4,517,1.041838000,0.1287
204.185.52.138,<->,136.25.188.252,0,0,4,255,4,255,1.040231000,0.0299
215.158.238.112,<->,98.249.65.11,4,2882,0,0,4,2882,1.039586000,0.0326
144.54.90.253,<->,8.250.148.31,0,0,4,232,4,232,1.037156000,0.0400
215.158.238.109,<->,145.116.209.92,4,682,0,0,4,682,1.036187000,0.0426
101.70.127.229,<->,53.94.228.30,4,932,0,0,4,932,1.035404000,0.2868
111.20.172.70,<->,33.233.141.95,0,0,4,601,4,601,1.035138000,0.0293
215.158.238.79,<->,139.163.161.34,4,681,0,0,4,681,1.034802000,0.0640
221.101.8.230,<->,218.5.150.2,4,664,0,0,4,664,1.034399000,0.3604
215.158.239.34,<->,57.210.104.216,4,3119,0,0,4,3119,1.034040000,0.8425
197.107.15.98,<->,136.25.188.252,0,0,4,1021,4,1021,1.033777000,0.7715
145.13.160.155,<->,8.52.222.23,0,0,4,762,4,762,1.032745000,0.0779
215.158.140.60,<->,149.254.114.58,4,2427,0,0,4,2427,1.032702000,0.4830
205.122.195.39,<->,133.178.226.19,0,0,4,1317,4,1317,1.032087000,0.1407
114.180.165.79,<->,92.27.219.153,0,0,4,236,4,236,1.031880000,0.2488
138.127.224.225,<->,33.233.141.107,0,0,4,976,4,976,1.031343000,0.0121
133.178.226.30,<->,89.86.110.68,4,1349,0,0,4,1349,1.030333000,0.1630
215.158.239.32,<->,80.57.141.192,4,1428,0,0,4,1428,1.030129000,0.0680
149.163.129.213,<->,133.178.227.24,0,0,4,2264,4,2264,1.029149000,0.9286
215.158.61.145,<->,8.176.8.189,0,0,4,2825,4,2825,1.028860000,0.8041
255.17.29.128,<->,8.220.176.253,0,0,4,202,4,202,1.027493000,0.2569
136.25.189.19,<->,113.143.223.216,4,1813,0,0,4,1813,1.027095000,0.1467
142.253.240.20,<->,136.25.188.224,0,0,4,762,4,762,1.026490000,0.4714
215.158.238.251,<->,131.219.230.200,4,1212,0,0,4,1212,1.026258000,0.2209
8.20.81.32,<->,6.122.148.3,0,0,4,224,4,224,1.022509000,0.9583
215.158.239.78,<->,199.20.29.53,4,949,0,0,4,949,1.022084000,0.3404
100.224.166.72,<->,8.52.242.68,0,0,4,232,4,232,1.021690000,0.0397
69.243.223.45,<->,8.252.221.196,0,0,4,501,4,501,1.021138000,0.5700
215.158.238.107,<->,131.215.37.57,4,1477,0,0,4,1477,1.021059000,0.1228
201.206.177.82,<->,80.42.185.53,0,0,4,4127,4,4127,1.019574000,0.2680
210.158.44.150,<->,127.62.26.151,4,1914,0,0,4,1914,1.019107000,0.1403
194.245.226.192,<->,8.252.222.179,0,0,4,243,4,243,1.015487000,0.3664
8.191.1.253,<->,8.43.206.150,0,0,4,232,4,232,1.015193000,0.0408
220.28.65.9,<->,136.25.189.27,0,0,4,2357,4,2357,1.015128000,0.0590
129.78.114.121,<->,33.241.84.13,4,762,0,0,4,762,1.014727000,0.3228
54.58.47.197,<->,48.52.68.86,0,0,4,2189,4,2189,1.013550000,0.2950
215.158.238.177,<->,142.93.98.208,4,1228,0,0,4,1228,1.013264000,0.1182
141.24.62.221,<->,100.228.42.88,0,0,4,2289,4,2289,1.011498000,0.4063
207.63.170.84,<->,136.25.188.227,0,0,4,762,4,762,1.011444000,0.4765
136.25.188.220,<->,8.227.55.120,4,232,0,0,4,232,1.010156000,0.0338
207.50.113.136,<->,8.182.136.221,0,0,4,225,4,225,1.009828000,0.8940
215.158.239.22,<->,215.158.127.153,4,3304,0,0,4,3304,1.008560000,0.0250
136.25.188.162,<->,8.240.118.187,4,1477,0,0,4,1477,1.006257000,0.3555
195.14.170.189,<->,136.25.188.53,0,0,4,249,4,249,1.005276000,0.2205
48.19.109.38,<->,8.252.221.238,0,0,4,494,4,494,1.003947000,0.4535
215.158.239.77,<->,119.196.23.42,4,2858,0,0,4,2858,1.003073000,0.2923
220.28.114.28,<->,136.25.188.248,0,0,4,421,4,421,1.002551000,0.0594
215.158.58.203,<->,136.25.189.213,0,0,4,261,4,261,1.002003000,0.0512
139.79.68.159,<->,8.220.176.253,0,0,4,430,4,430,1.001797000,0.1462
136.25.189.221,<->,111.150.207.58,4,224,0,0,4,224,1.001615000,0.0001
149.29.174.76,<->,50.224.76.234,0,0,4,845,4,845,1.001045000,0.2894
192.67.166.64,<->,56.114.235.120,4,1818,0,0,4,1818,0.999635000,0.0961
136.25.188.220,<->,57.210.104.163,4,1381,0,0,4,1381,0.999160000,0.1159
215.158.239.96,<->,199.71.81.103,4,212,0,0,4,212,0.998613000,0.2999
136.25.189.33,<->,96.156.169.203,4,2993,0,0,4,2993,0.997880000,1.0003
145.79.67.241,<->,8.220.189.81,0,0,4,603,4,603,0.997473000,0.0778
148.55.210.193,<->,136.25.188.252,0,0,4,1493,4,1493,0.996827000,0.2508
200.174.217.111,<->,6.188.163.28,4,592,0,0,4,592,0.995578000,0.9333
50.224.80.64,<->,8.239.128.102,4,924,0,0,4,924,0.994729000,0.3320
48.19.185.80,<->,8.252.221.198,0,0,4,200,4,200,0.992674000,0.1742
215.158.239.194,<->,53.176.57.216,4,694,0,0,4,694,0.990380000,0.0683
158.73.248.94,<->,89.183.110.72,0,0,4,4503,4,4503,0.989948000,0.1189
215.158.239.95,<->,199.82.248.216,4,388,0,0,4,388,0.989464000,0.9246
195.68.163.64,<->,136.25.188.55,0,0,4,224,4,224,0.989400000,0.0099
143.148.100.254,<->,0.195.210.34,0,0,4,255,4,255,0.988617000,0.3407
207.101.163.98,<->,8.182.224.87,0,0,4,228,4,228,0.985556000,0.2941
136.25.188.254,<->,131.2.115.214,4,1365,0,0,4,1365,0.983984000,0.2296
231.136.198.109,<->,136.25.188.163,0,0,4,495,4,495,0.983152000,0.8020
133.178.227.123,<->,111.150.207.167,4,224,0,0,4,224,0.982593000,0.0003
215.158.239.253,<->,56.97.187.116,4,465,0,0,4,465,0.980388000,0.0807
133.178.226.225,<->,106.188.226.66,4,270,0,0,4,270,0.979928000,0.2014
231.143.164.38,<->,136.25.188.178,0,0,4,269,4,269,0.979360000,0.9500
136.25.189.30,<->,96.156.169.253,4,1710,0,0,4,1710,0.978782000,0.3415
148.224.137.81,<->,136.25.189.0,0,0,4,1521,4,1521,0.977044000,0.4327
199.39.238.203,<->,136.25.188.178,0,0,4,249,4,249,0.976812000,0.3493
89.164.10.227,<->,50.224.76.234,0,0,4,902,4,902,0.974043000,0.0820
215.158.238.1,<->,192.229.43.55,4,909,0,0,4,909,0.973907000,0.0274
114.251.126.39,<->,92.27.209.193,0,0,4,200,4,200,0.972973000,0.4664
146.193.112.243,<->,8.252.221.206,0,0,4,399,4,399,0.972344000,0.3740
215.158.239.77,<->,199.20.23.28,4,853,0,0,4,853,0.971218000,0.9600
215.158.239.227,<->,139.36.120.124,4,4821,0,0,4,4821,0.968179000,0.0000
215.158.239.57,<->,143.42.79.210,4,762,0,0,4,762,0.967348000,0.4038
215.158.239.50,<->,196.104.175.12,4,297,0,0,4,297,0.966344000,0.2599
132.18.67.28,<->,6.228.48.108,0,0,4,782,4,782,0.965846000,0.2815
215.158.239.86,<->,72.23.194.223,4,1381,0,0,4,1381,0.964603000,0.2609
137.44.172.3,<->,100.228.42.93,0,0,4,534,4,534,0.964023000,0.1895
97.198.121.32,<->,80.27.154.150,4,773,0,0,4,773,0.961930000,0.9907
148.155.131.56,<->,89.183.104.250,0,0,4,2921,4,2921,0.961912000,0.0481
204.2.207.30,<->,136.25.188.253,0,0,4,762,4,762,0.961264000,0.5510
221.102.56.69,<->,80.42.218.23,0,0,4,470,4,470,0.960897000,0.0809
195.40.157.134,<->,136.25.188.54,0,0,4,249,4,249,0.960434000,0.2614
215.158.238.81,<->,112.220.206.116,4,1429,0,0,4,1429,0.959601000,0.1982
221.102.56.69,<->,109.3.152.35,0,0,4,470,4,470,0.954250000,0.0862
199.69.15.64,<->,136.25.188.174,0,0,4,249,4,249,0.952552000,0.1937
207.63.31.162,<->,136.25.188.173,0,0,4,762,4,762,0.952210000,0.5228
145.252.126.18,<->,113.123.103.236,4,200,0,0,4,200,0.951004000,0.0025
215.158.238.81,<->,139.160.226.246,4,1509,0,0,4,1509,0.950941000,0.1440
111.147.219.221,<->,54.59.84.229,4,224,0,0,4,224,0.950712000,0.9981
215.158.238.47,<->,29.211.186.213,4,1589,0,0,4,1589,0.950595000,0.2585
215.158.239.79,<->,196.92.199.220,4,292,0,0,4,292,0.950486000,0.8112
204.2.117.32,<->,136.25.188.55,0,0,4,249,4,249,0.950445000,0.2333
132.128.61.42,<->,80.41.0.92,0,0,4,231,4,231,0.950248000,0.1061
215.158.239.71,<->,126.219.49.170,4,1525,0,0,4,1525,0.949643000,0.2357
89.155.206.148,<->,35.56.97.26,0,0,4,1162,4,1162,0.948966000,0.1688
215.158.239.94,<->,199.20.23.73,4,249,0,0,4,249,0.948668000,0.2509
204.186.243.62,<->,136.25.188.196,0,0,4,592,4,592,0.948587000,0.8005
215.158.239.56,<->,143.91.212.113,4,212,0,0,4,212,0.948375000,1.0135
215.158.239.97,<->,199.20.30.178,4,224,0,0,4,224,0.948014000,0.0613
133.178.226.227,<->,111.52.90.194,4,459,0,0,4,459,0.947905000,0.7632
215.158.239.95,<->,142.166.122.95,4,762,0,0,4,762,0.947737000,0.4521
89.183.106.113,<->,89.155.206.148,4,1162,0,0,4,1162,0.947026000,0.1687
148.21.212.180,<->,136.25.189.80,0,0,4,2746,4,2746,0.946845000,0.6952
8.52.189.169,<->,6.15.207.94,4,232,0,0,4,232,0.941119000,0.0495
105.86.192.220,<->,0.195.210.44,0,0,4,335,4,335,0.940297000,0.1929
215.158.238.107,<->,158.184.99.168,4,1205,0,0,4,1205,0.939518000,0.2993
143.23.88.205,<->,136.25.188.254,0,0,4,3104,4,3104,0.939516000,0.7263
117.63.136.24,<->,92.27.219.21,0,0,4,206,4,206,0.938431000,0.2514
136.25.188.220,<->,29.214.108.180,4,2972,0,0,4,2972,0.937087000,0.9878
143.42.218.33,<->,136.25.188.253,0,0,4,200,4,200,0.936448000,0.0046
148.146.91.26,<->,136.25.188.255,0,0,4,2650,4,2650,0.936034000,0.8217
133.73.198.233,<->,8.52.250.106,0,0,4,232,4,232,0.934779000,0.0403
133.178.227.29,<->,133.56.180.78,4,1679,0,0,4,1679,0.932851000,1.0176
139.193.141.200,<->,27.74.241.183,4,200,0,0,4,200,0.931850000,0.1144
89.254.119.99,<->,8.252.221.171,0,0,4,1405,4,1405,0.930220000,0.1782
215.158.238.113,<->,8.191.15.70,4,1717,0,0,4,1717,0.929611000,0.1883
199.71.209.205,<->,136.25.188.226,0,0,4,782,4,782,0.929558000,0.9355
215.158.239.57,<->,199.20.31.234,4,224,0,0,4,224,0.927508000,0.3293
107.27.244.59,<->,50.224.89.241,0,0,4,1281,4,1281,0.926698000,0.2897
142.240.226.24,<->,136.25.188.163,0,0,4,264,4,264,0.926302000,0.0050
215.158.238.133,<->,149.96.53.42,4,1509,0,0,4,1509,0.924910000,0.1063
144.85.170.208,<->,98.87.144.179,4,224,0,0,4,224,0.922821000,0.7798
215.158.239.49,<->,156.165.37.65,4,2698,0,0,4,2698,0.922224000,0.4130
109.222.246.249,<->,14.71.93.243,4,532,0,0,4,532,0.921240000,0.2441
136.25.188.209,<->,8.227.55.209,4,232,0,0,4,232,0.920784000,0.0339
136.25.189.14,<->,29.214.108.211,4,2826,0,0,4,2826,0.920501000,0.3762
210.209.251.211,<->,101.70.96.205,0,0,4,666,4,666,0.919778000,0.1923
133.178.226.19,<->,126.219.246.73,4,2698,0,0,4,2698,0.919233000,0.3116
139.248.201.139,<->,50.200.173.137,4,320,0,0,4,320,0.919139000,0.1138
200.174.214.186,<->,53.244.62.198,4,592,0,0,4,592,0.918441000,0.4329
215.158.239.30,<->,158.166.175.250,4,1717,0,0,4,1717,0.916332000,0.1916
215.158.238.196,<->,148.190.124.22,4,1749,0,0,4,1749,0.916293000,0.1793
204.184.188.203,<->,136.25.188.255,0,0,4,248,4,248,0.914041000,0.1565
195.68.154.205,<->,136.25.188.252,0,0,4,1328,4,1328,0.913442000,0.8200
215.158.238.135,<->,8.191.6.217,4,1413,0,0,4,1413,0.910079000,0.0293
215.158.239.97,<->,199.20.28.116,4,248,0,0,4,248,0.909553000,0.0804
95.246.172.42,<->,8.252.221.223,0,0,4,492,4,492,0.908989000,0.3761
199.71.115.136,<->,136.25.188.243,0,0,4,200,4,200,0.908860000,0.2587
215.158.61.183,<->,8.176.8.179,0,0,4,567,4,567,0.907488000,0.6841
8.222.6.41,<->,8.52.132.227,0,0,4,232,4,232,0.907170000,0.0504
159.137.152.34,<->,133.178.226.227,0,0,4,270,4,270,0.906814000,0.7906
215.158.238.101,<->,145.116.209.82,4,682,0,0,4,682,0.906380000,0.0699
136.25.188.254,<->,8.227.55.190,4,232,0,0,4,232,0.905152000,0.0338
111.199.230.116,<->,0.195.210.44,0,0,4,335,4,335,0.905068000,0.1410
195.14.131.241,<->,136.25.188.176,0,0,4,294,4,294,0.904274000,0.0101
136.25.188.239,<->,8.227.55.207,4,232,0,0,4,232,0.903897000,0.0338
133.178.227.57,<->,104.154.137.243,4,1304,0,0,4,1304,0.903422000,0.2987
112.208.20.199,<->,99.72.196.59,0,0,4,206,4,206,0.903116000,0.2630
204.200.58.95,<->,136.25.188.53,0,0,4,300,4,300,0.902616000,0.0033
224.213.229.102,<->,109.222.200.21,0,0,4,993,4,993,0.902509000,0.0017
215.158.209.250,<->,80.27.157.207,0,0,4,232,4,232,0.901820000,0.0828
195.4.120.73,<->,136.25.188.209,0,0,4,762,4,762,0.901434000,0.6123
133.178.227.39,<->,133.56.180.13,4,1194,0,0,4,1194,0.901296000,0.1040
215.158.239.94,<->,29.214.108.164,4,2682,0,0,4,2682,0.899572000,0.9650
215.158.239.79,<->,195.43.124.209,4,465,0,0,4,465,0.898278000,0.4130
215.158.239.84,<->,142.241.4.24,4,264,0,0,4,264,0.897671000,0.0094
215.158.239.18,<->,113.86.1.52,4,1721,0,0,4,1721,0.895028000,0.1005
136.25.188.242,<->,8.227.55.221,4,232,0,0,4,232,0.894814000,0.0381
215.158.61.226,<->,8.252.222.217,0,0,4,2567,4,2567,0.894596000,0.0681
215.158.238.33,<->,113.23.104.213,4,249,0,0,4,249,0.894520000,0.1174
136.25.189.29,<->,29.211.228.247,4,3226,0,0,4,3226,0.892326000,0.9241
215.158.239.69,<->,29.214.73.151,4,1461,0,0,4,1461,0.891963000,0.2174
215.158.239.78,<->,199.20.30.22,4,200,0,0,4,200,0.891490000,0.1471
99.215.109.108,<->,8.182.244.237,0,0,4,224,4,224,0.889957000,0.0352
215.158.239.70,<->,143.173.13.198,4,2698,0,0,4,2698,0.889670000,0.9587
200.174.210.241,<->,53.213.148.81,4,362,0,0,4,362,0.888975000,1.0560
215.158.239.84,<->,199.20.31.92,4,249,0,0,4,249,0.888273000,0.2703
136.25.188.46,<->,122.159.245.165,4,1301,0,0,4,1301,0.888030000,0.2222
215.158.61.183,<->,8.176.8.195,0,0,4,568,4,568,0.887399000,0.3501
106.0.126.211,<->,89.183.104.163,0,0,4,4679,4,4679,0.886693000,0.9097
215.158.239.166,<->,96.155.60.129,4,224,0,0,4,224,0.886188000,0.0000
215.158.140.231,<->,126.219.101.173,4,2342,0,0,4,2342,0.885451000,0.5084
89.183.104.172,<->,78.44.243.152,4,693,0,0,4,693,0.885326000,1.0065
215.158.238.148,<->,126.219.190.117,4,1397,0,0,4,1397,0.885059000,0.1344
203.215.188.177,<->,111.151.237.20,4,445,0,0,4,445,0.882055000,0.5571
199.81.160.29,<->,136.25.188.255,0,0,4,224,4,224,0.880886000,1.0203
215.158.238.104,<->,143.155.227.57,4,1269,0,0,4,1269,0.879925000,0.2941
215.158.238.73,<->,104.3.161.84,4,1397,0,0,4,1397,0.879453000,0.2353
215.158.239.59,<->,112.68.105.216,4,2746,0,0,4,2746,0.877381000,0.6137
159.162.14.181,<->,8.182.227.180,0,0,4,1191,4,1191,0.877089000,0.0956
144.86.150.215,<->,118.90.83.212,4,220,0,0,4,220,0.876793000,0.3162
215.158.238.96,<->,192.227.190.244,4,1909,0,0,4,1909,0.876025000,0.1624
80.40.109.15,<->,8.55.211.213,4,470,0,0,4,470,0.875353000,0.0702
133.178.226.215,<->,6.29.108.74,4,948,0,0,4,948,0.874538000,0.0453
199.122.246.125,<->,136.25.188.220,0,0,4,200,4,200,0.871193000,0.4262
248.239.128.55,<->,233.145.251.212,4,2234,0,0,4,2234,0.870969000,0.0740
199.52.130.58,<->,136.25.188.176,0,0,4,249,4,249,0.867890000,0.2050
206.103.215.40,<->,136.25.189.45,0,0,4,1605,4,1605,0.866458000,0.2981
113.179.35.228,<->,92.27.27.174,0,0,4,236,4,236,0.865226000,0.2073
246.253.198.51,<->,116.77.119.226,4,202,0,0,4,202,0.862147000,0.6131
215.158.209.250,<->,80.27.152.110,0,0,4,232,4,232,0.861822000,0.1395
215.158.209.250,<->,80.27.154.164,0,0,4,232,4,232,0.861787000,0.1281
205.127.108.113,<->,33.233.141.35,0,0,4,871,4,871,0.860504000,0.6453
97.175.121.18,<->,8.20.87.86,0,0,4,232,4,232,0.858643000,0.1365
199.72.100.251,<->,136.25.188.241,0,0,4,300,4,300,0.857742000,0.0054
215.158.238.221,<->,131.219.110.180,4,1224,0,0,4,1224,0.857504000,0.0969
215.158.239.222,<->,215.158.61.243,4,4890,0,0,4,4890,0.857380000,0.0000
221.102.56.69,<->,192.65.178.170,0,0,4,470,4,470,0.857093000,0.1684
220.187.80.11,<->,92.27.27.173,0,0,4,628,4,628,0.855550000,0.7116
136.25.188.239,<->,8.227.55.87,4,232,0,0,4,232,0.853478000,0.0382
249.101.236.84,<->,53.213.100.206,4,387,0,0,4,387,0.852776000,0.1904
215.158.239.17,<->,80.57.141.220,4,1470,0,0,4,1470,0.850896000,0.0315
109.1.45.170,<->,56.114.235.120,4,715,0,0,4,715,0.850490000,0.1415
121.252.29.18,<->,92.27.209.249,0,0,4,326,4,326,0.850290000,0.2821
215.158.239.49,<->,199.20.31.92,4,249,0,0,4,249,0.849187000,0.2906
215.158.238.66,<->,158.192.3.223,4,1541,0,0,4,1541,0.848843000,0.3246
215.158.239.77,<->,207.16.255.152,4,200,0,0,4,200,0.848689000,0.1407
215.158.140.240,<->,113.93.9.90,4,232,0,0,4,232,0.848369000,0.2375
8.252.213.192,<->,8.250.155.12,0,0,4,232,4,232,0.848117000,0.0535
204.58.93.172,<->,50.224.76.234,0,0,4,1080,4,1080,0.847884000,0.5628
132.18.67.30,<->,100.94.106.156,0,0,4,810,4,810,0.843790000,0.5721
215.158.238.133,<->,148.129.19.107,4,1381,0,0,4,1381,0.843546000,0.2160
215.158.238.133,<->,131.2.115.252,4,1477,0,0,4,1477,0.843311000,0.1451
215.158.239.56,<->,142.253.200.173,4,200,0,0,4,200,0.842813000,0.8897
246.108.106.187,<->,111.147.185.223,0,0,4,206,4,206,0.842250000,0.2891
215.158.238.47,<->,206.103.215.202,4,1541,0,0,4,1541,0.841592000,0.1874
215.158.239.154,<->,111.151.237.171,4,2401,0,0,4,2401,0.840934000,0.1242
133.178.226.30,<->,93.190.35.178,4,1253,0,0,4,1253,0.840901000,0.1363
111.147.249.144,<->,50.145.213.17,4,225,0,0,4,225,0.840691000,0.0041
215.158.238.140,<->,149.184.89.21,4,1461,0,0,4,1461,0.840582000,0.1698
252.253.8.169,<->,0.195.210.46,0,0,4,743,4,743,0.839841000,0.0021
159.146.67.44,<->,111.147.178.69,0,0,4,364,4,364,0.839808000,0.6987
133.178.226.18,<->,29.211.6.60,4,2762,0,0,4,2762,0.839337000,1.0000
215.158.239.86,<->,199.20.31.92,4,249,0,0,4,249,0.839212000,0.3005
215.158.239.95,<->,196.238.162.142,4,243,0,0,4,243,0.836400000,1.1400
215.158.238.96,<->,123.166.46.220,4,1141,0,0,4,1141,0.834731000,0.1342
133.178.227.54,<->,133.56.180.88,4,1881,0,0,4,1881,0.833847000,0.9389
215.158.238.69,<->,111.151.109.33,4,224,0,0,4,224,0.833819000,0.0001
215.158.239.51,<->,196.90.171.92,4,280,0,0,4,280,0.833484000,0.1284
143.42.217.215,<->,136.25.188.222,0,0,4,1107,4,1107,0.833479000,0.3158
215.158.239.182,<->,57.210.104.45,4,458,0,0,4,458,0.832329000,0.3332
136.25.189.13,<->,8.222.98.72,4,2570,0,0,4,2570,0.829763000,0.6413
215.158.140.76,<->,29.211.228.217,4,1228,0,0,4,1228,0.828019000,0.7086
204.63.85.243,<->,136.25.188.209,0,0,4,248,4,248,0.826353000,0.8603
113.23.77.201,<->,101.126.182.154,0,0,4,458,4,458,0.826110000,0.3137
215.158.239.28,<->,29.214.74.161,4,1715,0,0,4,1715,0.825599000,0.2416
17.156.124.197,<->,8.20.87.95,0,0,4,1778,4,1778,0.825308000,0.0614
136.25.189.77,<->,135.229.0.202,4,1525,0,0,4,1525,0.824206000,0.4524
119.219.148.87,<->,92.168.217.146,0,0,4,224,4,224,0.823356000,1.1566
136.25.188.46,<->,113.23.20.116,4,1461,0,0,4,1461,0.821072000,0.4883
136.25.188.47,<->,113.23.104.246,4,249,0,0,4,249,0.820487000,0.1211
215.158.140.60,<->,8.40.51.233,4,1252,0,0,4,1252,0.818786000,0.0997
207.11.121.137,<->,8.252.222.186,0,0,4,453,4,453,0.818509000,0.2262
199.81.31.221,<->,136.25.188.253,0,0,4,239,4,239,0.817994000,0.0014
215.158.239.50,<->,207.59.29.37,4,300,0,0,4,300,0.817820000,0.0759
215.158.239.33,<->,215.158.127.181,4,3112,0,0,4,3112,0.817482000,1.1723
145.76.225.248,<->,80.27.159.59,0,0,4,1014,4,1014,0.816962000,0.7667
199.55.114.51,<->,8.182.235.164,0,0,4,694,4,694,0.815665000,0.7061
136.25.189.2,<->,113.143.223.213,4,1397,0,0,4,1397,0.811934000,0.1386
220.39.233.154,<->,215.158.238.81,0,0,4,2682,4,2682,0.811425000,0.7883
136.25.188.54,<->,8.227.55.201,4,232,0,0,4,232,0.809597000,0.0379
136.25.188.162,<->,8.227.55.188,4,232,0,0,4,232,0.808266000,0.0379
133.178.226.7,<->,131.144.113.188,4,2794,0,0,4,2794,0.807342000,0.8998
221.102.56.69,<->,6.74.255.56,0,0,4,470,4,470,0.805348000,0.0759
126.102.186.4,<->,8.228.215.123,0,0,4,489,4,489,0.804751000,1.1265
36.123.55.196,<->,8.20.87.35,0,0,4,228,4,228,0.804647000,0.1664
204.63.230.255,<->,136.25.188.227,0,0,4,224,4,224,0.803966000,0.1409
199.82.75.107,<->,136.25.188.241,0,0,4,794,4,794,0.803860000,0.6241
221.102.56.69,<->,98.128.50.78,0,0,4,470,4,470,0.803187000,0.0701
215.158.61.182,<->,8.176.8.199,0,0,4,5861,4,5861,0.802568000,0.0000
215.158.239.17,<->,145.13.164.231,4,1767,0,0,4,1767,0.801915000,1.1788
215.158.239.92,<->,196.104.167.37,4,457,0,0,4,457,0.798639000,0.9998
215.158.239.85,<->,204.226.14.183,4,249,0,0,4,249,0.796671000,0.1588
215.158.238.92,<->,149.17.136.247,4,1525,0,0,4,1525,0.795938000,0.0965
111.14.20.30,<->,8.252.222.36,0,0,4,243,4,243,0.795020000,0.1908
50.224.76.235,<->,0.159.34.250,4,695,0,0,4,695,0.793771000,0.1933
215.158.238.148,<->,80.47.111.74,4,1333,0,0,4,1333,0.792832000,0.0877
215.158.238.135,<->,112.220.206.117,4,2538,0,0,4,2538,0.792587000,1.1538
246.253.198.51,<->,112.9.237.77,4,206,0,0,4,206,0.790827000,0.3853
50.97.188.57,<->,8.220.176.253,0,0,4,635,4,635,0.789618000,0.0768
215.158.239.99,<->,199.20.29.153,4,224,0,0,4,224,0.789490000,0.0785
39.189.53.64,<->,8.182.238.140,0,0,4,413,4,413,0.788782000,0.0869
198.190.133.255,<->,50.224.89.243,0,0,4,2282,4,2282,0.788588000,0.5499
142.255.45.106,<->,136.25.188.242,0,0,4,762,4,762,0.788382000,1.0762
195.68.58.47,<->,136.25.188.211,0,0,4,794,4,794,0.787406000,0.5191
136.25.188.160,<->,8.252.210.162,4,1425,0,0,4,1425,0.786206000,0.1775
96.150.228.172,<->,8.52.188.70,0,0,4,232,4,232,0.786032000,0.0396
136.129.94.157,<->,6.145.165.55,4,590,0,0,4,590,0.785044000,0.2896
144.75.218.246,<->,138.127.225.148,4,1464,0,0,4,1464,0.784830000,1.0474
204.200.56.185,<->,136.25.188.252,0,0,4,300,4,300,0.784385000,0.0016
215.158.239.76,<->,207.167.180.154,4,249,0,0,4,249,0.784094000,0.2501
144.83.60.153,<->,92.162.253.12,0,0,4,5346,4,5346,0.783945000,0.0000
215.158.239.42,<->,96.135.154.168,4,3199,0,0,4,3199,0.781113000,1.1730
195.13.248.147,<->,136.25.188.227,0,0,4,762,4,762,0.780899000,0.4016
215.158.239.56,<->,199.20.31.82,4,224,0,0,4,224,0.779917000,1.1199
17.41.75.11,<->,8.220.190.86,0,0,4,1155,4,1155,0.779638000,1.0081
215.158.140.60,<->,8.240.116.184,4,2644,0,0,4,2644,0.779577000,0.1993
139.241.64.235,<->,8.252.223.143,0,0,4,1713,4,1713,0.778719000,0.0266
80.41.18.163,<->,8.209.235.29,4,2349,0,0,4,2349,0.778331000,0.1905
207.191.232.222,<->,136.25.188.226,0,0,4,472,4,472,0.777659000,1.0153
133.172.187.23,<->,8.183.25.124,0,0,4,762,4,762,0.777632000,0.0643
231.143.12.233,<->,136.25.188.174,0,0,4,236,4,236,0.775068000,0.2207
199.83.57.122,<->,136.25.188.177,0,0,4,1181,4,1181,0.773961000,0.5973
239.66.184.165,<->,100.92.208.90,0,0,4,808,4,808,0.773879000,0.5365
195.127.214.45,<->,136.25.188.242,0,0,4,1062,4,1062,0.773092000,0.4259
215.158.140.60,<->,131.219.230.194,4,2457,0,0,4,2457,0.772117000,0.7863
143.155.227.40,<->,136.25.188.210,0,0,4,1617,4,1617,0.769419000,0.2437
207.77.199.147,<->,136.25.188.210,0,0,4,288,4,288,0.768410000,1.0104
158.192.3.222,<->,136.25.188.237,0,0,4,1365,4,1365,0.764759000,0.5113
215.158.238.73,<->,113.23.117.105,4,1253,0,0,4,1253,0.762482000,1.2171
221.102.56.69,<->,98.128.50.14,0,0,4,470,4,470,0.761328000,0.0686
215.158.239.48,<->,199.106.84.20,4,886,0,0,4,886,0.760130000,0.3911
136.25.188.163,<->,8.227.55.195,4,232,0,0,4,232,0.759637000,0.0338
215.158.238.98,<->,69.31.238.234,4,1537,0,0,4,1537,0.759284000,0.6060
215.158.239.50,<->,199.20.29.87,4,370,0,0,4,370,0.758545000,0.8001
109.222.208.215,<->,93.196.138.15,4,240,0,0,4,240,0.757548000,1.0821
97.126.24.188,<->,54.36.66.170,4,438,0,0,4,438,0.757012000,1.0954
199.82.89.20,<->,136.25.188.227,0,0,4,264,4,264,0.756569000,0.4989
136.25.189.15,<->,6.29.108.5,4,1461,0,0,4,1461,0.756548000,0.0985
125.216.43.60,<->,8.252.222.204,0,0,4,1397,4,1397,0.754759000,0.1158
133.178.226.19,<->,118.20.108.74,4,1365,0,0,4,1365,0.754153000,0.1682
97.126.28.102,<->,8.235.232.213,4,1016,0,0,4,1016,0.753745000,0.2081
215.158.238.74,<->,106.188.252.233,4,1349,0,0,4,1349,0.753451000,0.1114
215.158.61.202,<->,136.25.188.42,0,0,4,3388,4,3388,0.753427000,1.0202
136.25.189.46,<->,96.156.169.247,4,1670,0,0,4,1670,0.753155000,0.1349
215.158.61.242,<->,8.176.8.252,0,0,4,5989,4,5989,0.752787000,0.0000
215.158.238.205,<->,122.159.115.147,4,232,0,0,4,232,0.752652000,0.2241
207.125.234.7,<->,22.59.4.26,0,0,4,200,4,200,0.752427000,1.2002
215.158.239.59,<->,199.20.5.35,4,249,0,0,4,249,0.750056000,0.2690
136.25.188.162,<->,8.227.55.199,4,232,0,0,4,232,0.749390000,0.0337
199.50.155.29,<->,136.25.188.46,0,0,4,264,4,264,0.747723000,0.0064
221.102.56.69,<->,6.74.93.51,0,0,4,470,4,470,0.746831000,0.2059
207.173.101.203,<->,136.25.188.253,0,0,4,1025,4,1025,0.742494000,1.0302
133.178.226.7,<->,8.222.212.27,4,1269,0,0,4,1269,0.741619000,0.1321
215.158.239.58,<->,207.63.148.252,4,782,0,0,4,782,0.741605000,0.6820
195.13.5.21,<->,136.25.188.162,0,0,4,294,4,294,0.741430000,0.0200
136.25.188.254,<->,122.159.245.165,4,2474,0,0,4,2474,0.741129000,1.2102
136.25.188.162,<->,8.227.55.102,4,232,0,0,4,232,0.739491000,0.0382
215.158.239.91,<->,139.5.114.139,4,380,0,0,4,380,0.739196000,0.0562
17.43.39.87,<->,8.220.184.39,0,0,4,503,4,503,0.736602000,0.0720
215.158.239.48,<->,196.110.250.206,4,570,0,0,4,570,0.735933000,0.8500
215.158.238.92,<->,131.1.253.244,4,1612,0,0,4,1612,0.735896000,0.4982
142.222.40.123,<->,8.252.222.143,0,0,4,200,4,200,0.733855000,0.0001
215.158.238.64,<->,115.140.139.149,4,1405,0,0,4,1405,0.733631000,0.8309
204.186.97.54,<->,136.25.188.227,0,0,4,224,4,224,0.733312000,0.0197
207.225.99.227,<->,0.195.210.46,0,0,4,1561,4,1561,0.733306000,0.2246
149.178.48.72,<->,129.224.112.252,0,0,4,305,4,305,0.733130000,0.8158
215.158.238.141,<->,113.23.117.93,4,1349,0,0,4,1349,0.732092000,0.3164
207.173.220.101,<->,136.25.188.225,0,0,4,272,4,272,0.732059000,0.9199
215.158.239.76,<->,199.106.112.188,4,300,0,0,4,300,0.730319000,0.0301
215.158.238.251,<->,119.168.0.250,4,1311,0,0,4,1311,0.729178000,0.2840
197.32.230.217,<->,145.252.127.155,0,0,4,200,4,200,0.729083000,0.0054
111.151.109.41,<->,8.252.221.72,0,0,4,224,4,224,0.728789000,0.0001
199.38.75.183,<->,136.25.188.236,0,0,4,264,4,264,0.727829000,0.3221
136.25.188.176,<->,8.227.55.220,4,232,0,0,4,232,0.726566000,0.0340
237.15.238.95,<->,92.27.219.235,0,0,4,236,4,236,0.726518000,0.1943
215.158.238.96,<->,111.151.70.65,4,1493,0,0,4,1493,0.726500000,1.2510
215.158.239.35,<->,122.158.246.249,4,1540,0,0,4,1540,0.725749000,0.1188
215.158.238.104,<->,113.20.94.123,4,1349,0,0,4,1349,0.725056000,0.3455
195.41.211.140,<->,136.25.188.225,0,0,4,200,4,200,0.722980000,0.8579
215.158.239.93,<->,91.247.40.79,4,2245,0,0,4,2245,0.722920000,0.1582
197.161.251.39,<->,136.25.188.242,0,0,4,762,4,762,0.722901000,0.2599
136.25.189.81,<->,8.222.58.232,4,2714,0,0,4,2714,0.722724000,1.2251
207.60.47.126,<->,136.25.188.225,0,0,4,200,4,200,0.721697000,0.7633
132.153.80.240,<->,8.53.4.76,0,0,4,643,4,643,0.721398000,0.3129
113.246.46.33,<->,92.27.219.211,0,0,4,708,4,708,0.721380000,0.7848
215.158.238.80,<->,113.23.104.246,4,249,0,0,4,249,0.721377000,0.1197
199.33.55.240,<->,136.25.188.255,0,0,4,782,4,782,0.720779000,1.1967
53.148.153.145,<->,8.52.222.253,0,0,4,249,4,249,0.720593000,0.0575
109.3.152.190,<->,8.45.168.98,4,352,0,0,4,352,0.720522000,0.1130
139.5.114.37,<->,8.52.184.161,0,0,4,232,4,232,0.719595000,0.0431
215.158.239.34,<->,149.96.60.11,4,1675,0,0,4,1675,0.718383000,0.2516
215.158.239.92,<->,199.20.6.166,4,249,0,0,4,249,0.717868000,1.1204
143.35.68.6,<->,136.25.188.255,0,0,4,762,4,762,0.717537000,0.5645
212.70.75.120,<->,136.25.188.226,0,0,4,1509,4,1509,0.717450000,0.1437
204.62.135.155,<->,136.25.188.238,0,0,4,268,4,268,0.713974000,0.3400
199.14.203.15,<->,136.25.188.163,0,0,4,300,4,300,0.713926000,0.0062
129.236.114.39,<->,33.233.141.68,0,0,4,4968,4,4968,0.712086000,0.0000
136.25.188.220,<->,8.227.55.42,4,232,0,0,4,232,0.711964000,0.0345
133.178.226.222,<->,80.56.246.234,4,614,0,0,4,614,0.709232000,0.1747
199.39.82.40,<->,136.25.188.53,0,0,4,224,4,224,0.708094000,0.7897
98.67.150.9,<->,53.218.56.159,4,345,0,0,4,345,0.704235000,0.1488
80.40.50.197,<->,29.156.85.9,4,1372,0,0,4,1372,0.703444000,1.1615
195.55.61.39,<->,136.25.188.239,0,0,4,200,4,200,0.701727000,0.2064
247.136.181.127,<->,27.160.143.95,4,200,0,0,4,200,0.701450000,1.2080
199.120.15.89,<->,136.25.188.252,0,0,4,869,4,869,0.701165000,0.9488
195.124.60.10,<->,136.25.188.163,0,0,4,782,4,782,0.699933000,1.1494
215.158.239.50,<->,199.20.6.65,4,224,0,0,4,224,0.699881000,1.1604
133.178.226.60,<->,115.140.139.155,4,1525,0,0,4,1525,0.699266000,0.3235
215.158.239.71,<->,61.35.124.168,4,1473,0,0,4,1473,0.698418000,0.4935
249.101.194.239,<->,112.208.20.255,4,206,0,0,4,206,0.697783000,0.2683
215.158.239.93,<->,196.90.181.186,4,460,0,0,4,460,0.697540000,1.1000
252.36.227.210,<->,80.38.22.80,0,0,4,1569,4,1569,0.697238000,0.7923
195.70.121.111,<->,136.25.188.46,0,0,4,762,4,762,0.697161000,0.3681
215.158.238.95,<->,29.211.228.81,4,1218,0,0,4,1218,0.696875000,0.1262
196.200.227.12,<->,8.252.222.185,0,0,4,243,4,243,0.696578000,0.2018
215.158.238.73,<->,122.158.49.151,4,2085,0,0,4,2085,0.695737000,0.1278
54.38.83.190,<->,48.54.62.209,0,0,4,1672,4,1672,0.695021000,1.2169
149.86.40.45,<->,8.220.180.52,0,0,4,762,4,762,0.694753000,0.2078
199.80.3.28,<->,136.25.188.224,0,0,4,1256,4,1256,0.694196000,1.1160
199.14.149.165,<->,136.25.188.175,0,0,4,206,4,206,0.693441000,1.0424
215.158.239.97,<->,196.89.121.16,4,248,0,0,4,248,0.692655000,0.5143
116.234.157.117,<->,50.224.76.234,0,0,4,4168,4,4168,0.691981000,0.2740
221.102.56.69,<->,192.67.74.7,0,0,4,470,4,470,0.691866000,0.3137
195.70.121.111,<->,136.25.188.236,0,0,4,762,4,762,0.691424000,0.3314
195.5.15.224,<->,136.25.188.54,0,0,4,200,4,200,0.691324000,0.1939
221.102.56.69,<->,213.38.232.168,0,0,4,470,4,470,0.688867000,0.0821
215.158.238.80,<->,113.23.104.223,4,1301,0,0,4,1301,0.688178000,0.2736
215.158.239.57,<->,199.20.30.108,4,260,0,0,4,260,0.687934000,0.6200
204.62.218.198,<->,136.25.188.173,0,0,4,312,4,312,0.687929000,0.9200
207.62.181.205,<->,136.25.188.174,0,0,4,200,4,200,0.687680000,0.5317
142.166.245.108,<->,136.25.188.174,0,0,4,300,4,300,0.687052000,0.0061
76.179.20.16,<->,8.252.222.21,0,0,4,527,4,527,0.686944000,0.5309
194.216.205.175,<->,136.25.188.178,0,0,4,297,4,297,0.686774000,0.3792
195.71.50.46,<->,136.25.188.177,0,0,4,200,4,200,0.686654000,0.4728
196.240.89.116,<->,136.25.188.196,0,0,4,224,4,224,0.686598000,0.0199
199.50.23.168,<->,136.25.188.227,0,0,4,200,4,200,0.685618000,0.0044
215.158.238.135,<->,207.88.93.20,4,1509,0,0,4,1509,0.684399000,0.2499
215.158.239.31,<->,8.252.214.212,4,1900,0,0,4,1900,0.684366000,0.0622
215.158.66.193,<->,8.252.221.76,0,0,4,508,4,508,0.683165000,0.0018
136.25.189.53,<->,96.156.169.210,4,5760,0,0,4,5760,0.683019000,0.0000
195.111.188.39,<->,91.231.193.172,0,0,4,200,4,200,0.682276000,1.2581
199.51.129.216,<->,136.25.188.177,0,0,4,2936,4,2936,0.681994000,0.4331
215.158.238.190,<->,131.219.110.168,4,1285,0,0,4,1285,0.680389000,0.0978
97.22.56.145,<->,8.183.25.124,0,0,4,423,4,423,0.678790000,0.4834
215.158.61.202,<->,8.176.8.204,0,0,4,2951,4,2951,0.677997000,0.4680
194.232.230.2,<->,136.25.188.176,0,0,4,723,4,723,0.677784000,1.1314
133.178.226.29,<->,122.158.246.172,4,1365,0,0,4,1365,0.675936000,0.1767
215.158.239.34,<->,8.191.15.68,4,1790,0,0,4,1790,0.675440000,0.0380
215.158.239.96,<->,196.90.189.109,4,272,0,0,4,272,0.674882000,1.1000
205.171.233.183,<->,0.195.210.42,0,0,4,264,4,264,0.673638000,0.1283
221.102.56.69,<->,109.0.215.102,0,0,4,470,4,470,0.672989000,0.0737
215.158.239.95,<->,143.134.191.112,4,249,0,0,4,249,0.672773000,0.2171
215.158.239.86,<->,199.20.29.193,4,200,0,0,4,200,0.672084000,0.4314
215.158.140.229,<->,89.76.109.227,4,1207,0,0,4,1207,0.670404000,0.5845
144.90.91.91,<->,92.27.219.163,0,0,4,2789,4,2789,0.670342000,0.1080
215.158.238.81,<->,192.229.40.108,4,2666,0,0,4,2666,0.669477000,1.3305
136.25.189.43,<->,96.156.169.238,4,3363,0,0,4,3363,0.668859000,0.0040
215.158.239.92,<->,196.90.11.111,4,272,0,0,4,272,0.668848000,1.2800
215.158.239.18,<->,126.219.142.155,4,1606,0,0,4,1606,0.668585000,0.1144
215.158.239.99,<->,199.20.4.163,4,1764,0,0,4,1764,0.668514000,0.2205
215.158.239.87,<->,201.211.113.181,4,1489,0,0,4,1489,0.668204000,0.3389
133.178.226.28,<->,131.1.195.232,4,2948,0,0,4,2948,0.667333000,0.6701
91.60.173.42,<->,8.52.222.23,0,0,4,762,4,762,0.666530000,0.0816
215.158.239.51,<->,199.82.248.236,4,893,0,0,4,893,0.666375000,1.1783
136.25.189.27,<->,100.216.78.145,4,516,0,0,4,516,0.665143000,0.0454
92.27.27.153,<->,40.210.30.180,4,802,0,0,4,802,0.665055000,0.4361
155.219.88.62,<->,136.129.94.189,0,0,4,527,4,527,0.662053000,0.5621
75.214.249.157,<->,8.252.222.236,0,0,4,280,4,280,0.661199000,0.4102
215.158.239.26,<->,111.151.142.170,4,224,0,0,4,224,0.660935000,0.0001
207.66.72.41,<->,8.182.229.19,0,0,4,250,4,250,0.660584000,0.2148
196.148.166.194,<->,8.255.175.14,4,356,0,0,4,356,0.660452000,0.3784
6.145.149.52,<->,0.195.210.44,0,0,4,286,4,286,0.660239000,0.2191
215.158.238.221,<->,131.219.110.138,4,1637,0,0,4,1637,0.660203000,0.1379
215.158.238.120,<->,192.226.161.63,4,1445,0,0,4,1445,0.658729000,0.3256
247.136.143.107,<->,128.58.13.42,4,394,0,0,4,394,0.658641000,0.6632
136.25.188.198,<->,8.227.55.197,4,232,0,0,4,232,0.657924000,0.0344
229.96.182.37,<->,133.56.191.21,4,200,0,0,4,200,0.656034000,0.0183
215.158.239.92,<->,199.20.4.177,4,384,0,0,4,384,0.656023000,0.6887
215.158.239.49,<->,29.211.228.247,4,2730,0,0,4,2730,0.655576000,1.0985
98.16.139.251,<->,8.52.186.161,0,0,4,762,4,762,0.655250000,0.0596
192.64.209.42,<->,117.209.253.28,4,228,0,0,4,228,0.655229000,0.4332
136.25.189.32,<->,106.188.253.150,4,2995,0,0,4,2995,0.655202000,0.9351
97.126.115.171,<->,53.180.126.199,4,224,0,0,4,224,0.654963000,1.0816
204.184.56.182,<->,136.25.188.44,0,0,4,406,4,406,0.649467000,0.0581
111.150.206.152,<->,6.73.247.16,0,0,4,232,4,232,0.648810000,0.2754
143.88.15.41,<->,133.178.226.30,0,0,4,2234,4,2234,0.647150000,1.3213
215.158.238.176,<->,106.188.251.41,4,249,0,0,4,249,0.646849000,0.1046
221.102.56.69,<->,102.81.240.180,0,0,4,470,4,470,0.645867000,0.0800
139.248.200.186,<->,119.53.43.104,4,1310,0,0,4,1310,0.644135000,0.4728
215.158.140.76,<->,140.173.227.37,4,1253,0,0,4,1253,0.643222000,0.5864
215.158.239.96,<->,207.188.101.252,4,500,0,0,4,500,0.642707000,0.7102
132.43.156.54,<->,80.38.56.151,0,0,4,2698,4,2698,0.640883000,1.0748
198.71.150.99,<->,80.38.16.15,0,0,4,1045,4,1045,0.639554000,0.7255
112.208.20.81,<->,99.72.196.59,0,0,4,206,4,206,0.639363000,0.2561
136.25.188.224,<->,57.199.250.212,4,2810,0,0,4,2810,0.639116000,1.1459
210.158.44.137,<->,124.58.27.63,4,342,0,0,4,342,0.638740000,0.7324
215.158.239.33,<->,8.191.15.8,4,1746,0,0,4,1746,0.638025000,0.0336
136.25.188.106,<->,99.17.108.35,4,240,0,0,4,240,0.637496000,1.0659
215.158.238.133,<->,212.70.75.108,4,1333,0,0,4,1333,0.636936000,0.1304
75.31.146.51,<->,8.252.221.221,0,0,4,224,4,224,0.636051000,0.1883
215.158.238.92,<->,8.220.51.235,4,1477,0,0,4,1477,0.635664000,0.2504
215.158.239.17,<->,29.209.59.201,4,1100,0,0,4,1100,0.634514000,0.3236
215.158.238.208,<->,206.103.215.197,4,1536,0,0,4,1536,0.633859000,0.1225
158.192.3.232,<->,136.25.188.197,0,0,4,1509,4,1509,0.633733000,0.1003
115.139.55.246,<->,50.224.76.235,0,0,4,1036,4,1036,0.633441000,0.1892
195.4.79.229,<->,136.25.188.253,0,0,4,1324,4,1324,0.633258000,1.1836
207.173.154.103,<->,136.25.188.55,0,0,4,218,4,218,0.631357000,0.1914
197.158.92.103,<->,139.163.86.75,0,0,4,232,4,232,0.631302000,0.4146
215.158.239.52,<->,0.195.237.14,4,5770,0,0,4,5770,0.630555000,0.0000
136.25.188.226,<->,48.131.158.214,4,1445,0,0,4,1445,0.630542000,0.1537
144.87.238.89,<->,8.182.251.218,0,0,4,842,4,842,0.629617000,0.0769
246.254.97.113,<->,132.18.67.30,4,393,0,0,4,393,0.629286000,0.1777
196.115.61.105,<->,92.27.194.147,0,0,4,424,4,424,0.628582000,0.5691
143.155.227.33,<->,136.25.188.210,0,0,4,472,4,472,0.628545000,1.3497
215.158.239.92,<->,199.20.30.119,4,249,0,0,4,249,0.627746000,0.2506
215.158.238.54,<->,197.125.126.218,4,2906,0,0,4,2906,0.626987000,1.2970
142.223.144.174,<->,136.25.188.252,0,0,4,281,4,281,0.626293000,1.1854
109.1.9.150,<->,93.90.207.116,4,202,0,0,4,202,0.624744000,0.9182
213.38.247.248,<->,8.55.211.213,4,470,0,0,4,470,0.624446000,0.0780
215.158.239.79,<->,204.226.110.13,4,762,0,0,4,762,0.623408000,0.7465
8.222.212.2,<->,8.43.183.182,0,0,4,232,4,232,0.622610000,0.0450
215.158.140.61,<->,126.219.194.161,4,1450,0,0,4,1450,0.621815000,0.2175
194.233.139.207,<->,136.25.188.55,0,0,4,1964,4,1964,0.621497000,1.0806
215.158.239.1,<->,96.135.154.174,4,2233,0,0,4,2233,0.621393000,0.1446
215.158.239.87,<->,199.33.220.112,4,317,0,0,4,317,0.621342000,1.3415
215.158.239.96,<->,207.115.153.176,4,300,0,0,4,300,0.620724000,0.0151
132.153.80.16,<->,8.52.154.152,0,0,4,626,4,626,0.620644000,0.0293
245.241.43.37,<->,8.204.53.229,4,470,0,0,4,470,0.620202000,0.1439
199.33.59.225,<->,136.25.188.178,0,0,4,300,4,300,0.620129000,0.0209
195.15.239.197,<->,136.25.188.243,0,0,4,326,4,326,0.618080000,0.6568
17.245.253.19,<->,8.220.181.149,0,0,4,527,4,527,0.616343000,0.0512
207.56.101.49,<->,136.25.188.52,0,0,4,762,4,762,0.616025000,0.3984
231.142.212.15,<->,215.158.239.57,0,0,4,762,4,762,0.612038000,0.4326
215.158.140.240,<->,122.159.30.58,4,232,0,0,4,232,0.611436000,0.2247
210.44.36.30,<->,159.23.224.231,0,0,4,200,4,200,0.610682000,1.3581
215.158.239.51,<->,196.108.135.169,4,332,0,0,4,332,0.610185000,1.2903
194.237.96.103,<->,136.25.188.46,0,0,4,249,4,249,0.609225000,0.2092
252.72.196.66,<->,27.160.143.95,4,200,0,0,4,200,0.609187000,1.0967
215.158.238.53,<->,8.222.109.108,4,1477,0,0,4,1477,0.608976000,0.7781
136.25.188.223,<->,122.159.245.157,4,249,0,0,4,249,0.608058000,0.0952
111.20.168.123,<->,101.224.91.140,4,950,0,0,4,950,0.607727000,0.0241
145.118.222.76,<->,8.220.176.253,0,0,4,442,4,442,0.607399000,0.0545
220.28.85.14,<->,215.158.238.40,0,0,4,5562,4,5562,0.607344000,0.0000
243.117.93.168,<->,144.86.144.224,0,0,4,1349,4,1349,0.607323000,0.2324
159.137.192.179,<->,138.81.213.82,4,815,0,0,4,815,0.606045000,0.1038
194.253.248.68,<->,8.252.222.236,0,0,4,769,4,769,0.605074000,0.4084
136.25.189.14,<->,116.106.46.84,4,2538,0,0,4,2538,0.601617000,1.0705
97.126.26.80,<->,54.52.240.109,4,241,0,0,4,241,0.601584000,0.2583
92.27.219.253,<->,50.97.8.241,4,206,0,0,4,206,0.600132000,0.0833
136.25.189.80,<->,135.229.0.214,4,1493,0,0,4,1493,0.598753000,0.4199
29.214.108.233,<->,8.252.223.160,0,0,4,1209,4,1209,0.597060000,0.4176
195.68.31.144,<->,136.25.188.173,0,0,4,320,4,320,0.595598000,1.1001
98.12.254.195,<->,0.195.210.44,0,0,4,378,4,378,0.594315000,0.9351
215.158.238.82,<->,80.47.111.107,4,2442,0,0,4,2442,0.594135000,1.3503
143.13.155.13,<->,136.25.188.242,0,0,4,300,4,300,0.594098000,0.0057
199.72.50.190,<->,92.27.194.147,0,0,4,425,4,425,0.592024000,0.5605
215.158.238.45,<->,197.125.116.84,4,2554,0,0,4,2554,0.589899000,0.9153
195.5.57.247,<->,136.25.188.53,0,0,4,200,4,200,0.589497000,0.0064
215.158.238.143,<->,6.73.247.91,4,1381,0,0,4,1381,0.589390000,0.0403
215.158.239.85,<->,207.60.48.199,4,762,0,0,4,762,0.589185000,0.6320
215.158.238.105,<->,131.6.152.17,4,1333,0,0,4,1333,0.588476000,0.1753
215.158.239.92,<->,196.108.61.166,4,1069,0,0,4,1069,0.588050000,0.2089
215.158.239.6,<->,149.96.60.148,4,2899,0,0,4,2899,0.587813000,1.2722
215.158.238.105,<->,159.182.91.27,4,1285,0,0,4,1285,0.586287000,0.4959
207.239.110.42,<->,136.25.188.178,0,0,4,362,4,362,0.583718000,1.0841
92.162.218.130,<->,80.38.62.152,0,0,4,1131,4,1131,0.583617000,0.1866
215.158.238.64,<->,8.220.51.216,4,1349,0,0,4,1349,0.583438000,0.2243
215.158.239.96,<->,196.106.186.71,4,200,0,0,4,200,0.581969000,0.7198
215.158.239.41,<->,29.212.195.149,4,1691,0,0,4,1691,0.581860000,0.1260
136.25.188.243,<->,80.47.111.65,4,2698,0,0,4,2698,0.581819000,0.3158
109.1.15.105,<->,8.45.175.127,4,384,0,0,4,384,0.581413000,0.1066
97.183.216.230,<->,92.27.226.86,4,320,0,0,4,320,0.581311000,0.1644
133.178.227.247,<->,69.132.159.48,4,3925,0,0,4,3925,0.580129000,0.2451
136.25.189.2,<->,56.28.207.201,4,1717,0,0,4,1717,0.578982000,0.0248
215.158.238.136,<->,97.174.232.241,4,1123,0,0,4,1123,0.578803000,0.6628
215.158.238.64,<->,122.159.245.163,4,249,0,0,4,249,0.578640000,0.0960
145.118.217.235,<->,8.43.155.172,0,0,4,232,4,232,0.577400000,0.0558
215.158.239.76,<->,199.20.29.229,4,249,0,0,4,249,0.576209000,1.3202
139.193.141.139,<->,117.2.248.23,4,2442,0,0,4,2442,0.575700000,0.1319
215.158.238.96,<->,8.240.118.180,4,1477,0,0,4,1477,0.572375000,0.5859
195.56.26.110,<->,92.27.234.141,0,0,4,200,4,200,0.572221000,1.0176
215.158.239.84,<->,195.96.156.37,4,300,0,0,4,300,0.571507000,0.0002
220.28.65.9,<->,136.25.189.10,0,0,4,3626,4,3626,0.570660000,0.0210
215.158.61.195,<->,8.176.8.210,0,0,4,5335,4,5335,0.570598000,0.0001
207.60.55.106,<->,136.25.188.177,0,0,4,762,4,762,0.570457000,0.4218
99.167.13.129,<->,8.182.253.38,0,0,4,762,4,762,0.570120000,0.1682
215.158.239.99,<->,196.92.132.46,4,224,0,0,4,224,0.569888000,0.0584
215.158.238.95,<->,192.205.37.205,4,1282,0,0,4,1282,0.569504000,1.1969
53.161.180.137,<->,48.55.163.98,0,0,4,337,4,337,0.569483000,0.6301
207.239.46.135,<->,136.25.188.198,0,0,4,300,4,300,0.569453000,0.0062
136.25.188.211,<->,122.158.245.88,4,1525,0,0,4,1525,0.568512000,0.2466
229.45.200.94,<->,27.158.122.184,4,603,0,0,4,603,0.566930000,0.6151
215.158.239.59,<->,196.91.141.131,4,248,0,0,4,248,0.565269000,1.3400
133.178.226.202,<->,111.158.193.231,4,1546,0,0,4,1546,0.564416000,0.4933
136.25.188.160,<->,119.196.23.43,4,1509,0,0,4,1509,0.564395000,0.3155
56.189.215.197,<->,8.52.161.33,0,0,4,236,4,236,0.563450000,0.8251
215.158.239.43,<->,122.158.239.251,4,1668,0,0,4,1668,0.563341000,0.1207
54.38.66.136,<->,48.52.162.238,0,0,4,351,4,351,0.562989000,0.5573
202.33.5.182,<->,136.25.188.226,0,0,4,224,4,224,0.562514000,0.2112
133.178.226.179,<->,91.42.57.252,4,810,0,0,4,810,0.560253000,1.0122
202.33.5.182,<->,136.25.188.209,0,0,4,224,4,224,0.560106000,0.2757
8.52.189.207,<->,6.14.154.251,4,762,0,0,4,762,0.559987000,0.5248
136.25.189.80,<->,29.212.199.54,4,2586,0,0,4,2586,0.559404000,0.7175
197.113.99.27,<->,136.25.188.254,0,0,4,265,4,265,0.558463000,0.1800
221.102.56.69,<->,192.65.241.179,0,0,4,470,4,470,0.557987000,0.5982
215.158.239.49,<->,199.20.30.0,4,272,0,0,4,272,0.556818000,0.6891
215.158.239.85,<->,199.20.28.182,4,460,0,0,4,460,0.556489000,1.4231
215.158.103.206,<->,129.220.171.193,4,3021,0,0,4,3021,0.555711000,0.8886
101.67.160.97,<->,8.52.186.156,0,0,4,1226,4,1226,0.555388000,0.1641
215.158.238.81,<->,192.228.30.34,4,1397,0,0,4,1397,0.555295000,0.0287
215.158.239.49,<->,38.104.11.60,4,1541,0,0,4,1541,0.555233000,0.1680
195.54.102.95,<->,136.25.188.179,0,0,4,269,4,269,0.551242000,0.8308
207.191.251.46,<->,136.25.188.163,0,0,4,272,4,272,0.550943000,0.4437
143.155.227.54,<->,133.178.226.70,0,0,4,1285,4,1285,0.548724000,0.1720
215.158.239.57,<->,196.108.90.172,4,794,0,0,4,794,0.548577000,1.4204
144.71.43.239,<->,38.229.228.56,4,200,0,0,4,200,0.548508000,0.4037
101.126.187.24,<->,8.55.231.92,4,273,0,0,4,273,0.546445000,0.0074
215.158.239.58,<->,194.238.200.253,4,264,0,0,4,264,0.546018000,0.0352
132.18.67.31,<->,102.83.62.125,0,0,4,236,4,236,0.544774000,0.8452
129.175.139.238,<->,8.176.8.111,0,0,4,3466,4,3466,0.544712000,0.2408
215.158.239.84,<->,199.20.28.110,4,260,0,0,4,260,0.544690000,1.3560
142.190.91.222,<->,136.25.188.236,0,0,4,200,4,200,0.544612000,0.2499
215.158.140.60,<->,8.220.54.107,4,1312,0,0,4,1312,0.544438000,0.3298
215.158.238.73,<->,126.219.196.185,4,2330,0,0,4,2330,0.543875000,1.2433
48.16.116.59,<->,8.252.221.236,0,0,4,610,4,610,0.543706000,0.3077
92.180.56.187,<->,22.59.5.231,0,0,4,200,4,200,0.543349000,1.2357
215.158.238.106,<->,111.150.186.220,4,1493,0,0,4,1493,0.541753000,0.1393
136.25.188.220,<->,8.227.55.243,4,232,0,0,4,232,0.541526000,0.0380
204.186.174.127,<->,136.25.188.238,0,0,4,224,4,224,0.541452000,0.7106
246.253.253.97,<->,53.167.183.246,4,5845,0,0,4,5845,0.540038000,0.0001
99.75.122.192,<->,92.27.4.178,4,5880,0,0,4,5880,0.539949000,1.0402
149.178.34.139,<->,100.228.42.102,0,0,4,1738,4,1738,0.539650000,0.3065
133.178.226.19,<->,29.123.209.149,4,1237,0,0,4,1237,0.539431000,0.2235
111.181.125.231,<->,8.55.227.120,4,352,0,0,4,352,0.538580000,0.1269
207.194.78.58,<->,92.27.194.147,0,0,4,406,4,406,0.536451000,0.6238
136.25.188.160,<->,131.251.111.22,4,1525,0,0,4,1525,0.536250000,0.2535
133.178.226.28,<->,126.219.190.180,4,1397,0,0,4,1397,0.534804000,0.1747
215.158.238.99,<->,8.222.109.84,4,268,0,0,4,268,0.534339000,1.3120
215.158.238.45,<->,8.222.0.245,4,1413,0,0,4,1413,0.531441000,0.4029
143.155.227.59,<->,136.25.188.225,0,0,4,249,4,249,0.531267000,0.1659
129.225.135.222,<->,129.225.132.224,0,0,4,2017,4,2017,0.530932000,0.2338
115.113.157.92,<->,92.27.219.243,0,0,4,206,4,206,0.530815000,0.3924
192.64.228.240,<->,8.49.69.216,4,394,0,0,4,394,0.530366000,0.0003
106.168.191.70,<->,100.94.173.42,0,0,4,542,4,542,0.529194000,1.2391
56.112.166.221,<->,8.182.141.189,0,0,4,668,4,668,0.529065000,1.1672
215.158.239.56,<->,207.228.107.46,4,224,0,0,4,224,0.528793000,0.2203
118.125.64.225,<->,50.224.76.248,0,0,4,2417,4,2417,0.528500000,1.3228
197.60.144.196,<->,8.20.87.187,0,0,4,1296,4,1296,0.528328000,0.4898
207.1.199.234,<->,92.27.234.141,0,0,4,200,4,200,0.527775000,1.0944
215.158.239.56,<->,199.20.29.163,4,249,0,0,4,249,0.526435000,0.3800
215.158.239.87,<->,207.57.43.17,4,1170,0,0,4,1170,0.524923000,0.3623
101.70.121.211,<->,53.86.250.203,4,677,0,0,4,677,0.524412000,0.1688
129.92.117.123,<->,97.124.66.195,4,2115,0,0,4,2115,0.524091000,0.1563
215.158.239.70,<->,106.188.253.148,4,2866,0,0,4,2866,0.523819000,1.4062
215.158.239.182,<->,113.207.62.154,4,459,0,0,4,459,0.523562000,0.1801
200.175.34.30,<->,53.68.42.250,4,3359,0,0,4,3359,0.523122000,0.1022
204.58.57.119,<->,136.25.188.237,0,0,4,591,4,591,0.523062000,1.3634
210.220.219.177,<->,137.39.55.59,4,1682,0,0,4,1682,0.520975000,0.0071
136.25.189.29,<->,89.80.251.22,4,2474,0,0,4,2474,0.519925000,0.5968
199.72.33.151,<->,136.25.188.198,0,0,4,300,4,300,0.519060000,0.0145
158.193.237.178,<->,8.252.223.192,0,0,4,580,4,580,0.518948000,1.1660
94.24.8.153,<->,92.27.219.38,0,0,4,206,4,206,0.518159000,0.4895
215.158.239.76,<->,199.20.30.170,4,260,0,0,4,260,0.518063000,1.2803
220.55.70.117,<->,117.62.170.239,4,200,0,0,4,200,0.517910000,1.0160
204.21.247.226,<->,136.25.188.225,0,0,4,418,4,418,0.516083000,1.4192
159.119.5.206,<->,8.220.176.253,0,0,4,573,4,573,0.514770000,0.1288
156.150.167.221,<->,8.252.222.61,0,0,4,272,4,272,0.514469000,1.0430
215.158.140.219,<->,53.231.101.25,4,1598,0,0,4,1598,0.514448000,1.4853
195.69.152.181,<->,136.25.188.243,0,0,4,813,4,813,0.513319000,1.3037
221.102.56.69,<->,220.80.238.103,0,0,4,470,4,470,0.513149000,0.0742
195.15.172.171,<->,136.25.188.254,0,0,4,778,4,778,0.512178000,1.1874
215.158.239.95,<->,142.221.133.113,4,200,0,0,4,200,0.510701000,0.0042
215.158.239.87,<->,207.239.58.57,4,1195,0,0,4,1195,0.509693000,1.2443
215.158.239.84,<->,204.3.184.181,4,300,0,0,4,300,0.509152000,0.0118
102.83.0.192,<->,97.96.136.236,4,624,0,0,4,624,0.509142000,1.0043
215.158.140.64,<->,111.151.107.208,4,268,0,0,4,268,0.508621000,0.7699
133.178.226.61,<->,99.192.168.180,4,224,0,0,4,224,0.508190000,0.0647
82.135.81.66,<->,22.59.5.231,0,0,4,200,4,200,0.508028000,1.1998
215.158.239.96,<->,207.61.227.81,4,249,0,0,4,249,0.507813000,0.2416
215.158.239.58,<->,199.20.28.242,4,582,0,0,4,582,0.507020000,0.3892
197.113.64.212,<->,136.25.188.178,0,0,4,236,4,236,0.506860000,0.1602
221.102.56.69,<->,192.67.86.35,0,0,4,470,4,470,0.504937000,0.2719
215.158.238.196,<->,215.158.127.101,4,2320,0,0,4,2320,0.503377000,1.3262
195.40.59.37,<->,136.25.188.209,0,0,4,264,4,264,0.503311000,0.0064
111.20.172.177,<->,111.20.168.123,0,0,4,950,4,950,0.503145000,0.0262
215.158.238.64,<->,142.204.32.86,4,1493,0,0,4,1493,0.503080000,0.2912
136.25.188.237,<->,113.23.104.247,4,1301,0,0,4,1301,0.502540000,0.5275
221.102.56.69,<->,218.4.179.115,0,0,4,462,4,462,0.502481000,0.8727
204.200.173.18,<->,136.25.188.53,0,0,4,200,4,200,0.501373000,0.0064
207.190.226.56,<->,136.25.188.239,0,0,4,300,4,300,0.501133000,0.0052
215.158.238.83,<->,113.23.104.245,4,2506,0,0,4,2506,0.501118000,1.3880
215.158.238.107,<->,113.23.40.36,4,1285,0,0,4,1285,0.500759000,0.1391
204.187.113.253,<->,136.25.188.199,0,0,4,474,4,474,0.499693000,1.1188
119.119.219.159,<->,80.41.29.163,0,0,4,200,4,200,0.499427000,0.2017
159.23.224.231,<->,143.14.74.10,4,224,0,0,4,224,0.499160000,1.4998
205.127.108.115,<->,101.224.89.150,0,0,4,3364,4,3364,0.498653000,0.0480
202.33.235.80,<->,136.25.188.225,0,0,4,794,4,794,0.498468000,1.1515
58.242.129.41,<->,8.252.221.196,0,0,4,501,4,501,0.497779000,0.5419
215.158.238.141,<->,8.222.213.66,4,1237,0,0,4,1237,0.495491000,0.1401
215.158.239.50,<->,199.39.229.223,4,239,0,0,4,239,0.495003000,0.0062
196.239.46.187,<->,92.27.194.147,0,0,4,425,4,425,0.494841000,0.6800
133.178.227.1,<->,48.129.133.61,4,2570,0,0,4,2570,0.493763000,1.0118
195.54.77.223,<->,136.25.188.46,0,0,4,618,4,618,0.493578000,1.2230
142.248.82.29,<->,136.25.188.196,0,0,4,200,4,200,0.493359000,0.1850
221.102.125.17,<->,139.254.211.64,4,248,0,0,4,248,0.493105000,0.0535
132.214.63.61,<->,58.43.188.13,4,357,0,0,4,357,0.492073000,0.3884
215.158.61.191,<->,8.176.8.208,0,0,4,2698,4,2698,0.490586000,0.2193
53.160.44.69,<->,48.53.36.9,0,0,4,238,4,238,0.488568000,1.0593
111.146.207.124,<->,50.140.149.101,4,424,0,0,4,424,0.488080000,1.2947
101.224.178.141,<->,89.183.104.115,0,0,4,356,4,356,0.487617000,1.5008
192.229.216.117,<->,159.223.99.55,4,762,0,0,4,762,0.487189000,0.0713
246.253.238.229,<->,207.88.23.78,4,304,0,0,4,304,0.486972000,0.0003
136.25.188.55,<->,112.235.95.21,4,2474,0,0,4,2474,0.486858000,1.2697
159.223.99.55,<->,8.52.134.29,0,0,4,762,4,762,0.486596000,0.0769
98.23.101.117,<->,89.183.104.249,0,0,4,356,4,356,0.485356000,1.5004
215.158.61.193,<->,8.176.8.182,0,0,4,3941,4,3941,0.484827000,0.0133
215.158.238.83,<->,148.129.19.195,4,1397,0,0,4,1397,0.483801000,0.2432
142.190.84.68,<->,136.25.188.55,0,0,4,224,4,224,0.483591000,0.0280
215.158.140.93,<->,201.136.143.26,4,1205,0,0,4,1205,0.483536000,0.2406
195.68.225.210,<->,92.27.194.147,0,0,4,232,4,232,0.482151000,0.0690
133.178.226.61,<->,118.20.108.65,4,1493,0,0,4,1493,0.481525000,0.1728
215.158.239.85,<->,199.20.28.185,4,200,0,0,4,200,0.481094000,0.1298
199.98.153.74,<->,136.25.188.225,0,0,4,1509,4,1509,0.480881000,0.2487
215.158.239.57,<->,207.40.77.92,4,224,0,0,4,224,0.480081000,0.0001
218.138.21.44,<->,8.220.190.86,0,0,4,517,4,517,0.479340000,0.6733
136.25.188.160,<->,69.150.169.180,4,1397,0,0,4,1397,0.478500000,0.2109
192.170.179.3,<->,133.178.226.197,0,0,4,232,4,232,0.478403000,0.0425
139.5.114.37,<->,8.52.184.170,0,0,4,232,4,232,0.477607000,0.0387
98.236.194.252,<->,46.44.197.149,4,200,0,0,4,200,0.476673000,1.1108
109.222.253.222,<->,53.234.241.192,4,904,0,0,4,904,0.476367000,0.7704
136.25.189.32,<->,118.20.100.138,4,2890,0,0,4,2890,0.475571000,0.6542
92.27.219.176,<->,29.239.238.231,4,208,0,0,4,208,0.474879000,0.9757
113.103.98.190,<->,92.27.27.171,0,0,4,226,4,226,0.473876000,1.2411
120.221.114.218,<->,89.183.104.250,0,0,4,206,4,206,0.472653000,0.2855
215.158.239.56,<->,199.20.29.117,4,533,0,0,4,533,0.472590000,1.4441
215.158.239.49,<->,196.105.77.195,4,901,0,0,4,901,0.472188000,0.5397
204.0.153.143,<->,136.25.188.227,0,0,4,272,4,272,0.470288000,1.2209
139.36.119.93,<->,99.74.87.192,0,0,4,4545,4,4545,0.466765000,0.0029
136.25.189.14,<->,61.35.70.233,4,2826,0,0,4,2826,0.466129000,1.2365
195.7.21.17,<->,136.25.188.254,0,0,4,294,4,294,0.465883000,0.0055
17.255.107.2,<->,8.220.191.217,0,0,4,709,4,709,0.464259000,0.0648
195.126.22.14,<->,136.25.188.55,0,0,4,869,4,869,0.464116000,0.3283
207.162.138.220,<->,8.182.229.19,0,0,4,762,4,762,0.464076000,0.3316
159.23.225.228,<->,130.242.204.14,4,226,0,0,4,226,0.463769000,0.5010
215.158.239.41,<->,8.253.128.25,4,1664,0,0,4,1664,0.462858000,0.2395
139.172.184.28,<->,0.195.210.44,0,0,4,378,4,378,0.462677000,0.1893
133.178.227.40,<->,69.132.194.25,4,1219,0,0,4,1219,0.462373000,0.2346
205.187.74.216,<->,109.1.18.115,0,0,4,492,4,492,0.462271000,0.2440
111.151.106.217,<->,97.126.31.64,0,0,4,224,4,224,0.461927000,0.0001
109.222.221.201,<->,54.55.66.165,4,224,0,0,4,224,0.459292000,1.0513
215.158.239.76,<->,207.166.82.223,4,249,0,0,4,249,0.459007000,0.3000
98.67.155.63,<->,8.234.107.157,4,362,0,0,4,362,0.458980000,1.1073
142.241.156.114,<->,136.25.188.46,0,0,4,314,4,314,0.458820000,0.3874
192.228.30.100,<->,6.73.247.16,0,0,4,232,4,232,0.458591000,0.0558
196.148.131.155,<->,89.155.31.210,4,2168,0,0,4,2168,0.458188000,0.0430
235.103.190.78,<->,8.182.235.164,0,0,4,583,4,583,0.456443000,0.0598
215.158.238.47,<->,122.158.51.87,4,2666,0,0,4,2666,0.456405000,1.4774
215.158.239.56,<->,199.20.31.184,4,1184,0,0,4,1184,0.455810000,0.8880
194.253.195.60,<->,8.220.190.86,0,0,4,912,4,912,0.455566000,1.0888
220.20.200.5,<->,127.255.90.88,4,5410,0,0,4,5410,0.455398000,0.0000
229.45.131.225,<->,193.24.114.87,4,1036,0,0,4,1036,0.453578000,0.1378
17.249.7.20,<->,8.220.176.253,0,0,4,232,4,232,0.453381000,0.0650
199.102.232.92,<->,92.27.219.230,0,0,4,208,4,208,0.452884000,1.3635
215.158.140.92,<->,215.158.42.38,4,1240,0,0,4,1240,0.451118000,0.0367
197.4.13.58,<->,136.25.188.55,0,0,4,1349,4,1349,0.450782000,0.2774
145.95.194.36,<->,92.27.219.190,0,0,4,206,4,206,0.450126000,0.1448
136.25.188.197,<->,8.222.7.21,4,1317,0,0,4,1317,0.449408000,0.0315
207.172.74.193,<->,136.25.188.225,0,0,4,554,4,554,0.448589000,1.0800
142.190.186.61,<->,136.25.188.53,0,0,4,212,4,212,0.447637000,1.0800
246.253.253.169,<->,53.201.86.104,4,1268,0,0,4,1268,0.447211000,1.2836
142.253.191.95,<->,136.25.188.242,0,0,4,794,4,794,0.446353000,1.4059
143.88.90.200,<->,136.25.188.173,0,0,4,212,4,212,0.446062000,0.6690
215.158.239.57,<->,196.106.58.186,4,243,0,0,4,243,0.445762000,0.1920
196.112.237.232,<->,8.252.222.205,0,0,4,1493,4,1493,0.445384000,0.1360
138.74.97.124,<->,133.54.28.251,0,0,4,616,4,616,0.445163000,0.0530
215.158.238.133,<->,126.219.132.237,4,1541,0,0,4,1541,0.444887000,1.4672
142.200.230.208,<->,50.224.76.235,0,0,4,1361,4,1361,0.444868000,0.3075
221.196.127.158,<->,97.198.98.33,0,0,4,224,4,224,0.444500000,1.4001
192.80.230.86,<->,145.242.126.88,0,0,4,3189,4,3189,0.444416000,1.1369
215.158.239.193,<->,137.107.106.106,4,3220,0,0,4,3220,0.444271000,0.0000
215.158.239.51,<->,199.20.28.104,4,206,0,0,4,206,0.443278000,0.2099
97.100.51.234,<->,80.27.152.99,0,0,4,2529,4,2529,0.442504000,0.9309
133.178.226.72,<->,133.56.180.18,4,1679,0,0,4,1679,0.441848000,1.0320
194.233.21.217,<->,136.25.188.222,0,0,4,256,4,256,0.441180000,1.1615
136.129.94.157,<->,111.199.239.9,4,590,0,0,4,590,0.440459000,0.2895
57.1.124.209,<->,50.224.89.243,0,0,4,224,4,224,0.438894000,0.0000
215.158.140.184,<->,8.222.7.181,4,2202,0,0,4,2202,0.438785000,1.2755
204.61.83.116,<->,136.25.188.199,0,0,4,1056,4,1056,0.438641000,0.3762
136.25.188.53,<->,69.31.238.53,4,1469,0,0,4,1469,0.436275000,1.3634
136.25.188.55,<->,69.31.238.37,4,1493,0,0,4,1493,0.432612000,0.3469
215.158.239.99,<->,195.6.24.49,4,762,0,0,4,762,0.431314000,0.3454
136.25.189.1,<->,56.161.218.55,4,2842,0,0,4,2842,0.431303000,1.1841
192.229.220.60,<->,111.151.238.139,4,232,0,0,4,232,0.430963000,0.0395
8.252.213.192,<->,8.250.155.16,0,0,4,232,4,232,0.429917000,0.0572
136.25.188.44,<->,8.252.213.15,4,1413,0,0,4,1413,0.429397000,0.1326
215.158.239.86,<->,196.106.235.223,4,1388,0,0,4,1388,0.429219000,0.1201
195.54.86.55,<->,136.25.188.176,0,0,4,296,4,296,0.428619000,0.5659
121.215.124.71,<->,89.183.109.183,0,0,4,200,4,200,0.427778000,1.1402
136.25.188.175,<->,131.1.253.250,4,2813,0,0,4,2813,0.427633000,1.4218
136.25.189.18,<->,8.249.253.227,4,2618,0,0,4,2618,0.427242000,1.3928
215.158.239.84,<->,199.78.251.95,4,200,0,0,4,200,0.427115000,0.1400
142.244.226.230,<->,136.25.188.253,0,0,4,762,4,762,0.426722000,0.4042
89.183.110.5,<->,6.16.149.123,4,559,0,0,4,559,0.426670000,1.4367
192.226.44.53,<->,133.178.227.251,0,0,4,1861,4,1861,0.426516000,0.0536
207.62.87.215,<->,136.25.188.46,0,0,4,239,4,239,0.426427000,0.0029
246.253.134.204,<->,30.199.160.160,4,2587,0,0,4,2587,0.425658000,0.9388
136.25.188.254,<->,113.23.104.247,4,249,0,0,4,249,0.425302000,0.1227
129.225.134.223,<->,129.225.132.93,0,0,4,1222,4,1222,0.425002000,0.1616
215.158.239.77,<->,29.211.5.251,4,2778,0,0,4,2778,0.423256000,0.4898
136.25.189.18,<->,57.226.224.40,4,1797,0,0,4,1797,0.421558000,0.1647
142.252.167.45,<->,136.25.188.226,0,0,4,200,4,200,0.420933000,0.6290
98.44.239.169,<->,8.182.248.147,0,0,4,224,4,224,0.420784000,0.0479
136.25.189.47,<->,29.211.5.81,4,232,0,0,4,232,0.420175000,0.2191
141.102.147.150,<->,92.162.253.86,0,0,4,2790,4,2790,0.419822000,0.1676
80.27.157.123,<->,69.175.101.3,4,200,0,0,4,200,0.419575000,0.2274
133.178.227.247,<->,29.212.196.161,4,2965,0,0,4,2965,0.418736000,0.1604
215.158.239.56,<->,204.0.200.16,4,248,0,0,4,248,0.417946000,1.4760
111.20.171.168,<->,111.20.168.10,0,0,4,3126,4,3126,0.417038000,0.0848
142.172.96.121,<->,8.220.189.63,0,0,4,790,4,790,0.416572000,0.3060
148.224.137.93,<->,136.25.189.1,0,0,4,1525,4,1525,0.416340000,0.2281
206.103.214.31,<->,136.25.189.81,0,0,4,1525,4,1525,0.416016000,0.0889
204.186.110.3,<->,136.25.188.176,0,0,4,260,4,260,0.415628000,1.5000
215.158.239.87,<->,199.32.169.124,4,200,0,0,4,200,0.415004000,0.0956
136.25.188.236,<->,8.227.55.253,4,232,0,0,4,232,0.414852000,0.0378
210.220.219.181,<->,53.224.207.241,4,1034,0,0,4,1034,0.414487000,1.1221
215.158.239.97,<->,199.20.4.21,4,224,0,0,4,224,0.413945000,0.0770
215.158.239.49,<->,80.56.79.101,4,1393,0,0,4,1393,0.413341000,0.2908
139.36.120.125,<->,99.74.26.149,0,0,4,693,4,693,0.411974000,0.2434
138.98.197.173,<->,89.183.98.97,4,690,0,0,4,690,0.411152000,0.1138
215.158.239.70,<->,56.161.218.37,4,2842,0,0,4,2842,0.410416000,1.0009
204.3.166.30,<->,136.25.188.253,0,0,4,225,4,225,0.409797000,0.2801
136.25.189.33,<->,29.211.93.23,4,2826,0,0,4,2826,0.409660000,0.4181
195.6.249.171,<->,136.25.188.46,0,0,4,200,4,200,0.408520000,0.0007
247.136.131.250,<->,8.55.211.213,4,470,0,0,4,470,0.408015000,0.0961
203.117.64.49,<->,0.195.210.42,0,0,4,280,4,280,0.406905000,1.5846
145.242.124.39,<->,99.75.205.146,0,0,4,350,4,350,0.405704000,0.2166
215.158.140.240,<->,57.210.104.91,4,232,0,0,4,232,0.404352000,0.2390
92.27.219.169,<->,78.46.152.207,4,260,0,0,4,260,0.402961000,1.1739
215.158.238.250,<->,215.158.6.233,4,2509,0,0,4,2509,0.402238000,0.8429
92.27.27.173,<->,82.130.189.215,4,206,0,0,4,206,0.401669000,0.0838
215.158.239.76,<->,204.226.0.149,4,200,0,0,4,200,0.401480000,0.0003
213.38.201.158,<->,113.178.172.170,4,200,0,0,4,200,0.400557000,1.1015
207.59.201.32,<->,136.25.188.52,0,0,4,877,4,877,0.400311000,0.9770
215.158.238.67,<->,136.139.59.126,4,1333,0,0,4,1333,0.399567000,0.2379
207.57.70.153,<->,136.25.188.255,0,0,4,236,4,236,0.399030000,0.4419
215.158.239.49,<->,199.50.54.14,4,214,0,0,4,214,0.398891000,1.2864
142.206.64.195,<->,136.25.188.177,0,0,4,232,4,232,0.397349000,0.8756
215.158.238.82,<->,131.2.115.231,4,1477,0,0,4,1477,0.396997000,0.2567
195.70.210.121,<->,92.27.194.147,0,0,4,422,4,422,0.396591000,0.5352
141.118.203.106,<->,8.252.221.198,0,0,4,943,4,943,0.396521000,0.3448
197.113.52.108,<->,92.27.27.163,0,0,4,516,4,516,0.396474000,0.7963
159.254.111.194,<->,100.228.42.92,0,0,4,646,4,646,0.395890000,0.5909
208.48.111.17,<->,139.163.17.164,0,0,4,200,4,200,0.395648000,1.3311
197.106.249.131,<->,136.25.188.209,0,0,4,249,4,249,0.395426000,0.1854
215.158.239.99,<->,196.105.59.105,4,249,0,0,4,249,0.394753000,0.4440
215.158.239.87,<->,131.144.113.52,4,1781,0,0,4,1781,0.393168000,0.2274
199.72.18.85,<->,136.25.188.163,0,0,4,200,4,200,0.390433000,0.2228
215.158.239.57,<->,207.59.196.167,4,300,0,0,4,300,0.389748000,0.0062
215.158.239.49,<->,57.227.83.218,4,2602,0,0,4,2602,0.389520000,0.5821
199.69.114.237,<->,136.25.188.163,0,0,4,300,4,300,0.389247000,0.0354
133.178.227.70,<->,48.131.159.8,4,1237,0,0,4,1237,0.389190000,0.1481
215.158.238.106,<->,42.226.3.119,4,2714,0,0,4,2714,0.389022000,1.4066
248.225.27.2,<->,56.114.235.120,4,972,0,0,4,972,0.388737000,0.0954
84.242.135.61,<->,50.224.76.235,0,0,4,829,4,829,0.388288000,0.4567
207.236.224.140,<->,136.25.188.241,0,0,4,244,4,244,0.387336000,0.8089
207.189.93.92,<->,92.27.194.147,0,0,4,451,4,451,0.386364000,0.5001
215.158.239.59,<->,198.204.76.216,4,2554,0,0,4,2554,0.385752000,1.1788
136.25.188.160,<->,104.3.168.213,4,2778,0,0,4,2778,0.384727000,1.2376
136.25.189.15,<->,128.23.84.21,4,2506,0,0,4,2506,0.384497000,1.4994
98.23.121.77,<->,89.183.104.115,0,0,4,356,4,356,0.384122000,1.5009
207.62.95.240,<->,136.25.188.199,0,0,4,300,4,300,0.383472000,0.0065
215.158.239.79,<->,199.20.30.221,4,224,0,0,4,224,0.383012000,0.0000
215.158.239.57,<->,113.92.151.11,4,2554,0,0,4,2554,0.380190000,0.8270
118.90.27.231,<->,50.224.89.243,0,0,4,994,4,994,0.380148000,0.1326
221.102.56.69,<->,136.181.39.23,0,0,4,470,4,470,0.379934000,0.2240
133.178.227.2,<->,48.131.158.233,4,2426,0,0,4,2426,0.379695000,0.9495
109.222.252.7,<->,53.246.154.134,4,816,0,0,4,816,0.378324000,0.5877
142.249.56.74,<->,136.25.188.222,0,0,4,239,4,239,0.377972000,0.5524
139.193.141.139,<->,69.218.198.30,4,1855,0,0,4,1855,0.376020000,0.5463
114.231.95.5,<->,92.27.219.231,0,0,4,206,4,206,0.375587000,0.2319
92.181.136.240,<->,22.59.6.26,0,0,4,200,4,200,0.375560000,1.3600
199.71.118.127,<->,136.25.188.176,0,0,4,762,4,762,0.375110000,0.4044
149.56.86.41,<->,50.224.89.241,0,0,4,437,4,437,0.373698000,0.3743
17.23.198.220,<->,8.220.191.154,0,0,4,200,4,200,0.373654000,0.0350
140.174.80.100,<->,133.178.227.16,0,0,4,1217,4,1217,0.373615000,0.2532
133.54.43.74,<->,115.84.66.60,4,200,0,0,4,200,0.372308000,0.3408
192.64.224.151,<->,74.172.3.5,4,532,0,0,4,532,0.372015000,1.3282
192.171.32.164,<->,133.178.227.16,0,0,4,2393,4,2393,0.370789000,1.3268
216.144.221.96,<->,133.178.227.114,0,0,4,467,4,467,0.370094000,1.1290
215.158.239.95,<->,199.20.4.233,4,312,0,0,4,312,0.369330000,0.0315
215.158.239.68,<->,143.128.227.162,4,200,0,0,4,200,0.369177000,1.0523
196.148.128.9,<->,195.5.16.230,4,200,0,0,4,200,0.369153000,1.2281
215.158.239.77,<->,194.234.219.228,4,762,0,0,4,762,0.368653000,0.6106
204.186.199.96,<->,136.25.188.253,0,0,4,256,4,256,0.366507000,0.8199
159.23.227.181,<->,130.18.22.31,4,200,0,0,4,200,0.365377000,1.3451
221.102.56.69,<->,109.1.92.249,0,0,4,470,4,470,0.363813000,0.0666
195.40.112.222,<->,136.25.188.241,0,0,4,300,4,300,0.363681000,0.0108
207.79.207.171,<->,102.50.212.241,0,0,4,218,4,218,0.363501000,1.2630
133.178.227.244,<->,111.151.237.139,4,2778,0,0,4,2778,0.362304000,0.1702
136.25.188.163,<->,8.227.55.175,4,232,0,0,4,232,0.360763000,0.0341
237.33.122.147,<->,92.27.27.158,0,0,4,485,4,485,0.360669000,0.9830
136.25.188.179,<->,130.165.253.86,4,1413,0,0,4,1413,0.359144000,0.4096
132.163.115.100,<->,89.183.104.242,0,0,4,582,4,582,0.358984000,0.0650
199.72.18.85,<->,136.25.188.177,0,0,4,200,4,200,0.358371000,0.2662
119.253.25.166,<->,89.183.110.45,0,0,4,200,4,200,0.358157000,1.0611
215.158.238.140,<->,116.107.47.42,4,1397,0,0,4,1397,0.357562000,0.1433
142.206.45.88,<->,136.25.188.220,0,0,4,762,4,762,0.357315000,0.7910
215.158.239.96,<->,196.90.112.117,4,933,0,0,4,933,0.355308000,0.6834
193.21.29.248,<->,102.50.198.43,0,0,4,649,4,649,0.353787000,0.3954
133.32.39.0,<->,14.71.93.60,4,595,0,0,4,595,0.353413000,0.1300
136.25.189.16,<->,89.80.251.7,4,2650,0,0,4,2650,0.353195000,1.1818
111.151.139.235,<->,29.211.214.80,0,0,4,298,4,298,0.353042000,1.5031
80.41.3.199,<->,8.55.211.213,4,470,0,0,4,470,0.351249000,0.0925
192.64.227.200,<->,125.2.49.79,4,206,0,0,4,206,0.350692000,0.6813
97.126.112.4,<->,50.236.233.103,4,1402,0,0,4,1402,0.350011000,0.9125
69.242.172.63,<->,8.252.221.230,0,0,4,1006,4,1006,0.349646000,1.4287
195.14.69.122,<->,136.25.188.174,0,0,4,762,4,762,0.348799000,0.6650
194.194.3.109,<->,100.93.144.191,0,0,4,276,4,276,0.348739000,0.6922
138.79.143.196,<->,92.27.219.156,0,0,4,1197,4,1197,0.348012000,0.7098
136.25.189.16,<->,29.211.93.6,4,2378,0,0,4,2378,0.347106000,1.4707
142.104.79.22,<->,92.27.219.190,0,0,4,208,4,208,0.346826000,1.6411
97.198.98.241,<->,92.180.27.95,4,200,0,0,4,200,0.346502000,0.9768
246.44.136.14,<->,124.55.36.202,4,335,0,0,4,335,0.346479000,0.1088
148.186.207.231,<->,133.178.226.49,0,0,4,1313,4,1313,0.345519000,0.3603
133.178.226.202,<->,130.165.253.42,4,1488,0,0,4,1488,0.345415000,1.2149
207.235.120.66,<->,196.148.128.241,0,0,4,200,4,200,0.345324000,1.3240
215.158.239.99,<->,207.191.24.150,4,224,0,0,4,224,0.344815000,0.2786
133.178.226.224,<->,113.207.61.212,4,459,0,0,4,459,0.343295000,0.1916
215.158.238.133,<->,143.155.227.33,4,249,0,0,4,249,0.343292000,0.1838
143.134.66.96,<->,136.25.188.197,0,0,4,756,4,756,0.343144000,1.0954
204.61.45.73,<->,136.25.188.243,0,0,4,758,4,758,0.342665000,0.3733
207.58.58.110,<->,136.25.188.178,0,0,4,965,4,965,0.341917000,0.2442
213.154.101.12,<->,97.198.98.33,0,0,4,224,4,224,0.341732000,1.2488
144.232.206.169,<->,8.183.24.167,0,0,4,786,4,786,0.340431000,0.1989
159.137.162.213,<->,120.250.122.210,4,796,0,0,4,796,0.340336000,0.5056
221.102.56.69,<->,109.1.60.22,0,0,4,470,4,470,0.340173000,0.1556
215.158.238.64,<->,192.224.20.19,4,2634,0,0,4,2634,0.340130000,1.6465
119.52.114.180,<->,80.41.16.79,0,0,4,532,4,532,0.339498000,1.0511
206.197.147.242,<->,50.224.76.235,0,0,4,1340,4,1340,0.338177000,0.2772
215.158.238.152,<->,0.195.237.14,4,5258,0,0,4,5258,0.337411000,0.0000
97.100.51.225,<->,80.27.152.229,0,0,4,2497,4,2497,0.337172000,1.1984
215.158.238.177,<->,6.116.31.8,4,3827,0,0,4,3827,0.336652000,0.0874
89.86.110.223,<->,8.252.223.162,0,0,4,1217,4,1217,0.336599000,0.5951
208.254.153.181,<->,98.236.235.218,0,0,4,224,4,224,0.336257000,1.5114
195.50.75.207,<->,50.224.76.230,0,0,4,2712,4,2712,0.335922000,0.9210
215.158.140.83,<->,131.1.195.27,4,1545,0,0,4,1545,0.334571000,0.1327
145.252.116.199,<->,100.120.38.6,4,822,0,0,4,822,0.334504000,0.0665
195.65.136.97,<->,50.223.3.228,0,0,4,200,4,200,0.334382000,1.4211
129.47.117.224,<->,99.162.71.215,0,0,4,1892,4,1892,0.334009000,1.6252
221.102.56.69,<->,220.80.171.36,0,0,4,470,4,470,0.333977000,0.0755
120.158.117.139,<->,50.224.89.243,0,0,4,1329,4,1329,0.333667000,0.1915
133.178.226.28,<->,126.219.190.136,4,224,0,0,4,224,0.333167000,0.0010
215.158.239.99,<->,199.20.31.39,4,243,0,0,4,243,0.332890000,0.5400
215.158.239.69,<->,199.20.4.209,4,782,0,0,4,782,0.332695000,1.5898
133.178.227.30,<->,133.56.180.35,4,1194,0,0,4,1194,0.332489000,0.9986
221.102.56.69,<->,80.40.106.78,0,0,4,470,4,470,0.331728000,0.0656
231.138.49.16,<->,136.25.188.53,0,0,4,1864,4,1864,0.331520000,0.1469
232.31.155.200,<->,89.183.111.204,0,0,4,1274,4,1274,0.329833000,0.4309
231.142.18.113,<->,215.158.239.79,0,0,4,762,4,762,0.329312000,0.3534
216.144.219.173,<->,215.158.140.193,0,0,4,798,4,798,0.328782000,0.0720
215.158.239.58,<->,196.94.6.49,4,224,0,0,4,224,0.327914000,0.3954
215.158.239.181,<->,57.210.104.90,4,458,0,0,4,458,0.327304000,0.2307
197.113.99.231,<->,136.25.188.163,0,0,4,1733,4,1733,0.326859000,1.3998
231.142.18.113,<->,215.158.239.57,0,0,4,762,4,762,0.325264000,0.4044
92.27.53.48,<->,89.183.104.115,0,0,4,356,4,356,0.324722000,1.5006
212.118.51.49,<->,8.52.169.89,0,0,4,762,4,762,0.324547000,0.0540
109.1.24.111,<->,99.167.188.131,4,940,0,0,4,940,0.323776000,1.0004
215.158.238.93,<->,113.23.21.223,4,1349,0,0,4,1349,0.323330000,0.2685
133.178.227.44,<->,133.56.180.46,4,1194,0,0,4,1194,0.322670000,1.3323
145.166.15.233,<->,89.183.104.115,0,0,4,356,4,356,0.322585000,1.5006
136.25.189.33,<->,126.219.49.40,4,2650,0,0,4,2650,0.322370000,0.6081
98.128.197.1,<->,8.49.114.128,4,2037,0,0,4,2037,0.321349000,0.0554
215.158.238.45,<->,8.191.6.123,4,1301,0,0,4,1301,0.321156000,0.0320
200.175.231.151,<->,6.130.18.22,4,276,0,0,4,276,0.321010000,0.5980
197.106.125.98,<->,136.25.188.163,0,0,4,224,4,224,0.318823000,0.0001
98.23.118.150,<->,89.183.104.244,0,0,4,200,4,200,0.317638000,1.6008
8.252.223.145,<->,8.219.187.248,4,1169,0,0,4,1169,0.316036000,0.1155
142.228.48.148,<->,136.25.188.236,0,0,4,200,4,200,0.315144000,0.0045
86.198.148.135,<->,0.195.210.24,0,0,4,797,4,797,0.314577000,1.6403
192.229.220.63,<->,111.151.238.139,4,232,0,0,4,232,0.313365000,0.0393
210.226.164.244,<->,54.43.249.8,4,313,0,0,4,313,0.313287000,0.0576
233.30.195.26,<->,98.236.235.218,0,0,4,224,4,224,0.311315000,1.5450
133.178.226.37,<->,131.1.253.208,4,1541,0,0,4,1541,0.311263000,0.1323
209.91.207.208,<->,139.163.0.103,0,0,4,200,4,200,0.310820000,1.5269
204.184.17.86,<->,136.25.188.225,0,0,4,364,4,364,0.310511000,1.2801
200.174.206.107,<->,54.39.80.35,4,666,0,0,4,666,0.310358000,1.5635
192.66.157.68,<->,8.45.175.127,4,408,0,0,4,408,0.310222000,0.1755
207.61.160.213,<->,136.25.188.209,0,0,4,300,4,300,0.309504000,0.0086
215.158.239.96,<->,199.20.30.134,4,249,0,0,4,249,0.309274000,0.8797
148.113.20.250,<->,80.38.61.209,0,0,4,794,4,794,0.309048000,0.7623
204.153.146.105,<->,50.223.3.228,0,0,4,200,4,200,0.306205000,1.5024
197.113.99.151,<->,136.25.188.241,0,0,4,1026,4,1026,0.306132000,0.5798
17.143.241.23,<->,8.220.176.253,0,0,4,697,4,697,0.305297000,1.0648
247.136.134.246,<->,192.169.60.182,4,470,0,0,4,470,0.305154000,0.0807
101.65.255.233,<->,100.224.138.151,4,232,0,0,4,232,0.303964000,0.0855
144.75.218.233,<->,132.200.124.228,4,622,0,0,4,622,0.303775000,0.9796
111.151.239.114,<->,8.30.103.118,0,0,4,224,4,224,0.302983000,0.9521
196.88.178.136,<->,136.25.188.252,0,0,4,762,4,762,0.302683000,0.5016
133.178.226.61,<->,57.247.184.219,4,1285,0,0,4,1285,0.302489000,0.5641
215.158.6.231,<->,8.252.223.153,0,0,4,2592,4,2592,0.301890000,1.1794
132.51.185.39,<->,8.52.222.117,0,0,4,1241,4,1241,0.301596000,0.0599
207.61.68.151,<->,136.25.188.226,0,0,4,496,4,496,0.301437000,0.2855
133.178.227.246,<->,113.85.83.140,4,2900,0,0,4,2900,0.301310000,0.2173
215.158.238.67,<->,131.1.195.249,4,2778,0,0,4,2778,0.301155000,1.6117
196.88.178.136,<->,136.25.188.52,0,0,4,762,4,762,0.300873000,0.5418
215.158.238.109,<->,100.224.166.122,4,1124,0,0,4,1124,0.300621000,1.3034
220.28.73.211,<->,136.25.188.49,0,0,4,4590,4,4590,0.300100000,0.0000
205.95.37.167,<->,92.27.194.117,0,0,4,2030,4,2030,0.299947000,0.5972
215.158.239.94,<->,142.227.54.218,4,424,0,0,4,424,0.298988000,1.4420
221.102.56.69,<->,109.2.12.217,0,0,4,470,4,470,0.298568000,0.1761
136.25.188.52,<->,57.210.107.8,4,1445,0,0,4,1445,0.298438000,0.8280
224.93.235.36,<->,80.27.157.204,0,0,4,1495,4,1495,0.297985000,1.1663
215.158.239.57,<->,195.96.175.234,4,794,0,0,4,794,0.297413000,1.2063
231.143.5.38,<->,136.25.188.226,0,0,4,248,4,248,0.296865000,1.4593
136.129.94.157,<->,111.199.225.189,4,592,0,0,4,592,0.296262000,0.2611
133.171.98.209,<->,8.220.176.253,0,0,4,438,4,438,0.295402000,0.0754
194.237.14.36,<->,136.25.188.238,0,0,4,297,4,297,0.294230000,0.2794
215.158.239.87,<->,196.93.193.38,4,320,0,0,4,320,0.293723000,0.2201
104.233.173.202,<->,50.224.76.248,0,0,4,2501,4,2501,0.292784000,0.3534
247.136.157.176,<->,8.55.140.54,4,1320,0,0,4,1320,0.292346000,0.0805
136.25.189.31,<->,113.23.14.134,4,2570,0,0,4,2570,0.291502000,1.2084
133.178.227.12,<->,69.246.42.12,4,1451,0,0,4,1451,0.291390000,0.1540
92.27.219.128,<->,42.204.29.17,4,5584,0,0,4,5584,0.289744000,1.6816
142.206.40.253,<->,136.25.188.238,0,0,4,618,4,618,0.289558000,0.8387
199.70.172.221,<->,136.25.188.242,0,0,4,224,4,224,0.289239000,0.8776
196.247.34.76,<->,136.25.188.253,0,0,4,249,4,249,0.288674000,0.8204
215.158.238.132,<->,120.154.177.214,4,1429,0,0,4,1429,0.288426000,0.4368
136.25.189.0,<->,114.146.74.194,4,2698,0,0,4,2698,0.286982000,1.6711
246.253.253.99,<->,54.55.44.79,4,1448,0,0,4,1448,0.286645000,1.0022
215.158.238.140,<->,148.23.246.201,4,224,0,0,4,224,0.286613000,0.0017
215.158.239.58,<->,142.241.219.157,4,300,0,0,4,300,0.285705000,0.0103
215.158.239.28,<->,125.84.52.247,4,1683,0,0,4,1683,0.285246000,0.1215
215.158.239.69,<->,118.20.100.183,4,3018,0,0,4,3018,0.285210000,1.1579
216.184.2.246,<->,136.25.189.2,0,0,4,2794,4,2794,0.284890000,0.0781
215.158.238.142,<->,112.220.206.117,4,1301,0,0,4,1301,0.284347000,0.2036
35.55.85.31,<->,8.183.25.124,0,0,4,730,4,730,0.284212000,1.6495
215.158.238.82,<->,142.234.196.219,4,2810,0,0,4,2810,0.284008000,1.6166
135.197.79.79,<->,98.236.235.218,0,0,4,200,4,200,0.282462000,1.4075
231.142.65.52,<->,215.158.239.68,0,0,4,762,4,762,0.281623000,0.3306
133.178.227.19,<->,125.216.43.40,4,1213,0,0,4,1213,0.281595000,0.3709
144.92.40.72,<->,106.5.208.194,4,734,0,0,4,734,0.281376000,1.3403
133.178.226.255,<->,97.4.157.0,4,389,0,0,4,389,0.280370000,0.0430
210.221.111.77,<->,57.148.44.122,4,1626,0,0,4,1626,0.279456000,0.5004
215.158.239.95,<->,199.20.28.234,4,249,0,0,4,249,0.278251000,0.2500
212.164.136.31,<->,98.213.198.6,4,200,0,0,4,200,0.277203000,1.2412
136.25.188.210,<->,111.150.186.172,4,224,0,0,4,224,0.276497000,0.0007
224.93.235.33,<->,80.27.157.12,0,0,4,2828,4,2828,0.276207000,1.4561
149.118.151.184,<->,136.25.188.224,0,0,4,1365,4,1365,0.274751000,0.1269
94.192.127.152,<->,8.252.221.236,0,0,4,606,4,606,0.274691000,0.4440
215.158.239.93,<->,199.20.6.245,4,224,0,0,4,224,0.273991000,1.3590
215.158.238.104,<->,192.227.190.231,4,1861,0,0,4,1861,0.273838000,0.1522
204.184.213.6,<->,136.25.188.198,0,0,4,248,4,248,0.272706000,1.3630
215.158.238.134,<->,126.219.60.223,4,1349,0,0,4,1349,0.272392000,0.1571
195.4.59.185,<->,136.25.188.253,0,0,4,249,4,249,0.271221000,0.1914
111.146.248.83,<->,94.39.218.34,4,532,0,0,4,532,0.271166000,0.9038
133.32.39.0,<->,14.71.90.213,4,447,0,0,4,447,0.269991000,0.1258
222.41.149.170,<->,50.224.80.64,0,0,4,538,4,538,0.269586000,1.5512
204.187.51.129,<->,136.25.188.226,0,0,4,1166,4,1166,0.268654000,0.7402
92.27.234.6,<->,82.247.233.205,4,200,0,0,4,200,0.268649000,1.2621
92.26.155.243,<->,14.125.23.80,0,0,4,436,4,436,0.268575000,0.1658
195.13.205.78,<->,136.25.188.196,0,0,4,762,4,762,0.268436000,0.3190
199.122.48.74,<->,136.25.188.253,0,0,4,757,4,757,0.268382000,1.6967
142.167.79.59,<->,136.25.188.225,0,0,4,218,4,218,0.268288000,1.2183
207.59.200.176,<->,92.27.194.147,0,0,4,425,4,425,0.268200000,0.7665
129.28.175.197,<->,50.224.76.230,0,0,4,1272,4,1272,0.268065000,0.0612
111.147.205.146,<->,73.107.78.160,4,271,0,0,4,271,0.267514000,1.0721
197.113.99.116,<->,136.25.188.255,0,0,4,869,4,869,0.266714000,1.2997
215.158.239.71,<->,207.188.86.6,4,249,0,0,4,249,0.266163000,0.2799
192.64.131.210,<->,159.23.224.231,0,0,4,206,4,206,0.265628000,1.3582
220.39.233.120,<->,215.158.238.66,0,0,4,2314,4,2314,0.265216000,1.2098
136.25.189.77,<->,116.106.46.121,4,2816,0,0,4,2816,0.265102000,1.6790
136.25.188.237,<->,8.222.96.7,4,1381,0,0,4,1381,0.264367000,1.1687
207.59.209.72,<->,136.25.188.209,0,0,4,224,4,224,0.264357000,0.0296
80.27.153.103,<->,4.129.110.82,4,281,0,0,4,281,0.264348000,0.2544
192.67.168.13,<->,120.117.233.56,4,208,0,0,4,208,0.264115000,1.5795
156.165.33.1,<->,133.178.227.14,0,0,4,1219,4,1219,0.263501000,0.2221
207.92.37.152,<->,8.182.136.192,0,0,4,762,4,762,0.263476000,0.3042
196.119.221.14,<->,92.27.194.147,0,0,4,491,4,491,0.263223000,0.8191
215.158.239.85,<->,199.20.30.22,4,200,0,0,4,200,0.262559000,0.1489
92.27.27.175,<->,72.63.102.180,4,232,0,0,4,232,0.262341000,1.7028
231.143.126.85,<->,136.25.188.225,0,0,4,933,4,933,0.262083000,1.2601
192.64.200.73,<->,35.56.31.165,4,496,0,0,4,496,0.261816000,1.4403
246.253.217.195,<->,114.143.1.94,4,2778,0,0,4,2778,0.261234000,0.9999
133.178.226.29,<->,128.194.247.212,4,260,0,0,4,260,0.261218000,0.1689
199.55.98.135,<->,50.224.76.234,0,0,4,212,4,212,0.261108000,0.3669
139.163.169.169,<->,133.178.226.212,0,0,4,1740,4,1740,0.260783000,0.9288
215.158.238.144,<->,80.57.141.219,4,682,0,0,4,682,0.260706000,0.0610
103.182.133.32,<->,50.224.88.92,0,0,4,224,4,224,0.260565000,1.3633
91.231.221.147,<->,8.252.223.188,0,0,4,1134,4,1134,0.259462000,1.5319
142.204.32.86,<->,136.25.188.223,0,0,4,1461,4,1461,0.258645000,0.3280
195.7.73.125,<->,136.25.188.254,0,0,4,224,4,224,0.257996000,0.0046
133.178.227.24,<->,72.23.148.244,4,1195,0,0,4,1195,0.257594000,1.0068
235.253.218.218,<->,215.158.238.92,0,0,4,1441,4,1441,0.256733000,0.8820
215.158.61.243,<->,8.176.8.179,0,0,4,3453,4,3453,0.255902000,1.0322
220.28.115.46,<->,136.25.189.93,0,0,4,3946,4,3946,0.255408000,0.1144
142.229.85.25,<->,136.25.188.160,0,0,4,989,4,989,0.255031000,0.3032
138.98.250.39,<->,6.212.6.128,4,224,0,0,4,224,0.254861000,1.2542
80.27.153.100,<->,4.129.110.82,4,281,0,0,4,281,0.254453000,0.2357
215.158.238.81,<->,131.144.113.170,4,224,0,0,4,224,0.253523000,0.0265
119.70.246.26,<->,92.27.219.237,0,0,4,5880,4,5880,0.253093000,1.4670
215.158.239.79,<->,199.20.29.43,4,816,0,0,4,816,0.252643000,1.2803
215.158.239.56,<->,196.88.157.91,4,869,0,0,4,869,0.252125000,0.3945
215.158.238.32,<->,8.191.6.219,4,1365,0,0,4,1365,0.251300000,0.0203
143.155.227.33,<->,136.25.188.226,0,0,4,249,4,249,0.250936000,0.1731
139.249.95.234,<->,100.120.38.6,4,261,0,0,4,261,0.250729000,0.0001
207.173.105.62,<->,136.25.188.45,0,0,4,280,4,280,0.249941000,1.6402
231.143.67.11,<->,136.25.188.241,0,0,4,224,4,224,0.249292000,0.0499
132.168.196.9,<->,122.22.230.148,4,208,0,0,4,208,0.249148000,1.1128
215.158.239.94,<->,196.93.174.232,4,582,0,0,4,582,0.248805000,1.7508
110.247.87.162,<->,91.231.194.54,0,0,4,200,4,200,0.247656000,1.0637
215.158.239.56,<->,195.54.120.30,4,762,0,0,4,762,0.247415000,0.5029
97.198.98.33,<->,17.8.130.43,4,200,0,0,4,200,0.247318000,1.3179
215.158.238.80,<->,122.216.233.232,4,224,0,0,4,224,0.246948000,0.0005
215.158.239.182,<->,100.224.132.151,4,380,0,0,4,380,0.246856000,0.0445
8.52.246.3,<->,8.42.79.134,4,232,0,0,4,232,0.246790000,0.0378
215.158.239.58,<->,199.20.31.193,4,260,0,0,4,260,0.246225000,0.6632
220.28.73.211,<->,136.25.188.249,0,0,4,3783,4,3783,0.245192000,0.0032
215.158.238.32,<->,29.212.182.225,4,1237,0,0,4,1237,0.244800000,0.5079
247.136.211.104,<->,64.214.57.24,4,797,0,0,4,797,0.244685000,1.0599
197.198.21.33,<->,80.38.52.42,0,0,4,762,4,762,0.242869000,1.4280
207.196.145.247,<->,92.27.234.141,0,0,4,200,4,200,0.241946000,1.3134
120.53.101.215,<->,100.94.160.103,0,0,4,1303,4,1303,0.241726000,1.4445
215.158.3.139,<->,8.176.8.248,0,0,4,1194,4,1194,0.241724000,0.0458
114.60.0.6,<->,22.59.5.231,0,0,4,200,4,200,0.241221000,1.3875
215.158.238.82,<->,122.159.245.169,4,2794,0,0,4,2794,0.241128000,0.3925
215.158.238.115,<->,192.226.161.17,4,2618,0,0,4,2618,0.240216000,1.7041
139.5.114.37,<->,8.52.184.173,0,0,4,232,4,232,0.239587000,0.0432
101.123.193.252,<->,8.55.195.24,4,347,0,0,4,347,0.239289000,0.1180
92.27.209.212,<->,57.141.132.156,4,1560,0,0,4,1560,0.239280000,0.4295
133.178.226.30,<->,113.23.117.116,4,1333,0,0,4,1333,0.238372000,0.1197
221.102.56.69,<->,192.67.161.246,0,0,4,470,4,470,0.237613000,0.1007
215.158.239.33,<->,113.86.1.40,4,1721,0,0,4,1721,0.236358000,0.1044
136.25.188.53,<->,95.90.127.146,4,765,0,0,4,765,0.235416000,1.7346
195.41.107.235,<->,136.25.188.198,0,0,4,320,4,320,0.235364000,0.4773
215.158.3.213,<->,99.74.87.197,0,0,4,1866,4,1866,0.235043000,0.1704
207.197.78.90,<->,109.222.212.23,0,0,4,5736,4,5736,0.233934000,1.6851
215.158.239.50,<->,199.32.187.69,4,264,0,0,4,264,0.233829000,0.1860
215.158.140.229,<->,29.212.42.171,4,2498,0,0,4,2498,0.232938000,1.1130
143.155.227.33,<->,133.178.226.31,0,0,4,249,4,249,0.232059000,0.1760
133.178.226.30,<->,8.252.214.62,4,1445,0,0,4,1445,0.230526000,0.0601
114.174.92.82,<->,80.42.131.57,0,0,4,375,4,375,0.230022000,0.8889
92.27.27.177,<->,57.33.182.12,4,226,0,0,4,226,0.229670000,1.3630
215.158.239.92,<->,207.166.169.32,4,1200,0,0,4,1200,0.228820000,1.7401
98.129.94.127,<->,97.4.43.222,4,356,0,0,4,356,0.228263000,0.2622
157.208.232.75,<->,108.39.53.224,0,0,4,268,4,268,0.228090000,1.1264
213.221.90.137,<->,98.236.235.73,0,0,4,224,4,224,0.228043000,1.3186
80.27.156.197,<->,74.87.133.34,4,1690,0,0,4,1690,0.227226000,0.3908
133.178.226.233,<->,130.36.8.137,4,224,0,0,4,224,0.226578000,1.0018
204.63.5.183,<->,136.25.188.53,0,0,4,1095,4,1095,0.225808000,0.7202
149.97.34.22,<->,50.224.76.234,0,0,4,723,4,723,0.225268000,1.5530
215.158.140.231,<->,131.144.114.235,4,224,0,0,4,224,0.225197000,0.0007
215.158.239.95,<->,199.20.31.153,4,903,0,0,4,903,0.225170000,1.4789
215.158.239.70,<->,199.20.30.62,4,200,0,0,4,200,0.224682000,0.4399
215.158.239.79,<->,207.115.200.229,4,820,0,0,4,820,0.224593000,1.6808
215.158.238.81,<->,122.158.49.128,4,1525,0,0,4,1525,0.224192000,0.2929
215.158.238.106,<->,143.227.65.142,4,1349,0,0,4,1349,0.224186000,0.2598
142.223.172.112,<->,136.25.188.178,0,0,4,206,4,206,0.224055000,0.1614
104.247.205.211,<->,92.27.194.147,0,0,4,424,4,424,0.222309000,0.6313
202.33.127.224,<->,136.25.188.220,0,0,4,249,4,249,0.222016000,0.2645
159.248.57.67,<->,136.25.188.209,0,0,4,232,4,232,0.221963000,0.0378
204.89.88.245,<->,92.27.194.147,0,0,4,406,4,406,0.221894000,0.5421
133.178.227.19,<->,8.220.54.244,4,224,0,0,4,224,0.221507000,0.0003
207.60.19.235,<->,136.25.188.53,0,0,4,435,4,435,0.220903000,0.9558
88.61.181.164,<->,50.224.81.197,0,0,4,256,4,256,0.220446000,1.4995
215.158.238.123,<->,29.212.182.225,4,1381,0,0,4,1381,0.220393000,0.1307
215.158.238.75,<->,104.3.161.2,4,224,0,0,4,224,0.220178000,0.0175
100.116.238.33,<->,92.27.27.167,0,0,4,658,4,658,0.219982000,0.1623
195.54.151.216,<->,136.25.188.163,0,0,4,276,4,276,0.219099000,0.1399
195.4.32.221,<->,136.25.188.163,0,0,4,200,4,200,0.218483000,0.0018
133.178.226.30,<->,57.160.181.229,4,2864,0,0,4,2864,0.218195000,1.5047
215.158.239.56,<->,199.20.29.11,4,1733,0,0,4,1733,0.218098000,1.7440
246.253.198.51,<->,114.155.143.126,4,206,0,0,4,206,0.217797000,0.3309
215.158.239.79,<->,196.93.253.247,4,200,0,0,4,200,0.217470000,1.4800
54.39.10.127,<->,48.53.239.203,0,0,4,236,4,236,0.217390000,1.5481
204.60.215.71,<->,136.25.188.160,0,0,4,304,4,304,0.216129000,1.3801
119.230.159.211,<->,6.75.237.59,0,0,4,276,4,276,0.214845000,0.3527
215.158.140.83,<->,33.221.186.171,4,1260,0,0,4,1260,0.214292000,1.1905
221.102.108.221,<->,118.90.182.249,4,1618,0,0,4,1618,0.213676000,0.1509
215.158.239.68,<->,199.20.29.145,4,1063,0,0,4,1063,0.213575000,0.3099
97.168.88.160,<->,54.36.97.247,4,231,0,0,4,231,0.213540000,0.0006
200.175.105.196,<->,53.244.210.133,4,1439,0,0,4,1439,0.213446000,0.8222
136.25.188.53,<->,101.224.63.210,4,300,0,0,4,300,0.212516000,0.0023
215.158.238.155,<->,122.158.69.2,4,4448,0,0,4,4448,0.211951000,1.0054
136.25.188.255,<->,8.227.55.173,4,232,0,0,4,232,0.211698000,0.0337
215.158.239.68,<->,196.91.81.242,4,292,0,0,4,292,0.211667000,0.2659
215.158.238.99,<->,118.20.87.65,4,1445,0,0,4,1445,0.211646000,0.2092
215.158.239.87,<->,207.167.253.182,4,1293,0,0,4,1293,0.211383000,0.3807
142.167.89.22,<->,136.25.188.243,0,0,4,200,4,200,0.209611000,0.0457
215.158.239.51,<->,196.108.43.221,4,206,0,0,4,206,0.209495000,1.1005
235.42.34.20,<->,215.158.238.104,0,0,4,249,4,249,0.209395000,0.1193
215.158.239.67,<->,122.158.69.2,4,4448,0,0,4,4448,0.209107000,1.0072
205.109.5.113,<->,22.59.36.31,0,0,4,200,4,200,0.208925000,1.4464
215.158.239.49,<->,29.214.73.151,4,2682,0,0,4,2682,0.208518000,1.3121
136.25.188.44,<->,8.179.43.82,4,1557,0,0,4,1557,0.207477000,0.2971
195.41.107.235,<->,136.25.188.243,0,0,4,320,4,320,0.207338000,0.3929
215.158.239.35,<->,91.57.162.254,4,1756,0,0,4,1756,0.206987000,0.0345
238.155.239.157,<->,89.183.104.254,0,0,4,208,4,208,0.205749000,1.1725
136.138.112.226,<->,136.25.188.162,0,0,4,2506,4,2506,0.205286000,0.3698
215.158.61.189,<->,8.176.8.95,0,0,4,3463,4,3463,0.205122000,1.1649
50.224.80.64,<->,50.118.185.242,4,542,0,0,4,542,0.204463000,0.1329
199.71.209.205,<->,136.25.188.220,0,0,4,998,4,998,0.204290000,1.2055
133.178.226.19,<->,8.241.236.64,4,1221,0,0,4,1221,0.203963000,0.3422
215.158.239.78,<->,204.0.146.238,4,272,0,0,4,272,0.203849000,1.7400
136.25.189.59,<->,61.35.124.249,4,1525,0,0,4,1525,0.202982000,0.8513
80.40.80.132,<->,8.55.211.213,4,470,0,0,4,470,0.202797000,0.0753
108.39.84.149,<->,50.224.89.241,0,0,4,325,4,325,0.202602000,0.0690
215.158.239.96,<->,143.42.134.73,4,259,0,0,4,259,0.202440000,0.5818
215.158.239.95,<->,204.56.133.222,4,794,0,0,4,794,0.201268000,1.4453
207.61.158.105,<->,136.25.188.55,0,0,4,432,4,432,0.200774000,1.2202
204.187.121.47,<->,136.25.188.177,0,0,4,370,4,370,0.200732000,1.7200
200.174.51.16,<->,53.161.15.106,4,402,0,0,4,402,0.200695000,0.9182
136.25.189.80,<->,96.112.108.55,4,224,0,0,4,224,0.200067000,0.0002
133.178.227.76,<->,8.50.171.202,4,2538,0,0,4,2538,0.199423000,1.6779
204.186.76.88,<->,136.25.188.224,0,0,4,260,4,260,0.198949000,1.2151
215.158.239.56,<->,204.61.154.8,4,224,0,0,4,224,0.196708000,0.9741
136.25.189.77,<->,29.209.59.213,4,2730,0,0,4,2730,0.196468000,0.5796
215.158.239.57,<->,199.20.31.175,4,309,0,0,4,309,0.196322000,0.0490
117.35.55.89,<->,8.31.37.163,0,0,4,971,4,971,0.195972000,0.2342
197.106.84.186,<->,8.182.224.248,0,0,4,452,4,452,0.195202000,0.2456
215.158.239.92,<->,195.55.59.183,4,785,0,0,4,785,0.195194000,1.2935
215.158.239.56,<->,195.97.60.49,4,886,0,0,4,886,0.194726000,0.1981
192.224.20.18,<->,136.25.188.252,0,0,4,1317,4,1317,0.194656000,0.1640
136.25.189.28,<->,135.228.221.198,4,1797,0,0,4,1797,0.194485000,0.3767
207.3.215.218,<->,50.223.3.228,0,0,4,396,4,396,0.194076000,0.1801
197.161.237.128,<->,136.25.188.236,0,0,4,762,4,762,0.193994000,0.3265
247.203.163.230,<->,50.224.76.230,0,0,4,911,4,911,0.193884000,0.0504
215.158.239.70,<->,204.56.18.191,4,762,0,0,4,762,0.191932000,0.6159
197.113.99.55,<->,136.25.188.209,0,0,4,224,4,224,0.191698000,0.0400
215.158.239.181,<->,113.207.62.162,4,270,0,0,4,270,0.191609000,0.2064
136.25.188.254,<->,41.157.110.196,4,300,0,0,4,300,0.191503000,0.0007
195.3.157.138,<->,129.224.112.252,0,0,4,300,4,300,0.190164000,0.1530
215.158.239.92,<->,199.69.122.51,4,224,0,0,4,224,0.189757000,0.0421
221.102.56.69,<->,109.3.172.183,0,0,4,470,4,470,0.189400000,0.0760
215.158.238.82,<->,100.224.138.214,4,1581,0,0,4,1581,0.188475000,0.0279
231.143.109.135,<->,136.25.188.253,0,0,4,315,4,315,0.188226000,0.9282
141.199.76.220,<->,136.25.189.77,0,0,4,2698,4,2698,0.188065000,0.7463
136.25.188.254,<->,113.23.104.246,4,432,0,0,4,432,0.187063000,0.8784
136.25.188.45,<->,29.214.108.136,4,1557,0,0,4,1557,0.186507000,0.2170
80.40.21.214,<->,8.45.175.127,4,966,0,0,4,966,0.186056000,0.1889
149.252.245.58,<->,136.25.189.77,0,0,4,1381,4,1381,0.185714000,0.1733
215.158.239.93,<->,199.20.4.135,4,200,0,0,4,200,0.185034000,0.2229
111.147.206.204,<->,53.69.124.66,4,247,0,0,4,247,0.184452000,0.0002
215.158.239.68,<->,199.20.31.72,4,249,0,0,4,249,0.184053000,0.2902
144.232.206.138,<->,89.183.104.115,0,0,4,356,4,356,0.183928000,1.5005
215.158.238.123,<->,80.57.141.61,4,1381,0,0,4,1381,0.183554000,0.0281
215.158.239.48,<->,196.93.240.138,4,272,0,0,4,272,0.182860000,1.1600
215.158.239.77,<->,199.20.5.31,4,224,0,0,4,224,0.182025000,1.1796
136.25.189.57,<->,6.116.14.9,4,2554,0,0,4,2554,0.181997000,1.7684
142.249.172.162,<->,136.25.188.52,0,0,4,588,4,588,0.181705000,0.3863
215.158.239.215,<->,215.158.61.202,4,2152,0,0,4,2152,0.181376000,1.5303
136.158.73.51,<->,133.178.227.227,0,0,4,262,4,262,0.180930000,0.6015
104.92.51.130,<->,89.183.109.134,0,0,4,275,4,275,0.180302000,1.1897
132.234.106.64,<->,111.181.113.65,0,0,4,598,4,598,0.180089000,0.1295
195.13.127.166,<->,136.25.188.242,0,0,4,206,4,206,0.179917000,1.2159
215.158.61.189,<->,8.176.8.218,0,0,4,2047,4,2047,0.179768000,1.3216
149.192.23.223,<->,136.25.189.47,0,0,4,232,4,232,0.179004000,0.2219
199.121.49.183,<->,136.25.188.225,0,0,4,340,4,340,0.178586000,1.1458
143.135.128.235,<->,136.25.188.255,0,0,4,690,4,690,0.178089000,1.6875
132.129.7.44,<->,97.198.98.241,0,0,4,224,4,224,0.177913000,1.3248
73.14.208.191,<->,8.252.222.61,0,0,4,886,4,886,0.176674000,0.8921
215.158.238.190,<->,68.231.26.203,4,1301,0,0,4,1301,0.176544000,1.3770
215.158.238.93,<->,113.23.21.196,4,224,0,0,4,224,0.176427000,0.0005
101.70.121.211,<->,50.239.121.175,4,256,0,0,4,256,0.176318000,1.4399
142.167.136.97,<->,136.25.188.237,0,0,4,224,4,224,0.176127000,0.0885
215.158.239.99,<->,199.80.81.169,4,296,0,0,4,296,0.175607000,1.4007
207.92.10.130,<->,8.182.226.78,0,0,4,762,4,762,0.175367000,0.3821
215.158.61.191,<->,136.25.188.40,0,0,4,3428,4,3428,0.174173000,1.4404
215.158.239.34,<->,122.158.239.11,4,224,0,0,4,224,0.173149000,0.0015
133.178.227.245,<->,80.47.104.132,4,2050,0,0,4,2050,0.171929000,1.8129
104.245.45.167,<->,50.224.76.230,0,0,4,1515,4,1515,0.170798000,0.2957
142.228.172.166,<->,136.25.188.53,0,0,4,212,4,212,0.170632000,0.2133
215.158.239.4,<->,122.158.246.191,4,1640,0,0,4,1640,0.170243000,0.2030
215.158.239.79,<->,143.76.107.81,4,410,0,0,4,410,0.169299000,0.6347
136.25.189.15,<->,32.183.36.244,4,2762,0,0,4,2762,0.168944000,1.7685
158.224.196.13,<->,80.42.179.101,0,0,4,241,4,241,0.168115000,0.7401
215.158.239.30,<->,149.96.60.154,4,1728,0,0,4,1728,0.168017000,0.0955
215.158.238.95,<->,89.86.110.10,4,1461,0,0,4,1461,0.168009000,0.1107
199.38.60.19,<->,136.25.188.175,0,0,4,320,4,320,0.167513000,0.5495
136.25.188.242,<->,106.17.143.227,4,1221,0,0,4,1221,0.167425000,0.4735
215.158.238.236,<->,89.86.110.213,4,1221,0,0,4,1221,0.166506000,0.1129
100.83.51.93,<->,97.126.113.45,0,0,4,765,4,765,0.165624000,0.8195
137.179.183.36,<->,53.149.207.79,4,2732,0,0,4,2732,0.164384000,1.2546
143.128.121.231,<->,136.25.188.252,0,0,4,320,4,320,0.164191000,0.5445
136.25.189.0,<->,8.222.58.219,4,1445,0,0,4,1445,0.163550000,0.2437
207.62.110.132,<->,136.25.188.243,0,0,4,886,4,886,0.163307000,1.6769
204.63.144.227,<->,136.25.188.53,0,0,4,276,4,276,0.162330000,1.6807
204.200.48.116,<->,136.25.188.176,0,0,4,302,4,302,0.162250000,1.2994
253.244.5.101,<->,50.224.76.235,0,0,4,769,4,769,0.162054000,0.2817
195.41.76.161,<->,136.25.188.163,0,0,4,858,4,858,0.161914000,0.8491
136.25.189.34,<->,96.156.169.222,4,2202,0,0,4,2202,0.159037000,0.7521
194.233.103.247,<->,136.25.188.255,0,0,4,303,4,303,0.158745000,0.2405
215.158.238.75,<->,122.158.49.151,4,1825,0,0,4,1825,0.158511000,0.4675
144.75.218.241,<->,138.127.231.62,4,1151,0,0,4,1151,0.157811000,1.2003
195.124.20.65,<->,136.25.188.227,0,0,4,224,4,224,0.157682000,1.2990
251.112.155.10,<->,215.158.238.65,0,0,4,224,4,224,0.157438000,0.0009
215.158.239.56,<->,196.1.15.75,4,1263,0,0,4,1263,0.157120000,1.8320
56.114.235.120,<->,8.228.209.115,0,0,4,2891,4,2891,0.156888000,0.0941
193.78.32.194,<->,159.23.224.4,0,0,4,200,4,200,0.156299000,1.4662
142.244.255.166,<->,136.25.188.211,0,0,4,762,4,762,0.156251000,0.3991
215.158.140.83,<->,8.221.197.173,4,2569,0,0,4,2569,0.155833000,0.6508
142.227.62.33,<->,136.25.188.237,0,0,4,200,4,200,0.155742000,0.4450
149.163.129.230,<->,136.25.189.13,0,0,4,2522,4,2522,0.154979000,1.6978
247.136.180.232,<->,122.6.184.30,4,655,0,0,4,655,0.154912000,1.5941
92.26.138.178,<->,14.125.23.243,0,0,4,404,4,404,0.154588000,1.4833
199.69.122.48,<->,136.25.188.44,0,0,4,200,4,200,0.154409000,0.1845
144.87.238.91,<->,8.182.139.26,0,0,4,758,4,758,0.154262000,0.1843
215.158.239.79,<->,199.106.113.244,4,476,0,0,4,476,0.153406000,1.8400
207.172.176.187,<->,136.25.188.44,0,0,4,570,4,570,0.153392000,0.4765
215.158.239.102,<->,215.158.61.189,4,1865,0,0,4,1865,0.151993000,1.5038
156.165.37.84,<->,136.25.189.28,0,0,4,2714,4,2714,0.151644000,1.1222
136.25.189.29,<->,116.106.46.58,4,1564,0,0,4,1564,0.150305000,0.3478
247.136.250.194,<->,80.233.221.39,4,200,0,0,4,200,0.148998000,1.0874
139.163.5.140,<->,29.165.29.168,4,262,0,0,4,262,0.148820000,0.1522
231.140.85.14,<->,215.158.239.49,0,0,4,224,4,224,0.148495000,0.0045
136.25.189.1,<->,120.154.131.21,4,2730,0,0,4,2730,0.148455000,0.3326
199.38.236.20,<->,136.25.188.163,0,0,4,200,4,200,0.146407000,0.0044
116.141.20.175,<->,50.224.76.230,0,0,4,1418,4,1418,0.145679000,0.1348
192.67.179.218,<->,127.155.247.137,4,298,0,0,4,298,0.143725000,0.1936
133.178.226.212,<->,113.93.9.37,4,1591,0,0,4,1591,0.142890000,1.7080
215.158.239.49,<->,199.20.30.48,4,390,0,0,4,390,0.142885000,0.5200
215.158.239.50,<->,196.91.88.36,4,224,0,0,4,224,0.142343000,0.1901
215.158.239.50,<->,196.94.33.73,4,224,0,0,4,224,0.142293000,0.0700
133.54.16.199,<->,117.130.2.181,4,1275,0,0,4,1275,0.142290000,0.7424
215.158.239.87,<->,207.115.122.109,4,886,0,0,4,886,0.142091000,1.7204
135.207.217.147,<->,98.236.254.37,0,0,4,516,4,516,0.141280000,1.8586
139.114.215.223,<->,89.139.242.246,0,0,4,449,4,449,0.141174000,0.0807
196.93.174.232,<->,136.25.188.46,0,0,4,582,4,582,0.140630000,1.6148
136.25.189.221,<->,8.222.214.24,4,2728,0,0,4,2728,0.140607000,0.0578
215.158.239.84,<->,199.20.31.230,4,346,0,0,4,346,0.140072000,0.9753
215.158.239.79,<->,131.144.113.52,4,1525,0,0,4,1525,0.139779000,0.8166
36.116.164.202,<->,8.252.222.30,0,0,4,894,4,894,0.139536000,0.9220
194.245.177.149,<->,8.182.224.248,0,0,4,758,4,758,0.139393000,0.8312
111.20.172.70,<->,33.233.141.22,0,0,4,453,4,453,0.139033000,0.9794
131.175.194.72,<->,92.27.219.21,0,0,4,236,4,236,0.138204000,0.3761
192.226.161.66,<->,133.178.227.1,0,0,4,1573,4,1573,0.138076000,0.4507
215.158.239.215,<->,215.158.61.145,4,2915,0,0,4,2915,0.138057000,1.0011
215.158.239.78,<->,149.96.171.91,4,2602,0,0,4,2602,0.137778000,0.6430
215.158.239.58,<->,196.90.28.22,4,778,0,0,4,778,0.137728000,0.5826
215.171.79.67,<->,8.52.173.229,0,0,4,2144,4,2144,0.137420000,0.1762
215.158.239.25,<->,111.151.142.231,4,224,0,0,4,224,0.136946000,0.0001
197.113.64.148,<->,136.25.188.46,0,0,4,224,4,224,0.136803000,0.3956
220.55.100.196,<->,38.65.11.4,4,256,0,0,4,256,0.136694000,0.9072
215.158.238.66,<->,113.23.7.56,4,1301,0,0,4,1301,0.136634000,0.1355
215.158.239.99,<->,195.80.198.59,4,886,0,0,4,886,0.136273000,0.3426
144.87.238.89,<->,8.182.253.40,0,0,4,1100,4,1100,0.135864000,0.0490
207.22.228.195,<->,0.195.210.46,0,0,4,622,4,622,0.135822000,0.7914
133.178.226.227,<->,122.158.206.246,4,458,0,0,4,458,0.135214000,1.6305
136.25.188.211,<->,50.150.173.115,4,232,0,0,4,232,0.134479000,0.0380
136.25.189.80,<->,133.224.119.55,4,2890,0,0,4,2890,0.133818000,0.4756
215.158.238.33,<->,122.158.51.54,4,224,0,0,4,224,0.133723000,0.0057
215.158.239.57,<->,199.79.55.96,4,256,0,0,4,256,0.133595000,1.4600
143.155.227.59,<->,136.25.188.209,0,0,4,432,4,432,0.132949000,1.1669
159.224.166.3,<->,8.220.176.253,0,0,4,200,4,200,0.132904000,1.0514
215.158.239.48,<->,196.90.26.63,4,224,0,0,4,224,0.132886000,0.3200
136.25.188.160,<->,104.3.161.68,4,1397,0,0,4,1397,0.132404000,0.2204
141.24.62.189,<->,39.43.133.101,0,0,4,1979,4,1979,0.132261000,0.8370
148.56.229.119,<->,136.25.189.59,0,0,4,2666,4,2666,0.132138000,1.8346
148.55.210.198,<->,136.25.188.175,0,0,4,224,4,224,0.131990000,0.0011
142.167.151.105,<->,136.25.188.52,0,0,4,249,4,249,0.131748000,0.1857
196.119.218.20,<->,92.27.194.147,0,0,4,422,4,422,0.131554000,0.7899
243.117.83.12,<->,139.163.1.75,0,0,4,1019,4,1019,0.131220000,0.2218
215.158.239.56,<->,199.20.31.227,4,886,0,0,4,886,0.131207000,0.3598
200.175.52.173,<->,53.68.146.9,4,600,0,0,4,600,0.131187000,1.3417
136.25.189.59,<->,112.68.105.215,4,2794,0,0,4,2794,0.130788000,1.3603
104.154.114.232,<->,89.183.106.29,0,0,4,200,4,200,0.130779000,1.6118
221.102.56.69,<->,109.2.14.67,0,0,4,470,4,470,0.130291000,0.0802
215.158.239.35,<->,111.151.239.85,4,2091,0,0,4,2091,0.130172000,0.0252
215.158.140.60,<->,122.158.179.5,4,2233,0,0,4,2233,0.130167000,1.8244
249.101.125.43,<->,109.124.142.60,4,838,0,0,4,838,0.129950000,0.1851
144.75.218.233,<->,99.168.7.150,4,514,0,0,4,514,0.129456000,1.1318
133.178.226.14,<->,104.3.168.189,4,1317,0,0,4,1317,0.129080000,0.5209
215.158.238.33,<->,69.132.194.106,4,224,0,0,4,224,0.129043000,0.0000
136.201.88.243,<->,8.220.176.253,0,0,4,681,4,681,0.127413000,0.0478
133.54.29.91,<->,93.77.192.197,4,200,0,0,4,200,0.125298000,1.2468
136.25.188.44,<->,122.159.245.148,4,2730,0,0,4,2730,0.125099000,1.3757
215.158.238.176,<->,29.211.228.201,4,236,0,0,4,236,0.125089000,0.0001
207.86.243.25,<->,8.252.222.223,0,0,4,249,4,249,0.124857000,0.3315
215.158.239.50,<->,207.228.12.183,4,794,0,0,4,794,0.124045000,0.8001
136.25.188.163,<->,8.227.55.217,4,232,0,0,4,232,0.124022000,0.0383
215.158.238.81,<->,113.23.104.212,4,1349,0,0,4,1349,0.123833000,0.2188
112.208.20.199,<->,100.92.157.52,0,0,4,206,4,206,0.123724000,0.2419
111.20.172.70,<->,101.224.89.248,0,0,4,378,4,378,0.123191000,0.9931
215.158.238.236,<->,131.2.115.215,4,1284,0,0,4,1284,0.123146000,0.1542
138.73.126.183,<->,77.38.144.199,4,244,0,0,4,244,0.123107000,1.7345
195.7.4.75,<->,136.25.188.175,0,0,4,320,4,320,0.122994000,0.6729
215.158.239.95,<->,142.241.250.85,4,224,0,0,4,224,0.122486000,0.3107
192.171.13.33,<->,8.252.222.153,0,0,4,1318,4,1318,0.122333000,0.0040
196.115.24.237,<->,8.182.226.78,0,0,4,2160,4,2160,0.122045000,1.0203
194.233.238.26,<->,136.25.188.46,0,0,4,269,4,269,0.121177000,0.9700
142.246.253.204,<->,50.223.3.228,0,0,4,200,4,200,0.120811000,1.7983
215.158.238.188,<->,128.23.167.27,4,224,0,0,4,224,0.120469000,0.0002
95.77.217.246,<->,50.224.76.235,0,0,4,566,4,566,0.120431000,0.2038
215.158.239.58,<->,207.228.58.157,4,260,0,0,4,260,0.119059000,1.7200
195.43.49.234,<->,136.25.188.177,0,0,4,300,4,300,0.118982000,0.0057
195.14.126.103,<->,136.25.188.209,0,0,4,540,4,540,0.118945000,1.3409
136.25.188.105,<->,128.243.151.37,4,515,0,0,4,515,0.118671000,0.9002
100.240.143.236,<->,8.53.0.167,0,0,4,762,4,762,0.117977000,0.0704
111.20.172.70,<->,33.233.141.58,0,0,4,627,4,627,0.117829000,0.9931
74.19.77.65,<->,50.224.76.235,0,0,4,2115,4,2115,0.117430000,0.1504
146.14.145.55,<->,133.178.226.70,0,0,4,1269,4,1269,0.116932000,0.2213
136.25.188.161,<->,57.160.185.42,4,1317,0,0,4,1317,0.116442000,0.3850
133.178.227.16,<->,104.3.168.148,4,1253,0,0,4,1253,0.115430000,1.2608
148.26.113.119,<->,133.178.227.1,0,0,4,2246,4,2246,0.114607000,1.1873
215.158.238.220,<->,8.222.213.13,4,2215,0,0,4,2215,0.114255000,0.6154
111.151.107.247,<->,8.252.222.153,0,0,4,484,4,484,0.114185000,0.0044
99.162.77.146,<->,53.167.130.195,4,224,0,0,4,224,0.113919000,1.8029
199.38.241.87,<->,136.25.188.243,0,0,4,385,4,385,0.113874000,1.6614
210.156.94.131,<->,145.136.243.126,4,200,0,0,4,200,0.113143000,1.0143
215.158.239.96,<->,199.20.28.14,4,224,0,0,4,224,0.112758000,0.5036
215.158.239.96,<->,204.226.11.185,4,224,0,0,4,224,0.112486000,0.0070
196.119.218.188,<->,50.223.3.228,0,0,4,200,4,200,0.112382000,1.0821
215.158.140.168,<->,100.224.243.98,4,5065,0,0,4,5065,0.112077000,0.0000
206.103.215.59,<->,136.25.189.59,0,0,4,2698,4,2698,0.111828000,1.8765
192.64.220.167,<->,149.132.192.46,4,274,0,0,4,274,0.111822000,0.4898
215.158.239.56,<->,207.239.77.83,4,200,0,0,4,200,0.111608000,0.0347
215.158.239.70,<->,113.92.151.56,4,2959,0,0,4,2959,0.111042000,1.3645
215.158.239.93,<->,194.251.117.13,4,300,0,0,4,300,0.110644000,0.0005
53.149.69.158,<->,48.53.172.18,0,0,4,231,4,231,0.110416000,0.3404
215.158.239.35,<->,120.155.14.153,4,1702,0,0,4,1702,0.110390000,0.1180
200.174.208.190,<->,54.36.173.88,4,224,0,0,4,224,0.110219000,0.6168
215.158.239.78,<->,207.167.190.60,4,376,0,0,4,376,0.109447000,1.3321
133.178.227.108,<->,132.43.3.23,4,1040,0,0,4,1040,0.109230000,1.6663
215.158.239.58,<->,204.226.109.183,4,320,0,0,4,320,0.107577000,0.3930
215.158.239.96,<->,143.20.71.191,4,347,0,0,4,347,0.107500000,0.2666
111.20.172.70,<->,33.233.141.63,0,0,4,491,4,491,0.107297000,1.0090
97.198.121.42,<->,89.204.88.146,4,528,0,0,4,528,0.106889000,1.5003
111.20.172.70,<->,33.233.141.99,0,0,4,454,4,454,0.106537000,0.0097
129.236.100.135,<->,129.224.112.252,0,0,4,312,4,312,0.105386000,0.0194
197.113.64.247,<->,136.25.188.225,0,0,4,949,4,949,0.105118000,0.4699
215.158.239.96,<->,194.200.219.61,4,224,0,0,4,224,0.104321000,1.2193
139.193.141.128,<->,105.200.233.252,4,224,0,0,4,224,0.104161000,1.8798
215.158.238.129,<->,97.174.232.195,4,1123,0,0,4,1123,0.103539000,1.7487
136.25.189.88,<->,89.80.251.8,4,2538,0,0,4,2538,0.103335000,0.7706
220.55.123.87,<->,27.11.152.179,4,439,0,0,4,439,0.103204000,0.1313
111.20.172.70,<->,33.233.141.122,0,0,4,584,4,584,0.103107000,0.9977
145.48.251.217,<->,8.52.164.238,0,0,4,232,4,232,0.103082000,0.0404
215.158.238.135,<->,212.70.75.109,4,1381,0,0,4,1381,0.103053000,0.0371
215.158.238.104,<->,148.129.19.200,4,224,0,0,4,224,0.102683000,0.0008
112.208.20.81,<->,100.92.157.52,0,0,4,206,4,206,0.101552000,0.2507
111.20.172.70,<->,101.224.89.244,0,0,4,495,4,495,0.101191000,1.0056
204.187.10.241,<->,136.25.188.238,0,0,4,794,4,794,0.100882000,1.8198
136.25.189.82,<->,120.154.71.23,4,2554,0,0,4,2554,0.099422000,0.2061
86.135.107.2,<->,8.252.222.132,0,0,4,886,4,886,0.099083000,0.1930
133.178.227.247,<->,113.207.47.231,4,2325,0,0,4,2325,0.098844000,0.5494
142.249.110.104,<->,136.25.188.238,0,0,4,239,4,239,0.098497000,0.0052
252.98.149.193,<->,212.249.34.8,4,333,0,0,4,333,0.098076000,0.2552
204.186.224.4,<->,136.25.188.54,0,0,4,871,4,871,0.096175000,1.1400
215.158.239.87,<->,207.239.77.83,4,200,0,0,4,200,0.096095000,0.0311
207.117.189.228,<->,80.38.39.192,0,0,4,587,4,587,0.095953000,0.7618
243.49.232.125,<->,192.67.139.145,0,0,4,244,4,244,0.095152000,1.1851
136.25.188.44,<->,126.219.132.252,4,1445,0,0,4,1445,0.095105000,0.7316
86.135.66.19,<->,8.252.222.49,0,0,4,309,4,309,0.094699000,0.0059
215.158.61.183,<->,8.176.8.202,0,0,4,5957,4,5957,0.094553000,0.0000
231.136.101.144,<->,136.25.188.178,0,0,4,224,4,224,0.094382000,1.7505
139.163.66.167,<->,97.113.65.172,4,2354,0,0,4,2354,0.093772000,0.9682
227.23.167.178,<->,89.183.108.5,0,0,4,200,4,200,0.093675000,0.0611
215.158.239.70,<->,207.191.236.228,4,782,0,0,4,782,0.093343000,1.2816
215.158.239.49,<->,8.249.253.247,4,2714,0,0,4,2714,0.092745000,0.4720
139.114.208.34,<->,132.249.70.233,0,0,4,524,4,524,0.092258000,1.6750
215.158.239.78,<->,199.20.30.190,4,224,0,0,4,224,0.091661000,1.3790
196.148.130.104,<->,133.199.141.65,4,224,0,0,4,224,0.091067000,0.0020
111.20.172.70,<->,111.20.168.10,0,0,4,407,4,407,0.091042000,1.0094
50.224.76.230,<->,29.94.15.172,4,206,0,0,4,206,0.090392000,1.8045
215.158.238.190,<->,140.174.85.72,4,224,0,0,4,224,0.090217000,0.0001
133.178.226.29,<->,131.1.253.249,4,1525,0,0,4,1525,0.090024000,0.1016
142.206.162.55,<->,136.25.188.222,0,0,4,236,4,236,0.090002000,1.2401
215.158.239.35,<->,57.210.104.245,4,1479,0,0,4,1479,0.089660000,1.4538
215.158.239.77,<->,199.20.29.47,4,3508,0,0,4,3508,0.089318000,1.5001
133.178.226.70,<->,48.129.132.246,4,2618,0,0,4,2618,0.089222000,0.8954
159.57.90.83,<->,111.147.91.126,0,0,4,656,4,656,0.089171000,0.9385
215.158.61.203,<->,8.176.8.189,0,0,4,2295,4,2295,0.088912000,1.1966
215.158.238.89,<->,145.116.209.93,4,682,0,0,4,682,0.088887000,0.0582
80.42.182.80,<->,8.209.235.29,4,2000,0,0,4,2000,0.086697000,0.0421
126.198.96.199,<->,50.224.100.195,0,0,4,714,4,714,0.086426000,1.3744
111.146.199.215,<->,97.110.90.234,4,1190,0,0,4,1190,0.086380000,0.1819
126.149.134.158,<->,50.224.76.235,0,0,4,1222,4,1222,0.083729000,0.3656
122.172.176.39,<->,50.224.76.235,0,0,4,1149,4,1149,0.083115000,0.1914
231.140.176.16,<->,136.25.188.44,0,0,4,239,4,239,0.083075000,0.0059
195.64.121.91,<->,50.223.3.228,0,0,4,206,4,206,0.082704000,0.5483
196.205.199.217,<->,136.25.188.55,0,0,4,224,4,224,0.082081000,0.0400
215.158.239.96,<->,207.236.9.27,4,320,0,0,4,320,0.081817000,0.2883
205.25.24.107,<->,109.222.216.231,0,0,4,540,4,540,0.081656000,0.2676
199.123.251.94,<->,136.25.188.238,0,0,4,200,4,200,0.081554000,0.0000
111.20.172.70,<->,101.224.89.137,0,0,4,573,4,573,0.081489000,1.0081
215.158.239.97,<->,204.3.142.28,4,200,0,0,4,200,0.081436000,0.1117
112.208.20.81,<->,102.50.183.146,0,0,4,202,4,202,0.081342000,0.2745
142.206.49.18,<->,136.25.188.178,0,0,4,200,4,200,0.081175000,0.0020
247.136.184.130,<->,210.209.251.211,4,592,0,0,4,592,0.080797000,0.1816
136.18.96.155,<->,8.182.244.237,0,0,4,1619,4,1619,0.080745000,0.0787
133.178.227.70,<->,122.159.123.27,4,2339,0,0,4,2339,0.080690000,1.1686
142.175.130.184,<->,50.223.3.230,0,0,4,415,4,415,0.080676000,0.1616
207.173.164.189,<->,136.25.188.178,0,0,4,272,4,272,0.080674000,0.1315
215.158.239.76,<->,207.63.142.15,4,218,0,0,4,218,0.079665000,1.4006
215.158.239.69,<->,149.254.114.235,4,1397,0,0,4,1397,0.079041000,0.1339
136.25.189.0,<->,8.33.226.58,4,1493,0,0,4,1493,0.078184000,0.2689
207.175.241.53,<->,136.25.188.238,0,0,4,320,4,320,0.078088000,0.4455
136.25.189.17,<->,68.124.221.170,4,1365,0,0,4,1365,0.078036000,1.4446
144.85.170.248,<->,17.22.230.173,4,1360,0,0,4,1360,0.077666000,1.8670
215.158.239.50,<->,8.222.58.218,4,2682,0,0,4,2682,0.077635000,1.8448
139.163.0.103,<->,96.190.28.68,4,200,0,0,4,200,0.077553000,1.5380
215.158.239.87,<->,57.199.250.213,4,1509,0,0,4,1509,0.077271000,0.2603
215.158.239.77,<->,196.92.131.24,4,894,0,0,4,894,0.076940000,1.8217
226.36.140.164,<->,92.27.219.155,0,0,4,572,4,572,0.076814000,1.2759
205.127.108.115,<->,101.224.89.253,0,0,4,3910,4,3910,0.076799000,0.1782
200.174.99.189,<->,53.160.81.233,4,777,0,0,4,777,0.075845000,0.8209
201.90.144.82,<->,50.224.96.232,0,0,4,3466,4,3466,0.075844000,1.0746
215.158.239.86,<->,199.50.0.190,4,762,0,0,4,762,0.075746000,0.8500
112.13.158.155,<->,109.222.208.215,0,0,4,268,4,268,0.075687000,1.7752
215.158.238.141,<->,8.219.184.150,4,224,0,0,4,224,0.075443000,0.0005
215.158.239.95,<->,199.20.29.222,4,272,0,0,4,272,0.074703000,1.5701
142.208.72.144,<->,136.25.188.176,0,0,4,442,4,442,0.074618000,0.4140
17.41.129.238,<->,8.53.15.98,0,0,4,807,4,807,0.074133000,0.7688
215.158.239.49,<->,57.227.81.11,4,1493,0,0,4,1493,0.074017000,0.1110
136.25.188.241,<->,41.48.192.108,4,300,0,0,4,300,0.073993000,0.0042
215.158.140.92,<->,126.219.246.186,4,2616,0,0,4,2616,0.073984000,1.6665
213.38.202.60,<->,8.55.211.213,4,470,0,0,4,470,0.073781000,0.0789
199.68.100.152,<->,136.25.188.176,0,0,4,300,4,300,0.072666000,0.0074
143.20.133.216,<->,136.25.188.210,0,0,4,224,4,224,0.072267000,0.0964
215.158.238.95,<->,131.144.114.210,4,2794,0,0,4,2794,0.072080000,1.7274
145.176.8.232,<->,102.83.21.26,0,0,4,488,4,488,0.072031000,0.1005
142.207.210.114,<->,136.25.188.225,0,0,4,305,4,305,0.071940000,0.2273
215.158.239.56,<->,204.226.117.233,4,236,0,0,4,236,0.071634000,0.0037
141.28.181.49,<->,92.27.219.149,0,0,4,2900,4,2900,0.071396000,0.0139
80.41.24.161,<->,14.30.152.112,4,1551,0,0,4,1551,0.071215000,0.3789
143.155.227.33,<->,136.25.188.199,0,0,4,432,4,432,0.070936000,0.1678
133.178.226.30,<->,93.156.41.103,4,997,0,0,4,997,0.070705000,0.3539
129.201.127.101,<->,50.224.76.235,0,0,4,2159,4,2159,0.070523000,0.1302
215.158.239.95,<->,196.1.147.146,4,886,0,0,4,886,0.070374000,0.4395
202.33.81.124,<->,136.25.188.240,0,0,4,300,4,300,0.070141000,0.0000
210.229.230.21,<->,104.85.21.141,4,286,0,0,4,286,0.069857000,1.6860
231.140.192.100,<->,136.25.188.178,0,0,4,232,4,232,0.069638000,0.9631
8.52.246.6,<->,8.42.79.134,4,232,0,0,4,232,0.069542000,0.0418
195.40.100.63,<->,136.25.188.236,0,0,4,1045,4,1045,0.069231000,1.0004
199.38.49.30,<->,136.25.188.209,0,0,4,886,4,886,0.069197000,0.2287
248.239.171.126,<->,221.102.56.69,4,470,0,0,4,470,0.069100000,0.0802
133.178.227.14,<->,131.144.114.251,4,1237,0,0,4,1237,0.068606000,0.4571
215.158.239.95,<->,196.94.218.162,4,224,0,0,4,224,0.068272000,1.9201
133.178.226.31,<->,113.20.94.106,4,1317,0,0,4,1317,0.068010000,1.6275
136.25.188.178,<->,42.226.3.105,4,224,0,0,4,224,0.067587000,0.0012
194.237.212.197,<->,136.25.188.53,0,0,4,705,4,705,0.067500000,0.5807
133.54.17.106,<->,88.10.130.201,4,224,0,0,4,224,0.067498000,1.5205
93.181.154.88,<->,92.27.219.143,0,0,4,200,4,200,0.067457000,0.3120
195.7.138.184,<->,136.25.188.241,0,0,4,326,4,326,0.067193000,1.1532
204.62.166.7,<->,136.25.188.198,0,0,4,224,4,224,0.067123000,1.5005
215.158.238.96,<->,159.23.130.171,4,1477,0,0,4,1477,0.066033000,0.1313
200.174.107.227,<->,54.38.66.136,4,712,0,0,4,712,0.065285000,1.1922
199.51.185.92,<->,136.25.188.174,0,0,4,662,4,662,0.064818000,0.1964
197.113.99.101,<->,136.25.188.252,0,0,4,224,4,224,0.064803000,0.1322
222.5.185.61,<->,92.27.234.6,0,0,4,200,4,200,0.064496000,1.2361
215.158.238.243,<->,8.221.197.178,4,2383,0,0,4,2383,0.064357000,1.8804
215.158.239.95,<->,196.89.5.64,4,200,0,0,4,200,0.064126000,0.0692
207.66.12.209,<->,50.223.3.228,0,0,4,206,4,206,0.063092000,1.7181
193.10.94.21,<->,136.25.188.210,0,0,4,224,4,224,0.063047000,0.0003
194.233.38.180,<->,136.25.188.174,0,0,4,486,4,486,0.062738000,1.8199
196.29.116.141,<->,50.223.3.228,0,0,4,397,4,397,0.061942000,0.3130
80.38.40.8,<->,42.68.246.173,4,216,0,0,4,216,0.061754000,0.4251
215.158.239.93,<->,142.244.68.43,4,1189,0,0,4,1189,0.061596000,0.3082
220.254.188.83,<->,8.220.176.253,0,0,4,630,4,630,0.060747000,0.0828
159.57.90.65,<->,132.49.145.62,0,0,4,2390,4,2390,0.060668000,0.0001
207.60.52.98,<->,136.25.188.255,0,0,4,332,4,332,0.060500000,1.8039
146.15.20.243,<->,80.27.155.29,0,0,4,1132,4,1132,0.059578000,1.3914
215.158.239.49,<->,112.220.198.117,4,1493,0,0,4,1493,0.059202000,0.0996
192.231.173.39,<->,99.74.26.190,0,0,4,746,4,746,0.059165000,0.1401
125.161.178.229,<->,92.27.219.210,0,0,4,500,4,500,0.059136000,0.4679
92.27.219.245,<->,33.57.79.52,4,4238,0,0,4,4238,0.058894000,0.7598
196.148.131.53,<->,194.237.237.8,4,320,0,0,4,320,0.058804000,1.5369
205.170.188.93,<->,50.224.76.235,0,0,4,1288,4,1288,0.057923000,0.1649
129.224.112.252,<->,27.127.251.23,4,300,0,0,4,300,0.056570000,0.0039
215.158.239.253,<->,113.24.0.18,4,270,0,0,4,270,0.056351000,0.2090
215.158.238.82,<->,131.173.115.91,4,2698,0,0,4,2698,0.056118000,1.8559
111.146.173.53,<->,54.59.1.108,4,2352,0,0,4,2352,0.055793000,1.6114
136.25.188.175,<->,57.160.181.231,4,1415,0,0,4,1415,0.055720000,1.1358
215.158.239.49,<->,29.212.198.180,4,2538,0,0,4,2538,0.055696000,1.5788
139.148.164.122,<->,8.182.139.197,0,0,4,762,4,762,0.055674000,0.1343
196.247.132.206,<->,136.25.188.54,0,0,4,1263,4,1263,0.054481000,1.2496
195.5.52.146,<->,136.25.188.176,0,0,4,200,4,200,0.054444000,0.2014
111.20.172.70,<->,33.233.141.51,0,0,4,503,4,503,0.054004000,1.9455
147.183.119.67,<->,8.252.221.236,0,0,4,846,4,846,0.053860000,1.1232
215.158.239.84,<->,207.213.181.123,4,272,0,0,4,272,0.053523000,1.5597
139.163.10.82,<->,108.134.75.27,4,396,0,0,4,396,0.053252000,0.1881
207.62.131.115,<->,136.25.188.53,0,0,4,200,4,200,0.053057000,0.0567
92.27.219.17,<->,40.212.145.54,4,226,0,0,4,226,0.052527000,1.5125
215.158.238.135,<->,38.104.11.3,4,1493,0,0,4,1493,0.051965000,0.4146
216.184.1.109,<->,136.25.188.247,0,0,4,3818,4,3818,0.051936000,0.0002
129.224.112.252,<->,27.127.251.38,4,317,0,0,4,317,0.051388000,0.0055
220.20.200.248,<->,119.159.22.233,4,493,0,0,4,493,0.051353000,0.0963
106.168.190.222,<->,99.75.255.41,0,0,4,1549,4,1549,0.050831000,0.9190
194.233.238.26,<->,136.25.188.174,0,0,4,224,4,224,0.050528000,1.7600
196.245.127.38,<->,136.25.188.46,0,0,4,786,4,786,0.049470000,1.6299
142.221.183.232,<->,136.25.188.53,0,0,4,782,4,782,0.048935000,1.2307
193.15.140.40,<->,50.224.76.235,0,0,4,1386,4,1386,0.048850000,0.1245
142.182.51.8,<->,136.25.188.252,0,0,4,224,4,224,0.048761000,0.0707
215.158.239.38,<->,111.151.142.181,4,224,0,0,4,224,0.048638000,0.0001
235.42.34.20,<->,215.158.238.97,0,0,4,1381,4,1381,0.048556000,0.2216
238.161.178.115,<->,92.27.27.178,0,0,4,336,4,336,0.048287000,0.4390
215.158.238.73,<->,29.213.219.30,4,224,0,0,4,224,0.048153000,0.0013
69.128.77.216,<->,54.92.5.14,4,1189,0,0,4,1189,0.048131000,1.9395
215.158.239.78,<->,195.42.32.139,4,350,0,0,4,350,0.047039000,0.4305
215.158.239.56,<->,204.21.1.62,4,224,0,0,4,224,0.047010000,0.0387
6.145.166.161,<->,0.195.210.46,0,0,4,873,4,873,0.047008000,0.6991
195.55.61.107,<->,136.25.188.227,0,0,4,300,4,300,0.046819000,0.0060
235.200.13.198,<->,133.178.227.108,0,0,4,620,4,620,0.045951000,1.5252
136.25.188.209,<->,72.23.234.28,4,379,0,0,4,379,0.045808000,0.6777
136.25.188.55,<->,8.227.55.229,4,232,0,0,4,232,0.044862000,0.0342
215.158.239.95,<->,199.20.6.26,4,261,0,0,4,261,0.044543000,1.8240
215.158.239.87,<->,199.20.31.149,4,224,0,0,4,224,0.043706000,0.0400
113.6.134.93,<->,100.228.42.88,0,0,4,200,4,200,0.043585000,0.0002
236.137.155.115,<->,89.183.104.255,0,0,4,647,4,647,0.043367000,0.2952
215.158.239.224,<->,8.191.7.160,4,4564,0,0,4,4564,0.043280000,0.9367
215.158.238.190,<->,8.240.116.213,4,2290,0,0,4,2290,0.042862000,1.2694
142.244.150.83,<->,136.25.188.163,0,0,4,240,4,240,0.042766000,0.1549
93.181.154.105,<->,89.183.104.145,0,0,4,204,4,204,0.042247000,0.3671
215.158.239.95,<->,199.20.28.197,4,218,0,0,4,218,0.042194000,1.7601
222.254.238.230,<->,210.220.219.153,0,0,4,576,4,576,0.041941000,0.4234
246.253.145.197,<->,143.99.29.57,4,2125,0,0,4,2125,0.041929000,0.8973
97.203.37.94,<->,8.182.226.78,0,0,4,200,4,200,0.041878000,1.6002
215.158.239.85,<->,204.2.170.9,4,958,0,0,4,958,0.041743000,0.3299
92.27.219.171,<->,27.79.107.211,4,208,0,0,4,208,0.041658000,0.8643
199.20.30.79,<->,196.148.128.191,0,0,4,200,4,200,0.041425000,0.2167
144.87.238.91,<->,8.182.138.83,0,0,4,1542,4,1542,0.041112000,0.1103
196.20.139.86,<->,8.228.218.37,0,0,4,208,4,208,0.040999000,1.3351
215.158.239.56,<->,199.20.29.43,4,224,0,0,4,224,0.040638000,0.0398
199.72.23.205,<->,136.25.188.177,0,0,4,224,4,224,0.040318000,0.0653
197.160.64.44,<->,8.182.227.180,0,0,4,508,4,508,0.040095000,0.1208
215.158.239.40,<->,8.222.7.181,4,1366,0,0,4,1366,0.039826000,0.0359
230.240.128.168,<->,8.52.135.109,0,0,4,550,4,550,0.039639000,0.3263
91.251.118.155,<->,8.45.175.127,4,461,0,0,4,461,0.039127000,0.0394
196.200.76.255,<->,8.252.222.204,0,0,4,200,4,200,0.039115000,0.1606
215.158.239.93,<->,199.20.31.16,4,248,0,0,4,248,0.039070000,1.8600
192.64.229.128,<->,112.237.247.242,4,3096,0,0,4,3096,0.039026000,1.3692
215.158.61.183,<->,8.176.8.109,0,0,4,2300,4,2300,0.038488000,1.9550
111.147.191.120,<->,54.43.0.78,4,1483,0,0,4,1483,0.038402000,0.4013
199.33.17.180,<->,136.25.188.252,0,0,4,300,4,300,0.038199000,0.0044
158.192.3.223,<->,133.178.226.90,0,0,4,2778,4,2778,0.037852000,1.9098
196.119.216.251,<->,50.223.3.228,0,0,4,200,4,200,0.037202000,0.6403
215.158.238.99,<->,122.159.70.92,4,224,0,0,4,224,0.037026000,0.0395
131.2.232.124,<->,80.42.141.34,0,0,4,632,4,632,0.036929000,0.9650
215.158.239.79,<->,195.83.24.157,4,1892,0,0,4,1892,0.036238000,1.1412
133.178.226.80,<->,8.252.210.162,4,2762,0,0,4,2762,0.035818000,0.9028
218.50.93.30,<->,39.15.235.33,0,0,4,200,4,200,0.035776000,0.4689
194.233.73.10,<->,136.25.188.225,0,0,4,248,4,248,0.034955000,0.3128
69.128.72.98,<->,54.92.5.14,4,1189,0,0,4,1189,0.034627000,1.9391
196.247.24.178,<->,136.25.188.46,0,0,4,224,4,224,0.034456000,0.0206
215.158.239.51,<->,199.20.31.54,4,224,0,0,4,224,0.034294000,1.0398
195.5.223.172,<->,136.25.188.241,0,0,4,800,4,800,0.034270000,0.3471
204.60.185.207,<->,136.25.188.163,0,0,4,200,4,200,0.034252000,0.0795
215.158.239.96,<->,196.91.187.15,4,296,0,0,4,296,0.033580000,0.4378
215.158.239.108,<->,133.232.6.65,4,522,0,0,4,522,0.033193000,1.8595
194.233.73.10,<->,136.25.188.239,0,0,4,236,4,236,0.033050000,0.2632
215.158.238.133,<->,57.31.51.198,4,224,0,0,4,224,0.032702000,0.0683
142.182.62.39,<->,136.25.188.175,0,0,4,200,4,200,0.032642000,0.0042
215.158.239.79,<->,199.20.30.190,4,1426,0,0,4,1426,0.032054000,1.2394
215.158.239.57,<->,196.92.183.50,4,224,0,0,4,224,0.031913000,1.4400
136.25.188.224,<->,113.23.104.247,4,1253,0,0,4,1253,0.031674000,0.9460
103.135.210.152,<->,35.56.100.188,0,0,4,200,4,200,0.031394000,1.5937
138.127.224.225,<->,33.233.141.35,0,0,4,950,4,950,0.031367000,0.0069
80.38.16.211,<->,79.136.250.50,4,616,0,0,4,616,0.030954000,0.8333
86.198.159.86,<->,0.195.210.24,0,0,4,549,4,549,0.030391000,0.4608
159.23.227.211,<->,97.80.39.125,4,200,0,0,4,200,0.029585000,1.6903
215.158.238.99,<->,0.34.21.19,4,1509,0,0,4,1509,0.029053000,0.2586
252.98.32.15,<->,212.249.34.44,4,339,0,0,4,339,0.028900000,0.0672
215.158.239.93,<->,199.20.31.252,4,224,0,0,4,224,0.028524000,0.0807
136.25.188.210,<->,111.151.239.73,4,2442,0,0,4,2442,0.028164000,0.1881
231.140.198.240,<->,136.25.188.252,0,0,4,792,4,792,0.027919000,0.1797
139.163.96.94,<->,18.51.205.32,4,200,0,0,4,200,0.027788000,1.9595
198.183.68.172,<->,92.27.219.230,0,0,4,296,4,296,0.027759000,1.9663
207.172.244.120,<->,136.25.188.54,0,0,4,272,4,272,0.027550000,1.3578
142.255.183.162,<->,136.25.188.239,0,0,4,212,4,212,0.026720000,1.2481
234.124.221.110,<->,97.198.98.32,0,0,4,340,4,340,0.026561000,0.1540
220.55.111.137,<->,129.254.96.5,4,732,0,0,4,732,0.025152000,0.0809
128.204.129.154,<->,50.224.76.230,0,0,4,271,4,271,0.024311000,0.1466
221.102.103.73,<->,194.245.224.227,4,653,0,0,4,653,0.024225000,1.0089
245.130.58.60,<->,192.229.210.156,0,0,4,212,4,212,0.023530000,0.0338
207.236.202.212,<->,136.25.188.224,0,0,4,206,4,206,0.023299000,0.3580
215.158.239.66,<->,80.57.141.226,4,2250,0,0,4,2250,0.022793000,0.0729
215.158.239.48,<->,196.89.62.65,4,326,0,0,4,326,0.020466000,0.2523
89.183.110.72,<->,0.70.165.207,4,1044,0,0,4,1044,0.019972000,0.1004
102.34.34.14,<->,98.67.158.12,0,0,4,546,4,546,0.019955000,0.1405
215.158.239.51,<->,199.20.28.169,4,200,0,0,4,200,0.019576000,0.0120
133.178.227.76,<->,133.56.180.5,4,1765,0,0,4,1765,0.019574000,0.4877
89.183.104.251,<->,33.57.78.97,4,200,0,0,4,200,0.019547000,0.3009
231.143.131.80,<->,136.25.188.160,0,0,4,408,4,408,0.019115000,1.9531
200.174.202.55,<->,53.149.154.111,4,782,0,0,4,782,0.019033000,1.5512
215.158.238.135,<->,120.154.221.218,4,224,0,0,4,224,0.018271000,0.0128
215.158.238.75,<->,126.219.190.159,4,224,0,0,4,224,0.018225000,0.0079
97.181.15.45,<->,8.220.202.31,0,0,4,634,4,634,0.017980000,0.0397
247.136.187.197,<->,193.94.10.184,4,2604,0,0,4,2604,0.017692000,0.7565
215.158.239.30,<->,8.222.97.61,4,1711,0,0,4,1711,0.017050000,1.2820
139.163.17.164,<->,82.225.113.208,4,200,0,0,4,200,0.016885000,1.5348
195.5.251.54,<->,136.25.188.255,0,0,4,1862,4,1862,0.016739000,1.6759
207.172.235.165,<->,136.25.188.176,0,0,4,224,4,224,0.016736000,0.1005
195.6.118.47,<->,136.25.188.174,0,0,4,224,4,224,0.016701000,0.0021
215.158.238.133,<->,120.155.14.70,4,1377,0,0,4,1377,0.016289000,0.7993
133.178.227.59,<->,133.56.180.11,4,2092,0,0,4,2092,0.016256000,1.9121
215.158.239.70,<->,199.20.30.193,4,224,0,0,4,224,0.016073000,0.0601
195.42.227.179,<->,136.25.188.44,0,0,4,224,4,224,0.015967000,0.0278
89.155.61.186,<->,80.38.51.106,0,0,4,830,4,830,0.015747000,0.2046
99.162.71.215,<->,53.161.125.14,4,416,0,0,4,416,0.015738000,1.0255
195.124.216.84,<->,136.25.188.173,0,0,4,448,4,448,0.015402000,1.5803
143.132.83.217,<->,136.25.188.254,0,0,4,224,4,224,0.015153000,0.0431
17.61.232.100,<->,8.220.233.99,0,0,4,320,4,320,0.014992000,0.2387
98.67.131.24,<->,53.189.131.169,4,466,0,0,4,466,0.014771000,0.5911
143.155.226.245,<->,133.178.226.28,0,0,4,224,4,224,0.014409000,0.0005
197.113.64.228,<->,136.25.188.163,0,0,4,370,4,370,0.014191000,0.8992
215.158.239.49,<->,195.71.123.210,4,792,0,0,4,792,0.014058000,0.9178
215.158.239.50,<->,196.90.113.35,4,256,0,0,4,256,0.013884000,1.3002
235.103.21.13,<->,8.182.244.179,0,0,4,200,4,200,0.013097000,0.0899
192.64.226.26,<->,139.241.56.117,4,4423,0,0,4,4423,0.013040000,0.4657
53.203.244.195,<->,48.52.203.74,0,0,4,260,4,260,0.012912000,0.0483
106.168.191.70,<->,80.42.185.5,0,0,4,790,4,790,0.012895000,1.6927
215.158.140.75,<->,8.190.217.21,4,224,0,0,4,224,0.012449000,0.0005
192.205.38.163,<->,133.32.39.0,0,0,4,415,4,415,0.012423000,0.0407
136.25.188.254,<->,111.151.239.44,4,1445,0,0,4,1445,0.012402000,0.0547
207.60.40.90,<->,136.25.188.209,0,0,4,886,4,886,0.012038000,0.5134
207.199.23.163,<->,92.27.234.141,0,0,4,200,4,200,0.011764000,1.5296
80.41.32.57,<->,38.28.41.166,4,208,0,0,4,208,0.011443000,1.8742
210.209.251.211,<->,80.41.38.205,0,0,4,592,4,592,0.011145000,0.1451
133.178.227.41,<->,120.20.132.11,4,1314,0,0,4,1314,0.010992000,0.4949
92.27.209.103,<->,50.63.20.4,4,320,0,0,4,320,0.010861000,1.5149
215.158.239.58,<->,196.93.184.165,4,1760,0,0,4,1760,0.010601000,0.4179
136.25.189.13,<->,29.214.73.158,4,1525,0,0,4,1525,0.010319000,0.3586
215.158.238.106,<->,6.73.247.65,4,1269,0,0,4,1269,0.010066000,0.5958
144.75.218.246,<->,99.168.7.150,4,576,0,0,4,576,0.009720000,1.8031
142.190.148.221,<->,136.25.188.178,0,0,4,212,4,212,0.009504000,1.0758
215.158.239.49,<->,113.23.66.221,4,1381,0,0,4,1381,0.009446000,0.6060
74.133.18.141,<->,8.52.134.84,0,0,4,200,4,200,0.009052000,0.2630
203.118.164.229,<->,136.25.188.253,0,0,4,200,4,200,0.008970000,0.3688
207.191.243.144,<->,136.25.188.196,0,0,4,320,4,320,0.008486000,0.4203
215.158.238.95,<->,122.159.31.168,4,224,0,0,4,224,0.008009000,0.0011
215.158.239.92,<->,143.89.71.213,4,320,0,0,4,320,0.008000000,0.4590
199.53.111.156,<->,136.25.188.163,0,0,4,269,4,269,0.007966000,0.0265
215.158.239.57,<->,159.23.130.170,4,2522,0,0,4,2522,0.007699000,0.3647
8.182.228.191,<->,6.242.27.151,4,542,0,0,4,542,0.007612000,0.0800
215.158.61.202,<->,8.176.8.194,0,0,4,2898,4,2898,0.007603000,1.4263
104.125.215.35,<->,80.42.175.248,0,0,4,208,4,208,0.007313000,1.1163
109.198.138.168,<->,0.195.210.46,0,0,4,224,4,224,0.007091000,0.0310
204.185.245.104,<->,136.25.188.220,0,0,4,885,4,885,0.007091000,0.2300
215.158.3.131,<->,133.178.227.244,0,0,4,261,4,261,0.006900000,0.0001
136.25.188.210,<->,113.23.104.220,4,1445,0,0,4,1445,0.006870000,0.1289
221.102.122.48,<->,139.254.211.64,4,249,0,0,4,249,0.006478000,0.2820
93.95.33.176,<->,50.224.76.234,0,0,4,3546,4,3546,0.006300000,0.4527
50.224.76.235,<->,50.183.208.169,4,666,0,0,4,666,0.005485000,0.0426
212.70.217.106,<->,136.25.189.77,0,0,4,1541,4,1541,0.004934000,1.4028
142.240.9.194,<->,136.25.188.199,0,0,4,591,4,591,0.004870000,0.4420
54.36.26.19,<->,48.55.77.23,0,0,4,1268,4,1268,0.004698000,1.9571
204.130.137.8,<->,0.195.210.46,0,0,4,273,4,273,0.004626000,0.3265
136.25.189.82,<->,116.106.46.108,4,2558,0,0,4,2558,0.004143000,0.6316
146.133.39.117,<->,8.252.222.174,0,0,4,762,4,762,0.004117000,0.3104
215.158.140.175,<->,8.222.7.168,4,2068,0,0,4,2068,0.003549000,1.9784
203.116.230.54,<->,136.25.188.174,0,0,4,427,4,427,0.003514000,0.0599
80.27.158.226,<->,72.151.67.10,4,1743,0,0,4,1743,0.003035000,0.3069
204.141.228.215,<->,8.252.222.44,0,0,4,967,4,967,0.002369000,0.2918
199.69.174.81,<->,136.25.188.52,0,0,4,200,4,200,0.002056000,0.2612
249.113.218.249,<->,97.126.26.166,0,0,4,316,4,316,0.002056000,0.1994
158.27.166.9,<->,80.41.50.144,0,0,4,268,4,268,0.001807000,1.8007
243.117.106.157,<->,80.38.36.175,0,0,4,1440,4,1440,0.001578000,0.1534
204.200.56.162,<->,136.25.188.53,0,0,4,260,4,260,0.001038000,0.0239
139.33.174.95,<->,97.126.14.75,0,0,4,747,4,747,0.001015000,0.0434
207.56.228.61,<->,136.25.188.252,0,0,4,540,4,540,0.000657000,1.8446
111.14.251.182,<->,8.182.244.237,0,0,4,200,4,200,0.000643000,0.0683
199.73.105.151,<->,136.25.188.198,0,0,4,320,4,320,0.000423000,0.5435
215.158.239.87,<->,195.70.29.10,4,224,0,0,4,224,0.000383000,0.0044
199.14.210.238,<->,136.25.188.198,0,0,3,150,3,150,1.996564000,0.0030
143.132.133.221,<->,136.25.188.45,0,0,3,244,3,244,1.995474000,0.0042
194.237.125.198,<->,136.25.188.238,0,0,3,150,3,150,1.993777000,0.0028
132.18.67.28,<->,101.124.232.114,0,0,3,168,3,168,1.989900000,0.0045
199.80.1.135,<->,136.25.188.237,0,0,3,168,3,168,1.989404000,0.0088
195.55.185.85,<->,136.25.188.197,0,0,3,168,3,168,1.979565000,0.0059
221.102.56.69,<->,213.38.166.21,0,0,3,192,3,192,1.974598000,0.0041
143.134.235.114,<->,136.25.188.163,0,0,3,150,3,150,1.970919000,0.0055
138.127.224.225,<->,33.233.141.115,0,0,3,725,3,725,1.970842000,0.0065
220.199.235.135,<->,136.25.188.254,0,0,3,697,3,697,1.968839000,0.0303
194.206.208.173,<->,8.182.251.151,0,0,3,150,3,150,1.966182000,0.0041
215.158.239.111,<->,111.151.109.37,3,168,0,0,3,168,1.966148000,0.0000
252.138.212.250,<->,136.25.188.161,0,0,3,326,3,326,1.960661000,0.0131
215.158.238.104,<->,145.14.166.92,3,199,0,0,3,199,1.959001000,0.0256
221.102.56.69,<->,109.2.27.172,0,0,3,414,3,414,1.956457000,0.0361
207.173.77.37,<->,136.25.188.237,0,0,3,168,3,168,1.952892000,0.0400
216.184.1.82,<->,136.25.188.170,0,0,3,324,3,324,1.952142000,0.0253
136.25.189.196,<->,129.222.36.38,3,1102,0,0,3,1102,1.949230000,0.0197
107.70.254.54,<->,8.183.25.25,0,0,3,402,3,402,1.947493000,0.0374
89.164.47.38,<->,8.52.187.74,0,0,3,403,3,403,1.945174000,0.0380
101.70.121.211,<->,53.197.213.66,3,2597,0,0,3,2597,1.944853000,0.0481
101.70.127.164,<->,53.209.35.194,3,888,0,0,3,888,1.938692000,0.0424
129.236.115.174,<->,111.20.168.123,0,0,3,1320,3,1320,1.937865000,0.0227
192.229.210.156,<->,133.172.83.44,3,667,0,0,3,667,1.937750000,0.0484
207.16.235.126,<->,0.195.210.33,0,0,3,150,3,150,1.935866000,0.0000
215.158.238.106,<->,111.150.186.224,3,168,0,0,3,168,1.935315000,0.0002
210.236.218.58,<->,50.224.108.146,0,0,3,447,3,447,1.934471000,0.0200
136.25.188.241,<->,99.93.189.162,3,168,0,0,3,168,1.933296000,0.0004
144.85.170.230,<->,91.231.218.55,3,204,0,0,3,204,1.933028000,0.0348
199.68.161.101,<->,136.25.188.198,0,0,3,150,3,150,1.931425000,0.0434
207.56.170.67,<->,136.25.188.225,0,0,3,150,3,150,1.928824000,0.0029
215.158.239.85,<->,207.188.252.26,3,2143,0,0,3,2143,1.927222000,0.0234
89.216.124.92,<->,8.235.216.152,3,503,0,0,3,503,1.925501000,0.0487
146.224.51.247,<->,8.252.222.186,0,0,3,168,3,168,1.923918000,0.0009
50.176.169.181,<->,8.52.182.119,0,0,3,541,3,541,1.922545000,0.0401
199.122.101.120,<->,136.25.188.241,0,0,3,150,3,150,1.917783000,0.0169
8.52.248.211,<->,6.111.222.227,3,357,0,0,3,357,1.917205000,0.0394
142.229.217.77,<->,136.25.188.55,0,0,3,168,3,168,1.912793000,0.0032
247.136.131.55,<->,132.18.67.28,3,444,0,0,3,444,1.912561000,0.0412
215.158.239.58,<->,199.20.28.161,3,168,0,0,3,168,1.909421000,0.0099
195.13.153.197,<->,136.25.188.242,0,0,3,244,3,244,1.903758000,0.0034
53.160.164.131,<->,48.53.114.198,0,0,3,205,3,205,1.903019000,0.0007
215.158.239.101,<->,129.222.39.148,3,877,0,0,3,877,1.902912000,0.0221
199.83.55.4,<->,136.25.188.209,0,0,3,244,3,244,1.901349000,0.0063
215.158.239.75,<->,98.219.126.175,3,337,0,0,3,337,1.901302000,0.0591
129.31.169.157,<->,8.182.226.78,0,0,3,628,3,628,1.900755000,0.0547
57.220.150.11,<->,8.53.4.76,0,0,3,693,3,693,1.900682000,0.0613
215.158.238.216,<->,215.158.132.240,3,238,0,0,3,238,1.897904000,0.0226
142.236.9.213,<->,136.25.188.238,0,0,3,168,3,168,1.896184000,0.0172
221.196.122.79,<->,138.98.250.43,0,0,3,349,3,349,1.896068000,0.0960
136.25.189.221,<->,100.224.163.115,3,2301,0,0,3,2301,1.893101000,0.0400
215.158.61.182,<->,8.176.8.99,0,0,3,4349,3,4349,1.892440000,0.0000
129.225.135.32,<->,129.225.132.73,0,0,3,150,3,150,1.891668000,0.0001
145.79.67.241,<->,8.220.178.246,0,0,3,168,3,168,1.889628000,0.0001
221.196.91.180,<->,144.85.170.244,0,0,3,822,3,822,1.888147000,0.0650
102.45.243.14,<->,80.38.13.15,0,0,3,316,3,316,1.887255000,0.0273
129.78.112.99,<->,111.2.156.140,3,665,0,0,3,665,1.886289000,0.0260
240.173.231.52,<->,8.220.200.160,0,0,3,551,3,551,1.885064000,0.1074
215.158.239.84,<->,196.95.104.104,3,228,0,0,3,228,1.884365000,0.0299
136.181.53.208,<->,0.195.216.193,3,382,0,0,3,382,1.884311000,0.0984
133.178.226.85,<->,111.151.109.23,3,168,0,0,3,168,1.884208000,0.0001
199.70.62.22,<->,136.25.188.225,0,0,3,150,3,150,1.884054000,0.0044
142.229.81.148,<->,136.25.188.163,0,0,3,168,3,168,1.881152000,0.0028
136.25.188.255,<->,92.48.92.132,3,378,0,0,3,378,1.880917000,0.0840
140.147.42.1,<->,8.252.222.28,0,0,3,156,3,156,1.876490000,0.0001
128.91.191.123,<->,80.40.13.234,0,0,3,824,3,824,1.873365000,0.0094
215.158.239.86,<->,143.132.101.154,3,244,0,0,3,244,1.873343000,0.0036
215.158.209.250,<->,80.27.152.239,0,0,3,176,3,176,1.872445000,0.0857
215.158.239.76,<->,143.13.234.114,3,150,0,0,3,150,1.870571000,0.0029
133.178.227.251,<->,111.150.185.73,3,4365,0,0,3,4365,1.870300000,0.0000
195.54.85.50,<->,136.25.188.209,0,0,3,150,3,150,1.869710000,0.0030
136.25.188.220,<->,111.30.166.181,3,562,0,0,3,562,1.869622000,0.0723
247.118.183.57,<->,8.183.25.25,0,0,3,438,3,438,1.868299000,0.0941
136.98.166.244,<->,8.220.177.81,0,0,3,548,3,548,1.867925000,0.0473
199.69.152.14,<->,136.25.188.222,0,0,3,1845,3,1845,1.867494000,0.0044
215.158.133.207,<->,6.73.247.33,0,0,3,2253,3,2253,1.867453000,0.0038
159.65.139.148,<->,136.25.188.224,0,0,3,726,3,726,1.866555000,0.0842
145.242.126.105,<->,98.197.185.18,3,315,0,0,3,315,1.863826000,0.1312
92.27.218.64,<->,89.153.97.181,3,181,0,0,3,181,1.863193000,0.1256
133.178.227.222,<->,111.150.185.46,3,428,0,0,3,428,1.861924000,0.0000
232.31.71.89,<->,144.71.44.216,0,0,3,204,3,204,1.858505000,0.1068
142.195.143.226,<->,136.25.188.225,0,0,3,168,3,168,1.858216000,0.0001
133.178.227.27,<->,130.165.253.26,3,1143,0,0,3,1143,1.858090000,0.1095
215.158.239.84,<->,195.49.251.245,3,244,0,0,3,244,1.855488000,0.0198
133.178.226.224,<->,106.155.165.107,3,336,0,0,3,336,1.854902000,0.1159
56.121.39.173,<->,8.222.6.88,3,1237,0,0,3,1237,1.853859000,0.0514
136.25.188.45,<->,91.57.173.52,3,1341,0,0,3,1341,1.853415000,0.1183
199.80.179.98,<->,136.25.188.46,0,0,3,150,3,150,1.853055000,0.0032
239.227.119.111,<->,221.102.143.189,3,253,0,0,3,253,1.851042000,0.0791
137.45.27.47,<->,92.162.253.77,0,0,3,494,3,494,1.850864000,0.0252
215.158.238.82,<->,100.224.138.232,3,1740,0,0,3,1740,1.850515000,0.1373
204.56.249.12,<->,136.25.188.241,0,0,3,168,3,168,1.850077000,0.0044
215.158.140.93,<->,29.214.211.31,3,1193,0,0,3,1193,1.848107000,0.1315
159.137.162.213,<->,122.219.189.1,3,438,0,0,3,438,1.846718000,0.1290
197.161.241.25,<->,136.25.188.225,0,0,3,376,3,376,1.846328000,0.1310
215.158.239.87,<->,29.209.59.166,3,1210,0,0,3,1210,1.845851000,0.1193
136.25.189.221,<->,100.224.163.114,3,2797,0,0,3,2797,1.844391000,0.0100
221.102.143.189,<->,80.40.42.241,0,0,3,253,3,253,1.842785000,0.0717
199.81.208.250,<->,136.25.188.239,0,0,3,693,3,693,1.841701000,0.1522
207.188.238.153,<->,136.25.188.225,0,0,3,726,3,726,1.841701000,0.1177
215.158.140.27,<->,98.228.163.96,3,176,0,0,3,176,1.840734000,0.0198
58.202.35.36,<->,8.252.222.49,0,0,3,370,3,370,1.838632000,0.1417
109.222.245.43,<->,101.64.188.49,3,1305,0,0,3,1305,1.837270000,0.0503
136.25.189.0,<->,96.156.169.222,3,1549,0,0,3,1549,1.837017000,0.1069
220.55.91.54,<->,92.162.221.229,3,762,0,0,3,762,1.836809000,0.1344
159.137.162.213,<->,93.210.14.5,3,434,0,0,3,434,1.836684000,0.1025
204.200.45.245,<->,136.25.188.196,0,0,3,199,3,199,1.836251000,0.1235
199.73.188.22,<->,136.25.188.255,0,0,3,722,3,722,1.836080000,0.1592
199.122.11.131,<->,136.25.188.243,0,0,3,1516,3,1516,1.835557000,0.0174
207.236.226.10,<->,136.25.188.222,0,0,3,168,3,168,1.835178000,0.1624
144.83.60.153,<->,92.162.253.38,0,0,3,150,3,150,1.833773000,0.0905
136.129.94.157,<->,6.145.167.112,3,541,0,0,3,541,1.833624000,0.1370
215.158.239.42,<->,80.47.228.231,3,1609,0,0,3,1609,1.830297000,0.0357
212.164.132.228,<->,133.30.255.42,3,2232,0,0,3,2232,1.829408000,0.0000
204.21.153.161,<->,136.25.188.179,0,0,3,150,3,150,1.829133000,0.0053
121.209.172.180,<->,50.224.76.234,0,0,3,618,3,618,1.827693000,0.1374
215.158.239.87,<->,159.23.130.181,3,1325,0,0,3,1325,1.826239000,0.0461
133.244.31.123,<->,80.27.154.175,3,327,0,0,3,327,1.825271000,0.1543
215.158.239.38,<->,215.158.127.173,3,3063,0,0,3,3063,1.825228000,0.0186
111.151.142.181,<->,99.74.26.166,0,0,3,168,3,168,1.824881000,0.0002
53.91.151.204,<->,8.252.221.223,0,0,3,536,3,536,1.824373000,0.1483
129.209.93.208,<->,8.183.25.25,0,0,3,402,3,402,1.823881000,0.0580
215.158.239.87,<->,128.23.84.21,3,1325,0,0,3,1325,1.822952000,0.1212
246.253.146.35,<->,204.41.40.158,3,267,0,0,3,267,1.822289000,0.1603
215.158.239.105,<->,215.158.61.191,3,769,0,0,3,769,1.820628000,0.0392
232.31.30.124,<->,220.55.124.203,0,0,3,342,3,342,1.820126000,0.1127
131.99.233.50,<->,50.224.76.235,0,0,3,1334,3,1334,1.819652000,0.0938
215.158.239.51,<->,194.234.174.83,3,409,0,0,3,409,1.818574000,0.1807
136.105.124.7,<->,6.75.134.121,0,0,3,2038,3,2038,1.818056000,0.0507
199.121.174.137,<->,136.25.188.241,0,0,3,722,3,722,1.817119000,0.1726
139.193.141.139,<->,131.24.162.38,3,2327,0,0,3,2327,1.815725000,0.1625
196.112.237.105,<->,50.224.76.230,0,0,3,1165,3,1165,1.815252000,0.1365
215.158.239.49,<->,142.190.246.182,3,150,0,0,3,150,1.815231000,0.0130
215.158.239.92,<->,207.16.14.38,3,168,0,0,3,168,1.815196000,0.0000
220.20.200.39,<->,144.83.60.153,3,1772,0,0,3,1772,1.813528000,0.0959
215.158.239.79,<->,207.236.255.28,3,360,0,0,3,360,1.813443000,0.1637
232.31.121.5,<->,139.193.141.194,0,0,3,483,3,483,1.813219000,0.1117
127.255.84.41,<->,92.162.253.89,0,0,3,679,3,679,1.812617000,0.1161
215.158.239.49,<->,207.239.77.231,3,722,0,0,3,722,1.812595000,0.1871
215.158.238.74,<->,91.57.162.185,3,1453,0,0,3,1453,1.812167000,0.1235
197.104.60.82,<->,129.26.244.195,0,0,3,274,3,274,1.812154000,0.1362
127.205.189.77,<->,80.42.176.32,0,0,3,184,3,184,1.810856000,0.0955
136.25.189.52,<->,98.219.126.175,3,2978,0,0,3,2978,1.810506000,0.0000
136.25.189.59,<->,96.156.169.212,3,2914,0,0,3,2914,1.810244000,0.1848
215.158.239.56,<->,199.20.29.65,3,150,0,0,3,150,1.808141000,0.1488
207.1.41.245,<->,50.224.76.235,0,0,3,683,3,683,1.807054000,0.1541
131.82.78.204,<->,50.224.76.230,0,0,3,1226,3,1226,1.805695000,0.1334
215.158.238.123,<->,148.72.94.167,3,396,0,0,3,396,1.803914000,0.1590
215.158.239.48,<->,199.15.223.216,3,722,0,0,3,722,1.802407000,0.1814
48.17.42.158,<->,8.252.221.205,0,0,3,561,3,561,1.802366000,0.1846
111.199.237.242,<->,0.195.210.44,0,0,3,402,3,402,1.801280000,0.1238
215.158.239.7,<->,33.209.218.97,3,1505,0,0,3,1505,1.800030000,0.1190
215.158.238.45,<->,205.122.195.39,3,1181,0,0,3,1181,1.799831000,0.1340
202.178.8.69,<->,98.190.109.178,0,0,3,284,3,284,1.799442000,0.1962
133.178.227.207,<->,69.31.239.60,3,428,0,0,3,428,1.799003000,0.0000
215.158.239.99,<->,199.20.30.194,3,150,0,0,3,150,1.798671000,0.1452
195.88.178.47,<->,8.182.226.78,0,0,3,156,3,156,1.798454000,0.1710
215.158.238.209,<->,120.154.179.64,3,1485,0,0,3,1485,1.798027000,0.1246
144.70.14.36,<->,82.239.221.53,3,698,0,0,3,698,1.795519000,0.1586
215.158.239.48,<->,142.241.156.45,3,150,0,0,3,150,1.793118000,0.0061
204.200.43.102,<->,136.25.188.209,0,0,3,376,3,376,1.793108000,0.1282
215.158.238.95,<->,193.39.70.28,3,1309,0,0,3,1309,1.792579000,0.1710
145.208.160.99,<->,50.145.93.227,3,900,0,0,3,900,1.792288000,0.0928
215.158.239.56,<->,196.93.220.8,3,352,0,0,3,352,1.791527000,0.0002
215.158.239.48,<->,195.126.45.4,3,722,0,0,3,722,1.791113000,0.1787
215.158.239.181,<->,113.23.46.151,3,404,0,0,3,404,1.790637000,0.1250
195.15.241.133,<->,136.25.188.253,0,0,3,722,3,722,1.790270000,0.1790
215.158.238.106,<->,29.211.186.213,3,1453,0,0,3,1453,1.789944000,0.1786
215.158.238.149,<->,106.188.183.74,3,1806,0,0,3,1806,1.789582000,0.1223
195.14.129.170,<->,136.25.188.55,0,0,3,667,3,667,1.787958000,0.1800
215.158.239.85,<->,207.236.255.28,3,360,0,0,3,360,1.786934000,0.2004
215.158.238.32,<->,96.135.154.197,3,1149,0,0,3,1149,1.786574000,0.0355
126.16.39.86,<->,50.224.76.234,0,0,3,938,3,938,1.786538000,0.1435
136.138.112.208,<->,136.25.188.176,0,0,3,1453,3,1453,1.785777000,0.0682
207.162.161.250,<->,8.182.227.180,0,0,3,352,3,352,1.785409000,0.1701
136.25.189.14,<->,57.31.51.169,3,1421,0,0,3,1421,1.785396000,0.1408
144.85.170.254,<->,98.87.145.175,3,792,0,0,3,792,1.785011000,0.1541
215.158.239.99,<->,199.20.4.130,3,1872,0,0,3,1872,1.783030000,0.0501
250.50.79.124,<->,80.38.11.227,0,0,3,489,3,489,1.782339000,0.1248
140.71.205.43,<->,8.252.221.206,0,0,3,425,3,425,1.782276000,0.1797
199.15.37.255,<->,136.25.188.238,0,0,3,667,3,667,1.782107000,0.1981
215.158.239.85,<->,199.20.29.216,3,1862,0,0,3,1862,1.781614000,0.0199
132.128.61.174,<->,97.126.39.212,0,0,3,626,3,626,1.781493000,0.0050
224.54.170.218,<->,215.158.239.70,0,0,3,1469,3,1469,1.780957000,0.1168
100.200.205.94,<->,8.182.139.197,0,0,3,667,3,667,1.780259000,0.1385
48.19.62.158,<->,8.252.222.49,0,0,3,360,3,360,1.779942000,0.2064
215.158.239.79,<->,196.106.76.163,3,1821,0,0,3,1821,1.779851000,0.0097
145.242.124.39,<->,99.72.60.194,0,0,3,197,3,197,1.779664000,0.0967
215.158.239.48,<->,195.49.132.160,3,722,0,0,3,722,1.779357000,0.1986
84.203.220.187,<->,8.252.222.220,0,0,3,1389,3,1389,1.778051000,0.1845
215.158.238.45,<->,149.96.50.215,3,1549,0,0,3,1549,1.777821000,0.1065
204.200.169.232,<->,136.25.188.46,0,0,3,730,3,730,1.776941000,0.1868
204.21.74.184,<->,136.25.188.55,0,0,3,366,3,366,1.776345000,0.1801
142.248.24.177,<->,136.25.188.46,0,0,3,667,3,667,1.776319000,0.1920
143.43.30.232,<->,136.25.188.174,0,0,3,693,3,693,1.775877000,0.2221
200.174.214.170,<->,53.200.90.174,3,1615,0,0,3,1615,1.775136000,0.1951
215.158.239.56,<->,195.127.172.174,3,722,0,0,3,722,1.774491000,0.1759
142.166.41.118,<->,136.25.188.209,0,0,3,168,3,168,1.774213000,0.0047
136.25.189.59,<->,96.156.169.221,3,1492,0,0,3,1492,1.773863000,0.1525
215.158.140.76,<->,192.204.170.251,3,1242,0,0,3,1242,1.772588000,0.2273
198.73.22.146,<->,0.195.210.42,0,0,3,656,3,656,1.772546000,0.1302
142.182.67.40,<->,136.25.188.176,0,0,3,360,3,360,1.772370000,0.1663
222.35.163.82,<->,50.224.61.152,0,0,3,418,3,418,1.771061000,0.0820
215.158.239.95,<->,195.127.172.174,3,722,0,0,3,722,1.769577000,0.1663
195.14.247.117,<->,136.25.188.242,0,0,3,168,3,168,1.769545000,0.0030
215.158.239.68,<->,143.89.180.228,3,722,0,0,3,722,1.768836000,0.1760
215.158.61.254,<->,99.74.27.175,0,0,3,2982,3,2982,1.768704000,0.0633
129.26.254.44,<->,98.117.53.73,3,1807,0,0,3,1807,1.768397000,0.0382
207.173.38.16,<->,136.25.188.196,0,0,3,714,3,714,1.768179000,0.0015
54.37.229.45,<->,48.55.80.159,0,0,3,290,3,290,1.768057000,0.0752
199.55.201.201,<->,8.182.250.65,0,0,3,156,3,156,1.767374000,0.1537
159.135.34.71,<->,8.52.183.207,0,0,3,150,3,150,1.766197000,0.1922
195.42.82.107,<->,8.52.244.92,0,0,3,624,3,624,1.765860000,0.2271
145.252.123.37,<->,117.36.215.101,3,885,0,0,3,885,1.765705000,0.1123
199.68.95.113,<->,8.52.128.66,0,0,3,383,3,383,1.764339000,0.2030
215.158.140.185,<->,8.222.7.154,3,1799,0,0,3,1799,1.764236000,0.1370
145.252.127.99,<->,53.249.52.18,3,388,0,0,3,388,1.764137000,0.1534
199.39.134.36,<->,136.25.188.53,0,0,3,168,3,168,1.763901000,0.0032
133.178.227.2,<->,80.57.141.96,3,1503,0,0,3,1503,1.763506000,0.0330
215.158.239.95,<->,199.73.40.248,3,375,0,0,3,375,1.763206000,0.1804
215.158.239.76,<->,199.20.29.99,3,168,0,0,3,168,1.762369000,0.2201
221.101.8.215,<->,194.253.80.233,3,909,0,0,3,909,1.762362000,0.1643
65.26.112.170,<->,8.252.221.230,0,0,3,532,3,532,1.761783000,0.2022
136.25.188.226,<->,80.47.111.6,3,168,0,0,3,168,1.761161000,0.0001
159.137.162.213,<->,105.108.103.246,3,438,0,0,3,438,1.760930000,0.1174
215.158.61.183,<->,8.176.8.93,0,0,3,217,3,217,1.760775000,0.0192
192.65.88.12,<->,132.18.67.30,3,444,0,0,3,444,1.760711000,0.0419
129.209.93.101,<->,8.182.226.78,0,0,3,668,3,668,1.760664000,0.0653
89.204.73.239,<->,8.182.226.78,0,0,3,387,3,387,1.759304000,0.2220
199.121.229.160,<->,136.25.188.209,0,0,3,150,3,150,1.759128000,0.1568
205.121.147.33,<->,98.67.140.57,0,0,3,367,3,367,1.758133000,0.1302
215.158.239.48,<->,142.244.61.220,3,156,0,0,3,156,1.757115000,0.1831
83.199.244.81,<->,50.224.80.64,0,0,3,1509,3,1509,1.756931000,0.1653
48.16.238.48,<->,8.252.221.236,0,0,3,533,3,533,1.756859000,0.1453
215.158.239.56,<->,194.199.202.252,3,667,0,0,3,667,1.756537000,0.1563
215.158.239.87,<->,199.20.7.89,3,630,0,0,3,630,1.755652000,0.1406
215.158.239.32,<->,126.219.142.47,3,1598,0,0,3,1598,1.754020000,0.1143
139.193.141.139,<->,122.12.195.62,3,1949,0,0,3,1949,1.753495000,0.1962
215.158.239.93,<->,199.20.109.177,3,722,0,0,3,722,1.753361000,0.1631
143.44.245.255,<->,136.25.188.224,0,0,3,392,3,392,1.751079000,0.1932
136.25.189.46,<->,133.146.0.138,3,1277,0,0,3,1277,1.750954000,0.2073
199.66.234.74,<->,136.25.188.52,0,0,3,722,3,722,1.750650000,0.1670
89.90.104.87,<->,6.122.148.113,0,0,3,506,3,506,1.749611000,0.0448
215.158.239.95,<->,196.108.116.224,3,360,0,0,3,360,1.749570000,0.1903
215.158.239.57,<->,142.247.235.45,3,722,0,0,3,722,1.749461000,0.2437
138.98.152.67,<->,57.125.232.216,3,305,0,0,3,305,1.748939000,0.1593
136.25.188.255,<->,57.210.107.8,3,1373,0,0,3,1373,1.748435000,0.1164
42.90.159.228,<->,0.195.210.42,0,0,3,667,3,667,1.746978000,0.1511
199.50.72.71,<->,136.25.188.196,0,0,3,360,3,360,1.746199000,0.2017
142.167.37.185,<->,136.25.188.175,0,0,3,722,3,722,1.745959000,0.2340
139.163.10.228,<->,27.11.102.242,3,366,0,0,3,366,1.743940000,0.1236
117.29.74.77,<->,50.224.89.243,0,0,3,168,3,168,1.743731000,0.0000
215.158.238.241,<->,123.166.46.199,3,1171,0,0,3,1171,1.743678000,0.1520
215.158.239.56,<->,194.237.31.83,3,360,0,0,3,360,1.742363000,0.1848
146.249.226.252,<->,8.252.222.61,0,0,3,168,3,168,1.742154000,0.0199
89.86.110.11,<->,8.252.222.226,0,0,3,1293,3,1293,1.740614000,0.0928
207.59.202.58,<->,136.25.188.220,0,0,3,2147,3,2147,1.739982000,0.0488
215.158.238.14,<->,122.158.239.127,3,429,0,0,3,429,1.739224000,0.0003
58.169.46.42,<->,0.195.210.42,0,0,3,370,3,370,1.739019000,0.2105
142.253.110.56,<->,136.25.188.237,0,0,3,360,3,360,1.738334000,0.1856
241.120.29.225,<->,215.158.239.78,0,0,3,1421,3,1421,1.738016000,0.0562
246.253.253.99,<->,206.243.231.162,3,2583,0,0,3,2583,1.737873000,0.0659
119.54.237.6,<->,0.195.210.42,0,0,3,667,3,667,1.736803000,0.1480
215.158.140.172,<->,135.243.190.253,3,150,0,0,3,150,1.736484000,0.0002
199.69.119.10,<->,136.25.188.255,0,0,3,667,3,667,1.735947000,0.2106
142.255.150.216,<->,136.25.188.225,0,0,3,722,3,722,1.735888000,0.2057
136.25.189.80,<->,29.123.209.236,3,1469,0,0,3,1469,1.735316000,0.2445
215.158.238.82,<->,8.42.43.73,3,1469,0,0,3,1469,1.734622000,0.2057
195.124.109.223,<->,136.25.188.177,0,0,3,693,3,693,1.734500000,0.2006
133.178.226.18,<->,57.210.107.41,3,1437,0,0,3,1437,1.734463000,0.2208
204.187.88.239,<->,136.25.188.162,0,0,3,722,3,722,1.733767000,0.1910
215.158.238.209,<->,38.51.98.229,3,1325,0,0,3,1325,1.733759000,0.1559
201.211.113.187,<->,136.25.189.83,0,0,3,364,3,364,1.733655000,0.2240
143.22.109.161,<->,8.183.25.25,0,0,3,399,3,399,1.733607000,0.1939
204.3.63.170,<->,136.25.188.236,0,0,3,883,3,883,1.733063000,0.0092
120.83.61.21,<->,89.183.104.157,0,0,3,156,3,156,1.732100000,0.1462
196.201.77.4,<->,8.252.222.38,0,0,3,667,3,667,1.730691000,0.1634
204.184.234.221,<->,136.25.188.177,0,0,3,162,3,162,1.730134000,0.0084
136.25.188.37,<->,111.151.107.247,3,462,0,0,3,462,1.730031000,0.0215
199.80.187.109,<->,136.25.188.173,0,0,3,722,3,722,1.729235000,0.2510
133.85.181.248,<->,100.92.37.100,0,0,3,524,3,524,1.729061000,0.0444
156.165.37.75,<->,136.25.189.29,0,0,3,1709,3,1709,1.728863000,0.2608
215.158.140.184,<->,6.72.10.83,3,150,0,0,3,150,1.728522000,0.0381
196.89.101.189,<->,136.25.188.220,0,0,3,168,3,168,1.728386000,0.0035
195.54.136.191,<->,136.25.188.211,0,0,3,722,3,722,1.727525000,0.1959
215.158.239.48,<->,199.69.119.113,3,360,0,0,3,360,1.727079000,0.1985
207.236.183.94,<->,136.25.188.177,0,0,3,193,3,193,1.725826000,0.1904
215.158.238.133,<->,111.158.193.220,3,1197,0,0,3,1197,1.725637000,0.0251
225.120.222.187,<->,133.178.226.60,0,0,3,1341,3,1341,1.725539000,0.1837
215.158.239.79,<->,199.32.150.17,3,693,0,0,3,693,1.725114000,0.2106
215.158.140.178,<->,83.243.33.162,3,1993,0,0,3,1993,1.724537000,0.0480
220.38.84.244,<->,136.25.189.57,0,0,3,1325,3,1325,1.724076000,0.2075
136.25.188.41,<->,53.159.128.145,3,221,0,0,3,221,1.723634000,0.0001
207.61.156.170,<->,136.25.188.220,0,0,3,667,3,667,1.723046000,0.2430
215.158.238.95,<->,149.33.107.2,3,1181,0,0,3,1181,1.721704000,0.1629
204.167.236.244,<->,39.248.89.87,0,0,3,807,3,807,1.719862000,0.2601
231.140.157.15,<->,136.25.188.226,0,0,3,212,3,212,1.718461000,0.0156
199.54.0.147,<->,8.182.243.35,0,0,3,667,3,667,1.718336000,0.1600
215.158.239.85,<->,196.108.54.10,3,392,0,0,3,392,1.717379000,0.2305
136.106.165.124,<->,0.195.210.42,0,0,3,150,3,150,1.716689000,0.0225
111.150.207.235,<->,8.252.223.83,0,0,3,168,3,168,1.716666000,0.0000
136.25.188.174,<->,8.240.118.201,3,1309,0,0,3,1309,1.714581000,0.2573
204.114.26.24,<->,92.27.194.147,0,0,3,369,3,369,1.713432000,0.1705
215.158.239.94,<->,207.228.243.25,3,726,0,0,3,726,1.712365000,0.2085
221.102.113.114,<->,207.92.143.171,3,281,0,0,3,281,1.712054000,0.2309
199.38.79.191,<->,136.25.188.227,0,0,3,168,3,168,1.711685000,0.0260
215.158.239.97,<->,199.39.181.253,3,150,0,0,3,150,1.710341000,0.0026
133.178.226.61,<->,8.252.253.196,3,1197,0,0,3,1197,1.709025000,0.1401
207.206.62.204,<->,50.223.3.228,0,0,3,360,3,360,1.708800000,0.1674
215.158.140.184,<->,8.222.7.182,3,2062,0,0,3,2062,1.708549000,0.2913
113.16.253.190,<->,50.224.76.235,0,0,3,1527,3,1527,1.708546000,0.1969
207.61.69.66,<->,136.25.188.255,0,0,3,667,3,667,1.708228000,0.2411
215.158.239.68,<->,199.20.30.144,3,150,0,0,3,150,1.708142000,0.0596
215.158.239.41,<->,33.209.213.8,3,1531,0,0,3,1531,1.707663000,0.1140
204.58.62.61,<->,136.25.188.241,0,0,3,150,3,150,1.706078000,0.0035
215.158.239.87,<->,199.20.28.138,3,340,0,0,3,340,1.705292000,0.2705
204.185.219.110,<->,136.25.188.243,0,0,3,402,3,402,1.705006000,0.1598
136.25.188.175,<->,76.138.212.213,3,722,0,0,3,722,1.704071000,0.2765
133.178.226.31,<->,8.255.92.203,3,2594,0,0,3,2594,1.704059000,0.2766
142.241.218.213,<->,136.25.188.225,0,0,3,752,3,752,1.702679000,0.2864
43.55.236.104,<->,8.252.221.223,0,0,3,553,3,553,1.702387000,0.1620
192.64.217.166,<->,125.60.240.2,3,218,0,0,3,218,1.702368000,0.1436
146.223.137.30,<->,8.252.222.50,0,0,3,401,3,401,1.701941000,0.2802
207.61.74.4,<->,136.25.188.226,0,0,3,366,3,366,1.701854000,0.1979
86.135.191.79,<->,8.252.222.140,0,0,3,370,3,370,1.700899000,0.2679
207.172.112.26,<->,136.25.188.252,0,0,3,722,3,722,1.700797000,0.2700
105.201.16.44,<->,100.95.233.66,0,0,3,517,3,517,1.700760000,0.2156
231.140.87.155,<->,215.158.239.49,0,0,3,371,3,371,1.700637000,0.1979
8.52.181.95,<->,8.3.252.200,3,488,0,0,3,488,1.700165000,0.0402
157.134.14.26,<->,50.224.76.235,0,0,3,1411,3,1411,1.699857000,0.2144
207.61.69.66,<->,136.25.188.175,0,0,3,667,3,667,1.699747000,0.2444
215.158.239.96,<->,207.166.184.89,3,360,0,0,3,360,1.697388000,0.2108
137.101.225.248,<->,100.228.42.77,0,0,3,1950,3,1950,1.697248000,0.0002
215.158.238.82,<->,192.204.170.196,3,1293,0,0,3,1293,1.696240000,0.2252
199.38.204.210,<->,136.25.188.196,0,0,3,667,3,667,1.696022000,0.2356
215.158.28.174,<->,98.173.205.232,3,164,0,0,3,164,1.695181000,0.0205
215.158.239.77,<->,194.234.178.23,3,722,0,0,3,722,1.694034000,0.1653
54.58.25.251,<->,48.53.192.41,0,0,3,506,3,506,1.691855000,0.2982
213.38.197.82,<->,8.55.224.156,3,253,0,0,3,253,1.690810000,0.0832
204.185.198.81,<->,136.25.188.222,0,0,3,722,3,722,1.689716000,0.1900
207.207.19.108,<->,8.20.87.153,0,0,3,1111,3,1111,1.689205000,0.1652
215.158.238.116,<->,96.135.154.29,3,4493,0,0,3,4493,1.688865000,0.0000
215.158.239.50,<->,196.107.8.38,3,192,0,0,3,192,1.688198000,0.2703
215.158.239.180,<->,8.191.15.132,3,205,0,0,3,205,1.687533000,0.0026
132.200.51.118,<->,129.224.112.220,0,0,3,219,3,219,1.686365000,0.1692
199.70.65.46,<->,136.25.188.255,0,0,3,722,3,722,1.686279000,0.2072
142.207.84.202,<->,136.25.188.176,0,0,3,722,3,722,1.685484000,0.1530
136.25.189.30,<->,96.156.169.49,3,2738,0,0,3,2738,1.685227000,0.2547
215.158.239.84,<->,199.20.5.29,3,168,0,0,3,168,1.684323000,0.0000
215.158.140.75,<->,29.211.165.23,3,1148,0,0,3,1148,1.684228000,0.2529
207.51.228.37,<->,136.25.188.53,0,0,3,392,3,392,1.683214000,0.2569
215.158.239.94,<->,194.232.113.64,3,722,0,0,3,722,1.683153000,0.2127
207.188.63.122,<->,136.25.188.222,0,0,3,877,3,877,1.683000000,0.3168
194.253.81.104,<->,8.252.222.237,0,0,3,370,3,370,1.682951000,0.1881
194.234.227.156,<->,136.25.188.55,0,0,3,722,3,722,1.682857000,0.2260
204.200.34.121,<->,8.252.222.210,0,0,3,661,3,661,1.681267000,0.1456
195.68.182.218,<->,136.25.188.55,0,0,3,722,3,722,1.679451000,0.3201
204.200.60.174,<->,136.25.188.253,0,0,3,693,3,693,1.677776000,0.2765
194.254.119.10,<->,8.20.87.206,0,0,3,914,3,914,1.677298000,0.2165
215.158.239.79,<->,199.82.187.144,3,722,0,0,3,722,1.677228000,0.2344
133.178.227.234,<->,111.151.106.201,3,168,0,0,3,168,1.677160000,0.0001
215.158.239.69,<->,199.20.31.73,3,244,0,0,3,244,1.677011000,0.0066
215.158.239.51,<->,199.20.29.166,3,168,0,0,3,168,1.676897000,0.1184
215.158.58.238,<->,6.73.247.91,0,0,3,1648,3,1648,1.674986000,0.2477
246.44.58.251,<->,111.150.186.0,3,176,0,0,3,176,1.674380000,0.1760
106.23.143.139,<->,8.52.245.115,0,0,3,440,3,440,1.674307000,0.2138
215.158.239.76,<->,204.1.227.143,3,214,0,0,3,214,1.674240000,0.0034
43.52.23.227,<->,8.252.221.221,0,0,3,1393,3,1393,1.673802000,0.1688
241.75.192.120,<->,221.102.116.168,0,0,3,150,3,150,1.671763000,0.0489
215.158.239.48,<->,199.32.131.218,3,376,0,0,3,376,1.671022000,0.1737
215.158.239.50,<->,196.89.56.25,3,722,0,0,3,722,1.670570000,0.2209
133.178.227.135,<->,8.35.106.212,3,1597,0,0,3,1597,1.669859000,0.0428
195.7.202.189,<->,136.25.188.222,0,0,3,667,3,667,1.669687000,0.2238
204.61.10.56,<->,136.25.188.222,0,0,3,168,3,168,1.669054000,0.0371
215.158.239.40,<->,80.47.111.160,3,1332,0,0,3,1332,1.668610000,0.0680
220.50.242.215,<->,133.32.39.1,0,0,3,268,3,268,1.668393000,0.0476
143.129.165.28,<->,136.25.188.178,0,0,3,360,3,360,1.667932000,0.1794
206.241.10.193,<->,99.167.142.84,0,0,3,365,3,365,1.667703000,0.1055
143.95.23.194,<->,136.25.188.198,0,0,3,150,3,150,1.667240000,0.0004
194.232.105.125,<->,136.25.188.243,0,0,3,360,3,360,1.665705000,0.3154
136.25.188.252,<->,8.179.43.168,3,1405,0,0,3,1405,1.664295000,0.3105
215.158.238.66,<->,133.101.64.107,3,1309,0,0,3,1309,1.663771000,0.0370
195.127.104.56,<->,136.25.188.236,0,0,3,689,3,689,1.660344000,0.2078
195.41.158.126,<->,136.25.188.52,0,0,3,562,3,562,1.660016000,0.2323
197.112.162.151,<->,0.195.210.46,0,0,3,340,3,340,1.658821000,0.2722
215.158.239.48,<->,207.167.84.239,3,156,0,0,3,156,1.658686000,0.0520
200.174.161.100,<->,54.58.233.225,3,329,0,0,3,329,1.658606000,0.2868
101.126.177.88,<->,89.90.104.87,3,506,0,0,3,506,1.657755000,0.0547
215.158.239.33,<->,139.7.138.55,3,1061,0,0,3,1061,1.657166000,0.0648
8.228.216.50,<->,0.195.216.193,3,1020,0,0,3,1020,1.657082000,0.2384
215.158.239.58,<->,195.80.76.92,3,722,0,0,3,722,1.656655000,0.2610
136.25.189.33,<->,131.144.113.7,3,1501,0,0,3,1501,1.656435000,0.2239
99.74.87.242,<->,80.56.83.69,3,168,0,0,3,168,1.656220000,0.0001
215.158.239.94,<->,196.107.168.17,3,722,0,0,3,722,1.656184000,0.3304
93.212.228.200,<->,8.31.37.175,0,0,3,388,3,388,1.656095000,0.1936
207.61.159.55,<->,136.25.188.198,0,0,3,437,3,437,1.655027000,0.3439
215.158.239.50,<->,143.94.164.5,3,722,0,0,3,722,1.653572000,0.3122
215.158.58.220,<->,99.74.27.37,0,0,3,2080,3,2080,1.653460000,0.2016
215.158.239.76,<->,207.57.53.94,3,722,0,0,3,722,1.652950000,0.2567
198.151.9.125,<->,111.147.93.202,0,0,3,290,3,290,1.652904000,0.1779
199.39.232.84,<->,136.25.188.227,0,0,3,376,3,376,1.650712000,0.2743
142.248.178.25,<->,136.25.188.242,0,0,3,667,3,667,1.650554000,0.2036
109.214.180.166,<->,8.52.222.23,0,0,3,898,3,898,1.650137000,0.0804
142.166.245.108,<->,136.25.188.222,0,0,3,244,3,244,1.650063000,0.0033
215.158.239.76,<->,199.20.29.148,3,326,0,0,3,326,1.649947000,0.2892
215.158.239.233,<->,100.244.13.26,3,215,0,0,3,215,1.648809000,0.0249
215.158.238.134,<->,8.40.50.245,3,1085,0,0,3,1085,1.648714000,0.0982
133.178.227.27,<->,29.211.122.238,3,1220,0,0,3,1220,1.647217000,0.1104
92.27.128.253,<->,8.252.221.249,0,0,3,1050,3,1050,1.645769000,0.3431
196.246.164.42,<->,136.25.188.241,0,0,3,244,3,244,1.644055000,0.0600
204.3.185.182,<->,136.25.188.224,0,0,3,371,3,371,1.643752000,0.2920
246.253.157.15,<->,119.226.13.55,3,152,0,0,3,152,1.643645000,0.1957
207.236.159.236,<->,136.25.188.52,0,0,3,663,3,663,1.643029000,0.2390
215.158.239.97,<->,207.61.95.77,3,667,0,0,3,667,1.643018000,0.2008
215.158.239.95,<->,142.191.46.117,3,722,0,0,3,722,1.642617000,0.2029
215.158.239.56,<->,142.227.62.207,3,667,0,0,3,667,1.642581000,0.1962
215.158.238.114,<->,29.211.186.213,3,1421,0,0,3,1421,1.642109000,0.1935
138.98.217.32,<->,27.11.49.127,3,382,0,0,3,382,1.641732000,0.1086
92.27.219.231,<->,67.240.21.67,3,156,0,0,3,156,1.639765000,0.3149
133.178.227.2,<->,111.150.187.233,3,2139,0,0,3,2139,1.638509000,0.1565
139.193.141.139,<->,50.53.223.140,3,1838,0,0,3,1838,1.637003000,0.2430
92.27.219.145,<->,33.57.78.124,3,156,0,0,3,156,1.636637000,0.1924
132.249.70.11,<->,53.208.51.3,3,446,0,0,3,446,1.636292000,0.0264
207.79.113.247,<->,92.27.194.147,0,0,3,473,3,473,1.636184000,0.2515
101.70.109.51,<->,82.195.71.7,3,150,0,0,3,150,1.636098000,0.1190
142.166.91.143,<->,136.25.188.220,0,0,3,360,3,360,1.634781000,0.2140
215.158.140.92,<->,119.196.23.111,3,1197,0,0,3,1197,1.634752000,0.1232
195.54.158.83,<->,136.25.188.176,0,0,3,752,3,752,1.634733000,0.3287
231.142.6.144,<->,215.158.239.87,0,0,3,722,3,722,1.633479000,0.1930
199.82.241.83,<->,136.25.188.178,0,0,3,667,3,667,1.633244000,0.1878
202.33.27.12,<->,136.25.188.209,0,0,3,726,3,726,1.632989000,0.2582
143.224.177.3,<->,0.195.210.46,0,0,3,1629,3,1629,1.632693000,0.0140
148.140.162.127,<->,89.183.104.178,0,0,3,204,3,204,1.632557000,0.2365
136.25.188.254,<->,131.144.113.219,3,1373,0,0,3,1373,1.632278000,0.3521
215.158.238.120,<->,204.123.232.197,3,1437,0,0,3,1437,1.631866000,0.1945
215.158.239.94,<->,199.82.194.185,3,498,0,0,3,498,1.631210000,0.2008
215.158.239.51,<->,199.51.236.251,3,402,0,0,3,402,1.630215000,0.2319
199.52.178.99,<->,136.25.188.209,0,0,3,360,3,360,1.629620000,0.2028
221.101.9.11,<->,204.130.124.252,3,156,0,0,3,156,1.629619000,0.3277
215.158.239.92,<->,199.20.5.64,3,722,0,0,3,722,1.628114000,0.3204
127.202.220.209,<->,50.224.76.235,0,0,3,917,3,917,1.627487000,0.2024
101.87.156.153,<->,100.228.42.52,0,0,3,677,3,677,1.627261000,0.2477
215.158.239.6,<->,96.135.154.110,3,1721,0,0,3,1721,1.626001000,0.1436
215.158.238.75,<->,113.23.104.203,3,1373,0,0,3,1373,1.625271000,0.2261
99.92.13.169,<->,8.52.189.207,0,0,3,227,3,227,1.623522000,0.0295
199.102.146.243,<->,50.223.3.228,0,0,3,352,3,352,1.623135000,0.2338
204.21.73.238,<->,136.25.188.163,0,0,3,244,3,244,1.622630000,0.0034
195.43.195.19,<->,136.25.188.209,0,0,3,693,3,693,1.621886000,0.3726
136.25.189.52,<->,80.56.91.244,3,3336,0,0,3,3336,1.621547000,0.3110
197.113.99.56,<->,136.25.188.175,0,0,3,524,3,524,1.621293000,0.3230
246.253.253.107,<->,89.152.226.82,3,205,0,0,3,205,1.618813000,0.0265
225.226.156.241,<->,8.20.87.89,0,0,3,156,3,156,1.618405000,0.0869
143.79.216.80,<->,136.25.188.198,0,0,3,626,3,626,1.617529000,0.3172
142.195.143.226,<->,136.25.188.255,0,0,3,168,3,168,1.617175000,0.0006
54.36.29.60,<->,48.54.128.253,0,0,3,237,3,237,1.615247000,0.2961
204.58.165.79,<->,136.25.188.196,0,0,3,244,3,244,1.613987000,0.0062
247.136.223.190,<->,54.35.247.52,3,393,0,0,3,393,1.612472000,0.2109
136.25.189.14,<->,123.166.46.231,3,1309,0,0,3,1309,1.612397000,0.1396
215.158.239.76,<->,207.60.89.242,3,150,0,0,3,150,1.612382000,0.0029
215.158.239.56,<->,196.0.225.225,3,693,0,0,3,693,1.611698000,0.2279
231.142.103.128,<->,136.25.188.44,0,0,3,244,3,244,1.610161000,0.0032
215.158.61.189,<->,8.176.8.233,0,0,3,410,3,410,1.610013000,0.3210
142.206.35.4,<->,136.25.188.252,0,0,3,667,3,667,1.609211000,0.2627
195.4.96.223,<->,136.25.188.177,0,0,3,626,3,626,1.609039000,0.2148
215.158.239.78,<->,195.4.123.187,3,168,0,0,3,168,1.608938000,0.0030
215.158.238.47,<->,57.184.236.91,3,1277,0,0,3,1277,1.608043000,0.2455
215.158.239.96,<->,199.80.9.28,3,722,0,0,3,722,1.605648000,0.2526
199.122.47.69,<->,136.25.188.225,0,0,3,366,3,366,1.604823000,0.2583
159.37.0.186,<->,145.116.119.49,0,0,3,207,3,207,1.601667000,0.0254
139.193.141.139,<->,57.141.31.210,3,1939,0,0,3,1939,1.601331000,0.3497
136.25.189.59,<->,119.168.0.26,3,2274,0,0,3,2274,1.601239000,0.2757
207.1.114.63,<->,92.27.194.147,0,0,3,477,3,477,1.601023000,0.1955
152.137.242.164,<->,8.252.221.221,0,0,3,488,3,488,1.600597000,0.2320
215.158.239.99,<->,196.0.232.99,3,187,0,0,3,187,1.600117000,0.2681
122.216.233.104,<->,8.252.222.185,0,0,3,1229,3,1229,1.600110000,0.1470
204.58.181.98,<->,136.25.188.173,0,0,3,726,3,726,1.599630000,0.2154
143.10.246.59,<->,136.25.188.254,0,0,3,392,3,392,1.599024000,0.2719
139.193.141.139,<->,127.187.184.88,3,2177,0,0,3,2177,1.598715000,0.1560
142.220.59.69,<->,136.25.188.174,0,0,3,752,3,752,1.598706000,0.2892
133.178.226.28,<->,120.54.127.12,3,1373,0,0,3,1373,1.598664000,0.1342
142.228.18.30,<->,136.25.188.52,0,0,3,362,3,362,1.597891000,0.2087
215.158.239.78,<->,8.222.98.57,3,1341,0,0,3,1341,1.597645000,0.0308
215.158.140.60,<->,104.3.168.52,3,1168,0,0,3,1168,1.596233000,0.1477
215.158.239.86,<->,204.3.134.243,3,722,0,0,3,722,1.595590000,0.2112
53.201.106.213,<->,48.53.101.92,0,0,3,237,3,237,1.594681000,0.3562
204.184.15.160,<->,136.25.188.46,0,0,3,168,3,168,1.593785000,0.0500
215.158.239.94,<->,204.226.11.55,3,156,0,0,3,156,1.592545000,0.1672
215.158.61.227,<->,97.126.31.73,0,0,3,3312,3,3312,1.592525000,0.0000
215.158.238.33,<->,131.1.195.220,3,1325,0,0,3,1325,1.592483000,0.1756
100.206.91.174,<->,33.233.141.52,0,0,3,311,3,311,1.591056000,0.3706
215.158.239.33,<->,106.188.156.152,3,1582,0,0,3,1582,1.590792000,0.1137
204.62.134.29,<->,136.25.188.178,0,0,3,199,3,199,1.589959000,0.2127
157.31.243.22,<->,80.27.153.44,0,0,3,410,3,410,1.589879000,0.2337
215.158.238.32,<->,29.213.195.69,3,1933,0,0,3,1933,1.589651000,0.1046
215.158.239.224,<->,192.226.44.117,3,735,0,0,3,735,1.589608000,0.3432
215.158.238.84,<->,145.116.209.80,3,626,0,0,3,626,1.588551000,0.0240
133.178.226.61,<->,113.23.104.246,3,1325,0,0,3,1325,1.588253000,0.1536
207.236.159.236,<->,136.25.188.227,0,0,3,667,3,667,1.587582000,0.2585
205.127.108.114,<->,33.233.141.0,0,0,3,1884,3,1884,1.585263000,0.0592
136.25.188.173,<->,73.179.110.89,3,343,0,0,3,343,1.584843000,0.1460
199.83.86.181,<->,136.25.188.175,0,0,3,752,3,752,1.584835000,0.2137
130.77.160.72,<->,8.252.222.71,0,0,3,1534,3,1534,1.582486000,0.2920
204.186.247.241,<->,136.25.188.55,0,0,3,192,3,192,1.582400000,0.3500
215.158.238.133,<->,133.73.194.9,3,1117,0,0,3,1117,1.582274000,0.0258
215.158.239.70,<->,199.122.12.182,3,667,0,0,3,667,1.580549000,0.2383
215.158.238.121,<->,48.131.156.26,3,1485,0,0,3,1485,1.580269000,0.1591
197.113.99.44,<->,136.25.188.225,0,0,3,168,3,168,1.579209000,0.2593
197.113.99.128,<->,136.25.188.198,0,0,3,244,3,244,1.577982000,0.0000
215.158.239.58,<->,204.0.244.86,3,693,0,0,3,693,1.577296000,0.2623
215.158.140.181,<->,100.224.243.72,3,3662,0,0,3,3662,1.574979000,0.0000
215.158.239.93,<->,195.81.19.82,3,168,0,0,3,168,1.574971000,0.0096
196.89.101.189,<->,136.25.188.237,0,0,3,168,3,168,1.572969000,0.0030
215.158.239.56,<->,195.54.94.62,3,288,0,0,3,288,1.572960000,0.2499
215.158.238.93,<->,42.134.254.0,3,1277,0,0,3,1277,1.572886000,0.1364
139.193.141.139,<->,98.129.146.202,3,1939,0,0,3,1939,1.572324000,0.0374
204.184.80.39,<->,136.25.188.196,0,0,3,722,3,722,1.572164000,0.4096
206.103.215.203,<->,136.25.189.30,0,0,3,1469,3,1469,1.568979000,0.1015
197.113.99.250,<->,136.25.188.196,0,0,3,326,3,326,1.568338000,0.2905
133.178.227.16,<->,18.202.90.199,3,1144,0,0,3,1144,1.567866000,0.3096
215.158.239.84,<->,195.70.135.134,3,204,0,0,3,204,1.566660000,0.1961
136.25.189.57,<->,69.150.169.153,3,1469,0,0,3,1469,1.565239000,0.2230
204.185.111.190,<->,136.25.188.178,0,0,3,199,3,199,1.562902000,0.1601
215.158.239.85,<->,196.109.74.33,3,192,0,0,3,192,1.561890000,0.0099
215.158.239.68,<->,199.20.29.82,3,244,0,0,3,244,1.561879000,0.0102
199.51.21.63,<->,136.25.188.46,0,0,3,150,3,150,1.561255000,0.4253
196.148.4.163,<->,53.243.94.97,3,192,0,0,3,192,1.560230000,0.0043
136.25.188.172,<->,122.159.245.165,3,1229,0,0,3,1229,1.559017000,0.1083
215.158.239.84,<->,142.248.16.154,3,372,0,0,3,372,1.558924000,0.3753
215.158.239.94,<->,199.20.31.239,3,392,0,0,3,392,1.558725000,0.3007
215.158.239.56,<->,196.108.10.83,3,722,0,0,3,722,1.557294000,0.3026
101.70.119.41,<->,53.208.122.85,3,2256,0,0,3,2256,1.556958000,0.0003
133.178.226.70,<->,126.219.100.200,3,1357,0,0,3,1357,1.556914000,0.2950
204.58.60.210,<->,136.25.188.196,0,0,3,722,3,722,1.555993000,0.3305
109.3.128.220,<->,8.55.216.92,3,1288,0,0,3,1288,1.554000000,0.0341
207.236.166.125,<->,136.25.188.254,0,0,3,385,3,385,1.553366000,0.3230
149.56.227.77,<->,109.222.200.93,0,0,3,244,3,244,1.553227000,0.2985
215.158.238.93,<->,113.23.66.104,3,1261,0,0,3,1261,1.553179000,0.1176
221.254.174.158,<->,145.18.221.98,0,0,3,427,3,427,1.552334000,0.0767
101.70.96.205,<->,53.214.81.58,3,162,0,0,3,162,1.551424000,0.3751
215.158.239.48,<->,195.13.241.106,3,362,0,0,3,362,1.549993000,0.0324
204.186.57.169,<->,136.25.188.238,0,0,3,360,3,360,1.549609000,0.4101
136.25.188.160,<->,8.252.210.160,3,1485,0,0,3,1485,1.548555000,0.1078
215.158.238.99,<->,118.20.87.79,3,1405,0,0,3,1405,1.548217000,0.1361
142.255.61.97,<->,136.25.188.45,0,0,3,887,3,887,1.548214000,0.1950
207.56.107.29,<->,136.25.188.178,0,0,3,360,3,360,1.547662000,0.4218
215.158.239.69,<->,199.20.28.108,3,1134,0,0,3,1134,1.547419000,0.3101
207.59.160.249,<->,136.25.188.237,0,0,3,150,3,150,1.546875000,0.0028
220.38.162.73,<->,215.158.140.163,0,0,3,1542,3,1542,1.546803000,0.0222
54.39.188.63,<->,48.55.170.180,0,0,3,237,3,237,1.546441000,0.2869
215.158.239.76,<->,199.20.30.52,3,498,0,0,3,498,1.546010000,0.3392
136.209.178.171,<->,8.182.226.78,0,0,3,150,3,150,1.545171000,0.0497
207.238.141.23,<->,136.25.188.177,0,0,3,180,3,180,1.545026000,0.2602
89.155.2.203,<->,8.183.25.124,0,0,3,156,3,156,1.541496000,0.0218
235.226.7.5,<->,139.193.141.139,0,0,3,2081,3,2081,1.540850000,0.1027
215.158.239.58,<->,196.91.92.22,3,722,0,0,3,722,1.536694000,0.3201
122.221.169.96,<->,50.224.76.230,0,0,3,968,3,968,1.536466000,0.1330
215.158.238.95,<->,80.57.141.73,3,1293,0,0,3,1293,1.534574000,0.0576
122.159.34.215,<->,8.252.222.209,0,0,3,1197,3,1197,1.533665000,0.4248
194.252.68.61,<->,0.195.210.42,0,0,3,365,3,365,1.532834000,0.3770
215.158.239.69,<->,195.83.140.200,3,693,0,0,3,693,1.530737000,0.4106
215.158.239.93,<->,196.1.217.234,3,168,0,0,3,168,1.530490000,0.0000
195.6.143.23,<->,136.25.188.242,0,0,3,150,3,150,1.530274000,0.0054
122.34.74.206,<->,89.183.104.254,0,0,3,351,3,351,1.529692000,0.2779
193.41.169.240,<->,8.52.225.237,0,0,3,156,3,156,1.527525000,0.1657
159.137.162.213,<->,149.238.107.34,3,438,0,0,3,438,1.527249000,0.1885
143.79.198.56,<->,136.25.188.242,0,0,3,193,3,193,1.527228000,0.3664
139.253.153.32,<->,92.162.253.43,0,0,3,438,3,438,1.526407000,0.0410
142.249.41.101,<->,136.25.188.163,0,0,3,150,3,150,1.525322000,0.0070
215.158.239.49,<->,195.83.140.200,3,693,0,0,3,693,1.524302000,0.2790
136.25.188.255,<->,122.159.245.165,3,1213,0,0,3,1213,1.524013000,0.2124
215.158.239.49,<->,196.89.235.166,3,667,0,0,3,667,1.523942000,0.2392
215.158.239.78,<->,207.59.31.20,3,667,0,0,3,667,1.521101000,0.3385
215.158.239.29,<->,158.166.175.248,3,1618,0,0,3,1618,1.520720000,0.1332
204.58.18.123,<->,136.25.188.220,0,0,3,156,3,156,1.520500000,0.1892
54.38.7.135,<->,48.54.50.60,0,0,3,321,3,321,1.520250000,0.2945
215.158.239.59,<->,204.227.217.14,3,150,0,0,3,150,1.520195000,0.0007
196.206.172.111,<->,136.25.188.225,0,0,3,360,3,360,1.519738000,0.4501
215.158.140.172,<->,8.222.7.169,3,1183,0,0,3,1183,1.517739000,0.0639
136.25.189.78,<->,131.144.115.252,3,1485,0,0,3,1485,1.517553000,0.3241
195.71.173.250,<->,136.25.188.222,0,0,3,726,3,726,1.517198000,0.3759
199.14.158.189,<->,136.25.188.163,0,0,3,168,3,168,1.517145000,0.0028
75.137.144.228,<->,8.252.221.198,0,0,3,538,3,538,1.517069000,0.1641
215.158.239.93,<->,195.55.56.77,3,370,0,0,3,370,1.515875000,0.4835
136.25.188.163,<->,84.209.174.83,3,693,0,0,3,693,1.515615000,0.4221
149.96.60.153,<->,133.178.226.28,0,0,3,1373,3,1373,1.514896000,0.0946
215.158.239.79,<->,195.70.5.197,3,722,0,0,3,722,1.514635000,0.4443
207.61.33.70,<->,136.25.188.255,0,0,3,626,3,626,1.514425000,0.4824
202.33.255.198,<->,136.25.188.240,0,0,3,199,3,199,1.512222000,0.3182
215.158.239.58,<->,196.92.254.194,3,192,0,0,3,192,1.511487000,0.4397
136.25.189.88,<->,8.42.43.73,3,1597,0,0,3,1597,1.510914000,0.0870
207.61.16.250,<->,136.25.188.236,0,0,3,722,3,722,1.510305000,0.4136
148.55.77.89,<->,139.193.141.139,0,0,3,1928,3,1928,1.508028000,0.2199
199.69.74.63,<->,136.25.188.209,0,0,3,722,3,722,1.507504000,0.2505
148.129.30.43,<->,136.25.189.77,0,0,3,1453,3,1453,1.506926000,0.1854
215.158.239.51,<->,199.106.197.210,3,168,0,0,3,168,1.505048000,0.0639
215.158.238.106,<->,111.150.34.250,3,1421,0,0,3,1421,1.504791000,0.1612
142.190.228.22,<->,136.25.188.252,0,0,3,375,3,375,1.504182000,0.3033
215.158.239.92,<->,199.20.31.6,3,156,0,0,3,156,1.504061000,0.4398
207.56.46.216,<->,136.25.188.254,0,0,3,150,3,150,1.503762000,0.0029
199.69.108.148,<->,136.25.188.227,0,0,3,270,3,270,1.503345000,0.0217
142.206.165.175,<->,136.25.188.252,0,0,3,667,3,667,1.502452000,0.2999
159.37.0.178,<->,145.116.119.49,0,0,3,207,3,207,1.501940000,0.0220
246.253.168.231,<->,105.88.18.211,3,470,0,0,3,470,1.500644000,0.2055
220.28.115.46,<->,136.25.189.5,0,0,3,2702,3,2702,1.500192000,0.0128
215.158.238.251,<->,8.222.6.215,3,1138,0,0,3,1138,1.500039000,0.4254
215.158.238.92,<->,143.88.15.41,3,1261,0,0,3,1261,1.498853000,0.1285
221.102.56.1,<->,129.1.81.150,0,0,3,199,3,199,1.498488000,0.0260
144.87.235.222,<->,132.18.67.29,3,1749,0,0,3,1749,1.497912000,0.0095
195.12.108.157,<->,136.25.188.176,0,0,3,150,3,150,1.497737000,0.1375
92.27.219.185,<->,4.240.214.61,3,1589,0,0,3,1589,1.497324000,0.0027
215.158.239.84,<->,199.32.172.120,3,168,0,0,3,168,1.497249000,0.0063
195.7.64.30,<->,136.25.188.208,0,0,3,667,3,667,1.497079000,0.2753
215.158.239.87,<->,199.82.184.226,3,375,0,0,3,375,1.494402000,0.2888
207.236.167.132,<->,136.25.188.198,0,0,3,378,3,378,1.493411000,0.3550
215.158.239.56,<->,199.20.31.124,3,693,0,0,3,693,1.491094000,0.3413
142.253.111.62,<->,136.25.188.55,0,0,3,667,3,667,1.488173000,0.2618
215.158.239.42,<->,122.158.246.183,3,1560,0,0,3,1560,1.486493000,0.1446
195.41.196.215,<->,136.25.188.255,0,0,3,367,3,367,1.485842000,0.4734
144.75.218.246,<->,8.47.122.178,3,299,0,0,3,299,1.485713000,0.4336
8.183.25.25,<->,8.20.102.81,3,461,0,0,3,461,1.485320000,0.0400
215.158.239.92,<->,142.252.236.149,3,726,0,0,3,726,1.485008000,0.3374
61.63.197.113,<->,50.224.76.234,0,0,3,1193,3,1193,1.484393000,0.2579
142.252.205.131,<->,136.25.188.252,0,0,3,150,3,150,1.484090000,0.0029
215.158.140.27,<->,140.145.218.248,3,176,0,0,3,176,1.483592000,0.2271
91.43.47.235,<->,8.228.215.7,0,0,3,389,3,389,1.483454000,0.0666
199.80.181.36,<->,136.25.188.172,0,0,3,150,3,150,1.483370000,0.0015
136.25.189.29,<->,116.106.44.35,3,1277,0,0,3,1277,1.482942000,0.1613
231.141.215.30,<->,136.25.188.174,0,0,3,150,3,150,1.482878000,0.0040
215.158.239.57,<->,199.20.6.232,3,192,0,0,3,192,1.482351000,0.3366
149.100.112.91,<->,139.193.141.139,0,0,3,2088,3,2088,1.481157000,0.3386
215.158.238.210,<->,8.219.185.122,3,2118,0,0,3,2118,1.480739000,0.0880
215.158.239.17,<->,121.67.161.192,3,1087,0,0,3,1087,1.480549000,0.4208
207.190.210.84,<->,136.25.188.177,0,0,3,150,3,150,1.480312000,0.0030
215.158.239.94,<->,29.211.228.217,3,1536,0,0,3,1536,1.480078000,0.1515
143.129.169.210,<->,136.25.188.163,0,0,3,241,3,241,1.480020000,0.3797
139.193.141.139,<->,98.164.243.95,3,1919,0,0,3,1919,1.479756000,0.0516
215.158.239.87,<->,142.252.236.149,3,726,0,0,3,726,1.479588000,0.3339
197.113.99.61,<->,136.25.188.44,0,0,3,722,3,722,1.479206000,0.4303
235.247.110.194,<->,92.27.194.147,0,0,3,339,3,339,1.476429000,0.4693
195.55.79.136,<->,136.25.188.220,0,0,3,667,3,667,1.476035000,0.3812
142.167.60.22,<->,136.25.188.209,0,0,3,150,3,150,1.475900000,0.2072
203.89.231.103,<->,50.224.80.64,0,0,3,197,3,197,1.474264000,0.2328
136.25.189.16,<->,8.222.3.223,3,1293,0,0,3,1293,1.474113000,0.2523
98.23.111.141,<->,92.27.209.234,0,0,3,150,3,150,1.473897000,0.2812
143.135.236.115,<->,136.25.188.208,0,0,3,722,3,722,1.473488000,0.2572
136.129.94.157,<->,111.199.239.119,3,534,0,0,3,534,1.472949000,0.2698
145.242.126.124,<->,33.218.92.101,3,334,0,0,3,334,1.471437000,0.1482
215.158.239.70,<->,148.26.113.42,3,1197,0,0,3,1197,1.471195000,0.1838
142.191.216.119,<->,136.25.188.225,0,0,3,150,3,150,1.470493000,0.0029
199.80.1.135,<->,136.25.188.226,0,0,3,168,3,168,1.467700000,0.0032
97.4.40.55,<->,80.38.37.64,0,0,3,246,3,246,1.466121000,0.0330
133.54.20.137,<->,59.146.100.23,3,554,0,0,3,554,1.465230000,0.2397
215.158.239.97,<->,196.109.223.108,3,726,0,0,3,726,1.465048000,0.2414
136.25.188.53,<->,84.28.215.132,3,360,0,0,3,360,1.464916000,0.3486
142.221.186.126,<->,136.25.188.253,0,0,3,376,3,376,1.464453000,0.4994
204.184.142.81,<->,136.25.188.178,0,0,3,722,3,722,1.464400000,0.2605
215.158.239.96,<->,199.20.30.238,3,244,0,0,3,244,1.463033000,0.0140
93.181.154.87,<->,89.183.104.231,0,0,3,156,3,156,1.463021000,0.3373
215.158.239.6,<->,106.188.214.29,3,1567,0,0,3,1567,1.462927000,0.0913
215.158.238.81,<->,192.205.37.205,3,1518,0,0,3,1518,1.462239000,0.0719
215.158.239.94,<->,195.81.19.82,3,168,0,0,3,168,1.461641000,0.0298
215.158.239.68,<->,202.33.255.198,3,199,0,0,3,199,1.461388000,0.3698
53.213.63.83,<->,48.52.215.212,0,0,3,665,3,665,1.460078000,0.4110
133.178.227.245,<->,111.151.237.158,3,4116,0,0,3,4116,1.459731000,0.0000
133.178.227.2,<->,106.188.252.230,3,1325,0,0,3,1325,1.458337000,0.1173
215.158.140.231,<->,100.50.96.239,3,2393,0,0,3,2393,1.457674000,0.4595
215.158.238.76,<->,139.163.161.19,3,626,0,0,3,626,1.456660000,0.0554
215.158.239.96,<->,143.42.43.107,3,150,0,0,3,150,1.456380000,0.0027
199.70.61.118,<->,136.25.188.208,0,0,3,379,3,379,1.456106000,0.3845
199.70.61.118,<->,136.25.188.177,0,0,3,379,3,379,1.452700000,0.3694
215.158.238.93,<->,6.116.31.21,3,1373,0,0,3,1373,1.451678000,0.2107
215.158.238.107,<->,29.211.186.199,3,1597,0,0,3,1597,1.451049000,0.1805
136.25.188.55,<->,113.20.94.121,3,168,0,0,3,168,1.450507000,0.0001
215.158.239.85,<->,207.63.54.13,3,156,0,0,3,156,1.449669000,0.2266
195.42.232.64,<->,136.25.188.255,0,0,3,150,3,150,1.448576000,0.0035
142.241.148.10,<->,136.25.188.236,0,0,3,150,3,150,1.447834000,0.0054
207.88.204.64,<->,50.224.76.234,0,0,3,1273,3,1273,1.447759000,0.1449
144.72.193.201,<->,100.93.246.58,0,0,3,764,3,764,1.447211000,0.1676
66.47.107.243,<->,8.252.222.63,0,0,3,150,3,150,1.446711000,0.2033
194.237.34.9,<->,136.25.188.55,0,0,3,244,3,244,1.445742000,0.0066
215.158.140.92,<->,126.219.101.175,3,1135,0,0,3,1135,1.445235000,0.2869
215.158.238.99,<->,199.69.87.69,3,1501,0,0,3,1501,1.444725000,0.1691
215.158.238.64,<->,113.23.104.221,3,1213,0,0,3,1213,1.444038000,0.1377
197.198.16.58,<->,136.25.188.178,0,0,3,324,3,324,1.443602000,0.2331
215.158.238.133,<->,106.188.251.194,3,1119,0,0,3,1119,1.443072000,0.1130
113.13.87.152,<->,92.27.219.29,0,0,3,447,3,447,1.443051000,0.3990
136.25.189.1,<->,131.144.115.118,3,2514,0,0,3,2514,1.441973000,0.5310
142.206.27.11,<->,136.25.188.55,0,0,3,698,3,698,1.441251000,0.0128
143.42.216.79,<->,136.25.188.176,0,0,3,150,3,150,1.440545000,0.0027
215.158.238.66,<->,131.36.198.24,3,1385,0,0,3,1385,1.439762000,0.1074
215.158.239.49,<->,199.20.28.159,3,392,0,0,3,392,1.439449000,0.2804
207.59.86.19,<->,136.25.188.239,0,0,3,168,3,168,1.439232000,0.0029
109.127.101.19,<->,8.176.8.206,0,0,3,2711,3,2711,1.436690000,0.3394
99.162.77.146,<->,53.161.183.246,3,555,0,0,3,555,1.435614000,0.3389
204.60.124.72,<->,136.25.188.243,0,0,3,242,3,242,1.435606000,0.1201
194.233.219.172,<->,136.25.188.177,0,0,3,244,3,244,1.435014000,0.0000
136.25.189.59,<->,29.212.199.34,3,1469,0,0,3,1469,1.434526000,0.2845
202.33.250.116,<->,136.25.188.222,0,0,3,726,3,726,1.434317000,0.4520
199.38.214.113,<->,136.25.188.199,0,0,3,244,3,244,1.434121000,0.0111
215.158.239.50,<->,122.159.245.29,3,1325,0,0,3,1325,1.433577000,0.1019
215.158.239.87,<->,199.20.31.201,3,722,0,0,3,722,1.432400000,0.3606
215.158.238.92,<->,143.227.65.224,3,1421,0,0,3,1421,1.431063000,0.2737
215.158.238.140,<->,193.18.105.54,3,1309,0,0,3,1309,1.430136000,0.2276
139.163.0.100,<->,107.112.71.200,3,283,0,0,3,283,1.430093000,0.0719
69.103.121.183,<->,8.252.221.220,0,0,3,312,3,312,1.430078000,0.1862
197.113.99.163,<->,136.25.188.225,0,0,3,722,3,722,1.429880000,0.3913
232.31.179.43,<->,220.55.125.160,0,0,3,335,3,335,1.429726000,0.1140
215.158.239.77,<->,207.166.75.106,3,1130,0,0,3,1130,1.429534000,0.2155
215.158.238.135,<->,112.220.206.107,3,1213,0,0,3,1213,1.429160000,0.1914
215.158.239.58,<->,199.39.65.23,3,150,0,0,3,150,1.428850000,0.0029
220.55.125.160,<->,27.11.41.174,3,395,0,0,3,395,1.428190000,0.1091
104.223.107.153,<->,92.27.219.30,0,0,3,156,3,156,1.427538000,0.5268
215.158.239.96,<->,196.93.212.117,3,722,0,0,3,722,1.426340000,0.4801
136.25.189.33,<->,68.124.221.158,3,1325,0,0,3,1325,1.425617000,0.3213
215.158.239.84,<->,199.20.6.137,3,360,0,0,3,360,1.425490000,0.3193
148.146.91.23,<->,136.25.188.199,0,0,3,1325,3,1325,1.425204000,0.2736
197.107.123.12,<->,136.25.188.44,0,0,3,376,3,376,1.424070000,0.2961
139.160.226.165,<->,136.25.189.82,0,0,3,2626,3,2626,1.422894000,0.5575
142.240.68.183,<->,136.25.188.243,0,0,3,150,3,150,1.420903000,0.0032
136.25.188.44,<->,131.173.115.89,3,1501,0,0,3,1501,1.420637000,0.2475
143.23.127.118,<->,136.25.188.175,0,0,3,722,3,722,1.419372000,0.3674
199.38.103.232,<->,136.25.188.177,0,0,3,150,3,150,1.417160000,0.0040
235.42.34.33,<->,215.158.238.123,0,0,3,1437,3,1437,1.416972000,0.1397
142.229.12.251,<->,136.25.188.236,0,0,3,150,3,150,1.415521000,0.0029
233.85.145.23,<->,8.183.25.25,0,0,3,402,3,402,1.413982000,0.5305
149.96.53.39,<->,136.25.188.47,0,0,3,1453,3,1453,1.413409000,0.1963
110.108.83.73,<->,109.1.54.101,0,0,3,224,3,224,1.411150000,0.2081
201.211.112.219,<->,133.178.226.30,0,0,3,1181,3,1181,1.407891000,0.2541
207.117.212.70,<->,8.182.239.140,0,0,3,175,3,175,1.407681000,0.1749
215.158.239.49,<->,199.72.88.152,3,392,0,0,3,392,1.406794000,0.1848
204.63.15.58,<->,136.25.188.241,0,0,3,168,3,168,1.406576000,0.4201
215.158.238.83,<->,113.23.104.215,3,1373,0,0,3,1373,1.406460000,0.2213
215.158.238.67,<->,197.125.126.249,3,2738,0,0,3,2738,1.404649000,0.4714
215.158.238.243,<->,126.219.194.16,3,1205,0,0,3,1205,1.404441000,0.2527
215.158.140.60,<->,8.190.217.148,3,1161,0,0,3,1161,1.404327000,0.1773
158.253.43.183,<->,136.25.188.226,0,0,3,1293,3,1293,1.403574000,0.1504
215.158.239.78,<->,29.214.73.139,3,1693,0,0,3,1693,1.402867000,0.2172
215.158.239.79,<->,207.16.193.216,3,722,0,0,3,722,1.402803000,0.3312
136.25.189.34,<->,57.4.201.137,3,1325,0,0,3,1325,1.401945000,0.1065
199.51.158.15,<->,136.25.188.238,0,0,3,340,3,340,1.400685000,0.2163
215.158.30.28,<->,136.25.189.28,0,0,3,1661,3,1661,1.399681000,0.0525
207.239.59.243,<->,136.25.188.209,0,0,3,722,3,722,1.398246000,0.4123
136.25.189.78,<->,96.156.169.169,3,1983,0,0,3,1983,1.397335000,0.1063
6.145.149.227,<->,0.195.210.46,0,0,3,553,3,553,1.394016000,0.4204
231.140.2.204,<->,136.25.188.211,0,0,3,726,3,726,1.393626000,0.4172
215.158.239.95,<->,199.20.28.172,3,370,0,0,3,370,1.391642000,0.3711
250.93.112.120,<->,50.224.76.235,0,0,3,1105,3,1105,1.389441000,0.4951
199.70.204.12,<->,136.25.188.198,0,0,3,375,3,375,1.388593000,0.2383
89.183.104.231,<->,33.57.77.135,3,156,0,0,3,156,1.388512000,0.4190
133.178.227.40,<->,29.211.6.119,3,1421,0,0,3,1421,1.386518000,0.3153
133.178.226.212,<->,122.158.176.232,3,3336,0,0,3,3336,1.386140000,0.2407
215.158.140.188,<->,100.224.243.66,3,3812,0,0,3,3812,1.385643000,0.0000
105.141.215.3,<->,50.224.89.243,0,0,3,412,3,412,1.385492000,0.2075
92.27.219.219,<->,33.57.78.103,3,154,0,0,3,154,1.384733000,0.4519
215.158.239.48,<->,195.54.81.44,3,752,0,0,3,752,1.384190000,0.1848
207.58.70.243,<->,136.25.188.54,0,0,3,162,3,162,1.383495000,0.2853
207.190.210.84,<->,136.25.188.53,0,0,3,150,3,150,1.383068000,0.0029
199.82.56.235,<->,136.25.188.225,0,0,3,244,3,244,1.383068000,0.0104
215.158.238.92,<->,136.139.59.101,3,2498,0,0,3,2498,1.382733000,0.5846
136.25.188.211,<->,113.23.104.220,3,1325,0,0,3,1325,1.382668000,0.1372
143.13.235.83,<->,136.25.188.209,0,0,3,168,3,168,1.382392000,0.0021
143.135.41.59,<->,136.25.188.241,0,0,3,722,3,722,1.382330000,0.4852
201.209.14.61,<->,139.193.141.139,0,0,3,1949,3,1949,1.382275000,0.3842
8.182.239.241,<->,6.242.35.66,3,524,0,0,3,524,1.378564000,0.0543
204.200.166.81,<->,136.25.188.242,0,0,3,150,3,150,1.376754000,0.1408
196.88.147.90,<->,136.25.188.253,0,0,3,667,3,667,1.375491000,0.2268
133.178.226.85,<->,100.120.38.6,3,1682,0,0,3,1682,1.375430000,0.3802
215.158.238.67,<->,29.213.218.232,3,1405,0,0,3,1405,1.375228000,0.1294
215.158.238.133,<->,122.158.51.91,3,1293,0,0,3,1293,1.374744000,0.1443
143.95.193.99,<->,136.25.188.238,0,0,3,244,3,244,1.374648000,0.0087
133.178.227.208,<->,111.151.237.128,3,1549,0,0,3,1549,1.374124000,0.0865
139.193.141.139,<->,6.228.183.5,3,1970,0,0,3,1970,1.373602000,0.2317
142.207.97.198,<->,136.25.188.237,0,0,3,204,3,204,1.371704000,0.6096
215.158.140.178,<->,6.15.196.147,3,893,0,0,3,893,1.371101000,0.0288
199.53.47.86,<->,136.25.188.255,0,0,3,156,3,156,1.371067000,0.2022
199.52.222.222,<->,136.25.188.226,0,0,3,150,3,150,1.370781000,0.0035
109.127.101.16,<->,102.50.165.139,0,0,3,631,3,631,1.369980000,0.3871
215.158.238.75,<->,8.240.117.62,3,1309,0,0,3,1309,1.368691000,0.3040
215.158.239.84,<->,204.2.124.2,3,402,0,0,3,402,1.367539000,0.3099
249.101.93.221,<->,109.127.101.16,3,605,0,0,3,605,1.367028000,0.0817
215.158.239.96,<->,199.70.111.166,3,150,0,0,3,150,1.366671000,0.2067
215.158.239.56,<->,198.204.76.195,3,1341,0,0,3,1341,1.366658000,0.3962
215.158.239.56,<->,195.80.102.27,3,752,0,0,3,752,1.366342000,0.4416
215.158.239.49,<->,199.20.31.113,3,722,0,0,3,722,1.365790000,0.2609
215.158.239.56,<->,199.20.28.27,3,726,0,0,3,726,1.365145000,0.4796
158.85.47.94,<->,133.178.227.247,0,0,3,1842,3,1842,1.364717000,0.0000
136.25.188.57,<->,111.151.142.231,3,168,0,0,3,168,1.364682000,0.0001
215.158.238.64,<->,113.23.104.247,3,1341,0,0,3,1341,1.364251000,0.1313
136.129.70.177,<->,6.15.100.1,3,412,0,0,3,412,1.364025000,0.2320
215.158.238.141,<->,131.144.115.171,3,1373,0,0,3,1373,1.364024000,0.1819
139.36.49.54,<->,109.1.21.169,0,0,3,540,3,540,1.362786000,0.2402
17.255.114.134,<->,8.220.188.50,0,0,3,760,3,760,1.362697000,0.5465
136.25.189.34,<->,116.106.46.69,3,2822,0,0,3,2822,1.361163000,0.4869
159.137.162.213,<->,105.111.168.128,3,438,0,0,3,438,1.361030000,0.3326
111.147.222.42,<->,50.236.117.202,3,156,0,0,3,156,1.360180000,0.1601
195.127.234.229,<->,8.52.250.9,0,0,3,1447,3,1447,1.358382000,0.5298
129.78.114.117,<->,117.50.180.99,3,523,0,0,3,523,1.357956000,0.2186
136.25.189.94,<->,96.156.169.199,3,2540,0,0,3,2540,1.357238000,0.0782
215.158.238.199,<->,29.211.165.26,3,1379,0,0,3,1379,1.356972000,0.1160
215.158.238.97,<->,143.155.227.33,3,376,0,0,3,376,1.355750000,0.1675
144.87.238.91,<->,8.182.227.18,0,0,3,150,3,150,1.354056000,0.0229
215.158.239.56,<->,199.20.7.197,3,722,0,0,3,722,1.353934000,0.3018
144.75.218.235,<->,138.127.225.148,3,1098,0,0,3,1098,1.352877000,0.0713
136.25.189.77,<->,126.219.49.42,3,2610,0,0,3,2610,1.349455000,0.4227
138.98.147.25,<->,42.68.240.157,3,150,0,0,3,150,1.348926000,0.0004
132.123.40.33,<->,111.151.237.13,3,377,0,0,3,377,1.347904000,0.0199
215.158.239.70,<->,8.215.68.57,3,1525,0,0,3,1525,1.346463000,0.1154
215.158.238.36,<->,69.31.239.99,3,1565,0,0,3,1565,1.345986000,0.1927
199.50.26.180,<->,136.25.188.46,0,0,3,150,3,150,1.345505000,0.4693
111.151.139.217,<->,67.174.33.171,0,0,3,168,3,168,1.345379000,0.0000
194.253.82.85,<->,8.252.222.236,0,0,3,229,3,229,1.344908000,0.0000
56.121.53.122,<->,53.249.54.105,3,373,0,0,3,373,1.344363000,0.3258
215.158.238.115,<->,143.155.227.33,3,376,0,0,3,376,1.343940000,0.1738
109.222.212.28,<->,53.84.124.210,3,361,0,0,3,361,1.343579000,0.0560
29.212.43.237,<->,8.252.222.204,0,0,3,1165,3,1165,1.342797000,0.1193
119.213.189.67,<->,92.27.219.49,0,0,3,174,3,174,1.342489000,0.2820
144.75.218.242,<->,138.127.231.3,3,882,0,0,3,882,1.342456000,0.6203
69.246.60.77,<->,8.252.222.31,0,0,3,667,3,667,1.340641000,0.3224
215.158.140.75,<->,29.213.219.52,3,1185,0,0,3,1185,1.339894000,0.2862
80.40.1.230,<->,50.127.188.132,3,156,0,0,3,156,1.337776000,0.0620
215.158.238.113,<->,197.103.151.87,3,1309,0,0,3,1309,1.336758000,0.1988
199.32.178.45,<->,136.25.188.175,0,0,3,150,3,150,1.333294000,0.1717
215.158.61.183,<->,8.176.8.197,0,0,3,541,3,541,1.332488000,0.5104
136.25.189.77,<->,113.92.151.21,3,1325,0,0,3,1325,1.332440000,0.1724
215.158.239.87,<->,199.20.29.132,3,150,0,0,3,150,1.332021000,0.3932
215.158.239.95,<->,8.249.253.234,3,1469,0,0,3,1469,1.331641000,0.1476
133.178.226.29,<->,112.93.136.102,3,1229,0,0,3,1229,1.330499000,0.1724
144.85.170.208,<->,98.87.145.232,3,1064,0,0,3,1064,1.330404000,0.3856
220.38.84.231,<->,215.158.239.92,0,0,3,1309,3,1309,1.329081000,0.1315
142.179.176.110,<->,139.163.26.238,0,0,3,150,3,150,1.329021000,0.5099
92.27.219.42,<->,88.5.213.212,3,203,0,0,3,203,1.328412000,0.3965
215.158.239.84,<->,199.20.31.19,3,722,0,0,3,722,1.327129000,0.3013
215.158.239.77,<->,207.114.92.54,3,722,0,0,3,722,1.326871000,0.4198
215.158.239.92,<->,207.114.92.54,3,722,0,0,3,722,1.326398000,0.4997
241.120.29.238,<->,136.25.189.1,0,0,3,1421,3,1421,1.325841000,0.1002
215.158.140.217,<->,192.228.81.200,3,950,0,0,3,950,1.325140000,0.0240
215.158.239.71,<->,42.189.53.21,3,1256,0,0,3,1256,1.325108000,0.2019
215.158.238.41,<->,111.151.109.19,3,168,0,0,3,168,1.324023000,0.0001
199.73.184.144,<->,136.25.188.225,0,0,3,150,3,150,1.323205000,0.0061
215.158.239.69,<->,207.236.246.163,3,1129,0,0,3,1129,1.320887000,0.0246
92.27.219.242,<->,84.240.119.222,3,150,0,0,3,150,1.320573000,0.3427
215.158.239.99,<->,199.121.76.183,3,752,0,0,3,752,1.319912000,0.1937
125.20.85.151,<->,80.42.183.31,0,0,3,156,3,156,1.319791000,0.6133
139.193.141.139,<->,131.148.119.65,3,1965,0,0,3,1965,1.319474000,0.1048
149.161.62.53,<->,139.193.141.139,0,0,3,1967,3,1967,1.319374000,0.3379
215.158.238.132,<->,112.220.206.116,3,1261,0,0,3,1261,1.318290000,0.1852
248.225.25.242,<->,56.9.27.51,3,555,0,0,3,555,1.317370000,0.2537
215.158.239.70,<->,148.21.212.181,3,1453,0,0,3,1453,1.315557000,0.1323
144.88.76.220,<->,54.69.75.250,3,263,0,0,3,263,1.315300000,0.0004
215.158.61.145,<->,8.176.8.197,0,0,3,512,3,512,1.315046000,0.5318
199.81.193.82,<->,136.25.188.243,0,0,3,199,3,199,1.314379000,0.3175
143.227.65.146,<->,133.178.226.18,0,0,3,1389,3,1389,1.313635000,0.2487
207.175.236.1,<->,136.25.188.220,0,0,3,150,3,150,1.313621000,0.0040
204.63.98.222,<->,136.25.188.175,0,0,3,162,3,162,1.312990000,0.0001
145.144.97.237,<->,8.222.6.88,3,1263,0,0,3,1263,1.312592000,0.0980
133.178.227.40,<->,8.222.6.193,3,1130,0,0,3,1130,1.312576000,0.0361
215.158.239.35,<->,126.219.142.36,3,1377,0,0,3,1377,1.312030000,0.1927
111.2.136.178,<->,8.182.226.78,0,0,3,516,3,516,1.310171000,0.0780
215.158.238.65,<->,112.220.206.116,3,1229,0,0,3,1229,1.309660000,0.1234
215.158.140.75,<->,69.31.239.7,3,1156,0,0,3,1156,1.308839000,0.2153
215.158.239.42,<->,29.211.5.208,3,1586,0,0,3,1586,1.307367000,0.1224
207.60.77.97,<->,136.25.188.163,0,0,3,722,3,722,1.306749000,0.4487
215.158.239.94,<->,113.23.14.212,3,1309,0,0,3,1309,1.303782000,0.1365
215.158.238.120,<->,126.219.132.165,3,1421,0,0,3,1421,1.302723000,0.2562
142.229.81.148,<->,136.25.188.255,0,0,3,168,3,168,1.302681000,0.0030
215.158.239.79,<->,199.20.28.202,3,1820,0,0,3,1820,1.300867000,0.6900
133.178.226.19,<->,48.49.55.188,3,1229,0,0,3,1229,1.300689000,0.2595
204.187.158.135,<->,136.25.188.222,0,0,3,162,3,162,1.299717000,0.2144
196.247.172.69,<->,136.25.188.176,0,0,3,824,3,824,1.299246000,0.0401
92.170.252.152,<->,48.17.236.244,3,399,0,0,3,399,1.298990000,0.4691
215.158.239.95,<->,196.105.5.204,3,524,0,0,3,524,1.298546000,0.5106
215.158.238.93,<->,131.2.102.59,3,1309,0,0,3,1309,1.296497000,0.1448
139.193.141.139,<->,113.129.239.137,3,1981,0,0,3,1981,1.296449000,0.1530
199.121.242.246,<->,136.25.188.225,0,0,3,168,3,168,1.295815000,0.0028
200.175.126.56,<->,89.153.117.22,3,4512,0,0,3,4512,1.295087000,0.4706
215.158.239.96,<->,199.20.30.131,3,722,0,0,3,722,1.294069000,0.2904
215.158.239.50,<->,206.103.214.39,3,1421,0,0,3,1421,1.293709000,0.0945
133.178.226.66,<->,122.158.69.2,3,3336,0,0,3,3336,1.291794000,0.1608
142.207.162.203,<->,136.25.188.197,0,0,3,275,3,275,1.291735000,0.4398
136.25.188.160,<->,80.47.111.74,3,1277,0,0,3,1277,1.291177000,0.0663
136.51.124.227,<->,8.53.4.76,0,0,3,156,3,156,1.289341000,0.0813
215.158.238.73,<->,193.39.69.170,3,1213,0,0,3,1213,1.288295000,0.1543
207.172.203.14,<->,136.25.188.196,0,0,3,168,3,168,1.286983000,0.0804
215.158.239.94,<->,196.90.196.130,3,877,0,0,3,877,1.284497000,0.5392
199.68.189.178,<->,136.25.188.163,0,0,3,726,3,726,1.283842000,0.4741
215.158.238.72,<->,120.154.221.235,3,1389,0,0,3,1389,1.283835000,0.2360
215.158.239.122,<->,53.246.131.101,3,221,0,0,3,221,1.283735000,0.0971
199.121.46.246,<->,136.25.188.243,0,0,3,150,3,150,1.283612000,0.0034
121.205.33.55,<->,89.183.104.137,0,0,3,326,3,326,1.283132000,0.6219
224.42.18.241,<->,139.193.141.139,0,0,3,1882,3,1882,1.282709000,0.3497
246.45.209.122,<->,59.150.215.46,3,168,0,0,3,168,1.280840000,0.3310
115.179.195.96,<->,80.41.20.208,0,0,3,156,3,156,1.280126000,0.1744
199.33.95.97,<->,136.25.188.252,0,0,3,156,3,156,1.278684000,0.1661
106.5.211.79,<->,48.53.111.214,0,0,3,477,3,477,1.278403000,0.6263
204.62.175.71,<->,136.25.188.225,0,0,3,244,3,244,1.278193000,0.0000
149.250.115.40,<->,136.25.188.55,0,0,3,1469,3,1469,1.277971000,0.2312
197.113.99.18,<->,136.25.188.255,0,0,3,392,3,392,1.277900000,0.5696
215.158.239.87,<->,199.20.31.59,3,204,0,0,3,204,1.277766000,0.4199
215.158.238.135,<->,112.68.105.246,3,1325,0,0,3,1325,1.277575000,0.1561
215.158.239.49,<->,195.55.190.198,3,375,0,0,3,375,1.277407000,0.2545
94.192.158.3,<->,8.252.222.143,0,0,3,244,3,244,1.277305000,0.0000
215.202.174.52,<->,136.25.189.14,0,0,3,1197,3,1197,1.276784000,0.2349
136.181.42.74,<->,54.49.224.150,3,343,0,0,3,343,1.275389000,0.1070
215.158.238.143,<->,104.154.137.200,3,1309,0,0,3,1309,1.273637000,0.2489
204.200.60.4,<->,136.25.188.174,0,0,3,242,3,242,1.272030000,0.6720
215.158.239.49,<->,199.20.31.72,3,726,0,0,3,726,1.270897000,0.4282
215.158.140.27,<->,126.221.81.103,3,176,0,0,3,176,1.270619000,0.1300
203.212.90.184,<->,50.223.3.228,0,0,3,439,3,439,1.270352000,0.7239
139.193.141.139,<->,33.98.12.115,3,1926,0,0,3,1926,1.267232000,0.1901
136.25.188.196,<->,131.1.253.247,3,1341,0,0,3,1341,1.266946000,0.2199
159.137.139.75,<->,133.178.227.41,0,0,3,2257,3,2257,1.266913000,0.6574
97.11.164.237,<->,54.59.120.90,3,456,0,0,3,456,1.265262000,0.0929
204.186.72.133,<->,136.25.188.53,0,0,3,302,3,302,1.265196000,0.1096
133.178.226.80,<->,57.4.201.97,3,1325,0,0,3,1325,1.263785000,0.1050
199.71.117.99,<->,136.25.188.222,0,0,3,667,3,667,1.261891000,0.3063
136.25.188.173,<->,80.47.111.87,3,1373,0,0,3,1373,1.261617000,0.2276
136.181.50.70,<->,0.195.216.195,3,193,0,0,3,193,1.261574000,0.0546
215.158.239.48,<->,199.20.30.216,3,204,0,0,3,204,1.261077000,0.3603
195.12.120.42,<->,136.25.188.178,0,0,3,156,3,156,1.260555000,0.1587
136.25.189.243,<->,54.42.119.66,3,1773,0,0,3,1773,1.258838000,0.0796
215.158.238.56,<->,148.129.19.250,3,1565,0,0,3,1565,1.258546000,0.1152
111.25.52.96,<->,98.67.141.138,0,0,3,175,3,175,1.258052000,0.0015
215.158.239.49,<->,123.166.47.58,3,1357,0,0,3,1357,1.256990000,0.1364
231.140.229.79,<->,215.158.239.49,0,0,3,360,3,360,1.256286000,0.7182
195.68.97.165,<->,136.25.188.46,0,0,3,722,3,722,1.255221000,0.6674
90.240.140.153,<->,50.149.34.234,3,611,0,0,3,611,1.253516000,0.2529
215.158.238.33,<->,8.252.213.37,3,1485,0,0,3,1485,1.252373000,0.0419
215.158.239.49,<->,212.70.75.119,3,2642,0,0,3,2642,1.249081000,0.5502
142.237.103.240,<->,136.25.188.55,0,0,3,363,3,363,1.247780000,0.0057
159.223.64.144,<->,144.85.170.208,0,0,3,519,3,519,1.243965000,0.0979
210.221.107.173,<->,8.37.242.210,3,383,0,0,3,383,1.242330000,0.0360
75.214.44.151,<->,8.252.221.236,0,0,3,156,3,156,1.242208000,0.1435
97.190.205.25,<->,8.37.175.39,3,692,0,0,3,692,1.241454000,0.3071
215.158.239.109,<->,215.158.61.145,3,770,0,0,3,770,1.241205000,0.3579
215.158.238.9,<->,8.222.109.84,3,1437,0,0,3,1437,1.240277000,0.2852
215.158.239.58,<->,199.20.7.206,3,244,0,0,3,244,1.239995000,0.0079
195.7.210.21,<->,136.25.188.225,0,0,3,168,3,168,1.239756000,0.0030
97.233.39.9,<->,8.220.190.86,0,0,3,175,3,175,1.239723000,0.0322
48.43.216.192,<->,0.195.210.46,0,0,3,156,3,156,1.239627000,0.3902
75.214.44.151,<->,8.252.221.198,0,0,3,156,3,156,1.239514000,0.1425
132.180.15.160,<->,8.220.200.124,0,0,3,150,3,150,1.238633000,0.0301
215.158.238.135,<->,42.97.54.90,3,1213,0,0,3,1213,1.237258000,0.2087
143.76.164.44,<->,8.182.226.42,0,0,3,150,3,150,1.236812000,0.1648
231.140.153.11,<->,215.158.239.94,0,0,3,392,3,392,1.235216000,0.6236
197.113.99.41,<->,136.25.188.53,0,0,3,213,3,213,1.234372000,0.3405
215.158.238.112,<->,112.93.136.104,3,1405,0,0,3,1405,1.233373000,0.1607
111.20.172.118,<->,101.224.89.157,0,0,3,2835,3,2835,1.230883000,0.0227
142.249.104.143,<->,136.25.188.199,0,0,3,726,3,726,1.230424000,0.4468
133.178.226.247,<->,111.151.142.182,3,168,0,0,3,168,1.228812000,0.0001
82.121.224.75,<->,8.52.180.14,0,0,3,175,3,175,1.226697000,0.0379
142.253.192.140,<->,136.25.188.198,0,0,3,270,3,270,1.225685000,0.0140
215.158.238.238,<->,8.219.185.104,3,2227,0,0,3,2227,1.225148000,0.0720
215.158.239.48,<->,196.91.4.154,3,888,0,0,3,888,1.224340000,0.2001
143.79.199.56,<->,136.25.188.163,0,0,3,150,3,150,1.224316000,0.0061
221.102.99.189,<->,199.12.100.120,3,495,0,0,3,495,1.223438000,0.2196
204.185.148.180,<->,136.25.188.242,0,0,3,498,3,498,1.222279000,0.6395
209.91.128.36,<->,8.52.139.19,0,0,3,2111,3,2111,1.221546000,0.2513
220.20.200.194,<->,113.168.237.37,3,658,0,0,3,658,1.219908000,0.1551
138.79.143.196,<->,111.146.147.152,0,0,3,539,3,539,1.219245000,0.6186
215.158.239.48,<->,142.167.211.243,3,244,0,0,3,244,1.219244000,0.0056
215.158.2.83,<->,136.116.10.96,0,0,3,300,3,300,1.219191000,0.6574
215.158.238.66,<->,57.210.107.8,3,1341,0,0,3,1341,1.219034000,0.2026
215.158.239.49,<->,195.49.65.139,3,1842,0,0,3,1842,1.218915000,0.0001
92.27.219.175,<->,78.44.111.82,3,4188,0,0,3,4188,1.218913000,0.0288
196.247.24.238,<->,136.25.188.175,0,0,3,284,3,284,1.218362000,0.1574
215.158.239.96,<->,195.81.105.245,3,693,0,0,3,693,1.217766000,0.5511
215.158.239.49,<->,199.20.31.124,3,168,0,0,3,168,1.217040000,0.0000
203.94.155.241,<->,136.25.188.46,0,0,3,156,3,156,1.216267000,0.2530
108.38.127.91,<->,50.224.76.230,0,0,3,150,3,150,1.215940000,0.5413
132.249.70.11,<->,53.94.69.91,3,168,0,0,3,168,1.215566000,0.0590
199.38.237.160,<->,136.25.188.52,0,0,3,150,3,150,1.214301000,0.0020
215.158.239.95,<->,204.2.151.175,3,244,0,0,3,244,1.212319000,0.0398
132.153.81.32,<->,8.43.155.247,0,0,3,168,3,168,1.211624000,0.0001
199.14.158.189,<->,136.25.188.209,0,0,3,168,3,168,1.211585000,0.0030
215.158.238.189,<->,8.219.185.106,3,2018,0,0,3,2018,1.211472000,0.0414
216.184.2.212,<->,6.73.247.25,0,0,3,2765,3,2765,1.210772000,0.0031
199.70.149.192,<->,136.25.188.177,0,0,3,150,3,150,1.209893000,0.0034
249.101.120.210,<->,22.5.212.226,3,582,0,0,3,582,1.208748000,0.1066
207.236.187.217,<->,136.25.188.252,0,0,3,150,3,150,1.208203000,0.7543
215.158.239.48,<->,196.93.47.221,3,162,0,0,3,162,1.207949000,0.0199
215.158.239.19,<->,8.222.7.180,3,1218,0,0,3,1218,1.207450000,0.0353
215.158.238.120,<->,194.205.112.168,3,1469,0,0,3,1469,1.207019000,0.1753
203.94.155.241,<->,136.25.188.162,0,0,3,156,3,156,1.206974000,0.2474
215.158.239.58,<->,207.56.41.2,3,667,0,0,3,667,1.206956000,0.4285
138.127.224.192,<->,92.27.8.182,0,0,3,494,3,494,1.205340000,0.3322
136.25.188.198,<->,95.90.181.60,3,390,0,0,3,390,1.203587000,0.3820
143.134.48.251,<->,136.25.188.241,0,0,3,842,3,842,1.203572000,0.7179
215.158.239.78,<->,199.20.31.243,3,244,0,0,3,244,1.203561000,0.0100
136.25.188.223,<->,122.159.245.172,3,1453,0,0,3,1453,1.203458000,0.2023
215.158.239.86,<->,199.20.30.158,3,168,0,0,3,168,1.202485000,0.0603
215.158.239.43,<->,8.219.187.249,3,1377,0,0,3,1377,1.202398000,0.0646
8.252.222.46,<->,4.121.146.241,3,726,0,0,3,726,1.202337000,0.1715
142.228.165.122,<->,136.25.188.196,0,0,3,877,3,877,1.201913000,0.3284
197.125.117.137,<->,133.178.227.1,0,0,3,2391,3,2391,1.200767000,0.6844
142.220.62.244,<->,136.25.188.162,0,0,3,150,3,150,1.200698000,0.0015
193.11.129.102,<->,136.25.189.57,0,0,3,2349,3,2349,1.199672000,0.6906
215.158.238.59,<->,126.219.102.72,3,1565,0,0,3,1565,1.198531000,0.1456
215.158.238.112,<->,144.253.73.85,3,1456,0,0,3,1456,1.195529000,0.0298
246.44.56.126,<->,69.149.14.34,3,408,0,0,3,408,1.194049000,0.4232
195.70.16.90,<->,136.25.188.163,0,0,3,693,3,693,1.193781000,0.4475
136.25.188.253,<->,29.212.182.215,3,1101,0,0,3,1101,1.192357000,0.4799
54.37.171.141,<->,48.55.138.147,0,0,3,150,3,150,1.192072000,0.0005
145.76.230.104,<->,33.233.141.16,0,0,3,380,3,380,1.191835000,0.1061
215.158.61.243,<->,136.25.188.35,0,0,3,770,3,770,1.190206000,0.1249
146.132.48.23,<->,136.25.189.81,0,0,3,1501,3,1501,1.190158000,0.2617
199.20.31.219,<->,92.27.194.147,0,0,3,184,3,184,1.188700000,0.7702
215.158.239.70,<->,142.191.179.38,3,150,0,0,3,150,1.188056000,0.0032
129.225.132.224,<->,129.225.131.152,3,1445,0,0,3,1445,1.187000000,0.2253
196.148.120.168,<->,27.11.59.51,3,159,0,0,3,159,1.186691000,0.1149
143.227.65.245,<->,136.25.188.178,0,0,3,1469,3,1469,1.186343000,0.2147
215.158.238.141,<->,148.190.126.29,3,1309,0,0,3,1309,1.185013000,0.5294
215.158.238.141,<->,143.155.227.33,3,1373,0,0,3,1373,1.184928000,0.2908
136.25.188.211,<->,69.132.194.169,3,1549,0,0,3,1549,1.184485000,0.3393
231.140.129.63,<->,136.25.188.199,0,0,3,168,3,168,1.183289000,0.0017
204.186.77.180,<->,136.25.188.209,0,0,3,200,3,200,1.182551000,0.0000
136.25.189.245,<->,111.151.106.216,3,168,0,0,3,168,1.182302000,0.0001
144.87.238.89,<->,8.182.136.93,0,0,3,150,3,150,1.180497000,0.0231
207.63.0.126,<->,136.25.188.177,0,0,3,883,3,883,1.180022000,0.6999
92.27.219.148,<->,78.44.2.32,3,156,0,0,3,156,1.179551000,0.4170
192.224.146.52,<->,133.178.227.134,0,0,3,4259,3,4259,1.178842000,0.0000
133.178.226.29,<->,131.144.113.214,3,1389,0,0,3,1389,1.178087000,0.1922
220.55.124.65,<->,92.162.218.53,3,533,0,0,3,533,1.175974000,0.1387
220.255.14.30,<->,139.193.141.139,0,0,3,1903,3,1903,1.175682000,0.0732
199.121.78.32,<->,136.25.188.52,0,0,3,150,3,150,1.173313000,0.0032
215.158.239.92,<->,199.20.29.200,3,150,0,0,3,150,1.172914000,0.0960
143.155.227.33,<->,133.178.226.37,0,0,3,1213,3,1213,1.169376000,0.1721
141.199.76.215,<->,136.25.189.57,0,0,3,1469,3,1469,1.169147000,0.2185
215.158.238.95,<->,29.209.59.166,3,1341,0,0,3,1341,1.168578000,0.3657
143.129.220.197,<->,136.25.188.198,0,0,3,244,3,244,1.167982000,0.0035
136.25.188.237,<->,122.159.245.165,3,1389,0,0,3,1389,1.167205000,0.1101
204.184.244.125,<->,136.25.188.176,0,0,3,722,3,722,1.166122000,0.5201
133.178.226.7,<->,8.219.187.245,3,1609,0,0,3,1609,1.162222000,0.0624
192.178.208.163,<->,98.67.158.12,0,0,3,201,3,201,1.162129000,0.0736
215.158.239.68,<->,202.33.23.96,3,193,0,0,3,193,1.161971000,0.2264
202.33.35.129,<->,136.25.188.209,0,0,3,168,3,168,1.161920000,0.0000
129.95.133.231,<->,14.125.23.209,0,0,3,274,3,274,1.161447000,0.1197
198.204.76.245,<->,136.25.189.29,0,0,3,1421,3,1421,1.159320000,0.1567
54.59.235.248,<->,48.53.135.101,0,0,3,225,3,225,1.159051000,0.4684
215.158.238.103,<->,100.224.166.122,3,618,0,0,3,618,1.158955000,0.4597
215.158.239.48,<->,196.91.218.75,3,162,0,0,3,162,1.158910000,0.1758
220.20.200.13,<->,144.83.60.153,3,572,0,0,3,572,1.158391000,0.1687
136.25.189.82,<->,80.56.79.73,3,1498,0,0,3,1498,1.155748000,0.1704
133.178.227.19,<->,8.252.213.36,3,1184,0,0,3,1184,1.155346000,0.1757
199.120.21.221,<->,136.25.188.254,0,0,3,192,3,192,1.155327000,0.1031
129.236.114.39,<->,33.233.141.1,0,0,3,3038,3,3038,1.154703000,0.0000
207.176.217.183,<->,50.223.3.228,0,0,3,150,3,150,1.154232000,0.6703
143.129.165.171,<->,136.25.188.253,0,0,3,722,3,722,1.152623000,0.3374
218.4.165.167,<->,132.216.20.76,3,156,0,0,3,156,1.152119000,0.1268
215.158.238.33,<->,29.211.186.213,3,1341,0,0,3,1341,1.151754000,0.1396
218.233.211.196,<->,8.220.202.4,0,0,3,181,3,181,1.150030000,0.0463
195.14.246.111,<->,136.25.188.177,0,0,3,168,3,168,1.149940000,0.0035
136.25.188.160,<->,57.199.250.196,3,1437,0,0,3,1437,1.149113000,0.2190
215.158.238.107,<->,128.69.139.73,3,1229,0,0,3,1229,1.148582000,0.1637
207.206.28.52,<->,50.223.3.228,0,0,3,302,3,302,1.148227000,0.1575
145.5.191.142,<->,50.224.111.73,0,0,3,176,3,176,1.147276000,0.2196
136.25.189.57,<->,133.146.0.88,3,1485,0,0,3,1485,1.147257000,0.1697
149.128.96.82,<->,133.178.226.76,0,0,3,199,3,199,1.146962000,0.1359
59.32.3.196,<->,34.90.46.185,0,0,3,166,3,166,1.146773000,0.1292
215.158.239.59,<->,135.228.221.201,3,1485,0,0,3,1485,1.144670000,0.4161
139.148.142.187,<->,8.52.189.173,0,0,3,436,3,436,1.143057000,0.3286
144.75.218.237,<->,132.200.124.228,3,766,0,0,3,766,1.142493000,0.6044
199.82.209.199,<->,136.25.188.44,0,0,3,168,3,168,1.142269000,0.0050
199.14.140.0,<->,136.25.188.163,0,0,3,150,3,150,1.141928000,0.0042
215.158.238.73,<->,27.178.41.49,3,1325,0,0,3,1325,1.141927000,0.3877
199.15.158.230,<->,136.25.188.178,0,0,3,722,3,722,1.141882000,0.4700
8.228.216.50,<->,8.191.6.125,3,1173,0,0,3,1173,1.139739000,0.0400
132.249.70.169,<->,82.195.35.9,3,857,0,0,3,857,1.138981000,0.0367
136.25.189.80,<->,61.35.124.188,3,2594,0,0,3,2594,1.138974000,0.8078
215.158.239.33,<->,126.219.142.149,3,1593,0,0,3,1593,1.136360000,0.1208
136.25.189.33,<->,57.4.201.182,3,1277,0,0,3,1277,1.135631000,0.2646
89.183.104.251,<->,82.150.74.32,3,156,0,0,3,156,1.135395000,0.0880
139.193.141.139,<->,127.106.135.213,3,1865,0,0,3,1865,1.135047000,0.3401
133.178.226.61,<->,29.214.108.148,3,1149,0,0,3,1149,1.134513000,0.1221
195.78.28.47,<->,144.85.170.228,0,0,3,204,3,204,1.133464000,0.3243
144.75.218.237,<->,138.127.225.148,3,1087,0,0,3,1087,1.132978000,0.5619
133.178.227.29,<->,111.151.142.246,3,168,0,0,3,168,1.132879000,0.0001
231.140.151.20,<->,136.25.188.253,0,0,3,150,3,150,1.132311000,0.0039
215.158.239.77,<->,199.20.31.37,3,168,0,0,3,168,1.132289000,0.3605
215.158.239.87,<->,199.68.207.61,3,242,0,0,3,242,1.132220000,0.7170
125.211.116.201,<->,92.27.219.178,0,0,3,156,3,156,1.132180000,0.3817
207.58.49.250,<->,136.25.188.175,0,0,3,150,3,150,1.131491000,0.1948
220.39.233.208,<->,136.25.188.46,0,0,3,1550,3,1550,1.130420000,0.7457
100.228.42.160,<->,56.109.10.125,3,821,0,0,3,821,1.129218000,0.1152
215.158.239.56,<->,195.54.55.145,3,150,0,0,3,150,1.129008000,0.7790
215.158.239.50,<->,204.58.46.87,3,381,0,0,3,381,1.128636000,0.7236
195.70.106.10,<->,136.25.188.255,0,0,3,150,3,150,1.128335000,0.0015
136.25.189.55,<->,96.156.169.165,3,2829,0,0,3,2829,1.128318000,0.0034
231.142.252.179,<->,136.25.188.178,0,0,3,150,3,150,1.127515000,0.0026
143.135.228.52,<->,136.25.188.225,0,0,3,150,3,150,1.127299000,0.0030
136.25.188.208,<->,122.159.245.165,3,1245,0,0,3,1245,1.127263000,0.2237
215.158.238.92,<->,192.226.44.91,3,1341,0,0,3,1341,1.127150000,0.0261
215.158.239.18,<->,29.211.5.201,3,1584,0,0,3,1584,1.126636000,0.2515
111.2.157.67,<->,8.182.226.78,0,0,3,1780,3,1780,1.126009000,0.7029
203.114.88.175,<->,136.25.188.162,0,0,3,2343,3,2343,1.125935000,0.6801
215.158.238.239,<->,8.219.186.187,3,2789,0,0,3,2789,1.125832000,0.0625
195.41.154.208,<->,136.25.188.254,0,0,3,168,3,168,1.125332000,0.0027
50.224.76.234,<->,33.78.89.163,3,4392,0,0,3,4392,1.122933000,0.7315
136.25.189.80,<->,29.213.219.59,3,2706,0,0,3,2706,1.122240000,0.7533
204.2.220.186,<->,136.25.188.52,0,0,3,150,3,150,1.121512000,0.0028
247.136.132.244,<->,109.219.207.11,3,475,0,0,3,475,1.121052000,0.1399
215.158.239.85,<->,199.20.6.101,3,244,0,0,3,244,1.120712000,0.0287
139.193.141.139,<->,119.45.23.69,3,2036,0,0,3,2036,1.120456000,0.3122
136.25.189.31,<->,29.209.59.215,3,1389,0,0,3,1389,1.119997000,0.1132
249.229.106.211,<->,8.52.148.157,0,0,3,150,3,150,1.119442000,0.0002
231.140.223.134,<->,136.25.188.174,0,0,3,722,3,722,1.119311000,0.5064
215.158.239.57,<->,143.13.147.87,3,168,0,0,3,168,1.118922000,0.0375
136.25.188.242,<->,30.73.149.65,3,677,0,0,3,677,1.117706000,0.5425
215.158.239.95,<->,196.104.53.46,3,726,0,0,3,726,1.116773000,0.4409
220.20.200.85,<->,119.45.80.77,3,465,0,0,3,465,1.116032000,0.1333
192.204.170.214,<->,136.25.188.160,0,0,3,2706,3,2706,1.115906000,0.7563
203.116.21.200,<->,136.25.188.239,0,0,3,264,3,264,1.115736000,0.8802
198.204.76.252,<->,133.178.226.30,0,0,3,168,3,168,1.112458000,0.0002
207.63.96.194,<->,136.25.188.220,0,0,3,150,3,150,1.110964000,0.0057
202.33.232.35,<->,136.25.188.236,0,0,3,983,3,983,1.110623000,0.3001
204.60.99.48,<->,136.25.188.163,0,0,3,490,3,490,1.109262000,0.7599
207.173.33.151,<->,136.25.188.198,0,0,3,168,3,168,1.105895000,0.0102
215.158.61.243,<->,8.176.8.201,0,0,3,541,3,541,1.103160000,0.6920
136.25.188.176,<->,131.1.253.244,3,1469,0,0,3,1469,1.101953000,0.1905
215.158.61.191,<->,8.176.8.236,0,0,3,3869,3,3869,1.100553000,0.0000
215.158.239.35,<->,8.222.97.69,3,1655,0,0,3,1655,1.099840000,0.1096
56.121.53.122,<->,17.199.155.30,3,555,0,0,3,555,1.095486000,0.0740
215.158.238.162,<->,111.151.142.216,3,168,0,0,3,168,1.095467000,0.0001
215.158.239.56,<->,195.43.91.147,3,630,0,0,3,630,1.095324000,0.7225
214.237.191.234,<->,8.43.215.120,0,0,3,156,3,156,1.095027000,0.1104
252.64.251.36,<->,80.27.157.123,0,0,3,1711,3,1711,1.094721000,0.0788
152.139.178.132,<->,98.236.194.252,0,0,3,150,3,150,1.092282000,0.0006
143.23.179.141,<->,136.25.188.220,0,0,3,150,3,150,1.092063000,0.6063
235.38.54.55,<->,92.27.27.169,0,0,3,156,3,156,1.091307000,0.6078
215.158.239.79,<->,195.127.211.141,3,371,0,0,3,371,1.089682000,0.3075
199.69.149.135,<->,136.25.188.177,0,0,3,150,3,150,1.089575000,0.0055
215.158.238.59,<->,8.222.109.124,3,2974,0,0,3,2974,1.088922000,0.8364
138.98.214.132,<->,0.47.133.39,3,168,0,0,3,168,1.088609000,0.0546
215.158.239.49,<->,199.80.85.234,3,371,0,0,3,371,1.086309000,0.3559
202.33.46.188,<->,136.25.188.236,0,0,3,244,3,244,1.085835000,0.0001
204.60.160.33,<->,136.25.188.227,0,0,3,231,3,231,1.085183000,0.5009
207.236.28.188,<->,136.25.188.209,0,0,3,244,3,244,1.084716000,0.0034
195.68.98.34,<->,136.25.188.176,0,0,3,168,3,168,1.084196000,0.1190
136.25.189.18,<->,57.227.83.183,3,1469,0,0,3,1469,1.083240000,0.1655
215.158.239.56,<->,142.229.93.245,3,184,0,0,3,184,1.082750000,0.8389
215.158.239.76,<->,199.20.4.129,3,204,0,0,3,204,1.082397000,0.2203
133.178.227.24,<->,126.219.60.234,3,1373,0,0,3,1373,1.080675000,0.1655
215.158.239.56,<->,196.1.169.142,3,180,0,0,3,180,1.080327000,0.0398
215.158.238.194,<->,8.219.184.144,3,1741,0,0,3,1741,1.078884000,0.1819
195.68.61.79,<->,136.25.188.177,0,0,3,168,3,168,1.078871000,0.0406
215.158.239.56,<->,199.15.230.38,3,360,0,0,3,360,1.078637000,0.6359
148.180.169.155,<->,92.27.219.19,0,0,3,156,3,156,1.078302000,0.2427
246.253.217.210,<->,130.77.96.33,3,1972,0,0,3,1972,1.077668000,0.3771
195.40.209.59,<->,136.25.188.255,0,0,3,360,3,360,1.077663000,0.2599
159.186.156.164,<->,8.182.241.94,0,0,3,162,3,162,1.077306000,0.0080
136.25.188.163,<->,8.217.44.53,3,2626,0,0,3,2626,1.077277000,0.4806
144.87.238.91,<->,8.252.221.171,0,0,3,1657,3,1657,1.077249000,0.0235
215.158.238.75,<->,113.23.117.95,3,1405,0,0,3,1405,1.075591000,0.4951
215.158.239.95,<->,133.146.0.198,3,2642,0,0,3,2642,1.074157000,0.0723
215.158.140.74,<->,83.252.34.178,3,150,0,0,3,150,1.073894000,0.0534
143.10.35.111,<->,136.25.188.160,0,0,3,150,3,150,1.072763000,0.2134
133.178.226.31,<->,8.252.210.160,3,2770,0,0,3,2770,1.071649000,0.7680
112.109.130.103,<->,8.228.218.37,0,0,3,156,3,156,1.070761000,0.3708
142.166.6.171,<->,136.25.188.220,0,0,3,716,3,716,1.070183000,0.1996
215.158.239.58,<->,196.106.156.147,3,168,0,0,3,168,1.070130000,0.0001
133.178.226.168,<->,111.151.109.32,3,168,0,0,3,168,1.068886000,0.0001
92.27.27.173,<->,48.109.17.12,3,156,0,0,3,156,1.066955000,0.4175
80.27.102.65,<->,8.252.222.63,0,0,3,244,3,244,1.065195000,0.0030
215.158.61.189,<->,8.176.8.253,0,0,3,914,3,914,1.064377000,0.1596
215.158.239.96,<->,207.61.197.99,3,168,0,0,3,168,1.063821000,0.0056
111.14.224.120,<->,8.182.251.218,0,0,3,150,3,150,1.063536000,0.0032
215.158.238.105,<->,143.20.121.130,3,1197,0,0,3,1197,1.062163000,0.5438
26.222.236.29,<->,8.220.177.81,0,0,3,504,3,504,1.062115000,0.2982
156.165.37.86,<->,136.25.189.82,0,0,3,1437,3,1437,1.062096000,0.2266
129.92.117.26,<->,53.240.94.87,3,538,0,0,3,538,1.062081000,0.0533
143.79.29.191,<->,136.25.188.46,0,0,3,532,3,532,1.061909000,0.3794
148.26.113.56,<->,136.25.189.82,0,0,3,1213,3,1213,1.061884000,0.2234
136.116.9.106,<->,50.224.80.67,0,0,3,510,3,510,1.060999000,0.0754
101.70.127.164,<->,53.209.248.108,3,891,0,0,3,891,1.058867000,0.0421
143.132.89.47,<->,136.25.188.238,0,0,3,192,3,192,1.058152000,0.6812
136.25.188.47,<->,120.20.132.38,3,1357,0,0,3,1357,1.057681000,0.2825
133.32.39.9,<->,29.209.14.231,3,852,0,0,3,852,1.057000000,0.7510
195.13.141.187,<->,136.25.188.242,0,0,3,285,3,285,1.056241000,0.0505
204.187.170.223,<->,136.25.188.252,0,0,3,288,3,288,1.055892000,0.7387
215.158.239.85,<->,195.70.20.91,3,184,0,0,3,184,1.055585000,0.8783
192.171.13.35,<->,8.176.8.237,0,0,3,622,3,622,1.054663000,0.0037
136.25.189.32,<->,61.35.70.234,3,2610,0,0,3,2610,1.053251000,0.9377
196.204.103.233,<->,136.25.188.177,0,0,3,877,3,877,1.052809000,0.2152
230.156.243.220,<->,8.252.222.158,0,0,3,189,3,189,1.052384000,0.0011
254.95.204.215,<->,139.193.141.139,0,0,3,1778,3,1778,1.051647000,0.2645
215.158.238.142,<->,131.36.198.50,3,1571,0,0,3,1571,1.049843000,0.2621
136.25.189.13,<->,114.166.219.8,3,1485,0,0,3,1485,1.049589000,0.1071
215.158.140.60,<->,201.211.113.33,3,1254,0,0,3,1254,1.049112000,0.4005
138.127.224.225,<->,101.224.89.251,0,0,3,729,3,729,1.048089000,0.0010
129.224.112.252,<->,27.127.251.61,3,237,0,0,3,237,1.046781000,0.0057
215.158.238.66,<->,118.20.101.16,3,1069,0,0,3,1069,1.046658000,0.1306
207.72.124.93,<->,8.252.222.243,0,0,3,162,3,162,1.046033000,0.0022
215.158.239.85,<->,199.20.30.176,3,409,0,0,3,409,1.045157000,0.4703
127.182.106.91,<->,109.1.16.242,0,0,3,156,3,156,1.044009000,0.3220
195.54.52.61,<->,136.25.188.163,0,0,3,244,3,244,1.043649000,0.0040
199.81.182.147,<->,136.25.188.52,0,0,3,199,3,199,1.043194000,0.1468
215.158.61.183,<->,8.176.8.210,0,0,3,541,3,541,1.042991000,0.5865
215.158.61.243,<->,8.176.8.206,0,0,3,2116,3,2116,1.042417000,0.9167
133.178.227.16,<->,80.47.152.229,3,1277,0,0,3,1277,1.042167000,0.1895
215.158.239.114,<->,82.112.3.187,3,1741,0,0,3,1741,1.041756000,0.0031
192.67.158.190,<->,56.13.192.154,3,901,0,0,3,901,1.040462000,0.0067
215.158.238.236,<->,158.85.50.170,3,1209,0,0,3,1209,1.039524000,0.2516
246.253.169.16,<->,97.19.22.19,3,150,0,0,3,150,1.038734000,0.2661
129.224.112.252,<->,27.127.251.31,3,236,0,0,3,236,1.038191000,0.0075
199.50.155.121,<->,136.25.188.239,0,0,3,168,3,168,1.037761000,0.0032
136.25.189.34,<->,96.156.169.229,3,1645,0,0,3,1645,1.037690000,0.0221
199.82.206.205,<->,136.25.188.176,0,0,3,156,3,156,1.036615000,0.1412
138.98.214.132,<->,38.88.109.17,3,609,0,0,3,609,1.036319000,0.7552
142.206.236.158,<->,136.25.188.222,0,0,3,150,3,150,1.036008000,0.0039
220.55.116.0,<->,84.214.213.6,3,786,0,0,3,786,1.033781000,0.1333
215.158.239.78,<->,199.20.28.86,3,277,0,0,3,277,1.033736000,0.4290
215.158.239.69,<->,192.171.32.154,3,1293,0,0,3,1293,1.032764000,0.3095
142.220.62.73,<->,136.25.188.52,0,0,3,150,3,150,1.032204000,0.0034
142.249.254.162,<->,136.25.188.220,0,0,3,168,3,168,1.031607000,0.0369
142.220.234.65,<->,136.25.188.162,0,0,3,150,3,150,1.031369000,0.9134
215.158.239.70,<->,199.20.28.249,3,722,0,0,3,722,1.030191000,0.4910
195.4.254.231,<->,136.25.188.53,0,0,3,156,3,156,1.029520000,0.2092
199.68.160.136,<->,136.25.188.55,0,0,3,162,3,162,1.029189000,0.8187
215.202.175.5,<->,8.252.222.211,0,0,3,1341,3,1341,1.027744000,0.2879
215.158.140.231,<->,48.131.159.0,3,2546,0,0,3,2546,1.027181000,0.9082
143.42.56.226,<->,136.25.188.45,0,0,3,150,3,150,1.026882000,0.0056
215.158.239.58,<->,195.49.130.151,3,873,0,0,3,873,1.025989000,0.1985
199.50.78.127,<->,136.25.188.220,0,0,3,162,3,162,1.025988000,0.9506
133.178.226.31,<->,57.210.107.9,3,1309,0,0,3,1309,1.025567000,0.3174
97.223.146.236,<->,92.27.27.175,0,0,3,161,3,161,1.025077000,0.1414
97.41.242.133,<->,48.54.85.219,0,0,3,255,3,255,1.024779000,0.0044
215.158.239.76,<->,196.91.44.119,3,199,0,0,3,199,1.024426000,0.5219
97.182.7.16,<->,8.52.181.95,0,0,3,466,3,466,1.022786000,0.4577
215.158.140.85,<->,122.29.159.29,3,1894,0,0,3,1894,1.022520000,0.1463
199.68.169.72,<->,136.25.188.178,0,0,3,150,3,150,1.021427000,0.7722
138.127.224.225,<->,101.224.89.222,0,0,3,726,3,726,1.020792000,0.0040
210.220.219.182,<->,50.239.19.179,3,1122,0,0,3,1122,1.018986000,0.0377
239.66.109.147,<->,220.55.72.216,0,0,3,533,3,533,1.018154000,0.1172
92.27.27.144,<->,78.55.151.222,3,249,0,0,3,249,1.017050000,0.9047
131.45.239.178,<->,92.162.253.34,0,0,3,444,3,444,1.016766000,0.1003
192.229.216.117,<->,112.68.84.214,3,156,0,0,3,156,1.014758000,0.1369
215.158.239.78,<->,57.247.184.202,3,1405,0,0,3,1405,1.014520000,0.1336
215.158.195.39,<->,111.151.109.36,3,168,0,0,3,168,1.012903000,0.5600
220.20.200.141,<->,144.83.60.153,3,2117,0,0,3,2117,1.012445000,0.1217
90.240.3.223,<->,54.37.192.99,3,336,0,0,3,336,1.012240000,0.7398
247.136.154.209,<->,88.156.22.45,3,234,0,0,3,234,1.012043000,0.4902
215.158.61.182,<->,8.176.8.232,0,0,3,4157,3,4157,1.011044000,0.0000
204.185.26.120,<->,136.25.188.162,0,0,3,490,3,490,1.010815000,0.7001
194.232.162.50,<->,136.25.188.178,0,0,3,244,3,244,1.010248000,0.0037
202.33.192.45,<->,136.25.188.220,0,0,3,199,3,199,1.009354000,0.2800
140.68.13.66,<->,8.252.222.29,0,0,3,168,3,168,1.009013000,0.0000
215.158.239.68,<->,142.229.119.236,3,502,0,0,3,502,1.007979000,0.8936
193.23.0.8,<->,89.183.104.188,0,0,3,156,3,156,1.006680000,0.8609
197.103.151.87,<->,133.178.226.37,0,0,3,1485,3,1485,1.005946000,0.2635
136.25.188.174,<->,112.220.206.117,3,1293,0,0,3,1293,1.002813000,0.2285
215.158.239.113,<->,129.222.39.146,3,1025,0,0,3,1025,1.002397000,0.0230
136.25.188.175,<->,69.31.238.203,3,1453,0,0,3,1453,1.001189000,0.2544
142.241.238.68,<->,136.25.188.55,0,0,3,168,3,168,1.000303000,0.0057
194.233.126.136,<->,136.25.188.226,0,0,3,722,3,722,1.000277000,0.6514
207.12.133.19,<->,92.27.194.147,0,0,3,365,3,365,1.000181000,0.7562
204.21.9.178,<->,136.25.188.46,0,0,3,150,3,150,1.000062000,0.0030
204.130.115.166,<->,8.252.223.175,0,0,3,1170,3,1170,0.999293000,0.1494
101.70.118.242,<->,54.48.33.198,3,845,0,0,3,845,0.999051000,0.0466
215.158.239.56,<->,199.121.65.88,3,360,0,0,3,360,0.998375000,0.0405
144.86.151.244,<->,92.162.221.160,3,605,0,0,3,605,0.997826000,0.1408
215.158.238.132,<->,112.235.95.75,3,1341,0,0,3,1341,0.996472000,0.1786
215.158.239.70,<->,8.249.253.226,3,1325,0,0,3,1325,0.993920000,0.1373
192.65.42.219,<->,8.55.195.24,3,199,0,0,3,199,0.993465000,0.0715
207.62.17.82,<->,136.25.188.177,0,0,3,156,3,156,0.992140000,0.2782
200.174.218.8,<->,53.214.117.149,3,1302,0,0,3,1302,0.991528000,0.2887
199.111.215.20,<->,8.182.235.164,0,0,3,426,3,426,0.990877000,0.3039
215.158.238.141,<->,38.206.2.171,3,1693,0,0,3,1693,0.990680000,0.2761
136.25.189.86,<->,96.156.169.209,3,2532,0,0,3,2532,0.989731000,0.0775
215.158.239.32,<->,106.188.184.98,3,1626,0,0,3,1626,0.989544000,0.0265
215.158.238.95,<->,192.229.40.91,3,1197,0,0,3,1197,0.989462000,0.0491
133.178.227.195,<->,111.151.106.231,3,168,0,0,3,168,0.988421000,0.0001
139.193.141.200,<->,131.160.156.25,3,168,0,0,3,168,0.986839000,0.1452
215.158.239.56,<->,199.20.28.245,3,184,0,0,3,184,0.986692000,0.8706
215.158.239.59,<->,207.213.166.22,3,168,0,0,3,168,0.986061000,0.0000
204.184.53.139,<->,136.25.188.53,0,0,3,212,3,212,0.986005000,0.1191
101.70.96.205,<->,91.40.92.170,3,1604,0,0,3,1604,0.985911000,0.0430
215.158.238.73,<->,193.39.70.0,3,1325,0,0,3,1325,0.985243000,0.1492
215.158.239.50,<->,199.82.206.81,3,722,0,0,3,722,0.984825000,0.5711
215.158.239.56,<->,199.20.31.169,3,213,0,0,3,213,0.984371000,0.7751
215.158.239.26,<->,111.151.109.27,3,168,0,0,3,168,0.983320000,0.0000
143.148.128.142,<->,0.195.210.46,0,0,3,1308,3,1308,0.982615000,0.9851
199.27.21.253,<->,8.220.189.63,0,0,3,150,3,150,0.982593000,0.3142
136.116.28.246,<->,89.64.114.178,3,176,0,0,3,176,0.982220000,0.0452
215.158.238.80,<->,29.211.186.217,3,1453,0,0,3,1453,0.981791000,0.1983
215.158.239.51,<->,199.20.28.249,3,722,0,0,3,722,0.981675000,0.4112
136.25.188.163,<->,126.219.194.99,3,2847,0,0,3,2847,0.979860000,0.7804
111.20.172.70,<->,33.233.141.86,0,0,3,335,3,335,0.979061000,1.0016
195.68.58.205,<->,136.25.188.46,0,0,3,199,3,199,0.978034000,0.7400
111.151.106.208,<->,6.73.247.11,0,0,3,168,3,168,0.975386000,0.0000
215.158.239.33,<->,8.255.92.103,3,1460,0,0,3,1460,0.973745000,0.0841
215.158.238.91,<->,145.116.209.76,3,626,0,0,3,626,0.973014000,0.0229
197.56.186.90,<->,8.252.222.150,0,0,3,168,3,168,0.972434000,0.1683
142.255.231.173,<->,136.25.188.255,0,0,3,150,3,150,0.968486000,0.1323
48.17.250.202,<->,8.252.222.36,0,0,3,168,3,168,0.968312000,0.6799
215.158.239.18,<->,29.214.205.38,3,1452,0,0,3,1452,0.967284000,0.2479
199.82.220.187,<->,136.25.188.242,0,0,3,244,3,244,0.967137000,0.0034
215.158.239.86,<->,195.40.124.55,3,244,0,0,3,244,0.966074000,0.0037
215.158.238.23,<->,8.252.214.239,3,1341,0,0,3,1341,0.963987000,0.0522
215.158.238.25,<->,8.222.109.85,3,1533,0,0,3,1533,0.963209000,0.7938
215.158.239.93,<->,207.114.77.109,3,366,0,0,3,366,0.961999000,0.5403
199.52.92.40,<->,136.25.188.226,0,0,3,170,3,170,0.961861000,0.2122
143.14.191.92,<->,136.25.189.80,0,0,3,1433,3,1433,0.961660000,0.2389
149.96.171.17,<->,136.25.189.77,0,0,3,2658,3,2658,0.961296000,1.0283
54.37.173.208,<->,8.228.215.157,0,0,3,514,3,514,0.960284000,0.1018
215.158.140.14,<->,111.150.207.113,3,168,0,0,3,168,0.959893000,0.0001
141.24.62.195,<->,100.228.42.88,0,0,3,837,3,837,0.959726000,0.4508
207.200.195.90,<->,8.252.222.220,0,0,3,162,3,162,0.959422000,0.0002
215.158.239.101,<->,129.222.36.132,3,221,0,0,3,221,0.958216000,0.0213
133.178.227.135,<->,80.47.104.142,3,2238,0,0,3,2238,0.958139000,0.2895
142.255.231.173,<->,136.25.188.237,0,0,3,150,3,150,0.958045000,0.1722
142.228.71.173,<->,136.25.188.198,0,0,3,150,3,150,0.956742000,0.0027
75.214.65.176,<->,8.252.221.204,0,0,3,556,3,556,0.954509000,0.2952
215.158.61.183,<->,8.176.8.250,0,0,3,510,3,510,0.954487000,1.0403
136.25.189.28,<->,112.220.198.85,3,1405,0,0,3,1405,0.954248000,0.1796
64.104.131.193,<->,58.43.188.27,3,826,0,0,3,826,0.954037000,0.6249
139.193.141.139,<->,82.150.219.116,3,1778,0,0,3,1778,0.953517000,0.1206
139.249.88.87,<->,53.214.108.121,3,316,0,0,3,316,0.952934000,0.1608
215.158.238.123,<->,131.2.115.246,3,1341,0,0,3,1341,0.952624000,0.6119
215.158.239.56,<->,207.191.82.117,3,168,0,0,3,168,0.952292000,0.0205
215.158.239.57,<->,196.106.97.237,3,752,0,0,3,752,0.951455000,0.3517
148.129.19.215,<->,136.25.188.221,0,0,3,1437,3,1437,0.950557000,0.1235
142.191.20.120,<->,136.25.188.163,0,0,3,168,3,168,0.950439000,0.0027
215.158.239.48,<->,196.0.148.196,3,192,0,0,3,192,0.950436000,1.0401
215.158.239.58,<->,204.0.200.16,3,186,0,0,3,186,0.949901000,1.0026
215.158.238.154,<->,145.234.121.19,3,2392,0,0,3,2392,0.948768000,0.0008
215.158.239.77,<->,199.20.31.164,3,1141,0,0,3,1141,0.948492000,0.6160
199.73.34.17,<->,136.25.188.44,0,0,3,722,3,722,0.948169000,0.7248
80.53.19.114,<->,8.52.185.0,0,0,3,168,3,168,0.946058000,0.0512
195.55.54.192,<->,136.25.188.241,0,0,3,150,3,150,0.945964000,0.0047
139.193.141.139,<->,50.74.34.51,3,1906,0,0,3,1906,0.943024000,0.2854
116.146.253.37,<->,92.27.219.234,0,0,3,156,3,156,0.942837000,0.5610
218.5.22.135,<->,100.228.42.201,0,0,3,669,3,669,0.942809000,0.4648
215.158.239.94,<->,149.184.89.90,3,1421,0,0,3,1421,0.939890000,0.1762
192.67.176.62,<->,26.218.94.114,3,253,0,0,3,253,0.939382000,0.2936
215.158.239.16,<->,8.255.92.138,3,1138,0,0,3,1138,0.938756000,0.0345
215.158.61.191,<->,8.176.8.179,0,0,3,2567,3,2567,0.936534000,0.9374
215.158.239.93,<->,199.15.120.211,3,628,0,0,3,628,0.933620000,0.2540
101.70.127.164,<->,53.209.60.99,3,852,0,0,3,852,0.933446000,0.0441
111.150.207.71,<->,8.252.221.233,0,0,3,168,3,168,0.933331000,0.0001
199.51.155.35,<->,136.25.188.252,0,0,3,150,3,150,0.932809000,0.0018
137.129.3.188,<->,58.43.188.12,3,579,0,0,3,579,0.932777000,0.1907
54.37.192.99,<->,48.53.252.223,0,0,3,278,3,278,0.931377000,0.1681
215.158.239.70,<->,207.16.32.235,3,193,0,0,3,193,0.929415000,0.1896
215.158.140.241,<->,126.219.100.200,3,2344,0,0,3,2344,0.928995000,0.3151
142.208.100.154,<->,136.25.188.241,0,0,3,722,3,722,0.928647000,0.9543
80.27.155.30,<->,75.94.79.196,3,2527,0,0,3,2527,0.928631000,0.8320
129.225.135.203,<->,129.225.132.224,0,0,3,197,3,197,0.927834000,0.0255
215.158.238.82,<->,106.188.252.178,3,199,0,0,3,199,0.927700000,0.0981
215.158.239.113,<->,129.222.39.214,3,221,0,0,3,221,0.926488000,0.0213
133.178.226.7,<->,131.2.115.245,3,1453,0,0,3,1453,0.926414000,0.1462
215.158.140.172,<->,143.12.213.138,3,162,0,0,3,162,0.926372000,0.8200
136.25.188.222,<->,100.201.78.45,3,168,0,0,3,168,0.925879000,0.0012
133.178.227.14,<->,29.211.165.34,3,1405,0,0,3,1405,0.925608000,0.1528
210.229.230.22,<->,35.63.66.82,3,174,0,0,3,174,0.924769000,0.3893
112.38.205.206,<->,92.168.217.253,0,0,3,168,3,168,0.924554000,0.1013
142.217.227.155,<->,50.223.3.228,0,0,3,168,3,168,0.922992000,0.7581
255.133.225.38,<->,255.133.225.23,0,0,3,279,3,279,0.922748000,0.6395
215.158.239.78,<->,140.218.109.107,3,1325,0,0,3,1325,0.921746000,0.2214
196.89.195.65,<->,136.25.188.226,0,0,3,722,3,722,0.920798000,0.6793
204.34.19.221,<->,100.95.230.73,0,0,3,253,3,253,0.920228000,0.6262
195.55.62.182,<->,136.25.188.242,0,0,3,150,3,150,0.920052000,0.0030
109.222.222.94,<->,53.239.138.128,3,306,0,0,3,306,0.918512000,0.3850
215.158.239.79,<->,207.63.234.76,3,252,0,0,3,252,0.917601000,0.7985
195.14.224.37,<->,136.25.188.160,0,0,3,877,3,877,0.917148000,0.6831
195.41.102.103,<->,136.25.188.242,0,0,3,150,3,150,0.917143000,0.0032
243.117.107.172,<->,80.38.1.52,0,0,3,1107,3,1107,0.916853000,0.1181
54.36.210.180,<->,48.53.34.115,0,0,3,234,3,234,0.916171000,0.4500
215.158.239.33,<->,137.129.85.91,3,1252,0,0,3,1252,0.915963000,0.1854
17.245.1.120,<->,8.220.239.104,0,0,3,175,3,175,0.915560000,0.0281
38.81.154.202,<->,8.52.182.119,0,0,3,377,3,377,0.915454000,0.5435
215.158.239.71,<->,113.23.14.217,3,1485,0,0,3,1485,0.915319000,0.1320
215.158.238.74,<->,126.219.60.202,3,1405,0,0,3,1405,0.915137000,0.1676
204.184.134.252,<->,136.25.188.53,0,0,3,162,3,162,0.915085000,0.0302
142.248.105.238,<->,136.25.188.252,0,0,3,175,3,175,0.914173000,0.2188
143.155.227.57,<->,136.25.188.237,0,0,3,1501,3,1501,0.912959000,0.1800
199.14.203.234,<->,136.25.188.173,0,0,3,726,3,726,0.912763000,0.4051
156.150.35.85,<->,8.252.222.60,0,0,3,168,3,168,0.911417000,0.0006
8.252.223.153,<->,8.219.184.100,3,1214,0,0,3,1214,0.909606000,0.0979
235.42.34.11,<->,215.158.238.93,0,0,3,1165,3,1165,0.908582000,0.1222
215.158.239.59,<->,141.199.76.240,3,1469,0,0,3,1469,0.906230000,0.2203
231.136.119.179,<->,136.25.188.253,0,0,3,176,3,176,0.905367000,0.4599
242.21.107.132,<->,139.193.141.139,0,0,3,1869,3,1869,0.904963000,0.2296
142.228.169.90,<->,136.25.188.252,0,0,3,667,3,667,0.904293000,0.4864
207.60.99.227,<->,136.25.188.254,0,0,3,150,3,150,0.903646000,0.0009
204.186.76.153,<->,136.25.188.253,0,0,3,360,3,360,0.903398000,0.9296
132.18.67.27,<->,102.231.177.130,0,0,3,480,3,480,0.902922000,0.0493
199.80.208.98,<->,136.25.188.162,0,0,3,150,3,150,0.902268000,0.2370
215.158.239.69,<->,196.89.124.85,3,168,0,0,3,168,0.899786000,0.7701
92.27.219.190,<->,78.46.255.104,3,4290,0,0,3,4290,0.898022000,0.9008
215.158.238.81,<->,126.219.196.185,3,2402,0,0,3,2402,0.897665000,1.0206
102.244.221.223,<->,89.183.104.234,0,0,3,166,3,166,0.895138000,0.7007
199.38.203.99,<->,136.25.188.53,0,0,3,225,3,225,0.894855000,0.3119
215.158.238.113,<->,29.211.186.199,3,1453,0,0,3,1453,0.893300000,0.2245
215.158.239.32,<->,8.190.216.229,3,1442,0,0,3,1442,0.892908000,0.0402
210.220.219.151,<->,50.239.31.210,3,168,0,0,3,168,0.892167000,0.4667
139.160.226.212,<->,136.25.189.57,0,0,3,1469,3,1469,0.891238000,0.0964
210.220.219.153,<->,53.224.63.119,3,258,0,0,3,258,0.889953000,0.8085
215.158.239.93,<->,207.191.5.77,3,1131,0,0,3,1131,0.889595000,0.1397
195.14.248.228,<->,136.25.188.44,0,0,3,244,3,244,0.889219000,0.0035
202.33.33.176,<->,136.25.188.240,0,0,3,199,3,199,0.888906000,0.8400
215.158.239.85,<->,122.52.97.61,3,1357,0,0,3,1357,0.888745000,0.1320
208.67.25.244,<->,74.237.50.175,3,198,0,0,3,198,0.888359000,0.2301
142.241.62.232,<->,136.25.188.196,0,0,3,150,3,150,0.887712000,0.0164
202.33.61.112,<->,136.25.188.252,0,0,3,370,3,370,0.887249000,1.0261
104.148.85.199,<->,92.27.219.192,0,0,3,156,3,156,0.886613000,0.9034
137.21.23.51,<->,8.204.75.19,3,176,0,0,3,176,0.886513000,0.0692
80.42.183.31,<->,29.204.172.105,3,156,0,0,3,156,0.886357000,0.4216
215.158.239.76,<->,149.254.114.243,3,1469,0,0,3,1469,0.885475000,0.1332
133.178.227.151,<->,56.1.237.247,3,164,0,0,3,164,0.884539000,0.0213
142.182.77.110,<->,136.25.188.54,0,0,3,150,3,150,0.884328000,0.0030
133.178.227.41,<->,131.219.230.192,3,1501,0,0,3,1501,0.884098000,0.1161
136.25.188.253,<->,72.23.194.203,3,1341,0,0,3,1341,0.883917000,0.2625
215.158.61.189,<->,136.25.188.35,0,0,3,1618,3,1618,0.883657000,0.8637
215.158.239.57,<->,199.20.30.178,3,288,0,0,3,288,0.883151000,0.6825
215.158.238.66,<->,198.204.76.255,3,199,0,0,3,199,0.882279000,0.1480
215.158.239.94,<->,130.150.82.120,3,1437,0,0,3,1437,0.882145000,0.1203
215.158.239.79,<->,204.2.235.161,3,168,0,0,3,168,0.881287000,0.0663
204.56.106.117,<->,136.25.188.54,0,0,3,330,3,330,0.881129000,0.4083
215.158.238.99,<->,149.96.53.40,3,1325,0,0,3,1325,0.878885000,0.1914
197.113.99.203,<->,136.25.188.173,0,0,3,260,3,260,0.878661000,0.6720
200.174.122.61,<->,53.214.103.50,3,1079,0,0,3,1079,0.875996000,0.2869
194.232.1.138,<->,136.25.188.176,0,0,3,150,3,150,0.875538000,0.0030
215.158.239.56,<->,207.228.237.157,3,150,0,0,3,150,0.875009000,0.0005
143.134.36.86,<->,136.25.188.237,0,0,3,244,3,244,0.874962000,0.0033
195.4.114.173,<->,136.25.188.253,0,0,3,244,3,244,0.874537000,0.0053
215.158.239.56,<->,199.20.4.171,3,204,0,0,3,204,0.873049000,0.7232
195.71.91.148,<->,136.25.188.209,0,0,3,150,3,150,0.871273000,0.0030
195.13.81.172,<->,136.25.188.239,0,0,3,168,3,168,0.871146000,0.0017
215.158.238.74,<->,133.73.194.9,3,1453,0,0,3,1453,0.870738000,0.0264
195.43.4.73,<->,136.25.188.226,0,0,3,244,3,244,0.869265000,0.0046
215.158.239.96,<->,143.99.76.222,3,180,0,0,3,180,0.869106000,0.8601
148.88.91.35,<->,139.193.141.139,0,0,3,2090,3,2090,0.868437000,0.1883
215.158.238.241,<->,119.168.0.234,3,1219,0,0,3,1219,0.868366000,0.1488
98.129.16.75,<->,50.224.75.42,0,0,3,164,3,164,0.867939000,1.0581
215.158.238.73,<->,106.188.183.73,3,1682,0,0,3,1682,0.867938000,0.0238
97.178.252.77,<->,8.250.158.144,0,0,3,766,3,766,0.865775000,1.1120
215.158.238.148,<->,126.219.132.243,3,1309,0,0,3,1309,0.865754000,0.2324
220.55.113.152,<->,92.27.131.90,3,331,0,0,3,331,0.865085000,0.0202
131.23.80.188,<->,97.198.104.142,0,0,3,150,3,150,0.861819000,0.0405
204.62.41.84,<->,136.25.188.196,0,0,3,199,3,199,0.859958000,0.2298
133.135.213.14,<->,129.6.83.11,0,0,3,4061,3,4061,0.859957000,0.0000
215.158.238.107,<->,148.217.121.141,3,1309,0,0,3,1309,0.859649000,0.6192
215.158.239.78,<->,194.199.207.228,3,244,0,0,3,244,0.859539000,0.0012
136.25.188.40,<->,80.56.246.231,3,1302,0,0,3,1302,0.859070000,0.8983
194.208.223.87,<->,80.40.61.86,0,0,3,234,3,234,0.858951000,0.5938
142.236.239.188,<->,136.25.188.163,0,0,3,168,3,168,0.858210000,0.0036
215.158.239.48,<->,195.55.151.85,3,667,0,0,3,667,0.857569000,1.0342
212.153.120.119,<->,136.25.188.252,0,0,3,150,3,150,0.856668000,0.0513
136.25.189.31,<->,96.156.169.168,3,1746,0,0,3,1746,0.856364000,0.1225
215.158.239.49,<->,195.4.5.226,3,150,0,0,3,150,0.855000000,0.0032
215.158.239.93,<->,196.91.30.78,3,726,0,0,3,726,0.852721000,0.7200
215.158.239.51,<->,199.20.5.151,3,150,0,0,3,150,0.852605000,0.1477
215.158.238.123,<->,143.14.191.92,3,1341,0,0,3,1341,0.851357000,0.1867
210.229.230.21,<->,98.243.253.100,3,182,0,0,3,182,0.851058000,1.0221
136.25.188.161,<->,6.116.31.20,3,1485,0,0,3,1485,0.850483000,0.0723
215.158.238.141,<->,128.23.84.234,3,1229,0,0,3,1229,0.849878000,0.6010
158.253.43.168,<->,133.178.226.18,0,0,3,1309,3,1309,0.849542000,0.2760
68.75.140.160,<->,8.252.221.223,0,0,3,377,3,377,0.849514000,0.7205
215.158.238.75,<->,143.227.65.157,3,1405,0,0,3,1405,0.849390000,0.3605
197.113.99.204,<->,136.25.188.227,0,0,3,156,3,156,0.849134000,1.1419
144.72.193.220,<->,100.92.137.57,0,0,3,301,3,301,0.847577000,0.0958
215.158.238.221,<->,106.188.251.56,3,1197,0,0,3,1197,0.847201000,0.1033
136.25.189.57,<->,8.47.120.154,3,1453,0,0,3,1453,0.847006000,0.3214
215.158.239.84,<->,196.89.244.164,3,168,0,0,3,168,0.846128000,0.0029
215.158.238.92,<->,119.168.0.138,3,1453,0,0,3,1453,0.845272000,0.2547
145.237.135.90,<->,137.21.23.223,0,0,3,1120,3,1120,0.845131000,1.0035
231.255.222.136,<->,192.64.236.216,0,0,3,675,3,675,0.843401000,0.0029
204.186.92.108,<->,136.25.188.236,0,0,3,199,3,199,0.842793000,0.1498
195.41.218.87,<->,136.25.188.226,0,0,3,856,3,856,0.842694000,0.6180
142.244.205.129,<->,136.25.188.162,0,0,3,156,3,156,0.842450000,0.1956
136.25.189.30,<->,125.84.55.22,3,1341,0,0,3,1341,0.841748000,0.3245
215.158.239.97,<->,199.20.29.7,3,490,0,0,3,490,0.840884000,0.5095
215.158.239.57,<->,199.20.28.189,3,244,0,0,3,244,0.840070000,0.0310
148.21.212.171,<->,136.25.189.81,0,0,3,1453,3,1453,0.839070000,0.1254
210.209.251.211,<->,109.2.43.79,0,0,3,542,3,542,0.836208000,0.3737
204.3.7.235,<->,136.25.188.209,0,0,3,244,3,244,0.834840000,0.0036
195.14.93.102,<->,136.25.188.198,0,0,3,150,3,150,0.834341000,0.0064
215.158.239.69,<->,141.39.23.86,3,1437,0,0,3,1437,0.833825000,0.2782
221.102.56.69,<->,220.80.224.201,0,0,3,192,3,192,0.832630000,0.9169
136.25.189.89,<->,61.35.70.230,3,1485,0,0,3,1485,0.832312000,0.2377
148.31.106.171,<->,136.25.188.253,0,0,3,1325,3,1325,0.830743000,0.1635
144.75.218.235,<->,138.127.224.104,3,925,0,0,3,925,0.829832000,1.0844
113.127.245.199,<->,92.27.219.39,0,0,3,288,3,288,0.829581000,0.7165
246.253.253.207,<->,207.83.86.49,3,455,0,0,3,455,0.828564000,0.4127
215.158.140.75,<->,113.23.56.96,3,2279,0,0,3,2279,0.827455000,0.5368
148.16.160.84,<->,139.193.141.139,0,0,3,1821,3,1821,0.825324000,0.1258
143.87.173.176,<->,136.25.188.46,0,0,3,667,3,667,0.825123000,0.8425
136.25.189.28,<->,56.161.218.20,3,1389,0,0,3,1389,0.823743000,0.0906
215.158.61.145,<->,8.176.8.225,0,0,3,769,3,769,0.822383000,0.8717
215.158.239.40,<->,8.252.253.188,3,1626,0,0,3,1626,0.821828000,0.1297
215.158.238.135,<->,111.150.34.246,3,1485,0,0,3,1485,0.821629000,0.1674
210.220.157.79,<->,136.25.188.178,0,0,3,1485,3,1485,0.821135000,0.1566
202.33.226.132,<->,136.25.188.220,0,0,3,975,3,975,0.821081000,0.4283
97.53.41.61,<->,8.182.245.10,0,0,3,150,3,150,0.820112000,0.0332
199.73.78.31,<->,136.25.188.53,0,0,3,893,3,893,0.819918000,0.6490
136.25.188.161,<->,29.212.43.236,3,1261,0,0,3,1261,0.819468000,0.2015
215.158.239.95,<->,199.82.242.87,3,168,0,0,3,168,0.819110000,0.0017
133.178.226.28,<->,113.23.117.69,3,1437,0,0,3,1437,0.817202000,0.1590
146.188.154.183,<->,92.27.219.145,0,0,3,156,3,156,0.816519000,0.9594
215.158.239.77,<->,204.1.191.90,3,722,0,0,3,722,0.815873000,0.8401
215.158.239.84,<->,195.6.97.133,3,162,0,0,3,162,0.815750000,0.6100
215.158.239.58,<->,199.20.30.33,3,726,0,0,3,726,0.814950000,1.1141
144.87.238.91,<->,8.182.136.93,0,0,3,150,3,150,0.813586000,0.0229
224.93.235.39,<->,80.27.157.204,0,0,3,1437,3,1437,0.813538000,0.4992
136.181.47.203,<->,0.195.216.193,3,487,0,0,3,487,0.812801000,0.0713
133.178.226.60,<->,112.220.206.22,3,1229,0,0,3,1229,0.810797000,0.1529
195.121.135.23,<->,139.193.141.139,0,0,3,1906,3,1906,0.809435000,0.3462
215.158.239.77,<->,199.106.113.244,3,150,0,0,3,150,0.808988000,0.3439
136.25.188.254,<->,112.235.95.5,3,1293,0,0,3,1293,0.807796000,0.2344
148.88.36.236,<->,139.193.141.139,0,0,3,1934,3,1934,0.807737000,0.1379
206.216.71.6,<->,89.183.104.249,0,0,3,306,3,306,0.806255000,0.7619
111.20.172.118,<->,111.20.168.24,0,0,3,1866,3,1866,0.805540000,0.0015
207.20.199.84,<->,0.195.210.44,0,0,3,156,3,156,0.805062000,0.3299
133.178.226.18,<->,131.173.115.10,3,1325,0,0,3,1325,0.804314000,0.3379
215.158.239.84,<->,126.219.60.213,3,1341,0,0,3,1341,0.804186000,0.2488
94.192.201.131,<->,8.252.221.236,0,0,3,150,3,150,0.803708000,0.5601
196.89.228.33,<->,136.25.188.220,0,0,3,156,3,156,0.803563000,0.2489
133.178.226.224,<->,113.188.193.234,3,1500,0,0,3,1500,0.802883000,0.6901
8.52.133.228,<->,4.7.144.163,3,156,0,0,3,156,0.802708000,1.0259
215.158.140.74,<->,83.232.78.125,3,156,0,0,3,156,0.802338000,0.0498
96.236.7.59,<->,8.52.134.84,0,0,3,1067,3,1067,0.801740000,0.7229
139.193.141.139,<->,120.19.84.242,3,1875,0,0,3,1875,0.801654000,0.3147
145.130.205.239,<->,8.182.137.40,0,0,3,1029,3,1029,0.801202000,0.0404
143.94.34.93,<->,136.25.188.196,0,0,3,168,3,168,0.799816000,0.0002
142.229.189.230,<->,136.25.188.174,0,0,3,708,3,708,0.799799000,0.3003
215.158.238.73,<->,128.123.91.58,3,1485,0,0,3,1485,0.798660000,0.5097
101.70.96.248,<->,54.42.184.216,3,407,0,0,3,407,0.798273000,0.0454
142.229.189.230,<->,136.25.188.255,0,0,3,708,3,708,0.797182000,0.2578
8.176.49.169,<->,0.220.255.202,3,175,0,0,3,175,0.795443000,0.0114
100.234.12.141,<->,97.183.194.231,0,0,3,355,3,355,0.794288000,0.0001
215.158.239.93,<->,199.20.31.31,3,192,0,0,3,192,0.792712000,0.6099
144.75.218.242,<->,119.94.225.50,3,427,0,0,3,427,0.791022000,0.2801
142.253.75.50,<->,136.25.188.196,0,0,3,722,3,722,0.789607000,0.5818
247.118.197.173,<->,8.182.226.78,0,0,3,150,3,150,0.787937000,0.3700
142.229.141.107,<->,136.25.188.254,0,0,3,150,3,150,0.787743000,0.0027
197.113.99.126,<->,136.25.188.255,0,0,3,2844,3,2844,0.787580000,1.2101
139.117.42.223,<->,109.222.210.246,0,0,3,168,3,168,0.787536000,0.0001
197.113.99.241,<->,136.25.188.222,0,0,3,722,3,722,0.786765000,0.6192
215.158.239.85,<->,133.224.119.54,3,1485,0,0,3,1485,0.785728000,0.0263
192.171.13.35,<->,8.176.8.83,0,0,3,417,3,417,0.785293000,0.0039
136.25.189.28,<->,89.80.251.8,3,2658,0,0,3,2658,0.785122000,0.8856
215.158.239.49,<->,194.202.165.129,3,156,0,0,3,156,0.784803000,1.1918
216.152.214.7,<->,215.158.239.32,0,0,3,150,3,150,0.784454000,1.1215
136.25.189.1,<->,96.156.169.215,3,1654,0,0,3,1654,0.784422000,0.1068
144.75.218.246,<->,139.252.1.230,3,270,0,0,3,270,0.784360000,0.7503
215.158.239.87,<->,57.199.250.202,3,1485,0,0,3,1485,0.784183000,0.2005
206.103.215.213,<->,136.25.189.83,0,0,3,1469,3,1469,0.783674000,0.1067
207.60.54.198,<->,136.25.188.254,0,0,3,923,3,923,0.783320000,0.4915
194.233.182.159,<->,136.25.188.236,0,0,3,212,3,212,0.783222000,0.6000
140.174.85.226,<->,133.178.227.16,0,0,3,1147,3,1147,0.782688000,0.3177
8.20.87.88,<->,6.145.173.32,3,156,0,0,3,156,0.782177000,0.1100
204.187.204.48,<->,136.25.188.162,0,0,3,1064,3,1064,0.781782000,0.9402
195.70.97.164,<->,136.25.188.255,0,0,3,156,3,156,0.776360000,0.7149
215.158.239.235,<->,111.150.207.239,3,168,0,0,3,168,0.775896000,0.0001
133.178.226.90,<->,122.158.51.61,3,1469,0,0,3,1469,0.775697000,0.3026
241.1.187.56,<->,92.27.219.204,0,0,3,164,3,164,0.775398000,1.0760
215.158.239.97,<->,199.20.31.207,3,359,0,0,3,359,0.774538000,0.4101
149.103.143.40,<->,139.193.141.139,0,0,3,1939,3,1939,0.772988000,0.1368
215.158.238.196,<->,69.31.239.14,3,1194,0,0,3,1194,0.772197000,0.2170
111.151.142.182,<->,8.252.221.65,0,0,3,168,3,168,0.771023000,0.0001
140.196.150.244,<->,80.27.153.42,0,0,3,2525,3,2525,0.769493000,0.0429
215.158.239.79,<->,142.207.217.218,3,663,0,0,3,663,0.769279000,0.5435
202.33.229.219,<->,136.25.188.236,0,0,3,199,3,199,0.769244000,0.2601
215.158.239.87,<->,116.106.60.161,3,199,0,0,3,199,0.769091000,0.1441
192.64.212.179,<->,105.249.105.196,3,224,0,0,3,224,0.768615000,0.9036
136.25.188.163,<->,61.72.108.238,3,1309,0,0,3,1309,0.768534000,0.3400
136.25.188.211,<->,8.42.43.39,3,1535,0,0,3,1535,0.767895000,0.0935
215.158.238.73,<->,113.23.104.252,3,1405,0,0,3,1405,0.767674000,0.1949
133.178.226.28,<->,29.211.186.55,3,1213,0,0,3,1213,0.766920000,0.0994
144.85.170.254,<->,98.87.144.72,3,834,0,0,3,834,0.764882000,0.5920
157.214.227.165,<->,50.224.75.112,0,0,3,150,3,150,0.764779000,0.0050
136.25.189.77,<->,96.156.169.247,3,1630,0,0,3,1630,0.763500000,0.1796
195.70.3.100,<->,136.25.188.176,0,0,3,150,3,150,0.763404000,0.2813
133.178.226.7,<->,118.20.87.71,3,1469,0,0,3,1469,0.762996000,0.1184
95.245.113.50,<->,8.252.221.204,0,0,3,168,3,168,0.761656000,0.6865
215.158.239.79,<->,199.15.79.21,3,156,0,0,3,156,0.761610000,0.1542
133.178.226.30,<->,89.86.110.9,3,1325,0,0,3,1325,0.761549000,0.5341
100.228.42.97,<->,92.175.46.229,3,861,0,0,3,861,0.760603000,0.0736
215.158.239.50,<->,196.88.141.143,3,156,0,0,3,156,0.760229000,0.1823
133.178.226.19,<->,113.23.104.221,3,1485,0,0,3,1485,0.759992000,0.2987
215.158.239.41,<->,149.96.53.41,3,1808,0,0,3,1808,0.759974000,0.3171
113.6.134.86,<->,100.228.42.88,0,0,3,837,3,837,0.759816000,0.2006
139.81.45.38,<->,138.98.246.1,0,0,3,376,3,376,0.758964000,0.3724
215.158.238.115,<->,61.72.108.193,3,1373,0,0,3,1373,0.757490000,0.2004
144.75.218.242,<->,138.127.230.221,3,251,0,0,3,251,0.756403000,1.0568
56.161.195.18,<->,8.52.137.40,0,0,3,150,3,150,0.755999000,0.0349
248.239.213.86,<->,92.27.219.193,0,0,3,164,3,164,0.755938000,1.0942
207.172.62.123,<->,136.25.188.198,0,0,3,192,3,192,0.754775000,0.9335
136.25.189.202,<->,129.222.39.173,3,221,0,0,3,221,0.754686000,0.0213
215.158.239.51,<->,196.106.156.210,3,352,0,0,3,352,0.752834000,1.2126
215.158.239.69,<->,196.108.8.62,3,168,0,0,3,168,0.752811000,0.0200
231.143.36.229,<->,136.25.188.46,0,0,3,199,3,199,0.752647000,0.4295
215.158.239.76,<->,196.106.7.103,3,244,0,0,3,244,0.752023000,0.0502
136.25.189.202,<->,129.222.39.50,3,221,0,0,3,221,0.751990000,0.0218
139.193.141.139,<->,104.189.57.198,3,1849,0,0,3,1849,0.751244000,0.6393
204.200.63.135,<->,136.25.188.252,0,0,3,749,3,749,0.750616000,0.3518
111.151.142.211,<->,8.252.222.219,0,0,3,168,3,168,0.750140000,0.0001
215.158.239.34,<->,131.95.192.158,3,1588,0,0,3,1588,0.750028000,0.1274
207.162.185.28,<->,8.182.227.180,0,0,3,175,3,175,0.749281000,0.1586
215.158.239.84,<->,33.223.64.255,3,1469,0,0,3,1469,0.748008000,0.1337
195.40.131.57,<->,136.25.188.179,0,0,3,667,3,667,0.747220000,0.7140
207.63.119.212,<->,136.25.188.54,0,0,3,189,3,189,0.747117000,0.0094
215.158.239.34,<->,126.219.102.182,3,1144,0,0,3,1144,0.743826000,0.1680
118.98.217.52,<->,111.146.157.228,0,0,3,150,3,150,0.743453000,0.9999
215.158.58.140,<->,99.74.27.166,0,0,3,667,3,667,0.743263000,0.0710
54.38.193.155,<->,48.54.146.64,0,0,3,583,3,583,0.743130000,0.2941
204.141.230.251,<->,8.252.222.159,0,0,3,156,3,156,0.742953000,0.5946
122.140.81.210,<->,89.183.104.142,0,0,3,463,3,463,0.742669000,0.2534
215.158.238.83,<->,131.144.116.87,3,1149,0,0,3,1149,0.742188000,0.2488
133.178.227.40,<->,69.150.169.163,3,2215,0,0,3,2215,0.741620000,1.0994
133.178.227.14,<->,29.212.182.213,3,1197,0,0,3,1197,0.740725000,0.2957
152.1.121.89,<->,20.50.240.231,0,0,3,706,3,706,0.738709000,0.0996
195.12.178.2,<->,136.25.188.255,0,0,3,858,3,858,0.737705000,0.1503
136.25.189.30,<->,113.143.223.229,3,1533,0,0,3,1533,0.736541000,0.1443
204.123.32.211,<->,139.193.141.200,0,0,3,168,3,168,0.735737000,0.1562
194.237.189.237,<->,136.25.188.252,0,0,3,244,3,244,0.735245000,0.0034
204.185.166.133,<->,136.25.188.255,0,0,3,168,3,168,0.734716000,0.0308
215.158.239.68,<->,199.20.30.89,3,168,0,0,3,168,0.733852000,0.0000
192.224.20.27,<->,133.178.226.31,0,0,3,1341,3,1341,0.733763000,0.1416
92.27.219.243,<->,33.57.74.149,3,156,0,0,3,156,0.733384000,0.6805
145.76.230.104,<->,101.224.89.228,0,0,3,652,3,652,0.733201000,0.0495
204.56.123.37,<->,136.25.188.175,0,0,3,168,3,168,0.730531000,0.0030
129.224.112.252,<->,97.242.126.192,3,243,0,0,3,243,0.729628000,0.1725
215.158.239.48,<->,204.2.250.243,3,244,0,0,3,244,0.729362000,0.0035
215.158.239.87,<->,207.217.81.70,3,1341,0,0,3,1341,0.729321000,0.1935
145.208.183.77,<->,53.148.225.225,3,367,0,0,3,367,0.728903000,0.0925
215.158.238.67,<->,33.209.217.203,3,1309,0,0,3,1309,0.728526000,0.3386
215.158.238.88,<->,100.224.166.122,3,1068,0,0,3,1068,0.727952000,1.2606
100.95.240.201,<->,27.12.1.152,3,160,0,0,3,160,0.724878000,0.3350
133.178.226.28,<->,32.183.36.53,3,1277,0,0,3,1277,0.724714000,0.1933
204.186.64.221,<->,136.25.188.174,0,0,3,722,3,722,0.724622000,1.2600
199.68.125.1,<->,136.25.188.174,0,0,3,877,3,877,0.724500000,0.3237
215.158.239.56,<->,196.90.83.92,3,199,0,0,3,199,0.724401000,0.3609
215.158.239.16,<->,8.255.92.67,3,1060,0,0,3,1060,0.724090000,0.1704
215.158.239.76,<->,196.91.71.96,3,300,0,0,3,300,0.724016000,0.4400
207.173.31.171,<->,136.25.188.54,0,0,3,726,3,726,0.723377000,0.8340
207.57.206.169,<->,136.25.188.177,0,0,3,156,3,156,0.723266000,0.3390
194.206.249.165,<->,8.182.226.78,0,0,3,150,3,150,0.722918000,0.2265
101.70.123.195,<->,53.83.195.125,3,192,0,0,3,192,0.722809000,1.0010
215.158.239.92,<->,196.90.83.92,3,199,0,0,3,199,0.722274000,0.3609
249.101.227.24,<->,127.157.237.188,3,662,0,0,3,662,0.721928000,0.1599
215.158.239.92,<->,199.20.31.181,3,288,0,0,3,288,0.721754000,0.9603
215.158.238.107,<->,128.211.32.18,3,1341,0,0,3,1341,0.720609000,0.1005
215.158.238.96,<->,148.146.91.22,3,1325,0,0,3,1325,0.720525000,0.2241
235.42.34.22,<->,136.25.189.59,0,0,3,1469,3,1469,0.717305000,0.1575
195.12.233.193,<->,136.25.188.196,0,0,3,200,3,200,0.716709000,0.8355
133.178.226.29,<->,76.100.108.235,3,2802,0,0,3,2802,0.716590000,0.9742
221.102.114.234,<->,199.12.96.90,3,706,0,0,3,706,0.716279000,0.2183
90.240.140.154,<->,53.214.81.160,3,780,0,0,3,780,0.715497000,0.2540
215.158.239.79,<->,199.15.18.129,3,204,0,0,3,204,0.715244000,0.8776
142.254.98.22,<->,136.25.188.236,0,0,3,864,3,864,0.712721000,0.5484
215.158.140.241,<->,192.204.170.227,3,1312,0,0,3,1312,0.710469000,0.5336
194.237.176.132,<->,8.52.229.28,0,0,3,2320,3,2320,0.707518000,1.0338
215.158.239.68,<->,199.20.28.182,3,150,0,0,3,150,0.707366000,0.1331
215.158.239.84,<->,199.20.23.168,3,150,0,0,3,150,0.707115000,0.1212
199.33.84.183,<->,136.25.188.236,0,0,3,376,3,376,0.706609000,0.2168
54.92.164.150,<->,18.189.64.135,0,0,3,192,3,192,0.706608000,0.0804
199.15.159.48,<->,136.25.188.253,0,0,3,968,3,968,0.706500000,0.5571
215.158.239.87,<->,195.55.45.146,3,706,0,0,3,706,0.706115000,0.3412
136.25.189.29,<->,122.251.2.212,3,1469,0,0,3,1469,0.703975000,0.1767
192.64.211.88,<->,127.177.15.49,3,162,0,0,3,162,0.703835000,0.7095
203.135.215.71,<->,89.183.104.230,0,0,3,160,3,160,0.702933000,0.8029
207.162.131.140,<->,8.182.250.109,0,0,3,150,3,150,0.702769000,0.0212
136.25.188.45,<->,111.151.70.41,3,1277,0,0,3,1277,0.702343000,0.2320
133.178.227.169,<->,111.150.207.59,3,168,0,0,3,168,0.702330000,0.0001
215.158.239.84,<->,29.123.209.237,3,1901,0,0,3,1901,0.701769000,0.1633
215.158.239.51,<->,207.60.106.243,3,150,0,0,3,150,0.701599000,0.0051
195.3.157.139,<->,39.15.169.14,0,0,3,258,3,258,0.701423000,0.7696
215.158.238.142,<->,38.104.11.0,3,1946,0,0,3,1946,0.700708000,0.3404
215.158.239.56,<->,199.20.4.240,3,888,0,0,3,888,0.700225000,0.3401
195.40.74.55,<->,136.25.188.163,0,0,3,168,3,168,0.699328000,0.1671
64.102.10.13,<->,8.252.222.23,0,0,3,706,3,706,0.696332000,0.6609
194.237.123.153,<->,136.25.188.211,0,0,3,150,3,150,0.696235000,0.0030
139.193.141.139,<->,126.207.88.132,3,1851,0,0,3,1851,0.696038000,0.4802
215.61.216.185,<->,133.32.39.0,0,0,3,176,3,176,0.695999000,0.0233
215.158.239.34,<->,149.96.50.20,3,1609,0,0,3,1609,0.695942000,0.0967
215.158.238.209,<->,113.23.40.43,3,2321,0,0,3,2321,0.695893000,1.0679
133.135.214.225,<->,129.6.83.11,0,0,3,2818,3,2818,0.695044000,0.0552
133.178.226.7,<->,8.219.187.251,3,1190,0,0,3,1190,0.695037000,0.0963
132.123.119.170,<->,8.52.187.74,0,0,3,162,3,162,0.694614000,0.0178
220.86.108.15,<->,50.224.61.172,0,0,3,150,3,150,0.694375000,0.7719
215.158.239.84,<->,142.241.37.119,3,706,0,0,3,706,0.694332000,0.8227
215.158.239.84,<->,199.38.91.194,3,150,0,0,3,150,0.693627000,0.0062
136.25.188.198,<->,84.223.186.28,3,706,0,0,3,706,0.692361000,0.7583
215.158.239.57,<->,199.20.28.74,3,188,0,0,3,188,0.690479000,1.0996
215.158.238.82,<->,8.190.217.152,3,1469,0,0,3,1469,0.689158000,0.0399
207.172.29.9,<->,136.25.188.177,0,0,3,368,3,368,0.688522000,1.0400
220.28.114.28,<->,136.25.189.55,0,0,3,3431,3,3431,0.688007000,0.5686
204.140.159.18,<->,39.15.169.14,0,0,3,249,3,249,0.687785000,1.1550
215.158.61.202,<->,8.176.8.182,0,0,3,2460,3,2460,0.685268000,0.2293
136.25.188.160,<->,131.1.253.247,3,1501,0,0,3,1501,0.685181000,0.1027
133.178.226.19,<->,80.47.111.11,3,1293,0,0,3,1293,0.684003000,0.0642
215.158.238.119,<->,145.116.209.92,3,618,0,0,3,618,0.682550000,0.0372
155.197.206.247,<->,133.178.227.2,0,0,3,168,3,168,0.682268000,0.0001
215.158.239.19,<->,106.188.156.219,3,1813,0,0,3,1813,0.681802000,0.1041
136.25.188.252,<->,29.213.219.103,3,1341,0,0,3,1341,0.681675000,0.6316
215.158.239.87,<->,195.43.176.39,3,366,0,0,3,366,0.681527000,0.3477
126.88.138.182,<->,92.27.219.232,0,0,3,156,3,156,0.681467000,0.1961
194.232.183.97,<->,136.25.188.220,0,0,3,150,3,150,0.681413000,0.2457
249.229.106.211,<->,8.53.3.201,0,0,3,150,3,150,0.681273000,0.0001
197.81.131.45,<->,136.25.188.46,0,0,3,150,3,150,0.680855000,0.3147
136.25.189.29,<->,29.212.180.163,3,1325,0,0,3,1325,0.680588000,0.1226
133.178.227.135,<->,29.212.136.152,3,1037,0,0,3,1037,0.680357000,0.1098
215.158.239.78,<->,143.135.37.247,3,375,0,0,3,375,0.679351000,0.5001
143.155.227.59,<->,133.178.226.31,0,0,3,1389,3,1389,0.679006000,0.2229
100.93.144.126,<->,27.12.1.152,3,160,0,0,3,160,0.678583000,0.1545
139.114.137.74,<->,100.228.42.52,0,0,3,765,3,765,0.677294000,0.0533
192.228.30.41,<->,133.178.226.28,0,0,3,2242,3,2242,0.676949000,1.3067
215.158.238.141,<->,131.215.37.40,3,1277,0,0,3,1277,0.676511000,0.4828
136.25.188.162,<->,113.23.104.203,3,1277,0,0,3,1277,0.676172000,0.3597
195.126.38.57,<->,136.25.188.209,0,0,3,150,3,150,0.674897000,0.0030
231.142.4.230,<->,136.25.188.175,0,0,3,168,3,168,0.673957000,0.0179
215.158.238.106,<->,27.178.41.9,3,1421,0,0,3,1421,0.673882000,0.4148
92.27.219.214,<->,88.155.32.239,3,156,0,0,3,156,0.673871000,0.8394
215.158.239.95,<->,199.106.231.216,3,1229,0,0,3,1229,0.673507000,1.0198
204.61.232.192,<->,136.25.188.253,0,0,3,150,3,150,0.673406000,0.0100
17.70.136.237,<->,8.220.200.173,0,0,3,2072,3,2072,0.672582000,0.2995
215.158.239.192,<->,215.158.61.242,3,3554,0,0,3,3554,0.672254000,0.0004
139.193.141.139,<->,50.25.206.110,3,1834,0,0,3,1834,0.672232000,0.2400
246.253.253.210,<->,136.6.92.157,3,375,0,0,3,375,0.671792000,0.2173
204.61.232.192,<->,136.25.188.241,0,0,3,150,3,150,0.670811000,0.0181
207.61.13.21,<->,136.25.188.178,0,0,3,150,3,150,0.670803000,0.0030
200.175.83.223,<->,53.149.94.186,3,683,0,0,3,683,0.669869000,0.2950
113.188.193.220,<->,8.176.8.105,0,0,3,168,3,168,0.669330000,0.0000
130.37.102.18,<->,39.214.55.177,0,0,3,258,3,258,0.668142000,0.7502
207.59.91.167,<->,136.25.188.239,0,0,3,244,3,244,0.667408000,0.0066
207.57.138.227,<->,136.25.188.163,0,0,3,150,3,150,0.667230000,0.0033
200.174.129.238,<->,6.171.58.242,3,3177,0,0,3,3177,0.666628000,0.9080
215.158.239.87,<->,195.127.164.233,3,376,0,0,3,376,0.665940000,1.2767
92.27.219.131,<->,38.255.125.152,3,156,0,0,3,156,0.664774000,0.5149
136.25.189.202,<->,129.222.39.121,3,221,0,0,3,221,0.664102000,0.0213
136.25.189.30,<->,128.69.139.84,3,1341,0,0,3,1341,0.663524000,0.2006
139.193.141.137,<->,17.41.67.243,3,168,0,0,3,168,0.662943000,0.0299
246.254.97.105,<->,111.151.239.115,3,439,0,0,3,439,0.661263000,0.0350
221.102.56.51,<->,192.67.144.122,0,0,3,498,3,498,0.660869000,0.0339
133.178.227.247,<->,8.191.135.67,3,2125,0,0,3,2125,0.659004000,0.1995
215.158.239.78,<->,195.126.181.14,3,156,0,0,3,156,0.658238000,0.1964
136.25.189.2,<->,72.23.194.234,3,2690,0,0,3,2690,0.657877000,1.1293
145.19.5.174,<->,53.229.128.45,3,176,0,0,3,176,0.657722000,0.0962
215.158.239.99,<->,199.20.5.233,3,204,0,0,3,204,0.656750000,0.1166
109.1.59.53,<->,100.123.121.232,3,1567,0,0,3,1567,0.656733000,0.0113
215.158.239.48,<->,207.188.189.158,3,1260,0,0,3,1260,0.656396000,1.1600
215.158.238.64,<->,112.93.136.89,3,1485,0,0,3,1485,0.656198000,0.1545
144.85.170.254,<->,98.87.146.247,3,168,0,0,3,168,0.655145000,0.0134
192.67.143.198,<->,134.244.248.146,3,156,0,0,3,156,0.654945000,0.7010
204.200.34.12,<->,136.25.188.163,0,0,3,199,3,199,0.653961000,0.2402
91.234.186.104,<->,8.252.221.249,0,0,3,2130,3,2130,0.652574000,0.2875
215.158.238.209,<->,122.251.2.236,3,1168,0,0,3,1168,0.652066000,0.2792
215.158.238.96,<->,42.226.3.118,3,2754,0,0,3,2754,0.651859000,1.2077
229.45.205.24,<->,220.50.226.64,3,798,0,0,3,798,0.650020000,0.4272
133.244.31.123,<->,80.27.154.173,3,307,0,0,3,307,0.649485000,0.1035
136.25.188.46,<->,84.209.172.217,3,156,0,0,3,156,0.648844000,0.5482
56.9.244.173,<->,8.182.241.53,0,0,3,199,3,199,0.648726000,0.0292
204.187.57.196,<->,136.25.188.198,0,0,3,1152,3,1152,0.648386000,0.3445
199.73.44.127,<->,136.25.188.253,0,0,3,244,3,244,0.647399000,0.0071
98.129.127.190,<->,88.8.215.100,3,159,0,0,3,159,0.646548000,0.6135
136.25.188.163,<->,84.209.172.217,3,156,0,0,3,156,0.646222000,0.5456
215.158.239.79,<->,196.94.84.1,3,204,0,0,3,204,0.645939000,0.3578
140.139.153.162,<->,133.54.21.162,0,0,3,4272,3,4272,0.645346000,0.8754
136.25.188.162,<->,48.52.231.159,3,150,0,0,3,150,0.644643000,0.0004
215.158.239.95,<->,207.236.251.89,3,168,0,0,3,168,0.644444000,0.0053
136.25.188.178,<->,29.211.186.212,3,1501,0,0,3,1501,0.644220000,0.1979
136.25.189.59,<->,57.31.64.70,3,1245,0,0,3,1245,0.642926000,0.1032
215.158.61.183,<->,8.176.8.183,0,0,3,1245,3,1245,0.640600000,0.1203
139.193.141.132,<->,110.20.23.94,3,150,0,0,3,150,0.640555000,1.1947
56.114.235.120,<->,8.228.213.135,0,0,3,1196,3,1196,0.640103000,0.0995
133.178.227.70,<->,8.222.6.193,3,1112,0,0,3,1112,0.639902000,0.2063
215.158.23.56,<->,111.150.207.59,3,168,0,0,3,168,0.639450000,0.0001
195.13.4.108,<->,136.25.188.197,0,0,3,1131,3,1131,0.639363000,0.1253
195.42.112.159,<->,136.25.188.53,0,0,3,150,3,150,0.639110000,0.0062
143.88.147.239,<->,136.25.188.198,0,0,3,168,3,168,0.639081000,0.0106
104.54.63.97,<->,80.42.190.120,0,0,3,160,3,160,0.638642000,1.0038
215.158.238.221,<->,192.171.32.145,3,2370,0,0,3,2370,0.638308000,1.1601
204.200.63.242,<->,136.25.188.254,0,0,3,150,3,150,0.638060000,0.0000
215.158.238.66,<->,106.188.252.235,3,1293,0,0,3,1293,0.636934000,0.1212
210.220.219.152,<->,53.249.54.97,3,367,0,0,3,367,0.635864000,0.2060
111.147.75.241,<->,53.244.240.54,3,1837,0,0,3,1837,0.635731000,0.0152
204.187.223.87,<->,136.25.188.55,0,0,3,180,3,180,0.635077000,0.2146
215.158.239.95,<->,199.20.4.177,3,150,0,0,3,150,0.634491000,0.1794
231.142.215.70,<->,215.158.239.51,0,0,3,150,3,150,0.634301000,0.0030
141.15.11.120,<->,97.149.24.218,0,0,3,635,3,635,0.633829000,0.1824
220.55.75.167,<->,33.57.74.181,3,225,0,0,3,225,0.633817000,0.5861
200.174.180.133,<->,53.245.89.21,3,1275,0,0,3,1275,0.633690000,1.3043
133.178.226.38,<->,38.206.2.168,3,1341,0,0,3,1341,0.632541000,0.2627
75.157.196.137,<->,0.195.210.46,0,0,3,1426,3,1426,0.632238000,1.3352
207.57.108.97,<->,136.25.188.176,0,0,3,193,3,193,0.631093000,0.2779
93.48.197.173,<->,89.183.104.239,0,0,3,150,3,150,0.630178000,1.3618
215.158.238.133,<->,131.1.253.248,3,1350,0,0,3,1350,0.628732000,0.1134
114.209.3.97,<->,92.27.219.249,0,0,3,164,3,164,0.627752000,1.2943
195.42.213.87,<->,136.25.188.209,0,0,3,150,3,150,0.627437000,0.0028
207.60.199.109,<->,136.25.188.45,0,0,3,490,3,490,0.626735000,0.3405
107.253.12.221,<->,8.182.139.197,0,0,3,1869,3,1869,0.625608000,0.3156
215.158.238.82,<->,114.25.48.52,3,1421,0,0,3,1421,0.625271000,0.2485
194.206.223.38,<->,8.182.227.180,0,0,3,150,3,150,0.624075000,0.1684
139.193.141.139,<->,122.212.85.246,3,168,0,0,3,168,0.623520000,0.1094
112.170.198.223,<->,92.27.219.38,0,0,3,164,3,164,0.623448000,1.2711
195.43.205.193,<->,136.25.188.242,0,0,3,653,3,653,0.622131000,1.0357
204.200.35.27,<->,136.25.188.44,0,0,3,270,3,270,0.621996000,0.0164
215.158.28.178,<->,111.27.225.31,3,164,0,0,3,164,0.620543000,0.0303
215.158.239.57,<->,57.31.99.1,3,1341,0,0,3,1341,0.620346000,0.1067
136.25.188.161,<->,27.22.184.67,3,1229,0,0,3,1229,0.619368000,0.6469
215.158.239.87,<->,140.174.85.73,3,1437,0,0,3,1437,0.618792000,0.4277
192.171.13.80,<->,8.252.222.202,0,0,3,602,3,602,0.618141000,0.0345
136.25.189.77,<->,6.116.14.11,3,1965,0,0,3,1965,0.618126000,0.1386
92.162.253.63,<->,8.4.159.46,3,375,0,0,3,375,0.617877000,0.0237
215.158.239.85,<->,120.155.8.84,3,1357,0,0,3,1357,0.617513000,0.1222
111.20.171.168,<->,33.233.141.88,0,0,3,2774,3,2774,0.617359000,0.5819
92.27.219.229,<->,57.114.28.94,3,174,0,0,3,174,0.615530000,0.6955
215.158.238.236,<->,192.204.170.250,3,1164,0,0,3,1164,0.615376000,0.2494
204.63.54.20,<->,136.25.188.197,0,0,3,162,3,162,0.615327000,0.0002
133.244.31.122,<->,80.27.154.173,3,197,0,0,3,197,0.615105000,0.0001
215.158.239.92,<->,196.111.85.53,3,1045,0,0,3,1045,0.613627000,0.9618
215.158.61.193,<->,8.176.8.105,0,0,3,3070,3,3070,0.613103000,1.3163
194.218.12.122,<->,8.182.243.89,0,0,3,168,3,168,0.612299000,0.8039
215.158.238.66,<->,112.93.136.88,3,1133,0,0,3,1133,0.612120000,0.3621
199.69.87.69,<->,136.25.188.237,0,0,3,1165,3,1165,0.610422000,0.2384
136.25.189.5,<->,8.220.7.141,3,505,0,0,3,505,0.608602000,0.0089
133.178.226.29,<->,113.23.117.118,3,1309,0,0,3,1309,0.608407000,0.1076
215.158.61.191,<->,8.176.8.205,0,0,3,2583,3,2583,0.607742000,1.3582
136.25.189.13,<->,120.20.132.43,3,1200,0,0,3,1200,0.607487000,0.1627
101.235.76.65,<->,17.3.209.41,3,1527,0,0,3,1527,0.606724000,0.8295
120.248.160.71,<->,80.40.38.190,0,0,3,496,3,496,0.606687000,1.1620
215.158.239.96,<->,196.91.144.120,3,360,0,0,3,360,0.606421000,1.0808
98.23.123.93,<->,8.252.222.221,0,0,3,150,3,150,0.604781000,0.2909
92.27.219.49,<->,67.225.124.134,3,156,0,0,3,156,0.604499000,0.4835
215.158.239.84,<->,199.20.4.146,3,1112,0,0,3,1112,0.603983000,0.2104
215.158.239.35,<->,131.95.192.176,3,1471,0,0,3,1471,0.603764000,0.1276
215.202.174.57,<->,215.158.239.93,0,0,3,2514,3,2514,0.603420000,1.3193
200.174.201.41,<->,53.213.148.81,3,1343,0,0,3,1343,0.603053000,0.3880
109.119.182.188,<->,109.1.59.53,0,0,3,505,3,505,0.602554000,0.0389
215.158.238.133,<->,125.84.60.105,3,1245,0,0,3,1245,0.601881000,0.2410
111.151.106.211,<->,8.252.223.81,0,0,3,168,3,168,0.601881000,0.0001
97.126.24.188,<->,54.36.93.106,3,327,0,0,3,327,0.601424000,0.5771
215.158.61.145,<->,136.25.189.209,0,0,3,511,3,511,0.601196000,1.1323
200.174.209.22,<->,54.38.7.230,3,405,0,0,3,405,0.600867000,0.4357
215.158.239.86,<->,199.33.220.112,3,230,0,0,3,230,0.600343000,0.4701
8.252.223.175,<->,8.222.6.193,3,1067,0,0,3,1067,0.600307000,0.1288
133.178.226.28,<->,29.211.6.52,3,1960,0,0,3,1960,0.598989000,0.1154
215.158.238.65,<->,131.2.115.246,3,1357,0,0,3,1357,0.598243000,0.2512
247.136.164.213,<->,78.44.32.87,3,168,0,0,3,168,0.597459000,1.1218
215.158.238.251,<->,158.85.50.137,3,1162,0,0,3,1162,0.597040000,0.3130
215.158.238.102,<->,145.116.209.71,3,168,0,0,3,168,0.595953000,0.0501
204.200.63.123,<->,136.25.188.53,0,0,3,162,3,162,0.594981000,0.4286
100.228.42.97,<->,92.175.44.111,3,685,0,0,3,685,0.594629000,0.0602
215.158.239.76,<->,207.188.20.40,3,168,0,0,3,168,0.594223000,0.6402
215.158.238.66,<->,29.213.195.62,3,168,0,0,3,168,0.594026000,0.0010
215.158.239.56,<->,199.20.31.167,3,168,0,0,3,168,0.592774000,0.4200
80.42.191.110,<->,38.65.192.57,3,244,0,0,3,244,0.592541000,1.0543
215.158.239.234,<->,158.188.198.216,3,2088,0,0,3,2088,0.592120000,1.3708
26.236.42.98,<->,8.220.190.86,0,0,3,2756,3,2756,0.591996000,0.0411
143.72.119.223,<->,136.25.188.255,0,0,3,162,3,162,0.591302000,0.2730
221.102.56.46,<->,192.65.245.38,0,0,3,372,3,372,0.590905000,0.0202
199.13.169.228,<->,8.52.161.33,0,0,3,150,3,150,0.590766000,0.3365
204.153.2.131,<->,92.27.194.147,0,0,3,369,3,369,0.590743000,1.2733
215.158.61.183,<->,136.25.189.195,0,0,3,1974,3,1974,0.589113000,0.1907
136.25.188.39,<->,111.151.237.142,3,1186,0,0,3,1186,0.587638000,0.2154
144.75.218.246,<->,138.127.224.101,3,251,0,0,3,251,0.587240000,0.4347
139.44.225.31,<->,132.18.67.28,3,459,0,0,3,459,0.586874000,0.0356
215.158.238.65,<->,192.228.30.85,3,1357,0,0,3,1357,0.586432000,0.0307
53.148.184.48,<->,48.54.120.23,0,0,3,1058,3,1058,0.585493000,0.3224
136.25.189.94,<->,8.203.24.137,3,176,0,0,3,176,0.583212000,0.0215
204.21.42.77,<->,136.25.188.178,0,0,3,150,3,150,0.583169000,0.2772
215.158.239.85,<->,199.20.31.236,3,150,0,0,3,150,0.582745000,0.0400
215.158.239.99,<->,207.167.186.84,3,781,0,0,3,781,0.581581000,0.4693
215.158.239.87,<->,199.50.143.41,3,150,0,0,3,150,0.580929000,0.0552
215.158.239.76,<->,207.166.72.135,3,168,0,0,3,168,0.580885000,0.0000
109.222.246.106,<->,92.173.80.91,3,156,0,0,3,156,0.580618000,1.3570
215.158.238.72,<->,131.251.111.3,3,1453,0,0,3,1453,0.579854000,0.1360
215.158.3.195,<->,8.176.8.36,0,0,3,2125,3,2125,0.578580000,0.0904
80.27.157.212,<->,66.245.79.98,3,2014,0,0,3,2014,0.578372000,0.0000
215.158.238.81,<->,88.51.246.250,3,1293,0,0,3,1293,0.576267000,0.2073
215.158.239.97,<->,196.91.53.11,3,217,0,0,3,217,0.574745000,1.4221
142.241.170.28,<->,136.25.188.252,0,0,3,150,3,150,0.574538000,0.0029
215.158.140.13,<->,89.64.25.113,3,176,0,0,3,176,0.573310000,0.0222
142.240.128.222,<->,136.25.188.176,0,0,3,168,3,168,0.572828000,0.0010
204.139.36.36,<->,8.182.237.144,0,0,3,150,3,150,0.572761000,0.0032
101.70.112.204,<->,8.232.214.178,3,199,0,0,3,199,0.572685000,0.0001
100.109.116.141,<->,8.220.238.247,0,0,3,162,3,162,0.571733000,0.4970
199.121.8.9,<->,136.25.188.224,0,0,3,244,3,244,0.570744000,0.0109
215.158.140.83,<->,112.93.136.122,3,1633,0,0,3,1633,0.569631000,0.1565
17.90.64.205,<->,8.220.190.86,0,0,3,156,3,156,0.568594000,0.0935
215.158.238.105,<->,116.106.60.163,3,1469,0,0,3,1469,0.567756000,0.2304
215.158.61.209,<->,8.252.223.10,0,0,3,760,3,760,0.567241000,1.3690
133.178.227.255,<->,8.35.106.108,3,1824,0,0,3,1824,0.567045000,0.0424
207.92.28.168,<->,8.182.139.197,0,0,3,150,3,150,0.566574000,0.2232
204.185.168.170,<->,136.25.188.52,0,0,3,168,3,168,0.565730000,0.1100
199.80.150.122,<->,136.25.188.209,0,0,3,284,3,284,0.565718000,0.0474
117.23.115.3,<->,101.70.97.172,0,0,3,150,3,150,0.565370000,1.1070
136.25.188.52,<->,30.73.98.18,3,150,0,0,3,150,0.565158000,0.0000
215.158.140.11,<->,53.160.111.19,3,2288,0,0,3,2288,0.564784000,0.0006
215.158.239.96,<->,195.13.169.16,3,193,0,0,3,193,0.564270000,0.2279
136.25.188.45,<->,122.158.51.63,3,1277,0,0,3,1277,0.562328000,0.2646
207.3.132.1,<->,139.193.141.139,0,0,3,1914,3,1914,0.561748000,0.1640
89.183.110.107,<->,75.24.59.240,3,214,0,0,3,214,0.560092000,0.2547
215.158.239.57,<->,141.199.76.228,3,1357,0,0,3,1357,0.559544000,0.2131
57.209.136.82,<->,6.122.205.96,0,0,3,221,3,221,0.558846000,1.1543
142.209.157.97,<->,136.25.188.174,0,0,3,228,3,228,0.556938000,0.4253
133.178.226.179,<->,111.150.207.59,3,168,0,0,3,168,0.556723000,0.0247
100.212.92.208,<->,97.126.31.86,0,0,3,176,3,176,0.555985000,0.0910
215.158.239.87,<->,142.227.55.17,3,722,0,0,3,722,0.555928000,0.9558
141.32.13.13,<->,139.193.141.139,0,0,3,1949,3,1949,0.555138000,0.2089
133.178.226.28,<->,89.86.110.10,3,1261,0,0,3,1261,0.554816000,0.1030
197.113.99.129,<->,136.25.188.46,0,0,3,404,3,404,0.554300000,1.3499
195.13.157.194,<->,136.25.188.240,0,0,3,150,3,150,0.553731000,1.3364
100.228.42.97,<->,92.175.46.101,3,701,0,0,3,701,0.553399000,0.0662
143.132.56.155,<->,136.25.188.254,0,0,3,244,3,244,0.553250000,0.0037
54.38.126.203,<->,48.53.101.0,0,0,3,237,3,237,0.552236000,1.2515
143.42.41.80,<->,136.25.188.226,0,0,3,156,3,156,0.551438000,0.1349
144.83.60.153,<->,92.162.253.88,0,0,3,614,3,614,0.551365000,0.1079
195.125.11.138,<->,136.25.188.255,0,0,3,168,3,168,0.550951000,0.0076
143.42.41.80,<->,136.25.188.177,0,0,3,156,3,156,0.550864000,0.1649
215.158.239.95,<->,199.20.6.114,3,284,0,0,3,284,0.549655000,0.2142
148.26.113.33,<->,136.25.189.18,0,0,3,1421,3,1421,0.548980000,0.3229
6.145.151.238,<->,0.195.210.44,0,0,3,192,3,192,0.547327000,0.0082
146.149.81.142,<->,8.252.221.231,0,0,3,150,3,150,0.546957000,0.4912
101.235.79.81,<->,89.74.85.198,3,660,0,0,3,660,0.546845000,0.2367
215.158.238.223,<->,104.154.137.59,3,1158,0,0,3,1158,0.546815000,0.1344
138.126.221.99,<->,92.27.219.146,0,0,3,164,3,164,0.546581000,1.1659
215.158.239.50,<->,199.20.29.230,3,150,0,0,3,150,0.546313000,0.0002
215.158.239.78,<->,204.2.89.57,3,192,0,0,3,192,0.545210000,0.9201
136.25.189.77,<->,58.49.163.234,3,1469,0,0,3,1469,0.543559000,0.1636
195.54.78.88,<->,136.25.188.242,0,0,3,150,3,150,0.543008000,0.4598
207.101.241.219,<->,8.182.233.86,0,0,3,745,3,745,0.542189000,1.1342
215.158.239.49,<->,199.20.31.135,3,168,0,0,3,168,0.542014000,1.1604
111.146.174.85,<->,53.244.230.218,3,2516,0,0,3,2516,0.541126000,0.0170
144.64.139.154,<->,84.214.213.10,3,1482,0,0,3,1482,0.540907000,0.1461
143.89.63.84,<->,136.25.188.238,0,0,3,402,3,402,0.540364000,0.6615
56.112.212.218,<->,8.182.238.140,0,0,3,586,3,586,0.538655000,0.0379
215.158.239.50,<->,196.92.226.2,3,168,0,0,3,168,0.538508000,1.1499
192.74.94.29,<->,8.182.248.147,0,0,3,369,3,369,0.538257000,1.2952
215.158.239.51,<->,143.42.41.80,3,156,0,0,3,156,0.538127000,0.1800
91.221.139.249,<->,8.252.223.228,0,0,3,338,3,338,0.537426000,1.2065
215.158.238.94,<->,149.96.53.37,3,1517,0,0,3,1517,0.536833000,0.1897
109.222.211.98,<->,53.224.105.49,3,605,0,0,3,605,0.535700000,0.1713
116.163.40.218,<->,92.27.219.18,0,0,3,156,3,156,0.535231000,0.6194
215.158.239.78,<->,199.20.28.44,3,722,0,0,3,722,0.535095000,1.4607
207.57.21.233,<->,136.25.188.54,0,0,3,150,3,150,0.534866000,0.4587
215.158.239.84,<->,196.90.121.49,3,168,0,0,3,168,0.534637000,1.4201
149.231.78.69,<->,139.193.141.139,0,0,3,1893,3,1893,0.531578000,0.3023
215.158.238.135,<->,8.191.6.123,3,1469,0,0,3,1469,0.531443000,0.1288
133.178.226.29,<->,57.3.89.231,3,1437,0,0,3,1437,0.530554000,0.1489
101.235.67.95,<->,8.20.81.7,3,850,0,0,3,850,0.527787000,0.0425
133.107.27.12,<->,35.56.98.241,0,0,3,170,3,170,0.527231000,1.4419
129.16.253.232,<->,98.129.59.32,0,0,3,2086,3,2086,0.525992000,1.4649
210.229.230.20,<->,110.241.106.59,3,401,0,0,3,401,0.525361000,0.0602
202.33.125.147,<->,136.25.188.163,0,0,3,168,3,168,0.522427000,0.0000
198.194.255.219,<->,92.27.194.147,0,0,3,168,3,168,0.521974000,0.2622
136.25.188.176,<->,100.200.67.242,3,150,0,0,3,150,0.521687000,0.0449
215.158.238.90,<->,100.224.166.158,3,1067,0,0,3,1067,0.521439000,0.4688
251.30.57.156,<->,139.163.17.164,0,0,3,150,3,150,0.520640000,0.9694
207.59.197.249,<->,136.25.188.226,0,0,3,168,3,168,0.520005000,0.9519
204.187.24.163,<->,136.25.188.220,0,0,3,722,3,722,0.519910000,1.1302
157.84.49.220,<->,92.181.196.31,0,0,3,183,3,183,0.518805000,0.3935
195.70.122.241,<->,136.25.188.209,0,0,3,722,3,722,0.518754000,1.0570
17.68.77.212,<->,8.220.188.50,0,0,3,150,3,150,0.517751000,0.4115
136.25.188.248,<->,100.224.202.178,3,168,0,0,3,168,0.517568000,0.0509
136.25.188.173,<->,112.220.206.107,3,376,0,0,3,376,0.514501000,0.1029
196.87.16.223,<->,136.25.188.54,0,0,3,168,3,168,0.513030000,1.2802
143.68.35.157,<->,136.25.188.253,0,0,3,150,3,150,0.512309000,0.0031
215.158.239.58,<->,199.51.209.237,3,168,0,0,3,168,0.511034000,0.0030
204.184.164.149,<->,136.25.188.220,0,0,3,220,3,220,0.510290000,0.1202
210.213.250.181,<->,8.52.246.161,0,0,3,156,3,156,0.509950000,0.1601
195.126.152.22,<->,136.25.188.178,0,0,3,371,3,371,0.509139000,0.7258
133.178.226.30,<->,56.19.241.25,3,1341,0,0,3,1341,0.509133000,0.1802
215.158.239.35,<->,8.222.7.181,3,1225,0,0,3,1225,0.509077000,0.0381
215.158.239.57,<->,33.209.219.92,3,1997,0,0,3,1997,0.508774000,0.1313
195.40.190.30,<->,136.25.188.211,0,0,3,889,3,889,0.508395000,0.4646
132.216.20.155,<->,101.124.203.11,0,0,3,1090,3,1090,0.507586000,0.0000
207.92.19.255,<->,8.182.243.141,0,0,3,156,3,156,0.507237000,0.1792
215.158.61.253,<->,99.74.26.134,0,0,3,502,3,502,0.506274000,0.7461
207.3.171.193,<->,8.52.230.164,0,0,3,810,3,810,0.505841000,0.1778
199.121.168.2,<->,136.25.188.196,0,0,3,244,3,244,0.504943000,0.0037
215.158.238.112,<->,69.150.169.203,3,1325,0,0,3,1325,0.503260000,0.2174
136.25.189.83,<->,122.216.233.84,3,1437,0,0,3,1437,0.502373000,0.0917
128.156.85.244,<->,8.252.222.192,0,0,3,168,3,168,0.501217000,0.0231
199.121.168.2,<->,136.25.188.52,0,0,3,244,3,244,0.500426000,0.0025
144.75.218.246,<->,139.252.1.242,3,399,0,0,3,399,0.499818000,1.1754
48.53.210.97,<->,6.171.78.167,3,1689,0,0,3,1689,0.498104000,0.3361
215.158.239.58,<->,142.240.134.17,3,150,0,0,3,150,0.497872000,0.0052
207.62.177.19,<->,136.25.188.239,0,0,3,150,3,150,0.497697000,0.0059
92.27.219.228,<->,48.110.201.236,3,168,0,0,3,168,0.495719000,1.0847
215.158.238.45,<->,89.86.110.85,3,1501,0,0,3,1501,0.495699000,1.1716
145.252.112.144,<->,105.201.86.202,3,372,0,0,3,372,0.495607000,0.2071
215.158.239.96,<->,196.107.117.216,3,244,0,0,3,244,0.494672000,0.0507
215.158.239.76,<->,207.61.251.48,3,667,0,0,3,667,0.494358000,1.2937
215.158.239.87,<->,149.96.171.27,3,2306,0,0,3,2306,0.493458000,1.4221
142.221.50.123,<->,136.25.188.253,0,0,3,162,3,162,0.493450000,0.2925
114.234.193.162,<->,92.27.219.199,0,0,3,164,3,164,0.491818000,1.3564
101.70.120.140,<->,50.145.216.150,3,150,0,0,3,150,0.491554000,1.0153
215.158.238.238,<->,6.29.108.75,3,1873,0,0,3,1873,0.490339000,0.0561
215.158.239.69,<->,204.2.14.151,3,663,0,0,3,663,0.489994000,1.2549
158.15.212.118,<->,92.27.219.153,0,0,3,4221,3,4221,0.489300000,1.1580
215.158.140.184,<->,127.168.65.198,3,150,0,0,3,150,0.489283000,0.2385
136.25.188.177,<->,38.104.11.0,3,1538,0,0,3,1538,0.489202000,0.1547
204.60.193.27,<->,136.25.188.196,0,0,3,228,3,228,0.488983000,0.9406
201.136.184.217,<->,133.178.227.41,0,0,3,1501,3,1501,0.488382000,0.2383
58.60.36.23,<->,8.252.222.134,0,0,3,186,3,186,0.488127000,0.5407
204.185.57.134,<->,136.25.188.240,0,0,3,199,3,199,0.488120000,1.5011
215.158.238.92,<->,104.3.168.217,3,1277,0,0,3,1277,0.488115000,0.2575
141.199.76.231,<->,136.25.189.16,0,0,3,2498,3,2498,0.487455000,1.4201
215.158.239.77,<->,199.20.30.197,3,168,0,0,3,168,0.487278000,0.0708
207.36.42.96,<->,92.27.194.147,0,0,3,162,3,162,0.486408000,0.9412
139.193.141.139,<->,27.149.101.100,3,1776,0,0,3,1776,0.486337000,0.3078
133.178.227.59,<->,29.211.165.9,3,1805,0,0,3,1805,0.486134000,0.1076
200.174.199.251,<->,54.36.13.173,3,168,0,0,3,168,0.484406000,0.2927
142.190.83.146,<->,136.25.188.177,0,0,3,162,3,162,0.483428000,0.8425
139.8.186.160,<->,133.178.227.19,0,0,3,1597,3,1597,0.482360000,0.0906
198.187.26.113,<->,100.92.195.69,0,0,3,156,3,156,0.482174000,0.3457
119.117.27.67,<->,92.27.27.158,0,0,3,156,3,156,0.481450000,0.8788
97.126.4.255,<->,27.10.93.204,3,174,0,0,3,174,0.481106000,0.1658
143.155.227.40,<->,133.178.226.19,0,0,3,1293,3,1293,0.480346000,0.1834
194.237.38.227,<->,136.25.188.177,0,0,3,712,3,712,0.479838000,1.2026
133.178.227.41,<->,133.56.180.0,3,1693,0,0,3,1693,0.479380000,0.0407
215.158.239.79,<->,204.226.109.227,3,150,0,0,3,150,0.478864000,0.0003
80.41.15.5,<->,27.116.206.43,3,570,0,0,3,570,0.478619000,0.0379
248.239.169.84,<->,8.49.69.216,3,485,0,0,3,485,0.478124000,0.0386
206.57.21.191,<->,80.41.53.163,0,0,3,156,3,156,0.477288000,0.9360
215.158.239.5,<->,80.47.111.181,3,1091,0,0,3,1091,0.476962000,0.0484
215.158.239.50,<->,195.83.191.30,3,168,0,0,3,168,0.475478000,0.0080
98.242.57.201,<->,92.27.219.230,0,0,3,511,3,511,0.475164000,1.0140
111.151.109.51,<->,97.126.31.86,0,0,3,168,3,168,0.473405000,0.0002
215.158.238.234,<->,111.151.139.187,3,168,0,0,3,168,0.473198000,0.0001
136.25.188.105,<->,132.43.156.54,3,427,0,0,3,427,0.471595000,1.4672
93.149.101.51,<->,80.38.22.203,0,0,3,156,3,156,0.471518000,0.3085
133.186.94.168,<->,133.178.226.233,0,0,3,168,3,168,0.467791000,1.0471
215.158.238.66,<->,112.220.206.107,3,1309,0,0,3,1309,0.467775000,0.1918
215.158.239.96,<->,199.20.28.91,3,168,0,0,3,168,0.467749000,1.3332
215.202.174.57,<->,215.158.239.85,0,0,3,1613,3,1613,0.467704000,0.3627
215.158.239.85,<->,199.20.31.245,3,244,0,0,3,244,0.466010000,0.0200
204.58.140.60,<->,136.25.188.210,0,0,3,1040,3,1040,0.466002000,0.0062
139.193.141.139,<->,125.196.33.22,3,1905,0,0,3,1905,0.465699000,0.1727
215.158.239.87,<->,199.20.29.203,3,392,0,0,3,392,0.464816000,0.4316
158.178.164.100,<->,100.228.42.163,0,0,3,709,3,709,0.464039000,0.0537
50.224.95.2,<->,38.162.94.107,3,680,0,0,3,680,0.463981000,0.3878
224.148.1.28,<->,220.50.239.169,3,930,0,0,3,930,0.463544000,0.0301
207.172.246.243,<->,136.25.188.252,0,0,3,1131,3,1131,0.462440000,0.5683
92.27.219.233,<->,29.139.111.221,3,476,0,0,3,476,0.462131000,1.3124
215.158.239.50,<->,199.20.31.62,3,726,0,0,3,726,0.461051000,0.3360
195.125.126.109,<->,136.25.188.225,0,0,3,150,3,150,0.459797000,0.5152
53.203.244.195,<->,48.54.252.54,0,0,3,381,3,381,0.458015000,0.6497
204.56.105.239,<->,136.25.188.220,0,0,3,360,3,360,0.456762000,0.2673
215.158.238.236,<->,8.192.205.0,3,2149,0,0,3,2149,0.456024000,1.4409
215.158.239.50,<->,68.124.221.183,3,2626,0,0,3,2626,0.455476000,1.4985
207.59.95.15,<->,136.25.188.174,0,0,3,150,3,150,0.455151000,0.0294
199.68.213.222,<->,136.25.188.239,0,0,3,150,3,150,0.453213000,0.0034
92.27.219.240,<->,8.0.99.113,3,650,0,0,3,650,0.452998000,0.5139
98.236.122.10,<->,92.27.219.137,0,0,3,156,3,156,0.452768000,0.1352
195.14.13.180,<->,136.25.188.177,0,0,3,404,3,404,0.452534000,0.4035
194.232.127.41,<->,136.25.188.211,0,0,3,168,3,168,0.452427000,0.0016
197.199.194.201,<->,136.25.188.199,0,0,3,150,3,150,0.451872000,0.0352
197.113.99.224,<->,136.25.188.239,0,0,3,176,3,176,0.451743000,1.2816
207.57.17.49,<->,136.25.188.53,0,0,3,192,3,192,0.451048000,0.1979
136.25.188.225,<->,33.239.214.171,3,1309,0,0,3,1309,0.450778000,0.3400
82.132.18.228,<->,50.224.49.195,0,0,3,168,3,168,0.450769000,1.3802
215.158.238.198,<->,131.22.233.155,3,168,0,0,3,168,0.448925000,0.0008
43.55.251.75,<->,8.252.222.133,0,0,3,150,3,150,0.447327000,1.5454
136.25.188.227,<->,69.150.168.218,3,1389,0,0,3,1389,0.447019000,0.3962
133.178.226.61,<->,8.222.212.27,3,1245,0,0,3,1245,0.446476000,0.3643
136.25.189.13,<->,29.213.219.10,3,1525,0,0,3,1525,0.444938000,0.1108
109.1.9.150,<->,104.154.237.127,3,156,0,0,3,156,0.444840000,0.3040
109.1.54.101,<->,80.238.60.11,3,292,0,0,3,292,0.444809000,1.2787
97.215.89.190,<->,80.42.177.25,0,0,3,3367,3,3367,0.444355000,1.4979
215.158.239.92,<->,196.89.192.246,3,150,0,0,3,150,0.442449000,0.0037
143.72.72.239,<->,136.25.188.252,0,0,3,150,3,150,0.442054000,0.0032
92.27.219.178,<->,38.80.130.180,3,447,0,0,3,447,0.441906000,0.0063
215.158.238.72,<->,122.216.233.224,3,1421,0,0,3,1421,0.441372000,0.2495
133.178.226.162,<->,111.151.109.27,3,168,0,0,3,168,0.440917000,0.0000
215.158.239.76,<->,199.20.30.73,3,244,0,0,3,244,0.440755000,0.0701
215.158.239.31,<->,125.84.52.215,3,1466,0,0,3,1466,0.439765000,0.3657
133.178.226.80,<->,57.227.82.220,3,1357,0,0,3,1357,0.439555000,0.2132
215.158.239.58,<->,196.92.45.73,3,193,0,0,3,193,0.438993000,0.3400
215.158.238.93,<->,140.53.140.215,3,168,0,0,3,168,0.437972000,0.0002
215.158.239.56,<->,196.94.244.232,3,236,0,0,3,236,0.436752000,0.4690
54.92.36.247,<->,48.52.173.199,0,0,3,236,3,236,0.436361000,0.0072
93.142.250.183,<->,80.42.184.112,0,0,3,156,3,156,0.434955000,0.3999
207.173.224.148,<->,136.25.188.54,0,0,3,168,3,168,0.434930000,0.0615
215.158.239.29,<->,8.255.92.81,3,1274,0,0,3,1274,0.431872000,0.0355
100.94.92.99,<->,8.4.158.70,3,150,0,0,3,150,0.430843000,0.0012
195.68.185.110,<->,136.25.188.179,0,0,3,204,3,204,0.430827000,1.4600
215.158.239.49,<->,142.249.160.227,3,168,0,0,3,168,0.430352000,0.0195
199.68.205.254,<->,136.25.188.45,0,0,3,150,3,150,0.428541000,0.0030
199.72.168.144,<->,136.25.188.225,0,0,3,150,3,150,0.427096000,0.0052
207.173.4.200,<->,136.25.188.53,0,0,3,168,3,168,0.426931000,0.3200
80.40.2.168,<->,78.45.12.81,3,168,0,0,3,168,0.426336000,0.9784
215.158.239.78,<->,199.20.20.121,3,150,0,0,3,150,0.424793000,0.0407
220.39.233.55,<->,215.158.238.221,0,0,3,1199,3,1199,0.424597000,0.1258
207.217.71.87,<->,92.27.194.147,0,0,3,361,3,361,0.423602000,0.6466
133.178.226.30,<->,117.155.166.218,3,1261,0,0,3,1261,0.421910000,0.2064
215.158.239.76,<->,199.20.4.236,3,768,0,0,3,768,0.421702000,0.0398
158.27.245.185,<->,139.193.141.139,0,0,3,2021,3,2021,0.420817000,0.1171
142.207.218.88,<->,136.25.188.176,0,0,3,276,3,276,0.420379000,0.7001
204.200.164.92,<->,136.25.188.252,0,0,3,706,3,706,0.419933000,0.7584
112.87.195.113,<->,92.27.219.31,0,0,3,164,3,164,0.419321000,1.5212
133.178.227.76,<->,8.240.116.213,3,1181,0,0,3,1181,0.418734000,0.1838
136.25.189.80,<->,114.150.180.138,3,1389,0,0,3,1389,0.418720000,0.2426
101.70.121.187,<->,82.193.206.120,3,150,0,0,3,150,0.418535000,0.0195
142.236.50.26,<->,136.25.188.175,0,0,3,244,3,244,0.418041000,0.0036
142.223.190.242,<->,136.25.188.252,0,0,3,979,3,979,0.417736000,0.6208
53.201.28.135,<->,48.53.37.64,0,0,3,1272,3,1272,0.417575000,1.0379
215.158.239.94,<->,57.31.50.197,3,1469,0,0,3,1469,0.417389000,0.0912
203.215.181.236,<->,118.241.252.70,3,184,0,0,3,184,0.416763000,1.1489
142.218.110.190,<->,99.73.151.145,0,0,3,316,3,316,0.416756000,0.3774
204.1.132.51,<->,136.25.188.255,0,0,3,726,3,726,0.416437000,1.5202
215.158.239.49,<->,195.83.184.144,3,180,0,0,3,180,0.415844000,1.0442
215.158.239.92,<->,199.20.28.179,3,168,0,0,3,168,0.415254000,1.2619
215.158.239.56,<->,199.20.28.96,3,1135,0,0,3,1135,0.414373000,0.2700
192.205.242.89,<->,133.178.226.214,0,0,3,176,3,176,0.414365000,1.4939
139.193.141.139,<->,0.34.75.142,3,1789,0,0,3,1789,0.414267000,0.2973
136.25.189.13,<->,72.23.48.195,3,1325,0,0,3,1325,0.414228000,0.3263
144.75.218.233,<->,138.127.224.104,3,911,0,0,3,911,0.413898000,0.5374
215.158.61.243,<->,8.176.8.250,0,0,3,1520,3,1520,0.413739000,1.5754
215.158.238.107,<->,32.183.36.250,3,1277,0,0,3,1277,0.413654000,0.2201
136.25.189.31,<->,129.15.253.166,3,1309,0,0,3,1309,0.413220000,0.0299
206.102.5.199,<->,92.27.27.99,0,0,3,156,3,156,0.411097000,0.4139
215.158.140.171,<->,215.158.42.194,3,766,0,0,3,766,0.411043000,0.1812
215.158.103.219,<->,149.88.113.197,3,1632,0,0,3,1632,0.410845000,1.4995
192.65.81.245,<->,109.127.101.16,3,605,0,0,3,605,0.410718000,0.1002
199.71.2.125,<->,136.25.188.173,0,0,3,1026,3,1026,0.409722000,0.8196
231.138.197.58,<->,136.25.188.253,0,0,3,706,3,706,0.409667000,0.9195
215.158.238.209,<->,100.50.96.162,3,1469,0,0,3,1469,0.409581000,0.1830
215.158.238.220,<->,155.197.206.249,3,1155,0,0,3,1155,0.408482000,0.4462
204.60.97.95,<->,136.25.188.177,0,0,3,244,3,244,0.408026000,0.0200
54.37.130.82,<->,48.55.72.9,0,0,3,677,3,677,0.407964000,1.0170
133.244.28.234,<->,112.60.2.68,3,210,0,0,3,210,0.407548000,0.0024
110.73.111.83,<->,89.153.91.164,0,0,3,1452,3,1452,0.407515000,0.0909
231.143.121.182,<->,136.25.188.242,0,0,3,1010,3,1010,0.405991000,1.4796
132.128.61.174,<->,101.126.186.68,0,0,3,525,3,525,0.405966000,0.2351
118.192.88.114,<->,80.41.4.115,0,0,3,355,3,355,0.404212000,0.1164
148.247.248.83,<->,139.193.141.139,0,0,3,1844,3,1844,0.403993000,0.1659
199.15.39.181,<->,136.25.188.227,0,0,3,781,3,781,0.403771000,0.4940
111.181.122.247,<->,106.5.208.177,3,558,0,0,3,558,0.403550000,0.2678
136.25.189.77,<->,135.229.0.201,3,1485,0,0,3,1485,0.403102000,0.2726
133.178.227.76,<->,123.166.46.118,3,1357,0,0,3,1357,0.402045000,0.3024
17.23.199.82,<->,8.220.233.27,0,0,3,1550,3,1550,0.400643000,0.7596
213.38.133.55,<->,8.55.230.253,3,291,0,0,3,291,0.399412000,1.3994
216.184.2.219,<->,136.25.189.31,0,0,3,1057,3,1057,0.398776000,0.2736
215.158.238.243,<->,8.222.6.193,3,1246,0,0,3,1246,0.398578000,0.1611
136.25.188.221,<->,69.31.239.22,3,168,0,0,3,168,0.397969000,0.0016
215.158.239.56,<->,196.94.184.187,3,714,0,0,3,714,0.397911000,0.8193
133.178.227.95,<->,111.151.142.200,3,168,0,0,3,168,0.396544000,0.0001
8.52.178.174,<->,6.228.58.28,3,150,0,0,3,150,0.396324000,0.5822
192.64.248.242,<->,134.94.147.245,3,506,0,0,3,506,0.395465000,0.2796
136.25.188.227,<->,30.73.132.24,3,242,0,0,3,242,0.395208000,1.3200
149.99.93.52,<->,133.178.226.29,0,0,3,1261,3,1261,0.394200000,0.4936
105.134.162.139,<->,92.162.253.113,0,0,3,3613,3,3613,0.394039000,0.0000
142.254.200.98,<->,136.25.188.198,0,0,3,156,3,156,0.393252000,0.2084
215.158.239.85,<->,207.190.47.122,3,1142,0,0,3,1142,0.392969000,0.6202
207.178.152.255,<->,100.95.251.127,0,0,3,162,3,162,0.392007000,1.3508
199.72.84.129,<->,136.25.188.177,0,0,3,150,3,150,0.390685000,0.0029
215.158.239.30,<->,149.96.50.30,3,1672,0,0,3,1672,0.390259000,0.0970
215.158.238.148,<->,29.211.186.201,3,1485,0,0,3,1485,0.390136000,0.1746
222.20.200.135,<->,132.249.70.233,0,0,3,409,3,409,0.390009000,0.9599
149.96.171.61,<->,136.25.189.2,0,0,3,1485,3,1485,0.389769000,0.1015
136.25.189.80,<->,123.166.46.246,3,2290,0,0,3,2290,0.389349000,1.6093
89.204.34.26,<->,8.182.253.100,0,0,3,168,3,168,0.389200000,0.0222
136.25.189.57,<->,89.80.251.6,3,1373,0,0,3,1373,0.388762000,0.1942
102.83.203.80,<->,8.222.6.88,3,1263,0,0,3,1263,0.388489000,0.0663
199.82.70.213,<->,136.25.188.222,0,0,3,244,3,244,0.388352000,0.0039
215.158.239.56,<->,196.92.227.75,3,192,0,0,3,192,0.388282000,0.5797
136.25.189.0,<->,120.154.71.25,3,1613,0,0,3,1613,0.387598000,0.2350
192.64.244.21,<->,50.248.185.204,3,335,0,0,3,335,0.386058000,0.0372
143.134.247.135,<->,136.25.188.53,0,0,3,200,3,200,0.386035000,0.1949
215.158.239.99,<->,199.20.28.29,3,756,0,0,3,756,0.385748000,1.2751
8.252.221.181,<->,8.37.249.22,3,176,0,0,3,176,0.385151000,0.0263
215.158.239.86,<->,29.211.228.186,3,1394,0,0,3,1394,0.383460000,0.1303
138.55.243.19,<->,39.15.234.173,0,0,3,398,3,398,0.383142000,0.7831
129.114.182.135,<->,92.27.219.159,0,0,3,150,3,150,0.382534000,1.1833
56.8.135.115,<->,8.182.227.14,0,0,3,168,3,168,0.382149000,0.0091
133.178.226.29,<->,57.210.107.19,3,1357,0,0,3,1357,0.380244000,0.1737
206.195.145.185,<->,99.73.178.32,0,0,3,156,3,156,0.378603000,1.5521
142.254.239.139,<->,136.25.188.160,0,0,3,162,3,162,0.378483000,0.1550
204.200.34.19,<->,136.25.188.209,0,0,3,204,3,204,0.378095000,0.0050
215.158.239.77,<->,199.80.210.102,3,193,0,0,3,193,0.377564000,1.3933
210.156.216.109,<->,77.24.25.158,3,495,0,0,3,495,0.377028000,0.7406
215.158.239.86,<->,199.20.29.63,3,204,0,0,3,204,0.376980000,1.0768
215.158.239.58,<->,199.20.28.191,3,150,0,0,3,150,0.376861000,0.0036
215.158.238.241,<->,8.222.6.193,3,1421,0,0,3,1421,0.376363000,0.0526
136.25.188.254,<->,8.222.212.11,3,1341,0,0,3,1341,0.376060000,0.0310
215.158.61.191,<->,8.176.8.233,0,0,3,3581,3,3581,0.375986000,0.0000
210.229.230.18,<->,158.164.109.21,3,193,0,0,3,193,0.375761000,1.2200
215.158.239.95,<->,196.91.220.246,3,204,0,0,3,204,0.373520000,1.3404
206.195.188.76,<->,98.236.223.92,0,0,3,186,3,186,0.373449000,0.3219
139.193.141.139,<->,102.88.140.214,3,1974,0,0,3,1974,0.373331000,0.0549
148.255.136.245,<->,136.25.189.33,0,0,3,1325,3,1325,0.372649000,0.1619
109.222.246.96,<->,33.240.41.79,3,212,0,0,3,212,0.372027000,0.7249
115.67.32.44,<->,50.224.106.182,0,0,3,578,3,578,0.371653000,0.3410
136.25.189.45,<->,57.199.250.198,3,1485,0,0,3,1485,0.371518000,0.2011
143.251.236.192,<->,0.195.210.46,0,0,3,709,3,709,0.371322000,0.6193
142.228.48.148,<->,136.25.188.252,0,0,3,150,3,150,0.370718000,0.0032
98.67.155.63,<->,53.196.208.123,3,505,0,0,3,505,0.370642000,0.6932
215.158.239.49,<->,199.20.30.204,3,296,0,0,3,296,0.370499000,1.3601
215.158.238.73,<->,8.240.116.183,3,1261,0,0,3,1261,0.369455000,0.6434
133.178.226.30,<->,8.179.43.246,3,168,0,0,3,168,0.369036000,0.0008
159.140.232.210,<->,8.220.184.78,0,0,3,150,3,150,0.369028000,1.4803
215.158.140.231,<->,201.211.113.41,3,1509,0,0,3,1509,0.368394000,0.2594
136.25.188.55,<->,104.3.161.40,3,1341,0,0,3,1341,0.367632000,0.2092
215.158.238.96,<->,8.222.96.7,3,1421,0,0,3,1421,0.367386000,0.2795
111.20.168.27,<->,100.206.91.174,3,311,0,0,3,311,0.366451000,0.0529
136.181.43.98,<->,56.114.235.120,3,880,0,0,3,880,0.365213000,0.1240
220.55.174.116,<->,57.227.119.229,3,625,0,0,3,625,0.364822000,0.2979
204.58.108.39,<->,136.25.188.226,0,0,3,150,3,150,0.364445000,0.2254
148.174.129.26,<->,139.193.141.139,0,0,3,2058,3,2058,0.363952000,0.1244
215.158.238.33,<->,126.219.132.253,3,1469,0,0,3,1469,0.363498000,0.3475
136.25.189.1,<->,8.252.253.227,3,1773,0,0,3,1773,0.363291000,0.1258
220.55.78.176,<->,84.214.213.145,3,930,0,0,3,930,0.363052000,1.4588
215.158.239.105,<->,111.151.107.247,3,504,0,0,3,504,0.362580000,0.0197
93.212.119.47,<->,92.27.219.225,0,0,3,164,3,164,0.362151000,1.2460
215.158.239.99,<->,142.227.100.148,3,150,0,0,3,150,0.361846000,0.0062
247.136.142.216,<->,159.194.183.177,3,606,0,0,3,606,0.360884000,0.1386
215.158.239.57,<->,114.25.48.41,3,1325,0,0,3,1325,0.360201000,0.4072
202.33.58.1,<->,136.25.188.240,0,0,3,187,3,187,0.360147000,0.1766
133.178.226.7,<->,38.104.11.53,3,1485,0,0,3,1485,0.359343000,0.3638
215.158.238.95,<->,201.211.112.213,3,1069,0,0,3,1069,0.358444000,0.5122
215.158.239.125,<->,111.151.106.211,3,168,0,0,3,168,0.357454000,0.0001
220.39.233.7,<->,133.178.227.40,0,0,3,2235,3,2235,0.357436000,1.4766
215.158.61.145,<->,136.25.189.213,0,0,3,2107,3,2107,0.356745000,0.8220
139.193.141.139,<->,117.23.6.36,3,1915,0,0,3,1915,0.354841000,0.5315
247.136.136.112,<->,27.123.17.33,3,156,0,0,3,156,0.354707000,0.2854
144.65.187.11,<->,100.228.42.38,0,0,3,435,3,435,0.354156000,0.0477
206.141.194.98,<->,97.126.13.85,0,0,3,158,3,158,0.353256000,0.9000
192.226.161.53,<->,133.178.226.19,0,0,3,1309,3,1309,0.353019000,0.3228
102.45.241.111,<->,92.162.252.33,0,0,3,323,3,323,0.352793000,0.0241
194.233.123.96,<->,136.25.188.222,0,0,3,199,3,199,0.351618000,0.2601
243.117.82.191,<->,220.55.94.156,0,0,3,568,3,568,0.350126000,0.1041
215.158.239.93,<->,142.166.222.190,3,168,0,0,3,168,0.347587000,0.0031
80.42.142.180,<->,0.232.95.251,3,150,0,0,3,150,0.346856000,1.2536
215.158.239.68,<->,199.20.4.146,3,1112,0,0,3,1112,0.346039000,0.1597
215.158.239.57,<->,196.92.37.138,3,168,0,0,3,168,0.344929000,0.0103
39.22.29.188,<->,30.192.18.236,3,203,0,0,3,203,0.344247000,0.1269
126.196.222.83,<->,80.40.2.27,0,0,3,224,3,224,0.342741000,0.4057
215.158.238.176,<->,8.188.227.52,3,1192,0,0,3,1192,0.342112000,0.2916
215.158.239.48,<->,199.20.31.193,3,150,0,0,3,150,0.341980000,1.4854
90.240.140.159,<->,53.244.244.128,3,180,0,0,3,180,0.341827000,0.3554
48.16.115.206,<->,8.252.222.37,0,0,3,168,3,168,0.340851000,0.0041
110.57.3.72,<->,92.27.27.179,0,0,3,263,3,263,0.340488000,0.5034
215.158.239.16,<->,8.219.187.246,3,1206,0,0,3,1206,0.340282000,0.2761
199.52.136.207,<->,136.25.188.252,0,0,3,150,3,150,0.340082000,0.0045
215.158.140.75,<->,72.23.148.212,3,2202,0,0,3,2202,0.339108000,1.5621
210.229.230.19,<->,80.233.205.8,3,369,0,0,3,369,0.338792000,0.0349
215.158.239.56,<->,199.20.30.133,3,192,0,0,3,192,0.337381000,1.2700
133.54.21.231,<->,0.37.116.157,3,426,0,0,3,426,0.337376000,1.1996
215.158.238.135,<->,136.139.59.124,3,1213,0,0,3,1213,0.337257000,0.1187
136.25.189.57,<->,69.132.46.143,3,1469,0,0,3,1469,0.335533000,0.3296
100.208.13.217,<->,77.39.172.5,3,399,0,0,3,399,0.335106000,0.6727
215.158.239.99,<->,207.114.1.194,3,168,0,0,3,168,0.335009000,0.0000
195.40.28.13,<->,136.25.188.209,0,0,3,162,3,162,0.334919000,0.4928
215.158.238.72,<->,149.161.153.88,3,1485,0,0,3,1485,0.334264000,0.2091
58.202.67.48,<->,8.252.221.237,0,0,3,150,3,150,0.332407000,0.1628
148.146.105.150,<->,98.236.223.238,0,0,3,186,3,186,0.332176000,0.3803
148.155.131.56,<->,92.27.27.185,0,0,3,804,3,804,0.332020000,0.0000
247.136.222.54,<->,221.102.143.189,3,423,0,0,3,423,0.331920000,1.0780
215.158.238.97,<->,33.239.214.179,3,1469,0,0,3,1469,0.331078000,0.4199
110.42.4.97,<->,50.224.80.67,0,0,3,533,3,533,0.330500000,0.0883
204.200.50.7,<->,136.25.188.198,0,0,3,150,3,150,0.330474000,0.0025
215.158.238.112,<->,156.165.33.20,3,1309,0,0,3,1309,0.329936000,0.2168
123.163.186.237,<->,39.15.169.14,0,0,3,264,3,264,0.329713000,1.0138
215.158.238.82,<->,120.80.17.23,3,1325,0,0,3,1325,0.327128000,0.1803
215.158.239.86,<->,106.188.253.166,3,2610,0,0,3,2610,0.327094000,1.6458
145.116.223.6,<->,133.178.226.246,0,0,3,1202,3,1202,0.326778000,0.9032
127.255.84.41,<->,92.162.253.82,0,0,3,679,3,679,0.325510000,0.1096
137.69.84.28,<->,8.182.252.86,0,0,3,150,3,150,0.325159000,0.0973
202.33.228.202,<->,136.25.188.54,0,0,3,168,3,168,0.325124000,0.0200
207.173.110.156,<->,136.25.188.54,0,0,3,228,3,228,0.324989000,0.2600
136.25.189.77,<->,56.28.207.192,3,1453,0,0,3,1453,0.324141000,0.1120
215.158.239.56,<->,199.20.28.145,3,156,0,0,3,156,0.324095000,0.3195
136.25.189.77,<->,6.73.23.200,3,1309,0,0,3,1309,0.323912000,0.0296
207.125.50.180,<->,92.27.219.137,0,0,3,156,3,156,0.323760000,1.2619
136.116.9.78,<->,58.43.188.11,3,578,0,0,3,578,0.323613000,0.1310
133.178.226.78,<->,8.222.212.42,3,1325,0,0,3,1325,0.323547000,0.1239
215.158.239.85,<->,199.20.30.67,3,204,0,0,3,204,0.322742000,0.9878
159.115.14.88,<->,75.92.230.44,3,156,0,0,3,156,0.321472000,0.6422
215.158.238.105,<->,192.229.40.108,3,1325,0,0,3,1325,0.321233000,0.0318
136.116.9.67,<->,50.224.80.67,0,0,3,534,3,534,0.320639000,0.0801
215.158.239.86,<->,204.227.231.167,3,150,0,0,3,150,0.320360000,0.0040
200.175.88.134,<->,136.25.188.196,0,0,3,150,3,150,0.319835000,0.0009
215.158.61.195,<->,8.176.8.189,0,0,3,3597,3,3597,0.319405000,0.0000
142.236.26.159,<->,136.25.188.255,0,0,3,276,3,276,0.317934000,1.1701
90.240.140.153,<->,54.59.43.115,3,724,0,0,3,724,0.316825000,0.2705
205.20.144.62,<->,92.27.219.195,0,0,3,164,3,164,0.316672000,1.5279
215.158.239.56,<->,196.0.209.152,3,956,0,0,3,956,0.315319000,0.4395
133.178.226.244,<->,111.150.74.50,3,2349,0,0,3,2349,0.314032000,0.0332
215.158.239.96,<->,194.251.159.84,3,150,0,0,3,150,0.313756000,0.1605
92.27.4.183,<->,82.198.194.236,0,0,3,181,3,181,0.313571000,0.1835
195.40.165.103,<->,136.25.188.254,0,0,3,168,3,168,0.313224000,0.0055
215.158.238.234,<->,111.151.106.229,3,168,0,0,3,168,0.312948000,0.0000
152.99.196.203,<->,0.195.210.42,0,0,3,156,3,156,0.312470000,0.3396
207.239.73.208,<->,136.25.188.53,0,0,3,253,3,253,0.312094000,0.2146
124.140.224.235,<->,92.27.194.117,0,0,3,156,3,156,0.310709000,0.1581
89.153.94.107,<->,54.37.224.121,3,1172,0,0,3,1172,0.310630000,0.0615
158.28.223.211,<->,80.41.4.141,0,0,3,601,3,601,0.310050000,0.0998
132.216.20.76,<->,101.126.180.109,0,0,3,1028,3,1028,0.309475000,0.1198
215.158.239.92,<->,199.20.5.231,3,812,0,0,3,812,0.309382000,1.0215
215.158.239.51,<->,207.115.154.92,3,893,0,0,3,893,0.308819000,0.3200
139.193.141.139,<->,116.175.209.73,3,1839,0,0,3,1839,0.307501000,0.1300
133.178.226.80,<->,112.235.116.201,3,1261,0,0,3,1261,0.306056000,0.1226
197.113.99.89,<->,136.25.188.241,0,0,3,1595,3,1595,0.305967000,1.2794
121.204.206.54,<->,89.183.104.150,0,0,3,156,3,156,0.305907000,0.3319
215.158.239.71,<->,131.144.113.62,3,1341,0,0,3,1341,0.305390000,0.1690
97.182.7.27,<->,8.220.178.246,0,0,3,175,3,175,0.305276000,0.0317
204.62.154.252,<->,136.25.188.243,0,0,3,252,3,252,0.305242000,0.7591
215.158.238.45,<->,29.213.195.55,3,1837,0,0,3,1837,0.303967000,0.5037
111.150.207.194,<->,8.176.8.102,0,0,3,168,3,168,0.303638000,0.0001
149.178.48.81,<->,129.224.112.252,0,0,3,228,3,228,0.303296000,1.6768
207.58.119.140,<->,136.25.188.55,0,0,3,213,3,213,0.301935000,0.0493
215.158.239.94,<->,199.20.29.153,3,752,0,0,3,752,0.301454000,0.5607
133.178.227.79,<->,48.129.132.248,3,2434,0,0,3,2434,0.301092000,1.6445
215.158.103.206,<->,129.223.93.3,3,1917,0,0,3,1917,0.300709000,1.4799
215.158.239.58,<->,196.90.186.239,3,168,0,0,3,168,0.300586000,0.0000
215.158.140.27,<->,148.247.42.185,3,176,0,0,3,176,0.300179000,0.1392
215.158.238.85,<->,145.116.209.76,3,618,0,0,3,618,0.300042000,0.0414
86.194.117.165,<->,0.195.210.24,0,0,3,168,3,168,0.299860000,1.5217
117.153.13.77,<->,100.92.178.214,0,0,3,274,3,274,0.299757000,0.7350
133.178.227.159,<->,100.237.111.179,3,164,0,0,3,164,0.299494000,0.0257
197.7.105.245,<->,139.163.23.75,0,0,3,216,3,216,0.298899000,1.3362
133.178.227.55,<->,133.56.180.28,3,1376,0,0,3,1376,0.298115000,1.1382
192.64.247.242,<->,149.138.58.95,3,150,0,0,3,150,0.297844000,1.6222
133.178.226.37,<->,76.100.108.230,3,1325,0,0,3,1325,0.297813000,0.5625
92.27.219.222,<->,69.196.227.88,3,156,0,0,3,156,0.297768000,1.6858
199.32.124.159,<->,136.25.188.55,0,0,3,150,3,150,0.297754000,0.0020
195.68.174.236,<->,136.25.188.163,0,0,3,168,3,168,0.297462000,1.0400
215.158.239.84,<->,196.95.201.226,3,168,0,0,3,168,0.296765000,0.0000
215.158.239.4,<->,120.155.14.151,3,1860,0,0,3,1860,0.296311000,0.1180
133.178.226.30,<->,29.213.216.233,3,1165,0,0,3,1165,0.296252000,0.4791
100.198.81.146,<->,8.20.87.155,0,0,3,150,3,150,0.295889000,0.0398
215.158.234.124,<->,91.51.217.98,0,0,3,1704,3,1704,0.295609000,0.1264
220.55.169.75,<->,27.202.117.216,3,163,0,0,3,163,0.295460000,1.4863
195.14.252.131,<->,136.25.188.241,0,0,3,168,3,168,0.294757000,0.0029
215.158.238.23,<->,197.125.117.164,3,1581,0,0,3,1581,0.294732000,0.1620
196.24.196.46,<->,92.27.194.147,0,0,3,168,3,168,0.294545000,0.0000
197.81.83.18,<->,8.182.235.164,0,0,3,689,3,689,0.294123000,0.1168
215.158.239.84,<->,199.20.29.101,3,502,0,0,3,502,0.294035000,0.4706
215.158.239.58,<->,196.90.143.236,3,706,0,0,3,706,0.292069000,0.3098
215.158.238.236,<->,131.144.116.29,3,2164,0,0,3,2164,0.290872000,1.5503
206.223.69.156,<->,92.27.219.187,0,0,3,164,3,164,0.289898000,1.6069
215.158.239.78,<->,199.20.29.32,3,192,0,0,3,192,0.289365000,0.1196
199.51.121.87,<->,136.25.188.252,0,0,3,150,3,150,0.288494000,0.0028
246.253.168.253,<->,222.245.128.141,3,150,0,0,3,150,0.288032000,0.3543
247.136.136.55,<->,40.219.15.82,3,156,0,0,3,156,0.287868000,0.9365
133.178.226.28,<->,104.3.168.47,3,168,0,0,3,168,0.287078000,0.0003
131.72.58.79,<->,8.52.139.48,0,0,3,162,3,162,0.286046000,0.7995
136.181.48.230,<->,53.230.100.50,3,1501,0,0,3,1501,0.285964000,0.0864
132.136.195.201,<->,98.119.93.145,3,587,0,0,3,587,0.285815000,0.9348
207.188.217.118,<->,136.25.188.252,0,0,3,244,3,244,0.285749000,0.0037
192.70.16.212,<->,50.224.80.67,0,0,3,853,3,853,0.284878000,0.2364
197.105.54.16,<->,136.25.188.52,0,0,3,150,3,150,0.284848000,0.0030
215.158.239.68,<->,196.105.109.202,3,252,0,0,3,252,0.284383000,0.2599
136.25.188.237,<->,69.31.238.54,3,1437,0,0,3,1437,0.282790000,0.2109
195.103.44.34,<->,8.182.229.19,0,0,3,150,3,150,0.282716000,0.0000
133.225.140.202,<->,80.42.174.46,0,0,3,511,3,511,0.282279000,0.0600
197.113.99.154,<->,136.25.188.179,0,0,3,1320,3,1320,0.282238000,1.2614
35.56.96.200,<->,35.55.57.164,3,365,0,0,3,365,0.282168000,1.1149
215.158.239.85,<->,199.20.29.90,3,714,0,0,3,714,0.281661000,1.6920
215.158.239.32,<->,101.161.158.219,3,150,0,0,3,150,0.280984000,0.5546
215.158.239.7,<->,29.212.196.39,3,1596,0,0,3,1596,0.280395000,0.1324
215.158.239.76,<->,199.20.31.218,3,697,0,0,3,697,0.279598000,1.2204
204.187.158.135,<->,136.25.188.178,0,0,3,162,3,162,0.279311000,0.2653
199.69.255.191,<->,136.25.188.253,0,0,3,861,3,861,0.279020000,0.2605
136.25.188.240,<->,29.211.186.213,3,1325,0,0,3,1325,0.277504000,0.2192
195.7.204.209,<->,136.25.188.242,0,0,3,150,3,150,0.277450000,0.0032
215.158.103.219,<->,129.203.66.31,3,2100,0,0,3,2100,0.277150000,1.6209
124.149.71.236,<->,80.42.164.52,0,0,3,150,3,150,0.277066000,1.3043
207.172.140.89,<->,136.25.188.54,0,0,3,204,3,204,0.276885000,0.6995
215.158.239.19,<->,8.222.7.162,3,1325,0,0,3,1325,0.276283000,0.0337
215.158.239.94,<->,148.129.19.193,3,1597,0,0,3,1597,0.275865000,0.2118
213.186.59.192,<->,144.85.170.246,0,0,3,168,3,168,0.275790000,1.1880
133.178.226.61,<->,106.188.236.166,3,1485,0,0,3,1485,0.275322000,1.5816
215.158.238.140,<->,97.243.113.39,3,1469,0,0,3,1469,0.273809000,1.6597
215.158.238.6,<->,139.161.104.30,3,180,0,0,3,180,0.273664000,0.0290
215.158.239.76,<->,199.20.28.49,3,168,0,0,3,168,0.273589000,0.0963
144.75.218.235,<->,97.94.119.24,3,229,0,0,3,229,0.273519000,0.8246
215.158.239.4,<->,122.158.246.245,3,1615,0,0,3,1615,0.273453000,1.1461
197.113.64.253,<->,136.25.188.53,0,0,3,168,3,168,0.272956000,0.3907
159.13.141.83,<->,50.145.197.62,3,566,0,0,3,566,0.272895000,0.6068
215.158.239.58,<->,207.191.253.169,3,150,0,0,3,150,0.272629000,0.2335
145.76.230.106,<->,33.233.141.0,0,0,3,379,3,379,0.272551000,0.0571
80.42.160.104,<->,33.118.105.113,3,150,0,0,3,150,0.272269000,1.3619
122.173.78.57,<->,92.27.219.201,0,0,3,164,3,164,0.272201000,1.4649
215.158.239.50,<->,196.93.113.153,3,522,0,0,3,522,0.271810000,0.3594
53.148.20.156,<->,48.53.94.227,0,0,3,988,3,988,0.271464000,0.5828
213.38.244.185,<->,8.45.175.127,3,175,0,0,3,175,0.271289000,0.0075
195.71.159.111,<->,136.25.188.209,0,0,3,606,3,606,0.271170000,1.4169
204.61.201.44,<->,136.25.188.178,0,0,3,150,3,150,0.271038000,0.1674
136.25.188.254,<->,6.116.31.21,3,1341,0,0,3,1341,0.269701000,0.1837
136.25.189.11,<->,96.156.169.205,3,3693,0,0,3,3693,0.269647000,0.0000
215.158.239.77,<->,207.228.66.131,3,150,0,0,3,150,0.268636000,1.2799
220.55.91.137,<->,112.84.117.133,3,150,0,0,3,150,0.268124000,0.1960
215.158.239.97,<->,199.20.31.103,3,168,0,0,3,168,0.268032000,0.0000
143.20.129.97,<->,136.25.188.254,0,0,3,156,3,156,0.267309000,0.1271
215.158.239.99,<->,199.20.6.216,3,156,0,0,3,156,0.266600000,0.8394
120.241.71.24,<->,89.183.104.254,0,0,3,463,3,463,0.266385000,0.4188
215.158.239.50,<->,207.188.252.26,3,150,0,0,3,150,0.265992000,0.0749
142.190.39.7,<->,136.25.188.241,0,0,3,244,3,244,0.265505000,0.0036
143.245.251.3,<->,8.20.87.195,0,0,3,582,3,582,0.264734000,0.2940
204.200.63.174,<->,136.25.188.239,0,0,3,168,3,168,0.264667000,0.0000
215.158.238.236,<->,8.221.197.182,3,2291,0,0,3,2291,0.262206000,1.5080
223.114.39.35,<->,8.252.222.156,0,0,3,168,3,168,0.261408000,0.0004
193.39.70.30,<->,133.178.226.61,0,0,3,168,3,168,0.261141000,0.0003
142.191.122.134,<->,136.25.188.45,0,0,3,150,3,150,0.261089000,0.1932
215.158.238.45,<->,8.222.109.123,3,204,0,0,3,204,0.260815000,1.6145
220.55.64.92,<->,105.201.86.57,3,150,0,0,3,150,0.260658000,0.0127
142.227.66.226,<->,136.25.188.198,0,0,3,150,3,150,0.260416000,0.0029
215.158.239.49,<->,148.26.113.21,3,1501,0,0,3,1501,0.260171000,0.1578
117.242.104.229,<->,92.27.219.226,0,0,3,161,3,161,0.259620000,0.3761
215.158.238.73,<->,112.220.206.116,3,1389,0,0,3,1389,0.259588000,0.2195
111.151.106.254,<->,6.73.247.6,0,0,3,168,3,168,0.259507000,0.0000
215.158.239.95,<->,142.236.169.88,3,2774,0,0,3,2774,0.259407000,1.4447
215.158.239.57,<->,194.228.138.175,3,524,0,0,3,524,0.258978000,0.3408
133.8.10.152,<->,111.20.168.6,0,0,3,2425,3,2425,0.258740000,0.8764
215.158.140.75,<->,8.40.51.129,3,1306,0,0,3,1306,0.256114000,0.5720
200.174.211.210,<->,6.171.93.27,3,393,0,0,3,393,0.255042000,1.5809
204.185.6.155,<->,136.25.188.252,0,0,3,236,3,236,0.254842000,1.2001
142.190.166.245,<->,136.25.188.237,0,0,3,192,3,192,0.254588000,1.3477
215.158.239.95,<->,199.20.28.98,3,722,0,0,3,722,0.254350000,1.4910
89.183.104.245,<->,86.76.154.253,3,156,0,0,3,156,0.253971000,0.5031
142.248.52.241,<->,136.25.188.237,0,0,3,726,3,726,0.253599000,0.0744
195.40.35.100,<->,136.25.188.46,0,0,3,150,3,150,0.253238000,0.0035
195.5.157.190,<->,136.25.188.173,0,0,3,150,3,150,0.252827000,0.0030
197.113.99.188,<->,136.25.188.53,0,0,3,252,3,252,0.252748000,0.6305
159.137.162.213,<->,105.108.227.231,3,444,0,0,3,444,0.252575000,0.2219
152.43.76.51,<->,8.252.222.60,0,0,3,156,3,156,0.252495000,0.1417
92.27.219.240,<->,48.107.197.58,3,4410,0,0,3,4410,0.251884000,1.1488
94.108.46.88,<->,0.195.210.46,0,0,3,392,3,392,0.251811000,0.8519
117.6.108.183,<->,89.183.104.167,0,0,3,156,3,156,0.251737000,0.1228
136.25.189.33,<->,122.216.233.77,3,1485,0,0,3,1485,0.251355000,0.0942
92.27.219.159,<->,27.64.147.6,3,519,0,0,3,519,0.249957000,0.2691
231.142.9.149,<->,215.158.239.57,0,0,3,827,3,827,0.249265000,1.0131
193.46.99.189,<->,92.27.27.177,0,0,3,212,3,212,0.247765000,0.2684
53.201.106.213,<->,48.52.105.184,0,0,3,225,3,225,0.247178000,0.2915
210.221.111.110,<->,8.222.6.127,3,2441,0,0,3,2441,0.246645000,0.1756
139.148.43.59,<->,8.182.227.29,0,0,3,150,3,150,0.245965000,0.5018
105.67.82.43,<->,8.252.222.114,0,0,3,706,3,706,0.245650000,0.2816
192.64.234.182,<->,115.151.14.15,3,1120,0,0,3,1120,0.245610000,0.0131
215.158.239.78,<->,199.20.31.74,3,1128,0,0,3,1128,0.244976000,0.7276
133.178.227.14,<->,8.40.51.168,3,1165,0,0,3,1165,0.244791000,0.2342
54.92.112.61,<->,48.53.65.129,0,0,3,150,3,150,0.244554000,0.9991
215.158.239.58,<->,199.20.29.33,3,738,0,0,3,738,0.243781000,1.1159
215.158.238.251,<->,61.35.70.37,3,1182,0,0,3,1182,0.241666000,0.3135
142.254.141.3,<->,136.25.188.225,0,0,3,193,3,193,0.241201000,1.4598
215.158.239.76,<->,207.244.14.234,3,1144,0,0,3,1144,0.240585000,0.6809
105.201.188.253,<->,102.50.97.98,0,0,3,294,3,294,0.240361000,0.9821
143.41.1.67,<->,50.223.3.228,0,0,3,150,3,150,0.239216000,1.4309
89.155.144.53,<->,8.183.25.124,0,0,3,156,3,156,0.238374000,0.0232
215.158.238.106,<->,29.211.4.180,3,168,0,0,3,168,0.237101000,1.3026
215.158.238.73,<->,194.205.112.171,3,1485,0,0,3,1485,0.236298000,0.2451
199.53.252.184,<->,136.25.188.173,0,0,3,168,3,168,0.235913000,0.0030
220.40.166.213,<->,215.158.238.33,0,0,3,1437,3,1437,0.235856000,0.1871
199.122.160.203,<->,136.25.188.163,0,0,3,344,3,344,0.235435000,1.6252
111.146.144.234,<->,53.68.162.248,3,2299,0,0,3,2299,0.235363000,1.0419
215.158.239.48,<->,207.239.97.8,3,150,0,0,3,150,0.234726000,0.0029
136.25.189.63,<->,96.156.169.166,3,1870,0,0,3,1870,0.234193000,0.1010
215.158.239.24,<->,215.158.127.153,3,2616,0,0,3,2616,0.234147000,0.0878
215.158.238.98,<->,133.73.194.233,3,1309,0,0,3,1309,0.233448000,0.7288
195.55.148.0,<->,136.25.188.238,0,0,3,150,3,150,0.233163000,0.0020
221.102.143.189,<->,80.41.2.180,0,0,3,423,3,423,0.232893000,1.4380
195.68.119.184,<->,136.25.188.222,0,0,3,220,3,220,0.232252000,0.5620
92.27.219.198,<->,40.222.57.185,3,150,0,0,3,150,0.231875000,0.1513
136.25.189.4,<->,129.175.139.163,3,3405,0,0,3,3405,0.231812000,0.0000
156.165.37.85,<->,136.25.189.89,0,0,3,168,3,168,0.230633000,0.0218
145.19.9.66,<->,81.96.98.4,3,240,0,0,3,240,0.229797000,1.2411
215.158.238.73,<->,8.219.184.150,3,1357,0,0,3,1357,0.229430000,0.1450
136.25.188.161,<->,135.231.170.176,3,168,0,0,3,168,0.229302000,0.0004
80.38.0.9,<->,38.38.209.227,3,156,0,0,3,156,0.228018000,1.6505
215.158.238.72,<->,42.226.3.107,3,1421,0,0,3,1421,0.227649000,0.3196
215.158.239.95,<->,195.7.109.234,3,170,0,0,3,170,0.226396000,0.7200
195.64.5.202,<->,8.20.87.206,0,0,3,639,3,639,0.225904000,0.0696
246.253.235.13,<->,76.3.28.78,3,209,0,0,3,209,0.225402000,0.2400
215.158.239.95,<->,207.239.46.211,3,168,0,0,3,168,0.225059000,0.0059
152.100.66.219,<->,8.252.222.179,0,0,3,180,3,180,0.224044000,0.4528
215.158.239.49,<->,196.107.133.9,3,176,0,0,3,176,0.224008000,1.0407
92.27.219.180,<->,72.62.223.132,3,170,0,0,3,170,0.223184000,0.3787
142.41.107.1,<->,92.27.219.251,0,0,3,150,3,150,0.223139000,1.4460
136.25.188.163,<->,114.25.48.63,3,168,0,0,3,168,0.222906000,0.0011
142.236.66.64,<->,136.25.188.242,0,0,3,714,3,714,0.222234000,1.1119
53.161.15.106,<->,48.53.220.217,0,0,3,334,3,334,0.221468000,0.3863
92.27.219.238,<->,29.44.96.146,3,156,0,0,3,156,0.220858000,0.5448
197.112.167.113,<->,136.25.188.55,0,0,3,346,3,346,0.220105000,0.0000
199.15.141.195,<->,136.25.188.242,0,0,3,244,3,244,0.219959000,0.1194
144.87.235.222,<->,120.83.145.40,3,398,0,0,3,398,0.219745000,0.2355
215.158.239.96,<->,199.20.30.53,3,168,0,0,3,168,0.219571000,0.0001
8.252.223.175,<->,8.219.184.94,3,2258,0,0,3,2258,0.218878000,1.6084
215.158.239.87,<->,196.104.45.206,3,150,0,0,3,150,0.218122000,0.1483
207.79.157.237,<->,99.72.167.52,0,0,3,175,3,175,0.218059000,0.9135
207.115.7.231,<->,92.27.194.147,0,0,3,361,3,361,0.217759000,0.4640
215.158.239.70,<->,196.93.124.127,3,260,0,0,3,260,0.217509000,1.1600
95.246.36.189,<->,8.252.221.206,0,0,3,184,3,184,0.217351000,0.1524
215.158.195.9,<->,111.150.207.201,3,212,0,0,3,212,0.216595000,1.1125
215.158.238.91,<->,145.116.209.92,3,168,0,0,3,168,0.216466000,0.0387
33.124.235.126,<->,22.59.37.233,0,0,3,150,3,150,0.216193000,1.0013
142.247.243.57,<->,136.25.188.46,0,0,3,168,3,168,0.216004000,0.1261
215.158.238.92,<->,131.36.198.50,3,1584,0,0,3,1584,0.215304000,0.7526
252.98.132.211,<->,54.46.168.68,3,1454,0,0,3,1454,0.215062000,0.1076
139.193.141.139,<->,124.55.74.224,3,1879,0,0,3,1879,0.214440000,0.2030
142.244.204.227,<->,136.25.188.242,0,0,3,403,3,403,0.214136000,0.8111
215.158.239.70,<->,195.6.240.39,3,150,0,0,3,150,0.214112000,0.0041
136.25.189.94,<->,96.156.169.251,3,2525,0,0,3,2525,0.214021000,0.0578
144.75.218.235,<->,138.127.231.62,3,777,0,0,3,777,0.212886000,1.2414
221.102.143.189,<->,192.65.236.21,0,0,3,423,3,423,0.211912000,1.4660
215.158.239.95,<->,199.20.29.209,3,752,0,0,3,752,0.211606000,0.5911
215.158.239.56,<->,142.254.249.248,3,168,0,0,3,168,0.210388000,0.0028
92.181.148.15,<->,92.27.219.61,0,0,3,987,3,987,0.210369000,0.8640
215.158.239.33,<->,8.255.92.138,3,1146,0,0,3,1146,0.209345000,0.0277
215.158.239.77,<->,199.20.29.70,3,168,0,0,3,168,0.208851000,0.0399
118.100.76.40,<->,109.222.212.23,0,0,3,224,3,224,0.208381000,0.2157
215.158.239.68,<->,199.32.117.198,3,251,0,0,3,251,0.207727000,0.1185
207.63.63.213,<->,136.25.188.46,0,0,3,150,3,150,0.207054000,1.3116
135.75.82.203,<->,89.183.104.174,0,0,3,150,3,150,0.206728000,1.3867
132.187.21.147,<->,8.182.245.110,0,0,3,150,3,150,0.206362000,0.0463
215.158.238.83,<->,112.220.206.107,3,1405,0,0,3,1405,0.205824000,0.1211
215.158.238.198,<->,69.150.169.254,3,1198,0,0,3,1198,0.205422000,0.2278
215.158.238.148,<->,29.214.73.157,3,168,0,0,3,168,0.205183000,0.0006
17.99.162.116,<->,8.52.189.207,0,0,3,150,3,150,0.205176000,0.0236
48.18.214.152,<->,8.252.222.150,0,0,3,168,3,168,0.205016000,0.0000
129.1.68.239,<->,112.208.20.240,3,698,0,0,3,698,0.204905000,0.3981
92.27.219.39,<->,78.46.142.27,3,948,0,0,3,948,0.204387000,1.7781
223.141.52.98,<->,111.147.69.106,0,0,3,188,3,188,0.203807000,1.7727
215.158.239.108,<->,215.158.61.202,3,2426,0,0,3,2426,0.203787000,0.0886
215.158.239.49,<->,196.108.16.150,3,150,0,0,3,150,0.203174000,0.0703
194.204.149.101,<->,50.223.3.228,0,0,3,150,3,150,0.203028000,0.0101
50.224.76.235,<->,38.30.94.85,3,1600,0,0,3,1600,0.202437000,0.3545
206.195.206.101,<->,129.92.113.35,0,0,3,292,3,292,0.202374000,0.1309
197.113.99.236,<->,136.25.188.55,0,0,3,820,3,820,0.201977000,1.7504
220.28.108.254,<->,215.158.239.65,0,0,3,2594,3,2594,0.201789000,0.0903
143.22.101.172,<->,8.182.241.177,0,0,3,549,3,549,0.201516000,0.4243
204.200.55.93,<->,136.25.188.220,0,0,3,830,3,830,0.201045000,0.6920
143.128.155.113,<->,136.25.188.54,0,0,3,225,3,225,0.200470000,0.0081
159.137.162.213,<->,6.212.69.136,3,444,0,0,3,444,0.200411000,0.1213
247.136.177.71,<->,105.90.245.152,3,150,0,0,3,150,0.200009000,1.6623
215.158.239.48,<->,204.1.185.76,3,693,0,0,3,693,0.199799000,0.9900
142.252.229.148,<->,136.25.188.239,0,0,3,150,3,150,0.199606000,0.0030
215.158.238.96,<->,143.155.227.33,3,1347,0,0,3,1347,0.199334000,1.7689
194.237.2.156,<->,136.25.188.198,0,0,3,156,3,156,0.199203000,0.1826
210.221.107.50,<->,8.222.6.226,3,302,0,0,3,302,0.198984000,0.2156
215.158.239.71,<->,29.213.219.40,3,2723,0,0,3,2723,0.198151000,1.7908
215.158.239.87,<->,195.80.82.72,3,402,0,0,3,402,0.197779000,0.7006
136.25.188.197,<->,104.3.161.55,3,1325,0,0,3,1325,0.197457000,0.2514
215.158.140.7,<->,91.57.169.16,3,205,0,0,3,205,0.197326000,0.0001
146.10.166.93,<->,136.25.189.83,0,0,3,1029,3,1029,0.196718000,0.2914
145.208.180.148,<->,53.68.232.129,3,539,0,0,3,539,0.196286000,0.1120
215.158.238.33,<->,69.132.194.169,3,168,0,0,3,168,0.196164000,0.0006
143.79.40.158,<->,136.25.188.52,0,0,3,162,3,162,0.196148000,0.0055
138.68.166.197,<->,8.252.221.249,0,0,3,1683,3,1683,0.196139000,0.2293
200.175.139.115,<->,54.37.5.99,3,199,0,0,3,199,0.195763000,0.0009
109.222.223.113,<->,53.234.201.87,3,749,0,0,3,749,0.193656000,0.0817
215.158.239.19,<->,126.219.102.191,3,1591,0,0,3,1591,0.193477000,0.3489
112.21.231.57,<->,80.38.41.124,0,0,3,168,3,168,0.193395000,0.0008
215.158.238.33,<->,140.174.80.136,3,1469,0,0,3,1469,0.193358000,0.3659
215.158.239.92,<->,199.72.90.111,3,168,0,0,3,168,0.192151000,0.0097
136.25.189.30,<->,69.132.46.143,3,168,0,0,3,168,0.192007000,0.7680
142.207.227.148,<->,136.25.188.226,0,0,3,156,3,156,0.191742000,0.1664
136.25.189.14,<->,42.97.54.96,3,1293,0,0,3,1293,0.191583000,0.1941
133.244.31.120,<->,80.27.154.175,3,311,0,0,3,311,0.191213000,0.0776
195.107.189.92,<->,0.195.210.46,0,0,3,755,3,755,0.190880000,0.1924
196.148.79.57,<->,8.181.37.222,3,3134,0,0,3,3134,0.190723000,0.0000
210.229.230.22,<->,99.213.176.44,3,236,0,0,3,236,0.190434000,1.1841
215.158.238.67,<->,8.220.51.215,3,168,0,0,3,168,0.190154000,0.0097
215.158.239.79,<->,199.20.6.234,3,168,0,0,3,168,0.190086000,0.0039
204.58.57.119,<->,136.25.188.220,0,0,3,1121,3,1121,0.187367000,1.1113
121.10.132.194,<->,92.27.219.63,0,0,3,652,3,652,0.187079000,0.6152
111.150.207.240,<->,99.74.26.108,0,0,3,168,3,168,0.186392000,0.0000
98.57.214.227,<->,8.228.218.33,0,0,3,882,3,882,0.185678000,0.0013
199.51.84.120,<->,136.25.188.243,0,0,3,168,3,168,0.185670000,0.0451
215.158.238.33,<->,207.217.81.70,3,1261,0,0,3,1261,0.185450000,0.1992
195.14.35.104,<->,92.27.27.158,0,0,3,150,3,150,0.184506000,1.5125
215.158.238.67,<->,106.188.183.96,3,1530,0,0,3,1530,0.184384000,0.1094
215.158.238.148,<->,126.219.194.161,3,168,0,0,3,168,0.184197000,0.0005
231.255.128.157,<->,97.198.123.121,0,0,3,242,3,242,0.184138000,0.4627
203.215.103.208,<->,118.241.252.70,3,184,0,0,3,184,0.183830000,1.1538
196.246.191.34,<->,136.25.188.177,0,0,3,314,3,314,0.183264000,0.7000
136.25.188.236,<->,30.73.95.215,3,199,0,0,3,199,0.183134000,0.5793
142.240.168.221,<->,136.25.188.210,0,0,3,244,3,244,0.183070000,0.0059
215.158.239.94,<->,199.20.6.137,3,201,0,0,3,201,0.182760000,0.7630
215.158.238.223,<->,126.219.100.189,3,1157,0,0,3,1157,0.181905000,0.1632
195.64.145.70,<->,8.182.244.179,0,0,3,150,3,150,0.181419000,0.1675
136.25.189.83,<->,56.28.207.201,3,1565,0,0,3,1565,0.179873000,0.2434
136.25.188.197,<->,29.214.108.90,3,1421,0,0,3,1421,0.178904000,0.1144
207.59.57.219,<->,136.25.188.196,0,0,3,150,3,150,0.178262000,0.0042
198.204.76.255,<->,136.25.188.224,0,0,3,1117,3,1117,0.178182000,0.1528
136.25.189.2,<->,72.23.194.222,3,1469,0,0,3,1469,0.177716000,0.3611
109.3.128.230,<->,8.45.175.127,3,199,0,0,3,199,0.177476000,0.0754
194.193.197.231,<->,99.75.33.195,0,0,3,190,3,190,0.177300000,1.0216
196.251.167.249,<->,80.41.29.163,0,0,3,238,3,238,0.176911000,0.7961
204.60.43.163,<->,136.25.188.252,0,0,3,212,3,212,0.176328000,0.2180
144.87.238.89,<->,8.182.227.71,0,0,3,150,3,150,0.175884000,0.0234
215.158.238.105,<->,8.47.120.244,3,1133,0,0,3,1133,0.175851000,0.2693
192.67.139.145,<->,42.81.250.54,3,183,0,0,3,183,0.175744000,0.6573
115.83.161.215,<->,35.56.96.84,0,0,3,482,3,482,0.175585000,0.1276
204.63.46.255,<->,136.25.188.177,0,0,3,192,3,192,0.175484000,1.0400
215.158.238.67,<->,8.240.116.201,3,199,0,0,3,199,0.174838000,0.0255
215.158.140.83,<->,61.72.108.237,3,1343,0,0,3,1343,0.174823000,0.1820
143.134.48.175,<->,136.25.188.242,0,0,3,294,3,294,0.174742000,0.2737
80.27.158.225,<->,75.92.190.105,3,1710,0,0,3,1710,0.174517000,0.0001
220.16.80.188,<->,8.182.248.147,0,0,3,150,3,150,0.174234000,1.5199
204.200.39.27,<->,136.25.188.161,0,0,3,150,3,150,0.174134000,0.0032
215.158.239.56,<->,199.20.5.70,3,1129,0,0,3,1129,0.173343000,1.1157
92.27.219.149,<->,66.16.107.179,3,192,0,0,3,192,0.173328000,1.2709
133.178.226.30,<->,30.249.194.138,3,168,0,0,3,168,0.173228000,0.0000
207.62.131.115,<->,136.25.188.209,0,0,3,150,3,150,0.173219000,0.0205
221.102.143.189,<->,109.3.189.142,0,0,3,423,3,423,0.173105000,1.4060
215.158.238.148,<->,134.172.158.199,3,1373,0,0,3,1373,0.171582000,1.3879
215.158.238.95,<->,89.85.89.215,3,1405,0,0,3,1405,0.171374000,0.1287
215.158.239.84,<->,143.91.200.242,3,244,0,0,3,244,0.171326000,0.0100
199.33.198.154,<->,136.25.188.177,0,0,3,193,3,193,0.170705000,0.2015
139.193.141.139,<->,112.19.158.143,3,1830,0,0,3,1830,0.170533000,0.1680
197.113.64.250,<->,136.25.188.55,0,0,3,168,3,168,0.169303000,0.1001
204.200.52.137,<->,136.25.188.174,0,0,3,150,3,150,0.169282000,0.2761
194.237.65.93,<->,136.25.188.177,0,0,3,461,3,461,0.168382000,1.8074
80.42.155.7,<->,8.44.70.165,3,406,0,0,3,406,0.168247000,0.0316
215.158.238.104,<->,131.144.113.163,3,168,0,0,3,168,0.168197000,0.0402
215.158.239.76,<->,196.91.129.33,3,168,0,0,3,168,0.167931000,1.5490
215.158.239.69,<->,199.68.13.79,3,706,0,0,3,706,0.167895000,0.3317
220.20.200.65,<->,149.19.161.234,3,445,0,0,3,445,0.167884000,0.1122
204.123.249.197,<->,8.182.248.147,0,0,3,229,3,229,0.167626000,0.0493
207.236.165.249,<->,136.25.188.177,0,0,3,150,3,150,0.167601000,0.0108
195.4.58.66,<->,136.25.188.196,0,0,3,168,3,168,0.167231000,0.0032
204.2.55.203,<->,136.25.188.239,0,0,3,150,3,150,0.167190000,0.0035
133.178.227.6,<->,111.151.142.171,3,168,0,0,3,168,0.165521000,0.0000
100.92.104.175,<->,88.8.73.190,3,238,0,0,3,238,0.165288000,0.3576
215.158.239.48,<->,199.20.31.74,3,1128,0,0,3,1128,0.164636000,0.3192
142.175.72.165,<->,50.224.76.230,0,0,3,150,3,150,0.164562000,0.0065
204.56.248.21,<->,136.25.188.253,0,0,3,162,3,162,0.163796000,1.3119
231.143.135.39,<->,136.25.188.209,0,0,3,199,3,199,0.163529000,0.1899
53.200.87.5,<->,48.54.6.32,0,0,3,669,3,669,0.163221000,0.2836
192.64.211.88,<->,78.45.179.241,3,592,0,0,3,592,0.160934000,1.5390
215.158.239.93,<->,194.251.64.62,3,877,0,0,3,877,0.160340000,0.3847
215.202.174.57,<->,215.158.238.81,0,0,3,168,3,168,0.159614000,0.0008
92.27.219.249,<->,80.247.29.166,3,164,0,0,3,164,0.159011000,1.0931
144.87.238.91,<->,8.182.227.180,0,0,3,150,3,150,0.158885000,0.0230
121.215.135.130,<->,98.236.223.238,0,0,3,150,3,150,0.157886000,1.6889
252.138.212.250,<->,136.25.188.178,0,0,3,1038,3,1038,0.157194000,1.3997
136.25.189.57,<->,57.31.64.72,3,1421,0,0,3,1421,0.156309000,0.1105
215.158.239.34,<->,80.47.111.181,3,1309,0,0,3,1309,0.156147000,0.2008
139.128.242.158,<->,92.27.219.60,0,0,3,156,3,156,0.156105000,1.2967
133.178.226.224,<->,8.53.223.192,3,206,0,0,3,206,0.155907000,0.2587
215.158.239.57,<->,199.20.30.111,3,241,0,0,3,241,0.155807000,0.2699
215.158.238.84,<->,145.116.209.4,3,626,0,0,3,626,0.155772000,0.0390
215.158.239.76,<->,196.93.78.245,3,184,0,0,3,184,0.155439000,1.6599
139.193.141.139,<->,113.183.198.133,3,1972,0,0,3,1972,0.155296000,0.1248
215.158.239.86,<->,207.88.93.20,3,180,0,0,3,180,0.154415000,0.0002
215.158.238.133,<->,148.190.126.51,3,168,0,0,3,168,0.153836000,0.0000
195.42.140.1,<->,136.25.188.252,0,0,3,771,3,771,0.153314000,0.2560
207.63.186.120,<->,136.25.188.52,0,0,3,150,3,150,0.152157000,1.7088
215.202.174.43,<->,215.158.239.93,0,0,3,1469,3,1469,0.152147000,0.2374
215.158.239.78,<->,199.20.29.212,3,168,0,0,3,168,0.151562000,0.1002
215.158.239.101,<->,129.222.39.167,3,221,0,0,3,221,0.151101000,0.0213
215.158.239.33,<->,126.219.102.214,3,1446,0,0,3,1446,0.150066000,0.2818
6.145.171.84,<->,0.195.210.8,0,0,3,1165,3,1165,0.149899000,1.8302
80.38.16.208,<->,37.119.83.124,3,557,0,0,3,557,0.149840000,1.3429
104.47.205.174,<->,92.27.219.157,0,0,3,164,3,164,0.149225000,1.2915
215.158.238.148,<->,91.57.174.7,3,168,0,0,3,168,0.148894000,0.0003
215.158.239.59,<->,206.103.215.196,3,168,0,0,3,168,0.148653000,0.0003
92.27.27.185,<->,89.164.72.67,3,156,0,0,3,156,0.147795000,1.2142
192.64.217.166,<->,149.151.124.60,3,218,0,0,3,218,0.147201000,0.6766
215.158.239.48,<->,199.20.31.138,3,340,0,0,3,340,0.147150000,1.0707
159.137.162.213,<->,93.215.154.0,3,444,0,0,3,444,0.146806000,0.2443
139.47.253.215,<->,111.147.243.205,0,0,3,634,3,634,0.146411000,0.0902
143.68.143.91,<->,136.25.188.177,0,0,3,150,3,150,0.146037000,0.0179
53.249.52.16,<->,50.224.109.239,0,0,3,176,3,176,0.143512000,0.1664
215.158.239.234,<->,192.226.44.116,3,345,0,0,3,345,0.143445000,0.0189
195.54.93.226,<->,8.52.168.247,0,0,3,150,3,150,0.143418000,1.8072
215.158.238.196,<->,8.240.116.197,3,180,0,0,3,180,0.142800000,0.0941
215.158.239.29,<->,141.199.67.7,3,168,0,0,3,168,0.141229000,0.0001
135.243.190.251,<->,8.52.179.111,0,0,3,834,3,834,0.140886000,0.5001
212.70.217.74,<->,136.25.188.242,0,0,3,168,3,168,0.140104000,1.5236
92.27.27.165,<->,79.210.151.187,3,180,0,0,3,180,0.140000000,1.6009
80.27.158.233,<->,6.255.60.209,3,2607,0,0,3,2607,0.138998000,0.0757
215.158.239.77,<->,196.94.239.58,3,204,0,0,3,204,0.138708000,1.1601
92.27.27.174,<->,27.25.112.156,3,156,0,0,3,156,0.138397000,0.1764
207.41.108.253,<->,8.182.241.177,0,0,3,682,3,682,0.137672000,0.6083
221.102.143.189,<->,220.80.132.211,0,0,3,168,3,168,0.137505000,0.7150
54.37.211.103,<->,48.53.162.29,0,0,3,336,3,336,0.136735000,0.7339
215.158.239.5,<->,96.135.154.124,3,1745,0,0,3,1745,0.136094000,0.2787
80.38.39.90,<->,53.250.249.111,3,365,0,0,3,365,0.135784000,0.7354
204.186.172.248,<->,136.25.188.209,0,0,3,1016,3,1016,0.135628000,0.7195
200.175.51.143,<->,53.213.63.93,3,749,0,0,3,749,0.135072000,0.3245
205.188.162.40,<->,192.67.172.77,0,0,3,399,3,399,0.134751000,1.8345
215.158.140.206,<->,41.132.115.82,3,1726,0,0,3,1726,0.134573000,0.6794
215.158.239.70,<->,204.0.146.238,3,1024,0,0,3,1024,0.134482000,0.6594
136.25.189.0,<->,61.35.70.200,3,1469,0,0,3,1469,0.134141000,0.3107
220.55.65.3,<->,76.100.67.143,3,156,0,0,3,156,0.134104000,1.4568
139.193.141.139,<->,27.149.104.52,3,1876,0,0,3,1876,0.133761000,0.0903
143.135.156.251,<->,136.25.188.45,0,0,3,162,3,162,0.132753000,1.0705
207.172.141.218,<->,136.25.188.175,0,0,3,204,3,204,0.131959000,1.7698
98.231.246.244,<->,64.104.209.129,0,0,3,4512,3,4512,0.131834000,1.3521
136.25.188.47,<->,29.212.43.247,3,168,0,0,3,168,0.130904000,0.0010
195.70.116.13,<->,136.25.188.162,0,0,3,244,3,244,0.130269000,0.0017
159.137.162.213,<->,122.205.7.221,3,444,0,0,3,444,0.130178000,0.2137
215.158.238.72,<->,57.227.82.232,3,1373,0,0,3,1373,0.129229000,0.2473
215.158.61.189,<->,8.176.8.188,0,0,3,2322,3,2322,0.128582000,0.9442
139.193.141.209,<->,122.238.67.234,3,671,0,0,3,671,0.128564000,0.6992
80.27.156.119,<->,77.147.46.186,3,2864,0,0,3,2864,0.128184000,1.6468
111.147.252.19,<->,111.5.197.195,3,1338,0,0,3,1338,0.128117000,0.0547
136.139.59.86,<->,136.25.188.243,0,0,3,1485,3,1485,0.127254000,1.0230
109.91.112.127,<->,100.228.42.40,0,0,3,749,3,749,0.127068000,0.5441
195.126.180.140,<->,136.25.188.255,0,0,3,168,3,168,0.126920000,0.0150
229.45.59.129,<->,8.181.151.154,3,518,0,0,3,518,0.125148000,0.2193
136.25.189.0,<->,29.214.73.130,3,1485,0,0,3,1485,0.125104000,0.3858
92.27.219.23,<->,88.122.3.5,3,176,0,0,3,176,0.124799000,1.6887
215.158.239.84,<->,199.20.30.200,3,150,0,0,3,150,0.124412000,0.6516
192.65.82.15,<->,91.231.209.213,3,150,0,0,3,150,0.124366000,1.2440
142.182.137.237,<->,136.25.188.176,0,0,3,168,3,168,0.124244000,0.0020
215.158.239.76,<->,204.61.205.154,3,706,0,0,3,706,0.123326000,0.8121
193.21.29.250,<->,102.51.182.154,0,0,3,156,3,156,0.122839000,0.1181
143.41.107.161,<->,50.224.76.234,0,0,3,1537,3,1537,0.121719000,0.1690
199.80.157.206,<->,136.25.188.253,0,0,3,204,3,204,0.121648000,0.0041
215.158.239.78,<->,199.20.28.221,3,244,0,0,3,244,0.121115000,0.0100
215.158.140.195,<->,99.74.26.195,3,1092,0,0,3,1092,0.119305000,0.0246
92.27.219.211,<->,68.76.106.67,3,164,0,0,3,164,0.119184000,1.3000
136.25.188.242,<->,104.3.168.202,3,1373,0,0,3,1373,0.118678000,0.3304
247.136.156.42,<->,105.67.199.153,3,178,0,0,3,178,0.118621000,0.5964
207.62.19.122,<->,136.25.188.162,0,0,3,212,3,212,0.118002000,0.3139
103.121.131.2,<->,8.220.190.86,0,0,3,658,3,658,0.117593000,0.7041
204.184.188.252,<->,136.25.188.178,0,0,3,212,3,212,0.117246000,1.4001
222.31.15.60,<->,8.220.239.84,0,0,3,168,3,168,0.117183000,0.0395
215.158.239.84,<->,195.97.121.41,3,156,0,0,3,156,0.117100000,0.6107
215.158.239.85,<->,199.15.112.32,3,722,0,0,3,722,0.117084000,1.6338
215.158.238.65,<->,114.94.161.196,3,168,0,0,3,168,0.116991000,0.0006
111.20.172.70,<->,101.224.89.131,0,0,3,511,3,511,0.116477000,0.9996
200.174.219.227,<->,53.68.206.154,3,1053,0,0,3,1053,0.116093000,0.1287
133.178.226.19,<->,113.23.104.247,3,1229,0,0,3,1229,0.116005000,1.3258
111.20.172.70,<->,33.233.141.82,0,0,3,426,3,426,0.115919000,1.0033
215.158.239.56,<->,195.80.195.48,3,168,0,0,3,168,0.115811000,0.0451
144.38.71.156,<->,8.204.73.39,3,1658,0,0,3,1658,0.115661000,0.0040
215.158.239.85,<->,204.0.247.88,3,244,0,0,3,244,0.115634000,0.0202
207.191.229.134,<->,136.25.188.196,0,0,3,150,3,150,0.115316000,0.0024
215.158.238.221,<->,126.219.100.188,3,1213,0,0,3,1213,0.114879000,0.3081
54.37.53.245,<->,48.53.243.255,0,0,3,1286,3,1286,0.114457000,0.3478
204.3.62.50,<->,136.25.188.174,0,0,3,162,3,162,0.114447000,0.5116
215.158.238.135,<->,131.36.198.32,3,168,0,0,3,168,0.114359000,0.0005
220.87.72.39,<->,89.183.104.138,0,0,3,164,3,164,0.114089000,1.1433
215.158.239.56,<->,199.20.28.7,3,200,0,0,3,200,0.114087000,0.2800
8.220.190.86,<->,6.101.113.132,3,589,0,0,3,589,0.114085000,0.0477
195.68.38.36,<->,136.25.188.55,0,0,3,236,3,236,0.112796000,1.1399
136.25.188.179,<->,116.107.47.35,3,168,0,0,3,168,0.112467000,0.0006
96.40.165.34,<->,8.220.190.86,0,0,3,150,3,150,0.112065000,0.0050
215.158.239.99,<->,199.81.22.225,3,156,0,0,3,156,0.111934000,0.2224
102.44.98.96,<->,54.36.89.97,3,336,0,0,3,336,0.111825000,0.2100
136.25.189.13,<->,124.11.230.205,3,1373,0,0,3,1373,0.110344000,0.2229
142.221.253.237,<->,136.25.188.45,0,0,3,667,3,667,0.109549000,1.0303
215.158.140.78,<->,215.158.2.230,3,1815,0,0,3,1815,0.109200000,1.1557
204.200.34.248,<->,136.25.188.177,0,0,3,168,3,168,0.109019000,0.0921
124.246.66.111,<->,92.27.219.193,0,0,3,164,3,164,0.108455000,1.2775
136.25.188.47,<->,33.209.219.58,3,1293,0,0,3,1293,0.108109000,1.0659
145.19.6.243,<->,97.68.17.69,3,445,0,0,3,445,0.107931000,1.2943
111.20.172.70,<->,33.233.141.87,0,0,3,359,3,359,0.107429000,0.0089
143.20.81.160,<->,136.25.188.175,0,0,3,156,3,156,0.106750000,0.7152
142.240.161.240,<->,136.25.188.45,0,0,3,726,3,726,0.105514000,0.8986
215.158.238.67,<->,122.159.245.165,3,1341,0,0,3,1341,0.105428000,0.3852
200.174.222.92,<->,54.36.230.207,3,405,0,0,3,405,0.104918000,0.2860
215.158.238.45,<->,29.212.198.104,3,1293,0,0,3,1293,0.104546000,0.2296
215.158.238.241,<->,131.22.233.144,3,1156,0,0,3,1156,0.103995000,0.6879
110.66.221.173,<->,92.27.219.247,0,0,3,1540,3,1540,0.103853000,0.7728
204.200.41.151,<->,136.25.188.255,0,0,3,162,3,162,0.103468000,0.3679
137.181.238.64,<->,8.43.215.120,0,0,3,150,3,150,0.102380000,0.0289
204.63.125.33,<->,136.25.188.242,0,0,3,296,3,296,0.101458000,1.2711
195.70.225.207,<->,136.25.188.52,0,0,3,168,3,168,0.101109000,0.0372
115.86.156.192,<->,22.59.37.233,0,0,3,150,3,150,0.101065000,0.9984
197.113.64.191,<->,136.25.188.208,0,0,3,168,3,168,0.100114000,0.0399
215.158.140.111,<->,192.171.13.80,3,561,0,0,3,561,0.100052000,0.0095
200.174.194.133,<->,53.245.246.100,3,646,0,0,3,646,0.099842000,0.3106
215.158.239.79,<->,207.114.226.249,3,168,0,0,3,168,0.099427000,0.0201
142.178.170.173,<->,50.223.3.228,0,0,3,156,3,156,0.099409000,1.4239
215.158.239.76,<->,199.106.116.106,3,168,0,0,3,168,0.099196000,0.0000
215.158.239.79,<->,194.232.3.98,3,270,0,0,3,270,0.098371000,0.3481
215.158.238.134,<->,148.23.229.11,3,1261,0,0,3,1261,0.098294000,0.1970
195.55.121.2,<->,136.25.188.252,0,0,3,150,3,150,0.098049000,0.0034
143.52.16.152,<->,136.25.188.209,0,0,3,168,3,168,0.097333000,0.0098
197.119.129.152,<->,8.183.25.25,0,0,3,199,3,199,0.097172000,0.2226
215.158.140.60,<->,113.23.56.134,3,168,0,0,3,168,0.097159000,0.0001
243.148.62.228,<->,0.195.210.8,0,0,3,162,3,162,0.096774000,0.2747
104.40.239.30,<->,89.183.104.147,0,0,3,2531,3,2531,0.096431000,0.4440
204.63.221.23,<->,136.25.188.45,0,0,3,192,3,192,0.096388000,1.7397
144.122.240.201,<->,144.108.80.170,3,203,0,0,3,203,0.096151000,0.1238
148.35.244.117,<->,139.193.141.139,0,0,3,168,3,168,0.096008000,0.0975
148.176.50.196,<->,50.224.89.241,0,0,3,168,3,168,0.093865000,0.0091
111.20.172.70,<->,101.224.89.245,0,0,3,365,3,365,0.093516000,0.0065
75.214.166.48,<->,8.252.222.158,0,0,3,168,3,168,0.093427000,0.0365
206.164.141.175,<->,92.27.219.190,0,0,3,164,3,164,0.093281000,1.6181
109.222.238.4,<->,53.195.188.160,3,1569,0,0,3,1569,0.092651000,1.1012
231.143.98.110,<->,136.25.188.177,0,0,3,168,3,168,0.092577000,1.4207
142.252.140.253,<->,136.25.188.236,0,0,3,376,3,376,0.092489000,1.1210
215.158.238.251,<->,48.129.132.249,3,1421,0,0,3,1421,0.092437000,1.0897
149.254.114.195,<->,133.178.226.37,0,0,3,168,3,168,0.092153000,0.0006
210.229.230.21,<->,111.74.211.171,3,249,0,0,3,249,0.091377000,0.0594
246.253.157.15,<->,124.119.31.199,3,150,0,0,3,150,0.091329000,0.1285
136.25.189.9,<->,96.156.169.204,3,1645,0,0,3,1645,0.091104000,0.1423
220.55.123.87,<->,27.11.31.205,3,150,0,0,3,150,0.091024000,0.0006
215.158.238.198,<->,8.192.205.0,3,168,0,0,3,168,0.090657000,0.0010
215.158.140.75,<->,131.144.112.245,3,1150,0,0,3,1150,0.090329000,0.1627
133.178.227.14,<->,29.211.165.11,3,1306,0,0,3,1306,0.089894000,1.1747
215.158.239.99,<->,199.20.5.176,3,244,0,0,3,244,0.089563000,0.0373
139.193.141.139,<->,119.111.182.206,3,2042,0,0,3,2042,0.089392000,0.0960
159.137.162.213,<->,103.186.254.87,3,444,0,0,3,444,0.088688000,0.1161
142.220.26.164,<->,136.25.188.198,0,0,3,909,3,909,0.088681000,0.3084
156.156.178.129,<->,8.252.222.134,0,0,3,326,3,326,0.087114000,0.1545
215.158.238.65,<->,112.220.206.22,3,168,0,0,3,168,0.085244000,0.0000
215.158.239.68,<->,199.20.31.247,3,168,0,0,3,168,0.085228000,0.0000
207.57.158.246,<->,136.25.188.53,0,0,3,150,3,150,0.084801000,0.0027
252.98.139.211,<->,139.33.175.144,3,1198,0,0,3,1198,0.084249000,0.0630
195.6.191.204,<->,136.25.188.178,0,0,3,168,3,168,0.084054000,0.3381
195.5.162.72,<->,136.25.188.46,0,0,3,168,3,168,0.084044000,0.0403
231.140.69.7,<->,215.158.239.51,0,0,3,706,3,706,0.083450000,0.1740
135.79.232.55,<->,109.1.54.145,0,0,3,360,3,360,0.083059000,0.1006
215.158.239.96,<->,199.20.29.115,3,744,0,0,3,744,0.082593000,1.7803
197.161.157.214,<->,136.25.188.225,0,0,3,168,3,168,0.082401000,0.0081
120.41.154.32,<->,92.168.217.252,0,0,3,168,3,168,0.082340000,0.0751
199.38.189.17,<->,136.25.188.178,0,0,3,156,3,156,0.082184000,0.6799
221.102.143.189,<->,192.64.78.135,0,0,3,338,3,338,0.081807000,1.8000
145.216.238.18,<->,111.146.175.90,0,0,3,156,3,156,0.081616000,1.6182
215.158.239.96,<->,199.20.6.120,3,726,0,0,3,726,0.081484000,1.8197
215.158.239.77,<->,196.107.97.91,3,288,0,0,3,288,0.081291000,1.6004
142.208.41.60,<->,136.25.188.46,0,0,3,667,3,667,0.080919000,0.5310
220.28.115.46,<->,136.25.189.6,0,0,3,2290,3,2290,0.080903000,0.0288
199.33.137.209,<->,136.25.188.255,0,0,3,162,3,162,0.080815000,0.0042
197.109.193.7,<->,136.25.188.209,0,0,3,156,3,156,0.079192000,0.2600
132.18.67.28,<->,100.182.180.242,0,0,3,445,3,445,0.078882000,0.0520
89.155.5.148,<->,8.182.227.71,0,0,3,156,3,156,0.078487000,0.0236
215.158.238.67,<->,80.47.228.219,3,1453,0,0,3,1453,0.078286000,0.0606
215.158.239.49,<->,133.56.180.31,3,2658,0,0,3,2658,0.078280000,1.2661
215.158.239.96,<->,199.20.31.237,3,170,0,0,3,170,0.078234000,0.5112
220.55.123.87,<->,127.65.173.253,3,162,0,0,3,162,0.078207000,1.6101
136.25.188.163,<->,116.106.61.226,3,1309,0,0,3,1309,0.078065000,0.2548
215.158.239.91,<->,98.219.126.140,3,2754,0,0,3,2754,0.077949000,0.0937
101.87.213.136,<->,100.228.42.72,0,0,3,749,3,749,0.077924000,0.0531
139.160.226.166,<->,136.25.188.178,0,0,3,168,3,168,0.077369000,0.0001
109.222.200.67,<->,50.145.81.54,3,554,0,0,3,554,0.076604000,0.0809
89.83.204.91,<->,20.192.127.114,0,0,3,150,3,150,0.076569000,1.3263
215.158.140.252,<->,8.222.212.22,3,1250,0,0,3,1250,0.075977000,0.0451
204.184.202.173,<->,136.25.188.222,0,0,3,199,3,199,0.075845000,0.1802
215.158.239.93,<->,57.199.250.221,3,1469,0,0,3,1469,0.074857000,0.1934
53.201.231.216,<->,48.53.35.6,0,0,3,721,3,721,0.074676000,0.2766
145.237.135.90,<->,137.21.23.222,0,0,3,1126,3,1126,0.073927000,1.1725
215.158.239.40,<->,96.135.154.126,3,168,0,0,3,168,0.073574000,0.0003
100.206.91.174,<->,33.233.141.91,0,0,3,311,3,311,0.073541000,0.0529
192.224.21.11,<->,136.25.189.32,0,0,3,1517,3,1517,0.073529000,1.6675
245.244.35.2,<->,8.182.226.78,0,0,3,706,3,706,0.073421000,0.1800
149.197.244.196,<->,144.71.43.240,0,0,3,213,3,213,0.073076000,0.4124
215.158.239.93,<->,196.91.122.97,3,252,0,0,3,252,0.073045000,0.6387
215.158.239.77,<->,196.91.86.109,3,406,0,0,3,406,0.072418000,0.2611
192.171.13.80,<->,8.252.222.19,0,0,3,398,3,398,0.071127000,1.4250
131.148.26.40,<->,100.228.42.102,0,0,3,761,3,761,0.070894000,0.4609
215.158.238.95,<->,99.192.168.186,3,1387,0,0,3,1387,0.069886000,0.0742
195.6.249.197,<->,136.25.188.199,0,0,3,180,3,180,0.069843000,0.2127
192.64.101.33,<->,8.55.224.156,3,261,0,0,3,261,0.069083000,1.4380
194.238.244.139,<->,136.25.188.253,0,0,3,150,3,150,0.068912000,0.0029
106.213.32.103,<->,8.252.222.141,0,0,3,150,3,150,0.068560000,0.1440
139.105.162.25,<->,99.81.176.123,3,176,0,0,3,176,0.067486000,1.9256
111.20.172.70,<->,111.20.168.28,0,0,3,370,3,370,0.065236000,0.9985
133.178.226.200,<->,29.214.216.100,3,168,0,0,3,168,0.064932000,0.0921
146.249.226.90,<->,8.252.222.151,0,0,3,168,3,168,0.064723000,0.2291
133.178.226.202,<->,72.151.67.120,3,168,0,0,3,168,0.064623000,0.1505
118.209.199.81,<->,92.27.219.247,0,0,3,1011,3,1011,0.064541000,1.0466
136.25.188.209,<->,96.30.181.225,3,150,0,0,3,150,0.064369000,1.6275
204.184.41.206,<->,136.25.188.176,0,0,3,714,3,714,0.063867000,1.0299
199.53.35.67,<->,136.25.188.222,0,0,3,150,3,150,0.063595000,0.0094
199.32.193.136,<->,136.25.188.241,0,0,3,706,3,706,0.063434000,0.3050
195.41.210.142,<->,136.25.188.196,0,0,3,649,3,649,0.063217000,1.1255
193.1.1.67,<->,101.70.111.87,0,0,3,246,3,246,0.062990000,1.9284
246.254.97.112,<->,56.114.235.120,3,679,0,0,3,679,0.062506000,0.0454
136.25.188.161,<->,72.23.194.203,3,168,0,0,3,168,0.062468000,0.0000
204.3.43.57,<->,136.25.188.160,0,0,3,168,3,168,0.062088000,0.0030
215.158.238.241,<->,106.188.253.228,3,1157,0,0,3,1157,0.061896000,0.1300
221.102.143.189,<->,98.129.57.240,0,0,3,4374,3,4374,0.061486000,1.4380
148.155.129.25,<->,101.224.89.208,0,0,3,496,3,496,0.060302000,1.0016
102.232.21.79,<->,89.90.104.87,3,506,0,0,3,506,0.059999000,0.0496
215.158.239.96,<->,196.91.240.5,3,162,0,0,3,162,0.059067000,1.1822
136.25.188.167,<->,100.224.202.157,3,168,0,0,3,168,0.058886000,0.0616
146.234.135.111,<->,136.25.189.80,0,0,3,1453,3,1453,0.058690000,0.1675
143.68.153.232,<->,136.25.188.255,0,0,3,270,3,270,0.058119000,0.3969
138.127.224.225,<->,33.233.141.10,0,0,3,723,3,723,0.057477000,0.0045
194.237.254.104,<->,136.25.188.236,0,0,3,199,3,199,0.057239000,0.1779
48.131.158.235,<->,8.252.223.143,0,0,3,1293,3,1293,0.056922000,0.1838
215.158.239.99,<->,199.20.6.222,3,168,0,0,3,168,0.056900000,0.5414
133.178.226.28,<->,122.158.70.40,3,1309,0,0,3,1309,0.056870000,0.1783
17.199.97.8,<->,8.20.87.210,0,0,3,150,3,150,0.056640000,0.0001
215.158.239.76,<->,199.20.5.203,3,168,0,0,3,168,0.056554000,0.6200
215.158.239.87,<->,199.20.30.223,3,150,0,0,3,150,0.055740000,1.7694
215.158.239.85,<->,196.93.114.117,3,296,0,0,3,296,0.055551000,1.2625
230.60.74.150,<->,96.31.74.8,0,0,3,399,3,399,0.055423000,1.7190
212.70.75.118,<->,136.25.189.15,0,0,3,1341,3,1341,0.055305000,0.2074
215.158.238.33,<->,112.235.95.74,3,1176,0,0,3,1176,0.055234000,0.4972
202.33.237.102,<->,136.25.188.240,0,0,3,193,3,193,0.055050000,0.2700
136.25.189.28,<->,91.247.40.69,3,1661,0,0,3,1661,0.054829000,0.1046
207.172.243.214,<->,136.25.188.176,0,0,3,1207,3,1207,0.054820000,1.7798
94.195.50.10,<->,8.252.221.205,0,0,3,150,3,150,0.054721000,0.0528
125.216.33.160,<->,8.252.222.176,0,0,3,168,3,168,0.054296000,0.0017
215.158.239.93,<->,122.216.233.155,3,1325,0,0,3,1325,0.054063000,0.0938
98.232.166.102,<->,57.211.62.3,3,250,0,0,3,250,0.053597000,0.1054
195.12.113.10,<->,136.25.188.175,0,0,3,706,3,706,0.052602000,0.4322
215.158.239.49,<->,207.58.9.163,3,204,0,0,3,204,0.052291000,1.7801
200.174.223.85,<->,54.36.129.165,3,334,0,0,3,334,0.052272000,0.2878
196.87.31.201,<->,136.25.188.52,0,0,3,830,3,830,0.051907000,0.9800
215.158.239.94,<->,8.215.68.90,3,1504,0,0,3,1504,0.051398000,0.4936
142.245.147.40,<->,136.25.188.253,0,0,3,199,3,199,0.051384000,0.2296
215.158.238.92,<->,126.219.196.185,3,2754,0,0,3,2754,0.050731000,1.8580
195.7.52.238,<->,136.25.188.198,0,0,3,150,3,150,0.050504000,0.0081
195.13.141.81,<->,136.25.188.174,0,0,3,168,3,168,0.050165000,0.1494
112.11.67.228,<->,92.27.219.155,0,0,3,150,3,150,0.050021000,0.1039
231.142.5.48,<->,136.25.188.254,0,0,3,150,3,150,0.049842000,0.0032
215.158.238.250,<->,113.23.56.88,3,1200,0,0,3,1200,0.049651000,1.4768
136.25.189.89,<->,106.188.253.137,3,168,0,0,3,168,0.049542000,0.0003
102.244.195.51,<->,35.56.100.188,0,0,3,150,3,150,0.048812000,1.0001
192.64.208.1,<->,100.124.212.156,3,488,0,0,3,488,0.048806000,0.3130
215.158.61.193,<->,8.176.8.199,0,0,3,2524,3,2524,0.048493000,0.7181
53.201.208.209,<->,8.30.106.217,0,0,3,281,3,281,0.048330000,0.1261
207.51.234.203,<->,0.195.210.46,0,0,3,1460,3,1460,0.048298000,0.4194
136.25.188.225,<->,57.247.184.229,3,1453,0,0,3,1453,0.048041000,1.8430
215.158.239.77,<->,8.252.253.225,3,1309,0,0,3,1309,0.047887000,1.6988
192.64.200.112,<->,134.18.200.92,3,220,0,0,3,220,0.047836000,1.5874
215.158.239.48,<->,199.20.30.28,3,901,0,0,3,901,0.047557000,0.6000
204.186.22.14,<->,136.25.188.254,0,0,3,228,3,228,0.047512000,1.1201
204.0.163.55,<->,136.25.188.255,0,0,3,663,3,663,0.047168000,1.6010
246.253.198.51,<->,126.109.98.254,3,150,0,0,3,150,0.046931000,0.1146
148.26.113.236,<->,133.178.227.24,0,0,3,1167,3,1167,0.046366000,0.2784
148.198.183.187,<->,132.249.70.233,0,0,3,243,3,243,0.046223000,0.9694
145.78.129.144,<->,8.220.239.66,0,0,3,193,3,193,0.046039000,0.0250
138.127.224.225,<->,33.233.141.43,0,0,3,719,3,719,0.045797000,0.0047
106.168.190.215,<->,80.40.1.196,0,0,3,1278,3,1278,0.045669000,0.4317
215.158.239.92,<->,196.88.76.140,3,150,0,0,3,150,0.045539000,1.4435
215.158.239.94,<->,149.163.129.243,3,1405,0,0,3,1405,0.045068000,1.5878
192.229.210.156,<->,50.10.84.183,3,199,0,0,3,199,0.044959000,0.0330
193.7.225.128,<->,8.220.176.253,0,0,3,659,3,659,0.044749000,0.1950
215.158.239.76,<->,196.1.96.2,3,168,0,0,3,168,0.044747000,0.8284
210.221.111.77,<->,60.92.18.35,3,218,0,0,3,218,0.044636000,1.0334
215.158.239.95,<->,196.107.73.46,3,830,0,0,3,830,0.044595000,0.2898
50.183.211.51,<->,8.52.246.194,0,0,3,2270,3,2270,0.044367000,0.0487
215.158.239.69,<->,199.20.7.188,3,180,0,0,3,180,0.044127000,0.0001
207.58.110.254,<->,136.25.188.196,0,0,3,156,3,156,0.043790000,0.0074
109.1.54.101,<->,107.127.118.108,3,335,0,0,3,335,0.043610000,0.1121
204.60.200.201,<->,136.25.188.176,0,0,3,204,3,204,0.043480000,1.8398
221.102.143.189,<->,109.0.198.192,0,0,3,276,3,276,0.043463000,1.5980
127.240.164.174,<->,50.224.76.235,0,0,3,1889,3,1889,0.043272000,0.6175
199.72.30.100,<->,136.25.188.220,0,0,3,162,3,162,0.043143000,0.2836
92.27.27.177,<->,42.27.147.254,3,441,0,0,3,441,0.042768000,0.1482
215.158.239.85,<->,196.109.193.180,3,168,0,0,3,168,0.042442000,0.0050
215.158.239.97,<->,194.237.76.134,3,168,0,0,3,168,0.041969000,0.1500
76.145.196.38,<->,8.52.222.199,0,0,3,715,3,715,0.041106000,0.3559
215.158.239.56,<->,199.20.5.38,3,150,0,0,3,150,0.041043000,0.6876
194.237.7.196,<->,136.25.188.225,0,0,3,204,3,204,0.040921000,0.0071
215.158.239.41,<->,8.222.7.169,3,1329,0,0,3,1329,0.040560000,0.0350
143.10.227.173,<->,136.25.188.196,0,0,3,726,3,726,0.040454000,1.3992
136.25.188.224,<->,42.97.54.62,3,1341,0,0,3,1341,0.040375000,0.3845
215.158.239.70,<->,199.20.29.81,3,244,0,0,3,244,0.040119000,0.0000
207.58.171.205,<->,133.32.39.50,0,0,3,150,3,150,0.039814000,0.8531
98.16.139.251,<->,8.52.171.31,0,0,3,175,3,175,0.039790000,0.0308
8.252.222.179,<->,4.20.144.197,3,180,0,0,3,180,0.039523000,0.2780
136.25.188.226,<->,29.211.6.19,3,168,0,0,3,168,0.039383000,0.0001
196.148.133.194,<->,58.131.3.21,3,150,0,0,3,150,0.038887000,1.5848
17.61.229.116,<->,8.220.204.147,0,0,3,1501,3,1501,0.038590000,0.1458
111.199.229.21,<->,0.195.210.44,0,0,3,287,3,287,0.037735000,0.1534
215.158.61.242,<->,8.176.8.244,0,0,3,2338,3,2338,0.037676000,0.4446
215.158.239.182,<->,106.188.226.67,3,317,0,0,3,317,0.036944000,0.0993
124.149.71.236,<->,6.122.156.201,0,0,3,150,3,150,0.036857000,1.3021
69.103.229.5,<->,8.252.222.37,0,0,3,192,3,192,0.036409000,0.5526
136.25.189.82,<->,113.23.66.212,3,1421,0,0,3,1421,0.036002000,1.6717
136.25.189.59,<->,131.6.152.4,3,1357,0,0,3,1357,0.035959000,0.2290
192.64.196.112,<->,119.152.219.102,3,2473,0,0,3,2473,0.035423000,0.6491
93.224.188.210,<->,89.183.104.244,0,0,3,150,3,150,0.034694000,0.0990
215.158.239.50,<->,199.121.90.76,3,168,0,0,3,168,0.033505000,0.0141
215.158.239.182,<->,68.231.30.24,3,206,0,0,3,206,0.033329000,0.2386
213.221.90.189,<->,144.85.170.246,0,0,3,168,3,168,0.033224000,1.6600
136.139.59.124,<->,136.25.188.175,0,0,3,168,3,168,0.033093000,0.0008
215.158.140.204,<->,8.222.7.154,3,1085,0,0,3,1085,0.032964000,0.1227
98.101.71.148,<->,8.182.251.218,0,0,3,150,3,150,0.032871000,0.0081
122.193.78.143,<->,50.224.76.234,0,0,3,156,3,156,0.032826000,1.9288
246.253.157.15,<->,113.59.49.51,3,150,0,0,3,150,0.032595000,0.1153
138.127.224.225,<->,33.233.141.67,0,0,3,731,3,731,0.032296000,0.0056
136.25.189.12,<->,135.229.0.221,3,1357,0,0,3,1357,0.031907000,0.2942
215.158.239.68,<->,199.20.7.66,3,436,0,0,3,436,0.031862000,1.8601
143.12.162.87,<->,136.25.188.173,0,0,3,244,3,244,0.031602000,0.0036
142.254.67.153,<->,136.25.188.243,0,0,3,156,3,156,0.031582000,0.0281
17.213.58.90,<->,8.220.181.167,0,0,3,162,3,162,0.030809000,1.8484
231.136.125.79,<->,136.25.188.209,0,0,3,168,3,168,0.030639000,0.1781
129.16.253.173,<->,129.1.96.220,0,0,3,874,3,874,0.030450000,0.0416
139.163.26.238,<->,110.198.133.116,3,162,0,0,3,162,0.029969000,0.0294
129.224.112.252,<->,27.127.251.41,3,226,0,0,3,226,0.029777000,0.0073
195.65.65.233,<->,8.182.243.89,0,0,3,168,3,168,0.029753000,0.1810
125.85.102.191,<->,8.52.189.42,0,0,3,150,3,150,0.029663000,1.0411
215.158.239.59,<->,8.220.51.251,3,1405,0,0,3,1405,0.029589000,1.8425
8.252.223.153,<->,8.192.205.73,3,1145,0,0,3,1145,0.029464000,0.2156
215.158.61.145,<->,8.176.8.104,0,0,3,510,3,510,0.029361000,1.0922
220.55.79.118,<->,198.206.5.108,3,239,0,0,3,239,0.028942000,0.7540
195.68.190.21,<->,136.25.188.46,0,0,3,168,3,168,0.028167000,0.5025
215.158.238.123,<->,197.125.116.84,3,1149,0,0,3,1149,0.028032000,0.1853
215.158.239.94,<->,113.23.66.232,3,1437,0,0,3,1437,0.027898000,0.1347
159.137.162.213,<->,122.217.246.204,3,444,0,0,3,444,0.026675000,0.2378
133.178.226.80,<->,38.104.11.3,3,168,0,0,3,168,0.026353000,0.0001
218.188.29.5,<->,80.27.158.180,0,0,3,150,3,150,0.026343000,0.2079
215.158.238.95,<->,33.239.214.170,3,1805,0,0,3,1805,0.025433000,0.2697
112.105.25.216,<->,91.231.193.200,0,0,3,150,3,150,0.025212000,0.2935
143.89.180.115,<->,136.25.188.176,0,0,3,180,3,180,0.024661000,0.2023
215.158.239.97,<->,196.105.121.181,3,269,0,0,3,269,0.024572000,0.3160
215.158.239.49,<->,194.238.211.170,3,150,0,0,3,150,0.024239000,0.0059
203.88.127.223,<->,136.25.188.45,0,0,3,150,3,150,0.023392000,0.0528
195.55.223.117,<->,136.25.188.176,0,0,3,150,3,150,0.023295000,0.0030
194.194.227.156,<->,99.75.102.6,0,0,3,156,3,156,0.023264000,0.1900
197.7.105.169,<->,8.182.228.163,0,0,3,204,3,204,0.023018000,0.2440
246.253.198.51,<->,57.234.142.227,3,150,0,0,3,150,0.022988000,0.1622
204.63.132.211,<->,136.25.188.177,0,0,3,362,3,362,0.022788000,0.0201
100.174.6.88,<->,8.182.248.147,0,0,3,181,3,181,0.022780000,1.6212
215.158.238.97,<->,131.144.113.169,3,1501,0,0,3,1501,0.022620000,0.3897
215.158.239.79,<->,194.202.105.155,3,877,0,0,3,877,0.022297000,1.3000
197.7.105.203,<->,8.182.136.93,0,0,3,818,3,818,0.022240000,0.5470
92.27.219.246,<->,88.5.66.212,3,168,0,0,3,168,0.022105000,0.6767
215.158.238.177,<->,61.35.22.200,3,1187,0,0,3,1187,0.021999000,0.2753
133.178.227.76,<->,8.57.163.181,3,168,0,0,3,168,0.021958000,1.6651
204.200.33.164,<->,136.25.188.253,0,0,3,150,3,150,0.021936000,0.0058
117.10.216.132,<->,50.224.76.235,0,0,3,1645,3,1645,0.021398000,0.2429
215.158.66.212,<->,133.178.226.197,0,0,3,168,3,168,0.021378000,0.0219
139.193.141.139,<->,0.34.13.137,3,1764,0,0,3,1764,0.021108000,0.0954
136.25.188.202,<->,80.57.141.218,3,205,0,0,3,205,0.020882000,0.0001
111.147.237.184,<->,104.143.73.202,3,151,0,0,3,151,0.020819000,0.0064
124.86.24.82,<->,8.31.37.162,0,0,3,833,3,833,0.020375000,0.3389
246.253.198.51,<->,112.87.183.154,3,150,0,0,3,150,0.020191000,0.2380
133.178.226.60,<->,80.47.111.107,3,1357,0,0,3,1357,0.019318000,0.0707
142.206.242.124,<->,92.27.194.147,0,0,3,360,3,360,0.017837000,0.4718
136.25.188.196,<->,106.188.236.202,3,1309,0,0,3,1309,0.016400000,0.2068
138.127.224.225,<->,33.233.141.231,0,0,3,716,3,716,0.016276000,0.0044
136.25.189.33,<->,126.219.194.141,3,168,0,0,3,168,0.015746000,0.0001
192.138.215.26,<->,92.27.219.18,0,0,3,216,3,216,0.015708000,1.7450
197.113.64.202,<->,136.25.188.242,0,0,3,244,3,244,0.015617000,0.0100
199.111.27.63,<->,8.182.241.53,0,0,3,1823,3,1823,0.014991000,1.0803
215.158.239.49,<->,199.20.6.175,3,204,0,0,3,204,0.014781000,0.0099
101.70.126.211,<->,54.51.94.174,3,557,0,0,3,557,0.014281000,0.0597
143.155.227.33,<->,136.25.188.222,0,0,3,168,3,168,0.014234000,0.0001
48.19.181.200,<->,8.252.221.236,0,0,3,552,3,552,0.014231000,0.3042
215.158.238.89,<->,145.116.209.71,3,168,0,0,3,168,0.013565000,0.0376
215.158.239.47,<->,98.219.126.175,3,1879,0,0,3,1879,0.013059000,1.9797
215.158.239.50,<->,204.21.60.148,3,168,0,0,3,168,0.012875000,0.0145
215.158.238.68,<->,97.174.232.209,3,1067,0,0,3,1067,0.012843000,1.6024
116.255.114.125,<->,50.224.76.234,0,0,3,2199,3,2199,0.012073000,0.1878
142.207.122.132,<->,136.25.188.53,0,0,3,150,3,150,0.011544000,0.0040
136.25.189.16,<->,133.56.180.0,3,1341,0,0,3,1341,0.011307000,0.1077
142.247.219.16,<->,136.25.188.242,0,0,3,294,3,294,0.011031000,1.9134
215.158.239.48,<->,196.90.122.74,3,192,0,0,3,192,0.010878000,1.4301
136.25.188.54,<->,41.136.170.119,3,168,0,0,3,168,0.010762000,0.0593
206.62.58.105,<->,80.42.146.108,0,0,3,268,3,268,0.010322000,0.8226
204.63.121.235,<->,136.25.188.227,0,0,3,213,3,213,0.009854000,0.0504
100.190.29.184,<->,8.220.176.253,0,0,3,150,3,150,0.009623000,0.2283
195.43.114.207,<->,136.25.188.209,0,0,3,168,3,168,0.009449000,0.1793
215.158.239.79,<->,207.114.9.63,3,150,0,0,3,150,0.008977000,0.1601
215.158.239.50,<->,207.228.71.23,3,236,0,0,3,236,0.008957000,1.6401
215.158.239.79,<->,196.94.3.111,3,180,0,0,3,180,0.008913000,0.6851
215.158.239.78,<->,199.20.28.167,3,156,0,0,3,156,0.008731000,1.0910
215.158.239.76,<->,199.20.28.135,3,168,0,0,3,168,0.008172000,1.0810
195.43.104.247,<->,136.25.188.255,0,0,3,156,3,156,0.007883000,0.3060
207.172.234.73,<->,136.25.188.177,0,0,3,168,3,168,0.007852000,1.2204
139.163.13.115,<->,100.76.46.65,3,1083,0,0,3,1083,0.007777000,0.3361
109.222.200.93,<->,105.65.93.60,3,406,0,0,3,406,0.007657000,0.4891
239.36.85.129,<->,136.25.188.55,0,0,3,150,3,150,0.007601000,0.0001
220.39.29.166,<->,99.74.26.96,0,0,3,256,3,256,0.007213000,0.0001
215.158.239.182,<->,106.188.226.65,3,396,0,0,3,396,0.007039000,0.1089
159.190.106.139,<->,8.182.226.78,0,0,3,150,3,150,0.006573000,1.1514
215.158.239.48,<->,207.166.149.157,3,168,0,0,3,168,0.006437000,0.1200
144.122.240.212,<->,144.108.64.184,3,207,0,0,3,207,0.006316000,0.0112
132.49.146.82,<->,54.58.153.140,3,1133,0,0,3,1133,0.006241000,0.2029
215.158.239.77,<->,196.90.67.96,3,180,0,0,3,180,0.006073000,0.4511
231.255.222.140,<->,220.82.8.138,0,0,3,928,3,928,0.006054000,0.0605
199.39.147.184,<->,136.25.188.209,0,0,3,168,3,168,0.005695000,0.0042
215.158.239.96,<->,207.190.47.213,3,168,0,0,3,168,0.005272000,0.0601
246.45.211.17,<->,215.158.209.250,3,168,0,0,3,168,0.004516000,0.0415
136.25.189.29,<->,29.214.108.245,3,1353,0,0,3,1353,0.004502000,1.1788
215.158.239.92,<->,207.191.20.206,3,180,0,0,3,180,0.003924000,1.1991
107.253.12.221,<->,8.182.228.20,0,0,3,1243,3,1243,0.003918000,0.4214
159.194.94.44,<->,100.176.233.172,3,306,0,0,3,306,0.003799000,1.8859
215.158.239.69,<->,196.94.72.151,3,168,0,0,3,168,0.003630000,0.0200
143.128.30.18,<->,136.25.188.163,0,0,3,706,3,706,0.003465000,1.1842
215.158.239.95,<->,194.250.222.108,3,706,0,0,3,706,0.002502000,0.1672
50.204.103.37,<->,8.220.176.253,0,0,3,467,3,467,0.002491000,0.3017
145.234.87.101,<->,136.25.189.47,0,0,3,168,3,168,0.002471000,0.0221
133.32.39.0,<->,124.37.24.172,3,168,0,0,3,168,0.002273000,0.0024
144.69.83.28,<->,115.139.125.174,3,150,0,0,3,150,0.002021000,0.0897
139.193.141.139,<->,115.139.86.211,3,1938,0,0,3,1938,0.001982000,0.0918
129.197.254.237,<->,6.73.243.231,0,0,3,2189,3,2189,0.001517000,0.0616
215.158.239.57,<->,196.108.232.26,3,168,0,0,3,168,0.000975000,0.0000
215.158.239.92,<->,199.20.28.129,3,156,0,0,3,156,0.000665000,0.6199
200.174.28.109,<->,54.37.1.37,3,754,0,0,3,754,0.000486000,0.3156
204.189.155.104,<->,136.25.188.52,0,0,3,204,3,204,0.000000000,1.4757
203.116.195.130,<->,136.25.188.239,0,0,2,149,2,149,1.999518000,0.0000
144.108.94.67,<->,99.162.77.146,0,0,2,131,2,131,1.999306000,0.0000
192.224.146.3,<->,133.178.227.135,0,0,2,1637,2,1637,1.998839000,0.0000
8.45.168.98,<->,6.72.10.208,0,0,2,125,2,125,1.995454000,0.0000
220.81.19.153,<->,8.55.211.213,2,128,0,0,2,128,1.994127000,0.0042
17.61.4.176,<->,8.52.178.9,0,0,2,112,2,112,1.994085000,0.0026
129.95.133.231,<->,8.201.224.59,0,0,2,197,2,197,1.993000000,0.0001
195.40.72.176,<->,136.25.188.209,0,0,2,136,2,136,1.991182000,0.0037
215.158.239.77,<->,199.20.7.209,2,143,0,0,2,143,1.989796000,0.0000
215.158.239.50,<->,194.251.95.32,2,149,0,0,2,149,1.988081000,0.0008
132.118.97.71,<->,109.1.49.70,0,0,2,125,2,125,1.986961000,0.0000
215.158.239.33,<->,120.155.14.74,2,1621,0,0,2,1621,1.981273000,0.0000
215.158.239.56,<->,199.20.30.41,2,112,0,0,2,112,1.977124000,0.0208
195.41.196.68,<->,136.25.188.237,0,0,2,100,2,100,1.975637000,0.0017
199.15.53.151,<->,136.25.188.255,0,0,2,143,2,143,1.975071000,0.0032
215.158.239.43,<->,112.220.206.17,2,1656,0,0,2,1656,1.973548000,0.0000
195.68.70.165,<->,136.25.188.236,0,0,2,960,2,960,1.973445000,0.0002
207.63.128.61,<->,136.25.188.243,0,0,2,100,2,100,1.972787000,0.0200
121.189.46.48,<->,92.27.194.147,0,0,2,112,2,112,1.972030000,0.0000
142.247.211.184,<->,136.25.188.196,0,0,2,392,2,392,1.971837000,0.0029
111.20.172.119,<->,111.20.168.12,0,0,2,2002,2,2002,1.971659000,0.0000
207.236.72.39,<->,136.25.188.46,0,0,2,100,2,100,1.970006000,0.0029
159.178.76.115,<->,8.220.190.86,0,0,2,515,2,515,1.969236000,0.0293
204.21.191.88,<->,136.25.188.52,0,0,2,100,2,100,1.969223000,0.0012
195.43.122.140,<->,136.25.188.162,0,0,2,100,2,100,1.968601000,0.0012
215.158.239.96,<->,207.61.23.119,2,925,0,0,2,925,1.968539000,0.0020
195.71.147.207,<->,136.25.188.236,0,0,2,143,2,143,1.968183000,0.0012
215.158.239.69,<->,199.20.31.190,2,197,0,0,2,197,1.968161000,0.0001
247.136.139.100,<->,120.71.141.210,2,136,0,0,2,136,1.964191000,0.0338
215.158.239.95,<->,192.171.32.182,2,1877,0,0,2,1877,1.963481000,0.0000
142.190.73.222,<->,136.25.188.225,0,0,2,100,2,100,1.963442000,0.0017
215.158.61.223,<->,136.25.188.194,0,0,2,2943,2,2943,1.963295000,0.0000
215.158.140.193,<->,8.222.7.184,2,1028,0,0,2,1028,1.961482000,0.0273
220.39.21.53,<->,99.74.26.158,0,0,2,1213,2,1213,1.959975000,0.0019
142.221.21.108,<->,136.25.188.44,0,0,2,956,2,956,1.959528000,0.0016
215.158.239.76,<->,199.80.23.222,2,100,0,0,2,100,1.957785000,0.0018
207.61.91.103,<->,136.25.188.255,0,0,2,1780,2,1780,1.957745000,0.0146
215.158.140.178,<->,8.222.7.170,2,1018,0,0,2,1018,1.957727000,0.0250
194.237.136.186,<->,136.25.188.44,0,0,2,100,2,100,1.956479000,0.0015
199.14.5.85,<->,136.25.188.178,0,0,2,149,2,149,1.955427000,0.0020
112.220.206.7,<->,8.252.223.153,0,0,2,1660,2,1660,1.955237000,0.0000
215.158.239.49,<->,199.20.5.161,2,228,0,0,2,228,1.955123000,0.0208
137.23.166.40,<->,101.70.127.108,0,0,2,181,2,181,1.954673000,0.0003
199.121.2.158,<->,136.25.188.177,0,0,2,112,2,112,1.954210000,0.0039
136.25.189.33,<->,29.211.228.250,2,1987,0,0,2,1987,1.954175000,0.0000
207.56.170.67,<->,136.25.188.253,0,0,2,100,2,100,1.953614000,0.0020
136.128.59.59,<->,92.162.253.27,0,0,2,100,2,100,1.953371000,0.0245
248.239.180.7,<->,221.102.56.69,2,120,0,0,2,120,1.952512000,0.0341
215.158.238.133,<->,112.220.206.24,2,149,0,0,2,149,1.951592000,0.0000
215.158.239.95,<->,196.91.48.231,2,112,0,0,2,112,1.950840000,0.0000
149.117.120.82,<->,139.193.141.139,0,0,2,1734,2,1734,1.950803000,0.0000
92.27.219.215,<->,54.93.165.122,2,560,0,0,2,560,1.950760000,0.0040
215.158.239.97,<->,194.199.199.166,2,958,0,0,2,958,1.950563000,0.0000
39.189.129.88,<->,8.20.87.204,0,0,2,100,2,100,1.949985000,0.0304
246.253.253.106,<->,210.209.251.214,2,531,0,0,2,531,1.949445000,0.0330
231.138.253.230,<->,136.25.188.252,0,0,2,106,2,106,1.948490000,0.0002
215.158.239.59,<->,120.154.225.253,2,1861,0,0,2,1861,1.947786000,0.0000
92.162.253.89,<->,35.62.67.92,2,100,0,0,2,100,1.946986000,0.0210
138.37.95.126,<->,92.162.253.61,0,0,2,125,2,125,1.946599000,0.0000
138.37.95.126,<->,92.162.253.51,0,0,2,125,2,125,1.945732000,0.0000
133.178.227.242,<->,106.188.251.138,2,1621,0,0,2,1621,1.943915000,0.0000
138.37.95.126,<->,92.162.253.59,0,0,2,125,2,125,1.943081000,0.0000
113.199.186.37,<->,92.27.219.32,0,0,2,373,2,373,1.941625000,0.0167
143.13.208.92,<->,136.25.188.222,0,0,2,100,2,100,1.941346000,0.0009
204.63.45.166,<->,136.25.188.237,0,0,2,149,2,149,1.941169000,0.0407
210.236.185.210,<->,97.168.79.77,0,0,2,106,2,106,1.941156000,0.0218
204.200.44.104,<->,136.25.188.209,0,0,2,1194,2,1194,1.940732000,0.0123
142.249.34.121,<->,136.25.188.177,0,0,2,960,2,960,1.940577000,0.0026
92.27.219.224,<->,81.11.131.84,2,457,0,0,2,457,1.940251000,0.0201
215.158.238.243,<->,8.222.6.215,2,120,0,0,2,120,1.940066000,0.0229
221.189.117.0,<->,8.52.169.61,0,0,2,106,2,106,1.939878000,0.0543
215.158.239.85,<->,196.93.5.8,2,969,0,0,2,969,1.939612000,0.0198
220.7.136.210,<->,136.25.188.52,0,0,2,100,2,100,1.939112000,0.0000
136.25.189.43,<->,96.156.169.176,2,2136,0,0,2,2136,1.937606000,0.0000
144.71.44.80,<->,134.65.80.3,2,100,0,0,2,100,1.937303000,0.0073
215.158.239.69,<->,207.56.212.136,2,100,0,0,2,100,1.936407000,0.0002
215.158.3.29,<->,8.252.222.251,0,0,2,1477,2,1477,1.934522000,0.0022
136.25.188.220,<->,30.73.138.137,2,149,0,0,2,149,1.934478000,0.0600
142.229.173.87,<->,136.25.188.225,0,0,2,143,2,143,1.933678000,0.0010
142.227.19.141,<->,136.25.188.253,0,0,2,959,2,959,1.933587000,0.0020
142.167.122.186,<->,136.25.188.174,0,0,2,149,2,149,1.931907000,0.0023
139.163.26.146,<->,138.73.226.247,2,202,0,0,2,202,1.931900000,0.0030
195.13.254.149,<->,136.25.188.253,0,0,2,982,2,982,1.931636000,0.0021
53.203.246.22,<->,48.54.4.151,0,0,2,567,2,567,1.931631000,0.0103
215.158.140.181,<->,53.231.93.171,2,509,0,0,2,509,1.930714000,0.0612
136.25.189.30,<->,56.28.207.201,2,2116,0,0,2,2116,1.929716000,0.0000
215.158.239.56,<->,195.4.207.49,2,112,0,0,2,112,1.929232000,0.0389
210.229.230.19,<->,101.176.99.177,2,118,0,0,2,118,1.929158000,0.0384
204.45.227.97,<->,8.52.179.217,0,0,2,100,2,100,1.929075000,0.0062
159.137.223.136,<->,127.197.137.42,2,128,0,0,2,128,1.927931000,0.0214
159.137.162.213,<->,107.127.183.182,2,106,0,0,2,106,1.926066000,0.0700
215.158.239.69,<->,199.76.9.231,2,242,0,0,2,242,1.925920000,0.0070
133.30.79.18,<->,50.224.76.248,0,0,2,106,2,106,1.925886000,0.0278
218.154.250.6,<->,8.52.163.19,0,0,2,100,2,100,1.924683000,0.0567
103.237.224.235,<->,8.52.186.161,0,0,2,100,2,100,1.923881000,0.0589
17.0.7.40,<->,8.220.178.203,0,0,2,106,2,106,1.923619000,0.0237
215.158.239.48,<->,204.0.244.199,2,963,0,0,2,963,1.923576000,0.0098
195.71.80.95,<->,136.25.188.253,0,0,2,143,2,143,1.921011000,0.0062
215.158.239.93,<->,207.166.162.210,2,149,0,0,2,149,1.920599000,0.0000
196.88.84.24,<->,136.25.188.253,0,0,2,125,2,125,1.920433000,0.0012
133.178.226.196,<->,56.1.238.203,2,810,0,0,2,810,1.919664000,0.0240
138.127.205.203,<->,109.222.194.66,0,0,2,135,2,135,1.918093000,0.0018
192.229.215.71,<->,139.246.60.47,2,485,0,0,2,485,1.918024000,0.0226
195.71.130.122,<->,136.25.188.46,0,0,2,943,2,943,1.917224000,0.0028
194.232.223.50,<->,136.25.188.252,0,0,2,136,2,136,1.916776000,0.0186
220.83.96.153,<->,8.55.211.213,2,128,0,0,2,128,1.915677000,0.0393
213.186.52.119,<->,144.85.170.208,0,0,2,120,2,120,1.915322000,0.0197
89.204.65.12,<->,8.182.252.86,0,0,2,112,2,112,1.915072000,0.0233
220.20.200.13,<->,144.83.60.136,2,100,0,0,2,100,1.914001000,0.0242
215.158.239.99,<->,199.20.28.225,2,944,0,0,2,944,1.913195000,0.0093
133.178.226.111,<->,126.219.247.38,2,1662,0,0,2,1662,1.912745000,0.0000
215.158.238.75,<->,113.23.117.87,2,1605,0,0,2,1605,1.912491000,0.0000
223.114.72.187,<->,8.252.222.23,0,0,2,112,2,112,1.911864000,0.0000
215.158.238.133,<->,122.159.31.102,2,1605,0,0,2,1605,1.910408000,0.0000
246.253.253.171,<->,143.251.136.81,2,100,0,0,2,100,1.910148000,0.0000
17.255.107.2,<->,8.220.235.203,0,0,2,112,2,112,1.910057000,0.0331
215.158.239.31,<->,117.155.166.251,2,1764,0,0,2,1764,1.909387000,0.0000
39.189.129.88,<->,8.43.215.120,0,0,2,100,2,100,1.908855000,0.0427
142.248.19.64,<->,136.25.188.252,0,0,2,958,2,958,1.907805000,0.0026
159.223.99.45,<->,8.220.180.84,0,0,2,100,2,100,1.907604000,0.0389
215.158.239.93,<->,207.62.71.76,2,936,0,0,2,936,1.907497000,0.0037
215.158.239.49,<->,199.20.5.167,2,965,0,0,2,965,1.906590000,0.0000
17.243.35.226,<->,8.220.234.165,0,0,2,106,2,106,1.906464000,0.0202
39.189.129.88,<->,8.250.157.155,0,0,2,100,2,100,1.905338000,0.0435
215.158.239.33,<->,149.96.50.9,2,1687,0,0,2,1687,1.904675000,0.0000
143.89.180.115,<->,136.25.188.241,0,0,2,735,2,735,1.902857000,0.0944
192.64.196.68,<->,134.106.251.179,2,108,0,0,2,108,1.902401000,0.0030
245.207.109.146,<->,221.102.103.73,0,0,2,520,2,520,1.902194000,0.0173
215.158.140.84,<->,111.151.139.246,2,2224,0,0,2,2224,1.901690000,0.0804
215.158.238.67,<->,91.247.40.43,2,1794,0,0,2,1794,1.901472000,0.0000
192.224.20.69,<->,133.178.227.251,0,0,2,120,2,120,1.898821000,0.0286
192.224.20.69,<->,133.178.227.253,0,0,2,120,2,120,1.898809000,0.0287
111.151.139.246,<->,8.252.223.171,0,0,2,2224,2,2224,1.897446000,0.0771
159.137.248.15,<->,122.3.58.2,2,100,0,0,2,100,1.896044000,0.0001
143.42.155.215,<->,136.25.188.222,0,0,2,426,2,426,1.896040000,0.0027
215.158.239.51,<->,205.227.96.23,2,1813,0,0,2,1813,1.895424000,0.0000
142.190.179.239,<->,136.25.188.252,0,0,2,100,2,100,1.895059000,0.0018
194.233.3.53,<->,136.25.188.174,0,0,2,197,2,197,1.894620000,0.0201
215.158.44.186,<->,136.25.189.81,0,0,2,1204,2,1204,1.894445000,0.0685
97.126.26.71,<->,56.90.112.160,2,380,0,0,2,380,1.894396000,0.0044
192.227.190.250,<->,80.56.78.208,0,0,2,172,2,172,1.893608000,0.0108
108.131.143.163,<->,8.220.235.178,0,0,2,100,2,100,1.893593000,0.0324
215.158.239.87,<->,199.71.157.70,2,946,0,0,2,946,1.892989000,0.0022
133.178.226.95,<->,96.155.60.253,2,562,0,0,2,562,1.892741000,0.0166
139.193.141.139,<->,66.87.70.36,2,1814,0,0,2,1814,1.892574000,0.0000
202.33.231.244,<->,136.25.188.220,0,0,2,143,2,143,1.891653000,0.0000
246.252.97.167,<->,145.16.34.73,0,0,2,488,2,488,1.891321000,0.0690
215.158.239.69,<->,80.56.79.101,2,1253,0,0,2,1253,1.888992000,0.0932
199.72.22.79,<->,136.25.188.198,0,0,2,388,2,388,1.888848000,0.0042
142.207.236.233,<->,136.25.188.253,0,0,2,100,2,100,1.888772000,0.0037
215.158.239.119,<->,215.158.61.191,2,1525,0,0,2,1525,1.888589000,0.0296
215.158.140.173,<->,6.73.247.8,2,996,0,0,2,996,1.888347000,0.0250
207.239.44.76,<->,136.25.188.252,0,0,2,100,2,100,1.888324000,0.0016
133.59.237.236,<->,8.52.163.19,0,0,2,112,2,112,1.887453000,0.0729
207.239.44.76,<->,136.25.188.222,0,0,2,100,2,100,1.887272000,0.0016
215.158.239.58,<->,204.226.100.19,2,920,0,0,2,920,1.887057000,0.0003
8.20.87.192,<->,6.145.153.254,2,124,0,0,2,124,1.884814000,0.1107
215.158.238.148,<->,126.219.190.163,2,1365,0,0,2,1365,1.884323000,0.1155
237.162.205.18,<->,133.54.43.12,0,0,2,100,2,100,1.883699000,0.0015
199.120.12.168,<->,136.25.188.236,0,0,2,100,2,100,1.883359000,0.0016
215.158.238.97,<->,8.252.213.13,2,1429,0,0,2,1429,1.883224000,0.0508
127.168.165.134,<->,8.176.8.193,0,0,2,257,2,257,1.882038000,0.0903
137.45.38.219,<->,8.220.190.86,0,0,2,100,2,100,1.880962000,0.0371
139.193.141.139,<->,122.199.215.176,2,1865,0,0,2,1865,1.879143000,0.0014
215.158.239.78,<->,199.20.4.42,2,963,0,0,2,963,1.877908000,0.0689
92.27.122.179,<->,35.56.100.21,0,0,2,106,2,106,1.876893000,0.0185
132.133.159.111,<->,8.182.226.78,0,0,2,106,2,106,1.876501000,0.0485
207.61.141.2,<->,136.25.188.252,0,0,2,149,2,149,1.875522000,0.0022
148.242.117.138,<->,50.224.76.230,0,0,2,102,2,102,1.873586000,0.1150
111.151.139.246,<->,8.252.221.181,0,0,2,2224,2,2224,1.872122000,0.0658
215.158.238.82,<->,192.228.30.34,2,1189,0,0,2,1189,1.870959000,0.0357
215.158.239.97,<->,199.20.7.176,2,100,0,0,2,100,1.870497000,0.0000
144.87.238.89,<->,8.252.221.171,0,0,2,543,2,543,1.870148000,0.0237
111.151.139.246,<->,8.176.8.185,0,0,2,2224,2,2224,1.869929000,0.0638
220.55.95.155,<->,27.49.171.232,2,128,0,0,2,128,1.869831000,0.0456
215.158.238.96,<->,29.213.195.69,2,1317,0,0,2,1317,1.869305000,0.1141
215.158.61.202,<->,8.176.8.219,0,0,2,1557,2,1557,1.868705000,0.0089
204.1.228.207,<->,136.25.188.209,0,0,2,149,2,149,1.868257000,0.0020
194.234.206.158,<->,136.25.188.209,0,0,2,953,2,953,1.867091000,0.0017
247.136.165.38,<->,104.217.186.99,2,104,0,0,2,104,1.866732000,0.1105
215.158.140.75,<->,137.129.85.75,2,1286,0,0,2,1286,1.865496000,0.0313
145.242.126.105,<->,98.197.185.20,2,164,0,0,2,164,1.865455000,0.0381
111.151.139.246,<->,8.252.221.226,0,0,2,2224,2,2224,1.865133000,0.0602
215.158.238.21,<->,120.33.113.232,2,1621,0,0,2,1621,1.864330000,0.0000
215.158.140.27,<->,98.228.168.159,2,120,0,0,2,120,1.863957000,0.0235
215.158.239.50,<->,199.106.106.24,2,149,0,0,2,149,1.863477000,0.0105
111.147.181.133,<->,53.244.224.179,2,416,0,0,2,416,1.863432000,0.0018
39.189.184.42,<->,8.20.87.86,0,0,2,112,2,112,1.862863000,0.1185
215.158.239.76,<->,199.20.28.202,2,938,0,0,2,938,1.859598000,0.0098
96.232.239.14,<->,92.27.219.36,0,0,2,100,2,100,1.859543000,0.0102
142.236.138.29,<->,136.25.188.254,0,0,2,100,2,100,1.859385000,0.0011
132.213.199.17,<->,8.53.3.201,0,0,2,112,2,112,1.858049000,0.0000
145.242.126.15,<->,98.197.185.20,2,164,0,0,2,164,1.857508000,0.0400
199.68.126.171,<->,136.25.188.55,0,0,2,610,2,610,1.856811000,0.0203
192.74.94.29,<->,8.182.251.218,0,0,2,112,2,112,1.855112000,0.0554
59.146.207.87,<->,50.224.89.243,0,0,2,853,2,853,1.854523000,0.0016
215.158.239.56,<->,199.20.28.63,2,1456,0,0,2,1456,1.854494000,0.0711
215.158.239.57,<->,199.20.29.238,2,246,0,0,2,246,1.854475000,0.0298
220.20.200.248,<->,100.206.84.172,2,318,0,0,2,318,1.853781000,0.0682
207.58.104.155,<->,136.25.188.236,0,0,2,947,2,947,1.853565000,0.0021
215.158.140.27,<->,80.127.206.96,2,120,0,0,2,120,1.853116000,0.0324
136.128.5.253,<->,8.228.212.50,0,0,2,195,2,195,1.853086000,0.0013
239.227.117.98,<->,112.208.20.225,2,102,0,0,2,102,1.851624000,0.1201
215.158.239.78,<->,199.20.7.151,2,157,0,0,2,157,1.851620000,0.0605
199.122.199.59,<->,136.25.188.252,0,0,2,100,2,100,1.851188000,0.0018
143.43.117.203,<->,136.25.188.46,0,0,2,100,2,100,1.850319000,0.0017
17.136.179.122,<->,8.220.176.253,0,0,2,100,2,100,1.850247000,0.0281
111.147.103.177,<->,70.191.71.13,2,328,0,0,2,328,1.849525000,0.0922
136.25.189.16,<->,112.68.105.202,2,1333,0,0,2,1333,1.849214000,0.1388
139.193.141.139,<->,127.66.71.21,2,1831,0,0,2,1831,1.848729000,0.0050
144.111.184.84,<->,132.249.70.233,0,0,2,152,2,152,1.848624000,0.1276
142.247.192.89,<->,136.25.188.174,0,0,2,100,2,100,1.847509000,0.0000
6.145.169.124,<->,0.195.210.44,0,0,2,226,2,226,1.846243000,0.1132
210.229.230.22,<->,101.85.203.160,2,136,0,0,2,136,1.846158000,0.0759
210.209.251.214,<->,80.41.78.81,0,0,2,100,2,100,1.845869000,0.0000
142.244.200.60,<->,136.25.188.46,0,0,2,920,2,920,1.845597000,0.0022
254.78.46.138,<->,139.193.141.139,0,0,2,1979,2,1979,1.844593000,0.0035
195.13.209.157,<->,136.25.188.254,0,0,2,956,2,956,1.844554000,0.0038
50.224.76.230,<->,0.34.120.82,2,106,0,0,2,106,1.842070000,0.1001
133.178.226.234,<->,56.97.186.21,2,974,0,0,2,974,1.841088000,0.0190
196.88.201.14,<->,136.25.188.54,0,0,2,950,2,950,1.840950000,0.0033
193.21.29.219,<->,100.95.177.186,0,0,2,162,2,162,1.840305000,0.1380
215.158.239.97,<->,196.93.132.92,2,112,0,0,2,112,1.839915000,0.0004
215.158.239.49,<->,199.20.29.250,2,124,0,0,2,124,1.839742000,0.0000
215.158.140.76,<->,89.93.82.148,2,1211,0,0,2,1211,1.839737000,0.1045
215.158.239.69,<->,207.61.248.74,2,800,0,0,2,800,1.839392000,0.0290
215.158.239.19,<->,33.209.218.117,2,1500,0,0,2,1500,1.839355000,0.1019
213.186.52.121,<->,144.85.170.248,0,0,2,120,2,120,1.838472000,0.0179
89.155.187.194,<->,8.182.226.167,0,0,2,120,2,120,1.838343000,0.0229
133.32.39.8,<->,80.57.138.214,2,112,0,0,2,112,1.837639000,0.0001
159.112.9.198,<->,56.121.50.130,0,0,2,162,2,162,1.836146000,0.1085
139.193.141.200,<->,128.158.0.97,2,100,0,0,2,100,1.835742000,0.0041
142.228.215.107,<->,136.25.188.53,0,0,2,948,2,948,1.835198000,0.0023
159.209.221.245,<->,80.27.159.19,0,0,2,120,2,120,1.834680000,0.0536
93.221.37.138,<->,92.27.219.244,0,0,2,104,2,104,1.834387000,0.0895
215.158.239.84,<->,199.20.28.204,2,959,0,0,2,959,1.833706000,0.0000
202.33.26.110,<->,136.25.188.179,0,0,2,143,2,143,1.831854000,0.0000
215.158.238.81,<->,192.228.30.26,2,1269,0,0,2,1269,1.831062000,0.0568
89.183.104.151,<->,33.57.78.94,2,106,0,0,2,106,1.830583000,0.1586
197.156.143.3,<->,0.195.210.46,0,0,2,100,2,100,1.830559000,0.0092
120.248.220.30,<->,0.195.210.46,0,0,2,462,2,462,1.829852000,0.0963
217.244.108.162,<->,50.223.3.230,0,0,2,112,2,112,1.828609000,0.0423
143.68.138.184,<->,136.25.188.174,0,0,2,112,2,112,1.828493000,0.0251
100.241.191.25,<->,8.182.227.71,0,0,2,100,2,100,1.828467000,0.0340
75.137.38.173,<->,8.252.221.196,0,0,2,100,2,100,1.828329000,0.1276
197.107.56.142,<->,8.182.136.217,0,0,2,100,2,100,1.828119000,0.0405
215.158.239.50,<->,199.32.239.159,2,112,0,0,2,112,1.828100000,0.1527
128.123.175.204,<->,8.220.202.59,0,0,2,106,2,106,1.827263000,0.1273
195.13.12.243,<->,136.25.188.175,0,0,2,390,2,390,1.826217000,0.0025
215.158.238.221,<->,158.85.50.137,2,1237,0,0,2,1237,1.824644000,0.1730
128.155.116.22,<->,0.195.210.8,0,0,2,124,2,124,1.823750000,0.1699
139.160.226.221,<->,136.25.189.89,0,0,2,1301,2,1301,1.823458000,0.0235
215.158.239.49,<->,29.211.5.118,2,1797,0,0,2,1797,1.823447000,0.0000
215.158.140.228,<->,41.161.80.229,2,100,0,0,2,100,1.823157000,0.0261
136.25.188.179,<->,41.148.41.133,2,100,0,0,2,100,1.823032000,0.0172
207.60.160.62,<->,136.25.188.162,0,0,2,100,2,100,1.822420000,0.0018
140.71.206.77,<->,8.252.221.230,0,0,2,506,2,506,1.821503000,0.1761
197.113.64.255,<->,136.25.188.163,0,0,2,149,2,149,1.821060000,0.0000
143.132.153.33,<->,136.25.188.174,0,0,2,149,2,149,1.820433000,0.0057
58.48.140.98,<->,8.252.221.230,0,0,2,504,2,504,1.819512000,0.1410
204.200.44.75,<->,136.25.188.52,0,0,2,112,2,112,1.818688000,0.0000
215.158.238.188,<->,197.133.131.184,2,1162,0,0,2,1162,1.818610000,0.1039
144.93.201.3,<->,8.220.178.166,0,0,2,100,2,100,1.818188000,0.0001
145.29.244.88,<->,8.52.187.43,0,0,2,100,2,100,1.816737000,0.0295
145.208.190.226,<->,132.222.219.171,2,395,0,0,2,395,1.816711000,0.1822
8.182.251.218,<->,6.255.249.189,2,106,0,0,2,106,1.816326000,0.0558
199.20.73.206,<->,133.32.39.41,0,0,2,120,2,120,1.816168000,0.1500
210.60.187.68,<->,111.147.92.14,0,0,2,100,2,100,1.816123000,0.1161
195.124.81.254,<->,136.25.188.174,0,0,2,1016,2,1016,1.815960000,0.0398
215.158.238.122,<->,122.158.49.180,2,1189,0,0,2,1189,1.815731000,0.1284
126.150.242.125,<->,92.27.8.30,0,0,2,120,2,120,1.814060000,0.0973
215.158.239.49,<->,143.91.233.92,2,963,0,0,2,963,1.813777000,0.0000
215.158.239.95,<->,199.20.31.56,2,831,0,0,2,831,1.811774000,0.1564
89.155.40.74,<->,8.182.251.218,0,0,2,112,2,112,1.811304000,0.0221
195.61.241.134,<->,133.32.39.45,0,0,2,116,2,116,1.810770000,0.1453
215.158.140.167,<->,8.222.7.186,2,1151,0,0,2,1151,1.810352000,0.0586
254.242.180.52,<->,124.228.209.84,2,100,0,0,2,100,1.810223000,0.1310
199.121.54.19,<->,136.25.188.45,0,0,2,100,2,100,1.808938000,0.0014
139.193.141.139,<->,114.182.12.254,2,1927,0,0,2,1927,1.808866000,0.0043
207.58.224.220,<->,136.25.188.241,0,0,2,527,2,527,1.808791000,0.0855
80.42.166.61,<->,8.179.135.180,2,125,0,0,2,125,1.808028000,0.0000
159.240.2.16,<->,8.52.222.23,0,0,2,100,2,100,1.807486000,0.0450
143.44.230.52,<->,136.25.188.238,0,0,2,120,2,120,1.807215000,0.1877
215.158.239.69,<->,196.0.81.175,2,136,0,0,2,136,1.807129000,0.0085
199.51.135.40,<->,136.25.188.241,0,0,2,954,2,954,1.805242000,0.0029
111.20.171.169,<->,33.233.141.11,0,0,2,646,2,646,1.805225000,0.0918
158.13.202.176,<->,92.27.27.154,0,0,2,104,2,104,1.805091000,0.0336
220.20.200.60,<->,144.83.60.153,2,678,0,0,2,678,1.804253000,0.1338
248.225.29.61,<->,53.180.201.219,2,100,0,0,2,100,1.803987000,0.0469
136.25.189.82,<->,119.196.23.8,2,1525,0,0,2,1525,1.803934000,0.1825
143.38.87.41,<->,99.74.87.231,0,0,2,1557,2,1557,1.802775000,0.1643
144.71.40.148,<->,139.155.32.124,2,100,0,0,2,100,1.802754000,0.0994
195.88.189.40,<->,8.182.241.177,0,0,2,532,2,532,1.802486000,0.1509
215.158.238.6,<->,192.229.42.164,2,2485,0,0,2,2485,1.802408000,0.0000
142.191.191.123,<->,136.25.188.163,0,0,2,120,2,120,1.802034000,0.1880
142.208.227.37,<->,136.25.188.253,0,0,2,120,2,120,1.801893000,0.1968
68.72.122.114,<->,8.252.221.220,0,0,2,120,2,120,1.801724000,0.1656
215.158.238.45,<->,38.104.11.105,2,1029,0,0,2,1029,1.800742000,0.1728
204.187.116.225,<->,136.25.188.174,0,0,2,120,2,120,1.800545000,0.1399
143.95.22.76,<->,136.25.188.222,0,0,2,149,2,149,1.800235000,0.0014
215.158.239.69,<->,29.212.180.235,2,1109,0,0,2,1109,1.800031000,0.1130
215.158.239.84,<->,196.108.117.163,2,100,0,0,2,100,1.800016000,0.0001
143.135.73.220,<->,136.25.188.252,0,0,2,617,2,617,1.799294000,0.0146
109.201.155.198,<->,8.182.139.197,0,0,2,106,2,106,1.799278000,0.1998
195.41.194.143,<->,136.25.188.225,0,0,2,100,2,100,1.798379000,0.1868
139.193.141.209,<->,105.132.14.228,2,584,0,0,2,584,1.798170000,0.1042
112.7.105.198,<->,50.224.89.243,0,0,2,1016,2,1016,1.797836000,0.1127
128.125.118.216,<->,89.183.110.72,0,0,2,120,2,120,1.797602000,0.0939
196.88.152.228,<->,136.25.188.199,0,0,2,112,2,112,1.797017000,0.1841
159.69.187.46,<->,144.108.64.179,2,143,0,0,2,143,1.796074000,0.0619
195.54.90.228,<->,136.25.188.252,0,0,2,100,2,100,1.795706000,0.1508
98.23.105.53,<->,8.252.221.249,0,0,2,112,2,112,1.795558000,0.1458
207.62.87.241,<->,136.25.188.222,0,0,2,100,2,100,1.792540000,0.2006
136.25.189.17,<->,33.223.64.245,2,1221,0,0,2,1221,1.790373000,0.1323
215.158.238.92,<->,140.145.218.202,2,1589,0,0,2,1589,1.790119000,0.0000
133.178.226.246,<->,8.33.227.71,2,278,0,0,2,278,1.790018000,0.0034
215.158.239.95,<->,199.20.30.218,2,100,0,0,2,100,1.789418000,0.0000
133.178.227.254,<->,113.23.56.44,2,1778,0,0,2,1778,1.787439000,0.0000
196.89.229.91,<->,136.25.188.198,0,0,2,120,2,120,1.787173000,0.2094
109.222.251.182,<->,53.180.103.98,2,112,0,0,2,112,1.786554000,0.0446
215.158.239.76,<->,199.20.28.57,2,100,0,0,2,100,1.785837000,0.0200
100.174.4.45,<->,8.182.230.198,0,0,2,100,2,100,1.785751000,0.1025
215.158.140.11,<->,53.231.141.31,2,147,0,0,2,147,1.785678000,0.0260
195.54.83.223,<->,136.25.188.175,0,0,2,937,2,937,1.784254000,0.0031
215.158.239.49,<->,196.90.115.19,2,128,0,0,2,128,1.783044000,0.1197
204.185.99.57,<->,136.25.188.177,0,0,2,460,2,460,1.782625000,0.0767
195.4.31.177,<->,136.25.188.178,0,0,2,100,2,100,1.782462000,0.0034
133.178.227.194,<->,111.151.109.27,2,112,0,0,2,112,1.782183000,0.0000
215.158.239.84,<->,6.73.23.162,2,1269,0,0,2,1269,1.782156000,0.0347
195.41.245.151,<->,136.25.188.46,0,0,2,112,2,112,1.780815000,0.0495
215.158.239.50,<->,148.56.229.107,2,1269,0,0,2,1269,1.779938000,0.1309
143.65.179.91,<->,8.20.87.153,0,0,2,106,2,106,1.779750000,0.2026
101.106.122.69,<->,92.27.219.141,0,0,2,335,2,335,1.779677000,0.0898
215.158.239.92,<->,199.20.4.11,2,106,0,0,2,106,1.779340000,0.0000
192.67.183.227,<->,116.166.253.26,2,104,0,0,2,104,1.778409000,0.1037
53.167.91.165,<->,48.52.237.32,0,0,2,100,2,100,1.777923000,0.0008
235.227.198.75,<->,8.31.37.163,0,0,2,106,2,106,1.777125000,0.1257
215.158.239.97,<->,143.128.159.242,2,106,0,0,2,106,1.776897000,0.2039
195.54.103.119,<->,136.25.188.220,0,0,2,658,2,658,1.776843000,0.0171
215.158.239.84,<->,196.92.181.47,2,106,0,0,2,106,1.776341000,0.0000
203.215.150.195,<->,118.241.252.70,2,120,0,0,2,120,1.774972000,0.1579
142.221.173.101,<->,136.25.188.163,0,0,2,106,2,106,1.774490000,0.2029
199.38.199.15,<->,136.25.188.175,0,0,2,100,2,100,1.773372000,0.1895
100.224.209.9,<->,93.78.111.95,2,124,0,0,2,124,1.773172000,0.1220
215.158.239.50,<->,199.39.188.6,2,149,0,0,2,149,1.772379000,0.0017
215.158.239.86,<->,196.94.180.143,2,149,0,0,2,149,1.772314000,0.1197
195.43.55.231,<->,136.25.188.177,0,0,2,979,2,979,1.769988000,0.0034
215.158.239.86,<->,199.20.30.192,2,120,0,0,2,120,1.769829000,0.1995
111.199.225.5,<->,0.195.210.44,0,0,2,226,2,226,1.768931000,0.1590
97.193.216.222,<->,8.252.222.46,0,0,2,100,2,100,1.768218000,0.0050
8.252.222.133,<->,4.122.216.208,2,118,0,0,2,118,1.768116000,0.1515
215.158.239.33,<->,8.219.187.246,2,1083,0,0,2,1083,1.767947000,0.1375
204.62.38.5,<->,136.25.188.197,0,0,2,304,2,304,1.767491000,0.1539
195.15.210.139,<->,136.25.188.46,0,0,2,100,2,100,1.766518000,0.0017
115.233.228.114,<->,50.224.89.243,0,0,2,1102,2,1102,1.766431000,0.1596
199.70.222.17,<->,136.25.188.253,0,0,2,961,2,961,1.766356000,0.0020
195.71.161.9,<->,136.25.188.252,0,0,2,945,2,945,1.765768000,0.0381
145.116.118.123,<->,53.196.35.112,2,840,0,0,2,840,1.765243000,0.0434
144.232.206.52,<->,8.252.222.237,0,0,2,112,2,112,1.765136000,0.0441
204.58.51.204,<->,136.25.188.253,0,0,2,100,2,100,1.765000000,0.1466
53.201.200.21,<->,48.54.157.178,0,0,2,149,2,149,1.764653000,0.0000
215.158.239.57,<->,195.54.57.126,2,228,0,0,2,228,1.764534000,0.0153
247.136.169.35,<->,121.242.88.242,2,172,0,0,2,172,1.764348000,0.1344
132.152.154.112,<->,8.220.204.234,0,0,2,124,2,124,1.763993000,0.1366
157.127.144.140,<->,8.252.221.223,0,0,2,112,2,112,1.763990000,0.2274
215.158.238.32,<->,192.105.122.233,2,1141,0,0,2,1141,1.763861000,0.0300
215.158.239.70,<->,119.196.23.8,2,1445,0,0,2,1445,1.763816000,0.1346
132.216.159.4,<->,92.162.253.79,0,0,2,100,2,100,1.763512000,0.0253
133.178.227.41,<->,48.129.132.251,2,1269,0,0,2,1269,1.763473000,0.1804
192.64.217.166,<->,125.43.71.208,2,104,0,0,2,104,1.762949000,0.1540
215.158.238.99,<->,8.191.0.72,2,1397,0,0,2,1397,1.762377000,0.1779
91.248.127.117,<->,8.52.186.156,0,0,2,112,2,112,1.761498000,0.0673
193.81.55.138,<->,92.162.253.7,0,0,2,1751,2,1751,1.761453000,0.1960
215.158.239.248,<->,129.175.139.137,2,390,0,0,2,390,1.761400000,0.0514
132.216.20.193,<->,102.232.177.216,0,0,2,112,2,112,1.761326000,0.0080
142.207.234.1,<->,136.25.188.54,0,0,2,100,2,100,1.761088000,0.0018
215.158.239.48,<->,195.49.62.93,2,960,0,0,2,960,1.760987000,0.1099
220.20.200.126,<->,144.83.60.153,2,106,0,0,2,106,1.759936000,0.0620
109.222.246.106,<->,54.42.69.14,2,197,0,0,2,197,1.759436000,0.1450
231.255.191.45,<->,192.67.111.1,0,0,2,691,2,691,1.759307000,0.1220
207.194.67.99,<->,8.182.227.180,0,0,2,112,2,112,1.759207000,0.0010
207.85.167.60,<->,136.25.188.226,0,0,2,100,2,100,1.758439000,0.0184
80.27.158.136,<->,75.92.183.178,2,106,0,0,2,106,1.758415000,0.2256
67.97.14.160,<->,50.224.76.235,0,0,2,100,2,100,1.757541000,0.0000
145.99.95.239,<->,132.151.128.158,0,0,2,154,2,154,1.757541000,0.0033
192.228.30.52,<->,133.178.226.30,0,0,2,1237,2,1237,1.757515000,0.0663
204.184.166.251,<->,136.25.188.177,0,0,2,951,2,951,1.756130000,0.0199
95.246.110.181,<->,8.252.221.223,0,0,2,112,2,112,1.756118000,0.1579
8.220.185.20,<->,6.101.43.182,2,100,0,0,2,100,1.755687000,0.0000
215.158.238.123,<->,192.170.183.67,2,1285,0,0,2,1285,1.755660000,0.0881
136.25.188.44,<->,29.211.186.199,2,1733,0,0,2,1733,1.755621000,0.0000
215.158.239.79,<->,196.109.149.96,2,120,0,0,2,120,1.755587000,0.2401
203.117.105.3,<->,50.224.76.235,0,0,2,120,2,120,1.754314000,0.1321
58.131.194.115,<->,8.252.221.205,0,0,2,100,2,100,1.754003000,0.1874
8.220.189.81,<->,6.101.43.182,2,100,0,0,2,100,1.753674000,0.0000
215.158.238.47,<->,116.99.180.151,2,1253,0,0,2,1253,1.752557000,0.2474
215.158.238.54,<->,122.158.70.59,2,1317,0,0,2,1317,1.750679000,0.1109
215.158.239.69,<->,116.106.38.40,2,1109,0,0,2,1109,1.750414000,0.1444
194.233.118.36,<->,136.25.188.177,0,0,2,948,2,948,1.750245000,0.0180
221.163.98.137,<->,92.162.252.133,0,0,2,100,2,100,1.750201000,0.0209
50.224.80.67,<->,50.125.173.143,2,563,0,0,2,563,1.749835000,0.0798
144.75.218.246,<->,138.127.225.75,2,134,0,0,2,134,1.749200000,0.1034
195.7.159.49,<->,136.25.188.241,0,0,2,106,2,106,1.748755000,0.2264
17.225.173.92,<->,8.220.189.63,0,0,2,100,2,100,1.746984000,0.0219
131.184.59.5,<->,50.224.76.230,0,0,2,128,2,128,1.746891000,0.0009
197.113.99.126,<->,136.25.188.222,0,0,2,149,2,149,1.746484000,0.0490
196.245.61.130,<->,136.25.188.174,0,0,2,100,2,100,1.746362000,0.0001
146.235.20.171,<->,0.195.210.33,0,0,2,112,2,112,1.745124000,0.0048
144.93.22.181,<->,99.74.51.61,0,0,2,743,2,743,1.744632000,0.0000
204.187.233.12,<->,136.25.188.175,0,0,2,963,2,963,1.743322000,0.0219
205.66.244.67,<->,50.224.76.234,0,0,2,106,2,106,1.743057000,0.2037
204.200.57.20,<->,8.252.222.221,0,0,2,100,2,100,1.742904000,0.1171
207.61.146.120,<->,136.25.188.46,0,0,2,100,2,100,1.741689000,0.2160
215.158.238.133,<->,113.92.151.107,2,1276,0,0,2,1276,1.741630000,0.1998
215.158.238.148,<->,114.94.161.196,2,1221,0,0,2,1221,1.740302000,0.1880
215.158.239.94,<->,195.55.50.126,2,120,0,0,2,120,1.740171000,0.2552
133.178.226.19,<->,80.47.111.74,2,1237,0,0,2,1237,1.740066000,0.0637
220.20.200.170,<->,131.69.188.185,2,106,0,0,2,106,1.739733000,0.1498
136.25.189.46,<->,57.247.184.200,2,1413,0,0,2,1413,1.739127000,0.1970
109.222.250.46,<->,88.4.80.196,2,460,0,0,2,460,1.738374000,0.2264
215.158.61.191,<->,136.25.188.34,0,0,2,120,2,120,1.737707000,0.0191
215.158.238.53,<->,126.219.136.86,2,1381,0,0,2,1381,1.736624000,0.1069
196.206.211.109,<->,136.25.188.198,0,0,2,100,2,100,1.736509000,0.0200
142.223.255.173,<->,136.25.188.174,0,0,2,956,2,956,1.736375000,0.0024
114.76.97.87,<->,92.162.252.174,0,0,2,100,2,100,1.735803000,0.1064
215.158.239.76,<->,199.20.23.221,2,106,0,0,2,106,1.734459000,0.2124
194.232.134.122,<->,136.25.188.177,0,0,2,112,2,112,1.732521000,0.1722
121.14.211.188,<->,50.224.76.235,0,0,2,120,2,120,1.732178000,0.2106
17.27.56.184,<->,8.220.234.159,0,0,2,100,2,100,1.731232000,0.1331
111.147.250.231,<->,50.145.194.89,2,112,0,0,2,112,1.731102000,0.1329
215.158.239.49,<->,196.88.16.105,2,936,0,0,2,936,1.730625000,0.0032
205.80.53.82,<->,89.183.104.143,0,0,2,279,2,279,1.730323000,0.0650
57.33.75.95,<->,50.224.76.235,0,0,2,120,2,120,1.730263000,0.2078
215.158.238.36,<->,201.211.112.235,2,1525,0,0,2,1525,1.730158000,0.2490
215.158.140.229,<->,215.158.127.230,2,1250,0,0,2,1250,1.729962000,0.0216
142.241.62.81,<->,136.25.188.236,0,0,2,124,2,124,1.729128000,0.2141
143.134.57.154,<->,136.25.188.174,0,0,2,106,2,106,1.728428000,0.2484
215.158.239.77,<->,199.70.171.119,2,100,0,0,2,100,1.728173000,0.0029
215.158.239.51,<->,207.61.95.77,2,106,0,0,2,106,1.727651000,0.1951
125.218.242.243,<->,50.224.76.235,0,0,2,106,2,106,1.726938000,0.1784
108.134.117.90,<->,30.58.134.103,2,1922,0,0,2,1922,1.726024000,0.0014
207.61.146.120,<->,136.25.188.176,0,0,2,100,2,100,1.725955000,0.2052
143.13.159.50,<->,136.25.188.176,0,0,2,100,2,100,1.725896000,0.0162
213.186.52.91,<->,144.86.144.95,0,0,2,112,2,112,1.725411000,0.0205
192.67.146.69,<->,149.200.188.126,2,111,0,0,2,111,1.724981000,0.1115
215.158.239.95,<->,196.92.241.39,2,120,0,0,2,120,1.724870000,0.2300
204.200.36.66,<->,136.25.188.52,0,0,2,976,2,976,1.723612000,0.0001
195.7.159.49,<->,136.25.188.225,0,0,2,106,2,106,1.723134000,0.2429
95.246.190.87,<->,8.252.221.223,0,0,2,112,2,112,1.723093000,0.1601
48.53.19.217,<->,6.147.62.230,2,168,0,0,2,168,1.722406000,0.0060
136.25.189.30,<->,120.155.8.100,2,1429,0,0,2,1429,1.722331000,0.1263
241.0.191.98,<->,215.158.238.132,0,0,2,1429,2,1429,1.722132000,0.0671
17.235.235.172,<->,8.220.189.81,0,0,2,1155,2,1155,1.721726000,0.0577
215.158.238.67,<->,33.209.217.213,2,1518,0,0,2,1518,1.721492000,0.0127
220.203.117.179,<->,8.220.176.253,0,0,2,106,2,106,1.721450000,0.0322
141.204.123.242,<->,136.25.188.105,0,0,2,295,2,295,1.720492000,0.2710
215.158.239.50,<->,196.108.69.194,2,100,0,0,2,100,1.720336000,0.0200
215.158.239.51,<->,194.232.172.252,2,100,0,0,2,100,1.720192000,0.0020
159.190.87.59,<->,8.182.243.35,0,0,2,414,2,414,1.719926000,0.2749
111.199.237.231,<->,0.195.210.44,0,0,2,165,2,165,1.718684000,0.1297
199.33.66.187,<->,136.25.188.176,0,0,2,100,2,100,1.717633000,0.0034
120.105.102.217,<->,50.224.76.248,0,0,2,106,2,106,1.717542000,0.1687
215.158.239.95,<->,204.61.35.173,2,950,0,0,2,950,1.717502000,0.0021
129.16.253.244,<->,6.74.81.99,0,0,2,1079,2,1079,1.717439000,0.1271
195.41.31.61,<->,136.25.188.227,0,0,2,102,2,102,1.717362000,0.2205
68.72.108.92,<->,8.252.221.239,0,0,2,112,2,112,1.716845000,0.1784
56.13.192.154,<->,6.75.194.219,0,0,2,851,2,851,1.714524000,0.0074
207.237.160.14,<->,136.25.188.253,0,0,2,136,2,136,1.714159000,0.1008
207.236.119.240,<->,136.25.188.227,0,0,2,100,2,100,1.712943000,0.1510
207.3.85.49,<->,102.51.154.36,0,0,2,277,2,277,1.712290000,0.0000
8.55.217.136,<->,6.122.148.113,0,0,2,100,2,100,1.712005000,0.0041
89.183.104.186,<->,80.93.141.150,2,128,0,0,2,128,1.711866000,0.0000
215.158.61.145,<->,8.176.8.226,0,0,2,1461,2,1461,1.711383000,0.0509
92.18.183.111,<->,8.220.191.154,0,0,2,106,2,106,1.711236000,0.0702
139.241.56.171,<->,6.73.247.43,0,0,2,1845,2,1845,1.711136000,0.0000
199.82.58.186,<->,136.25.188.252,0,0,2,603,2,603,1.710647000,0.1202
136.25.188.226,<->,112.220.206.22,2,1285,0,0,2,1285,1.710553000,0.1071
215.158.239.58,<->,199.20.31.211,2,100,0,0,2,100,1.709613000,0.0300
136.25.188.163,<->,84.250.181.78,2,709,0,0,2,709,1.709016000,0.2627
221.196.122.159,<->,136.25.188.226,0,0,2,112,2,112,1.708785000,0.1400
192.64.223.86,<->,38.28.38.35,2,100,0,0,2,100,1.707580000,0.0032
133.178.226.29,<->,57.210.104.163,2,1157,0,0,2,1157,1.706834000,0.1157
221.196.122.159,<->,136.25.188.209,0,0,2,112,2,112,1.706781000,0.1325
89.183.106.29,<->,18.139.6.149,2,2001,0,0,2,2001,1.706775000,0.0001
53.201.236.145,<->,48.54.187.72,0,0,2,120,2,120,1.706538000,0.2889
50.224.76.234,<->,27.78.97.69,2,106,0,0,2,106,1.706175000,0.1424
196.206.136.92,<->,136.25.188.46,0,0,2,112,2,112,1.706080000,0.1793
215.158.140.27,<->,68.124.221.207,2,120,0,0,2,120,1.705658000,0.2454
93.137.95.196,<->,50.224.76.234,0,0,2,124,2,124,1.704671000,0.0932
215.158.239.58,<->,196.1.49.84,2,100,0,0,2,100,1.704360000,0.1479
220.59.108.41,<->,220.20.200.33,0,0,2,100,2,100,1.703476000,0.0246
199.122.54.211,<->,136.25.188.55,0,0,2,100,2,100,1.703354000,0.1632
143.76.130.51,<->,8.182.229.19,0,0,2,100,2,100,1.703108000,0.1492
215.158.239.76,<->,196.1.49.84,2,100,0,0,2,100,1.702865000,0.1517
136.25.189.43,<->,96.156.169.227,2,2821,0,0,2,2821,1.701938000,0.0000
132.60.99.180,<->,80.40.37.166,0,0,2,164,2,164,1.701106000,0.0832
215.158.238.99,<->,80.47.111.107,2,1205,0,0,2,1205,1.700971000,0.1018
221.102.56.69,<->,218.4.176.120,0,0,2,252,2,252,1.700882000,0.1196
137.46.171.191,<->,8.52.154.255,0,0,2,100,2,100,1.700439000,0.0299
215.158.238.21,<->,89.80.251.224,2,1365,0,0,2,1365,1.700187000,0.1188
142.252.210.96,<->,136.25.188.208,0,0,2,112,2,112,1.699314000,0.2259
215.158.239.58,<->,194.203.75.85,2,124,0,0,2,124,1.699255000,0.2999
240.171.101.60,<->,8.220.186.114,0,0,2,112,2,112,1.698486000,0.0337
195.13.138.191,<->,136.25.188.177,0,0,2,135,2,135,1.697783000,0.2567
220.55.100.231,<->,112.21.194.95,2,106,0,0,2,106,1.697640000,0.1010
233.222.87.164,<->,0.195.210.42,0,0,2,100,2,100,1.697162000,0.0338
133.178.226.18,<->,126.219.196.166,2,1125,0,0,2,1125,1.697085000,0.1220
215.158.239.50,<->,113.23.66.212,2,1493,0,0,2,1493,1.696996000,0.2057
130.79.180.232,<->,8.31.37.163,0,0,2,106,2,106,1.695888000,0.0970
95.244.118.4,<->,8.252.222.60,0,0,2,124,2,124,1.695716000,0.1542
195.55.221.107,<->,136.25.188.222,0,0,2,100,2,100,1.694914000,0.0027
129.224.112.252,<->,97.242.126.198,2,135,0,0,2,135,1.694833000,0.2983
195.55.148.74,<->,136.25.188.45,0,0,2,100,2,100,1.694546000,0.1900
54.38.126.203,<->,48.54.111.255,0,0,2,143,2,143,1.694256000,0.0000
196.247.196.239,<->,136.25.188.227,0,0,2,120,2,120,1.694227000,0.2200
215.158.239.56,<->,196.107.10.71,2,112,0,0,2,112,1.693779000,0.1699
136.181.53.206,<->,0.195.216.195,2,186,0,0,2,186,1.692731000,0.0142
204.139.52.240,<->,8.182.226.24,0,0,2,106,2,106,1.692680000,0.1838
99.74.26.235,<->,8.58.132.243,2,120,0,0,2,120,1.692571000,0.0332
143.72.206.141,<->,136.25.188.160,0,0,2,100,2,100,1.689578000,0.1836
132.249.70.154,<->,129.225.3.207,2,120,0,0,2,120,1.689111000,0.0278
215.158.239.93,<->,196.93.23.195,2,120,0,0,2,120,1.688698000,0.2599
199.58.55.112,<->,50.224.76.235,0,0,2,106,2,106,1.688690000,0.1590
215.158.140.231,<->,69.150.168.192,2,1167,0,0,2,1167,1.688546000,0.2320
197.109.192.192,<->,136.25.188.239,0,0,2,112,2,112,1.686679000,0.0601
215.158.238.122,<->,128.23.84.234,2,1173,0,0,2,1173,1.686340000,0.1238
220.81.14.172,<->,8.45.162.111,2,112,0,0,2,112,1.683790000,0.2506
192.226.44.83,<->,136.25.189.196,0,0,2,112,2,112,1.683729000,0.0251
199.100.62.48,<->,50.223.3.228,0,0,2,106,2,106,1.683344000,0.1459
215.158.239.84,<->,207.61.95.77,2,106,0,0,2,106,1.683308000,0.1978
53.201.76.55,<->,48.53.19.157,0,0,2,2968,2,2968,1.682950000,0.0000
207.92.23.99,<->,8.182.229.19,0,0,2,100,2,100,1.682312000,0.0006
192.226.44.69,<->,133.178.227.254,0,0,2,2963,2,2963,1.682198000,0.0000
142.253.222.145,<->,136.25.188.163,0,0,2,106,2,106,1.680454000,0.1875
215.158.238.45,<->,114.150.180.159,2,1605,0,0,2,1605,1.680347000,0.2209
231.140.234.12,<->,136.25.188.220,0,0,2,100,2,100,1.680034000,0.0018
207.60.135.50,<->,136.25.188.237,0,0,2,137,2,137,1.679811000,0.0029
215.158.239.96,<->,199.69.209.83,2,100,0,0,2,100,1.679789000,0.1939
215.158.239.51,<->,142.241.15.155,2,106,0,0,2,106,1.679215000,0.0026
136.25.188.160,<->,128.123.91.66,2,1365,0,0,2,1365,1.679136000,0.1283
215.158.238.236,<->,122.159.123.17,2,1281,0,0,2,1281,1.679026000,0.1501
215.158.239.92,<->,195.49.213.146,2,112,0,0,2,112,1.679015000,0.2897
195.7.204.25,<->,136.25.188.52,0,0,2,120,2,120,1.678700000,0.2869
196.206.136.92,<->,136.25.188.220,0,0,2,112,2,112,1.678113000,0.2049
215.158.239.125,<->,215.158.61.195,2,2062,0,0,2,2062,1.677719000,0.1607
133.178.226.31,<->,122.159.245.165,2,120,0,0,2,120,1.676871000,0.1050
215.158.239.57,<->,199.20.30.124,2,149,0,0,2,149,1.676826000,0.0000
215.158.239.94,<->,133.8.213.76,2,1269,0,0,2,1269,1.676333000,0.0316
136.25.188.52,<->,69.31.239.14,2,1301,0,0,2,1301,1.676291000,0.2197
98.150.172.76,<->,8.176.8.69,0,0,2,395,2,395,1.674926000,0.0020
215.158.238.103,<->,100.224.166.161,2,562,0,0,2,562,1.674828000,0.0356
215.158.238.23,<->,96.38.231.102,2,1381,0,0,2,1381,1.674742000,0.0313
94.194.100.66,<->,8.252.222.132,0,0,2,118,2,118,1.674269000,0.1512
97.28.20.70,<->,8.176.42.231,0,0,2,100,2,100,1.674172000,0.0549
100.25.139.22,<->,50.224.76.235,0,0,2,100,2,100,1.673404000,0.0000
215.158.239.96,<->,199.20.5.68,2,120,0,0,2,120,1.673399000,0.3206
53.167.91.165,<->,48.52.67.39,0,0,2,100,2,100,1.673399000,0.1087
101.126.185.66,<->,8.55.217.136,2,100,0,0,2,100,1.672546000,0.0000
92.27.234.238,<->,84.220.145.75,2,102,0,0,2,102,1.672161000,0.2673
246.254.97.107,<->,132.128.61.22,2,143,0,0,2,143,1.671128000,0.0000
215.158.239.40,<->,98.198.114.57,2,1056,0,0,2,1056,1.670971000,0.0269
136.25.188.44,<->,113.23.104.252,2,1333,0,0,2,1333,1.670365000,0.1254
215.158.140.231,<->,111.150.187.215,2,1235,0,0,2,1235,1.670258000,0.2732
195.13.204.35,<->,136.25.188.177,0,0,2,100,2,100,1.668404000,0.2101
111.20.168.123,<->,101.224.91.182,2,818,0,0,2,818,1.667509000,0.0244
207.86.242.130,<->,8.182.139.161,0,0,2,100,2,100,1.667250000,0.0000
193.7.254.171,<->,92.162.252.195,0,0,2,100,2,100,1.666330000,0.0934
118.114.190.83,<->,50.224.76.248,0,0,2,100,2,100,1.666116000,0.1471
197.113.64.158,<->,136.25.188.163,0,0,2,120,2,120,1.665135000,0.2999
203.54.84.122,<->,136.25.188.236,0,0,2,100,2,100,1.664426000,0.2115
133.178.227.41,<->,80.57.141.96,2,1399,0,0,2,1399,1.664341000,0.0353
98.210.30.44,<->,50.150.173.141,2,112,0,0,2,112,1.663412000,0.0008
204.138.41.198,<->,8.182.241.177,0,0,2,112,2,112,1.663100000,0.2144
136.25.189.34,<->,29.211.93.15,2,120,0,0,2,120,1.662667000,0.1012
136.25.188.162,<->,113.23.104.246,2,120,0,0,2,120,1.662276000,0.1211
215.158.239.97,<->,199.20.31.132,2,981,0,0,2,981,1.662250000,0.0400
215.158.140.27,<->,215.158.43.248,2,120,0,0,2,120,1.662183000,0.0217
215.158.238.66,<->,143.155.227.59,2,120,0,0,2,120,1.662111000,0.1692
93.219.236.129,<->,50.224.76.248,0,0,2,106,2,106,1.661609000,0.1637
17.15.183.16,<->,8.220.176.253,0,0,2,327,2,327,1.660105000,0.0285
199.80.92.100,<->,50.224.76.234,0,0,2,106,2,106,1.659814000,0.2152
136.25.189.1,<->,135.228.221.200,2,1397,0,0,2,1397,1.659321000,0.2957
215.158.239.96,<->,196.59.133.147,2,120,0,0,2,120,1.655967000,0.3389
246.45.208.200,<->,78.113.151.36,2,1554,0,0,2,1554,1.655612000,0.0000
229.22.165.40,<->,50.224.76.234,0,0,2,106,2,106,1.655474000,0.1138
215.158.239.35,<->,109.205.55.34,2,1475,0,0,2,1475,1.654745000,0.0646
210.158.44.36,<->,129.148.253.17,2,372,0,0,2,372,1.654401000,0.0080
195.126.22.217,<->,136.25.188.220,0,0,2,100,2,100,1.654142000,0.2980
215.158.238.133,<->,113.23.104.221,2,112,0,0,2,112,1.653646000,0.1178
61.63.208.58,<->,50.224.76.248,0,0,2,118,2,118,1.653390000,0.2697
215.158.238.250,<->,58.11.224.43,2,1210,0,0,2,1210,1.653356000,0.1561
220.20.200.136,<->,144.83.60.153,2,676,0,0,2,676,1.652560000,0.3168
215.158.239.93,<->,207.236.228.60,2,120,0,0,2,120,1.652535000,0.1801
120.39.68.1,<->,80.41.6.158,0,0,2,118,2,118,1.651664000,0.0665
142.249.41.62,<->,136.25.188.55,0,0,2,100,2,100,1.650568000,0.2309
136.25.188.177,<->,33.209.217.237,2,1476,0,0,2,1476,1.650499000,0.1306
129.209.89.218,<->,0.195.210.46,0,0,2,135,2,135,1.650453000,0.2600
215.158.239.87,<->,6.73.9.162,2,1429,0,0,2,1429,1.649204000,0.0353
215.158.239.97,<->,143.99.90.95,2,112,0,0,2,112,1.647983000,0.1810
112.5.250.117,<->,50.224.76.234,0,0,2,106,2,106,1.647950000,0.1221
195.7.235.96,<->,136.25.188.227,0,0,2,957,2,957,1.647901000,0.0022
222.65.18.127,<->,89.90.107.0,2,125,0,0,2,125,1.647726000,0.0000
197.113.99.146,<->,136.25.188.227,0,0,2,112,2,112,1.647680000,0.0110
156.135.166.242,<->,8.252.221.205,0,0,2,106,2,106,1.647625000,0.3466
123.108.215.253,<->,92.162.252.1,0,0,2,100,2,100,1.647490000,0.1048
215.158.239.92,<->,207.58.10.161,2,100,0,0,2,100,1.646498000,0.3100
136.25.188.44,<->,8.222.212.27,2,1173,0,0,2,1173,1.646483000,0.0277
215.158.239.99,<->,196.109.174.101,2,106,0,0,2,106,1.646145000,0.2001
215.158.239.92,<->,8.47.120.147,2,1349,0,0,2,1349,1.645515000,0.2819
69.246.60.77,<->,8.252.222.37,0,0,2,106,2,106,1.645475000,0.1501
195.15.152.123,<->,136.25.188.222,0,0,2,100,2,100,1.645437000,0.0013
136.181.53.215,<->,0.195.216.195,2,149,0,0,2,149,1.645351000,0.0061
215.158.239.127,<->,215.158.61.243,2,1444,0,0,2,1444,1.645293000,0.1728
215.158.239.49,<->,199.20.7.135,2,987,0,0,2,987,1.645088000,0.0000
95.245.180.100,<->,8.252.221.236,0,0,2,106,2,106,1.644670000,0.1510
35.61.216.144,<->,8.182.224.87,0,0,2,120,2,120,1.644206000,0.0245
136.25.188.172,<->,8.222.212.27,2,120,0,0,2,120,1.644199000,0.0244
215.158.140.27,<->,100.224.132.171,2,120,0,0,2,120,1.643950000,0.0230
148.126.22.196,<->,50.224.76.235,0,0,2,106,2,106,1.643294000,0.1345
195.15.152.123,<->,136.25.188.220,0,0,2,100,2,100,1.642273000,0.1482
126.198.149.124,<->,80.42.169.232,0,0,2,391,2,391,1.641905000,0.1295
100.206.88.223,<->,92.162.253.223,0,0,2,125,2,125,1.641299000,0.0000
254.242.186.155,<->,159.231.131.109,2,337,0,0,2,337,1.641164000,0.0627
215.158.239.93,<->,199.69.88.186,2,106,0,0,2,106,1.641044000,0.1804
215.158.238.123,<->,56.102.22.3,2,2133,0,0,2,2133,1.640912000,0.0000
196.247.48.121,<->,136.25.188.220,0,0,2,128,2,128,1.640780000,0.2807
215.158.239.102,<->,215.158.61.145,2,714,0,0,2,714,1.640656000,0.1942
215.158.239.95,<->,194.237.140.129,2,604,0,0,2,604,1.640201000,0.0081
195.5.100.193,<->,8.52.187.14,0,0,2,100,2,100,1.639685000,0.2181
215.158.239.58,<->,199.20.7.107,2,945,0,0,2,945,1.639630000,0.0000
215.158.239.95,<->,195.81.30.54,2,120,0,0,2,120,1.638398000,0.2205
136.18.16.150,<->,8.182.224.248,0,0,2,100,2,100,1.638320000,0.0379
112.2.10.68,<->,8.176.37.25,0,0,2,112,2,112,1.638110000,0.1462
215.158.239.32,<->,80.57.141.190,2,1264,0,0,2,1264,1.637239000,0.0264
145.89.42.24,<->,8.204.66.217,2,197,0,0,2,197,1.636384000,0.0001
215.158.239.85,<->,199.20.4.87,2,952,0,0,2,952,1.635578000,0.0000
194.209.165.92,<->,8.52.168.63,0,0,2,100,2,100,1.634810000,0.1771
6.145.169.23,<->,0.195.210.44,0,0,2,165,2,165,1.634685000,0.1400
221.163.98.137,<->,220.20.200.169,0,0,2,100,2,100,1.634291000,0.0209
215.158.239.95,<->,143.129.191.182,2,944,0,0,2,944,1.633245000,0.0021
142.252.170.0,<->,136.25.188.241,0,0,2,100,2,100,1.633113000,0.1919
195.7.64.30,<->,136.25.188.253,0,0,2,106,2,106,1.632275000,0.1793
215.158.239.78,<->,199.20.31.124,2,120,0,0,2,120,1.631921000,0.3202
159.178.117.109,<->,8.52.222.23,0,0,2,100,2,100,1.631085000,0.0000
215.158.140.93,<->,8.42.42.188,2,1254,0,0,2,1254,1.630887000,0.2631
99.74.26.235,<->,8.58.132.242,2,120,0,0,2,120,1.630824000,0.0313
199.73.33.38,<->,136.25.188.162,0,0,2,956,2,956,1.630673000,0.0018
197.107.254.192,<->,8.252.222.30,0,0,2,100,2,100,1.629947000,0.2481
148.139.52.246,<->,92.162.253.252,0,0,2,100,2,100,1.629940000,0.0860
210.229.230.20,<->,100.153.170.193,2,118,0,0,2,118,1.629371000,0.2494
196.115.89.136,<->,8.52.136.86,0,0,2,100,2,100,1.629228000,0.0959
215.158.238.250,<->,57.31.50.233,2,1247,0,0,2,1247,1.628301000,0.0902
142.254.250.21,<->,136.25.188.241,0,0,2,100,2,100,1.627894000,0.0089
136.25.189.1,<->,122.159.245.58,2,1221,0,0,2,1221,1.627746000,0.1085
101.70.120.239,<->,89.207.30.140,2,112,0,0,2,112,1.626596000,0.0551
209.91.240.74,<->,8.220.188.183,0,0,2,100,2,100,1.625933000,0.0252
195.42.123.57,<->,136.25.188.45,0,0,2,100,2,100,1.625743000,0.2118
215.158.239.85,<->,141.39.23.69,2,1413,0,0,2,1413,1.625369000,0.2665
142.182.63.31,<->,136.25.188.211,0,0,2,381,2,381,1.625273000,0.0167
142.249.47.13,<->,136.25.188.226,0,0,2,100,2,100,1.625149000,0.1869
137.129.19.35,<->,54.38.18.155,2,106,0,0,2,106,1.624921000,0.0948
204.130.158.101,<->,0.195.210.44,0,0,2,149,2,149,1.624602000,0.1773
192.229.211.201,<->,82.99.214.214,2,100,0,0,2,100,1.624569000,0.0000
134.245.141.254,<->,92.27.219.238,0,0,2,331,2,331,1.624335000,0.3126
195.40.218.129,<->,136.25.188.53,0,0,2,120,2,120,1.624279000,0.2550
215.158.239.96,<->,204.226.92.239,2,124,0,0,2,124,1.624006000,0.3635
68.73.117.169,<->,8.252.221.236,0,0,2,112,2,112,1.622554000,0.1989
133.178.227.57,<->,120.20.132.20,2,1269,0,0,2,1269,1.621355000,0.2119
144.71.44.80,<->,114.186.157.236,2,162,0,0,2,162,1.621320000,0.1480
215.158.239.122,<->,215.158.61.202,2,2451,0,0,2,2451,1.620662000,0.0000
143.134.237.58,<->,136.25.188.252,0,0,2,296,2,296,1.620146000,0.0155
215.158.239.56,<->,196.90.72.19,2,120,0,0,2,120,1.619813000,0.2793
142.207.96.32,<->,136.25.188.178,0,0,2,137,2,137,1.619620000,0.0626
220.20.200.98,<->,131.22.119.229,2,106,0,0,2,106,1.619498000,0.1154
156.165.37.100,<->,136.25.189.15,0,0,2,1157,2,1157,1.619020000,0.2284
127.255.84.41,<->,92.162.253.10,0,0,2,1151,2,1151,1.618317000,0.3698
132.18.67.31,<->,102.50.169.135,0,0,2,100,2,100,1.617903000,0.0014
122.222.139.61,<->,50.224.76.248,0,0,2,124,2,124,1.617497000,0.1725
215.158.238.221,<->,48.131.158.225,2,1141,0,0,2,1141,1.616905000,0.1551
215.158.238.236,<->,131.36.105.38,2,1387,0,0,2,1387,1.615769000,0.1129
114.41.220.60,<->,80.40.69.41,0,0,2,119,2,119,1.615715000,0.2984
212.70.217.124,<->,136.25.189.13,0,0,2,1429,2,1429,1.614858000,0.0223
149.250.116.33,<->,133.178.227.208,0,0,2,1365,2,1365,1.614336000,0.1363
215.158.239.70,<->,125.84.55.40,2,1301,0,0,2,1301,1.613327000,0.1073
195.54.86.255,<->,136.25.188.220,0,0,2,948,2,948,1.611688000,0.0021
215.158.140.27,<->,141.185.47.151,2,120,0,0,2,120,1.610528000,0.2711
215.158.239.58,<->,142.191.216.49,2,100,0,0,2,100,1.610100000,0.2488
133.12.179.134,<->,92.27.8.244,0,0,2,114,2,114,1.609804000,0.0420
215.158.238.65,<->,122.29.158.174,2,1269,0,0,2,1269,1.607140000,0.1733
100.93.247.0,<->,38.238.10.170,2,104,0,0,2,104,1.606926000,0.0000
142.182.50.173,<->,136.25.188.199,0,0,2,100,2,100,1.606338000,0.2446
133.8.10.152,<->,33.233.141.29,0,0,2,2052,2,2052,1.605650000,0.0000
144.75.218.241,<->,138.127.231.115,2,732,0,0,2,732,1.604013000,0.0179
142.182.63.31,<->,136.25.188.174,0,0,2,378,2,378,1.603851000,0.0045
29.201.70.132,<->,8.52.186.161,0,0,2,100,2,100,1.603400000,0.1173
222.8.40.74,<->,215.158.140.87,0,0,2,106,2,106,1.603160000,0.2164
146.217.33.226,<->,8.43.155.247,0,0,2,100,2,100,1.602283000,0.2396
50.224.80.64,<->,46.42.250.238,2,803,0,0,2,803,1.601470000,0.0829
196.89.197.70,<->,136.25.188.222,0,0,2,100,2,100,1.601384000,0.2464
126.198.149.124,<->,8.228.215.194,0,0,2,392,2,392,1.600696000,0.1433
215.158.140.92,<->,131.144.116.36,2,1464,0,0,2,1464,1.600676000,0.1743
215.158.239.97,<->,195.127.178.42,2,106,0,0,2,106,1.600572000,0.1758
195.14.102.254,<->,136.25.188.163,0,0,2,100,2,100,1.600067000,0.1490
215.158.238.248,<->,113.92.150.218,2,1327,0,0,2,1327,1.599626000,0.1225
97.80.4.236,<->,8.182.226.24,0,0,2,904,2,904,1.599380000,0.0790
215.158.238.134,<->,128.23.167.168,2,1381,0,0,2,1381,1.597720000,0.2499
113.38.212.89,<->,109.222.200.127,0,0,2,114,2,114,1.596830000,0.1625
111.146.151.20,<->,53.244.60.68,2,450,0,0,2,450,1.596444000,0.0018
195.41.211.140,<->,136.25.188.241,0,0,2,100,2,100,1.595051000,0.0015
220.20.200.84,<->,144.83.60.153,2,2304,0,0,2,2304,1.594948000,0.0000
48.131.159.5,<->,8.252.222.204,0,0,2,1301,2,1301,1.594709000,0.1719
192.171.13.189,<->,8.176.8.177,0,0,2,314,2,314,1.593707000,0.0020
106.186.90.127,<->,102.50.102.153,0,0,2,101,2,101,1.592133000,0.1774
215.158.239.56,<->,196.93.253.43,2,118,0,0,2,118,1.591578000,0.1586
192.64.235.214,<->,80.226.252.43,2,189,0,0,2,189,1.590977000,0.2104
137.0.238.4,<->,8.52.185.88,0,0,2,100,2,100,1.590098000,0.1923
136.25.188.236,<->,92.175.125.206,2,100,0,0,2,100,1.590044000,0.0197
133.178.227.79,<->,126.219.102.63,2,1242,0,0,2,1242,1.589318000,0.1936
194.237.14.1,<->,136.25.188.241,0,0,2,728,2,728,1.589195000,0.2203
215.158.239.56,<->,196.95.52.95,2,112,0,0,2,112,1.589038000,0.2395
200.174.205.199,<->,54.58.252.179,2,138,0,0,2,138,1.588660000,0.2933
200.175.72.206,<->,54.92.112.61,2,294,0,0,2,294,1.587952000,0.0537
197.125.110.229,<->,136.25.189.0,0,0,2,1541,2,1541,1.587401000,0.2369
207.56.158.107,<->,136.25.188.252,0,0,2,100,2,100,1.587309000,0.2010
109.51.233.76,<->,8.183.25.124,0,0,2,100,2,100,1.586954000,0.0000
142.254.6.200,<->,136.25.188.253,0,0,2,153,2,153,1.585812000,0.1623
204.63.107.30,<->,136.25.188.52,0,0,2,137,2,137,1.585107000,0.0290
215.158.239.49,<->,199.80.87.149,2,106,0,0,2,106,1.584770000,0.1421
200.175.200.178,<->,53.148.121.200,2,120,0,0,2,120,1.584233000,0.2919
72.212.0.209,<->,0.195.210.42,0,0,2,153,2,153,1.583173000,0.3645
215.158.239.48,<->,195.49.83.231,2,160,0,0,2,160,1.582848000,0.2399
111.159.84.12,<->,8.220.178.210,0,0,2,106,2,106,1.582669000,0.0258
220.55.87.112,<->,203.48.153.21,2,106,0,0,2,106,1.582590000,0.1542
8.182.244.19,<->,6.21.248.46,2,709,0,0,2,709,1.582258000,0.1686
199.52.226.234,<->,136.25.188.163,0,0,2,100,2,100,1.582049000,0.1937
252.98.139.157,<->,98.231.182.54,2,112,0,0,2,112,1.582038000,0.0131
195.69.198.18,<->,136.25.188.253,0,0,2,100,2,100,1.581946000,0.2905
132.213.244.180,<->,8.53.4.16,0,0,2,112,2,112,1.581902000,0.0390
80.41.58.237,<->,50.140.157.178,2,326,0,0,2,326,1.581614000,0.1402
142.254.6.200,<->,136.25.188.252,0,0,2,153,2,153,1.581606000,0.1651
142.191.141.85,<->,136.25.188.198,0,0,2,100,2,100,1.580974000,0.1686
109.222.195.35,<->,54.41.177.117,2,100,0,0,2,100,1.580512000,0.0596
215.158.238.221,<->,48.131.157.3,2,1269,0,0,2,1269,1.579913000,0.2817
215.158.239.59,<->,119.168.0.57,2,1301,0,0,2,1301,1.579700000,0.1640
144.75.218.233,<->,138.127.225.148,2,732,0,0,2,732,1.579600000,0.1434
159.137.231.128,<->,38.136.117.62,2,102,0,0,2,102,1.579489000,0.1769
215.158.140.75,<->,139.163.163.174,2,1137,0,0,2,1137,1.579066000,0.0237
136.25.189.34,<->,96.156.169.255,2,1128,0,0,2,1128,1.578956000,0.2425
195.41.45.163,<->,136.25.188.241,0,0,2,106,2,106,1.576775000,0.1998
89.183.107.130,<->,89.3.133.24,2,344,0,0,2,344,1.576305000,0.0015
199.122.47.69,<->,136.25.188.237,0,0,2,612,2,612,1.576096000,0.3831
143.135.255.175,<->,136.25.188.254,0,0,2,100,2,100,1.575717000,0.2319
114.76.113.17,<->,109.222.194.169,0,0,2,1021,2,1021,1.574501000,0.1482
100.92.17.20,<->,88.8.3.47,2,106,0,0,2,106,1.574384000,0.1802
215.158.239.76,<->,207.188.123.170,2,100,0,0,2,100,1.574071000,0.2639
199.38.118.82,<->,136.25.188.237,0,0,2,786,2,786,1.571874000,0.2033
207.60.188.82,<->,136.25.188.52,0,0,2,922,2,922,1.570819000,0.0017
82.99.214.214,<->,8.52.225.100,0,0,2,100,2,100,1.570627000,0.0006
215.158.239.97,<->,143.91.211.175,2,120,0,0,2,120,1.570555000,0.3293
215.158.238.112,<->,159.23.130.167,2,1221,0,0,2,1221,1.570522000,0.0674
199.80.190.133,<->,136.25.188.224,0,0,2,106,2,106,1.569190000,0.1744
142.166.51.110,<->,136.25.188.242,0,0,2,100,2,100,1.569162000,0.2349
243.49.81.44,<->,239.227.127.252,0,0,2,294,2,294,1.568723000,0.0114
143.10.103.63,<->,136.25.188.241,0,0,2,149,2,149,1.568469000,0.0015
129.31.61.223,<->,8.182.244.19,0,0,2,112,2,112,1.567295000,0.0340
111.147.245.82,<->,53.244.236.61,2,112,0,0,2,112,1.567249000,0.0713
122.158.179.41,<->,8.252.222.236,0,0,2,1157,2,1157,1.566584000,0.1173
215.158.239.49,<->,194.250.220.108,2,950,0,0,2,950,1.565789000,0.0000
215.158.140.185,<->,8.191.10.198,2,1237,0,0,2,1237,1.565634000,0.0723
195.7.222.38,<->,136.25.188.160,0,0,2,100,2,100,1.564761000,0.2591
98.23.111.141,<->,92.27.209.119,0,0,2,100,2,100,1.564636000,0.0000
215.158.239.79,<->,196.93.106.189,2,100,0,0,2,100,1.563432000,0.2598
98.23.111.141,<->,92.27.209.202,0,0,2,100,2,100,1.563251000,0.0000
143.13.193.89,<->,136.25.188.198,0,0,2,100,2,100,1.563161000,0.0024
199.73.149.162,<->,136.25.188.225,0,0,2,100,2,100,1.563099000,0.0039
231.140.126.243,<->,215.158.239.99,0,0,2,106,2,106,1.562558000,0.3723
215.158.239.57,<->,199.20.28.197,2,100,0,0,2,100,1.562240000,0.1796
194.237.194.196,<->,136.25.188.252,0,0,2,106,2,106,1.561582000,0.1672
192.226.161.85,<->,133.178.227.57,0,0,2,1143,2,1143,1.561357000,0.2530
192.171.32.152,<->,136.25.189.78,0,0,2,1285,2,1285,1.561314000,0.1316
143.129.94.140,<->,136.25.188.238,0,0,2,100,2,100,1.560494000,0.0017
210.229.230.20,<->,111.59.166.200,2,118,0,0,2,118,1.560100000,0.2425
143.46.12.204,<->,136.25.188.105,0,0,2,293,2,293,1.558270000,0.3668
142.245.167.107,<->,136.25.188.252,0,0,2,120,2,120,1.557920000,0.3420
143.132.68.11,<->,136.25.188.53,0,0,2,100,2,100,1.557423000,0.0040
247.136.136.208,<->,205.184.170.197,2,281,0,0,2,281,1.557023000,0.1696
145.105.170.35,<->,8.20.87.94,0,0,2,136,2,136,1.556842000,0.1560
109.1.11.75,<->,17.20.3.122,2,106,0,0,2,106,1.556375000,0.3002
215.158.239.82,<->,0.195.253.228,2,1994,0,0,2,1994,1.555510000,0.0000
199.32.226.84,<->,136.25.188.252,0,0,2,112,2,112,1.555502000,0.0007
215.158.238.148,<->,199.69.87.93,2,1173,0,0,2,1173,1.555139000,0.1584
139.78.230.224,<->,8.20.87.7,0,0,2,112,2,112,1.554789000,0.3763
142.191.151.172,<->,136.25.188.198,0,0,2,773,2,773,1.554771000,0.0024
220.39.174.212,<->,215.158.238.121,0,0,2,1269,2,1269,1.554342000,0.1275
204.184.241.185,<->,136.25.188.177,0,0,2,100,2,100,1.554230000,0.1799
50.48.121.204,<->,8.220.176.253,0,0,2,112,2,112,1.554001000,0.0290
215.158.61.209,<->,8.252.222.200,0,0,2,433,2,433,1.553761000,0.0767
215.158.238.134,<->,89.86.110.9,2,997,0,0,2,997,1.553245000,0.0924
129.224.112.252,<->,74.1.12.213,2,178,0,0,2,178,1.552751000,0.0112
205.127.108.115,<->,101.224.89.180,0,0,2,499,2,499,1.552205000,0.3224
215.158.140.230,<->,100.182.96.242,2,643,0,0,2,643,1.551830000,0.2295
115.121.32.147,<->,92.27.194.117,0,0,2,106,2,106,1.551617000,0.2799
133.135.214.222,<->,129.6.83.11,0,0,2,2485,2,2485,1.551282000,0.0000
192.64.245.156,<->,80.237.224.21,2,228,0,0,2,228,1.550408000,0.4039
215.158.239.76,<->,116.106.46.117,2,1476,0,0,2,1476,1.550234000,0.3036
133.178.227.16,<->,48.129.132.248,2,1077,0,0,2,1077,1.549923000,0.1694
215.158.238.99,<->,29.211.186.201,2,112,0,0,2,112,1.549602000,0.0003
199.52.44.60,<->,136.25.188.179,0,0,2,100,2,100,1.548883000,0.2188
199.52.44.60,<->,136.25.188.52,0,0,2,100,2,100,1.548881000,0.2227
215.158.239.71,<->,128.23.84.8,2,1141,0,0,2,1141,1.548728000,0.1155
133.178.226.7,<->,57.160.181.216,2,1237,0,0,2,1237,1.548411000,0.1311
231.140.38.208,<->,215.158.239.70,0,0,2,106,2,106,1.548335000,0.1860
136.25.189.1,<->,96.156.169.160,2,1397,0,0,2,1397,1.548165000,0.1311
247.136.140.83,<->,14.30.152.50,2,100,0,0,2,100,1.547915000,0.0100
98.67.140.104,<->,53.83.63.193,2,112,0,0,2,112,1.547127000,0.1400
249.101.84.15,<->,76.187.242.22,2,168,0,0,2,168,1.546525000,0.0000
200.174.143.130,<->,53.160.193.35,2,356,0,0,2,356,1.545718000,0.0105
199.33.203.41,<->,136.25.188.52,0,0,2,100,2,100,1.545498000,0.0019
246.253.253.208,<->,195.59.71.46,2,250,0,0,2,250,1.545489000,0.0000
142.208.167.177,<->,136.25.188.53,0,0,2,100,2,100,1.545200000,0.0379
144.69.82.139,<->,92.169.159.102,2,142,0,0,2,142,1.544996000,0.0338
99.171.89.123,<->,8.182.244.237,0,0,2,947,2,947,1.544823000,0.0599
215.158.238.223,<->,143.155.227.40,2,112,0,0,2,112,1.544678000,0.1735
215.158.239.77,<->,207.239.101.124,2,100,0,0,2,100,1.544627000,0.1338
215.158.238.114,<->,143.155.227.59,2,1333,0,0,2,1333,1.543933000,0.2371
207.63.121.119,<->,136.25.188.174,0,0,2,100,2,100,1.543829000,0.1941
111.151.239.222,<->,80.38.29.215,0,0,2,106,2,106,1.542720000,0.0334
199.121.20.35,<->,136.25.188.236,0,0,2,135,2,135,1.542636000,0.2008
247.136.226.88,<->,112.33.109.68,2,100,0,0,2,100,1.542031000,0.2440
136.25.189.15,<->,68.124.221.169,2,1429,0,0,2,1429,1.541873000,0.3217
231.143.236.165,<->,136.25.188.174,0,0,2,688,2,688,1.541523000,0.0001
215.158.239.50,<->,199.50.158.131,2,100,0,0,2,100,1.540858000,0.0145
142.207.65.145,<->,136.25.188.46,0,0,2,100,2,100,1.540643000,0.1783
109.222.215.186,<->,53.234.72.123,2,112,0,0,2,112,1.540489000,0.0502
195.40.48.37,<->,91.231.195.125,0,0,2,208,2,208,1.540017000,0.3750
143.155.227.59,<->,136.25.188.224,0,0,2,1141,2,1141,1.539692000,0.1697
207.59.207.147,<->,136.25.188.196,0,0,2,100,2,100,1.539074000,0.0022
199.39.82.92,<->,136.25.188.242,0,0,2,100,2,100,1.538802000,0.0019
100.124.212.156,<->,80.41.56.143,0,0,2,100,2,100,1.538704000,0.0020
243.117.93.53,<->,129.78.116.160,0,0,2,100,2,100,1.538428000,0.0002
36.116.253.245,<->,8.252.221.223,0,0,2,304,2,304,1.537523000,0.1665
99.207.140.179,<->,8.220.185.254,0,0,2,100,2,100,1.537283000,0.0000
226.73.2.55,<->,8.220.187.2,0,0,2,106,2,106,1.537037000,0.0248
117.46.245.99,<->,50.224.76.230,0,0,2,106,2,106,1.536826000,0.1039
195.14.139.42,<->,136.25.188.55,0,0,2,100,2,100,1.535842000,0.1531
94.194.38.158,<->,8.252.221.238,0,0,2,112,2,112,1.535802000,0.1701
215.158.239.92,<->,6.29.108.40,2,1381,0,0,2,1381,1.535396000,0.0311
143.20.71.191,<->,136.25.188.253,0,0,2,100,2,100,1.534137000,0.1582
143.134.51.28,<->,136.25.188.163,0,0,2,106,2,106,1.532936000,0.0015
109.127.101.16,<->,99.73.161.56,0,0,2,549,2,549,1.532870000,0.0452
195.71.95.254,<->,136.25.188.53,0,0,2,112,2,112,1.532514000,0.1343
215.158.239.49,<->,6.73.23.219,2,1301,0,0,2,1301,1.532265000,0.3934
92.162.253.105,<->,35.107.150.32,2,106,0,0,2,106,1.531747000,0.0198
132.249.70.213,<->,100.225.82.255,2,218,0,0,2,218,1.530531000,0.0081
8.182.245.110,<->,6.133.205.116,2,371,0,0,2,371,1.529694000,0.0435
220.87.83.83,<->,50.224.80.64,0,0,2,1315,2,1315,1.529585000,0.2874
136.41.13.4,<->,98.198.167.139,2,1466,0,0,2,1466,1.528992000,0.0004
215.158.238.244,<->,215.158.33.161,2,350,0,0,2,350,1.528847000,0.0104
215.158.239.93,<->,114.146.74.203,2,1413,0,0,2,1413,1.528402000,0.1401
224.93.235.33,<->,80.27.157.207,0,0,2,2301,2,2301,1.528206000,0.0000
215.158.238.133,<->,131.36.198.34,2,1306,0,0,2,1306,1.528161000,0.1040
196.204.48.99,<->,136.25.188.46,0,0,2,120,2,120,1.527645000,0.4381
144.64.139.146,<->,125.152.68.220,2,168,0,0,2,168,1.526143000,0.0697
142.248.58.249,<->,136.25.188.46,0,0,2,100,2,100,1.525464000,0.2665
220.60.19.177,<->,215.158.238.35,0,0,2,502,2,502,1.525281000,0.0027
192.67.143.167,<->,133.174.131.41,2,100,0,0,2,100,1.524903000,0.0998
202.33.10.37,<->,136.25.188.220,0,0,2,143,2,143,1.524865000,0.0025
142.236.219.73,<->,136.25.188.177,0,0,2,120,2,120,1.524427000,0.1505
133.30.231.132,<->,8.220.178.198,0,0,2,106,2,106,1.524012000,0.0265
111.2.157.67,<->,8.182.228.163,0,0,2,100,2,100,1.523954000,0.0390
215.158.238.93,<->,6.116.31.20,2,1365,0,0,2,1365,1.523739000,0.0596
144.71.44.209,<->,143.252.79.101,2,100,0,0,2,100,1.523598000,0.0007
215.158.140.229,<->,29.211.6.102,2,1465,0,0,2,1465,1.521944000,0.1182
133.178.227.1,<->,133.56.180.90,2,1333,0,0,2,1333,1.520064000,0.0394
215.158.238.122,<->,29.212.203.139,2,1269,0,0,2,1269,1.519665000,0.1636
204.200.57.164,<->,136.25.188.177,0,0,2,106,2,106,1.519623000,0.1239
194.234.255.84,<->,50.224.76.230,0,0,2,120,2,120,1.518946000,0.1269
196.88.31.189,<->,136.25.188.238,0,0,2,605,2,605,1.518076000,0.1047
215.158.239.79,<->,207.63.52.133,2,730,0,0,2,730,1.516778000,0.0039
215.158.239.57,<->,143.128.184.198,2,106,0,0,2,106,1.515282000,0.1985
197.113.99.168,<->,136.25.188.255,0,0,2,143,2,143,1.515249000,0.0000
249.101.84.243,<->,54.58.97.161,2,108,0,0,2,108,1.514165000,0.2808
207.191.212.75,<->,136.25.188.227,0,0,2,136,2,136,1.513976000,0.0154
215.158.239.70,<->,199.106.39.5,2,120,0,0,2,120,1.512560000,0.3005
142.227.251.30,<->,136.25.188.176,0,0,2,149,2,149,1.511857000,0.0722
204.226.49.238,<->,8.20.87.206,0,0,2,112,2,112,1.511403000,0.1548
105.111.25.197,<->,50.224.76.230,0,0,2,100,2,100,1.511360000,0.1206
220.28.65.9,<->,215.158.239.75,0,0,2,2106,2,2106,1.510810000,0.0000
220.20.200.127,<->,144.83.60.139,2,100,0,0,2,100,1.510531000,0.0261
199.33.90.202,<->,136.25.188.46,0,0,2,106,2,106,1.510213000,0.4870
220.39.233.54,<->,133.178.227.14,0,0,2,1301,2,1301,1.509992000,0.1141
215.158.238.67,<->,106.188.183.73,2,1496,0,0,2,1496,1.509896000,0.1048
136.25.189.1,<->,131.144.113.60,2,1365,0,0,2,1365,1.509780000,0.2123
134.198.171.8,<->,92.27.27.175,0,0,2,104,2,104,1.509140000,0.2526
111.199.239.217,<->,0.195.210.44,0,0,2,149,2,149,1.508924000,0.1499
198.146.30.172,<->,144.86.151.114,0,0,2,176,2,176,1.508228000,0.0031
215.158.239.93,<->,196.89.181.155,2,143,0,0,2,143,1.508144000,0.0000
215.158.238.148,<->,42.226.3.119,2,1365,0,0,2,1365,1.507641000,0.3090
102.224.165.182,<->,57.84.217.167,2,698,0,0,2,698,1.506948000,0.0160
204.186.248.159,<->,136.25.188.209,0,0,2,112,2,112,1.506393000,0.0000
148.129.19.124,<->,133.178.226.61,0,0,2,1429,2,1429,1.506100000,0.1422
156.143.11.242,<->,144.75.218.237,0,0,2,354,2,354,1.505740000,0.1518
207.193.35.39,<->,8.182.227.18,0,0,2,580,2,580,1.505611000,0.3462
215.158.140.27,<->,95.74.72.71,2,120,0,0,2,120,1.504149000,0.3338
109.222.216.202,<->,92.27.78.103,2,268,0,0,2,268,1.503210000,0.4437
197.113.64.171,<->,136.25.188.55,0,0,2,956,2,956,1.503145000,0.4900
247.136.181.26,<->,90.199.69.209,2,686,0,0,2,686,1.502756000,0.0202
204.60.146.78,<->,136.25.188.253,0,0,2,112,2,112,1.502400000,0.1972
215.158.238.253,<->,131.36.182.208,2,120,0,0,2,120,1.501734000,0.0981
220.20.200.164,<->,92.27.134.155,2,106,0,0,2,106,1.501319000,0.0228
74.168.7.23,<->,50.224.76.248,0,0,2,106,2,106,1.500117000,0.3847
60.101.84.133,<->,8.252.221.221,0,0,2,100,2,100,1.499971000,0.0000
53.189.54.77,<->,8.228.221.161,0,0,2,344,2,344,1.499764000,0.4859
210.229.230.22,<->,81.107.212.18,2,136,0,0,2,136,1.499360000,0.0723
215.158.239.78,<->,196.89.181.155,2,143,0,0,2,143,1.498783000,0.0000
199.32.150.99,<->,136.25.188.54,0,0,2,100,2,100,1.498658000,0.0005
215.158.239.48,<->,142.208.240.181,2,137,0,0,2,137,1.498467000,0.0017
207.56.104.108,<->,136.25.188.209,0,0,2,106,2,106,1.496496000,0.3661
133.178.227.19,<->,8.222.2.21,2,1193,0,0,2,1193,1.496454000,0.0955
136.25.189.32,<->,123.166.46.234,2,1349,0,0,2,1349,1.496200000,0.2038
98.23.111.141,<->,92.27.209.227,0,0,2,100,2,100,1.495960000,0.0000
136.25.189.88,<->,8.179.43.55,2,1285,0,0,2,1285,1.495938000,0.2088
210.220.219.178,<->,53.239.143.73,2,325,0,0,2,325,1.495900000,0.2906
246.253.253.107,<->,89.205.211.115,2,501,0,0,2,501,1.495853000,0.0465
212.70.217.75,<->,136.25.189.83,0,0,2,1253,2,1253,1.495799000,0.0251
215.158.239.92,<->,199.20.5.197,2,124,0,0,2,124,1.495695000,0.4500
204.2.102.51,<->,136.25.188.208,0,0,2,100,2,100,1.495602000,0.2082
136.25.189.17,<->,29.211.93.15,2,120,0,0,2,120,1.495101000,0.1026
215.158.239.59,<->,158.253.43.167,2,1317,0,0,2,1317,1.494412000,0.1578
195.41.238.250,<->,136.25.188.177,0,0,2,100,2,100,1.493553000,0.0023
119.94.225.50,<->,80.38.6.211,0,0,2,286,2,286,1.493146000,0.0200
113.210.31.226,<->,50.224.76.248,0,0,2,106,2,106,1.492050000,0.2001
142.249.72.88,<->,136.25.188.226,0,0,2,100,2,100,1.491402000,0.0017
136.25.188.163,<->,109.116.63.19,2,100,0,0,2,100,1.491361000,0.0169
215.158.239.70,<->,199.20.31.33,2,965,0,0,2,965,1.491174000,0.0200
115.170.240.204,<->,92.27.219.54,0,0,2,231,2,231,1.490828000,0.3283
89.150.61.76,<->,8.220.239.84,0,0,2,106,2,106,1.489590000,0.0379
104.254.31.24,<->,50.224.76.248,0,0,2,106,2,106,1.489333000,0.2469
109.119.182.228,<->,8.182.235.52,0,0,2,100,2,100,1.489121000,0.0202
136.25.189.213,<->,98.192.115.72,2,100,0,0,2,100,1.488836000,0.0000
234.182.169.148,<->,89.183.108.200,0,0,2,153,2,153,1.488569000,0.0225
89.183.104.173,<->,33.57.74.167,2,100,0,0,2,100,1.488455000,0.1314
215.158.239.10,<->,96.135.154.98,2,1937,0,0,2,1937,1.488386000,0.0000
215.158.140.140,<->,8.252.213.117,2,112,0,0,2,112,1.488015000,0.0273
146.234.70.87,<->,0.195.210.42,0,0,2,100,2,100,1.487776000,0.0052
210.229.230.18,<->,192.176.51.172,2,118,0,0,2,118,1.487594000,0.2520
91.69.181.250,<->,50.224.76.235,0,0,2,120,2,120,1.486667000,0.0222
194.237.218.116,<->,136.25.188.253,0,0,2,100,2,100,1.486411000,0.1797
207.62.38.139,<->,136.25.188.163,0,0,2,102,2,102,1.486192000,0.2870
215.158.239.86,<->,131.144.113.9,2,1253,0,0,2,1253,1.486108000,0.1845
17.33.88.98,<->,8.52.154.228,0,0,2,792,2,792,1.485602000,0.4795
143.10.47.43,<->,136.25.188.178,0,0,2,143,2,143,1.484926000,0.0126
98.23.111.141,<->,92.27.209.229,0,0,2,100,2,100,1.484833000,0.0000
210.156.34.185,<->,89.220.214.254,2,255,0,0,2,255,1.484334000,0.1256
199.70.236.208,<->,136.25.188.236,0,0,2,100,2,100,1.483261000,0.0015
136.25.189.15,<->,130.117.160.70,2,1237,0,0,2,1237,1.483248000,0.1339
145.203.236.158,<->,136.25.188.163,0,0,2,112,2,112,1.483078000,0.0232
215.158.239.84,<->,196.90.95.88,2,128,0,0,2,128,1.483059000,0.3998
220.20.200.116,<->,102.45.208.135,2,100,0,0,2,100,1.482800000,0.0229
195.7.147.178,<->,136.25.188.53,0,0,2,100,2,100,1.482736000,0.2584
109.2.111.102,<->,8.45.175.127,2,197,0,0,2,197,1.482669000,0.0000
137.19.242.61,<->,50.224.15.251,2,389,0,0,2,389,1.481996000,0.1372
133.178.227.79,<->,133.56.180.9,2,1303,0,0,2,1303,1.481906000,0.0245
215.158.239.78,<->,29.211.165.20,2,1269,0,0,2,1269,1.481608000,0.1111
195.71.163.42,<->,136.25.188.55,0,0,2,135,2,135,1.480940000,0.3191
215.158.239.78,<->,199.20.5.122,2,945,0,0,2,945,1.480916000,0.0763
136.25.188.52,<->,56.12.213.238,2,112,0,0,2,112,1.480526000,0.0214
215.158.238.135,<->,205.227.96.23,2,1381,0,0,2,1381,1.479718000,0.1272
215.158.238.47,<->,114.25.48.62,2,1237,0,0,2,1237,1.478215000,0.1935
149.197.245.156,<->,80.40.16.41,0,0,2,109,2,109,1.475885000,0.1998
146.249.226.231,<->,8.252.222.140,0,0,2,120,2,120,1.475803000,0.3393
195.5.226.40,<->,136.25.188.177,0,0,2,100,2,100,1.475303000,0.1816
159.23.227.171,<->,93.135.236.168,2,100,0,0,2,100,1.474768000,0.1617
199.50.124.17,<->,136.25.188.222,0,0,2,106,2,106,1.474721000,0.2094
207.60.253.155,<->,136.25.188.254,0,0,2,197,2,197,1.474339000,0.0015
215.158.239.95,<->,199.20.31.143,2,149,0,0,2,149,1.473133000,0.2105
195.55.157.61,<->,136.25.188.176,0,0,2,112,2,112,1.473125000,0.1663
136.25.189.1,<->,120.154.71.20,2,1429,0,0,2,1429,1.471442000,0.2224
207.191.193.98,<->,136.25.188.176,0,0,2,120,2,120,1.471069000,0.2242
215.158.140.27,<->,98.89.150.79,2,120,0,0,2,120,1.470357000,0.0500
111.146.197.80,<->,53.244.1.14,2,853,0,0,2,853,1.470286000,0.0100
136.25.188.220,<->,122.159.245.164,2,1157,0,0,2,1157,1.470265000,0.1085
133.178.226.61,<->,106.188.252.233,2,1253,0,0,2,1253,1.469375000,0.1458
131.233.164.64,<->,129.224.112.252,0,0,2,148,2,148,1.469069000,0.0073
89.205.211.109,<->,8.228.216.50,0,0,2,483,2,483,1.468901000,0.0556
195.68.49.166,<->,136.25.188.237,0,0,2,956,2,956,1.467502000,0.0200
200.174.199.176,<->,54.37.145.251,2,194,0,0,2,194,1.464965000,0.1034
220.55.96.152,<->,143.106.201.86,2,271,0,0,2,271,1.464918000,0.0106
192.64.204.68,<->,122.120.221.47,2,100,0,0,2,100,1.464851000,0.1468
210.158.44.130,<->,145.200.61.224,2,100,0,0,2,100,1.462198000,0.0260
220.20.200.165,<->,149.92.32.244,2,100,0,0,2,100,1.462048000,0.1610
215.158.140.27,<->,38.31.196.176,2,120,0,0,2,120,1.461336000,0.3010
220.38.238.124,<->,133.178.227.79,0,0,2,1235,2,1235,1.461021000,0.2823
215.158.239.97,<->,195.4.105.119,2,120,0,0,2,120,1.460740000,0.3015
215.158.140.11,<->,22.45.211.91,2,663,0,0,2,663,1.460114000,0.0004
136.25.189.57,<->,29.212.198.171,2,1413,0,0,2,1413,1.459925000,0.2951
215.158.239.50,<->,120.154.131.47,2,1445,0,0,2,1445,1.459836000,0.1114
204.41.22.99,<->,139.193.141.139,0,0,2,238,2,238,1.459360000,0.0388
221.102.103.73,<->,207.23.68.228,2,125,0,0,2,125,1.459352000,0.0000
215.158.140.8,<->,215.158.61.195,2,994,0,0,2,994,1.459170000,0.0233
97.126.118.62,<->,53.159.24.211,2,159,0,0,2,159,1.459093000,0.0644
92.27.219.244,<->,40.223.152.65,2,104,0,0,2,104,1.457341000,0.0992
199.33.203.41,<->,136.25.188.209,0,0,2,100,2,100,1.456752000,0.1819
215.158.239.85,<->,80.56.72.245,2,1221,0,0,2,1221,1.456352000,0.2170
207.60.152.130,<->,91.231.195.125,0,0,2,208,2,208,1.456071000,0.3279
137.47.232.19,<->,8.220.190.86,0,0,2,112,2,112,1.455577000,0.0395
143.72.232.167,<->,136.25.188.238,0,0,2,124,2,124,1.454539000,0.2753
215.158.140.27,<->,105.193.33.88,2,120,0,0,2,120,1.454502000,0.0942
215.158.239.84,<->,207.166.10.138,2,962,0,0,2,962,1.454151000,0.0387
139.193.141.209,<->,82.198.36.203,2,561,0,0,2,561,1.453958000,0.2743
136.25.189.94,<->,29.211.206.37,2,293,0,0,2,293,1.453830000,0.0070
195.124.40.68,<->,136.25.188.198,0,0,2,149,2,149,1.453408000,0.0000
112.208.20.190,<->,100.95.53.131,0,0,2,358,2,358,1.452913000,0.2234
215.158.239.50,<->,142.252.177.167,2,149,0,0,2,149,1.452253000,0.0027
58.143.242.65,<->,8.252.221.204,0,0,2,100,2,100,1.452194000,0.1628
207.236.0.219,<->,136.25.188.177,0,0,2,100,2,100,1.450113000,0.1502
76.179.191.234,<->,8.252.221.238,0,0,2,106,2,106,1.450058000,0.1579
156.150.130.209,<->,8.252.222.62,0,0,2,100,2,100,1.449606000,0.0000
109.29.69.147,<->,8.220.191.251,0,0,2,529,2,529,1.449075000,0.0403
204.61.47.132,<->,136.25.188.220,0,0,2,100,2,100,1.449062000,0.1513
204.186.83.224,<->,136.25.188.55,0,0,2,1151,2,1151,1.448566000,0.5172
215.158.239.86,<->,199.63.178.200,2,1333,0,0,2,1333,1.448529000,0.1471
210.229.230.18,<->,103.47.53.131,2,118,0,0,2,118,1.448072000,0.2569
215.158.239.85,<->,196.106.69.44,2,120,0,0,2,120,1.447879000,0.2008
89.86.110.227,<->,8.252.223.131,0,0,2,1209,2,1209,1.447596000,0.1335
199.52.73.113,<->,136.25.188.52,0,0,2,106,2,106,1.447038000,0.2565
80.125.16.180,<->,78.45.217.58,2,104,0,0,2,104,1.446919000,0.0337
210.229.230.19,<->,50.204.15.57,2,118,0,0,2,118,1.446792000,0.1039
215.158.239.48,<->,196.107.152.23,2,112,0,0,2,112,1.446057000,0.0392
215.158.239.48,<->,142.248.197.100,2,100,0,0,2,100,1.445838000,0.2030
104.193.36.174,<->,50.224.76.234,0,0,2,100,2,100,1.445751000,0.1434
215.158.239.84,<->,196.94.112.17,2,658,0,0,2,658,1.444573000,0.2000
143.13.239.77,<->,136.25.188.241,0,0,2,100,2,100,1.443857000,0.2127
192.64.244.65,<->,0.38.144.54,2,709,0,0,2,709,1.442091000,0.2498
215.158.239.84,<->,207.188.142.23,2,100,0,0,2,100,1.441108000,0.1946
215.158.239.93,<->,207.61.15.197,2,135,0,0,2,135,1.440618000,0.2856
215.158.238.121,<->,113.23.111.182,2,1429,0,0,2,1429,1.440598000,0.1682
138.121.99.24,<->,8.220.178.246,0,0,2,611,2,611,1.439992000,0.0252
144.64.136.137,<->,117.152.220.96,2,106,0,0,2,106,1.438962000,0.1517
215.158.238.134,<->,133.186.30.36,2,1365,0,0,2,1365,1.438862000,0.0385
124.57.153.180,<->,80.42.129.190,0,0,2,120,2,120,1.438775000,0.1185
8.55.212.136,<->,6.74.242.83,0,0,2,197,2,197,1.438626000,0.0000
133.178.226.90,<->,57.210.107.25,2,1518,0,0,2,1518,1.438353000,0.3590
142.183.35.79,<->,136.25.188.243,0,0,2,120,2,120,1.437498000,0.4346
215.158.239.231,<->,8.191.7.199,2,179,0,0,2,179,1.437110000,0.0002
215.158.238.73,<->,8.252.210.248,2,1285,0,0,2,1285,1.436320000,0.0478
215.158.239.95,<->,196.94.227.74,2,175,0,0,2,175,1.434750000,0.0990
129.175.139.238,<->,8.176.8.99,0,0,2,565,2,565,1.434337000,0.4146
95.246.166.29,<->,8.252.221.239,0,0,2,112,2,112,1.434257000,0.2375
142.227.52.147,<->,136.25.188.199,0,0,2,1530,2,1530,1.434119000,0.4146
215.158.239.99,<->,207.166.96.155,2,100,0,0,2,100,1.434097000,0.0000
140.161.45.32,<->,136.25.189.58,0,0,2,1269,2,1269,1.433880000,0.3230
204.62.89.107,<->,136.25.188.162,0,0,2,120,2,120,1.433828000,0.2385
220.60.81.144,<->,136.25.189.33,0,0,2,1155,2,1155,1.433358000,0.1008
203.37.18.144,<->,8.220.238.62,0,0,2,100,2,100,1.432552000,0.1709
199.12.0.87,<->,8.52.186.156,0,0,2,106,2,106,1.432541000,0.4820
195.43.244.17,<->,136.25.188.253,0,0,2,100,2,100,1.432178000,0.1688
194.205.168.97,<->,8.182.226.167,0,0,2,100,2,100,1.431918000,0.1539
142.166.55.253,<->,136.25.188.239,0,0,2,100,2,100,1.431780000,0.0032
248.225.25.172,<->,54.40.52.190,2,200,0,0,2,200,1.431706000,0.3226
143.13.239.77,<->,136.25.188.175,0,0,2,100,2,100,1.430235000,0.1925
215.158.239.95,<->,207.166.100.62,2,963,0,0,2,963,1.429735000,0.0402
92.27.219.43,<->,48.108.118.139,2,112,0,0,2,112,1.428952000,0.0798
195.55.181.10,<->,136.25.188.209,0,0,2,100,2,100,1.428859000,0.0035
144.83.60.153,<->,92.162.253.94,0,0,2,125,2,125,1.428132000,0.0000
215.158.239.77,<->,199.20.29.212,2,112,0,0,2,112,1.427416000,0.0472
146.248.115.199,<->,141.252.251.223,0,0,2,120,2,120,1.427375000,0.3644
133.178.227.76,<->,89.76.109.245,2,2206,0,0,2,2206,1.426983000,0.4369
56.8.151.146,<->,8.182.226.78,0,0,2,100,2,100,1.426605000,0.0584
129.26.254.60,<->,53.189.209.21,2,120,0,0,2,120,1.426539000,0.1504
215.158.239.95,<->,195.41.138.4,2,100,0,0,2,100,1.426229000,0.0103
210.229.230.18,<->,103.36.39.102,2,118,0,0,2,118,1.423296000,0.2019
210.229.230.20,<->,103.12.39.16,2,118,0,0,2,118,1.423011000,0.2538
215.158.239.101,<->,215.158.61.202,2,792,0,0,2,792,1.422642000,0.1500
204.185.249.28,<->,136.25.188.53,0,0,2,958,2,958,1.422060000,0.0392
215.158.238.135,<->,111.151.70.30,2,1543,0,0,2,1543,1.421712000,0.2388
196.148.133.194,<->,138.126.131.34,2,404,0,0,2,404,1.421496000,0.0005
215.158.239.97,<->,199.20.28.148,2,112,0,0,2,112,1.420292000,0.1000
204.60.11.253,<->,136.25.188.225,0,0,2,137,2,137,1.419470000,0.0100
133.178.226.49,<->,113.23.117.86,2,120,0,0,2,120,1.418890000,0.1130
138.121.99.24,<->,8.220.202.59,0,0,2,100,2,100,1.416677000,0.0285
203.215.160.157,<->,6.243.218.191,2,167,0,0,2,167,1.415175000,0.0000
143.44.27.150,<->,136.25.188.199,0,0,2,106,2,106,1.413908000,0.2498
215.158.140.241,<->,8.222.6.193,2,120,0,0,2,120,1.412992000,0.0279
200.174.220.137,<->,54.39.6.118,2,484,0,0,2,484,1.412890000,0.0295
145.16.34.73,<->,137.39.55.91,2,100,0,0,2,100,1.412586000,0.0004
215.158.140.87,<->,83.242.143.211,2,100,0,0,2,100,1.412411000,0.0428
17.27.56.184,<->,8.220.181.167,0,0,2,106,2,106,1.411401000,0.0011
143.108.28.2,<->,8.220.195.51,0,0,2,112,2,112,1.410964000,0.1343
215.158.239.93,<->,207.191.112.39,2,120,0,0,2,120,1.410898000,0.3094
207.58.51.236,<->,136.25.188.44,0,0,2,100,2,100,1.410608000,0.1812
136.25.189.16,<->,96.156.169.168,2,1525,0,0,2,1525,1.410321000,0.0222
143.132.200.174,<->,136.25.188.253,0,0,2,100,2,100,1.410154000,0.2087
199.121.51.158,<->,136.25.188.252,0,0,2,124,2,124,1.409646000,0.1491
215.158.239.57,<->,196.90.65.5,2,380,0,0,2,380,1.408643000,0.3798
106.169.207.139,<->,50.224.76.235,0,0,2,106,2,106,1.408571000,0.1075
140.24.189.196,<->,8.252.222.156,0,0,2,100,2,100,1.408256000,0.1953
197.113.99.160,<->,136.25.188.178,0,0,2,963,2,963,1.408243000,0.0000
207.58.51.236,<->,136.25.188.197,0,0,2,100,2,100,1.408039000,0.1898
215.158.238.45,<->,89.80.251.7,2,1157,0,0,2,1157,1.407058000,0.1331
127.106.241.57,<->,0.195.210.44,0,0,2,165,2,165,1.406944000,0.1759
195.5.76.1,<->,136.25.188.241,0,0,2,100,2,100,1.406437000,0.0029
143.132.200.174,<->,136.25.188.222,0,0,2,100,2,100,1.405724000,0.2057
50.224.80.67,<->,8.238.74.141,2,396,0,0,2,396,1.405077000,0.1505
159.112.21.107,<->,0.195.210.46,0,0,2,1510,2,1510,1.404639000,0.5776
197.105.53.72,<->,8.252.222.159,0,0,2,100,2,100,1.404547000,0.3999
145.229.244.20,<->,8.52.182.119,0,0,2,100,2,100,1.404249000,0.0039
149.80.31.19,<->,50.224.76.230,0,0,2,106,2,106,1.403270000,0.1109
99.175.115.103,<->,50.145.0.192,2,120,0,0,2,120,1.403210000,0.1215
215.158.140.76,<->,8.220.54.227,2,1239,0,0,2,1239,1.403187000,0.1132
98.230.220.18,<->,8.182.244.237,0,0,2,106,2,106,1.403181000,0.0245
144.83.60.153,<->,92.162.253.6,0,0,2,100,2,100,1.403094000,0.0247
97.4.117.28,<->,56.121.51.247,0,0,2,2026,2,2026,1.402371000,0.0000
220.51.255.205,<->,215.158.140.182,0,0,2,648,2,648,1.402266000,0.0251
215.158.239.95,<->,199.20.31.182,2,106,0,0,2,106,1.401483000,0.0000
112.50.134.78,<->,50.224.76.234,0,0,2,106,2,106,1.401345000,0.1706
231.140.128.144,<->,215.158.239.56,0,0,2,143,2,143,1.400690000,0.0015
224.223.25.232,<->,8.220.202.59,0,0,2,100,2,100,1.400378000,0.0312
33.241.95.37,<->,8.20.87.72,0,0,2,106,2,106,1.400204000,0.2606
159.69.187.1,<->,144.108.80.170,2,144,0,0,2,144,1.399843000,0.3822
97.126.26.39,<->,33.3.70.169,2,208,0,0,2,208,1.399345000,0.1282
8.20.87.210,<->,6.145.149.214,2,112,0,0,2,112,1.397946000,0.1201
215.158.239.58,<->,195.81.63.205,2,144,0,0,2,144,1.397056000,0.2603
215.158.239.51,<->,204.58.220.252,2,106,0,0,2,106,1.395979000,0.1830
195.77.212.49,<->,50.224.76.235,0,0,2,106,2,106,1.395723000,0.2120
215.158.61.183,<->,136.25.188.30,0,0,2,485,2,485,1.395485000,0.4275
139.193.141.207,<->,110.68.182.105,2,112,0,0,2,112,1.395185000,0.5947
48.129.133.80,<->,8.252.223.143,0,0,2,1237,2,1237,1.394960000,0.3738
136.25.189.15,<->,57.199.250.198,2,1509,0,0,2,1509,1.393689000,0.2751
215.158.239.70,<->,196.90.44.141,2,434,0,0,2,434,1.393271000,0.3802
215.158.238.45,<->,99.74.26.116,2,1125,0,0,2,1125,1.393263000,0.0353
215.158.239.48,<->,196.92.244.20,2,124,0,0,2,124,1.392775000,0.1989
215.158.61.95,<->,159.165.71.215,0,0,2,100,2,100,1.392705000,0.0221
195.126.30.131,<->,136.25.188.242,0,0,2,100,2,100,1.390656000,0.3089
215.158.239.56,<->,199.20.31.39,2,954,0,0,2,954,1.389863000,0.0000
144.232.206.182,<->,89.183.104.181,0,0,2,100,2,100,1.389495000,0.5501
204.61.63.39,<->,136.25.188.46,0,0,2,112,2,112,1.389467000,0.1919
195.14.3.167,<->,136.25.188.176,0,0,2,100,2,100,1.389465000,0.0007
137.129.19.45,<->,54.39.227.121,2,106,0,0,2,106,1.388790000,0.0992
136.25.189.18,<->,120.155.8.109,2,1269,0,0,2,1269,1.388329000,0.1870
215.158.239.68,<->,207.63.240.255,2,143,0,0,2,143,1.388165000,0.0099
142.221.15.189,<->,136.25.188.252,0,0,2,137,2,137,1.388007000,0.0020
142.248.203.157,<->,136.25.188.255,0,0,2,106,2,106,1.387882000,0.4068
195.14.128.76,<->,136.25.188.53,0,0,2,954,2,954,1.387838000,0.0157
207.60.192.240,<->,136.25.188.253,0,0,2,100,2,100,1.385475000,0.0022
195.4.206.169,<->,136.25.188.225,0,0,2,100,2,100,1.384997000,0.0032
215.158.239.96,<->,196.92.196.15,2,168,0,0,2,168,1.384130000,0.3598
115.81.89.180,<->,50.224.76.235,0,0,2,106,2,106,1.383239000,0.1359
199.38.94.112,<->,136.25.188.226,0,0,2,120,2,120,1.383213000,0.5072
97.126.26.40,<->,33.3.70.169,2,208,0,0,2,208,1.382465000,0.1144
199.80.30.244,<->,136.25.188.178,0,0,2,100,2,100,1.381912000,0.0027
89.183.104.165,<->,42.31.137.99,2,594,0,0,2,594,1.381689000,0.3400
87.1.81.204,<->,80.27.152.228,0,0,2,100,2,100,1.381319000,0.3680
89.183.107.124,<->,35.62.79.154,2,120,0,0,2,120,1.381029000,0.0265
223.115.15.226,<->,8.252.221.239,0,0,2,112,2,112,1.380509000,0.1708
207.239.173.59,<->,136.25.188.176,0,0,2,143,2,143,1.379964000,0.0020
215.158.238.32,<->,8.191.15.11,2,1253,0,0,2,1253,1.379783000,0.0239
215.158.239.79,<->,142.252.67.76,2,135,0,0,2,135,1.379557000,0.2375
198.30.248.218,<->,109.222.242.13,0,0,2,106,2,106,1.379346000,0.4050
215.158.238.106,<->,148.56.229.100,2,1269,0,0,2,1269,1.378888000,0.1205
159.13.229.102,<->,132.240.86.217,2,227,0,0,2,227,1.378752000,0.3077
217.248.31.77,<->,138.98.214.132,0,0,2,106,2,106,1.378697000,0.1045
144.75.218.95,<->,17.61.6.231,2,112,0,0,2,112,1.377828000,0.0741
215.158.239.77,<->,207.213.202.246,2,120,0,0,2,120,1.377502000,0.2076
149.163.129.160,<->,136.25.189.57,0,0,2,1413,2,1413,1.377335000,0.1990
53.187.78.215,<->,39.15.169.14,0,0,2,175,2,175,1.376946000,0.1996
215.158.140.60,<->,139.106.73.234,2,1221,0,0,2,1221,1.376508000,0.0289
200.175.215.55,<->,54.37.85.196,2,185,0,0,2,185,1.375876000,0.4678
194.233.171.114,<->,136.25.188.238,0,0,2,128,2,128,1.375762000,0.2821
199.38.38.242,<->,136.25.188.243,0,0,2,104,2,104,1.375455000,0.1320
193.4.195.214,<->,144.71.40.36,0,0,2,102,2,102,1.375426000,0.1643
215.158.239.97,<->,207.236.245.176,2,100,0,0,2,100,1.375366000,0.0026
215.158.239.95,<->,139.160.226.200,2,1445,0,0,2,1445,1.375163000,0.0264
159.69.187.49,<->,144.108.64.184,2,150,0,0,2,150,1.375024000,0.0133
246.253.253.97,<->,111.151.239.156,2,731,0,0,2,731,1.374957000,0.0292
215.158.238.134,<->,8.219.186.181,2,1077,0,0,2,1077,1.373606000,0.3136
139.252.1.217,<->,101.224.204.193,0,0,2,150,2,150,1.373404000,0.0991
205.224.38.167,<->,102.51.12.80,0,0,2,100,2,100,1.373069000,0.0007
212.164.143.230,<->,46.41.87.241,2,415,0,0,2,415,1.372595000,0.0692
144.54.85.140,<->,136.25.188.209,0,0,2,120,2,120,1.371915000,0.0857
136.41.13.4,<->,95.221.82.205,2,1480,0,0,2,1480,1.371261000,0.0000
215.158.140.27,<->,143.14.191.88,2,120,0,0,2,120,1.370834000,0.1701
101.124.235.213,<->,89.74.85.198,2,355,0,0,2,355,1.370113000,0.1088
215.158.239.92,<->,195.54.73.111,2,106,0,0,2,106,1.369462000,0.2358
215.158.239.56,<->,195.42.86.194,2,100,0,0,2,100,1.368942000,0.2008
195.4.255.137,<->,136.25.188.225,0,0,2,100,2,100,1.367904000,0.0029
92.162.253.100,<->,35.107.150.45,2,100,0,0,2,100,1.367702000,0.0182
215.158.239.68,<->,199.20.30.197,2,658,0,0,2,658,1.367643000,0.5180
247.127.114.238,<->,221.102.113.231,0,0,2,100,2,100,1.367291000,0.0322
231.143.143.0,<->,136.25.188.163,0,0,2,136,2,136,1.366309000,0.3801
132.49.144.232,<->,54.36.194.252,2,181,0,0,2,181,1.364973000,0.0000
207.63.96.194,<->,136.25.188.226,0,0,2,100,2,100,1.364502000,0.0153
119.45.113.35,<->,92.162.252.142,0,0,2,100,2,100,1.364422000,0.1053
92.27.27.174,<->,78.123.37.8,2,100,0,0,2,100,1.364366000,0.3034
144.76.42.211,<->,144.64.138.24,0,0,2,152,2,152,1.363963000,0.0409
69.223.54.98,<->,50.224.76.235,0,0,2,106,2,106,1.363674000,0.1744
195.5.137.158,<->,136.25.188.252,0,0,2,100,2,100,1.363405000,0.1831
192.65.82.37,<->,8.45.168.98,2,508,0,0,2,508,1.363234000,0.0001
195.55.159.186,<->,136.25.188.175,0,0,2,100,2,100,1.362608000,0.1531
207.212.200.80,<->,92.27.219.39,0,0,2,2210,2,2210,1.361721000,0.3370
136.25.188.176,<->,131.1.253.210,2,1513,0,0,2,1513,1.361571000,0.1023
75.137.50.255,<->,8.252.221.221,0,0,2,112,2,112,1.361515000,0.2131
133.178.227.24,<->,100.50.96.222,2,1125,0,0,2,1125,1.361369000,0.1544
8.252.222.63,<->,4.123.43.176,2,143,0,0,2,143,1.361264000,0.0000
215.158.238.176,<->,8.220.54.215,2,1185,0,0,2,1185,1.361194000,0.1051
113.188.193.197,<->,8.252.222.58,0,0,2,112,2,112,1.361072000,0.0256
215.158.239.79,<->,207.228.3.2,2,136,0,0,2,136,1.360637000,0.0000
204.3.56.20,<->,136.25.188.54,0,0,2,106,2,106,1.360402000,0.2345
246.253.253.6,<->,46.198.194.141,2,1251,0,0,2,1251,1.359680000,0.1306
133.178.227.41,<->,8.222.6.193,2,991,0,0,2,991,1.359500000,0.2575
145.236.79.181,<->,8.52.188.25,0,0,2,112,2,112,1.359130000,0.0515
80.32.33.204,<->,8.52.181.8,0,0,2,100,2,100,1.358436000,0.0409
99.74.26.152,<->,8.240.120.93,2,581,0,0,2,581,1.357475000,0.0129
204.3.62.50,<->,136.25.188.242,0,0,2,106,2,106,1.356293000,0.2378
144.75.218.237,<->,138.127.231.62,2,543,0,0,2,543,1.355770000,0.3295
133.178.227.24,<->,69.150.168.231,2,1153,0,0,2,1153,1.355394000,0.2163
255.133.39.74,<->,53.231.144.222,2,147,0,0,2,147,1.355065000,0.0001
111.147.251.182,<->,60.82.95.221,2,192,0,0,2,192,1.354685000,0.4555
204.120.150.93,<->,50.224.76.234,0,0,2,112,2,112,1.354616000,0.0000
204.187.46.190,<->,136.25.188.252,0,0,2,306,2,306,1.354436000,0.0001
215.158.238.82,<->,29.212.203.155,2,1253,0,0,2,1253,1.354201000,0.1270
215.202.174.55,<->,136.25.189.12,0,0,2,1221,2,1221,1.354150000,0.2339
242.121.32.147,<->,212.164.134.114,0,0,2,115,2,115,1.353308000,0.2428
199.53.47.86,<->,136.25.188.242,0,0,2,112,2,112,1.350345000,0.1918
114.183.235.64,<->,99.74.27.84,0,0,2,1240,2,1240,1.350334000,0.3171
120.83.73.157,<->,89.183.104.243,0,0,2,648,2,648,1.350146000,0.2006
195.41.59.163,<->,136.25.188.179,0,0,2,100,2,100,1.350113000,0.2255
210.209.251.214,<->,145.16.98.204,0,0,2,913,2,913,1.349775000,0.0003
196.240.212.210,<->,136.25.188.176,0,0,2,100,2,100,1.349552000,0.2166
133.178.226.215,<->,8.190.217.163,2,112,0,0,2,112,1.348755000,0.0042
145.213.37.27,<->,136.129.94.109,0,0,2,168,2,168,1.348700000,0.0374
133.178.226.215,<->,91.57.168.68,2,112,0,0,2,112,1.348404000,0.0039
199.69.210.44,<->,136.25.188.220,0,0,2,100,2,100,1.348134000,0.2638
192.226.44.75,<->,136.25.188.29,0,0,2,1098,2,1098,1.347617000,0.0070
136.25.189.18,<->,131.144.113.10,2,1493,0,0,2,1493,1.346118000,0.2272
142.207.203.238,<->,136.25.188.54,0,0,2,100,2,100,1.345604000,0.0027
207.63.170.142,<->,136.25.188.209,0,0,2,100,2,100,1.345122000,0.1959
8.182.229.174,<->,6.133.194.44,2,657,0,0,2,657,1.344944000,0.0417
224.93.235.34,<->,80.27.157.204,0,0,2,1395,2,1395,1.344497000,0.4504
148.184.58.233,<->,50.224.76.244,0,0,2,106,2,106,1.344268000,0.0931
8.49.69.216,<->,6.74.92.233,0,0,2,1770,2,1770,1.343653000,0.0727
133.178.226.191,<->,56.97.186.243,2,112,0,0,2,112,1.343105000,0.0000
133.178.226.215,<->,8.191.15.74,2,112,0,0,2,112,1.343096000,0.0041
108.36.99.104,<->,50.224.76.235,0,0,2,100,2,100,1.341815000,0.0020
54.37.38.33,<->,48.52.73.71,0,0,2,312,2,312,1.341184000,0.5139
215.158.239.69,<->,207.115.78.240,2,120,0,0,2,120,1.341089000,0.2899
195.43.203.148,<->,136.25.188.178,0,0,2,106,2,106,1.340630000,0.1773
109.1.8.94,<->,53.213.1.69,2,165,0,0,2,165,1.340529000,0.0000
215.158.239.49,<->,204.61.158.68,2,106,0,0,2,106,1.337205000,0.1582
215.158.239.48,<->,199.20.7.143,2,136,0,0,2,136,1.336883000,0.2877
214.56.90.12,<->,50.224.76.234,0,0,2,106,2,106,1.336349000,0.1451
195.83.28.83,<->,80.38.3.11,0,0,2,601,2,601,1.335781000,0.1988
17.201.151.140,<->,8.220.204.234,0,0,2,112,2,112,1.335726000,0.0269
133.178.227.12,<->,80.57.141.67,2,1396,0,0,2,1396,1.334876000,0.0261
221.163.98.137,<->,220.20.200.19,0,0,2,100,2,100,1.334560000,0.0294
100.122.38.84,<->,8.182.229.19,0,0,2,100,2,100,1.334178000,0.1362
215.158.239.99,<->,194.237.186.119,2,136,0,0,2,136,1.333906000,0.0048
192.64.248.243,<->,118.50.66.100,2,104,0,0,2,104,1.333549000,0.5902
139.163.120.40,<->,118.113.168.54,2,112,0,0,2,112,1.333258000,0.1473
199.15.152.221,<->,136.25.188.46,0,0,2,136,2,136,1.332830000,0.4300
215.158.239.58,<->,199.20.29.132,2,100,0,0,2,100,1.332667000,0.1493
136.25.189.13,<->,6.15.207.233,2,1269,0,0,2,1269,1.332213000,0.0266
148.255.136.202,<->,136.25.189.16,0,0,2,1237,2,1237,1.331541000,0.1569
91.231.221.147,<->,0.195.210.33,0,0,2,100,2,100,1.331300000,0.0000
80.15.90.172,<->,69.128.106.102,0,0,2,644,2,644,1.330992000,0.3200
136.25.189.8,<->,56.28.207.191,2,407,0,0,2,407,1.330988000,0.0033
203.215.112.46,<->,118.241.252.70,2,120,0,0,2,120,1.330520000,0.1620
133.178.226.19,<->,57.227.189.183,2,1269,0,0,2,1269,1.330414000,0.1155
243.134.122.0,<->,8.182.226.78,0,0,2,100,2,100,1.329586000,0.0287
199.73.34.24,<->,136.25.188.176,0,0,2,100,2,100,1.329146000,0.2747
199.32.178.45,<->,136.25.188.222,0,0,2,100,2,100,1.329097000,0.1730
215.158.140.27,<->,159.154.253.88,2,120,0,0,2,120,1.327426000,0.0670
89.183.110.88,<->,27.135.24.146,2,120,0,0,2,120,1.327041000,0.2111
220.20.200.140,<->,67.2.14.156,2,100,0,0,2,100,1.326757000,0.1992
207.72.121.71,<->,8.176.49.189,0,0,2,100,2,100,1.326736000,0.2669
142.229.35.165,<->,136.25.188.255,0,0,2,106,2,106,1.324962000,0.1579
215.158.238.66,<->,8.191.6.216,2,1109,0,0,2,1109,1.324667000,0.0234
214.245.143.148,<->,210.158.44.41,0,0,2,100,2,100,1.324342000,0.1101
109.222.219.163,<->,53.214.88.10,2,112,0,0,2,112,1.324242000,0.2529
114.76.119.97,<->,92.162.253.80,0,0,2,100,2,100,1.323967000,0.1089
92.27.59.96,<->,8.182.136.181,0,0,2,112,2,112,1.323527000,0.0482
252.98.149.157,<->,137.39.55.81,2,899,0,0,2,899,1.323079000,0.0917
8.52.178.229,<->,6.37.218.160,2,100,0,0,2,100,1.322882000,0.0558
215.158.239.30,<->,122.158.239.248,2,1257,0,0,2,1257,1.322735000,0.1196
207.62.163.149,<->,136.25.188.225,0,0,2,100,2,100,1.322118000,0.0039
142.240.227.26,<->,136.25.188.163,0,0,2,106,2,106,1.321042000,0.1853
215.158.239.58,<->,199.20.6.85,2,100,0,0,2,100,1.319456000,0.1536
220.59.108.41,<->,92.162.253.25,0,0,2,100,2,100,1.319188000,0.0227
247.136.165.203,<->,40.220.179.65,2,140,0,0,2,140,1.318686000,0.6294
215.158.238.64,<->,113.23.104.220,2,1141,0,0,2,1141,1.318249000,0.4214
204.185.39.72,<->,136.25.188.45,0,0,2,192,2,192,1.317745000,0.0996
215.158.239.94,<->,196.107.189.140,2,112,0,0,2,112,1.316647000,0.2599
144.69.82.139,<->,92.169.159.101,2,139,0,0,2,139,1.315791000,0.1394
142.244.238.65,<->,136.25.188.255,0,0,2,106,2,106,1.315544000,0.2562
215.158.61.183,<->,136.25.188.29,0,0,2,1255,2,1255,1.314467000,0.3744
215.158.61.243,<->,8.176.8.238,0,0,2,821,2,821,1.314109000,0.5968
144.75.218.237,<->,138.127.231.114,2,578,0,0,2,578,1.313639000,0.0893
215.158.238.36,<->,131.144.115.170,2,1205,0,0,2,1205,1.313310000,0.1561
215.158.239.28,<->,8.222.7.160,2,1001,0,0,2,1001,1.313108000,0.1428
126.198.149.124,<->,111.147.155.165,0,0,2,394,2,394,1.312965000,0.1324
215.158.239.95,<->,199.81.23.66,2,106,0,0,2,106,1.312928000,0.1517
143.53.50.46,<->,136.25.188.45,0,0,2,120,2,120,1.312542000,0.1826
143.42.65.253,<->,136.25.188.46,0,0,2,532,2,532,1.311502000,0.0078
207.191.58.224,<->,136.25.188.241,0,0,2,434,2,434,1.310815000,0.3800
136.25.188.252,<->,84.210.156.185,2,100,0,0,2,100,1.310630000,0.0002
215.158.61.202,<->,136.25.188.39,0,0,2,837,2,837,1.310603000,0.0848
81.121.151.105,<->,50.224.76.234,0,0,2,106,2,106,1.310146000,0.0979
221.196.123.18,<->,8.52.231.225,0,0,2,136,2,136,1.309508000,0.6704
111.147.204.38,<->,17.31.166.193,2,248,0,0,2,248,1.309426000,0.1743
215.158.238.236,<->,48.129.133.55,2,1237,0,0,2,1237,1.309301000,0.1582
215.158.239.84,<->,142.228.224.77,2,102,0,0,2,102,1.308950000,0.5063
203.215.115.157,<->,118.241.252.70,2,120,0,0,2,120,1.308913000,0.1510
222.79.118.35,<->,210.193.94.45,2,248,0,0,2,248,1.308363000,0.0204
215.158.238.67,<->,113.23.104.203,2,1329,0,0,2,1329,1.308180000,0.6480
6.145.152.250,<->,0.195.210.44,0,0,2,143,2,143,1.307804000,0.1382
215.158.239.56,<->,199.20.5.104,2,120,0,0,2,120,1.306971000,0.2335
233.51.75.15,<->,215.158.140.27,0,0,2,120,2,120,1.306728000,0.1061
143.53.50.46,<->,136.25.188.177,0,0,2,120,2,120,1.306711000,0.1853
199.82.100.160,<->,136.25.188.225,0,0,2,100,2,100,1.306630000,0.2091
215.158.238.133,<->,89.86.110.9,2,1141,0,0,2,1141,1.306231000,0.1014
142.240.132.112,<->,136.25.188.252,0,0,2,120,2,120,1.305473000,0.2291
203.215.127.149,<->,118.241.252.70,2,120,0,0,2,120,1.305027000,0.1410
136.25.189.46,<->,126.219.60.220,2,1301,0,0,2,1301,1.304772000,0.2256
94.192.200.115,<->,80.38.25.116,0,0,2,100,2,100,1.304583000,0.0000
120.21.175.67,<->,92.27.219.236,0,0,2,218,2,218,1.304016000,0.4595
215.158.239.50,<->,199.20.29.137,2,100,0,0,2,100,1.303224000,0.0364
246.253.253.171,<->,145.166.26.99,2,112,0,0,2,112,1.303122000,0.0297
142.240.227.26,<->,136.25.188.54,0,0,2,106,2,106,1.302628000,0.1816
148.187.166.178,<->,92.26.149.106,0,0,2,173,2,173,1.301337000,0.3046
215.158.239.57,<->,131.6.152.21,2,1269,0,0,2,1269,1.300006000,0.1831
207.58.99.223,<->,136.25.188.46,0,0,2,137,2,137,1.299085000,0.0032
215.158.238.133,<->,120.154.221.235,2,1269,0,0,2,1269,1.297117000,0.2705
136.25.189.29,<->,30.249.194.153,2,1413,0,0,2,1413,1.295816000,0.2451
215.158.239.57,<->,195.7.4.235,2,100,0,0,2,100,1.295662000,0.2391
215.158.238.45,<->,29.213.219.103,2,1285,0,0,2,1285,1.295524000,0.1237
121.227.17.63,<->,92.27.219.212,0,0,2,112,2,112,1.295009000,0.6572
204.3.154.3,<->,136.25.188.52,0,0,2,100,2,100,1.294724000,0.0035
215.158.140.76,<->,68.231.26.200,2,1213,0,0,2,1213,1.293318000,0.1530
215.158.239.84,<->,148.217.121.181,2,1381,0,0,2,1381,1.293195000,0.1885
130.47.195.252,<->,8.52.243.47,0,0,2,100,2,100,1.292712000,0.0201
80.41.32.57,<->,38.86.74.97,2,100,0,0,2,100,1.292447000,0.0502
215.158.239.95,<->,196.95.23.181,2,124,0,0,2,124,1.292069000,0.0800
148.155.129.25,<->,101.224.89.159,0,0,2,342,2,342,1.291120000,0.0055
118.131.233.12,<->,92.27.194.114,0,0,2,593,2,593,1.291062000,0.6122
143.23.89.196,<->,136.25.188.52,0,0,2,106,2,106,1.289801000,0.3778
241.5.27.245,<->,215.158.239.87,0,0,2,1413,2,1413,1.289647000,0.0838
215.158.239.56,<->,196.242.88.223,2,120,0,0,2,120,1.289111000,0.1929
215.158.239.77,<->,106.188.253.148,2,1362,0,0,2,1362,1.288642000,0.1257
92.175.125.194,<->,8.220.178.166,0,0,2,100,2,100,1.288631000,0.0197
142.237.46.140,<->,136.25.188.174,0,0,2,124,2,124,1.288365000,0.0012
215.158.140.27,<->,140.163.167.87,2,120,0,0,2,120,1.287647000,0.2855
192.67.173.140,<->,113.40.122.0,2,118,0,0,2,118,1.287079000,0.1816
215.158.239.56,<->,142.227.16.216,2,120,0,0,2,120,1.286048000,0.5859
145.116.206.99,<->,136.25.189.137,0,0,2,100,2,100,1.285630000,0.0259
196.112.237.233,<->,136.25.189.80,0,0,2,1285,2,1285,1.285106000,0.2031
215.158.239.48,<->,195.96.136.210,2,124,0,0,2,124,1.284853000,0.3199
252.132.51.222,<->,92.27.194.147,0,0,2,112,2,112,1.283747000,0.0024
215.158.239.96,<->,199.20.7.175,2,120,0,0,2,120,1.283667000,0.6074
197.107.15.98,<->,136.25.188.178,0,0,2,136,2,136,1.283341000,0.0019
215.158.239.50,<->,196.90.96.37,2,112,0,0,2,112,1.283012000,0.0016
98.98.23.141,<->,8.52.182.119,0,0,2,100,2,100,1.282817000,0.0729
215.158.239.92,<->,199.33.243.74,2,143,0,0,2,143,1.282629000,0.0010
17.200.44.174,<->,8.220.190.86,0,0,2,102,2,102,1.282495000,0.0292
192.224.21.47,<->,133.178.226.66,0,0,2,120,2,120,1.281225000,0.0291
215.158.239.85,<->,195.81.42.127,2,120,0,0,2,120,1.281166000,0.5893
89.255.68.193,<->,8.20.87.187,0,0,2,120,2,120,1.280869000,0.1335
215.158.238.80,<->,112.220.206.107,2,120,0,0,2,120,1.280110000,0.0999
17.115.98.58,<->,8.220.188.183,0,0,2,636,2,636,1.278794000,0.0245
215.158.140.27,<->,38.27.126.240,2,120,0,0,2,120,1.278558000,0.1577
220.20.200.172,<->,53.173.23.121,2,100,0,0,2,100,1.278543000,0.1701
149.224.49.236,<->,144.75.218.242,0,0,2,140,2,140,1.277672000,0.3424
105.166.131.5,<->,92.27.219.203,0,0,2,104,2,104,1.276846000,0.6393
218.233.211.196,<->,8.220.188.183,0,0,2,100,2,100,1.275399000,0.0000
80.42.155.74,<->,8.55.152.101,2,179,0,0,2,179,1.274427000,0.0000
86.76.233.159,<->,80.27.159.117,0,0,2,100,2,100,1.274248000,0.1973
215.158.239.29,<->,80.47.111.161,2,1096,0,0,2,1096,1.274160000,0.0851
215.158.61.183,<->,8.176.8.247,0,0,2,2869,2,2869,1.274104000,0.0000
144.122.240.237,<->,144.76.43.246,2,150,0,0,2,150,1.273889000,0.7132
235.42.35.91,<->,215.158.238.148,0,0,2,1125,2,1125,1.273860000,0.4436
203.215.125.193,<->,118.241.252.70,2,120,0,0,2,120,1.273539000,0.1643
139.59.41.200,<->,8.182.253.227,0,0,2,106,2,106,1.271975000,0.0203
195.14.249.169,<->,136.25.188.238,0,0,2,106,2,106,1.271108000,0.1430
215.158.239.70,<->,196.91.1.53,2,128,0,0,2,128,1.271004000,0.3798
215.158.239.57,<->,195.41.171.110,2,100,0,0,2,100,1.270101000,0.1663
144.83.60.139,<->,92.162.253.97,0,0,2,100,2,100,1.269869000,0.0250
142.220.241.46,<->,136.25.188.196,0,0,2,100,2,100,1.268964000,0.2200
199.70.23.31,<->,136.25.188.237,0,0,2,112,2,112,1.268833000,0.1957
215.158.238.45,<->,29.212.195.3,2,1285,0,0,2,1285,1.268409000,0.1250
204.200.160.221,<->,136.25.188.236,0,0,2,100,2,100,1.267354000,0.1379
215.158.239.56,<->,143.132.31.242,2,100,0,0,2,100,1.265083000,0.0000
215.158.103.219,<->,129.229.242.60,2,1584,0,0,2,1584,1.264612000,0.5418
215.158.239.87,<->,142.236.228.255,2,106,0,0,2,106,1.264346000,0.1601
215.158.140.27,<->,140.174.84.7,2,120,0,0,2,120,1.263875000,0.2297
142.236.217.230,<->,136.25.188.175,0,0,2,112,2,112,1.263146000,0.0378
111.146.144.40,<->,50.238.193.116,2,622,0,0,2,622,1.262001000,0.2890
53.240.56.15,<->,8.228.209.115,0,0,2,112,2,112,1.261579000,0.0435
220.39.233.197,<->,133.178.226.19,0,0,2,1269,2,1269,1.260420000,0.1197
215.158.239.85,<->,199.72.68.170,2,106,0,0,2,106,1.259647000,0.1507
215.158.239.69,<->,194.251.91.218,2,100,0,0,2,100,1.258218000,0.0003
204.21.96.158,<->,136.25.188.253,0,0,2,100,2,100,1.257770000,0.1680
204.186.1.169,<->,136.25.188.174,0,0,2,112,2,112,1.257724000,0.1201
192.204.123.0,<->,136.25.189.88,0,0,2,1429,2,1429,1.257227000,0.1065
199.39.251.109,<->,136.25.188.253,0,0,2,112,2,112,1.257016000,0.0034
215.158.238.9,<->,113.23.117.31,2,1381,0,0,2,1381,1.256120000,0.1155
215.158.239.70,<->,212.70.217.75,2,1269,0,0,2,1269,1.255982000,0.0322
195.6.221.70,<->,136.25.188.255,0,0,2,145,2,145,1.255839000,0.4770
108.180.216.100,<->,8.52.158.147,0,0,2,106,2,106,1.255339000,0.0455
194.237.182.123,<->,136.25.188.54,0,0,2,100,2,100,1.255264000,0.0025
158.195.24.146,<->,139.193.141.139,0,0,2,112,2,112,1.254925000,0.1005
121.31.106.144,<->,109.1.56.197,0,0,2,100,2,100,1.254607000,0.6204
210.229.230.19,<->,159.184.231.124,2,118,0,0,2,118,1.254049000,0.2665
215.158.239.56,<->,195.71.93.107,2,326,0,0,2,326,1.253905000,0.0208
200.73.217.247,<->,8.220.176.253,0,0,2,100,2,100,1.253468000,0.0012
133.178.226.60,<->,131.144.116.237,2,1093,0,0,2,1093,1.253142000,0.1833
207.58.173.209,<->,136.25.188.52,0,0,2,100,2,100,1.252699000,0.3240
144.75.218.237,<->,8.47.122.178,2,200,0,0,2,200,1.252654000,0.4671
207.58.197.224,<->,136.25.188.163,0,0,2,100,2,100,1.252652000,0.1838
143.76.175.211,<->,8.182.227.180,0,0,2,100,2,100,1.250696000,0.0022
220.20.200.163,<->,123.108.189.17,2,106,0,0,2,106,1.250548000,0.1155
143.12.34.117,<->,136.25.188.177,0,0,2,942,2,942,1.250548000,0.0259
215.158.238.190,<->,33.221.186.184,2,1146,0,0,2,1146,1.250393000,0.2146
144.72.195.98,<->,111.146.147.251,0,0,2,864,2,864,1.250377000,0.0595
119.45.10.74,<->,92.162.253.94,0,0,2,270,2,270,1.250077000,0.1183
207.59.187.85,<->,136.25.188.173,0,0,2,106,2,106,1.248774000,0.5270
215.158.140.27,<->,38.71.71.55,2,120,0,0,2,120,1.248350000,0.3018
140.28.146.96,<->,92.27.219.215,0,0,2,102,2,102,1.247641000,0.3210
243.117.83.168,<->,133.54.28.241,0,0,2,100,2,100,1.247190000,0.1235
142.207.248.149,<->,136.25.188.225,0,0,2,1186,2,1186,1.247069000,0.2725
210.229.230.21,<->,100.148.17.45,2,118,0,0,2,118,1.247035000,0.2304
247.136.201.118,<->,201.213.20.210,2,194,0,0,2,194,1.246736000,0.0678
119.45.80.60,<->,92.162.253.188,0,0,2,100,2,100,1.245700000,0.1174
207.61.214.110,<->,136.25.188.242,0,0,2,100,2,100,1.244846000,0.2117
139.249.90.204,<->,100.120.38.6,2,120,0,0,2,120,1.244254000,0.0730
216.144.222.186,<->,215.158.140.165,0,0,2,100,2,100,1.244181000,0.0338
249.101.216.84,<->,54.38.254.96,2,322,0,0,2,322,1.244112000,0.0344
159.137.249.250,<->,33.248.188.200,2,112,0,0,2,112,1.244102000,0.0377
199.69.16.44,<->,136.25.188.255,0,0,2,950,2,950,1.243891000,0.0039
136.25.189.58,<->,114.94.161.213,2,1413,0,0,2,1413,1.243884000,0.1683
143.42.232.82,<->,136.25.188.252,0,0,2,100,2,100,1.243808000,0.3733
144.83.60.137,<->,92.162.253.96,0,0,2,100,2,100,1.243433000,0.0264
215.158.140.27,<->,149.254.205.176,2,120,0,0,2,120,1.243210000,0.1019
210.229.230.22,<->,109.105.145.158,2,118,0,0,2,118,1.243054000,0.2209
215.158.239.57,<->,114.146.74.226,2,1109,0,0,2,1109,1.243001000,0.1364
199.68.189.24,<->,136.25.188.198,0,0,2,220,2,220,1.242996000,0.4379
144.75.218.246,<->,138.127.224.104,2,603,0,0,2,603,1.242806000,0.4517
249.229.106.112,<->,8.43.210.80,0,0,2,806,2,806,1.242034000,0.0286
215.158.239.94,<->,38.104.11.40,2,1301,0,0,2,1301,1.241985000,0.1525
144.85.170.244,<->,139.148.114.204,2,112,0,0,2,112,1.241705000,0.7366
136.25.189.15,<->,68.124.221.182,2,1461,0,0,2,1461,1.241654000,0.2438
145.19.169.181,<->,92.162.253.239,0,0,2,100,2,100,1.240962000,0.0201
126.198.149.124,<->,100.93.22.85,0,0,2,390,2,390,1.240631000,0.1546
215.158.238.133,<->,114.25.48.78,2,1173,0,0,2,1173,1.240519000,0.1766
204.184.235.241,<->,136.25.188.175,0,0,2,112,2,112,1.240488000,0.0404
215.158.239.70,<->,69.150.169.187,2,1149,0,0,2,1149,1.240339000,0.2091
136.25.189.0,<->,119.196.23.55,2,1365,0,0,2,1365,1.240338000,0.1862
142.207.39.212,<->,136.25.188.238,0,0,2,120,2,120,1.240271000,0.5349
199.70.160.51,<->,136.25.188.174,0,0,2,100,2,100,1.240267000,0.2313
126.198.147.25,<->,92.27.27.183,0,0,2,391,2,391,1.239689000,0.1577
17.248.138.62,<->,8.220.200.124,0,0,2,100,2,100,1.239309000,0.0270
145.130.204.44,<->,8.182.233.86,0,0,2,106,2,106,1.238636000,0.0454
136.25.188.254,<->,8.222.212.27,2,1173,0,0,2,1173,1.238308000,0.0313
143.10.125.115,<->,136.25.188.236,0,0,2,100,2,100,1.238126000,0.0118
215.158.239.99,<->,207.60.60.95,2,100,0,0,2,100,1.237471000,0.2993
17.248.138.62,<->,8.220.188.50,0,0,2,100,2,100,1.237438000,0.0262
194.233.54.93,<->,136.25.188.46,0,0,2,658,2,658,1.236290000,0.0784
199.68.20.34,<->,136.25.188.209,0,0,2,120,2,120,1.236187000,0.2939
215.158.239.77,<->,199.20.30.176,2,120,0,0,2,120,1.235707000,0.3098
6.145.168.118,<->,0.195.210.44,0,0,2,143,2,143,1.235303000,0.2098
215.158.239.56,<->,207.188.91.21,2,106,0,0,2,106,1.234692000,0.3239
29.157.140.52,<->,8.182.136.236,0,0,2,100,2,100,1.234477000,0.1188
215.158.239.57,<->,196.93.101.106,2,152,0,0,2,152,1.234090000,0.3800
139.163.96.104,<->,50.94.121.229,2,248,0,0,2,248,1.232509000,0.2597
248.239.92.239,<->,132.18.67.26,2,112,0,0,2,112,1.231953000,0.0027
207.173.130.194,<->,136.25.188.210,0,0,2,136,2,136,1.231438000,0.1203
92.27.27.165,<->,50.235.152.134,2,112,0,0,2,112,1.230959000,0.6924
142.166.40.68,<->,136.25.188.176,0,0,2,106,2,106,1.230541000,0.4923
112.11.97.199,<->,8.31.37.161,0,0,2,963,2,963,1.230370000,0.1219
220.84.197.99,<->,66.216.210.188,2,100,0,0,2,100,1.230280000,0.1978
136.25.188.175,<->,33.209.217.228,2,112,0,0,2,112,1.229775000,0.6128
215.158.238.113,<->,57.199.250.196,2,1413,0,0,2,1413,1.229750000,0.2028
142.221.178.208,<->,136.25.188.238,0,0,2,120,2,120,1.229459000,0.3814
50.224.76.234,<->,48.129.94.231,2,120,0,0,2,120,1.229405000,0.1862
215.202.175.5,<->,215.158.238.133,0,0,2,1285,2,1285,1.228745000,0.2726
113.123.25.66,<->,89.183.104.252,0,0,2,106,2,106,1.228647000,0.5274
215.158.239.76,<->,199.20.5.103,2,112,0,0,2,112,1.228603000,0.0000
192.171.13.189,<->,8.252.222.105,0,0,2,284,2,284,1.228442000,0.0016
215.158.61.202,<->,136.25.189.210,0,0,2,2811,2,2811,1.227982000,0.1541
133.178.227.14,<->,8.219.187.251,2,1397,0,0,2,1397,1.227901000,0.0685
143.79.216.168,<->,136.25.188.225,0,0,2,100,2,100,1.227576000,0.0000
215.158.239.76,<->,196.0.254.96,2,658,0,0,2,658,1.227512000,0.4195
136.25.189.0,<->,8.252.253.196,2,1429,0,0,2,1429,1.226995000,0.1365
192.178.173.46,<->,132.249.70.233,0,0,2,299,2,299,1.226714000,0.1030
215.158.238.104,<->,143.155.227.33,2,1157,0,0,2,1157,1.226400000,0.1775
215.158.239.35,<->,149.96.53.54,2,1533,0,0,2,1533,1.226382000,0.1020
246.253.253.213,<->,207.83.0.182,2,100,0,0,2,100,1.225982000,0.4301
207.64.196.58,<->,8.182.234.173,0,0,2,100,2,100,1.225754000,0.0000
133.42.251.189,<->,92.27.27.144,0,0,2,100,2,100,1.225741000,0.5686
136.25.189.83,<->,113.92.151.24,2,1308,0,0,2,1308,1.225732000,0.1748
143.132.103.11,<->,136.25.188.226,0,0,2,100,2,100,1.225647000,0.1751
220.28.108.254,<->,215.158.239.67,0,0,2,2778,2,2778,1.224827000,0.0000
142.167.222.236,<->,136.25.188.224,0,0,2,106,2,106,1.224601000,0.6983
207.61.214.110,<->,136.25.188.236,0,0,2,100,2,100,1.224334000,0.2020
215.158.239.85,<->,113.92.151.118,2,1301,0,0,2,1301,1.223984000,0.0982
215.201.235.99,<->,8.183.25.124,0,0,2,112,2,112,1.222531000,0.2931
199.15.152.221,<->,136.25.188.52,0,0,2,136,2,136,1.222449000,0.4299
139.163.120.41,<->,112.24.188.118,2,120,0,0,2,120,1.222362000,0.1042
99.215.120.166,<->,8.183.25.124,0,0,2,100,2,100,1.221336000,0.0330
143.252.64.230,<->,129.224.112.252,0,0,2,135,2,135,1.220833000,0.7253
215.158.239.70,<->,56.20.41.31,2,1397,0,0,2,1397,1.220813000,0.0344
56.9.244.247,<->,8.182.226.78,0,0,2,861,2,861,1.220767000,0.0324
132.118.97.71,<->,80.42.154.222,0,0,2,149,2,149,1.219465000,0.0000
215.158.239.240,<->,192.228.30.185,2,539,0,0,2,539,1.219342000,0.0001
129.224.112.252,<->,92.160.14.37,2,158,0,0,2,158,1.218894000,0.0036
194.233.74.159,<->,136.25.188.227,0,0,2,163,2,163,1.218710000,0.0400
215.158.239.68,<->,195.40.159.229,2,326,0,0,2,326,1.218587000,0.6921
143.13.180.223,<->,136.25.188.198,0,0,2,667,2,667,1.218323000,0.1368
92.27.218.242,<->,29.250.106.180,2,250,0,0,2,250,1.218316000,0.1558
159.13.243.75,<->,54.58.113.240,2,321,0,0,2,321,1.218073000,0.0359
220.20.200.61,<->,84.211.26.201,2,100,0,0,2,100,1.217612000,0.2044
111.151.142.129,<->,8.252.223.245,0,0,2,112,2,112,1.217460000,0.0000
246.253.253.208,<->,195.0.73.54,2,266,0,0,2,266,1.216497000,0.3425
93.221.214.170,<->,8.31.37.161,0,0,2,118,2,118,1.216138000,0.2443
145.213.37.26,<->,136.129.94.107,0,0,2,168,2,168,1.215928000,0.1094
215.158.238.123,<->,131.4.188.255,2,1285,0,0,2,1285,1.215133000,0.5625
192.64.254.164,<->,8.45.162.111,2,125,0,0,2,125,1.214904000,0.0000
207.162.174.184,<->,8.182.235.164,0,0,2,100,2,100,1.214886000,0.0005
215.158.238.143,<->,112.220.206.107,2,120,0,0,2,120,1.214867000,0.0982
205.89.36.60,<->,89.183.104.137,0,0,2,104,2,104,1.214362000,0.6451
133.178.227.76,<->,126.219.100.248,2,1125,0,0,2,1125,1.213900000,0.3831
136.25.189.31,<->,122.216.233.153,2,1269,0,0,2,1269,1.213891000,0.0921
159.13.135.29,<->,53.213.20.251,2,805,0,0,2,805,1.212292000,0.0025
120.105.109.102,<->,50.224.76.248,0,0,2,106,2,106,1.211199000,0.2382
215.158.140.74,<->,102.49.92.252,2,118,0,0,2,118,1.211076000,0.0691
136.25.189.14,<->,8.47.120.246,2,1301,0,0,2,1301,1.210723000,0.2350
215.158.239.95,<->,207.190.184.136,2,228,0,0,2,228,1.210532000,0.2202
143.155.227.33,<->,136.25.188.172,0,0,2,246,2,246,1.209696000,0.1671
222.65.26.49,<->,33.250.210.16,2,352,0,0,2,352,1.209339000,0.0010
146.171.130.228,<->,133.178.227.16,0,0,2,1381,2,1381,1.209161000,0.2891
206.103.215.34,<->,136.25.189.0,0,0,2,1253,2,1253,1.208442000,0.1667
112.118.148.133,<->,109.1.58.226,0,0,2,100,2,100,1.207890000,0.3250
92.162.253.70,<->,8.4.143.176,2,100,0,0,2,100,1.207750000,0.0245
192.65.240.199,<->,132.128.61.223,2,100,0,0,2,100,1.207424000,0.0445
136.25.188.178,<->,131.173.115.84,2,1349,0,0,2,1349,1.207372000,0.5319
143.13.48.59,<->,136.25.188.178,0,0,2,658,2,658,1.206886000,0.2090
132.136.194.171,<->,116.184.23.7,2,108,0,0,2,108,1.206057000,0.1698
112.97.29.171,<->,80.41.18.10,0,0,2,217,2,217,1.205411000,0.4059
215.158.239.51,<->,69.150.169.38,2,1285,0,0,2,1285,1.205186000,0.2201
100.93.188.233,<->,89.205.210.165,2,147,0,0,2,147,1.204799000,0.0000
136.25.188.163,<->,8.227.10.77,2,120,0,0,2,120,1.203818000,0.0170
97.168.119.55,<->,91.231.223.53,2,106,0,0,2,106,1.203347000,0.2481
136.25.188.161,<->,114.25.48.25,2,1205,0,0,2,1205,1.203187000,0.1718
207.57.161.89,<->,136.25.188.163,0,0,2,120,2,120,1.202984000,0.2394
143.13.48.59,<->,136.25.188.163,0,0,2,658,2,658,1.202971000,0.0474
95.247.43.157,<->,8.252.221.221,0,0,2,112,2,112,1.202696000,0.1529
215.158.239.51,<->,195.40.25.105,2,102,0,0,2,102,1.202567000,0.6201
145.16.34.73,<->,137.39.55.47,2,112,0,0,2,112,1.201579000,0.0000
118.252.76.119,<->,50.224.76.235,0,0,2,106,2,106,1.200155000,0.1417
133.178.227.23,<->,100.224.133.123,2,599,0,0,2,599,1.199167000,0.0405
204.139.38.148,<->,8.182.235.164,0,0,2,100,2,100,1.199034000,0.0264
196.240.242.210,<->,136.25.188.241,0,0,2,611,2,611,1.198719000,0.0499
92.27.27.165,<->,74.133.57.237,2,120,0,0,2,120,1.198572000,0.7318
94.197.44.79,<->,35.56.101.157,0,0,2,160,2,160,1.198369000,0.3685
235.253.218.229,<->,133.178.226.30,0,0,2,1365,2,1365,1.196917000,0.7162
221.102.56.69,<->,136.181.50.254,0,0,2,128,2,128,1.196486000,0.6320
235.253.220.246,<->,215.158.239.77,0,0,2,1413,2,1413,1.195788000,0.1833
156.135.2.78,<->,0.195.210.42,0,0,2,354,2,354,1.194998000,0.2345
207.59.194.140,<->,136.25.188.177,0,0,2,100,2,100,1.194350000,0.2604
133.178.226.215,<->,131.251.111.52,2,112,0,0,2,112,1.192931000,0.1176
195.124.172.110,<->,136.25.188.209,0,0,2,100,2,100,1.192751000,0.2709
136.25.189.78,<->,133.146.0.75,2,1349,0,0,2,1349,1.192329000,0.0630
195.42.146.59,<->,136.25.188.163,0,0,2,100,2,100,1.191970000,0.2103
215.158.239.92,<->,142.255.137.51,2,102,0,0,2,102,1.191968000,0.3619
215.158.239.84,<->,196.108.57.197,2,120,0,0,2,120,1.190540000,0.7706
133.178.226.215,<->,130.36.8.103,2,823,0,0,2,823,1.190310000,0.1069
215.158.239.85,<->,195.42.22.18,2,100,0,0,2,100,1.188184000,0.2200
144.232.221.31,<->,35.56.102.150,0,0,2,100,2,100,1.187687000,0.0000
215.158.239.68,<->,199.20.5.237,2,128,0,0,2,128,1.186662000,0.0000
108.180.200.119,<->,8.53.2.132,0,0,2,100,2,100,1.185557000,0.0010
199.32.197.239,<->,136.25.188.220,0,0,2,100,2,100,1.184875000,0.1626
204.61.128.174,<->,136.25.188.239,0,0,2,100,2,100,1.184853000,0.1565
94.193.127.240,<->,8.252.222.60,0,0,2,100,2,100,1.184305000,0.0069
204.60.95.212,<->,136.25.188.243,0,0,2,951,2,951,1.184187000,0.0826
144.75.218.237,<->,99.168.7.150,2,289,0,0,2,289,1.182808000,0.2979
102.45.241.111,<->,92.162.253.16,0,0,2,100,2,100,1.182069000,0.0248
207.239.67.27,<->,136.25.188.55,0,0,2,100,2,100,1.181576000,0.0019
136.25.189.45,<->,112.68.105.213,2,1429,0,0,2,1429,1.180735000,0.1435
215.158.239.94,<->,195.49.41.114,2,136,0,0,2,136,1.180605000,0.1460
142.240.221.172,<->,136.25.188.174,0,0,2,106,2,106,1.180470000,0.2397
215.158.3.13,<->,99.73.241.125,0,0,2,508,2,508,1.179949000,0.0000
195.70.4.190,<->,136.25.188.241,0,0,2,100,2,100,1.179815000,0.4004
142.190.131.48,<->,136.25.188.176,0,0,2,100,2,100,1.179022000,0.1954
125.18.130.104,<->,92.27.27.166,0,0,2,2916,2,2916,1.178012000,0.6379
142.248.47.73,<->,136.25.188.242,0,0,2,100,2,100,1.176802000,0.1835
159.23.227.171,<->,106.132.139.141,2,342,0,0,2,342,1.176205000,0.4456
215.158.239.40,<->,8.255.92.81,2,1074,0,0,2,1074,1.176063000,0.2290
50.224.89.239,<->,42.35.49.134,2,147,0,0,2,147,1.176022000,0.0000
215.158.238.190,<->,195.65.1.180,2,1104,0,0,2,1104,1.174143000,0.2875
215.158.140.60,<->,8.191.7.251,2,2055,0,0,2,2055,1.174139000,0.7973
199.69.28.179,<->,136.25.188.220,0,0,2,100,2,100,1.173681000,0.0020
136.25.188.172,<->,80.47.228.213,2,1445,0,0,2,1445,1.173480000,0.0315
199.83.164.149,<->,136.25.188.222,0,0,2,100,2,100,1.172626000,0.0024
145.79.67.241,<->,8.220.235.114,0,0,2,120,2,120,1.172612000,0.0250
144.75.218.235,<->,138.127.225.151,2,526,0,0,2,526,1.172213000,0.2985
231.142.35.175,<->,136.25.188.53,0,0,2,100,2,100,1.171999000,0.2043
99.162.77.146,<->,53.200.59.220,2,497,0,0,2,497,1.171514000,0.2927
109.51.169.114,<->,8.182.226.78,0,0,2,872,2,872,1.171302000,0.5563
221.196.122.67,<->,136.25.188.173,0,0,2,112,2,112,1.171300000,0.1119
221.102.56.25,<->,192.65.64.124,0,0,2,197,2,197,1.170447000,0.0000
215.158.3.33,<->,99.73.241.125,0,0,2,508,2,508,1.168749000,0.0000
215.158.239.79,<->,143.13.124.234,2,100,0,0,2,100,1.168332000,0.0015
215.158.140.27,<->,38.88.250.159,2,120,0,0,2,120,1.168227000,0.2480
212.164.140.243,<->,126.231.20.192,2,396,0,0,2,396,1.168081000,0.1518
215.158.238.95,<->,141.103.76.137,2,1109,0,0,2,1109,1.168056000,0.1309
142.248.91.237,<->,136.25.188.253,0,0,2,112,2,112,1.167033000,0.8206
144.75.218.237,<->,53.167.244.138,2,252,0,0,2,252,1.166783000,0.6271
204.186.122.183,<->,136.25.188.222,0,0,2,328,2,328,1.166541000,0.2195
210.229.230.21,<->,6.141.138.161,2,118,0,0,2,118,1.166264000,0.2335
247.136.147.117,<->,129.211.15.11,2,112,0,0,2,112,1.166251000,0.0218
215.158.238.236,<->,131.219.110.169,2,1151,0,0,2,1151,1.165982000,0.0997
247.136.212.188,<->,207.77.10.160,2,112,0,0,2,112,1.165564000,0.7510
215.158.239.76,<->,149.252.245.36,2,1333,0,0,2,1333,1.165467000,0.0929
133.178.227.12,<->,56.1.237.9,2,1508,0,0,2,1508,1.165444000,0.0322
195.3.103.216,<->,136.25.189.1,0,0,2,1253,2,1253,1.165150000,0.1505
215.158.61.189,<->,136.25.188.34,0,0,2,741,2,741,1.164992000,0.0429
96.242.38.144,<->,8.52.131.48,0,0,2,102,2,102,1.164667000,0.2119
215.158.140.27,<->,121.130.202.224,2,120,0,0,2,120,1.164649000,0.1439
121.211.213.138,<->,92.27.27.156,0,0,2,702,2,702,1.164427000,0.2681
142.227.67.192,<->,136.25.188.198,0,0,2,100,2,100,1.164196000,0.0026
204.58.34.150,<->,136.25.188.179,0,0,2,100,2,100,1.163850000,0.1611
140.9.184.155,<->,129.224.112.252,0,0,2,161,2,161,1.163075000,0.0029
142.248.47.73,<->,136.25.188.54,0,0,2,100,2,100,1.161599000,0.1807
215.158.239.95,<->,196.90.62.38,2,112,0,0,2,112,1.160611000,0.3001
215.158.140.27,<->,141.185.8.239,2,120,0,0,2,120,1.160147000,0.2535
220.55.84.159,<->,149.172.47.81,2,106,0,0,2,106,1.159716000,0.1514
129.224.112.252,<->,92.160.15.143,2,150,0,0,2,150,1.159460000,0.0022
215.158.238.198,<->,197.125.118.95,2,1244,0,0,2,1244,1.158843000,0.1002
194.232.225.22,<->,136.25.188.255,0,0,2,106,2,106,1.158738000,0.2430
195.5.79.82,<->,136.25.188.45,0,0,2,100,2,100,1.158595000,0.1905
199.111.112.177,<->,8.182.235.164,0,0,2,100,2,100,1.158235000,0.0024
111.151.106.203,<->,99.74.26.171,0,0,2,112,2,112,1.158073000,0.0000
136.25.189.59,<->,32.183.36.249,2,1429,0,0,2,1429,1.158065000,0.1958
144.75.218.237,<->,139.252.1.230,2,180,0,0,2,180,1.157632000,0.1606
104.190.120.170,<->,50.224.76.230,0,0,2,100,2,100,1.157458000,0.1631
192.64.204.68,<->,125.57.94.174,2,100,0,0,2,100,1.157101000,0.1390
247.136.144.224,<->,66.244.99.65,2,127,0,0,2,127,1.156930000,0.2816
215.158.239.95,<->,207.190.45.69,2,106,0,0,2,106,1.156619000,0.5209
215.158.239.84,<->,195.55.150.48,2,106,0,0,2,106,1.156293000,0.1833
124.42.155.136,<->,8.252.221.171,0,0,2,369,2,369,1.155921000,0.3459
109.51.92.28,<->,8.182.244.19,0,0,2,741,2,741,1.155188000,0.1446
192.224.20.52,<->,133.178.227.250,0,0,2,1461,2,1461,1.155007000,0.1008
215.158.239.85,<->,194.251.142.214,2,112,0,0,2,112,1.154644000,0.0687
221.196.123.31,<->,136.25.188.173,0,0,2,112,2,112,1.154638000,0.1200
92.27.59.69,<->,8.183.25.124,0,0,2,112,2,112,1.153360000,0.0422
207.92.27.14,<->,8.182.226.42,0,0,2,100,2,100,1.153345000,0.0000
215.158.239.77,<->,196.93.82.84,2,112,0,0,2,112,1.153124000,0.2801
195.109.35.75,<->,99.73.186.154,0,0,2,134,2,134,1.152932000,0.8400
215.158.239.56,<->,207.228.152.240,2,961,0,0,2,961,1.152683000,0.0000
220.31.31.23,<->,8.182.241.177,0,0,2,568,2,568,1.152558000,0.0638
215.158.238.113,<->,57.227.83.183,2,1397,0,0,2,1397,1.152179000,0.1101
53.200.150.117,<->,48.55.149.22,0,0,2,100,2,100,1.151536000,0.2999
215.158.239.97,<->,199.20.30.80,2,124,0,0,2,124,1.151484000,0.8117
143.155.227.33,<->,136.25.188.221,0,0,2,246,2,246,1.151247000,0.1736
204.58.34.150,<->,136.25.188.54,0,0,2,100,2,100,1.150259000,0.1459
198.30.245.43,<->,137.21.2.203,0,0,2,465,2,465,1.150243000,0.1608
207.162.131.219,<->,8.182.253.209,0,0,2,100,2,100,1.149415000,0.0005
215.158.239.48,<->,204.2.156.176,2,709,0,0,2,709,1.149174000,0.4196
203.215.123.200,<->,118.241.252.70,2,120,0,0,2,120,1.148825000,0.1557
215.201.174.182,<->,8.182.226.78,0,0,2,656,2,656,1.148800000,0.1761
98.33.78.19,<->,92.27.219.188,0,0,2,304,2,304,1.148128000,0.5097
132.168.198.158,<->,50.145.220.35,2,112,0,0,2,112,1.147943000,0.0900
231.142.252.181,<->,136.25.188.209,0,0,2,161,2,161,1.147897000,0.0468
69.243.202.119,<->,8.252.221.236,0,0,2,100,2,100,1.147667000,0.1505
54.55.139.166,<->,8.228.210.186,0,0,2,120,2,120,1.147524000,0.0664
142.228.58.183,<->,136.25.188.255,0,0,2,100,2,100,1.147428000,0.2207
136.25.189.19,<->,131.144.113.60,2,1285,0,0,2,1285,1.147396000,0.2186
199.33.141.117,<->,136.25.188.236,0,0,2,100,2,100,1.147146000,0.0017
204.184.41.206,<->,136.25.188.178,0,0,2,658,2,658,1.145976000,0.4701
136.181.42.3,<->,82.193.206.111,2,112,0,0,2,112,1.145088000,0.0021
231.142.226.241,<->,136.25.188.198,0,0,2,100,2,100,1.142607000,0.0016
215.158.239.78,<->,196.91.93.155,2,112,0,0,2,112,1.142518000,0.8400
129.78.113.145,<->,119.117.18.69,2,100,0,0,2,100,1.142454000,0.0009
204.185.100.217,<->,136.25.188.53,0,0,2,120,2,120,1.142038000,0.6776
215.158.238.105,<->,199.69.87.93,2,1381,0,0,2,1381,1.141224000,0.1854
142.255.13.160,<->,136.25.188.174,0,0,2,106,2,106,1.141080000,0.2597
136.25.189.88,<->,29.209.59.213,2,1333,0,0,2,1333,1.139964000,0.1107
207.57.41.169,<->,136.25.188.227,0,0,2,114,2,114,1.139715000,0.2099
215.158.239.30,<->,113.93.9.37,2,1516,0,0,2,1516,1.138144000,0.3081
207.57.41.169,<->,136.25.188.45,0,0,2,114,2,114,1.137586000,0.2100
231.142.117.95,<->,136.25.188.175,0,0,2,100,2,100,1.137411000,0.1771
136.181.42.3,<->,91.40.231.175,2,181,0,0,2,181,1.137122000,0.0000
199.121.86.116,<->,136.25.188.178,0,0,2,135,2,135,1.137024000,0.4312
136.181.42.3,<->,8.49.69.216,2,197,0,0,2,197,1.136933000,0.0000
107.10.183.170,<->,8.52.171.120,0,0,2,707,2,707,1.136812000,0.0626
221.102.143.189,<->,220.80.213.14,0,0,2,197,2,197,1.136773000,0.0000
109.119.182.228,<->,8.182.251.47,0,0,2,100,2,100,1.136243000,0.0331
134.160.217.145,<->,92.27.219.61,0,0,2,649,2,649,1.135999000,0.3138
204.140.145.221,<->,8.182.241.177,0,0,2,112,2,112,1.135104000,0.1791
192.67.150.206,<->,110.6.236.172,2,108,0,0,2,108,1.134624000,0.0012
146.170.141.36,<->,80.27.158.233,0,0,2,100,2,100,1.134192000,0.6118
244.149.8.95,<->,215.158.140.27,0,0,2,120,2,120,1.133692000,0.1332
129.224.112.252,<->,97.242.126.193,2,171,0,0,2,171,1.133096000,0.0047
144.76.46.38,<->,102.51.208.201,0,0,2,481,2,481,1.133063000,0.0360
136.25.188.254,<->,4.138.30.188,2,106,0,0,2,106,1.133017000,0.3273
200.179.165.43,<->,50.224.76.248,0,0,2,100,2,100,1.132566000,0.0001
92.27.234.195,<->,92.27.51.139,2,240,0,0,2,240,1.132421000,0.0000
159.178.66.219,<->,8.52.133.228,0,0,2,112,2,112,1.132248000,0.0338
56.124.246.90,<->,8.220.176.253,0,0,2,100,2,100,1.132077000,0.0266
102.231.186.190,<->,8.49.69.216,2,197,0,0,2,197,1.131909000,0.0000
89.216.25.2,<->,8.176.58.112,0,0,2,100,2,100,1.131624000,0.0003
215.202.174.56,<->,215.158.239.97,0,0,2,1173,2,1173,1.130425000,0.2409
215.158.239.50,<->,207.59.172.221,2,143,0,0,2,143,1.129612000,0.0012
143.132.195.27,<->,136.25.188.252,0,0,2,106,2,106,1.129480000,0.2133
215.158.140.87,<->,111.199.248.115,2,100,0,0,2,100,1.128712000,0.5220
215.158.140.177,<->,6.15.196.203,2,1049,0,0,2,1049,1.128530000,0.0257
133.178.227.1,<->,8.222.6.193,2,1045,0,0,2,1045,1.128356000,0.0354
133.178.226.234,<->,56.1.238.231,2,796,0,0,2,796,1.128328000,0.0191
252.189.160.163,<->,8.182.241.177,0,0,2,112,2,112,1.128039000,0.1859
215.158.239.56,<->,196.107.43.0,2,124,0,0,2,124,1.127334000,0.5397
207.62.106.96,<->,136.25.188.198,0,0,2,641,2,641,1.126734000,0.2710
215.158.239.41,<->,149.96.60.11,2,1509,0,0,2,1509,1.126416000,0.2561
50.51.20.222,<->,8.220.176.253,0,0,2,112,2,112,1.126204000,0.0260
254.126.121.12,<->,100.94.188.60,0,0,2,125,2,125,1.125966000,0.2430
143.13.117.23,<->,136.25.188.160,0,0,2,100,2,100,1.125835000,0.0015
136.18.70.77,<->,8.182.139.168,0,0,2,106,2,106,1.124949000,0.0298
215.158.239.76,<->,196.109.184.155,2,106,0,0,2,106,1.124893000,0.3196
136.25.189.36,<->,100.216.78.145,2,2518,0,0,2,2518,1.124263000,0.0000
109.222.220.176,<->,53.191.244.178,2,344,0,0,2,344,1.123964000,0.4975
129.175.139.161,<->,67.174.33.137,0,0,2,437,2,437,1.123715000,0.0027
215.158.140.27,<->,116.125.105.207,2,120,0,0,2,120,1.123298000,0.1025
194.232.1.138,<->,136.25.188.242,0,0,2,100,2,100,1.122851000,0.0014
220.20.200.137,<->,136.177.72.3,2,100,0,0,2,100,1.122710000,0.0524
199.52.83.48,<->,136.25.188.197,0,0,2,106,2,106,1.121977000,0.2062
98.158.80.51,<->,8.182.241.94,0,0,2,100,2,100,1.121914000,0.0624
142.205.232.34,<->,136.25.188.53,0,0,2,112,2,112,1.121760000,0.1808
215.158.239.56,<->,196.106.119.34,2,688,0,0,2,688,1.121583000,0.1204
204.115.77.211,<->,92.27.219.166,0,0,2,112,2,112,1.121106000,0.6484
215.158.61.183,<->,8.176.8.232,0,0,2,112,2,112,1.120997000,0.6731
215.158.239.92,<->,199.51.197.185,2,100,0,0,2,100,1.120013000,0.2831
142.205.232.34,<->,8.252.222.132,0,0,2,112,2,112,1.119619000,0.1987
132.216.20.184,<->,80.40.56.122,0,0,2,143,2,143,1.119472000,0.0000
210.229.230.22,<->,26.209.247.67,2,136,0,0,2,136,1.118982000,0.0787
136.25.189.81,<->,131.6.152.4,2,1253,0,0,2,1253,1.118256000,0.1693
8.182.136.81,<->,6.242.51.21,2,441,0,0,2,441,1.118105000,0.0552
118.127.120.217,<->,50.224.76.234,0,0,2,106,2,106,1.116944000,0.1847
159.137.152.183,<->,133.178.226.212,0,0,2,390,2,390,1.114093000,0.0223
207.236.234.31,<->,136.25.188.175,0,0,2,100,2,100,1.113859000,0.1446
204.187.83.233,<->,136.25.188.253,0,0,2,380,2,380,1.113225000,0.2614
215.158.238.133,<->,29.209.4.26,2,1125,0,0,2,1125,1.113089000,0.1174
97.22.63.90,<->,8.182.226.78,0,0,2,691,2,691,1.112980000,0.0696
215.158.239.96,<->,207.239.67.32,2,106,0,0,2,106,1.112788000,0.1658
195.41.140.136,<->,136.25.188.255,0,0,2,120,2,120,1.112443000,0.0040
97.18.65.129,<->,8.220.176.253,0,0,2,112,2,112,1.111922000,0.0216
129.236.115.34,<->,111.20.168.123,0,0,2,740,2,740,1.111788000,0.0210
111.20.172.70,<->,33.233.141.39,0,0,2,583,2,583,1.111414000,0.0052
215.158.239.77,<->,204.21.105.164,2,100,0,0,2,100,1.110736000,0.2045
133.178.226.215,<->,8.33.226.5,2,112,0,0,2,112,1.108262000,0.0000
199.71.14.17,<->,136.25.188.54,0,0,2,319,2,319,1.107039000,0.0146
195.127.98.238,<->,136.25.188.225,0,0,2,100,2,100,1.106499000,0.1764
252.136.244.20,<->,192.67.183.120,0,0,2,120,2,120,1.106326000,0.0403
199.83.63.202,<->,136.25.188.174,0,0,2,100,2,100,1.106141000,0.0020
53.213.200.116,<->,48.53.37.167,0,0,2,149,2,149,1.105970000,0.0000
215.158.238.123,<->,29.214.69.5,2,1253,0,0,2,1253,1.105298000,0.7690
111.20.168.13,<->,54.37.219.162,2,147,0,0,2,147,1.105265000,0.0000
56.121.60.239,<->,50.29.195.180,2,128,0,0,2,128,1.104940000,0.0398
129.236.100.84,<->,129.224.112.252,0,0,2,151,2,151,1.104334000,0.0110
246.108.122.37,<->,80.40.11.119,0,0,2,100,2,100,1.104200000,0.1286
215.158.239.18,<->,215.158.42.96,2,1221,0,0,2,1221,1.104171000,0.0354
97.199.145.69,<->,54.37.145.129,2,580,0,0,2,580,1.103940000,0.0078
215.158.239.51,<->,199.20.30.31,2,120,0,0,2,120,1.103484000,0.6105
199.69.57.220,<->,136.25.188.252,0,0,2,100,2,100,1.103114000,0.2336
193.51.220.212,<->,98.236.95.94,0,0,2,100,2,100,1.102351000,0.4199
58.60.37.155,<->,8.252.222.135,0,0,2,120,2,120,1.101754000,0.1957
215.158.239.56,<->,195.55.113.196,2,106,0,0,2,106,1.101634000,0.2018
129.175.139.190,<->,29.211.214.32,0,0,2,244,2,244,1.101365000,0.2395
215.158.239.58,<->,196.88.77.226,2,100,0,0,2,100,1.101329000,0.2217
207.172.194.99,<->,136.25.188.46,0,0,2,128,2,128,1.101263000,0.8791
215.158.239.49,<->,199.32.234.249,2,114,0,0,2,114,1.101212000,0.3464
205.127.108.113,<->,33.233.141.75,0,0,2,139,2,139,1.101028000,0.0000
199.32.150.99,<->,136.25.188.176,0,0,2,100,2,100,1.100848000,0.1688
210.229.230.18,<->,108.165.142.247,2,118,0,0,2,118,1.100826000,0.2719
215.158.127.28,<->,136.25.188.37,0,0,2,2242,2,2242,1.100768000,0.0000
210.229.230.22,<->,98.178.105.18,2,118,0,0,2,118,1.100650000,0.2482
215.158.238.176,<->,119.196.23.10,2,1099,0,0,2,1099,1.100539000,0.1371
193.86.141.14,<->,109.222.254.133,0,0,2,100,2,100,1.099855000,0.0000
144.87.238.91,<->,8.182.244.179,0,0,2,100,2,100,1.098359000,0.0226
220.20.200.6,<->,53.65.17.168,2,100,0,0,2,100,1.098196000,0.1581
117.34.239.188,<->,8.31.37.163,0,0,2,100,2,100,1.097965000,0.1142
58.203.179.178,<->,8.252.221.222,0,0,2,100,2,100,1.097939000,0.1641
148.155.129.25,<->,33.233.141.230,0,0,2,340,2,340,1.097825000,0.0032
92.27.27.158,<->,84.10.176.198,2,649,0,0,2,649,1.097247000,0.5208
46.129.181.226,<->,8.52.168.141,0,0,2,100,2,100,1.096850000,0.1446
205.227.96.8,<->,136.25.189.88,0,0,2,1269,2,1269,1.095271000,0.1251
220.78.195.137,<->,8.52.222.23,0,0,2,100,2,100,1.095055000,0.0397
80.41.32.232,<->,38.173.151.23,2,112,0,0,2,112,1.094678000,0.0030
215.158.239.58,<->,196.91.209.210,2,112,0,0,2,112,1.094245000,0.3002
89.183.104.179,<->,48.111.12.103,2,112,0,0,2,112,1.093294000,0.7637
215.158.238.133,<->,96.38.231.165,2,1173,0,0,2,1173,1.093135000,0.0230
215.202.174.59,<->,136.25.189.59,0,0,2,1269,2,1269,1.093032000,0.5413
136.25.189.82,<->,120.154.131.22,2,1413,0,0,2,1413,1.091981000,0.1132
199.20.30.21,<->,92.27.194.147,0,0,2,100,2,100,1.091662000,0.1483
215.158.239.57,<->,119.196.23.22,2,1141,0,0,2,1141,1.091179000,0.1210
100.122.42.250,<->,8.182.226.78,0,0,2,100,2,100,1.090697000,0.0559
80.40.63.6,<->,22.36.147.6,2,163,0,0,2,163,1.090674000,0.0000
215.158.239.3,<->,129.150.75.195,2,112,0,0,2,112,1.090494000,0.1677
205.127.108.113,<->,101.224.89.186,0,0,2,139,2,139,1.089986000,0.0000
148.229.96.144,<->,89.183.110.72,0,0,2,120,2,120,1.089690000,0.1238
100.122.38.220,<->,8.182.251.218,0,0,2,106,2,106,1.089305000,0.0806
8.220.185.20,<->,6.101.98.202,2,739,0,0,2,739,1.089127000,0.3576
100.192.167.54,<->,8.52.189.207,0,0,2,100,2,100,1.088789000,0.0269
100.206.84.172,<->,92.162.253.126,0,0,2,100,2,100,1.088282000,0.0421
93.181.154.23,<->,92.27.219.243,0,0,2,100,2,100,1.088016000,0.6652
195.126.60.209,<->,136.25.188.53,0,0,2,313,2,313,1.087430000,0.3770
196.204.5.174,<->,136.25.188.46,0,0,2,112,2,112,1.087282000,0.0177
92.30.203.218,<->,8.220.184.162,0,0,2,531,2,531,1.087275000,0.0291
192.67.167.86,<->,92.45.66.15,2,108,0,0,2,108,1.086934000,0.2532
210.229.230.22,<->,130.19.167.229,2,136,0,0,2,136,1.086854000,0.1726
89.183.104.251,<->,67.240.73.44,2,100,0,0,2,100,1.086592000,0.2409
192.171.13.33,<->,8.252.222.166,0,0,2,557,2,557,1.086358000,0.0252
222.254.228.206,<->,215.158.140.11,0,0,2,830,2,830,1.085804000,0.5386
204.187.117.251,<->,136.25.188.227,0,0,2,658,2,658,1.085536000,0.2600
143.95.114.109,<->,136.25.188.253,0,0,2,100,2,100,1.085329000,0.1626
252.98.149.245,<->,54.47.78.134,2,100,0,0,2,100,1.084431000,0.1086
207.93.233.239,<->,159.137.243.168,0,0,2,106,2,106,1.083803000,0.2373
129.236.100.120,<->,129.224.112.252,0,0,2,151,2,151,1.083780000,0.0023
92.27.219.153,<->,78.45.136.53,2,266,0,0,2,266,1.083609000,0.0079
152.105.243.218,<->,8.252.221.197,0,0,2,100,2,100,1.083112000,0.1612
215.158.238.25,<->,148.21.212.232,2,1525,0,0,2,1525,1.083043000,0.1210
215.158.103.206,<->,129.211.22.194,2,1598,0,0,2,1598,1.082759000,0.8561
143.22.110.83,<->,8.182.226.78,0,0,2,100,2,100,1.082710000,0.0001
80.40.63.6,<->,8.45.168.98,2,179,0,0,2,179,1.082647000,0.0000
215.158.239.56,<->,199.20.30.97,2,958,0,0,2,958,1.082263000,0.0198
215.158.239.96,<->,196.95.151.130,2,124,0,0,2,124,1.081988000,0.2210
215.158.140.83,<->,8.57.163.141,2,1219,0,0,2,1219,1.081464000,0.7160
215.158.238.133,<->,8.240.117.62,2,112,0,0,2,112,1.080786000,0.0001
199.32.147.42,<->,136.25.188.45,0,0,2,100,2,100,1.080296000,0.1830
215.158.61.203,<->,8.176.8.199,0,0,2,2389,2,2389,1.080181000,0.0000
215.158.61.193,<->,8.176.8.84,0,0,2,375,2,375,1.079578000,0.0683
195.61.156.13,<->,8.182.250.65,0,0,2,112,2,112,1.079145000,0.1520
215.158.238.93,<->,106.188.251.222,2,1278,0,0,2,1278,1.078746000,0.1101
144.75.218.246,<->,132.43.156.54,2,319,0,0,2,319,1.078380000,0.3555
215.158.239.84,<->,199.20.4.215,2,112,0,0,2,112,1.078108000,0.2163
91.48.164.164,<->,8.52.163.19,0,0,2,100,2,100,1.077952000,0.0716
129.236.100.136,<->,129.224.112.252,0,0,2,149,2,149,1.077369000,0.0129
111.20.172.70,<->,101.224.89.152,0,0,2,582,2,582,1.076654000,0.0013
124.40.37.23,<->,80.40.11.119,0,0,2,100,2,100,1.076148000,0.1368
215.158.239.76,<->,199.69.190.94,2,106,0,0,2,106,1.075709000,0.1921
133.178.226.78,<->,8.222.212.0,2,120,0,0,2,120,1.075652000,0.0222
133.178.226.7,<->,125.216.33.131,2,1397,0,0,2,1397,1.075639000,0.1129
216.144.220.7,<->,215.158.140.185,0,0,2,106,2,106,1.075316000,0.4564
215.158.239.48,<->,196.104.242.149,2,128,0,0,2,128,1.074507000,0.3807
204.186.210.48,<->,136.25.188.220,0,0,2,136,2,136,1.074091000,0.0077
56.9.118.82,<->,8.182.252.86,0,0,2,106,2,106,1.073935000,0.0683
111.150.207.99,<->,99.74.26.110,0,0,2,156,2,156,1.073822000,0.7536
215.158.238.188,<->,148.21.212.227,2,1140,0,0,2,1140,1.073747000,0.1512
127.176.190.243,<->,92.27.219.50,0,0,2,112,2,112,1.073695000,0.6802
215.158.238.243,<->,192.204.170.235,2,1101,0,0,2,1101,1.073252000,0.3843
207.61.81.191,<->,136.25.188.254,0,0,2,100,2,100,1.073006000,0.6997
210.220.219.153,<->,91.41.85.245,2,496,0,0,2,496,1.072490000,0.0502
221.102.51.197,<->,99.74.87.243,0,0,2,120,2,120,1.072366000,0.0337
215.158.238.72,<->,143.155.227.33,2,246,0,0,2,246,1.071673000,0.1658
204.2.220.186,<->,136.25.188.241,0,0,2,100,2,100,1.070747000,0.0024
35.17.219.171,<->,8.220.205.146,0,0,2,2220,2,2220,1.070719000,0.0702
215.158.239.56,<->,143.13.81.196,2,100,0,0,2,100,1.070681000,0.2321
215.158.239.78,<->,199.79.125.157,2,136,0,0,2,136,1.070299000,0.6443
215.158.239.96,<->,143.91.240.206,2,100,0,0,2,100,1.069645000,0.8593
143.76.13.229,<->,136.25.188.239,0,0,2,112,2,112,1.069068000,0.1485
235.253.220.216,<->,215.158.238.196,0,0,2,1288,2,1288,1.069067000,0.1976
215.158.239.56,<->,143.20.163.42,2,100,0,0,2,100,1.068203000,0.1526
138.127.224.225,<->,101.224.89.180,0,0,2,471,2,471,1.067675000,0.0078
248.225.31.77,<->,53.240.233.79,2,533,0,0,2,533,1.067005000,0.0458
215.158.239.79,<->,143.13.81.196,2,100,0,0,2,100,1.066763000,0.2148
159.69.187.48,<->,144.108.64.184,2,123,0,0,2,123,1.066507000,0.0939
215.158.140.27,<->,57.61.162.208,2,120,0,0,2,120,1.066186000,0.1051
136.25.189.29,<->,57.31.50.218,2,1269,0,0,2,1269,1.065792000,0.0941
215.158.239.57,<->,143.13.81.196,2,100,0,0,2,100,1.065268000,0.2040
148.21.212.148,<->,136.25.189.32,0,0,2,1333,2,1333,1.064863000,0.2048
209.60.50.164,<->,192.67.154.172,0,0,2,188,2,188,1.064733000,0.0000
195.4.97.202,<->,136.25.188.45,0,0,2,106,2,106,1.064543000,0.1936
6.145.172.220,<->,0.195.210.44,0,0,2,143,2,143,1.064377000,0.7995
215.158.239.99,<->,143.13.81.196,2,100,0,0,2,100,1.064310000,0.2173
210.220.219.151,<->,8.235.221.41,2,186,0,0,2,186,1.064181000,0.2209
205.197.26.41,<->,8.52.135.109,0,0,2,100,2,100,1.063502000,0.1284
246.253.169.113,<->,100.243.235.178,2,106,0,0,2,106,1.063467000,0.0814
138.127.224.225,<->,33.233.141.1,0,0,2,493,2,493,1.063365000,0.0029
220.82.56.122,<->,132.128.61.93,2,352,0,0,2,352,1.063329000,0.0027
129.236.111.66,<->,129.224.112.252,0,0,2,150,2,150,1.063141000,0.0004
248.239.129.134,<->,231.255.222.140,2,263,0,0,2,263,1.062760000,0.0567
204.184.76.26,<->,136.25.188.220,0,0,2,128,2,128,1.062290000,0.1600
138.127.224.225,<->,101.224.89.208,0,0,2,474,2,474,1.062247000,0.0040
247.118.158.36,<->,8.182.253.52,0,0,2,112,2,112,1.061068000,0.4161
144.75.218.241,<->,139.252.1.230,2,180,0,0,2,180,1.060885000,0.2513
142.249.41.15,<->,136.25.188.174,0,0,2,106,2,106,1.060317000,0.2067
136.181.51.96,<->,54.50.73.135,2,120,0,0,2,120,1.058650000,0.0635
195.55.62.187,<->,136.25.188.243,0,0,2,112,2,112,1.057729000,0.2724
215.158.239.84,<->,142.195.246.147,2,238,0,0,2,238,1.057640000,0.1011
197.5.160.221,<->,136.25.188.224,0,0,2,1237,2,1237,1.057618000,0.0926
50.224.76.235,<->,38.176.207.45,2,128,0,0,2,128,1.057295000,0.2804
54.37.67.188,<->,48.54.84.190,0,0,2,166,2,166,1.056983000,0.0005
195.70.207.64,<->,136.25.188.238,0,0,2,136,2,136,1.056429000,0.7010
50.224.61.172,<->,8.224.43.74,2,100,0,0,2,100,1.056183000,0.0000
204.184.40.37,<->,136.25.188.174,0,0,2,106,2,106,1.056149000,0.0908
136.25.189.95,<->,96.156.169.209,2,380,0,0,2,380,1.055719000,0.2612
199.73.141.49,<->,136.25.188.225,0,0,2,106,2,106,1.055575000,0.2311
215.158.33.177,<->,101.126.182.254,0,0,2,112,2,112,1.054205000,0.0140
215.158.239.70,<->,195.80.188.30,2,152,0,0,2,152,1.054101000,0.0502
210.229.230.22,<->,109.88.195.33,2,118,0,0,2,118,1.053460000,0.2300
210.229.230.22,<->,91.209.206.184,2,118,0,0,2,118,1.052985000,0.2740
76.179.87.27,<->,8.252.222.95,0,0,2,118,2,118,1.052486000,0.1437
215.158.61.202,<->,8.176.8.225,0,0,2,1557,2,1557,1.052078000,0.0297
133.178.226.90,<->,106.188.236.158,2,1075,0,0,2,1075,1.051162000,0.2477
144.75.218.241,<->,130.61.211.1,2,211,0,0,2,211,1.050782000,0.1198
195.55.16.198,<->,136.25.188.177,0,0,2,120,2,120,1.050647000,0.4036
129.236.111.79,<->,129.224.112.252,0,0,2,153,2,153,1.050040000,0.0055
139.193.141.209,<->,0.34.0.84,2,592,0,0,2,592,1.049782000,0.0928
215.158.239.77,<->,199.20.31.88,2,852,0,0,2,852,1.049361000,0.0096
137.21.23.51,<->,8.37.203.183,2,120,0,0,2,120,1.049222000,0.0319
133.178.226.7,<->,131.173.115.10,2,1045,0,0,2,1045,1.048791000,0.1978
129.236.111.82,<->,129.224.112.252,0,0,2,155,2,155,1.048193000,0.0048
136.25.189.15,<->,29.123.209.236,2,1381,0,0,2,1381,1.048020000,0.2101
142.255.19.224,<->,136.25.188.163,0,0,2,100,2,100,1.047229000,0.3518
159.23.225.213,<->,33.4.134.245,2,126,0,0,2,126,1.046222000,0.5099
215.158.239.35,<->,149.96.50.218,2,1558,0,0,2,1558,1.045502000,0.4529
215.158.239.92,<->,143.134.247.196,2,100,0,0,2,100,1.045185000,0.2077
197.144.29.95,<->,8.20.87.182,0,0,2,112,2,112,1.044908000,0.1140
145.76.230.104,<->,33.233.141.231,0,0,2,112,2,112,1.044075000,0.0002
207.239.222.32,<->,136.25.188.176,0,0,2,100,2,100,1.043723000,0.0121
215.158.239.78,<->,143.134.247.196,2,100,0,0,2,100,1.043697000,0.2106
207.58.114.73,<->,136.25.188.220,0,0,2,100,2,100,1.043226000,0.1883
220.20.200.17,<->,92.27.255.126,2,100,0,0,2,100,1.042588000,0.0966
215.158.239.30,<->,69.31.238.203,2,1460,0,0,2,1460,1.041758000,0.2325
210.209.251.214,<->,99.167.139.101,0,0,2,100,2,100,1.041331000,0.6649
89.183.104.150,<->,33.57.78.90,2,100,0,0,2,100,1.040968000,0.1465
192.64.223.86,<->,57.46.23.242,2,628,0,0,2,628,1.040863000,0.0106
246.254.97.229,<->,132.18.67.30,2,1253,0,0,2,1253,1.040796000,0.0026
138.127.224.225,<->,101.224.89.171,0,0,2,478,2,478,1.040594000,0.0010
215.158.239.49,<->,207.236.58.178,2,100,0,0,2,100,1.040551000,0.4159
137.129.19.35,<->,54.39.184.254,2,106,0,0,2,106,1.040377000,0.0775
97.151.151.182,<->,8.52.133.228,0,0,2,100,2,100,1.040296000,0.0612
142.191.153.101,<->,136.25.188.54,0,0,2,100,2,100,1.040004000,0.0013
215.158.239.87,<->,194.248.144.74,2,100,0,0,2,100,1.039712000,0.0007
215.158.239.77,<->,195.41.170.179,2,120,0,0,2,120,1.039698000,0.2090
93.181.154.49,<->,92.27.219.217,0,0,2,100,2,100,1.039300000,0.1303
100.122.34.43,<->,8.182.224.248,0,0,2,100,2,100,1.038881000,0.0010
215.158.239.95,<->,207.191.39.64,2,120,0,0,2,120,1.038834000,0.3598
220.20.200.142,<->,127.255.84.41,2,100,0,0,2,100,1.038378000,0.1075
69.128.122.123,<->,54.59.99.218,2,1242,0,0,2,1242,1.038281000,0.0210
194.104.154.46,<->,136.25.188.198,0,0,2,100,2,100,1.038135000,0.9000
204.185.254.14,<->,136.25.188.225,0,0,2,120,2,120,1.038097000,0.0196
133.178.226.232,<->,126.219.61.38,2,112,0,0,2,112,1.037852000,0.0000
215.158.239.86,<->,199.71.148.177,2,106,0,0,2,106,1.037564000,0.2235
206.149.2.93,<->,8.220.176.253,0,0,2,100,2,100,1.036650000,0.1526
111.20.172.70,<->,33.233.141.100,0,0,2,238,2,238,1.036646000,0.0446
233.225.69.163,<->,50.224.76.230,0,0,2,106,2,106,1.036350000,0.0956
215.158.140.27,<->,126.219.196.240,2,120,0,0,2,120,1.035549000,0.1150
215.158.140.206,<->,8.222.7.182,2,1100,0,0,2,1100,1.035173000,0.0267
221.94.36.174,<->,50.224.76.234,0,0,2,100,2,100,1.034993000,0.0776
231.143.93.88,<->,136.25.188.163,0,0,2,956,2,956,1.034211000,0.0395
195.54.50.104,<->,136.25.188.242,0,0,2,173,2,173,1.033706000,0.1245
111.146.225.58,<->,8.222.6.62,2,100,0,0,2,100,1.033672000,0.0018
207.88.64.75,<->,136.25.188.198,0,0,2,1030,2,1030,1.033556000,0.1541
138.127.224.225,<->,33.233.141.114,0,0,2,472,2,472,1.032942000,0.0003
199.120.22.127,<->,136.25.188.223,0,0,2,112,2,112,1.032762000,0.1814
120.207.134.63,<->,92.27.194.233,0,0,2,100,2,100,1.032506000,0.2425
215.158.140.27,<->,122.158.179.48,2,120,0,0,2,120,1.032009000,0.1117
203.144.209.172,<->,8.20.87.144,0,0,2,100,2,100,1.031452000,0.1130
17.113.2.125,<->,8.220.234.165,0,0,2,106,2,106,1.031446000,0.0280
148.155.129.25,<->,101.224.89.175,0,0,2,345,2,345,1.031042000,0.0054
192.67.146.69,<->,22.43.163.87,2,100,0,0,2,100,1.030947000,0.0458
199.15.47.5,<->,136.25.188.162,0,0,2,100,2,100,1.030471000,0.1791
143.20.49.158,<->,136.25.188.220,0,0,2,100,2,100,1.030455000,0.2232
26.200.175.254,<->,8.52.189.207,0,0,2,100,2,100,1.030313000,0.0000
215.158.61.193,<->,8.176.8.232,0,0,2,1441,2,1441,1.030038000,0.9367
215.158.239.95,<->,148.26.113.10,2,1285,0,0,2,1285,1.029626000,0.1597
215.158.238.58,<->,149.33.107.9,2,1413,0,0,2,1413,1.028863000,0.1632
210.229.230.18,<->,6.167.84.3,2,118,0,0,2,118,1.027782000,0.2321
247.136.162.79,<->,26.218.95.13,2,147,0,0,2,147,1.027738000,0.0000
17.255.107.2,<->,8.220.198.188,0,0,2,112,2,112,1.027699000,0.0283
204.21.175.59,<->,136.25.188.178,0,0,2,310,2,310,1.027491000,0.0186
140.174.84.21,<->,133.178.227.57,0,0,2,1137,2,1137,1.027467000,0.2149
196.246.207.147,<->,136.25.188.177,0,0,2,136,2,136,1.027217000,0.0200
215.158.140.27,<->,29.211.238.15,2,120,0,0,2,120,1.026880000,0.1465
145.200.61.224,<->,92.162.253.62,0,0,2,443,2,443,1.026299000,0.0273
142.191.29.150,<->,136.25.188.177,0,0,2,100,2,100,1.025630000,0.2086
131.137.149.87,<->,92.27.194.117,0,0,2,100,2,100,1.025564000,0.0007
199.73.53.130,<->,136.25.188.209,0,0,2,100,2,100,1.025483000,0.3070
192.229.216.117,<->,97.151.151.182,2,100,0,0,2,100,1.025423000,0.0481
215.158.140.8,<->,96.156.169.127,2,613,0,0,2,613,1.024644000,0.0418
221.102.104.0,<->,207.200.195.90,2,106,0,0,2,106,1.024228000,0.1744
53.224.89.221,<->,8.228.219.242,0,0,2,163,2,163,1.023954000,0.0000
196.103.220.143,<->,80.40.41.209,0,0,2,268,2,268,1.023414000,0.3014
149.254.114.194,<->,136.25.189.33,0,0,2,1445,2,1445,1.023131000,0.2834
220.80.187.186,<->,8.45.175.127,2,125,0,0,2,125,1.023066000,0.0000
210.221.109.12,<->,54.58.106.235,2,100,0,0,2,100,1.022900000,0.1163
136.25.188.199,<->,113.23.104.213,2,1413,0,0,2,1413,1.022804000,0.2382
195.3.103.217,<->,136.25.189.80,0,0,2,1285,2,1285,1.022605000,0.1516
115.233.236.124,<->,50.224.89.243,0,0,2,1017,2,1017,1.022133000,0.1607
142.208.102.199,<->,136.25.188.254,0,0,2,120,2,120,1.022128000,0.2040
56.9.98.237,<->,8.182.253.209,0,0,2,100,2,100,1.021642000,0.0002
215.158.103.206,<->,129.229.242.60,2,1432,0,0,2,1432,1.020979000,0.3741
143.52.171.63,<->,136.25.188.225,0,0,2,106,2,106,1.020026000,0.1759
215.158.238.149,<->,114.25.48.32,2,1397,0,0,2,1397,1.019523000,0.1920
196.124.78.211,<->,8.52.229.39,0,0,2,100,2,100,1.019237000,0.9565
143.147.2.220,<->,92.27.219.139,0,0,2,2940,2,2940,1.019209000,0.3979
132.249.91.21,<->,80.41.49.163,0,0,2,100,2,100,1.018970000,0.0000
22.36.16.223,<->,8.182.224.248,0,0,2,100,2,100,1.018900000,0.0006
199.82.203.84,<->,136.25.188.241,0,0,2,112,2,112,1.017882000,0.2262
127.62.26.151,<->,92.162.253.36,0,0,2,100,2,100,1.017869000,0.1460
17.34.35.51,<->,8.220.200.124,0,0,2,100,2,100,1.017579000,0.0268
125.214.64.64,<->,50.224.76.248,0,0,2,118,2,118,1.017515000,0.1163
143.20.37.51,<->,136.25.188.162,0,0,2,106,2,106,1.017139000,0.1743
215.158.239.51,<->,199.20.31.227,2,112,0,0,2,112,1.016352000,0.2200
231.142.216.133,<->,136.25.188.237,0,0,2,112,2,112,1.016297000,0.1836
17.113.2.125,<->,8.220.176.253,0,0,2,100,2,100,1.013689000,0.0000
223.36.99.25,<->,133.178.227.24,0,0,2,1204,2,1204,1.013251000,0.2928
136.25.189.0,<->,123.166.46.213,2,1285,0,0,2,1285,1.012757000,0.1321
97.19.21.205,<->,8.182.252.86,0,0,2,112,2,112,1.011891000,0.0521
198.206.15.35,<->,8.220.176.253,0,0,2,112,2,112,1.011855000,0.1116
215.158.239.14,<->,139.161.104.53,2,149,0,0,2,149,1.010960000,0.0000
97.182.7.27,<->,8.52.148.196,0,0,2,100,2,100,1.010613000,0.0004
50.224.75.42,<->,42.71.197.172,2,112,0,0,2,112,1.010591000,0.6281
215.158.239.5,<->,69.31.238.52,2,1467,0,0,2,1467,1.009630000,0.2333
145.166.11.36,<->,8.182.250.65,0,0,2,100,2,100,1.008758000,0.0212
215.158.239.96,<->,195.42.60.97,2,100,0,0,2,100,1.008187000,0.2092
215.158.239.59,<->,113.92.151.53,2,1421,0,0,2,1421,1.008154000,0.1012
54.36.24.6,<->,48.53.48.166,0,0,2,120,2,120,1.007989000,0.3698
145.89.27.67,<->,8.53.119.89,2,100,0,0,2,100,1.006827000,0.0631
144.122.240.204,<->,144.108.64.184,2,159,0,0,2,159,1.006715000,0.0105
204.185.49.78,<->,136.25.188.243,0,0,2,112,2,112,1.006693000,0.2801
144.83.60.153,<->,92.162.253.60,0,0,2,461,2,461,1.006060000,0.1549
126.18.184.108,<->,50.224.76.234,0,0,2,106,2,106,1.005810000,0.1576
195.43.107.19,<->,136.25.188.226,0,0,2,100,2,100,1.005418000,0.1680
251.24.84.172,<->,8.252.222.46,0,0,2,112,2,112,1.005364000,0.0001
195.114.88.237,<->,92.27.27.164,0,0,2,104,2,104,1.004544000,0.9776
215.158.239.85,<->,8.249.253.226,2,1429,0,0,2,1429,1.003967000,0.2078
204.187.125.191,<->,136.25.188.174,0,0,2,774,2,774,1.003894000,0.7999
215.158.239.48,<->,199.82.218.14,2,106,0,0,2,106,1.003612000,0.1626
105.108.130.181,<->,50.224.76.234,0,0,2,106,2,106,1.003396000,0.1136
215.158.238.93,<->,192.224.21.67,2,1253,0,0,2,1253,1.003209000,0.8549
252.98.141.99,<->,8.47.122.178,2,178,0,0,2,178,1.003184000,0.0060
133.54.25.80,<->,130.13.251.210,2,112,0,0,2,112,1.001763000,0.1359
204.60.13.107,<->,136.25.188.44,0,0,2,124,2,124,1.001636000,0.3401
210.228.29.0,<->,139.241.119.19,0,0,2,260,2,260,1.001390000,0.0014
39.176.44.203,<->,8.220.187.2,0,0,2,106,2,106,1.001195000,0.0510
144.86.145.164,<->,83.96.62.35,2,100,0,0,2,100,1.000951000,0.0611
199.82.249.125,<->,136.25.188.253,0,0,2,100,2,100,1.000649000,0.1394
215.158.239.50,<->,195.55.11.252,2,136,0,0,2,136,1.000165000,0.1651
199.14.254.16,<->,136.25.188.252,0,0,2,100,2,100,1.000135000,0.1557
109.1.14.71,<->,105.90.194.26,2,109,0,0,2,109,1.000076000,0.2154
199.14.254.16,<->,136.25.188.52,0,0,2,100,2,100,0.999936000,0.1425
50.224.80.64,<->,46.44.217.168,2,803,0,0,2,803,0.999751000,0.2727
80.38.13.221,<->,33.241.84.13,2,106,0,0,2,106,0.997671000,0.1622
221.102.103.73,<->,194.253.94.195,2,525,0,0,2,525,0.997548000,0.6417
111.146.250.198,<->,109.26.79.44,2,100,0,0,2,100,0.997472000,0.4005
91.46.155.190,<->,8.220.181.167,0,0,2,100,2,100,0.996716000,0.0013
133.178.227.30,<->,131.1.235.233,2,170,0,0,2,170,0.996455000,0.0004
133.178.226.30,<->,89.86.110.11,2,1269,0,0,2,1269,0.996091000,0.1071
76.101.167.186,<->,8.252.222.141,0,0,2,137,2,137,0.995922000,0.0000
142.227.161.52,<->,136.25.188.220,0,0,2,100,2,100,0.995493000,0.1688
201.222.32.9,<->,80.41.21.72,0,0,2,123,2,123,0.995273000,0.7217
215.158.238.107,<->,32.183.36.53,2,1253,0,0,2,1253,0.995059000,0.3188
215.158.61.189,<->,136.25.189.196,0,0,2,1205,2,1205,0.995014000,0.1006
144.54.85.229,<->,136.25.188.226,0,0,2,112,2,112,0.993529000,0.1125
247.136.164.69,<->,8.209.235.29,2,100,0,0,2,100,0.993334000,0.0362
111.20.172.70,<->,33.233.141.229,0,0,2,580,2,580,0.993274000,0.0017
249.101.237.43,<->,54.51.14.53,2,120,0,0,2,120,0.993237000,0.1143
220.20.200.92,<->,144.83.60.153,2,374,0,0,2,374,0.993052000,0.0124
215.158.239.92,<->,199.20.29.193,2,120,0,0,2,120,0.993052000,0.4985
123.156.103.111,<->,20.238.136.74,0,0,2,128,2,128,0.993009000,0.9996
215.158.238.105,<->,135.253.11.53,2,1285,0,0,2,1285,0.991978000,0.1526
195.54.85.50,<->,136.25.188.177,0,0,2,100,2,100,0.991827000,0.0032
80.41.56.143,<->,8.209.235.29,2,100,0,0,2,100,0.991570000,0.0326
136.25.189.41,<->,96.156.169.238,2,2245,0,0,2,2245,0.991145000,0.0000
194.211.231.146,<->,91.231.195.125,0,0,2,264,2,264,0.991069000,0.4998
210.229.230.21,<->,87.61.245.99,2,118,0,0,2,118,0.990441000,0.2346
8.182.253.209,<->,6.133.234.122,2,112,0,0,2,112,0.990375000,0.4201
103.230.44.251,<->,89.183.104.148,0,0,2,112,2,112,0.990165000,0.6457
204.186.8.139,<->,136.25.188.198,0,0,2,120,2,120,0.989865000,0.3899
204.187.91.47,<->,136.25.188.198,0,0,2,112,2,112,0.989342000,0.0000
133.178.227.41,<->,29.211.165.85,2,1243,0,0,2,1243,0.988505000,0.1011
204.63.210.161,<->,136.25.188.225,0,0,2,120,2,120,0.988292000,0.8901
111.20.172.70,<->,33.233.141.60,0,0,2,265,2,265,0.988121000,1.0049
131.144.248.187,<->,129.224.112.252,0,0,2,164,2,164,0.988067000,0.0433
17.33.88.103,<->,8.52.139.80,0,0,2,112,2,112,0.987202000,0.3825
215.158.238.123,<->,146.10.166.70,2,1237,0,0,2,1237,0.987144000,0.1928
136.128.124.227,<->,8.183.24.179,0,0,2,112,2,112,0.986905000,0.0466
92.27.219.207,<->,27.41.206.143,2,112,0,0,2,112,0.985900000,0.6783
142.190.238.197,<->,136.25.188.237,0,0,2,106,2,106,0.985800000,0.2254
215.158.239.87,<->,143.99.78.98,2,120,0,0,2,120,0.985764000,0.2917
139.241.115.2,<->,29.211.214.254,0,0,2,194,2,194,0.985761000,0.0007
203.114.125.31,<->,136.25.188.236,0,0,2,100,2,100,0.985283000,0.1078
215.158.239.32,<->,8.241.236.246,2,1259,0,0,2,1259,0.985082000,0.3175
204.184.182.110,<->,136.25.188.177,0,0,2,120,2,120,0.983863000,0.0177
215.158.239.48,<->,199.20.30.117,2,128,0,0,2,128,0.983840000,0.2995
199.53.251.18,<->,136.25.188.238,0,0,2,118,2,118,0.983683000,0.3409
92.27.219.141,<->,84.211.77.13,2,100,0,0,2,100,0.983363000,0.0002
210.229.230.19,<->,114.199.71.219,2,118,0,0,2,118,0.982671000,0.3088
138.127.224.104,<->,101.224.89.214,0,0,2,568,2,568,0.982576000,1.0113
131.153.183.226,<->,56.121.47.18,0,0,2,216,2,216,0.982503000,0.1522
109.222.230.147,<->,14.71.93.20,2,149,0,0,2,149,0.982247000,0.0000
144.83.60.153,<->,92.162.253.36,0,0,2,677,2,677,0.982111000,0.0746
148.217.121.180,<->,136.25.189.29,0,0,2,1301,2,1301,0.982048000,0.1635
213.186.61.91,<->,80.38.5.0,0,0,2,100,2,100,0.980649000,0.0207
148.217.121.182,<->,136.25.189.13,0,0,2,1269,2,1269,0.980623000,0.2094
215.158.239.87,<->,196.91.211.45,2,352,0,0,2,352,0.980386000,0.2364
137.129.19.45,<->,53.244.102.135,2,106,0,0,2,106,0.979884000,0.0975
215.158.239.71,<->,56.161.218.42,2,1301,0,0,2,1301,0.979729000,0.0305
204.187.136.157,<->,136.25.188.173,0,0,2,296,2,296,0.978882000,0.0202
101.67.174.17,<->,8.52.186.156,0,0,2,100,2,100,0.977502000,0.0297
103.157.92.113,<->,8.52.188.75,0,0,2,517,2,517,0.977129000,0.0439
48.131.159.10,<->,8.252.223.175,0,0,2,1237,2,1237,0.977088000,0.4237
192.67.162.92,<->,38.71.255.21,2,104,0,0,2,104,0.976520000,0.9555
210.229.230.19,<->,110.76.8.220,2,118,0,0,2,118,0.976433000,0.1018
215.158.238.134,<->,29.212.43.236,2,1269,0,0,2,1269,0.976084000,0.1340
215.158.239.86,<->,57.236.82.215,2,1445,0,0,2,1445,0.974090000,0.1608
192.65.173.125,<->,8.55.220.143,2,179,0,0,2,179,0.973880000,0.0000
215.158.239.48,<->,199.20.31.62,2,112,0,0,2,112,0.973826000,0.0000
215.158.238.0,<->,89.85.90.132,2,2163,0,0,2,2163,0.973738000,0.0000
210.229.230.22,<->,96.253.8.137,2,118,0,0,2,118,0.972619000,0.1010
139.163.16.203,<->,17.61.229.116,2,100,0,0,2,100,0.972285000,0.0020
142.254.255.65,<->,136.25.188.198,0,0,2,100,2,100,0.972061000,0.1109
132.249.70.100,<->,91.42.195.218,2,308,0,0,2,308,0.971794000,0.0255
111.199.225.136,<->,0.195.210.44,0,0,2,143,2,143,0.971171000,0.4199
215.158.238.155,<->,8.203.131.211,2,120,0,0,2,120,0.971071000,0.0251
92.27.4.173,<->,89.183.104.149,0,0,2,106,2,106,0.970928000,0.1534
57.1.20.68,<->,0.195.210.42,0,0,2,135,2,135,0.970700000,0.3258
215.158.238.123,<->,199.98.153.75,2,112,0,0,2,112,0.969579000,0.0000
136.25.189.12,<->,113.92.151.117,2,1269,0,0,2,1269,0.969547000,0.1020
215.158.239.31,<->,215.158.127.181,2,1800,0,0,2,1800,0.969522000,0.0000
195.13.248.147,<->,136.25.188.175,0,0,2,106,2,106,0.969508000,0.1803
144.75.218.246,<->,97.68.93.9,2,1414,0,0,2,1414,0.969085000,0.0586
158.5.93.145,<->,50.224.76.234,0,0,2,100,2,100,0.969052000,0.0009
229.102.219.67,<->,111.147.242.225,0,0,2,104,2,104,0.967297000,0.3058
203.117.50.219,<->,0.195.210.44,0,0,2,181,2,181,0.966975000,0.5200
231.142.180.158,<->,215.158.239.84,0,0,2,106,2,106,0.966840000,0.1680
204.61.129.216,<->,136.25.188.162,0,0,2,100,2,100,0.966582000,0.1949
241.120.29.241,<->,215.158.239.57,0,0,2,1237,2,1237,0.966555000,0.0597
136.25.188.46,<->,41.129.26.187,2,100,0,0,2,100,0.966105000,0.0000
132.213.244.180,<->,8.53.7.199,0,0,2,106,2,106,0.965590000,0.0875
195.14.186.121,<->,136.25.188.177,0,0,2,100,2,100,0.964869000,0.1813
255.133.225.247,<->,255.133.225.23,0,0,2,168,2,168,0.964179000,0.6399
247.136.217.5,<->,134.12.84.188,2,100,0,0,2,100,0.963617000,0.8173
220.20.200.122,<->,144.83.60.153,2,678,0,0,2,678,0.961892000,0.5760
144.75.218.246,<->,97.94.181.63,2,344,0,0,2,344,0.961143000,0.3591
215.158.239.85,<->,199.20.7.75,2,128,0,0,2,128,0.960864000,1.0097
195.4.117.168,<->,136.25.188.175,0,0,2,100,2,100,0.960627000,0.2123
215.158.140.92,<->,29.214.71.56,2,1167,0,0,2,1167,0.959389000,0.2789
48.132.118.109,<->,8.252.222.179,0,0,2,285,2,285,0.959100000,1.0300
215.158.61.227,<->,8.252.222.8,0,0,2,546,2,546,0.958859000,0.7540
248.239.64.14,<->,8.55.216.92,2,197,0,0,2,197,0.958007000,0.0000
251.122.146.43,<->,8.52.222.23,0,0,2,572,2,572,0.957366000,0.0276
142.203.238.99,<->,102.51.115.242,0,0,2,396,2,396,0.956392000,0.9738
215.158.239.84,<->,196.104.53.46,2,100,0,0,2,100,0.955642000,0.2621
89.216.124.92,<->,54.50.145.179,2,125,0,0,2,125,0.955626000,0.0000
115.149.99.162,<->,111.147.150.12,0,0,2,117,2,117,0.955618000,0.6158
195.7.101.75,<->,136.25.188.209,0,0,2,106,2,106,0.955338000,0.2129
133.178.227.14,<->,133.56.180.82,2,1306,0,0,2,1306,0.954798000,0.0371
92.27.27.144,<->,0.97.212.105,2,112,0,0,2,112,0.954758000,0.9451
141.182.241.55,<->,8.252.221.198,0,0,2,112,2,112,0.954734000,0.1805
215.158.61.202,<->,8.176.8.250,0,0,2,1461,2,1461,0.954626000,0.2869
17.0.65.173,<->,8.20.87.94,0,0,2,1006,2,1006,0.953873000,0.2281
220.55.229.56,<->,100.94.52.121,0,0,2,515,2,515,0.953807000,0.0057
112.158.254.7,<->,92.27.27.99,0,0,2,297,2,297,0.953582000,0.0000
195.70.50.11,<->,136.25.188.162,0,0,2,112,2,112,0.952559000,0.9963
91.231.222.203,<->,0.195.210.44,0,0,2,143,2,143,0.951732000,0.0982
207.162.131.21,<->,8.182.241.177,0,0,2,112,2,112,0.951127000,0.1614
136.25.189.15,<->,96.135.155.7,2,1445,0,0,2,1445,0.951083000,0.0941
192.204.151.251,<->,136.25.188.221,0,0,2,128,2,128,0.950980000,1.0000
133.32.1.24,<->,124.119.42.215,2,106,0,0,2,106,0.950873000,0.1245
215.158.239.49,<->,199.20.31.105,2,128,0,0,2,128,0.950771000,0.5076
204.184.28.15,<->,136.25.188.241,0,0,2,124,2,124,0.950165000,0.8209
99.183.200.170,<->,8.43.219.233,0,0,2,100,2,100,0.949664000,0.0197
146.249.218.211,<->,8.252.222.162,0,0,2,320,2,320,0.949632000,0.0172
111.151.107.247,<->,8.252.223.38,0,0,2,450,2,450,0.949625000,0.0031
220.20.200.143,<->,133.199.160.225,2,100,0,0,2,100,0.948803000,0.0206
148.129.30.28,<->,136.25.189.82,0,0,2,1429,2,1429,0.947947000,0.1985
195.41.208.112,<->,136.25.188.226,0,0,2,106,2,106,0.947788000,0.5300
254.126.121.48,<->,109.0.230.164,0,0,2,141,2,141,0.946979000,0.0060
215.158.239.68,<->,199.20.29.191,2,136,0,0,2,136,0.946696000,0.8399
215.158.239.58,<->,196.90.135.98,2,168,0,0,2,168,0.946564000,0.3796
142.190.24.105,<->,136.25.188.241,0,0,2,106,2,106,0.944867000,0.2092
129.224.112.252,<->,113.189.202.235,2,138,0,0,2,138,0.944679000,1.0125
27.9.50.162,<->,0.195.210.42,0,0,2,100,2,100,0.944467000,0.2506
117.15.100.145,<->,50.224.80.67,0,0,2,505,2,505,0.944453000,0.1196
125.216.43.59,<->,8.252.222.204,0,0,2,1237,2,1237,0.944339000,0.1115
143.68.183.178,<->,136.25.188.163,0,0,2,112,2,112,0.944022000,0.0025
192.67.173.170,<->,8.49.69.216,2,164,0,0,2,164,0.942612000,0.0765
194.154.22.157,<->,50.224.80.64,0,0,2,628,2,628,0.942338000,0.2061
143.68.135.57,<->,136.25.188.255,0,0,2,100,2,100,0.942281000,0.0012
205.124.103.209,<->,50.224.76.235,0,0,2,120,2,120,0.941979000,0.2856
215.158.239.78,<->,207.166.183.164,2,120,0,0,2,120,0.941821000,0.4207
111.150.206.53,<->,101.224.204.164,0,0,2,1052,2,1052,0.941042000,0.1458
207.172.141.218,<->,136.25.188.176,0,0,2,136,2,136,0.940470000,0.9400
207.190.228.76,<->,136.25.188.174,0,0,2,100,2,100,0.940206000,0.1678
215.158.239.34,<->,96.135.154.130,2,112,0,0,2,112,0.939626000,0.0218
97.233.127.125,<->,8.252.221.170,0,0,2,100,2,100,0.939465000,0.0298
215.158.238.66,<->,126.219.190.171,2,1333,0,0,2,1333,0.939215000,0.1330
137.160.171.29,<->,8.182.226.78,0,0,2,431,2,431,0.939152000,0.0760
215.158.238.248,<->,120.190.31.242,2,1283,0,0,2,1283,0.938508000,0.2115
215.158.239.71,<->,29.123.209.239,2,1253,0,0,2,1253,0.938017000,0.1714
207.175.1.41,<->,136.25.188.243,0,0,2,100,2,100,0.937655000,0.7708
220.20.200.143,<->,144.83.60.138,2,100,0,0,2,100,0.937339000,0.0264
102.59.37.17,<->,8.53.3.213,0,0,2,100,2,100,0.937280000,0.0605
215.158.61.189,<->,8.176.8.254,0,0,2,714,2,714,0.936440000,0.0005
145.116.223.93,<->,133.178.226.186,0,0,2,1146,2,1146,0.935760000,0.9273
136.25.188.198,<->,8.227.55.58,2,112,0,0,2,112,0.934780000,0.0185
246.253.253.99,<->,100.123.122.202,2,112,0,0,2,112,0.934699000,0.0000
215.158.238.140,<->,30.249.194.149,2,1109,0,0,2,1109,0.934536000,0.3925
247.118.178.25,<->,8.183.25.124,0,0,2,106,2,106,0.934064000,1.0077
207.63.113.95,<->,136.25.188.220,0,0,2,106,2,106,0.933691000,0.2119
215.158.238.9,<->,198.204.77.167,2,1365,0,0,2,1365,0.933001000,0.1572
136.25.188.106,<->,131.13.136.222,2,344,0,0,2,344,0.931110000,0.4051
58.164.104.206,<->,20.194.30.147,0,0,2,266,2,266,0.930723000,0.0315
111.150.74.42,<->,8.176.8.71,0,0,2,501,2,501,0.930563000,0.0168
197.7.105.83,<->,8.182.234.173,0,0,2,106,2,106,0.928806000,0.2569
145.213.37.27,<->,136.129.94.107,0,0,2,168,2,168,0.928633000,0.6271
207.173.141.131,<->,136.25.188.177,0,0,2,136,2,136,0.928614000,0.2200
199.73.133.114,<->,136.25.188.252,0,0,2,100,2,100,0.928284000,0.1920
215.158.239.56,<->,199.20.31.138,2,108,0,0,2,108,0.928258000,0.3400
107.111.108.197,<->,8.220.205.146,0,0,2,2714,2,2714,0.928098000,0.1745
246.253.168.231,<->,119.119.168.190,2,100,0,0,2,100,0.927804000,0.0030
215.158.239.49,<->,97.243.113.59,2,1285,0,0,2,1285,0.925183000,0.0964
101.70.96.205,<->,54.48.32.155,2,886,0,0,2,886,0.925098000,0.0005
255.15.224.164,<->,215.158.140.27,0,0,2,120,2,120,0.924850000,0.0245
215.158.238.196,<->,106.188.245.22,2,1233,0,0,2,1233,0.924843000,0.5184
136.25.188.253,<->,41.143.205.110,2,100,0,0,2,100,0.924828000,0.0004
54.39.91.119,<->,48.53.63.228,0,0,2,100,2,100,0.924362000,0.9791
215.158.239.69,<->,142.240.149.67,2,100,0,0,2,100,0.924161000,0.2395
210.220.219.153,<->,50.236.87.156,2,100,0,0,2,100,0.924012000,0.0001
255.133.225.170,<->,255.133.225.23,0,0,2,168,2,168,0.923925000,0.6410
120.154.99.74,<->,8.252.222.204,0,0,2,1205,2,1205,0.923745000,0.1035
199.15.32.198,<->,136.25.188.226,0,0,2,100,2,100,0.923399000,0.2795
194.227.247.51,<->,8.182.250.65,0,0,2,120,2,120,0.922424000,0.2231
215.158.239.77,<->,199.122.244.212,2,106,0,0,2,106,0.920806000,0.1735
215.158.61.145,<->,8.176.8.210,0,0,2,1444,2,1444,0.920110000,0.8903
215.158.239.68,<->,142.227.64.172,2,259,0,0,2,259,0.919825000,0.3335
80.246.53.102,<->,80.40.50.197,0,0,2,132,2,132,0.919420000,0.4062
136.18.144.220,<->,8.182.226.78,0,0,2,633,2,633,0.919266000,0.3098
215.158.238.51,<->,129.222.36.33,2,112,0,0,2,112,0.918995000,0.0212
136.25.189.94,<->,89.90.95.212,2,120,0,0,2,120,0.918792000,0.0170
136.25.188.237,<->,8.50.236.136,2,1365,0,0,2,1365,0.918352000,0.1397
199.39.88.70,<->,50.224.76.234,0,0,2,120,2,120,0.918106000,0.6280
195.5.199.239,<->,136.25.188.252,0,0,2,100,2,100,0.917896000,0.1998
133.178.227.2,<->,133.56.180.91,2,1315,0,0,2,1315,0.917652000,0.0388
158.166.175.187,<->,136.25.189.1,0,0,2,1253,2,1253,0.917408000,0.1892
207.2.112.219,<->,8.20.87.153,0,0,2,1015,2,1015,0.917130000,0.1792
143.44.10.143,<->,136.25.188.52,0,0,2,100,2,100,0.917090000,0.4158
159.69.187.25,<->,144.108.80.170,2,142,0,0,2,142,0.917062000,0.4798
80.40.43.190,<->,8.45.175.127,2,483,0,0,2,483,0.916349000,0.0014
215.158.239.18,<->,158.166.175.235,2,1556,0,0,2,1556,0.915939000,0.1206
195.68.36.17,<->,136.25.188.174,0,0,2,112,2,112,0.915813000,0.4005
89.183.104.230,<->,6.74.114.97,2,104,0,0,2,104,0.915228000,0.0000
100.216.218.106,<->,8.52.222.23,0,0,2,100,2,100,0.914992000,0.0008
199.122.49.159,<->,136.25.188.239,0,0,2,120,2,120,0.914172000,0.7679
97.233.98.53,<->,8.182.227.214,0,0,2,106,2,106,0.913916000,0.0496
196.247.82.39,<->,136.25.188.175,0,0,2,112,2,112,0.913823000,0.9914
215.158.239.70,<->,199.20.31.148,2,136,0,0,2,136,0.912921000,0.0849
72.157.195.82,<->,0.195.210.42,0,0,2,100,2,100,0.912767000,0.0000
199.38.199.32,<->,136.25.188.178,0,0,2,106,2,106,0.911970000,0.2162
148.184.48.93,<->,91.231.195.147,0,0,2,698,2,698,0.911944000,0.2032
100.161.107.233,<->,100.93.168.223,0,0,2,147,2,147,0.911452000,0.0000
204.2.5.87,<->,136.25.188.176,0,0,2,100,2,100,0.911274000,0.2456
8.220.186.239,<->,6.101.98.97,2,100,0,0,2,100,0.911092000,0.0040
215.158.238.155,<->,8.203.131.210,2,120,0,0,2,120,0.910985000,0.0250
136.25.189.42,<->,100.216.78.145,2,1543,0,0,2,1543,0.910894000,0.0000
142.182.77.110,<->,136.25.188.178,0,0,2,100,2,100,0.910302000,0.0015
207.20.140.168,<->,129.224.112.252,0,0,2,148,2,148,0.910057000,0.8865
220.43.27.91,<->,145.19.9.106,0,0,2,127,2,127,0.909413000,0.0001
215.158.140.19,<->,215.158.61.145,2,1462,0,0,2,1462,0.909389000,0.7342
17.6.58.27,<->,8.220.189.63,0,0,2,100,2,100,0.909311000,0.0262
133.178.227.50,<->,8.252.210.251,2,1358,0,0,2,1358,0.909295000,0.0312
215.158.238.100,<->,8.240.148.59,2,165,0,0,2,165,0.908503000,0.0223
199.15.166.72,<->,136.25.188.160,0,0,2,643,2,643,0.908160000,0.2313
111.199.227.182,<->,0.195.210.44,0,0,2,192,2,192,0.908075000,0.1410
136.25.188.198,<->,8.222.7.55,2,1438,0,0,2,1438,0.907762000,0.0416
204.184.28.15,<->,136.25.188.178,0,0,2,124,2,124,0.907406000,0.8401
215.158.239.86,<->,204.123.232.197,2,1285,0,0,2,1285,0.907090000,0.1537
195.15.145.186,<->,136.25.188.222,0,0,2,112,2,112,0.906960000,0.0633
137.21.22.142,<->,58.43.188.11,2,100,0,0,2,100,0.906519000,0.1539
66.241.176.131,<->,0.195.210.42,0,0,2,100,2,100,0.905631000,0.0000
136.25.189.13,<->,56.28.207.192,2,1541,0,0,2,1541,0.905094000,0.0218
92.27.52.56,<->,35.56.99.192,0,0,2,164,2,164,0.904921000,0.6232
215.158.238.134,<->,113.23.117.107,2,1397,0,0,2,1397,0.904768000,0.1130
27.118.95.205,<->,8.52.245.115,0,0,2,137,2,137,0.904622000,0.3076
207.172.146.233,<->,136.25.188.163,0,0,2,106,2,106,0.903524000,0.0897
195.55.79.254,<->,136.25.188.241,0,0,2,100,2,100,0.902425000,0.1781
220.38.238.41,<->,133.178.227.40,0,0,2,1202,2,1202,0.902135000,0.1064
204.89.70.205,<->,102.51.188.71,0,0,2,136,2,136,0.902041000,1.0279
215.158.238.177,<->,8.220.54.227,2,1253,0,0,2,1253,0.901774000,0.0982
108.180.199.51,<->,8.52.154.152,0,0,2,106,2,106,0.901564000,0.0590
142.252.77.78,<->,136.25.188.176,0,0,2,112,2,112,0.901559000,0.0193
215.158.239.71,<->,57.31.51.245,2,1237,0,0,2,1237,0.901157000,0.1136
17.198.121.6,<->,8.220.186.114,0,0,2,112,2,112,0.900969000,0.0254
126.198.149.124,<->,102.51.52.218,0,0,2,391,2,391,0.900421000,0.1394
97.126.113.184,<->,89.205.211.109,2,501,0,0,2,501,0.900089000,0.0452
145.192.174.193,<->,8.52.222.23,0,0,2,100,2,100,0.899701000,0.0223
92.27.219.189,<->,33.57.78.94,2,100,0,0,2,100,0.898730000,0.1622
215.158.140.74,<->,26.218.209.9,2,695,0,0,2,695,0.897778000,0.3221
215.158.239.78,<->,207.56.104.121,2,102,0,0,2,102,0.897436000,0.4476
48.131.159.4,<->,8.252.223.130,0,0,2,1189,2,1189,0.897060000,0.4146
106.168.191.163,<->,100.93.173.132,0,0,2,165,2,165,0.896282000,0.3194
215.158.238.96,<->,140.53.140.215,2,112,0,0,2,112,0.896203000,0.0048
96.236.124.227,<->,8.52.222.23,0,0,2,106,2,106,0.895264000,0.0262
80.27.153.42,<->,66.195.157.130,2,2237,0,0,2,2237,0.893920000,0.0071
125.223.91.142,<->,20.33.115.210,0,0,2,128,2,128,0.893679000,0.8304
199.14.43.119,<->,136.25.188.55,0,0,2,100,2,100,0.893560000,0.2104
57.81.55.173,<->,20.192.127.218,0,0,2,176,2,176,0.893460000,0.9996
158.184.56.17,<->,50.224.76.230,0,0,2,106,2,106,0.892969000,0.5721
215.158.238.82,<->,113.23.104.223,2,1237,0,0,2,1237,0.892507000,0.1254
133.178.227.41,<->,29.214.69.233,2,1168,0,0,2,1168,0.891257000,0.3150
116.239.228.239,<->,50.224.76.248,0,0,2,120,2,120,0.890990000,0.2363
66.47.83.74,<->,8.252.221.236,0,0,2,502,2,502,0.890845000,1.0263
136.25.189.15,<->,27.22.184.84,2,1269,0,0,2,1269,0.890758000,0.1446
195.76.114.156,<->,50.223.3.228,0,0,2,136,2,136,0.889646000,1.1071
207.60.128.121,<->,136.25.188.55,0,0,2,100,2,100,0.889503000,0.2477
142.167.111.68,<->,136.25.188.253,0,0,2,106,2,106,0.889219000,0.2312
197.113.99.68,<->,136.25.188.176,0,0,2,112,2,112,0.889152000,0.7517
100.200.205.57,<->,8.182.239.159,0,0,2,112,2,112,0.888229000,0.0937
215.158.238.105,<->,115.157.30.33,2,1253,0,0,2,1253,0.887775000,0.1297
215.158.239.68,<->,195.40.143.22,2,849,0,0,2,849,0.887709000,0.0269
127.255.90.90,<->,92.162.253.30,0,0,2,100,2,100,0.887158000,0.1052
199.120.158.118,<->,136.25.188.45,0,0,2,106,2,106,0.887040000,0.2127
215.158.239.85,<->,199.20.30.227,2,100,0,0,2,100,0.886821000,0.0000
143.68.187.105,<->,136.25.188.220,0,0,2,106,2,106,0.886438000,0.9931
143.134.50.181,<->,136.25.188.252,0,0,2,100,2,100,0.886137000,0.2091
139.163.83.210,<->,126.251.166.187,2,124,0,0,2,124,0.884674000,0.1999
195.41.105.248,<->,136.25.188.163,0,0,2,100,2,100,0.884554000,0.2274
204.187.194.213,<->,136.25.188.198,0,0,2,192,2,192,0.884147000,0.0796
100.190.29.184,<->,8.220.198.246,0,0,2,100,2,100,0.884043000,0.0000
231.143.60.212,<->,136.25.188.177,0,0,2,168,2,168,0.883461000,0.2801
193.64.94.36,<->,80.42.160.38,0,0,2,100,2,100,0.883336000,0.2336
215.158.239.71,<->,33.209.219.124,2,1253,0,0,2,1253,0.883111000,0.1505
215.158.238.51,<->,129.222.36.49,2,112,0,0,2,112,0.883019000,0.0190
215.158.239.76,<->,143.13.147.47,2,100,0,0,2,100,0.882836000,0.0032
199.68.45.42,<->,136.25.188.222,0,0,2,100,2,100,0.881914000,0.1814
8.252.222.23,<->,4.120.137.247,2,128,0,0,2,128,0.881855000,1.0492
229.96.181.7,<->,8.181.151.154,2,112,0,0,2,112,0.881764000,0.0161
215.158.140.231,<->,197.133.247.180,2,1448,0,0,2,1448,0.881643000,0.1174
207.239.204.235,<->,136.25.188.46,0,0,2,389,2,389,0.881008000,0.0019
204.58.63.91,<->,136.25.188.198,0,0,2,949,2,949,0.879922000,0.0282
136.25.189.13,<->,29.211.5.69,2,1381,0,0,2,1381,0.878579000,0.1174
6.145.169.8,<->,0.195.210.44,0,0,2,143,2,143,0.878187000,0.1231
92.27.219.235,<->,66.11.253.17,2,104,0,0,2,104,0.876143000,0.3549
123.129.242.214,<->,89.183.110.72,0,0,2,120,2,120,0.875251000,0.1158
54.50.95.107,<->,8.228.219.34,0,0,2,460,2,460,0.875066000,0.0277
210.229.230.18,<->,122.245.128.236,2,118,0,0,2,118,0.875042000,0.2066
215.158.239.94,<->,143.20.210.71,2,100,0,0,2,100,0.874987000,0.0015
249.229.107.171,<->,8.52.142.49,0,0,2,1251,2,1251,0.873868000,0.3486
204.200.42.156,<->,136.25.188.209,0,0,2,522,2,522,0.872844000,0.3957
207.172.26.189,<->,136.25.188.46,0,0,2,124,2,124,0.872747000,0.0002
247.136.141.15,<->,75.95.120.8,2,104,0,0,2,104,0.872734000,0.0010
142.241.27.40,<->,136.25.188.178,0,0,2,100,2,100,0.872270000,0.3410
215.158.239.79,<->,207.191.178.156,2,512,0,0,2,512,0.871338000,0.1765
143.192.84.146,<->,8.228.215.123,0,0,2,113,2,113,0.870049000,1.1127
215.158.239.76,<->,199.20.29.238,2,100,0,0,2,100,0.869821000,0.0000
133.178.227.2,<->,8.53.217.99,2,1278,0,0,2,1278,0.869655000,0.1145
215.158.61.183,<->,8.176.8.182,0,0,2,1189,2,1189,0.869610000,1.0490
192.67.182.178,<->,66.244.211.44,2,100,0,0,2,100,0.868348000,0.7929
142.175.241.227,<->,50.223.3.228,0,0,2,100,2,100,0.868153000,0.4856
192.67.172.34,<->,100.124.212.246,2,125,0,0,2,125,0.868111000,0.0000
248.225.29.121,<->,53.224.230.131,2,244,0,0,2,244,0.866811000,0.0021
144.75.218.235,<->,129.188.130.3,2,160,0,0,2,160,0.866505000,0.5283
215.158.239.84,<->,199.20.31.137,2,128,0,0,2,128,0.866203000,0.0000
205.127.108.113,<->,101.224.89.208,0,0,2,1319,2,1319,0.865632000,0.0583
215.158.239.94,<->,207.191.250.159,2,100,0,0,2,100,0.865299000,0.2331
220.55.75.166,<->,33.57.74.181,2,150,0,0,2,150,0.864669000,0.0995
146.193.47.81,<->,8.252.221.197,0,0,2,112,2,112,0.864291000,0.1854
122.96.128.51,<->,80.40.11.172,0,0,2,100,2,100,0.863821000,0.0009
17.121.0.251,<->,8.220.234.165,0,0,2,100,2,100,0.863257000,0.0945
197.196.47.226,<->,92.27.219.19,0,0,2,104,2,104,0.863142000,0.5189
215.158.239.95,<->,196.105.18.89,2,100,0,0,2,100,0.862412000,0.1586
204.185.37.34,<->,136.25.188.208,0,0,2,120,2,120,0.861855000,1.1200
142.248.11.247,<->,136.25.188.55,0,0,2,100,2,100,0.861369000,0.0274
133.178.227.206,<->,8.240.125.165,2,296,0,0,2,296,0.860868000,0.7007
215.158.239.85,<->,195.54.89.72,2,328,0,0,2,328,0.860824000,0.6532
204.184.96.13,<->,136.25.188.178,0,0,2,143,2,143,0.859643000,0.0168
249.101.106.195,<->,220.28.65.25,2,165,0,0,2,165,0.859209000,0.1085
215.158.239.87,<->,142.247.248.234,2,106,0,0,2,106,0.857939000,0.7502
204.185.180.91,<->,136.25.188.211,0,0,2,136,2,136,0.857906000,0.4001
104.136.21.9,<->,99.73.231.161,0,0,2,108,2,108,0.857897000,0.3903
220.20.200.37,<->,144.83.60.153,2,125,0,0,2,125,0.857415000,0.0000
221.102.113.102,<->,100.239.24.44,2,124,0,0,2,124,0.856466000,0.0377
246.253.253.169,<->,54.58.230.81,2,1827,0,0,2,1827,0.856451000,0.1304
207.190.29.70,<->,136.25.188.225,0,0,2,100,2,100,0.856267000,0.1954
207.172.12.188,<->,136.25.188.197,0,0,2,124,2,124,0.855505000,0.0824
100.92.86.210,<->,27.158.211.34,2,100,0,0,2,100,0.855348000,0.6611
215.158.239.50,<->,196.104.200.133,2,213,0,0,2,213,0.854803000,0.1310
215.158.239.76,<->,199.20.6.120,2,434,0,0,2,434,0.854643000,0.8606
246.253.168.231,<->,29.249.228.84,2,1509,0,0,2,1509,0.853903000,0.0022
142.239.121.87,<->,133.178.226.49,0,0,2,1381,2,1381,0.853473000,0.1424
215.158.239.96,<->,142.248.94.208,2,100,0,0,2,100,0.853422000,0.2495
159.194.180.52,<->,139.193.141.206,0,0,2,112,2,112,0.852894000,0.1161
115.121.142.77,<->,80.41.29.36,0,0,2,100,2,100,0.852808000,1.0958
207.61.156.37,<->,136.25.188.222,0,0,2,100,2,100,0.852561000,0.0227
66.47.31.172,<->,8.252.222.205,0,0,2,112,2,112,0.852045000,0.1418
142.191.20.120,<->,136.25.188.227,0,0,2,112,2,112,0.851638000,0.0015
247.157.0.168,<->,77.21.42.142,2,104,0,0,2,104,0.850916000,0.0080
6.145.168.153,<->,0.195.210.44,0,0,2,143,2,143,0.850647000,0.1123
192.65.118.85,<->,8.45.162.111,2,143,0,0,2,143,0.848451000,0.0000
210.229.230.22,<->,100.107.158.124,2,118,0,0,2,118,0.848140000,0.2609
195.70.153.110,<->,136.25.188.225,0,0,2,112,2,112,0.848042000,0.4677
126.198.149.124,<->,100.95.250.35,0,0,2,395,2,395,0.846813000,0.1458
207.191.232.222,<->,136.25.188.241,0,0,2,120,2,120,0.846651000,0.4757
143.68.193.3,<->,136.25.188.220,0,0,2,135,2,135,0.846582000,1.1077
215.158.239.49,<->,199.20.31.184,2,120,0,0,2,120,0.846552000,0.3025
75.131.21.137,<->,8.252.222.63,0,0,2,100,2,100,0.845539000,0.0000
136.91.46.115,<->,89.183.104.182,0,0,2,112,2,112,0.845286000,0.5871
249.101.93.184,<->,159.57.90.68,2,112,0,0,2,112,0.844572000,0.7357
145.144.97.107,<->,53.230.58.251,2,176,0,0,2,176,0.843923000,1.0001
210.158.44.170,<->,136.128.50.214,2,100,0,0,2,100,0.843140000,0.0225
143.155.227.57,<->,133.178.226.31,0,0,2,1429,2,1429,0.842919000,0.1800
146.249.227.119,<->,8.252.221.221,0,0,2,568,2,568,0.842628000,1.1192
204.21.75.114,<->,136.25.188.242,0,0,2,202,2,202,0.842370000,0.1587
144.83.60.153,<->,92.162.253.67,0,0,2,106,2,106,0.842303000,0.0636
142.236.184.190,<->,136.25.188.175,0,0,2,100,2,100,0.842175000,0.0039
199.39.40.249,<->,136.25.188.236,0,0,2,100,2,100,0.841586000,0.0015
68.72.92.217,<->,8.252.221.206,0,0,2,112,2,112,0.840351000,0.1726
215.158.238.223,<->,48.131.157.3,2,1269,0,0,2,1269,0.839631000,0.1655
99.75.168.29,<->,33.250.101.9,2,112,0,0,2,112,0.839601000,0.1600
100.109.116.141,<->,8.220.200.124,0,0,2,106,2,106,0.839304000,0.3224
215.158.239.35,<->,92.175.142.172,2,112,0,0,2,112,0.838836000,0.0522
215.158.239.94,<->,143.89.215.106,2,112,0,0,2,112,0.838561000,0.0485
128.113.144.228,<->,50.224.76.235,0,0,2,120,2,120,0.838232000,0.1032
204.32.174.74,<->,92.27.219.44,0,0,2,112,2,112,0.837568000,0.6757
215.158.239.85,<->,143.72.59.210,2,135,0,0,2,135,0.836759000,0.4649
215.158.239.87,<->,142.253.112.239,2,143,0,0,2,143,0.836346000,0.0000
231.255.190.2,<->,192.67.139.230,0,0,2,723,2,723,0.835387000,0.0007
210.229.230.22,<->,96.161.183.14,2,118,0,0,2,118,0.835258000,0.0879
215.158.140.13,<->,192.170.84.43,2,120,0,0,2,120,0.834999000,0.0239
194.233.59.40,<->,136.25.188.174,0,0,2,927,2,927,0.834897000,0.1005
143.123.198.246,<->,50.224.76.230,0,0,2,106,2,106,0.834850000,0.1699
195.127.173.52,<->,136.25.188.238,0,0,2,100,2,100,0.833011000,0.0007
195.55.53.51,<->,136.25.188.46,0,0,2,100,2,100,0.832548000,0.0072
140.136.9.105,<->,97.126.119.191,0,0,2,870,2,870,0.832198000,0.0232
101.106.122.69,<->,92.27.219.159,0,0,2,456,2,456,0.831445000,0.0919
48.17.255.133,<->,8.252.221.236,0,0,2,128,2,128,0.831160000,0.9944
6.145.172.253,<->,0.195.210.44,0,0,2,136,2,136,0.830924000,0.0002
100.124.212.156,<->,80.42.174.211,0,0,2,355,2,355,0.830343000,0.0009
215.158.30.32,<->,29.211.214.254,0,0,2,203,2,203,0.830324000,0.3098
198.42.206.19,<->,89.183.111.197,0,0,2,659,2,659,0.830220000,0.0259
215.158.140.27,<->,144.65.45.181,2,120,0,0,2,120,0.829615000,0.0286
141.134.183.188,<->,8.252.222.142,0,0,2,100,2,100,0.828900000,0.0000
147.47.52.115,<->,8.252.221.204,0,0,2,100,2,100,0.828815000,0.0122
91.41.83.140,<->,8.228.209.115,0,0,2,143,2,143,0.828612000,0.0000
207.200.202.120,<->,8.182.229.19,0,0,2,106,2,106,0.828364000,0.4097
110.9.120.22,<->,80.40.61.163,0,0,2,210,2,210,0.827678000,0.0501
252.98.36.210,<->,104.236.105.161,2,100,0,0,2,100,0.827455000,0.0167
207.72.120.226,<->,8.252.222.172,0,0,2,112,2,112,0.827357000,0.2042
215.158.239.49,<->,114.25.48.54,2,1285,0,0,2,1285,0.827338000,0.1628
143.128.136.139,<->,136.25.188.44,0,0,2,438,2,438,0.826130000,0.2027
215.158.239.49,<->,199.121.105.18,2,100,0,0,2,100,0.825990000,0.1524
133.178.227.1,<->,8.42.42.101,2,1157,0,0,2,1157,0.824858000,0.0867
133.135.213.65,<->,129.6.83.11,0,0,2,2645,2,2645,0.824748000,0.0000
215.158.239.58,<->,142.228.75.143,2,100,0,0,2,100,0.824079000,0.1799
255.133.225.78,<->,255.133.225.23,0,0,2,128,2,128,0.823652000,0.6409
215.158.239.68,<->,30.73.96.89,2,989,0,0,2,989,0.822969000,0.2186
144.83.60.153,<->,92.162.253.145,0,0,2,596,2,596,0.822173000,0.0117
199.70.57.228,<->,136.25.188.236,0,0,2,106,2,106,0.821561000,0.2216
133.178.226.38,<->,122.159.245.149,2,1269,0,0,2,1269,0.821486000,0.1007
142.221.198.168,<->,136.25.188.220,0,0,2,106,2,106,0.821001000,0.1804
215.158.239.84,<->,196.92.205.203,2,246,0,0,2,246,0.820459000,0.3405
207.63.85.62,<->,136.25.188.209,0,0,2,100,2,100,0.819158000,0.5619
136.25.189.90,<->,57.31.64.92,2,1253,0,0,2,1253,0.818799000,0.0995
192.64.210.144,<->,91.250.185.182,2,188,0,0,2,188,0.817712000,0.9999
136.25.189.46,<->,57.31.51.176,2,1221,0,0,2,1221,0.817296000,0.1725
195.125.104.107,<->,136.25.188.199,0,0,2,100,2,100,0.816394000,0.1370
17.240.202.152,<->,8.220.188.50,0,0,2,100,2,100,0.816033000,0.0258
216.38.40.208,<->,145.116.118.116,0,0,2,703,2,703,0.815992000,0.0257
112.208.20.81,<->,6.72.38.245,0,0,2,100,2,100,0.815983000,0.0000
235.37.190.201,<->,136.25.189.30,0,0,2,1285,2,1285,0.815611000,0.1261
195.5.199.239,<->,136.25.188.177,0,0,2,100,2,100,0.815347000,0.2344
215.158.239.77,<->,142.223.243.28,2,106,0,0,2,106,0.814875000,0.1572
147.11.11.151,<->,102.44.106.77,0,0,2,677,2,677,0.814239000,0.1997
207.63.2.86,<->,136.25.188.176,0,0,2,100,2,100,0.814231000,0.4611
197.7.105.66,<->,8.182.241.177,0,0,2,112,2,112,0.813581000,0.4746
139.148.1.93,<->,8.183.25.124,0,0,2,628,2,628,0.813411000,0.1430
141.252.251.223,<->,100.50.96.207,2,120,0,0,2,120,0.813241000,0.3632
136.25.188.220,<->,41.175.89.220,2,135,0,0,2,135,0.812847000,0.0709
53.148.20.156,<->,48.52.87.32,0,0,2,143,2,143,0.812644000,0.0000
104.252.174.36,<->,92.27.219.34,0,0,2,434,2,434,0.810801000,0.4412
145.166.30.92,<->,92.27.219.205,0,0,2,168,2,168,0.810734000,1.0043
204.62.143.9,<->,136.25.188.198,0,0,2,143,2,143,0.810353000,0.2210
115.234.169.233,<->,50.224.76.235,0,0,2,106,2,106,0.810287000,0.1258
215.158.238.50,<->,129.222.39.90,2,112,0,0,2,112,0.810160000,0.0193
196.87.27.8,<->,136.25.188.175,0,0,2,100,2,100,0.809788000,0.1369
159.73.142.167,<->,8.176.37.62,0,0,2,112,2,112,0.809288000,0.0440
215.158.239.76,<->,199.33.96.203,2,136,0,0,2,136,0.808734000,1.0626
17.213.58.90,<->,8.220.190.86,0,0,2,112,2,112,0.808277000,0.0691
215.158.239.93,<->,29.214.109.164,2,1253,0,0,2,1253,0.807655000,0.1565
194.237.93.242,<->,136.25.188.179,0,0,2,100,2,100,0.807212000,0.0017
143.89.63.84,<->,136.25.188.197,0,0,2,128,2,128,0.806941000,1.0306
252.98.181.203,<->,193.91.145.43,2,112,0,0,2,112,0.806381000,1.0509
133.62.79.123,<->,8.252.222.50,0,0,2,100,2,100,0.805327000,0.0648
159.137.255.191,<->,121.120.77.98,2,100,0,0,2,100,0.805058000,0.0010
215.158.140.217,<->,8.192.194.217,2,442,0,0,2,442,0.803915000,0.5435
215.158.239.84,<->,196.93.99.4,2,100,0,0,2,100,0.803682000,0.0005
215.158.239.78,<->,143.42.235.166,2,100,0,0,2,100,0.802896000,0.2189
215.158.239.86,<->,131.144.113.68,2,1349,0,0,2,1349,0.802634000,0.1645
212.164.143.229,<->,101.85.230.99,2,100,0,0,2,100,0.801118000,0.0378
97.243.218.137,<->,8.182.226.78,0,0,2,102,2,102,0.800712000,0.1398
210.229.230.18,<->,80.240.245.7,2,118,0,0,2,118,0.800414000,0.0400
215.158.239.49,<->,120.154.131.37,2,1237,0,0,2,1237,0.799776000,0.1152
235.37.190.219,<->,215.158.239.59,0,0,2,1477,2,1477,0.799724000,0.1325
136.25.188.163,<->,50.179.15.252,2,135,0,0,2,135,0.799349000,0.2314
215.158.239.97,<->,196.94.200.115,2,106,0,0,2,106,0.798444000,1.0082
197.113.99.203,<->,136.25.188.253,0,0,2,1793,2,1793,0.797930000,0.1999
215.158.140.13,<->,109.126.137.238,2,547,0,0,2,547,0.797806000,0.0028
207.162.145.221,<->,8.182.253.40,0,0,2,100,2,100,0.797501000,0.1739
215.158.238.74,<->,143.227.65.185,2,1141,0,0,2,1141,0.797219000,0.4263
204.186.53.227,<->,136.25.188.55,0,0,2,168,2,168,0.796534000,0.5401
109.206.109.131,<->,56.121.49.30,0,0,2,100,2,100,0.796364000,0.3789
119.229.190.112,<->,89.183.104.138,0,0,2,112,2,112,0.795636000,0.7551
215.158.238.132,<->,104.3.169.46,2,1093,0,0,2,1093,0.795569000,0.1541
6.145.166.119,<->,0.195.210.46,0,0,2,100,2,100,0.795115000,0.1711
215.158.239.215,<->,215.158.61.243,2,455,0,0,2,455,0.794751000,0.2632
215.158.239.56,<->,196.95.112.208,2,124,0,0,2,124,0.794631000,0.2798
144.54.85.138,<->,136.25.188.226,0,0,2,112,2,112,0.794301000,0.0792
246.253.253.107,<->,109.127.101.16,2,613,0,0,2,613,0.793514000,0.0279
136.25.188.234,<->,100.224.202.178,2,112,0,0,2,112,0.793330000,0.0202
137.19.241.43,<->,6.209.77.113,2,112,0,0,2,112,0.793232000,0.0696
136.25.188.106,<->,131.45.197.200,2,120,0,0,2,120,0.792412000,0.3198
50.52.142.86,<->,8.52.182.119,0,0,2,106,2,106,0.792005000,0.0303
32.236.164.211,<->,8.220.239.104,0,0,2,690,2,690,0.791534000,0.2386
148.56.229.109,<->,136.25.189.17,0,0,2,1301,2,1301,0.791365000,0.1200
97.168.81.64,<->,50.238.208.223,2,100,0,0,2,100,0.790683000,0.0000
35.56.19.111,<->,8.182.136.143,0,0,2,120,2,120,0.790664000,0.0207
207.188.208.25,<->,136.25.188.196,0,0,2,106,2,106,0.790488000,0.1795
247.136.177.109,<->,26.234.21.155,2,100,0,0,2,100,0.790452000,0.5781
207.57.125.44,<->,136.25.188.52,0,0,2,100,2,100,0.790431000,0.0014
194.237.93.242,<->,136.25.188.209,0,0,2,100,2,100,0.790137000,0.0015
215.158.239.76,<->,199.20.30.199,2,112,0,0,2,112,0.789705000,0.2399
249.101.92.202,<->,94.39.140.57,2,184,0,0,2,184,0.789694000,1.0358
92.27.219.203,<->,78.46.49.242,2,205,0,0,2,205,0.789019000,0.7940
136.25.189.59,<->,29.213.219.58,2,1285,0,0,2,1285,0.788875000,0.1185
215.158.239.79,<->,199.20.29.224,2,136,0,0,2,136,0.788721000,0.1041
100.230.7.112,<->,6.122.144.87,0,0,2,100,2,100,0.788339000,1.0000
215.158.239.79,<->,204.3.164.81,2,100,0,0,2,100,0.788040000,0.2385
215.158.239.93,<->,143.135.157.58,2,100,0,0,2,100,0.787065000,0.2892
17.194.236.193,<->,8.220.176.253,0,0,2,324,2,324,0.786738000,0.5381
215.158.239.59,<->,29.123.209.236,2,1413,0,0,2,1413,0.786447000,0.1666
142.236.78.144,<->,136.25.188.253,0,0,2,124,2,124,0.785667000,0.5921
142.207.125.86,<->,136.25.188.225,0,0,2,120,2,120,0.784795000,0.5065
215.158.239.48,<->,199.20.7.212,2,124,0,0,2,124,0.784736000,0.0612
94.192.85.101,<->,8.252.222.108,0,0,2,112,2,112,0.784526000,0.1898
92.27.219.129,<->,67.226.174.178,2,104,0,0,2,104,0.782421000,0.2665
215.158.239.93,<->,195.70.63.237,2,112,0,0,2,112,0.781795000,0.0572
123.162.64.53,<->,50.224.76.234,0,0,2,100,2,100,0.781731000,0.7492
215.158.239.84,<->,199.20.31.88,2,124,0,0,2,124,0.781284000,1.1236
207.225.102.55,<->,0.195.210.46,0,0,2,618,2,618,0.780396000,0.3642
204.190.146.60,<->,136.25.188.54,0,0,2,128,2,128,0.780301000,1.1600
89.183.104.149,<->,40.219.76.152,2,108,0,0,2,108,0.779769000,1.1933
155.219.37.89,<->,136.25.188.225,0,0,2,100,2,100,0.779131000,0.2792
111.147.209.101,<->,53.201.142.135,2,181,0,0,2,181,0.778755000,0.0000
194.233.196.82,<->,136.25.188.209,0,0,2,128,2,128,0.778742000,0.0007
246.253.201.22,<->,149.68.156.164,2,131,0,0,2,131,0.778741000,0.3577
215.158.239.51,<->,196.91.100.219,2,112,0,0,2,112,0.778612000,0.0423
195.215.34.52,<->,50.224.76.235,0,0,2,106,2,106,0.778457000,0.1727
215.158.239.94,<->,212.70.75.118,2,1285,0,0,2,1285,0.778367000,0.0280
202.60.223.159,<->,8.252.221.207,0,0,2,112,2,112,0.778320000,0.1954
98.67.154.150,<->,53.231.149.209,2,457,0,0,2,457,0.777947000,0.2353
215.158.239.77,<->,8.33.226.42,2,1269,0,0,2,1269,0.777684000,0.1015
94.192.85.101,<->,8.252.222.92,0,0,2,112,2,112,0.777666000,0.1618
207.92.58.74,<->,192.64.206.74,0,0,2,100,2,100,0.777397000,0.0003
195.7.177.255,<->,136.25.188.239,0,0,2,100,2,100,0.776837000,0.1909
195.7.223.133,<->,136.25.188.55,0,0,2,106,2,106,0.776463000,0.2718
199.122.103.22,<->,136.25.188.255,0,0,2,100,2,100,0.775719000,0.1561
121.11.14.81,<->,50.224.76.234,0,0,2,124,2,124,0.774899000,0.4289
136.25.189.59,<->,126.219.194.7,2,1446,0,0,2,1446,0.774761000,0.0962
207.117.213.142,<->,8.182.250.109,0,0,2,100,2,100,0.774745000,0.7889
196.148.175.168,<->,8.181.37.222,2,112,0,0,2,112,0.774377000,0.6436
237.7.174.46,<->,100.94.177.44,0,0,2,164,2,164,0.774165000,0.2667
92.27.52.56,<->,92.27.26.203,0,0,2,166,2,166,0.773048000,0.1843
205.127.142.147,<->,109.1.38.119,0,0,2,110,2,110,0.772932000,1.0336
143.68.11.75,<->,136.25.188.222,0,0,2,100,2,100,0.772827000,0.7645
8.20.87.187,<->,6.145.164.170,2,124,0,0,2,124,0.772724000,0.0000
246.254.97.228,<->,206.243.231.162,2,1017,0,0,2,1017,0.772362000,0.0393
17.30.191.234,<->,8.52.189.207,0,0,2,826,2,826,0.770944000,0.2830
215.158.103.203,<->,56.123.30.54,2,102,0,0,2,102,0.770670000,0.1039
121.67.9.245,<->,89.183.104.135,0,0,2,698,2,698,0.768859000,1.0257
203.215.149.144,<->,118.241.252.70,2,120,0,0,2,120,0.767052000,0.1593
133.178.227.2,<->,113.92.150.217,2,1217,0,0,2,1217,0.767029000,0.1592
215.158.239.50,<->,204.226.34.131,2,106,0,0,2,106,0.766470000,0.1507
101.70.121.77,<->,8.37.175.39,2,373,0,0,2,373,0.765315000,0.0448
220.20.200.178,<->,119.94.237.56,2,106,0,0,2,106,0.764959000,0.1178
220.20.200.134,<->,33.157.240.98,2,100,0,0,2,100,0.764552000,0.1371
215.158.239.79,<->,196.90.112.117,2,821,0,0,2,821,0.764384000,0.4980
69.128.111.213,<->,54.36.24.6,2,100,0,0,2,100,0.764099000,0.8128
50.23.41.165,<->,8.52.171.120,0,0,2,100,2,100,0.764058000,0.0354
215.158.239.99,<->,199.39.64.238,2,143,0,0,2,143,0.762990000,0.0011
112.208.20.152,<->,111.146.164.226,0,0,2,255,2,255,0.761931000,0.1280
95.245.113.50,<->,8.252.221.199,0,0,2,112,2,112,0.761726000,0.2860
136.25.189.89,<->,124.72.94.18,2,1269,0,0,2,1269,0.761530000,0.1700
50.23.41.165,<->,8.52.224.51,0,0,2,100,2,100,0.761341000,0.0020
144.75.218.237,<->,138.127.230.2,2,599,0,0,2,599,0.761331000,1.1958
133.178.227.40,<->,48.131.156.73,2,112,0,0,2,112,0.761158000,0.0003
221.102.125.17,<->,194.245.229.24,2,1518,0,0,2,1518,0.761027000,0.4013
89.183.104.137,<->,38.182.16.102,2,104,0,0,2,104,0.760533000,0.8000
99.162.75.124,<->,53.214.102.249,2,515,0,0,2,515,0.760127000,0.1544
215.158.239.97,<->,199.20.28.131,2,100,0,0,2,100,0.760038000,0.1442
138.37.118.244,<->,92.162.253.48,0,0,2,100,2,100,0.759657000,0.0249
207.191.169.148,<->,136.25.188.45,0,0,2,112,2,112,0.759493000,0.0019
6.145.151.200,<->,0.195.210.44,0,0,2,143,2,143,0.759118000,0.1619
194.237.35.160,<->,136.25.188.225,0,0,2,143,2,143,0.758631000,0.0016
229.59.207.106,<->,50.224.80.64,0,0,2,100,2,100,0.758206000,0.0520
231.143.66.34,<->,136.25.188.225,0,0,2,658,2,658,0.758129000,0.4297
196.202.62.38,<->,8.182.227.180,0,0,2,602,2,602,0.757781000,0.2878
111.150.207.168,<->,99.74.87.225,0,0,2,156,2,156,0.756899000,0.0650
220.80.162.195,<->,8.55.216.92,2,197,0,0,2,197,0.756222000,0.0000
136.25.189.13,<->,133.146.0.170,2,1349,0,0,2,1349,0.755558000,0.0241
232.88.132.205,<->,8.220.188.43,0,0,2,643,2,643,0.754428000,0.1580
112.73.216.90,<->,92.27.219.238,0,0,2,104,2,104,0.753463000,0.0005
215.158.239.58,<->,196.105.36.152,2,284,0,0,2,284,0.753140000,0.2804
116.75.210.91,<->,92.27.219.166,0,0,2,112,2,112,0.752875000,0.7576
132.168.196.174,<->,53.78.162.188,2,116,0,0,2,116,0.752769000,0.0398
143.95.106.178,<->,136.25.188.209,0,0,2,120,2,120,0.752749000,0.4443
142.239.121.92,<->,133.178.226.18,0,0,2,1125,2,1125,0.752525000,0.4511
210.220.219.182,<->,192.179.63.29,2,373,0,0,2,373,0.750668000,0.0015
192.64.221.19,<->,106.176.179.39,2,1529,0,0,2,1529,0.750480000,0.0000
6.145.166.164,<->,0.195.210.44,0,0,2,143,2,143,0.750358000,0.1231
144.75.218.237,<->,50.149.206.145,2,513,0,0,2,513,0.750103000,0.2551
109.222.251.50,<->,8.37.249.230,2,184,0,0,2,184,0.749938000,0.5091
95.244.118.4,<->,8.252.222.36,0,0,2,137,2,137,0.749697000,0.0016
136.25.188.253,<->,84.242.68.230,2,102,0,0,2,102,0.749403000,0.3434
220.20.200.96,<->,131.45.239.178,2,678,0,0,2,678,0.748698000,0.8277
144.75.218.237,<->,138.127.225.165,2,508,0,0,2,508,0.748658000,1.1784
136.25.189.90,<->,96.156.169.254,2,1557,0,0,2,1557,0.748306000,0.1971
142.167.140.224,<->,136.25.188.55,0,0,2,136,2,136,0.748177000,0.9998
119.43.150.48,<->,20.151.0.202,0,0,2,160,2,160,0.747761000,0.9997
210.229.230.18,<->,100.202.111.157,2,118,0,0,2,118,0.747232000,0.2521
147.58.211.46,<->,8.252.221.214,0,0,2,112,2,112,0.747038000,0.1564
231.140.32.67,<->,136.25.188.252,0,0,2,100,2,100,0.747004000,0.2323
215.158.61.211,<->,99.74.27.172,0,0,2,391,2,391,0.746927000,0.0006
215.158.238.51,<->,129.222.36.77,2,112,0,0,2,112,0.746426000,0.0212
215.158.239.78,<->,196.90.0.243,2,149,0,0,2,149,0.746315000,0.0000
215.158.239.113,<->,129.222.36.65,2,112,0,0,2,112,0.745757000,0.0192
247.136.255.52,<->,117.64.120.171,2,238,0,0,2,238,0.745528000,0.1614
92.162.253.34,<->,92.27.68.141,2,100,0,0,2,100,0.745123000,0.0196
148.217.121.180,<->,136.25.189.12,0,0,2,1253,2,1253,0.745054000,0.1599
142.252.248.146,<->,136.25.188.179,0,0,2,112,2,112,0.744580000,0.1203
204.3.171.226,<->,136.25.188.252,0,0,2,120,2,120,0.743893000,0.3383
199.53.212.230,<->,136.25.188.254,0,0,2,106,2,106,0.743580000,0.3814
109.1.21.151,<->,8.55.135.127,2,125,0,0,2,125,0.743116000,0.0000
215.158.238.108,<->,100.224.166.161,2,562,0,0,2,562,0.743004000,0.0262
159.31.237.1,<->,78.45.154.137,2,184,0,0,2,184,0.742900000,0.5138
152.12.131.83,<->,92.27.219.223,0,0,2,642,2,642,0.741021000,0.0034
199.71.253.141,<->,136.25.188.45,0,0,2,106,2,106,0.740452000,0.1927
215.158.239.56,<->,207.60.123.143,2,120,0,0,2,120,0.740123000,0.3296
247.136.248.75,<->,122.252.125.129,2,106,0,0,2,106,0.740059000,0.5491
207.58.163.112,<->,136.25.188.173,0,0,2,100,2,100,0.740058000,0.0276
132.249.70.213,<->,101.229.93.43,2,212,0,0,2,212,0.740042000,0.4661
53.149.38.189,<->,8.228.215.41,0,0,2,163,2,163,0.740019000,0.9591
8.52.182.119,<->,8.3.252.131,2,100,0,0,2,100,0.739731000,0.0362
215.158.238.32,<->,118.20.101.16,2,1301,0,0,2,1301,0.739476000,0.6050
215.158.239.56,<->,199.106.246.187,2,112,0,0,2,112,0.739425000,0.5168
199.73.103.114,<->,136.25.188.254,0,0,2,128,2,128,0.739033000,1.0208
142.236.142.220,<->,136.25.188.209,0,0,2,100,2,100,0.737974000,0.6983
109.206.166.234,<->,50.224.92.222,0,0,2,300,2,300,0.737611000,1.0019
207.56.55.79,<->,136.25.188.209,0,0,2,106,2,106,0.736727000,0.3145
144.64.136.129,<->,136.116.9.75,2,100,0,0,2,100,0.735753000,1.0594
192.64.208.147,<->,127.81.151.203,2,172,0,0,2,172,0.735625000,0.6990
56.9.159.83,<->,8.182.251.218,0,0,2,758,2,758,0.735511000,0.0800
215.158.238.56,<->,126.219.196.105,2,1349,0,0,2,1349,0.733825000,0.1247
220.55.140.187,<->,92.27.234.26,0,0,2,153,2,153,0.733527000,0.0588
215.158.239.56,<->,199.20.30.159,2,106,0,0,2,106,0.732813000,0.2617
142.248.247.189,<->,136.25.188.222,0,0,2,100,2,100,0.732750000,0.2369
255.133.225.201,<->,255.133.225.23,0,0,2,128,2,128,0.732221000,0.6649
144.89.245.80,<->,97.183.223.16,0,0,2,112,2,112,0.732123000,0.0020
104.213.111.229,<->,50.224.76.234,0,0,2,112,2,112,0.732006000,0.0049
215.158.238.96,<->,159.23.130.167,2,1237,0,0,2,1237,0.731859000,0.0483
215.158.239.84,<->,195.54.73.111,2,106,0,0,2,106,0.731680000,0.1643
141.199.76.223,<->,136.25.189.81,0,0,2,1269,2,1269,0.730129000,0.2197
195.5.60.150,<->,136.25.188.46,0,0,2,100,2,100,0.729531000,0.2395
221.102.56.69,<->,98.128.112.210,0,0,2,100,2,100,0.729338000,0.0000
215.158.239.87,<->,149.184.89.88,2,1397,0,0,2,1397,0.729128000,0.1745
133.178.227.40,<->,112.235.95.68,2,1476,0,0,2,1476,0.729109000,0.1069
144.75.218.246,<->,129.35.251.34,2,303,0,0,2,303,0.728774000,0.3170
129.187.1.149,<->,100.182.186.91,0,0,2,100,2,100,0.728461000,0.1223
142.248.29.157,<->,136.25.188.178,0,0,2,106,2,106,0.728162000,0.8446
204.184.197.122,<->,136.25.188.176,0,0,2,338,2,338,0.728029000,0.2511
222.79.83.198,<->,210.229.230.22,0,0,2,118,2,118,0.728014000,0.2431
215.158.239.79,<->,201.211.113.180,2,1301,0,0,2,1301,0.727784000,0.3893
133.178.227.251,<->,29.214.74.136,2,1189,0,0,2,1189,0.727630000,0.1148
130.73.139.115,<->,39.1.152.199,0,0,2,136,2,136,0.727565000,1.0000
126.211.107.156,<->,89.183.104.248,0,0,2,397,2,397,0.726693000,1.0130
92.27.219.193,<->,33.57.78.66,2,100,0,0,2,100,0.726602000,0.6398
247.118.150.119,<->,8.182.228.163,0,0,2,593,2,593,0.726407000,0.0400
111.146.140.132,<->,17.61.177.228,2,814,0,0,2,814,0.726191000,0.0500
192.64.64.176,<->,112.208.20.194,2,100,0,0,2,100,0.725577000,0.0000
215.158.239.97,<->,143.20.9.17,2,100,0,0,2,100,0.725435000,0.1375
145.166.30.92,<->,92.27.219.52,0,0,2,168,2,168,0.725169000,1.0119
197.113.99.252,<->,136.25.188.238,0,0,2,128,2,128,0.725091000,1.0000
207.58.246.46,<->,136.25.188.54,0,0,2,143,2,143,0.724632000,0.0036
53.161.235.49,<->,48.53.35.88,0,0,2,106,2,106,0.724614000,0.9994
215.158.239.51,<->,142.208.195.90,2,106,0,0,2,106,0.724462000,0.3979
221.102.124.223,<->,158.27.248.227,2,120,0,0,2,120,0.724014000,0.2761
199.121.54.19,<->,136.25.188.253,0,0,2,100,2,100,0.723513000,0.1856
210.156.111.217,<->,200.164.14.129,2,446,0,0,2,446,0.721953000,0.0008
210.236.82.159,<->,8.183.25.25,0,0,2,112,2,112,0.721758000,0.0215
215.158.239.97,<->,195.70.3.141,2,143,0,0,2,143,0.721610000,0.0030
128.141.71.147,<->,8.31.37.162,0,0,2,106,2,106,0.721088000,0.2883
114.38.12.40,<->,50.224.76.235,0,0,2,118,2,118,0.720980000,0.1367
215.158.239.50,<->,143.91.194.153,2,112,0,0,2,112,0.720651000,1.2007
215.158.140.92,<->,201.211.113.32,2,1501,0,0,2,1501,0.720472000,0.6743
144.75.218.241,<->,139.252.1.253,2,343,0,0,2,343,0.719560000,0.9380
215.158.239.99,<->,199.20.30.68,2,120,0,0,2,120,0.719522000,0.4799
215.158.238.107,<->,192.229.40.54,2,1237,0,0,2,1237,0.719448000,0.4643
199.52.68.236,<->,136.25.188.198,0,0,2,100,2,100,0.718658000,0.0019
89.204.223.30,<->,89.183.108.215,0,0,2,1110,2,1110,0.718623000,1.0002
144.74.36.1,<->,8.182.226.78,0,0,2,100,2,100,0.718002000,0.4207
222.254.247.163,<->,210.220.219.178,0,0,2,517,2,517,0.717529000,0.0056
199.52.92.168,<->,136.25.188.44,0,0,2,128,2,128,0.716672000,0.9619
50.224.76.235,<->,33.4.24.161,2,106,0,0,2,106,0.716156000,0.1601
215.158.239.76,<->,195.49.148.192,2,100,0,0,2,100,0.716101000,0.3804
207.62.89.133,<->,136.25.188.174,0,0,2,952,2,952,0.715918000,0.0021
206.243.192.207,<->,92.162.253.203,0,0,2,100,2,100,0.715728000,0.1654
145.19.9.13,<->,110.194.114.3,2,314,0,0,2,314,0.715694000,0.0367
136.25.189.29,<->,61.35.124.165,2,1333,0,0,2,1333,0.715323000,0.2276
126.198.149.124,<->,99.75.118.25,0,0,2,391,2,391,0.714952000,0.1372
215.158.239.87,<->,199.32.236.26,2,106,0,0,2,106,0.714332000,0.1680
133.178.227.19,<->,80.47.152.245,2,1253,0,0,2,1253,0.713800000,0.1389
111.150.187.222,<->,8.252.223.176,0,0,2,1105,2,1105,0.713521000,0.2466
144.75.218.241,<->,138.127.225.148,2,732,0,0,2,732,0.713430000,1.2548
204.42.100.81,<->,133.24.77.91,0,0,2,120,2,120,0.713000000,0.0031
222.16.245.21,<->,192.64.228.248,0,0,2,112,2,112,0.712250000,0.0000
207.82.202.68,<->,20.23.205.94,0,0,2,128,2,128,0.711198000,0.9958
109.119.182.189,<->,89.216.125.35,0,0,2,112,2,112,0.710830000,0.0000
196.115.133.150,<->,136.25.189.2,0,0,2,1381,2,1381,0.709616000,0.1782
195.123.175.8,<->,100.94.55.113,0,0,2,278,2,278,0.709545000,0.9772
215.158.239.87,<->,29.211.93.22,2,1429,0,0,2,1429,0.709474000,0.1340
215.158.239.69,<->,196.106.47.167,2,709,0,0,2,709,0.709400000,0.3000
149.40.32.242,<->,50.224.76.235,0,0,2,120,2,120,0.709074000,0.1870
207.57.129.65,<->,136.25.188.46,0,0,2,135,2,135,0.708990000,0.3955
247.136.192.204,<->,27.242.250.182,2,168,0,0,2,168,0.708877000,0.4130
133.96.32.14,<->,8.182.244.19,0,0,2,112,2,112,0.708869000,0.0240
207.56.104.108,<->,136.25.188.199,0,0,2,106,2,106,0.708514000,0.2493
143.53.19.243,<->,136.25.188.198,0,0,2,106,2,106,0.708493000,0.7844
195.41.235.212,<->,136.25.188.222,0,0,2,100,2,100,0.707986000,0.5510
133.178.227.43,<->,8.219.187.246,2,1362,0,0,2,1362,0.707588000,0.0493
145.16.103.60,<->,8.35.106.57,2,147,0,0,2,147,0.707496000,0.0000
235.253.220.214,<->,133.178.227.2,0,0,2,1244,2,1244,0.706130000,0.1971
205.210.174.212,<->,80.40.44.132,0,0,2,746,2,746,0.705393000,1.0276
66.63.190.126,<->,8.252.221.197,0,0,2,100,2,100,0.705142000,0.1640
220.55.122.79,<->,27.11.34.178,2,318,0,0,2,318,0.705067000,0.1821
215.158.239.57,<->,199.20.31.112,2,128,0,0,2,128,0.704585000,0.6683
136.25.188.252,<->,96.30.181.225,2,136,0,0,2,136,0.704322000,1.0247
132.220.100.51,<->,8.53.4.76,0,0,2,100,2,100,0.703605000,0.0953
156.165.37.73,<->,136.25.189.13,0,0,2,1333,2,1333,0.703589000,0.2248
210.229.230.18,<->,101.193.94.205,2,118,0,0,2,118,0.703446000,0.3216
142.207.52.165,<->,136.25.188.55,0,0,2,100,2,100,0.703431000,0.3321
215.158.239.87,<->,195.54.56.77,2,112,0,0,2,112,0.703295000,0.3058
215.158.239.78,<->,143.91.230.145,2,100,0,0,2,100,0.702164000,0.0000
255.133.226.138,<->,8.20.87.7,0,0,2,344,2,344,0.702084000,0.9982
220.16.80.153,<->,8.182.248.147,0,0,2,100,2,100,0.701724000,1.1811
215.158.140.230,<->,132.208.78.60,2,100,0,0,2,100,0.701659000,0.0903
199.90.8.21,<->,8.182.226.42,0,0,2,112,2,112,0.700772000,0.0000
199.52.224.164,<->,136.25.188.45,0,0,2,100,2,100,0.700597000,0.0025
123.156.103.111,<->,20.238.142.84,0,0,2,128,2,128,0.698771000,1.0001
207.51.235.225,<->,0.195.210.46,0,0,2,100,2,100,0.698751000,0.0000
215.158.61.242,<->,8.176.8.195,0,0,2,455,2,455,0.697836000,0.1105
133.178.227.16,<->,8.50.170.201,2,1317,0,0,2,1317,0.697208000,0.0946
136.25.189.80,<->,33.209.219.75,2,1429,0,0,2,1429,0.696903000,0.2453
159.80.143.31,<->,159.80.129.217,0,0,2,256,2,256,0.696881000,0.6025
111.147.129.118,<->,53.214.239.188,2,838,0,0,2,838,0.696708000,0.9054
231.143.109.135,<->,136.25.188.45,0,0,2,100,2,100,0.696677000,0.0999
6.145.171.243,<->,0.195.210.44,0,0,2,149,2,149,0.696597000,0.1099
215.158.239.96,<->,142.255.143.151,2,137,0,0,2,137,0.696597000,0.0017
8.222.49.230,<->,6.73.247.24,0,0,2,1621,2,1621,0.696577000,0.0000
215.158.239.58,<->,199.20.29.150,2,963,0,0,2,963,0.695684000,0.0800
136.25.189.136,<->,111.151.142.168,2,124,0,0,2,124,0.695654000,0.0337
142.249.59.202,<->,136.25.188.54,0,0,2,135,2,135,0.695423000,0.3872
215.158.238.45,<->,119.196.23.9,2,1269,0,0,2,1269,0.694467000,0.1235
136.177.72.3,<->,92.162.253.74,0,0,2,825,2,825,0.694441000,0.0429
246.253.157.59,<->,119.231.232.223,2,100,0,0,2,100,0.693952000,0.0967
215.158.238.81,<->,192.204.170.244,2,1349,0,0,2,1349,0.693669000,0.2973
215.158.239.69,<->,199.20.30.232,2,136,0,0,2,136,0.693428000,0.3349
221.102.143.189,<->,192.65.116.41,0,0,2,197,2,197,0.693248000,0.0000
133.178.226.177,<->,53.176.63.198,2,746,0,0,2,746,0.693110000,0.2345
145.252.117.151,<->,37.112.13.153,2,100,0,0,2,100,0.692789000,0.9994
215.158.238.223,<->,97.243.113.40,2,1130,0,0,2,1130,0.692570000,0.0792
230.83.120.210,<->,220.81.57.237,0,0,2,266,2,266,0.691242000,0.2200
137.137.124.206,<->,122.235.215.40,2,218,0,0,2,218,0.690957000,0.0204
215.158.238.220,<->,48.129.133.53,2,1037,0,0,2,1037,0.690074000,0.1638
136.25.189.34,<->,96.156.169.195,2,1541,0,0,2,1541,0.688801000,0.5887
92.27.219.228,<->,68.227.114.3,2,108,0,0,2,108,0.688746000,0.8248
142.240.42.99,<->,136.25.188.227,0,0,2,100,2,100,0.688746000,0.2092
215.158.140.27,<->,59.158.134.20,2,120,0,0,2,120,0.688568000,0.2708
58.59.89.41,<->,8.252.221.222,0,0,2,112,2,112,0.687988000,0.2029
17.41.75.11,<->,8.220.178.166,0,0,2,106,2,106,0.687707000,0.0762
215.158.238.133,<->,29.213.219.103,2,112,0,0,2,112,0.687346000,0.0003
215.158.238.53,<->,8.246.253.81,2,1413,0,0,2,1413,0.686943000,0.1294
194.237.128.131,<->,136.25.188.242,0,0,2,522,2,522,0.686416000,0.0030
98.158.84.242,<->,8.182.226.78,0,0,2,100,2,100,0.686086000,0.0816
194.233.138.139,<->,136.25.188.53,0,0,2,152,2,152,0.685892000,0.4000
109.222.251.106,<->,8.232.109.189,2,324,0,0,2,324,0.685698000,0.1170
215.158.239.57,<->,196.1.130.55,2,136,0,0,2,136,0.685614000,1.0207
95.245.146.158,<->,8.252.222.77,0,0,2,112,2,112,0.684954000,0.0011
195.70.17.138,<->,136.25.188.177,0,0,2,100,2,100,0.684943000,0.0015
215.158.239.218,<->,145.234.121.50,2,574,0,0,2,574,0.684501000,0.0026
215.158.239.84,<->,204.226.32.134,2,106,0,0,2,106,0.684213000,0.1770
133.178.227.79,<->,126.219.194.55,2,1119,0,0,2,1119,0.684005000,0.2479
133.178.227.79,<->,8.222.6.193,2,112,0,0,2,112,0.683518000,0.0248
98.87.186.55,<->,92.27.219.234,0,0,2,128,2,128,0.683192000,0.8554
199.52.217.25,<->,136.25.188.177,0,0,2,112,2,112,0.682769000,0.0028
196.88.173.141,<->,136.25.188.53,0,0,2,102,2,102,0.682741000,0.6169
139.253.175.86,<->,101.70.110.59,0,0,2,723,2,723,0.680667000,0.0038
199.120.132.74,<->,136.25.188.199,0,0,2,106,2,106,0.680180000,0.2106
136.18.189.67,<->,8.182.136.57,0,0,2,1380,2,1380,0.680014000,0.3321
215.158.195.4,<->,111.151.142.130,2,112,0,0,2,112,0.679473000,0.0000
193.64.187.35,<->,98.236.223.238,0,0,2,215,2,215,0.679333000,0.1614
215.158.49.77,<->,136.116.28.232,0,0,2,595,2,595,0.678786000,0.1417
106.168.190.66,<->,101.126.191.241,0,0,2,165,2,165,0.678370000,0.3141
215.158.140.27,<->,201.47.124.151,2,120,0,0,2,120,0.678231000,0.2594
199.71.219.229,<->,136.25.188.252,0,0,2,100,2,100,0.678052000,0.4054
54.92.112.204,<->,48.52.81.82,0,0,2,100,2,100,0.677394000,0.7793
159.137.152.190,<->,133.178.226.214,0,0,2,390,2,390,0.676979000,0.0203
204.46.43.131,<->,50.224.76.230,0,0,2,106,2,106,0.676508000,0.1984
50.224.76.235,<->,27.78.4.56,2,106,0,0,2,106,0.673624000,0.1212
215.158.239.94,<->,196.115.133.150,2,1445,0,0,2,1445,0.672220000,0.1570
203.116.220.178,<->,144.64.139.133,0,0,2,128,2,128,0.671430000,0.9593
215.158.238.91,<->,56.19.241.59,2,320,0,0,2,320,0.670788000,0.4255
215.158.239.76,<->,143.91.230.145,2,100,0,0,2,100,0.670305000,0.0000
195.55.137.172,<->,136.25.188.254,0,0,2,112,2,112,0.669763000,0.0084
144.85.170.208,<->,91.69.181.15,2,112,0,0,2,112,0.669614000,0.0197
98.128.226.115,<->,8.55.224.156,2,197,0,0,2,197,0.669338000,0.0000
136.25.188.179,<->,8.249.253.149,2,1285,0,0,2,1285,0.668536000,0.4094
215.158.239.93,<->,199.63.178.200,2,1285,0,0,2,1285,0.667938000,0.1392
215.158.239.87,<->,143.42.79.210,2,106,0,0,2,106,0.667839000,0.3819
197.125.118.14,<->,133.178.227.16,0,0,2,1198,2,1198,0.667831000,0.0923
249.101.104.130,<->,239.29.96.45,2,216,0,0,2,216,0.667511000,0.0000
215.158.140.27,<->,57.9.192.236,2,120,0,0,2,120,0.667490000,0.2290
215.158.239.57,<->,195.4.4.181,2,100,0,0,2,100,0.666386000,0.6058
215.158.239.57,<->,207.60.99.46,2,100,0,0,2,100,0.666262000,0.0153
132.216.20.184,<->,80.40.43.127,0,0,2,181,2,181,0.665792000,0.0000
132.133.159.10,<->,8.182.244.237,0,0,2,100,2,100,0.665364000,0.0002
215.158.239.58,<->,207.59.4.117,2,849,0,0,2,849,0.662710000,1.3315
215.158.238.66,<->,33.209.219.55,2,1333,0,0,2,1333,0.662191000,0.1450
129.16.253.232,<->,100.182.137.123,0,0,2,1166,2,1166,0.661506000,0.0536
195.14.149.80,<->,136.25.188.163,0,0,2,106,2,106,0.661402000,0.1530
201.222.12.47,<->,92.27.219.60,0,0,2,2940,2,2940,0.660534000,0.0321
133.178.226.30,<->,121.20.63.196,2,1205,0,0,2,1205,0.660458000,0.1357
144.75.218.246,<->,138.127.230.132,2,550,0,0,2,550,0.660121000,0.0027
105.106.43.181,<->,50.224.76.234,0,0,2,106,2,106,0.659620000,0.1097
159.135.1.136,<->,8.52.222.23,0,0,2,106,2,106,0.659471000,0.0370
29.214.108.240,<->,8.252.223.141,0,0,2,1159,2,1159,0.658137000,0.4152
136.25.189.196,<->,129.222.36.164,2,112,0,0,2,112,0.658062000,0.0192
215.158.239.94,<->,207.166.75.195,2,688,0,0,2,688,0.657890000,0.7965
215.158.239.58,<->,204.0.191.172,2,106,0,0,2,106,0.657103000,0.1200
215.158.239.245,<->,111.150.207.167,2,156,0,0,2,156,0.657040000,1.1303
215.158.239.57,<->,195.6.27.168,2,100,0,0,2,100,0.656789000,0.0587
220.204.42.141,<->,136.25.188.252,0,0,2,100,2,100,0.655565000,0.0000
6.145.167.149,<->,0.195.210.44,0,0,2,165,2,165,0.655497000,0.0976
96.236.7.59,<->,8.52.186.161,0,0,2,100,2,100,0.655002000,0.0000
199.83.222.225,<->,136.25.188.173,0,0,2,100,2,100,0.653768000,0.0039
220.55.173.147,<->,27.202.117.216,2,100,0,0,2,100,0.653389000,1.0000
199.52.85.152,<->,136.25.188.46,0,0,2,100,2,100,0.653356000,0.0488
220.20.200.69,<->,53.231.26.246,2,100,0,0,2,100,0.651769000,0.1673
92.27.219.194,<->,64.214.35.48,2,100,0,0,2,100,0.651618000,1.0001
117.63.224.154,<->,50.224.76.234,0,0,2,118,2,118,0.651120000,0.0996
230.156.234.211,<->,8.252.221.206,0,0,2,118,2,118,0.651087000,0.1440
132.249.142.223,<->,8.52.169.61,0,0,2,767,2,767,0.649818000,0.2702
137.69.184.109,<->,8.182.244.237,0,0,2,100,2,100,0.649652000,1.1433
64.148.91.176,<->,34.13.94.119,0,0,2,114,2,114,0.649207000,0.0178
133.178.227.40,<->,126.219.102.9,2,1100,0,0,2,1100,0.649175000,0.3070
17.26.173.37,<->,8.220.178.203,0,0,2,100,2,100,0.649009000,0.0260
139.163.121.135,<->,97.68.91.46,2,112,0,0,2,112,0.648580000,0.0003
215.158.239.99,<->,199.20.31.108,2,1141,0,0,2,1141,0.648253000,0.8801
215.158.239.95,<->,196.91.112.113,2,136,0,0,2,136,0.648129000,0.0599
122.244.201.60,<->,89.183.104.131,0,0,2,108,2,108,0.647760000,0.6728
206.176.132.3,<->,80.38.41.203,0,0,2,100,2,100,0.647698000,0.0000
139.241.64.118,<->,98.232.172.128,0,0,2,128,2,128,0.647345000,1.0019
210.229.230.18,<->,100.155.201.187,2,118,0,0,2,118,0.646442000,0.2480
215.158.239.78,<->,196.104.78.23,2,1713,0,0,2,1713,0.646130000,0.4602
215.158.140.216,<->,91.42.195.239,2,112,0,0,2,112,0.645438000,0.0261
215.158.238.251,<->,4.7.157.72,2,1194,0,0,2,1194,0.645027000,0.2913
207.172.219.33,<->,136.25.188.199,0,0,2,120,2,120,0.644622000,0.6500
231.138.6.93,<->,136.25.188.239,0,0,2,136,2,136,0.642798000,0.9808
215.158.238.53,<->,131.144.116.55,2,1413,0,0,2,1413,0.642576000,0.1813
120.150.106.190,<->,89.183.104.132,0,0,2,104,2,104,0.641991000,0.7669
249.101.211.0,<->,53.93.228.116,2,112,0,0,2,112,0.641964000,0.9582
215.158.238.107,<->,106.188.252.217,2,1445,0,0,2,1445,0.641611000,0.1041
142.190.145.115,<->,136.25.188.174,0,0,2,106,2,106,0.641266000,0.1940
136.25.189.202,<->,129.222.39.127,2,112,0,0,2,112,0.640700000,0.0192
195.5.62.123,<->,136.25.188.54,0,0,2,135,2,135,0.640539000,0.3323
196.247.165.73,<->,136.25.188.254,0,0,2,136,2,136,0.640462000,1.0678
136.25.189.57,<->,96.156.169.254,2,1130,0,0,2,1130,0.639358000,0.3197
144.75.218.246,<->,138.127.231.221,2,636,0,0,2,636,0.638926000,1.3468
215.158.239.79,<->,196.92.1.28,2,128,0,0,2,128,0.637453000,1.0924
192.64.209.247,<->,27.167.166.227,2,1562,0,0,2,1562,0.637422000,0.5003
129.225.134.75,<->,129.225.132.224,0,0,2,967,2,967,0.637090000,0.0571
92.27.219.46,<->,88.45.29.184,2,136,0,0,2,136,0.636955000,1.0402
136.25.189.90,<->,56.161.218.60,2,1477,0,0,2,1477,0.636901000,0.0633
111.147.115.147,<->,53.148.134.85,2,761,0,0,2,761,0.636483000,0.0010
231.143.148.221,<->,136.25.188.53,0,0,2,741,2,741,0.635741000,0.6401
222.244.24.215,<->,215.158.239.57,0,0,2,1269,2,1269,0.635525000,0.0256
220.20.200.94,<->,89.153.100.60,2,106,0,0,2,106,0.635270000,0.0184
215.158.239.113,<->,129.222.36.33,2,112,0,0,2,112,0.634336000,0.0211
215.158.239.93,<->,199.20.31.172,2,120,0,0,2,120,0.634067000,0.3599
136.25.188.179,<->,99.141.104.180,2,135,0,0,2,135,0.633765000,0.0385
215.158.239.18,<->,80.47.111.182,2,1106,0,0,2,1106,0.633640000,0.2149
199.70.231.121,<->,136.25.188.241,0,0,2,106,2,106,0.633123000,0.1785
17.6.195.239,<->,8.220.177.81,0,0,2,549,2,549,0.632464000,0.2714
192.67.130.105,<->,159.151.56.171,2,104,0,0,2,104,0.632218000,0.6987
224.93.21.36,<->,8.52.222.23,0,0,2,100,2,100,0.632091000,0.0220
92.27.26.238,<->,27.202.117.216,2,100,0,0,2,100,0.631537000,1.0002
199.120.132.74,<->,136.25.188.236,0,0,2,106,2,106,0.631103000,0.2005
215.158.239.69,<->,148.55.210.216,2,1285,0,0,2,1285,0.630907000,0.2091
215.158.238.198,<->,8.222.2.54,2,1254,0,0,2,1254,0.630097000,0.1022
215.158.239.95,<->,199.20.28.119,2,120,0,0,2,120,0.629739000,0.2204
142.190.179.109,<->,136.25.188.252,0,0,2,106,2,106,0.629375000,0.8175
133.178.226.28,<->,133.73.194.11,2,1205,0,0,2,1205,0.628953000,0.0298
221.102.143.189,<->,192.64.125.25,0,0,2,184,2,184,0.628400000,0.0021
204.200.48.116,<->,136.25.188.178,0,0,2,151,2,151,0.628356000,0.4875
207.172.46.151,<->,136.25.188.174,0,0,2,1204,2,1204,0.628070000,0.8795
215.158.239.30,<->,100.166.21.52,2,112,0,0,2,112,0.628000000,0.0575
220.55.169.27,<->,27.202.117.216,2,100,0,0,2,100,0.627963000,1.0001
203.120.5.84,<->,80.38.36.144,0,0,2,167,2,167,0.627837000,0.9424
146.249.227.87,<->,8.252.221.223,0,0,2,112,2,112,0.627769000,0.1998
142.190.126.17,<->,136.25.188.160,0,0,2,100,2,100,0.627396000,0.1830
136.25.189.57,<->,120.155.8.111,2,1237,0,0,2,1237,0.627164000,0.5727
143.232.93.56,<->,8.20.87.179,0,0,2,1069,2,1069,0.627150000,1.0851
215.158.238.141,<->,148.56.229.108,2,1125,0,0,2,1125,0.626462000,0.1384
215.158.239.49,<->,199.20.5.216,2,100,0,0,2,100,0.626043000,0.0200
98.236.90.77,<->,53.190.238.197,2,112,0,0,2,112,0.625759000,1.0200
215.158.140.228,<->,83.231.251.124,2,100,0,0,2,100,0.625580000,0.0503
136.18.58.122,<->,8.182.235.164,0,0,2,376,2,376,0.625523000,0.1010
192.252.142.66,<->,80.38.34.181,0,0,2,106,2,106,0.625512000,0.2385
246.253.253.208,<->,196.21.24.47,2,162,0,0,2,162,0.624980000,0.6601
144.75.218.235,<->,138.127.225.15,2,546,0,0,2,546,0.624718000,1.0570
144.87.238.89,<->,8.252.223.193,0,0,2,582,2,582,0.624653000,0.5368
136.25.188.46,<->,41.129.198.194,2,106,0,0,2,106,0.624564000,0.0217
215.158.238.73,<->,29.211.228.42,2,1189,0,0,2,1189,0.624060000,0.1374
192.171.13.33,<->,8.252.222.202,0,0,2,542,2,542,0.623135000,0.0004
215.158.238.149,<->,122.159.245.165,2,1317,0,0,2,1317,0.622535000,0.1431
112.13.24.22,<->,50.224.76.248,0,0,2,124,2,124,0.622483000,0.1120
207.58.180.32,<->,136.25.188.225,0,0,2,135,2,135,0.622227000,0.2338
196.112.119.95,<->,0.195.210.44,0,0,2,149,2,149,0.621961000,0.2573
215.158.239.113,<->,129.222.39.114,2,112,0,0,2,112,0.621477000,0.0189
220.20.200.123,<->,210.60.25.92,2,100,0,0,2,100,0.621166000,0.0912
92.27.194.147,<->,35.64.99.218,2,120,0,0,2,120,0.620422000,0.0185
254.70.113.234,<->,192.64.255.44,0,0,2,168,2,168,0.620388000,0.0259
101.224.183.152,<->,91.231.118.234,2,170,0,0,2,170,0.620307000,0.9498
143.42.236.181,<->,136.25.188.241,0,0,2,100,2,100,0.620049000,0.1663
220.55.106.26,<->,148.91.130.202,2,100,0,0,2,100,0.619867000,0.1991
136.25.189.14,<->,113.92.151.92,2,1461,0,0,2,1461,0.619612000,0.1593
106.169.196.77,<->,92.27.219.153,0,0,2,362,2,362,0.619369000,0.0032
203.215.127.219,<->,118.241.252.70,2,120,0,0,2,120,0.618983000,0.1475
144.75.218.233,<->,8.47.123.78,2,338,0,0,2,338,0.618865000,0.9338
139.193.141.209,<->,92.70.153.19,2,586,0,0,2,586,0.618754000,0.0569
215.158.239.77,<->,204.1.248.208,2,106,0,0,2,106,0.617167000,0.1802
246.253.253.212,<->,142.178.1.24,2,602,0,0,2,602,0.616618000,1.2548
138.98.214.132,<->,134.12.85.89,2,106,0,0,2,106,0.616402000,0.4582
136.25.189.46,<->,112.220.198.95,2,1253,0,0,2,1253,0.616010000,0.1641
141.15.18.19,<->,111.147.79.227,0,0,2,100,2,100,0.615487000,0.0000
124.176.118.187,<->,80.41.16.173,0,0,2,128,2,128,0.614339000,1.0048
144.75.218.241,<->,138.127.224.101,2,167,0,0,2,167,0.613930000,0.6289
200.174.214.48,<->,100.176.233.172,2,212,0,0,2,212,0.613566000,0.3347
215.158.239.58,<->,196.95.63.215,2,112,0,0,2,112,0.613097000,0.1995
100.247.37.21,<->,8.220.202.31,0,0,2,106,2,106,0.613069000,0.2944
207.4.95.36,<->,8.220.178.73,0,0,2,100,2,100,0.612876000,0.0000
207.4.95.36,<->,8.52.187.74,0,0,2,100,2,100,0.612667000,0.1409
203.58.217.99,<->,136.25.188.236,0,0,2,100,2,100,0.612562000,0.3572
215.158.239.76,<->,199.106.245.8,2,658,0,0,2,658,0.611995000,0.8812
235.42.34.34,<->,136.25.188.252,0,0,2,1365,2,1365,0.611426000,0.1398
91.248.126.109,<->,8.252.222.45,0,0,2,1541,2,1541,0.611382000,0.1618
204.186.4.18,<->,136.25.188.45,0,0,2,112,2,112,0.610996000,0.9198
207.4.95.36,<->,8.52.180.22,0,0,2,100,2,100,0.610967000,0.0000
144.75.218.237,<->,138.127.230.221,2,167,0,0,2,167,0.610477000,0.1702
199.11.106.188,<->,111.181.118.27,0,0,2,100,2,100,0.610398000,0.2198
48.17.37.157,<->,8.252.221.197,0,0,2,112,2,112,0.610377000,0.1557
137.47.204.97,<->,8.220.188.50,0,0,2,949,2,949,0.610354000,0.0213
215.158.239.205,<->,109.126.137.212,2,797,0,0,2,797,0.610231000,0.0021
142.244.64.7,<->,136.25.188.52,0,0,2,100,2,100,0.609995000,0.0022
210.229.230.19,<->,97.208.112.127,2,118,0,0,2,118,0.609920000,0.2516
129.224.112.252,<->,92.162.219.24,2,158,0,0,2,158,0.609766000,0.2917
111.151.106.254,<->,97.126.31.86,0,0,2,112,2,112,0.609702000,0.0000
196.29.127.255,<->,50.224.76.235,0,0,2,106,2,106,0.609540000,0.1948
207.172.230.55,<->,136.25.188.177,0,0,2,128,2,128,0.608753000,0.6352
199.80.37.144,<->,136.25.188.174,0,0,2,143,2,143,0.608621000,0.0010
100.108.68.20,<->,8.52.187.176,0,0,2,752,2,752,0.606844000,0.0597
204.61.94.233,<->,136.25.188.175,0,0,2,106,2,106,0.606816000,0.2114
215.158.239.59,<->,142.204.2.84,2,1285,0,0,2,1285,0.606111000,0.1720
141.20.135.250,<->,97.126.104.141,0,0,2,100,2,100,0.605437000,0.2796
195.54.94.157,<->,136.25.188.46,0,0,2,220,2,220,0.604460000,1.3804
210.229.230.19,<->,97.245.247.173,2,118,0,0,2,118,0.604109000,0.2656
136.25.189.16,<->,113.143.223.204,2,1285,0,0,2,1285,0.604058000,0.1440
92.27.194.117,<->,40.220.45.84,2,100,0,0,2,100,0.603160000,0.0016
215.158.239.77,<->,207.236.60.36,2,106,0,0,2,106,0.602602000,0.2439
204.186.4.18,<->,136.25.188.253,0,0,2,112,2,112,0.602088000,0.8995
129.224.112.252,<->,74.1.12.192,2,162,0,0,2,162,0.601739000,0.0716
195.71.154.29,<->,136.25.188.243,0,0,2,100,2,100,0.601347000,0.0017
129.78.116.178,<->,76.100.65.212,2,100,0,0,2,100,0.600712000,0.2473
215.158.238.196,<->,8.222.6.193,2,1121,0,0,2,1121,0.600670000,0.0361
215.158.61.145,<->,136.25.189.196,0,0,2,456,2,456,0.600378000,0.1745
215.158.239.95,<->,195.54.42.181,2,100,0,0,2,100,0.598923000,0.1254
57.133.195.242,<->,8.20.87.175,0,0,2,100,2,100,0.598816000,1.0000
17.137.123.140,<->,8.20.87.144,0,0,2,106,2,106,0.598546000,0.0310
125.10.47.171,<->,80.40.24.45,0,0,2,1258,2,1258,0.597787000,0.0105
215.158.238.81,<->,131.144.113.181,2,1109,0,0,2,1109,0.597652000,0.2010
215.158.238.96,<->,126.219.102.245,2,1157,0,0,2,1157,0.597629000,0.9831
133.178.227.16,<->,69.150.168.254,2,1301,0,0,2,1301,0.597257000,0.2610
215.158.239.86,<->,143.128.151.156,2,112,0,0,2,112,0.597218000,0.9414
195.70.145.112,<->,136.25.188.53,0,0,2,120,2,120,0.595697000,0.2348
207.178.147.200,<->,139.193.141.209,0,0,2,595,2,595,0.595202000,0.3967
199.15.129.188,<->,136.25.188.196,0,0,2,150,2,150,0.594156000,0.1803
143.134.194.117,<->,136.25.188.220,0,0,2,100,2,100,0.594053000,0.3318
144.85.170.254,<->,139.36.58.189,2,136,0,0,2,136,0.593838000,1.0336
215.158.239.84,<->,199.20.30.122,2,136,0,0,2,136,0.592209000,0.1199
89.155.187.166,<->,35.56.97.26,0,0,2,112,2,112,0.591795000,1.0025
215.158.140.75,<->,192.226.161.99,2,1498,0,0,2,1498,0.591786000,0.3104
220.20.200.91,<->,131.45.239.178,2,576,0,0,2,576,0.589045000,0.0027
120.83.221.8,<->,92.162.252.202,0,0,2,100,2,100,0.589027000,0.1064
136.25.189.2,<->,126.219.49.40,2,1269,0,0,2,1269,0.588678000,0.2192
215.158.239.84,<->,196.93.145.51,2,136,0,0,2,136,0.588217000,0.6398
148.180.97.178,<->,136.25.188.162,0,0,2,106,2,106,0.587708000,0.2979
222.31.62.153,<->,8.52.182.119,0,0,2,100,2,100,0.587640000,0.0536
136.25.189.29,<->,8.47.120.219,2,1269,0,0,2,1269,0.587596000,0.2558
215.158.239.92,<->,143.44.172.165,2,100,0,0,2,100,0.586718000,0.2505
215.158.238.250,<->,149.254.114.124,2,1233,0,0,2,1233,0.586356000,0.1299
131.45.239.182,<->,92.162.253.146,0,0,2,100,2,100,0.585332000,0.0872
215.158.239.86,<->,199.20.29.185,2,136,0,0,2,136,0.585259000,0.9005
207.56.56.235,<->,136.25.188.45,0,0,2,100,2,100,0.584719000,0.2018
80.40.53.91,<->,38.88.3.40,2,100,0,0,2,100,0.584590000,0.9500
118.87.143.91,<->,92.27.219.169,0,0,2,108,2,108,0.584446000,0.8061
128.145.161.120,<->,8.220.179.243,0,0,2,373,2,373,0.584442000,0.1991
144.87.235.131,<->,124.62.152.8,2,176,0,0,2,176,0.584132000,1.0218
215.158.239.93,<->,194.251.93.183,2,100,0,0,2,100,0.584017000,0.1630
215.158.239.85,<->,143.44.172.165,2,100,0,0,2,100,0.583216000,0.2859
215.158.239.86,<->,199.20.6.130,2,947,0,0,2,947,0.582547000,0.0000
207.59.241.128,<->,136.25.188.241,0,0,2,128,2,128,0.582224000,1.0145
50.224.121.247,<->,48.130.165.6,2,100,0,0,2,100,0.582005000,1.0400
50.224.76.234,<->,48.15.234.169,2,120,0,0,2,120,0.581870000,0.2998
80.41.244.231,<->,8.45.175.127,2,1338,0,0,2,1338,0.581829000,0.0537
246.253.252.58,<->,133.185.237.41,2,248,0,0,2,248,0.581746000,1.1681
207.172.142.252,<->,136.25.188.253,0,0,2,112,2,112,0.581222000,0.8405
109.222.200.111,<->,82.239.211.136,2,100,0,0,2,100,0.577764000,1.2243
80.27.155.117,<->,78.46.139.109,2,100,0,0,2,100,0.577243000,0.2615
215.158.239.84,<->,199.20.23.105,2,149,0,0,2,149,0.577136000,0.0100
139.163.169.232,<->,133.178.226.234,0,0,2,112,2,112,0.576739000,0.0266
50.224.76.234,<->,33.135.86.33,2,106,0,0,2,106,0.576476000,0.1409
215.158.239.87,<->,204.1.158.85,2,100,0,0,2,100,0.576463000,0.4134
220.7.96.19,<->,139.163.41.64,0,0,2,120,2,120,0.576434000,0.0223
142.253.70.241,<->,136.25.188.243,0,0,2,106,2,106,0.575677000,0.7180
192.171.13.33,<->,8.252.222.171,0,0,2,567,2,567,0.575163000,0.0238
201.192.214.122,<->,139.163.96.103,0,0,2,762,2,762,0.573989000,0.1900
48.115.165.110,<->,8.252.221.221,0,0,2,112,2,112,0.573752000,0.1398
215.158.239.99,<->,143.44.172.165,2,100,0,0,2,100,0.573650000,0.2502
204.17.80.168,<->,8.52.185.168,0,0,2,112,2,112,0.573121000,1.3746
136.25.189.90,<->,135.228.221.200,2,1429,0,0,2,1429,0.573102000,0.2989
95.246.219.52,<->,8.252.222.207,0,0,2,112,2,112,0.572997000,0.0021
215.158.238.143,<->,57.227.83.196,2,1413,0,0,2,1413,0.572884000,0.0959
215.158.239.70,<->,192.224.21.11,2,1285,0,0,2,1285,0.572707000,0.0362
92.26.148.165,<->,14.124.15.109,0,0,2,100,2,100,0.572446000,0.0589
92.27.4.165,<->,80.40.123.105,0,0,2,106,2,106,0.571564000,0.1316
129.224.112.252,<->,97.242.126.180,2,164,0,0,2,164,0.570958000,0.0649
215.158.239.56,<->,199.20.30.214,2,120,0,0,2,120,0.570737000,0.7600
215.158.239.77,<->,196.93.20.235,2,168,0,0,2,168,0.570608000,0.3234
103.17.11.235,<->,101.122.134.124,0,0,2,1546,2,1546,0.569971000,0.0009
215.158.140.229,<->,48.131.159.6,2,1301,0,0,2,1301,0.569706000,0.1710
218.4.179.37,<->,159.42.43.102,2,112,0,0,2,112,0.569677000,0.0541
142.254.141.3,<->,136.25.188.226,0,0,2,143,2,143,0.569612000,0.1025
197.7.105.28,<->,8.182.243.141,0,0,2,112,2,112,0.569099000,0.7409
192.67.159.184,<->,109.219.207.0,2,381,0,0,2,381,0.568878000,0.0331
192.179.6.68,<->,109.222.200.27,0,0,2,128,2,128,0.568823000,1.0030
195.6.215.218,<->,136.25.188.225,0,0,2,100,2,100,0.568231000,0.0004
136.221.24.202,<->,133.178.226.212,0,0,2,112,2,112,0.568014000,0.0000
142.207.206.132,<->,136.25.188.237,0,0,2,100,2,100,0.567606000,0.1803
101.126.181.46,<->,98.165.75.39,2,100,0,0,2,100,0.567290000,0.0930
136.25.189.82,<->,133.224.119.33,2,1285,0,0,2,1285,0.566787000,0.0266
204.56.119.73,<->,136.25.188.225,0,0,2,100,2,100,0.566168000,0.1324
202.33.240.214,<->,136.25.188.227,0,0,2,137,2,137,0.566167000,0.0000
89.183.104.135,<->,38.251.245.90,2,108,0,0,2,108,0.565151000,0.7270
33.245.237.81,<->,20.115.209.25,0,0,2,513,2,513,0.564886000,0.0239
142.249.86.142,<->,136.25.188.174,0,0,2,953,2,953,0.564842000,0.0000
207.175.3.33,<->,136.25.188.160,0,0,2,112,2,112,0.564193000,0.2501
207.127.112.235,<->,92.27.194.147,0,0,2,112,2,112,0.564170000,0.1579
142.189.65.141,<->,8.20.87.153,0,0,2,112,2,112,0.563887000,0.1617
215.158.239.42,<->,8.241.236.248,2,1533,0,0,2,1533,0.563117000,0.1151
99.167.60.63,<->,92.27.219.179,0,0,2,307,2,307,0.562799000,0.0012
215.158.239.76,<->,199.20.28.3,2,631,0,0,2,631,0.562697000,1.3891
123.189.152.133,<->,92.27.219.178,0,0,2,108,2,108,0.562432000,0.6569
215.158.239.70,<->,143.10.57.201,2,112,0,0,2,112,0.562283000,0.1545
215.158.239.79,<->,199.20.30.147,2,1186,0,0,2,1186,0.562139000,1.1100
195.68.147.176,<->,136.25.188.209,0,0,2,120,2,120,0.561043000,0.1999
231.143.11.100,<->,136.25.188.239,0,0,2,434,2,434,0.560823000,0.9601
143.10.177.55,<->,136.25.188.220,0,0,2,106,2,106,0.560381000,0.1998
204.62.101.33,<->,136.25.188.177,0,0,2,120,2,120,0.560329000,0.2504
199.20.12.255,<->,50.224.76.234,0,0,2,120,2,120,0.560313000,0.2742
192.64.229.17,<->,127.161.246.238,2,132,0,0,2,132,0.559467000,1.0219
115.161.92.138,<->,50.224.76.248,0,0,2,100,2,100,0.559240000,0.1265
215.158.239.120,<->,131.4.236.16,2,252,0,0,2,252,0.559152000,0.0008
215.158.140.229,<->,76.100.141.52,2,1145,0,0,2,1145,0.558833000,0.2511
220.20.200.140,<->,53.231.25.14,2,100,0,0,2,100,0.558148000,0.1725
215.158.238.132,<->,104.3.163.105,2,1429,0,0,2,1429,0.557626000,0.1373
192.67.139.111,<->,87.9.230.170,2,272,0,0,2,272,0.557625000,0.8421
210.229.230.18,<->,100.107.26.137,2,136,0,0,2,136,0.557410000,0.2497
196.102.141.221,<->,101.70.118.242,0,0,2,268,2,268,0.556194000,0.5804
119.112.101.8,<->,92.162.253.132,0,0,2,337,2,337,0.555854000,0.1827
215.158.239.70,<->,128.69.139.87,2,1269,0,0,2,1269,0.555820000,0.1733
248.239.187.11,<->,8.45.175.127,2,371,0,0,2,371,0.555557000,0.0013
133.32.39.21,<->,111.151.109.36,2,112,0,0,2,112,0.555409000,0.0000
142.248.11.171,<->,136.25.188.163,0,0,2,100,2,100,0.554219000,0.1999
132.249.70.213,<->,22.50.105.63,2,266,0,0,2,266,0.553933000,0.1690
159.0.4.237,<->,136.25.188.173,0,0,2,112,2,112,0.553562000,0.0289
204.248.217.8,<->,0.195.210.44,0,0,2,149,2,149,0.553305000,0.4960
98.197.187.143,<->,97.126.113.135,0,0,2,100,2,100,0.553292000,0.0000
194.232.206.196,<->,136.25.188.163,0,0,2,106,2,106,0.553149000,0.1515
215.158.239.57,<->,212.70.217.127,2,1381,0,0,2,1381,0.552012000,0.0219
215.158.239.70,<->,120.154.225.187,2,1237,0,0,2,1237,0.551710000,0.1569
98.67.155.83,<->,82.193.202.117,2,112,0,0,2,112,0.551357000,0.1446
143.128.136.111,<->,136.25.188.238,0,0,2,100,2,100,0.550560000,0.1752
113.206.203.173,<->,89.153.90.223,0,0,2,126,2,126,0.550553000,0.0008
221.102.143.189,<->,80.42.169.109,0,0,2,197,2,197,0.550048000,0.0000
141.118.203.107,<->,8.252.221.198,0,0,2,100,2,100,0.549879000,0.1494
99.215.70.35,<->,8.182.251.218,0,0,2,100,2,100,0.549528000,0.0394
136.25.188.177,<->,131.36.198.43,2,112,0,0,2,112,0.549297000,0.2005
249.101.113.138,<->,144.95.111.109,2,117,0,0,2,117,0.548653000,1.3601
195.5.243.115,<->,136.25.188.46,0,0,2,100,2,100,0.548412000,0.0016
197.7.105.212,<->,8.182.232.70,0,0,2,128,2,128,0.548290000,1.0824
98.216.123.160,<->,92.27.27.182,0,0,2,108,2,108,0.548091000,0.5967
247.136.209.19,<->,74.249.86.136,2,112,0,0,2,112,0.547471000,0.0006
215.158.140.19,<->,129.222.39.232,2,112,0,0,2,112,0.547102000,0.0221
89.183.104.156,<->,33.57.78.35,2,100,0,0,2,100,0.546801000,0.6482
223.115.143.166,<->,8.252.221.221,0,0,2,106,2,106,0.546343000,1.3553
27.11.210.203,<->,8.220.176.253,0,0,2,112,2,112,0.545787000,0.1169
144.75.218.233,<->,141.37.226.86,2,174,0,0,2,174,0.545007000,0.3021
210.229.230.19,<->,138.55.235.100,2,118,0,0,2,118,0.544222000,0.2342
223.114.221.180,<->,8.252.222.210,0,0,2,118,2,118,0.543497000,0.1647
89.85.89.215,<->,8.252.222.185,0,0,2,1269,2,1269,0.543306000,0.1198
89.204.29.47,<->,8.183.25.124,0,0,2,238,2,238,0.542746000,0.0226
215.158.239.76,<->,196.1.201.10,2,112,0,0,2,112,0.542284000,0.3799
92.27.219.184,<->,78.44.15.199,2,100,0,0,2,100,0.542048000,0.0006
119.185.122.12,<->,92.27.219.247,0,0,2,108,2,108,0.541875000,0.7236
215.158.239.57,<->,199.20.115.146,2,100,0,0,2,100,0.541115000,0.1557
199.71.118.141,<->,136.25.188.252,0,0,2,106,2,106,0.540964000,0.2124
57.31.50.25,<->,8.252.223.175,0,0,2,966,2,966,0.540502000,0.0916
80.38.16.208,<->,36.116.107.116,2,100,0,0,2,100,0.540329000,0.0003
215.158.239.8,<->,8.220.7.141,2,252,0,0,2,252,0.539914000,0.0021
142.214.141.181,<->,92.27.219.197,0,0,2,108,2,108,0.539678000,1.1863
246.253.198.51,<->,113.48.139.170,2,100,0,0,2,100,0.539492000,0.0176
215.158.239.48,<->,199.20.7.109,2,112,0,0,2,112,0.539249000,0.2898
199.20.12.72,<->,92.27.194.147,0,0,2,100,2,100,0.538935000,0.1505
106.19.13.203,<->,100.92.204.94,0,0,2,100,2,100,0.538724000,0.6464
215.158.239.36,<->,56.115.251.18,2,112,0,0,2,112,0.537801000,0.0209
111.151.106.229,<->,8.252.221.100,0,0,2,112,2,112,0.537751000,0.0000
215.158.238.33,<->,113.23.104.247,2,1221,0,0,2,1221,0.535705000,0.1404
92.27.219.39,<->,33.227.94.168,2,662,0,0,2,662,0.535430000,0.9887
204.200.32.173,<->,136.25.188.252,0,0,2,100,2,100,0.535247000,0.1479
215.158.238.102,<->,100.224.166.158,2,561,0,0,2,561,0.534898000,0.1732
143.251.236.204,<->,0.195.210.46,0,0,2,1470,2,1470,0.534471000,1.4245
133.178.226.61,<->,8.191.14.19,2,1366,0,0,2,1366,0.534434000,0.0336
126.198.147.25,<->,100.93.141.169,0,0,2,392,2,392,0.534426000,0.1296
119.45.4.11,<->,92.162.253.75,0,0,2,100,2,100,0.533810000,0.1065
204.43.228.82,<->,50.224.76.234,0,0,2,106,2,106,0.533525000,0.1413
194.44.234.10,<->,92.27.219.139,0,0,2,108,2,108,0.533222000,0.7590
231.142.162.108,<->,215.158.239.76,0,0,2,135,2,135,0.533156000,0.3881
195.71.132.1,<->,136.25.188.253,0,0,2,100,2,100,0.533036000,0.1222
6.145.166.38,<->,0.195.210.46,0,0,2,137,2,137,0.532608000,0.0999
197.45.243.206,<->,92.27.27.170,0,0,2,151,2,151,0.532399000,0.0000
195.70.80.153,<->,136.25.188.227,0,0,2,106,2,106,0.530993000,0.2705
220.20.200.33,<->,127.62.25.159,2,100,0,0,2,100,0.530708000,0.1397
231.140.144.102,<->,136.25.188.220,0,0,2,100,2,100,0.530341000,0.1688
129.68.193.194,<->,8.220.188.50,0,0,2,100,2,100,0.530160000,0.0295
215.158.239.35,<->,8.252.253.196,2,1507,0,0,2,1507,0.530038000,0.1410
199.15.240.242,<->,136.25.188.241,0,0,2,100,2,100,0.529668000,0.0020
109.93.139.198,<->,8.220.189.63,0,0,2,100,2,100,0.529594000,0.0460
8.182.228.191,<->,6.20.18.188,2,100,0,0,2,100,0.529551000,0.1641
133.8.10.152,<->,33.233.141.55,0,0,2,1468,2,1468,0.528760000,0.3028
143.13.42.97,<->,136.25.188.176,0,0,2,100,2,100,0.527595000,0.0010
143.129.40.246,<->,136.25.188.198,0,0,2,135,2,135,0.526723000,0.4035
231.143.33.171,<->,92.27.194.147,0,0,2,112,2,112,0.526513000,0.0001
204.187.246.97,<->,136.25.188.209,0,0,2,144,2,144,0.525807000,0.6799
215.158.239.93,<->,29.212.198.183,2,1269,0,0,2,1269,0.525688000,0.2243
133.178.226.76,<->,112.220.206.116,2,149,0,0,2,149,0.525648000,0.0000
136.25.188.236,<->,29.211.6.61,2,1191,0,0,2,1191,0.525377000,0.3947
215.158.239.57,<->,119.168.0.57,2,1429,0,0,2,1429,0.525319000,0.1407
139.163.20.196,<->,97.53.8.224,2,100,0,0,2,100,0.525062000,0.8801
69.246.48.221,<->,8.252.222.49,0,0,2,100,2,100,0.525029000,0.1520
117.7.29.229,<->,50.224.76.234,0,0,2,106,2,106,0.524275000,0.3370
220.0.242.22,<->,92.27.219.32,0,0,2,104,2,104,0.524003000,0.0106
136.25.189.12,<->,6.73.9.210,2,1461,0,0,2,1461,0.523639000,0.0318
210.229.230.19,<->,6.192.99.218,2,118,0,0,2,118,0.523474000,0.2491
110.86.201.155,<->,92.27.219.187,0,0,2,284,2,284,0.523174000,0.0000
210.156.28.9,<->,50.224.76.234,0,0,2,106,2,106,0.523143000,0.0907
92.27.219.252,<->,88.45.158.210,2,104,0,0,2,104,0.523071000,1.4463
80.41.59.232,<->,38.57.179.208,2,1917,0,0,2,1917,0.522782000,0.6580
133.178.226.212,<->,69.31.239.15,2,112,0,0,2,112,0.522691000,0.4783
92.27.219.31,<->,69.133.95.41,2,121,0,0,2,121,0.522642000,0.7057
145.76.225.245,<->,80.27.159.59,0,0,2,100,2,100,0.521537000,0.0585
72.156.38.45,<->,50.224.76.235,0,0,2,100,2,100,0.521433000,1.0552
207.60.226.150,<->,136.25.188.209,0,0,2,100,2,100,0.520627000,0.0015
215.158.239.69,<->,126.219.194.40,2,1541,0,0,2,1541,0.520578000,0.0954
159.13.153.140,<->,129.124.149.147,2,810,0,0,2,810,0.520541000,0.0004
8.182.244.237,<->,6.20.48.254,2,100,0,0,2,100,0.519858000,0.5185
144.92.163.176,<->,53.167.48.249,2,125,0,0,2,125,0.519685000,0.0000
207.172.228.166,<->,136.25.188.225,0,0,2,149,2,149,0.519585000,0.0348
97.46.187.226,<->,8.52.134.243,0,0,2,102,2,102,0.519319000,0.0623
207.57.139.216,<->,136.25.188.174,0,0,2,100,2,100,0.519169000,0.0015
215.158.239.49,<->,199.15.120.211,2,120,0,0,2,120,0.518975000,0.1695
130.2.77.218,<->,80.38.45.116,0,0,2,100,2,100,0.518696000,1.3504
97.149.111.99,<->,53.245.244.92,2,307,0,0,2,307,0.518377000,1.0740
192.67.175.129,<->,113.204.178.179,2,112,0,0,2,112,0.518170000,0.4428
215.158.239.78,<->,207.57.215.230,2,100,0,0,2,100,0.517832000,1.4517
197.113.99.27,<->,136.25.188.237,0,0,2,112,2,112,0.517807000,0.3190
105.168.113.221,<->,50.224.76.230,0,0,2,128,2,128,0.517747000,0.2075
144.75.218.241,<->,33.238.69.117,2,264,0,0,2,264,0.517392000,1.0938
141.20.135.250,<->,129.13.225.25,0,0,2,100,2,100,0.516868000,0.2637
215.158.239.48,<->,195.127.160.117,2,100,0,0,2,100,0.516239000,0.2165
215.158.102.78,<->,129.224.112.252,0,0,2,150,2,150,0.514767000,0.9577
220.20.200.145,<->,206.134.128.204,2,100,0,0,2,100,0.514707000,0.1315
133.178.226.233,<->,97.174.232.56,2,390,0,0,2,390,0.514352000,0.0195
69.246.48.221,<->,8.252.222.174,0,0,2,100,2,100,0.514032000,0.0072
206.199.183.63,<->,132.168.196.9,0,0,2,104,2,104,0.513941000,0.0107
204.61.58.190,<->,136.25.188.196,0,0,2,100,2,100,0.513752000,0.0012
215.158.239.92,<->,207.61.42.124,2,100,0,0,2,100,0.513461000,0.2881
215.158.140.27,<->,134.172.159.168,2,120,0,0,2,120,0.513083000,0.2726
231.140.186.23,<->,215.158.239.70,0,0,2,120,2,120,0.512877000,0.1741
215.158.239.49,<->,199.20.5.135,2,136,0,0,2,136,0.512750000,0.2597
199.8.138.98,<->,196.148.133.194,0,0,2,1548,2,1548,0.512628000,0.0000
215.158.239.92,<->,207.239.227.25,2,120,0,0,2,120,0.512261000,0.1619
100.182.99.11,<->,20.179.124.160,0,0,2,104,2,104,0.512158000,1.0063
68.208.141.19,<->,8.52.171.120,0,0,2,631,2,631,0.512112000,0.4440
143.132.20.42,<->,136.25.188.163,0,0,2,100,2,100,0.511809000,0.2153
112.11.21.26,<->,101.70.111.86,0,0,2,164,2,164,0.511446000,1.0161
89.183.104.165,<->,64.214.35.146,2,100,0,0,2,100,0.511152000,1.0000
215.158.239.48,<->,207.61.42.124,2,100,0,0,2,100,0.511049000,0.2673
215.158.140.27,<->,60.110.124.96,2,120,0,0,2,120,0.510996000,0.2504
141.245.151.199,<->,136.47.66.197,2,174,0,0,2,174,0.510796000,0.9693
99.162.77.146,<->,54.38.184.33,2,302,0,0,2,302,0.510780000,0.6735
215.158.238.247,<->,6.15.202.155,2,136,0,0,2,136,0.510758000,1.0005
89.204.9.122,<->,8.182.253.209,0,0,2,112,2,112,0.509504000,0.0212
215.158.239.56,<->,207.61.219.141,2,106,0,0,2,106,0.509271000,0.2121
215.158.239.18,<->,122.158.246.232,2,112,0,0,2,112,0.508990000,0.1153
216.144.221.35,<->,215.158.140.207,0,0,2,477,2,477,0.506240000,0.0437
215.158.140.60,<->,131.219.110.171,2,1272,0,0,2,1272,0.505604000,0.1047
136.88.62.107,<->,136.25.188.222,0,0,2,336,2,336,0.504993000,0.0226
215.158.238.75,<->,143.20.121.128,2,1236,0,0,2,1236,0.504847000,0.2361
215.158.238.250,<->,158.85.50.137,2,1102,0,0,2,1102,0.504718000,0.1450
215.158.238.209,<->,123.166.46.220,2,1282,0,0,2,1282,0.504319000,0.1428
215.158.239.56,<->,196.94.254.108,2,124,0,0,2,124,0.504243000,0.3773
215.158.239.58,<->,199.20.31.91,2,100,0,0,2,100,0.503883000,0.2399
239.66.101.100,<->,99.72.215.157,0,0,2,1342,2,1342,0.503567000,0.9989
215.158.238.82,<->,8.191.15.11,2,1365,0,0,2,1365,0.503421000,0.0235
136.25.189.1,<->,29.211.5.249,2,1285,0,0,2,1285,0.503180000,0.1096
194.233.74.207,<->,136.25.188.46,0,0,2,112,2,112,0.503095000,0.7181
144.87.238.91,<->,8.182.252.86,0,0,2,100,2,100,0.502728000,0.0248
104.250.245.231,<->,50.224.76.230,0,0,2,106,2,106,0.502717000,0.1684
215.158.238.32,<->,122.158.49.233,2,1381,0,0,2,1381,0.502319000,0.1150
92.27.219.148,<->,78.51.0.169,2,112,0,0,2,112,0.501699000,1.3809
149.101.111.205,<->,50.224.89.239,0,0,2,147,2,147,0.501605000,0.0000
92.170.100.24,<->,50.224.76.235,0,0,2,106,2,106,0.501217000,0.0965
215.158.238.241,<->,29.214.211.1,2,1200,0,0,2,1200,0.500811000,0.1482
136.25.189.94,<->,89.90.95.217,2,120,0,0,2,120,0.499983000,0.0190
97.94.179.20,<->,80.38.57.148,0,0,2,100,2,100,0.499665000,1.1159
136.25.188.197,<->,122.158.179.43,2,1221,0,0,2,1221,0.499602000,0.1107
215.158.238.106,<->,143.227.65.185,2,1253,0,0,2,1253,0.499085000,0.1316
210.221.107.50,<->,53.191.207.209,2,112,0,0,2,112,0.498995000,1.2677
216.144.221.162,<->,215.158.140.177,0,0,2,100,2,100,0.498814000,0.0388
92.170.88.168,<->,92.27.219.31,0,0,2,181,2,181,0.498564000,0.0075
50.224.76.230,<->,33.246.111.64,2,106,0,0,2,106,0.498019000,0.1250
247.157.68.96,<->,141.111.203.119,2,162,0,0,2,162,0.497956000,0.1276
207.188.53.186,<->,136.25.188.160,0,0,2,100,2,100,0.497695000,0.0015
99.168.205.8,<->,8.52.148.157,0,0,2,100,2,100,0.497259000,0.0521
252.98.149.68,<->,140.146.142.42,2,131,0,0,2,131,0.497226000,0.0000
122.194.154.80,<->,92.27.219.31,0,0,2,108,2,108,0.496839000,0.6708
215.158.238.82,<->,112.220.206.107,2,246,0,0,2,246,0.496635000,0.1027
117.55.14.34,<->,8.182.234.114,0,0,2,100,2,100,0.496498000,0.1043
92.27.219.220,<->,38.241.37.145,2,100,0,0,2,100,0.496152000,0.9128
109.1.5.52,<->,92.160.68.135,2,100,0,0,2,100,0.496111000,0.0029
215.158.239.50,<->,199.20.31.66,2,100,0,0,2,100,0.496073000,0.0704
136.25.188.163,<->,17.137.191.252,2,106,0,0,2,106,0.495836000,0.0283
248.239.124.20,<->,27.253.69.198,2,285,0,0,2,285,0.494945000,0.2101
50.179.173.163,<->,8.43.200.206,0,0,2,100,2,100,0.494925000,0.0000
108.137.1.17,<->,0.195.210.44,0,0,2,143,2,143,0.494497000,0.0663
215.158.238.149,<->,143.155.227.33,2,120,0,0,2,120,0.494469000,0.1659
117.130.224.137,<->,92.27.27.175,0,0,2,255,2,255,0.494274000,0.0078
195.68.111.162,<->,136.25.188.241,0,0,2,173,2,173,0.494212000,0.0111
118.37.87.250,<->,92.27.219.207,0,0,2,640,2,640,0.493218000,0.7239
92.27.194.147,<->,0.230.245.252,2,124,0,0,2,124,0.491878000,0.2198
192.67.145.193,<->,33.240.23.50,2,362,0,0,2,362,0.491590000,0.0651
133.178.227.79,<->,29.212.42.226,2,1158,0,0,2,1158,0.490982000,0.2738
199.72.20.117,<->,136.25.188.209,0,0,2,100,2,100,0.490924000,0.1570
95.245.77.142,<->,8.252.222.23,0,0,2,118,2,118,0.490712000,0.1600
137.167.89.215,<->,8.220.190.86,0,0,2,100,2,100,0.489894000,0.0349
133.178.227.76,<->,8.40.51.203,2,1119,0,0,2,1119,0.489696000,0.0989
192.205.37.205,<->,133.178.226.38,0,0,2,1468,2,1468,0.489642000,0.0308
144.75.218.237,<->,53.165.133.164,2,168,0,0,2,168,0.489578000,0.6141
215.158.238.73,<->,113.23.101.139,2,112,0,0,2,112,0.489547000,0.0000
109.0.228.28,<->,4.122.107.17,2,362,0,0,2,362,0.489446000,0.0897
196.89.40.59,<->,136.25.188.208,0,0,2,106,2,106,0.489230000,0.1993
204.3.159.38,<->,136.25.188.254,0,0,2,100,2,100,0.489140000,0.0015
220.20.200.68,<->,121.105.196.56,2,100,0,0,2,100,0.488355000,0.1098
138.126.224.187,<->,92.27.219.236,0,0,2,182,2,182,0.488140000,0.5883
215.158.238.236,<->,8.241.233.59,2,1264,0,0,2,1264,0.487621000,0.1138
115.121.192.145,<->,92.27.219.237,0,0,2,187,2,187,0.486848000,1.2936
106.30.133.175,<->,0.195.210.42,0,0,2,150,2,150,0.486327000,1.2080
195.6.110.67,<->,136.25.188.220,0,0,2,112,2,112,0.486004000,0.2000
215.158.140.27,<->,159.194.55.144,2,120,0,0,2,120,0.485477000,0.0851
199.33.51.133,<->,136.25.188.198,0,0,2,100,2,100,0.485433000,0.2298
143.23.224.168,<->,136.25.188.220,0,0,2,100,2,100,0.482841000,0.1724
215.158.239.68,<->,195.80.184.102,2,168,0,0,2,168,0.482416000,0.2702
199.15.217.215,<->,136.25.188.45,0,0,2,100,2,100,0.481646000,0.0020
102.44.126.45,<->,54.37.224.223,2,364,0,0,2,364,0.481227000,0.0011
17.78.176.236,<->,8.250.148.57,0,0,2,686,2,686,0.481081000,0.1219
139.47.239.231,<->,110.109.231.156,2,216,0,0,2,216,0.480777000,1.0182
194.233.165.103,<->,136.25.188.236,0,0,2,136,2,136,0.480689000,0.1656
193.51.144.93,<->,35.56.98.12,0,0,2,100,2,100,0.480677000,1.0063
196.247.52.15,<->,136.25.188.177,0,0,2,136,2,136,0.480452000,1.0200
204.187.148.66,<->,136.25.188.209,0,0,2,124,2,124,0.479760000,0.0615
143.251.236.166,<->,0.195.210.46,0,0,2,149,2,149,0.479708000,0.0007
89.183.104.252,<->,48.110.190.201,2,104,0,0,2,104,0.479137000,1.1948
215.158.239.94,<->,149.96.171.90,2,1061,0,0,2,1061,0.479099000,0.1050
145.57.24.51,<->,50.224.76.235,0,0,2,102,2,102,0.479030000,0.0480
110.63.148.205,<->,50.224.76.248,0,0,2,118,2,118,0.479013000,0.0455
92.27.219.246,<->,33.70.22.192,2,100,0,0,2,100,0.478885000,0.8239
215.158.238.236,<->,128.194.247.54,2,1166,0,0,2,1166,0.478483000,0.1671
29.95.158.240,<->,20.199.198.133,0,0,2,128,2,128,0.477584000,0.9951
207.61.58.64,<->,136.25.188.177,0,0,2,120,2,120,0.477567000,0.3423
80.57.78.105,<->,8.252.221.181,0,0,2,120,2,120,0.477515000,0.0184
136.25.189.95,<->,96.156.169.227,2,2103,0,0,2,2103,0.476803000,0.0000
215.158.140.27,<->,68.231.30.240,2,120,0,0,2,120,0.476691000,0.2364
195.7.213.170,<->,136.25.188.163,0,0,2,112,2,112,0.476137000,0.0029
126.198.147.25,<->,100.93.44.55,0,0,2,389,2,389,0.475655000,0.1996
136.25.188.45,<->,112.220.206.107,2,1285,0,0,2,1285,0.475619000,0.0973
204.186.27.148,<->,136.25.188.222,0,0,2,120,2,120,0.475088000,0.5403
92.27.27.167,<->,42.46.193.243,2,642,0,0,2,642,0.474630000,0.0000
54.92.119.24,<->,48.54.190.23,0,0,2,104,2,104,0.474620000,0.0153
215.158.239.79,<->,199.20.4.95,2,173,0,0,2,173,0.474184000,1.0975
204.185.78.129,<->,136.25.188.199,0,0,2,296,2,296,0.473752000,0.8595
111.2.136.21,<->,8.182.252.86,0,0,2,100,2,100,0.473546000,0.0110
199.12.113.243,<->,136.25.188.198,0,0,2,611,2,611,0.473444000,0.0016
133.178.226.197,<->,6.116.14.117,2,739,0,0,2,739,0.473171000,0.0650
132.60.127.206,<->,80.41.56.251,0,0,2,318,2,318,0.473162000,1.0737
104.142.6.132,<->,80.41.53.16,0,0,2,350,2,350,0.472964000,0.0022
220.28.65.25,<->,111.147.98.142,0,0,2,165,2,165,0.472876000,0.0703
138.98.251.122,<->,99.16.186.18,2,120,0,0,2,120,0.472602000,1.0002
215.158.239.84,<->,114.25.48.60,2,1269,0,0,2,1269,0.471893000,0.2062
136.25.189.88,<->,29.209.59.164,2,1429,0,0,2,1429,0.471372000,0.1103
215.158.239.71,<->,207.97.104.223,2,100,0,0,2,100,0.470773000,0.0000
105.163.226.222,<->,92.27.219.244,0,0,2,108,2,108,0.470403000,0.6760
215.158.239.58,<->,207.115.51.177,2,100,0,0,2,100,0.470324000,0.1721
251.24.105.206,<->,8.182.227.180,0,0,2,100,2,100,0.469756000,0.0000
231.142.30.40,<->,136.25.188.163,0,0,2,112,2,112,0.469513000,0.1784
111.147.134.65,<->,97.110.90.234,2,565,0,0,2,565,0.469450000,0.0085
142.190.76.165,<->,136.25.188.252,0,0,2,228,2,228,0.468775000,0.0079
215.158.239.49,<->,106.7.35.105,2,1333,0,0,2,1333,0.468160000,0.1633
215.158.239.56,<->,142.247.252.8,2,100,0,0,2,100,0.467126000,1.0053
215.158.238.135,<->,113.23.117.105,2,1093,0,0,2,1093,0.467104000,0.1190
215.158.239.49,<->,29.213.219.95,2,1285,0,0,2,1285,0.466906000,0.1155
111.199.237.35,<->,0.195.210.44,0,0,2,143,2,143,0.466871000,0.3673
142.255.132.250,<->,136.25.188.253,0,0,2,100,2,100,0.466746000,0.0027
202.33.244.1,<->,136.25.188.174,0,0,2,100,2,100,0.466263000,0.0000
136.25.189.32,<->,69.132.46.246,2,1045,0,0,2,1045,0.466142000,0.3268
221.163.98.137,<->,92.162.253.37,0,0,2,100,2,100,0.466023000,0.0208
215.158.238.96,<->,133.73.194.32,2,1301,0,0,2,1301,0.465948000,0.0246
215.158.140.216,<->,50.239.48.167,2,112,0,0,2,112,0.465823000,0.0248
195.42.106.196,<->,136.25.188.222,0,0,2,100,2,100,0.465173000,0.1960
215.158.239.120,<->,97.4.79.164,2,514,0,0,2,514,0.465139000,0.0198
252.36.154.206,<->,8.252.222.162,0,0,2,100,2,100,0.464011000,1.4208
121.195.174.188,<->,89.183.104.166,0,0,2,104,2,104,0.463979000,0.0002
133.178.226.197,<->,102.40.147.23,2,798,0,0,2,798,0.463830000,0.0229
195.53.143.28,<->,136.25.188.173,0,0,2,136,2,136,0.463588000,1.0000
136.25.188.46,<->,75.140.207.21,2,106,0,0,2,106,0.462269000,0.3657
215.158.140.221,<->,133.20.250.202,2,288,0,0,2,288,0.461789000,0.1957
98.18.104.222,<->,80.41.4.117,0,0,2,2184,2,2184,0.461155000,0.0000
215.158.239.109,<->,80.57.208.13,2,789,0,0,2,789,0.460798000,0.0577
195.70.80.153,<->,136.25.188.174,0,0,2,106,2,106,0.460768000,0.2853
231.142.148.128,<->,215.158.239.77,0,0,2,100,2,100,0.460595000,0.1784
215.158.140.14,<->,96.150.228.178,2,355,0,0,2,355,0.460162000,0.0230
195.70.134.244,<->,136.25.188.253,0,0,2,100,2,100,0.458856000,0.0020
215.158.239.76,<->,196.91.112.113,2,136,0,0,2,136,0.458212000,0.0801
133.135.217.174,<->,92.27.235.77,0,0,2,128,2,128,0.458169000,0.9986
222.59.244.202,<->,48.53.123.29,0,0,2,104,2,104,0.458056000,0.0000
139.163.20.196,<->,99.22.236.63,2,577,0,0,2,577,0.457381000,0.0756
215.158.140.27,<->,141.57.126.191,2,120,0,0,2,120,0.456855000,0.2164
195.0.110.228,<->,50.224.76.234,0,0,2,106,2,106,0.456651000,0.1621
133.178.227.168,<->,122.158.176.232,2,2224,0,0,2,2224,0.456209000,0.1092
215.158.239.95,<->,142.208.6.43,2,135,0,0,2,135,0.456075000,0.4081
109.119.182.247,<->,8.182.244.19,0,0,2,100,2,100,0.455685000,0.0229
215.158.238.134,<->,113.23.104.247,2,1285,0,0,2,1285,0.455548000,0.4198
215.158.239.99,<->,142.208.6.43,2,135,0,0,2,135,0.454602000,0.4149
215.158.61.182,<->,8.176.8.103,0,0,2,1722,2,1722,0.453793000,0.2252
129.113.219.200,<->,92.162.253.108,0,0,2,100,2,100,0.453628000,1.1642
50.224.76.230,<->,50.136.173.211,2,106,0,0,2,106,0.453618000,0.2104
133.12.161.201,<->,8.220.176.253,0,0,2,100,2,100,0.453472000,0.0379
102.50.242.234,<->,102.45.3.188,2,809,0,0,2,809,0.453401000,0.1798
196.206.255.60,<->,136.25.188.242,0,0,2,136,2,136,0.452902000,1.4001
220.28.114.25,<->,111.147.106.141,0,0,2,324,2,324,0.452875000,1.2461
133.178.226.28,<->,8.240.116.183,2,112,0,0,2,112,0.452817000,0.0012
128.157.48.40,<->,50.224.76.234,0,0,2,106,2,106,0.452710000,0.1122
97.94.123.83,<->,92.27.219.245,0,0,2,102,2,102,0.452076000,1.3510
215.158.238.96,<->,192.204.151.99,2,1429,0,0,2,1429,0.452042000,0.2284
136.25.189.14,<->,114.25.48.55,2,1445,0,0,2,1445,0.451433000,0.1729
101.70.123.130,<->,53.201.187.127,2,112,0,0,2,112,0.451187000,0.6260
98.128.155.134,<->,8.45.175.127,2,432,0,0,2,432,0.451119000,0.0335
159.165.71.215,<->,8.45.253.203,2,120,0,0,2,120,0.450853000,0.0207
203.215.115.179,<->,118.241.252.70,2,120,0,0,2,120,0.450658000,0.1505
210.229.230.21,<->,99.203.178.222,2,118,0,0,2,118,0.450582000,0.2559
118.38.6.71,<->,50.224.80.64,0,0,2,678,2,678,0.449700000,0.1358
246.253.253.210,<->,206.72.123.108,2,250,0,0,2,250,0.449575000,0.2485
247.136.192.204,<->,133.252.81.46,2,168,0,0,2,168,0.449165000,0.9681
215.158.140.74,<->,133.213.24.157,2,118,0,0,2,118,0.448518000,0.0302
136.25.189.77,<->,8.222.58.219,2,1349,0,0,2,1349,0.448437000,0.0948
215.158.238.95,<->,146.10.166.85,2,1365,0,0,2,1365,0.448402000,0.2151
132.180.212.246,<->,129.224.112.252,0,0,2,130,2,130,0.448272000,0.3294
209.18.32.202,<->,8.220.188.50,0,0,2,112,2,112,0.448061000,0.0244
142.240.117.12,<->,136.25.188.45,0,0,2,100,2,100,0.447337000,0.3272
8.49.69.216,<->,6.122.206.86,0,0,2,1130,2,1130,0.447196000,0.4601
245.127.8.27,<->,8.182.248.147,0,0,2,100,2,100,0.446356000,0.9579
138.126.75.69,<->,133.178.226.235,0,0,2,848,2,848,0.446199000,0.0463
215.158.239.56,<->,199.20.28.139,2,112,0,0,2,112,0.446187000,0.1200
6.145.164.138,<->,0.195.210.44,0,0,2,192,2,192,0.445961000,0.1109
199.55.33.227,<->,8.182.227.180,0,0,2,100,2,100,0.445922000,0.0448
199.39.45.26,<->,136.25.188.45,0,0,2,100,2,100,0.445564000,0.1976
195.5.41.65,<->,136.25.188.241,0,0,2,100,2,100,0.445546000,0.4073
92.27.64.227,<->,8.252.222.37,0,0,2,100,2,100,0.445454000,0.1014
92.27.219.155,<->,88.122.215.244,2,108,0,0,2,108,0.444552000,0.8303
197.113.64.163,<->,136.25.188.222,0,0,2,137,2,137,0.444015000,0.0300
193.81.55.4,<->,92.162.253.244,0,0,2,100,2,100,0.443924000,0.0946
215.158.61.183,<->,8.176.8.205,0,0,2,485,2,485,0.443666000,0.0318
111.151.107.208,<->,8.252.223.245,0,0,2,112,2,112,0.443455000,0.0001
249.101.109.210,<->,136.141.44.253,2,131,0,0,2,131,0.442725000,0.9542
143.87.27.65,<->,8.52.182.119,0,0,2,112,2,112,0.442139000,0.1568
17.194.236.193,<->,8.220.188.50,0,0,2,100,2,100,0.442018000,0.4950
215.158.238.141,<->,61.34.184.244,2,1253,0,0,2,1253,0.441939000,0.2414
197.7.81.19,<->,0.195.210.42,0,0,2,135,2,135,0.441528000,0.3252
142.190.160.240,<->,136.25.188.242,0,0,2,100,2,100,0.441256000,0.2134
143.24.218.165,<->,8.20.87.206,0,0,2,100,2,100,0.440767000,0.1820
215.158.239.35,<->,8.236.31.22,2,112,0,0,2,112,0.440701000,0.0518
207.172.56.76,<->,136.25.188.252,0,0,2,658,2,658,0.440140000,0.4700
199.51.214.192,<->,136.25.188.198,0,0,2,112,2,112,0.439867000,0.3183
215.158.239.29,<->,139.161.104.175,2,1367,0,0,2,1367,0.439700000,0.0290
35.55.85.31,<->,8.182.226.78,0,0,2,2498,2,2498,0.439335000,0.6004
215.158.239.78,<->,207.61.15.197,2,135,0,0,2,135,0.439209000,0.2889
136.25.188.220,<->,131.6.152.9,2,1141,0,0,2,1141,0.439136000,0.1702
197.106.83.199,<->,136.25.188.55,0,0,2,112,2,112,0.438383000,0.1223
199.80.194.196,<->,136.25.188.174,0,0,2,102,2,102,0.437614000,1.2860
133.54.17.233,<->,106.176.164.190,2,112,0,0,2,112,0.437433000,0.6413
221.163.98.141,<->,92.162.253.191,0,0,2,100,2,100,0.437413000,0.0195
246.254.97.112,<->,139.114.139.232,2,112,0,0,2,112,0.436582000,0.0004
215.158.238.21,<->,113.23.101.68,2,1397,0,0,2,1397,0.436522000,0.1339
215.158.239.93,<->,199.20.31.143,2,1754,0,0,2,1754,0.436490000,0.0001
215.158.239.56,<->,194.237.87.119,2,120,0,0,2,120,0.435509000,0.1483
215.158.238.82,<->,113.24.246.181,2,1125,0,0,2,1125,0.435452000,0.1001
68.212.95.38,<->,8.52.164.127,0,0,2,557,2,557,0.434983000,0.4434
210.229.230.18,<->,107.111.197.177,2,136,0,0,2,136,0.434218000,0.0669
215.158.239.58,<->,196.91.91.51,2,128,0,0,2,128,0.434043000,0.9998
129.252.164.193,<->,8.252.221.249,0,0,2,112,2,112,0.433903000,0.2517
215.158.239.70,<->,193.10.94.194,2,1253,0,0,2,1253,0.433696000,0.1576
136.25.188.233,<->,0.195.253.228,2,2776,0,0,2,2776,0.433577000,0.0000
54.37.145.251,<->,48.54.44.240,0,0,2,121,2,121,0.433156000,0.0399
215.158.238.188,<->,158.85.50.154,2,1104,0,0,2,1104,0.433091000,0.1689
215.158.239.48,<->,196.1.30.11,2,100,0,0,2,100,0.433081000,0.4629
215.158.239.99,<->,196.168.209.120,2,224,0,0,2,224,0.432407000,0.1004
215.158.239.92,<->,199.20.30.40,2,658,0,0,2,658,0.431376000,0.3305
136.177.72.3,<->,92.162.253.170,0,0,2,100,2,100,0.431240000,0.0415
111.20.172.118,<->,101.224.89.174,0,0,2,669,2,669,0.431006000,0.0000
243.117.125.15,<->,129.224.112.252,0,0,2,176,2,176,0.430715000,0.2175
204.187.192.134,<->,136.25.188.178,0,0,2,597,2,597,0.429646000,0.9409
136.25.188.55,<->,84.241.241.56,2,102,0,0,2,102,0.429627000,0.4410
139.193.141.139,<->,126.198.102.162,2,143,0,0,2,143,0.429583000,0.0000
215.158.239.59,<->,57.31.99.55,2,1285,0,0,2,1285,0.429435000,0.1116
207.175.1.41,<->,136.25.188.174,0,0,2,100,2,100,0.429385000,1.5008
203.215.108.91,<->,118.241.252.70,2,128,0,0,2,128,0.429198000,0.9983
204.184.197.122,<->,136.25.188.46,0,0,2,338,2,338,0.429058000,0.2240
112.47.191.84,<->,92.27.27.180,0,0,2,367,2,367,0.428843000,0.2799
136.153.134.210,<->,8.52.222.23,0,0,2,112,2,112,0.428566000,0.0213
17.139.200.50,<->,8.220.202.151,0,0,2,112,2,112,0.428344000,0.0333
215.158.239.70,<->,196.107.190.56,2,120,0,0,2,120,0.428293000,0.1910
195.70.232.93,<->,136.25.188.242,0,0,2,100,2,100,0.427892000,0.0012
133.178.226.212,<->,80.47.228.197,2,846,0,0,2,846,0.427801000,0.0270
142.191.124.36,<->,136.25.188.163,0,0,2,100,2,100,0.426911000,0.0056
101.123.190.154,<->,56.108.244.9,2,100,0,0,2,100,0.426895000,1.3624
215.158.239.113,<->,129.222.39.87,2,112,0,0,2,112,0.426639000,0.0194
121.74.22.120,<->,92.27.27.179,0,0,2,104,2,104,0.426471000,0.0000
195.71.60.137,<->,136.25.188.238,0,0,2,100,2,100,0.426191000,0.4513
215.158.239.56,<->,196.104.107.160,2,112,0,0,2,112,0.425709000,0.1802
136.25.189.15,<->,104.154.137.20,2,1301,0,0,2,1301,0.425385000,0.1286
215.158.239.101,<->,129.222.39.143,2,112,0,0,2,112,0.425299000,0.0191
215.158.238.88,<->,145.116.209.4,2,562,0,0,2,562,0.425115000,0.0201
94.192.23.95,<->,8.252.221.237,0,0,2,100,2,100,0.424918000,0.0000
246.253.198.51,<->,112.86.88.202,2,100,0,0,2,100,0.424780000,0.0054
210.229.230.18,<->,100.31.1.3,2,118,0,0,2,118,0.424748000,0.2493
138.60.35.151,<->,8.52.176.86,0,0,2,100,2,100,0.424310000,0.0363
215.158.239.97,<->,207.191.156.69,2,100,0,0,2,100,0.423963000,0.2186
80.40.56.218,<->,54.44.62.184,2,150,0,0,2,150,0.423731000,0.0393
195.41.223.200,<->,136.25.188.209,0,0,2,100,2,100,0.423260000,0.0041
195.5.235.136,<->,136.25.188.255,0,0,2,611,2,611,0.423086000,0.0175
255.133.228.28,<->,136.25.189.94,0,0,2,200,2,200,0.422241000,0.9987
142.228.163.52,<->,136.25.188.242,0,0,2,100,2,100,0.421603000,0.1969
50.224.76.230,<->,29.133.162.130,2,106,0,0,2,106,0.421544000,0.1110
215.158.239.56,<->,196.94.111.228,2,120,0,0,2,120,0.421433000,0.2997
132.249.70.213,<->,101.87.248.103,2,251,0,0,2,251,0.421066000,0.8449
199.68.150.136,<->,136.25.188.237,0,0,2,441,2,441,0.420280000,0.4499
195.6.242.36,<->,136.25.188.175,0,0,2,617,2,617,0.419709000,1.5586
215.158.238.132,<->,89.70.190.250,2,1269,0,0,2,1269,0.419332000,0.0354
210.229.230.18,<->,100.190.211.77,2,118,0,0,2,118,0.419228000,0.2245
136.25.189.1,<->,96.156.169.212,2,1440,0,0,2,1440,0.418984000,0.1229
113.226.157.159,<->,89.183.104.157,0,0,2,104,2,104,0.418848000,0.2370
241.5.27.230,<->,215.158.239.59,0,0,2,1237,2,1237,0.418659000,0.0828
136.25.188.52,<->,38.79.163.55,2,112,0,0,2,112,0.418522000,0.0001
159.210.119.122,<->,156.151.153.183,2,100,0,0,2,100,0.418123000,0.5200
215.158.107.51,<->,8.176.8.100,0,0,2,100,2,100,0.417359000,0.0176
195.71.60.137,<->,136.25.188.178,0,0,2,100,2,100,0.417046000,0.4519
215.158.239.97,<->,196.104.227.171,2,136,0,0,2,136,0.416673000,1.0200
207.191.166.85,<->,136.25.188.160,0,0,2,100,2,100,0.416591000,0.2120
195.43.240.227,<->,136.25.188.220,0,0,2,112,2,112,0.416456000,0.2064
241.120.29.237,<->,215.158.239.59,0,0,2,1253,2,1253,0.415332000,0.0488
139.193.141.209,<->,127.106.156.222,2,565,0,0,2,565,0.414963000,0.3462
192.67.167.86,<->,87.62.187.115,2,108,0,0,2,108,0.414481000,0.7478
215.158.239.49,<->,196.91.83.56,2,112,0,0,2,112,0.413578000,0.6586
215.158.239.94,<->,122.216.233.180,2,1365,0,0,2,1365,0.413492000,0.0990
215.158.239.51,<->,207.60.16.48,2,120,0,0,2,120,0.413214000,0.5014
108.46.247.60,<->,8.220.176.253,0,0,2,100,2,100,0.412217000,0.0379
199.72.51.138,<->,136.25.188.253,0,0,2,112,2,112,0.412187000,0.2200
194.238.244.139,<->,136.25.188.53,0,0,2,100,2,100,0.411615000,0.0014
215.158.239.76,<->,204.0.191.117,2,112,0,0,2,112,0.411412000,0.3621
194.192.175.74,<->,50.223.3.228,0,0,2,120,2,120,0.411102000,0.7180
215.158.140.172,<->,109.186.239.83,2,100,0,0,2,100,0.410662000,0.0000
210.229.230.22,<->,82.122.77.131,2,118,0,0,2,118,0.410598000,0.2180
145.221.35.19,<->,8.182.250.192,0,0,2,100,2,100,0.410114000,0.0243
204.200.173.134,<->,136.25.188.241,0,0,2,106,2,106,0.410085000,0.1871
50.224.76.234,<->,42.64.124.156,2,106,0,0,2,106,0.409642000,0.1816
215.158.238.66,<->,29.211.186.149,2,1397,0,0,2,1397,0.409517000,0.1049
230.82.2.230,<->,136.99.38.188,0,0,2,136,2,136,0.409270000,0.9612
215.158.239.49,<->,142.182.53.83,2,106,0,0,2,106,0.409235000,0.1867
220.20.200.94,<->,133.248.86.103,2,1071,0,0,2,1071,0.409101000,0.1848
142.207.225.232,<->,136.25.188.254,0,0,2,112,2,112,0.408579000,1.5687
102.228.188.41,<->,50.224.80.64,0,0,2,671,2,671,0.408522000,0.0396
215.158.140.27,<->,207.88.93.31,2,120,0,0,2,120,0.408128000,0.1475
142.207.225.232,<->,136.25.188.176,0,0,2,112,2,112,0.408039000,1.5686
114.183.93.59,<->,50.224.89.241,0,0,2,1299,2,1299,0.406839000,0.1428
215.158.239.92,<->,142.182.53.83,2,106,0,0,2,106,0.406377000,0.1877
204.60.83.192,<->,136.25.188.225,0,0,2,246,2,246,0.406371000,0.7003
53.214.109.33,<->,8.228.214.88,0,0,2,143,2,143,0.406019000,0.0000
192.67.175.66,<->,75.94.222.102,2,104,0,0,2,104,0.405687000,1.0444
207.236.28.230,<->,136.25.188.252,0,0,2,100,2,100,0.405164000,0.0017
215.158.239.76,<->,196.90.47.255,2,100,0,0,2,100,0.403982000,0.2300
136.25.189.1,<->,126.219.194.155,2,1285,0,0,2,1285,0.403569000,0.0933
8.220.179.94,<->,6.101.97.58,2,106,0,0,2,106,0.403295000,0.0992
215.158.239.162,<->,111.151.237.171,2,112,0,0,2,112,0.403074000,0.0000
129.225.134.86,<->,129.225.132.224,0,0,2,1022,2,1022,0.402913000,0.0511
215.158.239.34,<->,129.252.72.175,2,112,0,0,2,112,0.402239000,0.0585
126.198.149.124,<->,99.73.248.65,0,0,2,395,2,395,0.401916000,0.1843
215.158.140.60,<->,8.192.205.87,2,1175,0,0,2,1175,0.401657000,0.1638
143.53.35.6,<->,136.25.188.253,0,0,2,100,2,100,0.401090000,0.0020
139.163.81.178,<->,98.156.220.248,2,112,0,0,2,112,0.400980000,0.0551
221.102.101.45,<->,139.254.211.64,2,112,0,0,2,112,0.400162000,0.1069
221.196.122.34,<->,136.25.188.173,0,0,2,112,2,112,0.399878000,0.0578
215.158.239.50,<->,195.43.72.104,2,112,0,0,2,112,0.399840000,0.2106
192.229.210.156,<->,50.51.40.109,2,100,0,0,2,100,0.399546000,0.0002
210.229.230.18,<->,80.89.242.216,2,118,0,0,2,118,0.398915000,0.2794
215.158.140.231,<->,131.144.116.219,2,1256,0,0,2,1256,0.398875000,0.3860
221.102.102.206,<->,35.55.98.169,2,120,0,0,2,120,0.398776000,0.0221
144.75.218.246,<->,97.94.119.43,2,153,0,0,2,153,0.398060000,1.3466
143.43.237.167,<->,136.25.188.198,0,0,2,112,2,112,0.397645000,0.6893
205.225.212.78,<->,92.27.219.42,0,0,2,806,2,806,0.397621000,0.1579
126.101.55.158,<->,92.27.219.34,0,0,2,104,2,104,0.397195000,0.8476
202.161.176.199,<->,92.27.219.44,0,0,2,112,2,112,0.397098000,0.8911
204.1.132.51,<->,136.25.188.175,0,0,2,124,2,124,0.396913000,0.5804
215.158.239.76,<->,196.105.20.240,2,112,0,0,2,112,0.396401000,0.1230
215.158.140.177,<->,6.228.17.103,2,112,0,0,2,112,0.396138000,0.0018
215.158.239.56,<->,199.82.240.125,2,106,0,0,2,106,0.396030000,0.1397
110.40.13.209,<->,80.42.175.248,0,0,2,113,2,113,0.395958000,0.5507
224.234.193.175,<->,8.20.87.254,0,0,2,112,2,112,0.395888000,0.0942
215.158.239.87,<->,142.252.67.76,2,135,0,0,2,135,0.395477000,0.2515
215.158.239.97,<->,196.90.47.255,2,100,0,0,2,100,0.395443000,0.2404
195.4.253.98,<->,136.25.188.174,0,0,2,100,2,100,0.394888000,0.0000
142.188.148.82,<->,20.214.92.24,0,0,2,130,2,130,0.394564000,0.9767
92.180.179.45,<->,20.194.30.147,0,0,2,260,2,260,0.394255000,0.0203
197.107.77.140,<->,136.25.188.163,0,0,2,149,2,149,0.394244000,0.0022
123.143.177.61,<->,89.183.104.227,0,0,2,1236,2,1236,0.394181000,1.1347
196.206.136.92,<->,136.25.188.199,0,0,2,124,2,124,0.393960000,0.8651
159.57.86.226,<->,144.75.218.242,0,0,2,339,2,339,0.393932000,0.6837
133.8.10.152,<->,111.20.168.154,0,0,2,1046,2,1046,0.393481000,1.3615
203.215.187.164,<->,118.241.252.70,2,120,0,0,2,120,0.393390000,0.1544
221.163.98.137,<->,92.162.252.202,0,0,2,100,2,100,0.393228000,0.0196
136.99.122.178,<->,66.246.165.183,2,440,0,0,2,440,0.392547000,0.4760
215.158.239.87,<->,142.255.139.49,2,112,0,0,2,112,0.391931000,0.0012
221.102.120.63,<->,100.241.191.28,2,112,0,0,2,112,0.391898000,0.0239
215.158.239.84,<->,199.20.31.200,2,100,0,0,2,100,0.391227000,0.0000
204.63.234.140,<->,136.25.188.198,0,0,2,128,2,128,0.391043000,1.1792
64.77.204.181,<->,0.195.210.44,0,0,2,143,2,143,0.390824000,0.3302
198.228.207.244,<->,97.198.98.33,0,0,2,100,2,100,0.390389000,0.8442
88.1.23.205,<->,0.195.210.42,0,0,2,136,2,136,0.390109000,1.1649
215.158.239.48,<->,199.20.30.143,2,100,0,0,2,100,0.389965000,0.0000
54.37.1.37,<->,48.54.158.36,0,0,2,513,2,513,0.389921000,0.0119
133.178.226.178,<->,8.240.247.85,2,700,0,0,2,700,0.389865000,0.9153
215.158.239.99,<->,199.20.29.24,2,688,0,0,2,688,0.387818000,0.5238
158.85.50.66,<->,133.178.227.14,0,0,2,1266,2,1266,0.387275000,0.1341
82.196.213.153,<->,8.20.87.210,0,0,2,558,2,558,0.386953000,0.1255
142.253.237.24,<->,136.25.188.238,0,0,2,100,2,100,0.386142000,0.1867
132.3.107.145,<->,78.49.145.199,2,100,0,0,2,100,0.385291000,1.2190
200.175.157.151,<->,53.213.200.116,2,570,0,0,2,570,0.384623000,1.3102
138.98.178.182,<->,116.108.180.63,2,100,0,0,2,100,0.384580000,0.3427
215.158.239.69,<->,196.91.130.166,2,128,0,0,2,128,0.384526000,1.2812
215.158.239.48,<->,199.20.5.98,2,1158,0,0,2,1158,0.384432000,0.0782
108.33.74.50,<->,50.224.76.234,0,0,2,106,2,106,0.384427000,0.0830
17.61.227.235,<->,8.220.179.94,0,0,2,100,2,100,0.384292000,0.0317
215.158.239.79,<->,204.0.222.35,2,152,0,0,2,152,0.384123000,1.5402
215.158.140.231,<->,48.131.157.1,2,1172,0,0,2,1172,0.383965000,0.1450
215.158.140.60,<->,48.131.159.5,2,1170,0,0,2,1170,0.383945000,0.1958
215.158.239.56,<->,194.251.72.11,2,100,0,0,2,100,0.383755000,0.1535
192.67.181.145,<->,100.224.242.186,2,147,0,0,2,147,0.383434000,0.0000
196.88.26.109,<->,136.25.188.53,0,0,2,100,2,100,0.383229000,0.9074
215.158.140.27,<->,193.4.149.154,2,120,0,0,2,120,0.383155000,0.1225
215.158.238.90,<->,100.224.166.163,2,562,0,0,2,562,0.382586000,0.4792
215.158.239.79,<->,199.106.131.135,2,112,0,0,2,112,0.382523000,0.0424
64.104.131.193,<->,53.167.176.27,2,100,0,0,2,100,0.382393000,1.0469
113.173.255.26,<->,80.42.129.116,0,0,2,126,2,126,0.382100000,0.3282
86.192.9.193,<->,0.195.210.24,0,0,2,149,2,149,0.381873000,0.0000
215.158.239.50,<->,199.97.194.182,2,1333,0,0,2,1333,0.381776000,0.1847
144.75.218.235,<->,139.252.1.242,2,342,0,0,2,342,0.381655000,0.2937
196.21.39.101,<->,92.27.27.148,0,0,2,100,2,100,0.381286000,0.5050
215.158.140.27,<->,133.73.194.16,2,120,0,0,2,120,0.381283000,0.0205
192.67.148.242,<->,38.170.229.4,2,100,0,0,2,100,0.380908000,1.3594
105.106.93.106,<->,92.27.219.41,0,0,2,112,2,112,0.380837000,0.7424
78.128.203.22,<->,39.15.169.14,0,0,2,174,2,174,0.380452000,0.8468
195.4.176.240,<->,136.25.188.225,0,0,2,106,2,106,0.380246000,0.2801
215.158.239.96,<->,207.63.129.34,2,112,0,0,2,112,0.379529000,0.0536
121.157.193.242,<->,92.27.219.50,0,0,2,108,2,108,0.379395000,0.5941
8.52.223.102,<->,4.7.144.163,2,106,0,0,2,106,0.378871000,0.2925
142.249.224.241,<->,136.25.188.220,0,0,2,100,2,100,0.378097000,0.0028
194.237.216.206,<->,136.25.188.243,0,0,2,100,2,100,0.378061000,0.0012
215.158.1.3,<->,136.25.188.26,0,0,2,100,2,100,0.377350000,0.0195
215.158.239.78,<->,114.94.161.207,2,1509,0,0,2,1509,0.377110000,0.1727
142.191.33.17,<->,136.25.188.45,0,0,2,228,2,228,0.376768000,0.0055
215.158.238.45,<->,29.212.195.22,2,1269,0,0,2,1269,0.376677000,0.1161
207.57.195.72,<->,136.25.188.209,0,0,2,112,2,112,0.376565000,0.3030
215.158.140.27,<->,106.7.35.103,2,120,0,0,2,120,0.376395000,0.1361
142.167.125.229,<->,136.25.188.52,0,0,2,106,2,106,0.376331000,0.0490
215.158.238.177,<->,48.131.156.68,2,1285,0,0,2,1285,0.376208000,0.1429
215.158.238.66,<->,8.220.51.155,2,1397,0,0,2,1397,0.375963000,0.2734
204.62.251.211,<->,136.25.188.238,0,0,2,160,2,160,0.375789000,0.1980
133.8.10.152,<->,33.233.141.56,0,0,2,608,2,608,0.375564000,1.2726
215.158.238.212,<->,131.141.218.103,2,322,0,0,2,322,0.375522000,0.0288
215.201.83.92,<->,54.38.254.96,2,475,0,0,2,475,0.375396000,0.0126
152.105.92.208,<->,92.181.251.39,0,0,2,266,2,266,0.374682000,1.5311
215.158.239.56,<->,204.226.80.200,2,955,0,0,2,955,0.374379000,0.0002
53.160.122.243,<->,48.52.141.31,0,0,2,128,2,128,0.374364000,1.1261
215.158.238.226,<->,120.190.31.242,2,1313,0,0,2,1313,0.373899000,0.2040
126.198.149.124,<->,100.92.202.96,0,0,2,394,2,394,0.373501000,0.1552
195.5.138.166,<->,136.25.188.45,0,0,2,100,2,100,0.373493000,0.1820
133.213.24.157,<->,8.53.11.126,0,0,2,112,2,112,0.373429000,0.0736
17.27.56.184,<->,8.220.189.81,0,0,2,100,2,100,0.373338000,0.0625
156.142.121.160,<->,8.252.221.197,0,0,2,100,2,100,0.372825000,0.1509
215.158.239.79,<->,199.20.23.224,2,1434,0,0,2,1434,0.372766000,0.7605
215.158.238.236,<->,84.203.220.167,2,1445,0,0,2,1445,0.372702000,1.5261
142.191.168.149,<->,136.25.188.162,0,0,2,680,2,680,0.372600000,0.4487
204.184.0.201,<->,136.25.188.163,0,0,2,963,2,963,0.371968000,1.3396
92.27.219.28,<->,50.21.108.183,2,108,0,0,2,108,0.371886000,0.5902
94.192.233.199,<->,8.252.221.221,0,0,2,106,2,106,0.371798000,0.1727
218.147.52.203,<->,8.176.54.2,0,0,2,112,2,112,0.371332000,0.0312
204.63.216.149,<->,136.25.188.253,0,0,2,658,2,658,0.370677000,0.1797
133.178.227.229,<->,100.224.243.73,2,345,0,0,2,345,0.370421000,0.0381
196.88.26.109,<->,136.25.188.52,0,0,2,100,2,100,0.370368000,0.9001
111.151.142.245,<->,8.252.221.72,0,0,2,112,2,112,0.369474000,0.0001
215.158.103.219,<->,138.127.231.62,2,663,0,0,2,663,0.369286000,0.0655
215.158.140.27,<->,48.114.160.224,2,120,0,0,2,120,0.368444000,0.2113
215.158.239.79,<->,199.20.6.140,2,143,0,0,2,143,0.368182000,0.0645
207.189.68.218,<->,144.93.121.10,0,0,2,224,2,224,0.368168000,1.0011
50.224.76.235,<->,29.144.125.142,2,106,0,0,2,106,0.367737000,0.3421
215.158.238.196,<->,154.183.124.176,2,1285,0,0,2,1285,0.367548000,0.2297
215.158.239.92,<->,199.20.29.132,2,100,0,0,2,100,0.367026000,0.1498
204.200.168.241,<->,136.25.188.209,0,0,2,106,2,106,0.366604000,0.1887
92.20.243.77,<->,89.183.106.73,0,0,2,100,2,100,0.365051000,1.0009
146.253.87.247,<->,144.75.218.242,0,0,2,242,2,242,0.364297000,0.3843
142.223.129.33,<->,136.25.188.173,0,0,2,112,2,112,0.363871000,0.2252
133.178.226.30,<->,6.116.14.117,2,1285,0,0,2,1285,0.363634000,0.0854
142.228.75.39,<->,136.25.188.160,0,0,2,100,2,100,0.362414000,0.4687
159.194.17.34,<->,144.85.170.246,0,0,2,112,2,112,0.362175000,0.9305
142.249.114.209,<->,136.25.188.176,0,0,2,136,2,136,0.362081000,1.0210
101.124.233.255,<->,17.98.9.54,2,328,0,0,2,328,0.361597000,0.8956
229.69.191.88,<->,92.27.219.36,0,0,2,100,2,100,0.361440000,0.1018
109.222.193.26,<->,8.232.109.12,2,1610,0,0,2,1610,0.360155000,0.0000
195.126.38.57,<->,136.25.188.177,0,0,2,100,2,100,0.360016000,0.0014
197.113.99.59,<->,136.25.188.225,0,0,2,149,2,149,0.359930000,0.0301
98.129.75.233,<->,58.43.188.9,2,413,0,0,2,413,0.359315000,0.0003
133.178.226.212,<->,80.47.228.215,2,112,0,0,2,112,0.358425000,0.4783
215.158.239.76,<->,89.80.251.9,2,1301,0,0,2,1301,0.357974000,0.1236
215.158.238.198,<->,29.211.165.35,2,1097,0,0,2,1097,0.357773000,0.1317
215.158.140.27,<->,8.192.205.47,2,120,0,0,2,120,0.357704000,0.1573
215.158.238.198,<->,215.158.6.213,2,1165,0,0,2,1165,0.355889000,0.0260
136.129.83.88,<->,100.50.96.76,2,162,0,0,2,162,0.355694000,1.0004
210.229.230.21,<->,106.252.1.239,2,186,0,0,2,186,0.355157000,1.0471
215.158.239.79,<->,143.128.227.162,2,100,0,0,2,100,0.354100000,0.1814
215.158.239.59,<->,196.93.194.68,2,112,0,0,2,112,0.354024000,0.0000
133.178.227.235,<->,80.57.138.196,2,112,0,0,2,112,0.353953000,0.0000
50.145.94.82,<->,48.55.150.61,0,0,2,239,2,239,0.353753000,0.5793
218.4.179.37,<->,159.42.43.112,2,112,0,0,2,112,0.352243000,0.1184
126.198.149.124,<->,111.146.143.209,0,0,2,391,2,391,0.352032000,0.1337
143.52.27.234,<->,136.25.188.176,0,0,2,1155,2,1155,0.351561000,0.2123
207.236.2.165,<->,136.25.188.177,0,0,2,100,2,100,0.351338000,0.1690
215.158.239.93,<->,0.34.21.10,2,1285,0,0,2,1285,0.351275000,0.0924
116.141.37.196,<->,50.224.76.235,0,0,2,100,2,100,0.350630000,0.0006
220.39.174.196,<->,215.158.239.84,0,0,2,1317,2,1317,0.350568000,0.1103
109.1.118.120,<->,80.46.139.86,2,106,0,0,2,106,0.350317000,0.8521
100.92.38.16,<->,89.205.254.2,2,741,0,0,2,741,0.350126000,0.0495
111.146.136.41,<->,53.235.185.13,2,286,0,0,2,286,0.349917000,0.0458
209.91.187.251,<->,8.52.148.104,0,0,2,451,2,451,0.349878000,0.0489
129.95.133.231,<->,8.193.65.211,0,0,2,112,2,112,0.348580000,0.0437
112.225.115.46,<->,50.224.76.235,0,0,2,100,2,100,0.348365000,0.0023
204.41.29.229,<->,8.52.227.111,0,0,2,100,2,100,0.348277000,0.0100
215.158.238.123,<->,29.211.186.213,2,112,0,0,2,112,0.348080000,0.0006
120.233.143.121,<->,92.27.219.151,0,0,2,600,2,600,0.347031000,0.0079
215.158.239.119,<->,53.210.166.146,2,257,0,0,2,257,0.346705000,0.0076
215.158.239.84,<->,204.2.66.40,2,827,0,0,2,827,0.345922000,1.6314
210.209.251.214,<->,145.16.88.13,0,0,2,531,2,531,0.345891000,0.0554
145.192.91.197,<->,8.52.178.108,0,0,2,1123,2,1123,0.345493000,0.2697
144.75.218.233,<->,53.162.176.63,2,532,0,0,2,532,0.344741000,0.4568
92.27.219.148,<->,33.57.78.65,2,112,0,0,2,112,0.344732000,1.6388
215.158.239.6,<->,8.190.216.215,2,1508,0,0,2,1508,0.344679000,0.0466
195.127.94.67,<->,136.25.188.236,0,0,2,611,2,611,0.342693000,0.0545
231.143.35.44,<->,136.25.188.177,0,0,2,168,2,168,0.342252000,0.9199
247.136.181.176,<->,38.64.107.17,2,100,0,0,2,100,0.341626000,0.7941
215.158.61.145,<->,136.25.188.41,0,0,2,1541,2,1541,0.341479000,0.0144
215.158.239.94,<->,199.20.29.73,2,112,0,0,2,112,0.340522000,0.7299
222.103.245.212,<->,221.102.118.5,0,0,2,598,2,598,0.340343000,0.0211
204.62.87.51,<->,136.25.188.53,0,0,2,136,2,136,0.339260000,0.2000
215.158.140.27,<->,88.1.225.159,2,120,0,0,2,120,0.338774000,0.2782
215.158.239.78,<->,125.84.55.30,2,1461,0,0,2,1461,0.338360000,0.1091
142.207.250.34,<->,136.25.188.198,0,0,2,135,2,135,0.336011000,0.1948
121.5.245.69,<->,101.253.111.244,0,0,2,112,2,112,0.335839000,0.0995
192.171.32.182,<->,136.25.189.14,0,0,2,1397,2,1397,0.333988000,0.1326
249.101.109.210,<->,136.141.44.252,2,116,0,0,2,116,0.333561000,0.0004
207.88.162.99,<->,8.252.222.197,0,0,2,136,2,136,0.333426000,0.0000
92.27.27.161,<->,48.111.183.109,2,104,0,0,2,104,0.333276000,0.9076
143.44.95.172,<->,136.25.188.222,0,0,2,128,2,128,0.333069000,0.7780
215.158.239.95,<->,199.20.29.121,2,163,0,0,2,163,0.332678000,0.0801
136.25.189.60,<->,96.156.169.178,2,2258,0,0,2,2258,0.332381000,0.0000
215.158.239.93,<->,195.5.144.201,2,100,0,0,2,100,0.332313000,0.2225
215.158.239.79,<->,142.223.153.67,2,163,0,0,2,163,0.332235000,0.0237
195.3.118.142,<->,8.252.222.140,0,0,2,100,2,100,0.331621000,0.2286
231.142.47.124,<->,136.25.188.45,0,0,2,100,2,100,0.331296000,0.1535
215.158.239.92,<->,142.236.244.148,2,124,0,0,2,124,0.331182000,0.6772
204.184.59.32,<->,136.25.188.226,0,0,2,120,2,120,0.330394000,1.6498
130.79.65.92,<->,8.252.222.205,0,0,2,112,2,112,0.329844000,0.0938
215.158.238.106,<->,61.35.70.231,2,1125,0,0,2,1125,0.329830000,0.2405
100.151.99.70,<->,8.52.222.23,0,0,2,1268,2,1268,0.328003000,0.1475
207.64.64.126,<->,8.182.241.177,0,0,2,100,2,100,0.327828000,0.9259
145.252.121.82,<->,119.53.190.76,2,503,0,0,2,503,0.327815000,0.0898
215.158.140.184,<->,39.189.135.157,2,100,0,0,2,100,0.327412000,0.0266
142.208.46.85,<->,136.25.188.209,0,0,2,100,2,100,0.326537000,0.1804
204.56.7.227,<->,136.25.188.226,0,0,2,100,2,100,0.326407000,0.1500
207.236.2.165,<->,136.25.188.45,0,0,2,100,2,100,0.326316000,0.1569
215.158.239.56,<->,194.232.123.252,2,106,0,0,2,106,0.326191000,1.2940
204.184.249.225,<->,136.25.188.54,0,0,2,128,2,128,0.325738000,0.7636
215.158.238.123,<->,106.188.251.194,2,1287,0,0,2,1287,0.325664000,0.1124
215.158.61.243,<->,8.176.8.246,0,0,2,485,2,485,0.325587000,0.0480
235.20.22.83,<->,215.158.239.30,0,0,2,112,2,112,0.325454000,1.4984
144.75.218.246,<->,53.200.173.149,2,468,0,0,2,468,0.325410000,0.0069
111.147.97.95,<->,53.213.141.53,2,1146,0,0,2,1146,0.325342000,0.0859
145.247.103.20,<->,8.52.186.156,0,0,2,100,2,100,0.324951000,0.0012
195.65.122.97,<->,8.182.228.158,0,0,2,100,2,100,0.324045000,0.1606
17.5.228.52,<->,8.220.185.236,0,0,2,112,2,112,0.323739000,0.0393
136.25.188.46,<->,30.73.103.146,2,118,0,0,2,118,0.323720000,0.2292
131.144.36.214,<->,80.38.25.116,0,0,2,412,2,412,0.323441000,0.9220
207.60.184.177,<->,136.25.188.222,0,0,2,102,2,102,0.323316000,0.1891
35.55.100.4,<->,8.182.244.177,0,0,2,628,2,628,0.323262000,0.0413
215.158.239.96,<->,199.69.134.39,2,100,0,0,2,100,0.322703000,0.2988
215.158.239.95,<->,199.20.30.201,2,163,0,0,2,163,0.322543000,0.1299
212.164.143.229,<->,99.164.219.173,2,675,0,0,2,675,0.322086000,0.1203
215.158.239.95,<->,196.94.240.9,2,120,0,0,2,120,0.321899000,0.9452
223.120.19.40,<->,8.252.221.221,0,0,2,112,2,112,0.321575000,0.7474
133.178.227.79,<->,106.188.253.131,2,1327,0,0,2,1327,0.321183000,0.1302
215.158.140.27,<->,106.188.193.47,2,120,0,0,2,120,0.320642000,0.1205
142.208.86.226,<->,136.25.188.253,0,0,2,240,2,240,0.320543000,0.7120
215.158.239.92,<->,143.135.145.175,2,124,0,0,2,124,0.320414000,0.9328
117.6.225.235,<->,8.31.37.174,0,0,2,1205,2,1205,0.319251000,0.0986
149.197.243.185,<->,80.38.54.169,0,0,2,849,2,849,0.319200000,0.2118
136.25.188.252,<->,113.23.104.221,2,1285,0,0,2,1285,0.318830000,0.1196
142.229.6.90,<->,136.25.188.197,0,0,2,100,2,100,0.318799000,0.5818
112.104.254.44,<->,92.27.27.165,0,0,2,112,2,112,0.318285000,0.4026
136.25.188.226,<->,122.158.51.87,2,1381,0,0,2,1381,0.318270000,0.1499
215.158.239.69,<->,199.78.55.172,2,658,0,0,2,658,0.318142000,1.2400
215.158.238.66,<->,42.226.3.104,2,112,0,0,2,112,0.317104000,0.0011
247.136.139.153,<->,78.45.177.152,2,100,0,0,2,100,0.316689000,1.5597
69.220.6.1,<->,8.252.221.206,0,0,2,112,2,112,0.316522000,0.1954
192.67.139.145,<->,107.23.207.19,2,122,0,0,2,122,0.315899000,1.5519
215.158.140.12,<->,129.222.39.198,2,112,0,0,2,112,0.315735000,0.0221
210.229.230.19,<->,129.6.176.62,2,118,0,0,2,118,0.315554000,0.2353
204.187.163.107,<->,136.25.188.255,0,0,2,896,2,896,0.314680000,0.6228
217.9.139.9,<->,132.249.70.213,0,0,2,202,2,202,0.314459000,0.0621
195.3.103.216,<->,136.25.189.34,0,0,2,1269,2,1269,0.314397000,0.2156
215.158.239.50,<->,199.20.28.175,2,112,0,0,2,112,0.314015000,1.3200
215.158.239.94,<->,199.20.28.175,2,112,0,0,2,112,0.313990000,0.6787
204.184.175.185,<->,136.25.188.243,0,0,2,112,2,112,0.313815000,1.4762
206.129.51.196,<->,192.67.186.29,0,0,2,100,2,100,0.313695000,0.6700
215.158.238.223,<->,143.155.227.33,2,112,0,0,2,112,0.313692000,0.1649
215.158.238.23,<->,29.212.199.99,2,1429,0,0,2,1429,0.313690000,0.2256
196.200.77.166,<->,50.223.3.228,0,0,2,100,2,100,0.313131000,0.0041
143.76.165.4,<->,8.182.248.147,0,0,2,917,2,917,0.313053000,0.1685
215.158.238.64,<->,29.211.186.197,2,1413,0,0,2,1413,0.312641000,0.1071
215.158.140.173,<->,92.25.107.157,2,849,0,0,2,849,0.312494000,0.4811
195.124.218.209,<->,136.25.188.176,0,0,2,124,2,124,0.312221000,0.1799
195.68.127.154,<->,136.25.188.227,0,0,2,773,2,773,0.312025000,0.4811
194.234.206.62,<->,136.25.188.46,0,0,2,120,2,120,0.311622000,0.2110
215.158.238.56,<->,156.181.149.220,2,112,0,0,2,112,0.311192000,0.0001
143.153.239.177,<->,8.20.87.181,0,0,2,106,2,106,0.310583000,0.1542
137.132.207.124,<->,99.175.107.53,0,0,2,640,2,640,0.310294000,0.0308
145.208.138.125,<->,92.27.219.204,0,0,2,2848,2,2848,0.310291000,0.2640
199.71.190.149,<->,136.25.188.177,0,0,2,100,2,100,0.310096000,0.0000
215.158.239.78,<->,114.25.48.41,2,1301,0,0,2,1301,0.309934000,0.1666
231.140.222.232,<->,136.25.188.176,0,0,2,106,2,106,0.309329000,0.2503
75.82.118.154,<->,50.224.76.248,0,0,2,100,2,100,0.309182000,0.2304
195.40.227.240,<->,136.25.188.252,0,0,2,220,2,220,0.308751000,0.2375
142.249.34.157,<->,136.25.188.174,0,0,2,135,2,135,0.308370000,0.4063
196.21.179.238,<->,102.51.148.6,0,0,2,100,2,100,0.307859000,0.7550
193.36.124.28,<->,50.224.76.230,0,0,2,106,2,106,0.307208000,0.1448
138.127.224.101,<->,97.126.26.71,0,0,2,168,2,168,0.307020000,0.4769
159.31.202.215,<->,53.201.180.80,2,186,0,0,2,186,0.306416000,1.6360
207.173.221.185,<->,136.25.188.255,0,0,2,128,2,128,0.305516000,1.2520
220.55.104.32,<->,203.120.90.182,2,598,0,0,2,598,0.305360000,0.2599
210.229.230.22,<->,97.115.82.210,2,118,0,0,2,118,0.304978000,0.2215
247.136.136.154,<->,105.69.56.207,2,128,0,0,2,128,0.304698000,0.9924
207.239.32.230,<->,136.25.188.254,0,0,2,100,2,100,0.304208000,0.0025
136.25.188.254,<->,29.214.108.91,2,1413,0,0,2,1413,0.303376000,0.1901
230.113.228.44,<->,220.83.21.43,0,0,2,266,2,266,0.302902000,0.2990
196.245.123.164,<->,136.25.188.236,0,0,2,100,2,100,0.302451000,0.0000
215.201.130.92,<->,8.182.234.12,0,0,2,106,2,106,0.302129000,0.0215
111.147.75.29,<->,53.149.56.25,2,264,0,0,2,264,0.301605000,0.3060
53.224.112.122,<->,8.228.209.115,0,0,2,836,2,836,0.300872000,0.0912
195.6.18.221,<->,136.25.188.45,0,0,2,100,2,100,0.300609000,0.3201
136.25.189.30,<->,48.129.132.211,2,1445,0,0,2,1445,0.300140000,0.1506
136.25.189.46,<->,72.23.194.200,2,112,0,0,2,112,0.300020000,0.0000
72.49.217.35,<->,8.52.225.100,0,0,2,112,2,112,0.299487000,0.0022
139.163.20.196,<->,131.124.23.163,2,628,0,0,2,628,0.299192000,0.1090
195.5.31.103,<->,136.25.188.176,0,0,2,100,2,100,0.298790000,0.0022
200.174.223.236,<->,54.59.183.69,2,128,0,0,2,128,0.298779000,1.1070
192.64.248.242,<->,144.232.206.14,2,104,0,0,2,104,0.298634000,0.3283
215.158.140.163,<->,8.222.0.246,2,239,0,0,2,239,0.297850000,0.0010
205.155.151.46,<->,92.27.27.179,0,0,2,104,2,104,0.297733000,0.6960
142.190.135.163,<->,136.25.188.253,0,0,2,106,2,106,0.297649000,0.7078
20.151.18.52,<->,0.112.13.35,2,160,0,0,2,160,0.297641000,1.0000
92.27.219.175,<->,33.57.79.36,2,113,0,0,2,113,0.297105000,0.0248
216.76.218.35,<->,109.222.193.127,0,0,2,112,2,112,0.297016000,0.0575
48.18.83.240,<->,8.252.221.199,0,0,2,118,2,118,0.296807000,1.5559
195.70.174.195,<->,136.25.188.226,0,0,2,112,2,112,0.296178000,0.0022
201.139.233.184,<->,8.252.222.51,0,0,2,100,2,100,0.295709000,0.0006
89.183.104.189,<->,27.41.227.36,2,100,0,0,2,100,0.294713000,0.4901
221.102.143.189,<->,192.66.169.73,0,0,2,197,2,197,0.294599000,0.0001
207.60.13.88,<->,136.25.188.252,0,0,2,100,2,100,0.294494000,0.3100
215.158.239.76,<->,204.61.37.99,2,100,0,0,2,100,0.294242000,0.0015
195.5.14.64,<->,136.25.188.242,0,0,2,100,2,100,0.294067000,0.1921
204.2.51.112,<->,136.25.188.163,0,0,2,136,2,136,0.292991000,0.6830
201.139.255.220,<->,8.252.221.198,0,0,2,672,2,672,0.292720000,0.1533
215.158.239.56,<->,199.38.138.165,2,112,0,0,2,112,0.292669000,0.0345
97.126.4.255,<->,27.10.94.65,2,118,0,0,2,118,0.292329000,0.0000
204.65.246.235,<->,92.27.194.147,0,0,2,112,2,112,0.291749000,0.6797
142.252.110.220,<->,136.25.188.54,0,0,2,106,2,106,0.291535000,0.6773
204.186.94.133,<->,136.25.188.225,0,0,2,658,2,658,0.291075000,0.1975
142.248.52.1,<->,136.25.188.198,0,0,2,100,2,100,0.290769000,0.2820
197.152.202.235,<->,0.195.210.46,0,0,2,1337,2,1337,0.290647000,0.3212
92.27.219.180,<->,57.116.92.187,2,230,0,0,2,230,0.290459000,0.7391
29.95.158.240,<->,20.199.198.150,0,0,2,128,2,128,0.290059000,0.9990
197.113.99.76,<->,136.25.188.226,0,0,2,136,2,136,0.289835000,1.4506
202.178.8.109,<->,80.38.61.213,0,0,2,128,2,128,0.289673000,1.0007
215.158.140.27,<->,84.209.160.103,2,120,0,0,2,120,0.289533000,0.2486
92.27.219.185,<->,88.0.194.179,2,104,0,0,2,104,0.289376000,0.4716
215.158.239.84,<->,199.20.20.251,2,100,0,0,2,100,0.289324000,0.0000
148.56.229.121,<->,136.25.189.81,0,0,2,1253,2,1253,0.289304000,0.1246
221.196.123.47,<->,136.25.188.163,0,0,2,112,2,112,0.288957000,0.2983
8.220.189.63,<->,6.101.72.29,2,100,0,0,2,100,0.288923000,0.1179
89.216.125.163,<->,53.224.84.147,2,125,0,0,2,125,0.288516000,0.0000
140.8.228.13,<->,0.195.210.42,0,0,2,100,2,100,0.288412000,0.0058
142.249.51.237,<->,136.25.188.52,0,0,2,120,2,120,0.288292000,0.2050
200.175.152.2,<->,53.213.42.33,2,169,0,0,2,169,0.288014000,0.0021
66.47.33.43,<->,8.252.222.161,0,0,2,118,2,118,0.287969000,0.1334
202.77.92.35,<->,109.1.57.73,0,0,2,329,2,329,0.287069000,0.5598
204.187.199.184,<->,136.25.188.255,0,0,2,120,2,120,0.286329000,1.1199
141.23.229.64,<->,136.25.189.57,0,0,2,1349,2,1349,0.286168000,0.3193
247.136.152.114,<->,131.2.232.125,2,659,0,0,2,659,0.286033000,0.0563
138.20.8.9,<->,8.220.202.59,0,0,2,100,2,100,0.285248000,0.1551
143.10.39.95,<->,136.25.188.52,0,0,2,102,2,102,0.284910000,0.2030
215.158.42.95,<->,133.178.226.223,0,0,2,149,2,149,0.283985000,0.0000
119.45.10.75,<->,92.162.253.119,0,0,2,100,2,100,0.283841000,0.1137
204.61.201.44,<->,136.25.188.254,0,0,2,100,2,100,0.283296000,0.1813
200.174.176.10,<->,53.213.45.75,2,100,0,0,2,100,0.282536000,0.0001
215.158.239.36,<->,138.28.170.248,2,100,0,0,2,100,0.282429000,0.1221
204.185.31.197,<->,136.25.188.226,0,0,2,124,2,124,0.282381000,0.0400
215.158.238.66,<->,89.86.110.43,2,112,0,0,2,112,0.282173000,0.0005
109.222.254.231,<->,53.201.161.188,2,1564,0,0,2,1564,0.282104000,0.0810
195.41.77.237,<->,136.25.188.198,0,0,2,106,2,106,0.281708000,0.2122
199.121.170.163,<->,136.25.188.46,0,0,2,106,2,106,0.281701000,0.1635
197.113.99.177,<->,136.25.188.55,0,0,2,228,2,228,0.281636000,0.0391
220.50.242.203,<->,215.158.239.109,0,0,2,112,2,112,0.281417000,0.0232
215.158.239.48,<->,199.122.59.17,2,120,0,0,2,120,0.280610000,0.2218
199.71.174.164,<->,136.25.188.252,0,0,2,228,2,228,0.279943000,0.0499
142.229.188.92,<->,136.25.188.163,0,0,2,112,2,112,0.279757000,0.2577
207.188.245.68,<->,136.25.188.177,0,0,2,100,2,100,0.279456000,0.2006
220.20.200.190,<->,121.105.194.40,2,622,0,0,2,622,0.279283000,0.0664
131.22.119.229,<->,92.162.253.172,0,0,2,100,2,100,0.279231000,0.1173
143.45.0.139,<->,133.178.226.31,0,0,2,1285,2,1285,0.278941000,0.1781
199.20.31.187,<->,92.27.194.147,0,0,2,319,2,319,0.278862000,0.1633
80.38.16.211,<->,54.68.57.160,2,100,0,0,2,100,0.278233000,1.4508
106.168.190.67,<->,100.93.165.206,0,0,2,450,2,450,0.277948000,0.1743
195.5.63.250,<->,136.25.188.255,0,0,2,100,2,100,0.277699000,0.2646
195.70.127.107,<->,136.25.188.210,0,0,2,100,2,100,0.277124000,0.3099
207.61.95.82,<->,136.25.188.177,0,0,2,100,2,100,0.276620000,0.0015
149.207.3.10,<->,50.224.89.243,0,0,2,310,2,310,0.276550000,0.1530
221.102.143.189,<->,192.64.92.213,0,0,2,197,2,197,0.275802000,1.3117
195.71.86.203,<->,136.25.188.211,0,0,2,100,2,100,0.275507000,0.1914
233.169.18.253,<->,136.25.188.243,0,0,2,106,2,106,0.275443000,0.0211
215.158.239.87,<->,195.55.181.10,2,100,0,0,2,100,0.275134000,0.2072
50.224.76.234,<->,29.154.193.195,2,106,0,0,2,106,0.274709000,0.1168
149.1.209.97,<->,20.207.104.91,0,0,2,276,2,276,0.274407000,0.4524
209.91.171.63,<->,8.220.190.86,0,0,2,100,2,100,0.274385000,0.0000
199.5.174.227,<->,92.27.219.51,0,0,2,104,2,104,0.273712000,0.0046
215.158.239.77,<->,207.88.93.21,2,1413,0,0,2,1413,0.273555000,0.2851
159.223.99.55,<->,8.43.182.255,0,0,2,723,2,723,0.273130000,0.3076
134.195.42.72,<->,92.27.219.39,0,0,2,112,2,112,0.273115000,1.4942
199.68.119.238,<->,136.25.188.53,0,0,2,100,2,100,0.273029000,0.0015
197.159.127.97,<->,136.25.188.220,0,0,2,143,2,143,0.272954000,0.0019
207.206.254.187,<->,102.50.110.21,0,0,2,266,2,266,0.272691000,0.6523
136.25.189.15,<->,133.146.0.147,2,1285,0,0,2,1285,0.272427000,0.0263
226.162.38.40,<->,109.1.65.112,0,0,2,435,2,435,0.272332000,0.5201
192.205.242.85,<->,133.178.226.212,0,0,2,112,2,112,0.272298000,1.1279
133.178.227.252,<->,100.50.96.80,2,949,0,0,2,949,0.271736000,0.1593
215.158.239.95,<->,195.80.53.79,2,124,0,0,2,124,0.271483000,0.4502
215.158.239.76,<->,195.49.244.36,2,112,0,0,2,112,0.271219000,1.4380
215.158.239.92,<->,199.20.30.71,2,112,0,0,2,112,0.271181000,0.3971
94.24.223.119,<->,92.27.219.180,0,0,2,104,2,104,0.271074000,0.0014
106.146.163.167,<->,89.183.104.160,0,0,2,526,2,526,0.270516000,0.1081
199.53.241.8,<->,136.25.188.178,0,0,2,100,2,100,0.270330000,0.1788
192.64.195.195,<->,113.203.146.133,2,104,0,0,2,104,0.269657000,0.8318
90.240.140.125,<->,84.4.11.134,2,150,0,0,2,150,0.269572000,1.5480
215.158.239.78,<->,207.228.66.131,2,100,0,0,2,100,0.269300000,0.4414
136.25.189.15,<->,96.156.169.213,2,1397,0,0,2,1397,0.269155000,0.1003
197.107.92.124,<->,136.25.188.55,0,0,2,202,2,202,0.268404000,0.1838
48.16.198.210,<->,8.252.221.197,0,0,2,100,2,100,0.268105000,0.1688
195.5.252.189,<->,136.25.188.174,0,0,2,106,2,106,0.267973000,0.5139
195.126.186.115,<->,136.25.188.174,0,0,2,100,2,100,0.267336000,0.7113
29.95.158.240,<->,20.199.198.157,0,0,2,128,2,128,0.266394000,0.9966
66.59.35.235,<->,8.252.221.199,0,0,2,112,2,112,0.266103000,0.1324
215.158.239.79,<->,199.82.210.15,2,106,0,0,2,106,0.265989000,0.9064
197.46.47.36,<->,8.52.178.229,0,0,2,100,2,100,0.265888000,0.2049
215.158.239.92,<->,196.88.174.103,2,112,0,0,2,112,0.265744000,0.3114
215.158.239.56,<->,196.90.141.188,2,100,0,0,2,100,0.265603000,0.3899
231.140.89.101,<->,50.224.76.230,0,0,2,106,2,106,0.265495000,0.3866
215.158.239.58,<->,199.20.30.156,2,112,0,0,2,112,0.265246000,0.2280
215.158.239.233,<->,100.244.13.14,2,903,0,0,2,903,0.265174000,0.4180
136.25.188.178,<->,131.36.198.22,2,112,0,0,2,112,0.264541000,0.0002
10.186.7.79,<->,8.52.179.217,0,0,2,100,2,100,0.264162000,0.0293
215.158.239.51,<->,199.20.31.153,2,106,0,0,2,106,0.263992000,0.4800
114.56.80.51,<->,8.52.139.192,0,0,2,589,2,589,0.263342000,0.6659
192.67.145.193,<->,134.5.66.49,2,266,0,0,2,266,0.263010000,0.6631
92.27.27.150,<->,29.241.12.238,2,100,0,0,2,100,0.262905000,1.2816
215.158.239.50,<->,57.227.83.212,2,1365,0,0,2,1365,0.262819000,0.1028
215.158.61.189,<->,8.176.8.105,0,0,2,1189,2,1189,0.262748000,0.0181
29.95.158.240,<->,20.199.198.158,0,0,2,128,2,128,0.262649000,0.9936
80.42.176.246,<->,53.90.7.85,2,132,0,0,2,132,0.262509000,1.0225
100.206.84.172,<->,92.162.253.125,0,0,2,318,2,318,0.262209000,0.0535
131.72.58.79,<->,8.53.0.43,0,0,2,106,2,106,0.262201000,0.4497
207.185.201.63,<->,92.27.219.177,0,0,2,108,2,108,0.261805000,0.6440
111.147.71.150,<->,53.245.79.95,2,181,0,0,2,181,0.260583000,0.0000
149.184.89.86,<->,136.25.189.80,0,0,2,1413,2,1413,0.260455000,0.2467
215.158.239.32,<->,6.29.97.54,2,1224,0,0,2,1224,0.259531000,0.1793
144.75.218.241,<->,138.127.225.151,2,541,0,0,2,541,0.259529000,1.0018
215.158.239.84,<->,196.104.15.90,2,100,0,0,2,100,0.258838000,0.2951
139.163.46.197,<->,121.118.167.211,2,100,0,0,2,100,0.258764000,0.9299
207.239.217.224,<->,136.25.188.225,0,0,2,100,2,100,0.258713000,0.3433
215.158.238.201,<->,53.231.140.175,2,147,0,0,2,147,0.258604000,0.0252
227.29.202.222,<->,92.27.27.178,0,0,2,208,2,208,0.258531000,0.0757
156.165.37.100,<->,136.25.189.29,0,0,2,112,2,112,0.258215000,0.0399
221.102.103.73,<->,195.85.158.128,2,581,0,0,2,581,0.257677000,0.1598
215.158.239.85,<->,135.229.0.202,2,1221,0,0,2,1221,0.257385000,0.2937
204.187.97.205,<->,136.25.188.54,0,0,2,670,2,670,0.256873000,1.1609
133.178.227.70,<->,111.150.187.244,2,1349,0,0,2,1349,0.256787000,0.2840
97.126.118.120,<->,29.223.31.98,2,114,0,0,2,114,0.256545000,0.2977
97.127.127.14,<->,54.58.183.105,2,100,0,0,2,100,0.256461000,0.5657
215.158.239.99,<->,207.213.115.149,2,112,0,0,2,112,0.256442000,0.0096
117.6.225.235,<->,8.31.37.160,0,0,2,1253,2,1253,0.256441000,0.1154
111.199.225.127,<->,0.195.210.44,0,0,2,143,2,143,0.256432000,0.2400
94.193.37.58,<->,92.181.115.14,0,0,2,266,2,266,0.256117000,1.5181
119.45.229.218,<->,97.168.127.135,0,0,2,1486,2,1486,0.256069000,0.0900
215.158.140.92,<->,48.131.158.245,2,1169,0,0,2,1169,0.255751000,0.3298
133.164.32.53,<->,54.50.173.203,2,125,0,0,2,125,0.255284000,0.0000
215.158.239.56,<->,199.20.5.43,2,821,0,0,2,821,0.254892000,1.7399
98.156.229.198,<->,8.182.226.122,0,0,2,567,2,567,0.254733000,0.0994
133.178.227.204,<->,111.151.142.208,2,168,0,0,2,168,0.254633000,0.6988
215.158.238.132,<->,198.204.78.21,2,112,0,0,2,112,0.254407000,0.0092
215.158.239.78,<->,143.128.227.162,2,100,0,0,2,100,0.254059000,0.2338
255.57.239.24,<->,247.136.235.134,0,0,2,160,2,160,0.253624000,1.1577
199.111.145.156,<->,8.182.227.180,0,0,2,100,2,100,0.253275000,0.0000
148.111.30.85,<->,144.75.218.246,0,0,2,150,2,150,0.253092000,0.4233
203.215.150.183,<->,118.241.252.70,2,128,0,0,2,128,0.253034000,0.9994
215.158.239.48,<->,142.166.235.214,2,112,0,0,2,112,0.252454000,0.0254
249.101.92.61,<->,53.245.112.116,2,941,0,0,2,941,0.252190000,0.1996
220.20.200.86,<->,35.107.149.134,2,100,0,0,2,100,0.252139000,0.0216
215.158.239.70,<->,149.254.114.228,2,1461,0,0,2,1461,0.251930000,0.1250
215.158.239.57,<->,199.20.30.40,2,658,0,0,2,658,0.251363000,0.4995
92.27.219.164,<->,88.4.24.74,2,108,0,0,2,108,0.251257000,0.7406
215.158.238.143,<->,91.57.173.62,2,112,0,0,2,112,0.250556000,0.0003
141.125.248.132,<->,0.195.210.42,0,0,2,988,2,988,0.250548000,0.2337
144.87.235.222,<->,115.151.119.83,2,100,0,0,2,100,0.250383000,0.1174
143.22.89.67,<->,8.182.226.42,0,0,2,100,2,100,0.250057000,1.0011
142.190.132.115,<->,89.183.104.230,0,0,2,104,2,104,0.249806000,0.0015
136.25.188.177,<->,32.236.216.205,2,100,0,0,2,100,0.249642000,0.0015
231.142.160.54,<->,136.25.188.53,0,0,2,106,2,106,0.249618000,0.0022
133.178.227.57,<->,29.212.192.60,2,1364,0,0,2,1364,0.249597000,0.1419
69.221.66.96,<->,8.252.221.221,0,0,2,118,2,118,0.249277000,0.1587
247.136.252.169,<->,113.203.214.122,2,119,0,0,2,119,0.248744000,1.4694
199.24.117.223,<->,8.252.222.69,0,0,2,106,2,106,0.248703000,0.1436
98.128.47.45,<->,8.45.175.127,2,371,0,0,2,371,0.248563000,0.0011
215.158.239.84,<->,195.127.171.142,2,106,0,0,2,106,0.248525000,0.2225
139.241.56.117,<->,99.72.85.186,0,0,2,472,2,472,0.248188000,1.0300
215.158.238.32,<->,113.23.21.231,2,1141,0,0,2,1141,0.247373000,0.1337
246.253.168.245,<->,57.7.1.42,2,100,0,0,2,100,0.246867000,0.0000
215.158.239.68,<->,196.92.194.31,2,136,0,0,2,136,0.246852000,1.0982
145.18.193.4,<->,128.91.191.99,2,112,0,0,2,112,0.246828000,0.0004
212.241.174.245,<->,8.220.176.253,0,0,2,100,2,100,0.246438000,0.8579
32.235.1.60,<->,8.220.202.4,0,0,2,106,2,106,0.246412000,0.0323
159.69.187.4,<->,6.147.69.18,2,149,0,0,2,149,0.246326000,0.4252
126.198.147.25,<->,100.92.93.23,0,0,2,389,2,389,0.245158000,0.1564
210.229.230.18,<->,101.194.225.29,2,118,0,0,2,118,0.244786000,0.2340
192.229.215.71,<->,4.240.210.61,2,100,0,0,2,100,0.244716000,0.2509
101.106.122.69,<->,89.183.104.189,0,0,2,456,2,456,0.244386000,0.2422
136.25.188.221,<->,61.72.108.237,2,112,0,0,2,112,0.244128000,0.0003
202.223.124.75,<->,98.129.83.35,0,0,2,266,2,266,0.243996000,0.3899
195.14.19.180,<->,136.25.188.242,0,0,2,100,2,100,0.243642000,0.0017
215.158.239.84,<->,149.184.89.90,2,1477,0,0,2,1477,0.243573000,0.1763
200.174.219.221,<->,53.68.113.123,2,138,0,0,2,138,0.243242000,0.2890
215.158.239.56,<->,195.49.202.90,2,100,0,0,2,100,0.243013000,0.0639
215.158.61.203,<->,8.176.8.203,0,0,2,1477,2,1477,0.242839000,0.1180
143.155.227.57,<->,136.25.188.226,0,0,2,1157,2,1157,0.242576000,0.1775
50.224.76.235,<->,4.241.131.82,2,100,0,0,2,100,0.242474000,0.0134
196.240.243.169,<->,136.25.188.226,0,0,2,106,2,106,0.241914000,0.2275
215.158.239.70,<->,199.80.215.24,2,106,0,0,2,106,0.241762000,0.2584
149.199.106.244,<->,92.27.219.187,0,0,2,108,2,108,0.241588000,0.7298
197.146.98.193,<->,8.20.87.144,0,0,2,112,2,112,0.241267000,0.1324
136.25.188.222,<->,41.159.226.106,2,177,0,0,2,177,0.241089000,0.0305
143.230.117.31,<->,129.224.112.252,0,0,2,153,2,153,0.240457000,1.4874
195.41.121.95,<->,136.25.188.241,0,0,2,100,2,100,0.240353000,0.0027
215.158.239.50,<->,196.93.253.247,2,120,0,0,2,120,0.240037000,1.0601
215.158.238.94,<->,57.41.134.74,2,1253,0,0,2,1253,0.239541000,0.1590
136.246.48.156,<->,89.183.104.231,0,0,2,100,2,100,0.238883000,0.8030
6.145.149.122,<->,0.195.210.44,0,0,2,143,2,143,0.238508000,0.1319
215.158.238.106,<->,192.226.161.103,2,1461,0,0,2,1461,0.238410000,0.2976
143.44.10.143,<->,136.25.188.176,0,0,2,100,2,100,0.238233000,0.4174
199.69.184.152,<->,136.25.188.198,0,0,2,643,2,643,0.238059000,0.3041
54.37.130.82,<->,48.53.20.198,0,0,2,1150,2,1150,0.237057000,0.2990
215.158.238.81,<->,29.212.195.23,2,112,0,0,2,112,0.236989000,0.0070
122.222.164.109,<->,50.224.76.234,0,0,2,100,2,100,0.236747000,0.0084
194.192.116.169,<->,50.224.76.230,0,0,2,106,2,106,0.235655000,0.2562
231.142.6.67,<->,215.158.239.94,0,0,2,120,2,120,0.235569000,0.1621
207.235.168.89,<->,50.224.76.235,0,0,2,100,2,100,0.235498000,0.0081
224.93.235.34,<->,80.27.157.12,0,0,2,100,2,100,0.234738000,0.5070
159.137.152.55,<->,133.178.226.66,0,0,2,120,2,120,0.233813000,0.0203
215.158.140.27,<->,149.161.153.103,2,120,0,0,2,120,0.233631000,0.0934
215.158.238.107,<->,8.220.51.214,2,112,0,0,2,112,0.233169000,0.0001
247.136.171.196,<->,26.218.94.114,2,179,0,0,2,179,0.232393000,0.0000
66.12.221.199,<->,8.43.215.120,0,0,2,887,2,887,0.231404000,0.4734
207.96.169.133,<->,50.224.76.234,0,0,2,106,2,106,0.231354000,0.2799
56.140.239.118,<->,35.56.101.204,0,0,2,100,2,100,0.231341000,1.0301
207.173.47.89,<->,136.25.188.176,0,0,2,152,2,152,0.230947000,0.8800
119.71.51.183,<->,92.27.219.135,0,0,2,108,2,108,0.230366000,0.7980
207.87.58.96,<->,136.25.188.254,0,0,2,202,2,202,0.230285000,0.2250
133.178.227.24,<->,8.240.116.185,2,1157,0,0,2,1157,0.228927000,0.0388
215.158.140.163,<->,120.155.87.47,2,282,0,0,2,282,0.228350000,0.2995
215.158.140.234,<->,131.141.219.100,2,322,0,0,2,322,0.228197000,0.0025
215.158.239.76,<->,196.93.196.95,2,112,0,0,2,112,0.227497000,0.3798
144.83.60.153,<->,92.162.253.31,0,0,2,100,2,100,0.227447000,0.0386
120.165.152.110,<->,92.27.219.217,0,0,2,112,2,112,0.226031000,0.0000
29.95.158.240,<->,20.199.198.181,0,0,2,128,2,128,0.225976000,0.9988
17.248.138.62,<->,8.220.190.86,0,0,2,100,2,100,0.225887000,0.0254
195.54.18.146,<->,136.25.188.242,0,0,2,106,2,106,0.225154000,0.0064
247.136.233.125,<->,100.224.242.153,2,147,0,0,2,147,0.225119000,0.0000
215.158.239.97,<->,199.20.28.218,2,112,0,0,2,112,0.225070000,0.0408
215.158.140.163,<->,111.151.107.247,2,320,0,0,2,320,0.224985000,0.0245
215.158.239.94,<->,199.20.5.151,2,228,0,0,2,228,0.224711000,0.0000
215.158.239.113,<->,215.158.42.215,2,570,0,0,2,570,0.224578000,0.0008
136.25.189.45,<->,8.252.253.190,2,1237,0,0,2,1237,0.224537000,0.1352
195.124.167.68,<->,136.25.188.226,0,0,2,112,2,112,0.224414000,1.1003
215.158.239.76,<->,199.20.30.201,2,629,0,0,2,629,0.224107000,0.1002
205.225.222.236,<->,35.56.96.142,0,0,2,112,2,112,0.223488000,0.0884
215.158.239.79,<->,199.20.29.154,2,629,0,0,2,629,0.223251000,0.5805
127.143.148.147,<->,0.195.210.42,0,0,2,100,2,100,0.222968000,0.0001
198.211.60.248,<->,50.224.76.234,0,0,2,106,2,106,0.222662000,0.6974
215.158.239.79,<->,199.20.28.44,2,120,0,0,2,120,0.222375000,0.2509
56.8.169.243,<->,8.182.226.122,0,0,2,100,2,100,0.222209000,0.0390
136.25.189.33,<->,29.211.5.121,2,1317,0,0,2,1317,0.222102000,0.1855
215.158.140.27,<->,8.219.187.239,2,120,0,0,2,120,0.221729000,0.0416
109.1.54.209,<->,18.49.202.252,2,176,0,0,2,176,0.221290000,0.2241
8.220.191.154,<->,6.124.60.228,2,100,0,0,2,100,0.220664000,0.4292
215.158.239.58,<->,143.44.228.84,2,100,0,0,2,100,0.220558000,0.3669
210.229.230.20,<->,100.63.23.85,2,118,0,0,2,118,0.220402000,0.2336
215.158.239.59,<->,207.239.97.8,2,100,0,0,2,100,0.220388000,0.0014
215.158.239.71,<->,199.66.137.180,2,1349,0,0,2,1349,0.220221000,0.1497
103.11.9.63,<->,50.224.76.235,0,0,2,106,2,106,0.219768000,0.1569
215.158.239.87,<->,195.83.63.69,2,100,0,0,2,100,0.219180000,0.0000
142.240.142.239,<->,136.25.188.44,0,0,2,112,2,112,0.218822000,0.0330
142.223.129.33,<->,136.25.188.241,0,0,2,325,2,325,0.218764000,0.0081
215.158.239.93,<->,29.212.199.58,2,1477,0,0,2,1477,0.218389000,1.7775
92.27.219.163,<->,6.118.108.124,2,1672,0,0,2,1672,0.218258000,0.0000
207.59.44.36,<->,136.25.188.177,0,0,2,106,2,106,0.217553000,0.2476
194.233.191.193,<->,136.25.188.255,0,0,2,118,2,118,0.217308000,0.1536
215.158.238.236,<->,93.39.51.107,2,1191,0,0,2,1191,0.216751000,0.2897
215.158.239.48,<->,199.20.23.174,2,100,0,0,2,100,0.216645000,0.0001
215.158.238.120,<->,27.178.41.10,2,112,0,0,2,112,0.216006000,0.0003
215.158.140.87,<->,83.232.28.226,2,100,0,0,2,100,0.215612000,0.0000
247.39.103.240,<->,35.56.98.12,0,0,2,100,2,100,0.214490000,1.0156
215.158.238.114,<->,205.37.248.14,2,1301,0,0,2,1301,0.214475000,0.1341
100.228.42.193,<->,57.18.37.133,2,805,0,0,2,805,0.214111000,0.5975
195.14.240.217,<->,136.25.188.253,0,0,2,112,2,112,0.214007000,0.0042
120.158.42.249,<->,111.147.104.245,0,0,2,100,2,100,0.213613000,0.4160
192.67.154.172,<->,103.13.74.78,2,104,0,0,2,104,0.213270000,0.0132
215.158.127.244,<->,133.178.227.27,0,0,2,1161,2,1161,0.213044000,0.0212
141.118.203.107,<->,8.252.221.205,0,0,2,585,2,585,0.212801000,0.1463
195.13.157.94,<->,136.25.188.242,0,0,2,100,2,100,0.212763000,0.6704
100.218.114.30,<->,8.252.221.249,0,0,2,100,2,100,0.212561000,0.0421
132.212.185.37,<->,80.42.130.250,0,0,2,100,2,100,0.212193000,0.0005
196.246.171.55,<->,136.25.188.173,0,0,2,658,2,658,0.212187000,1.2205
133.178.227.14,<->,38.20.151.75,2,1154,0,0,2,1154,0.212172000,0.2727
196.148.128.40,<->,148.157.241.119,2,104,0,0,2,104,0.212140000,1.4393
247.136.134.38,<->,126.198.147.25,2,680,0,0,2,680,0.211634000,1.7341
204.20.175.50,<->,136.25.188.174,0,0,2,228,2,228,0.211508000,0.5486
80.41.9.195,<->,8.49.69.216,2,179,0,0,2,179,0.211342000,0.0000
199.39.255.127,<->,136.25.188.45,0,0,2,100,2,100,0.211313000,0.0025
17.88.223.52,<->,8.220.177.152,0,0,2,100,2,100,0.210879000,0.3461
220.20.200.87,<->,33.148.97.180,2,100,0,0,2,100,0.210789000,0.1125
215.158.239.57,<->,195.81.63.66,2,124,0,0,2,124,0.210609000,0.2402
215.158.239.92,<->,199.33.230.254,2,102,0,0,2,102,0.210404000,0.1612
17.249.7.20,<->,8.220.234.159,0,0,2,112,2,112,0.210361000,0.0210
109.95.80.134,<->,50.224.89.239,0,0,2,147,2,147,0.210222000,0.0000
215.158.239.48,<->,199.20.5.10,2,112,0,0,2,112,0.210024000,0.4959
215.158.239.78,<->,142.227.0.187,2,120,0,0,2,120,0.209907000,0.6607
129.225.132.224,<->,129.225.131.156,2,715,0,0,2,715,0.209286000,0.1726
215.158.239.86,<->,196.93.217.19,2,112,0,0,2,112,0.209075000,0.5502
93.181.154.68,<->,92.27.219.151,0,0,2,106,2,106,0.208986000,0.2097
139.193.141.143,<->,132.30.97.203,2,1162,0,0,2,1162,0.208956000,0.1079
142.252.240.15,<->,136.25.188.175,0,0,2,100,2,100,0.208776000,0.0012
112.16.129.156,<->,50.224.76.234,0,0,2,102,2,102,0.208388000,0.0942
204.187.94.208,<->,136.25.188.174,0,0,2,106,2,106,0.208365000,0.1600
119.207.123.153,<->,109.1.24.236,0,0,2,147,2,147,0.207116000,0.0000
192.67.128.244,<->,142.205.143.22,2,268,0,0,2,268,0.206704000,0.2509
220.80.238.163,<->,8.45.172.190,2,362,0,0,2,362,0.206351000,0.8679
92.27.219.53,<->,33.57.74.178,2,474,0,0,2,474,0.204808000,1.4976
215.158.239.92,<->,199.20.7.206,2,100,0,0,2,100,0.204671000,0.0000
111.181.96.177,<->,98.150.107.178,2,100,0,0,2,100,0.204077000,1.0002
142.241.20.255,<->,136.25.188.178,0,0,2,106,2,106,0.203742000,0.1762
211.168.225.235,<->,210.229.230.22,0,0,2,112,2,112,0.203270000,0.0232
118.208.149.7,<->,89.183.104.248,0,0,2,104,2,104,0.203138000,0.1921
194.233.191.193,<->,136.25.188.222,0,0,2,118,2,118,0.202897000,0.1407
215.158.239.48,<->,199.20.30.175,2,136,0,0,2,136,0.202443000,1.2793
143.10.103.166,<->,136.25.188.255,0,0,2,795,2,795,0.202377000,1.4359
142.166.78.168,<->,136.25.188.196,0,0,2,112,2,112,0.202336000,1.3597
220.38.238.124,<->,133.178.227.27,0,0,2,1210,2,1210,0.202047000,0.1440
199.38.135.45,<->,136.25.188.242,0,0,2,100,2,100,0.202020000,0.1691
204.60.19.201,<->,136.25.188.178,0,0,2,152,2,152,0.201917000,0.5000
215.158.117.54,<->,129.254.122.124,0,0,2,200,2,200,0.201815000,1.0004
215.158.238.107,<->,113.23.66.104,2,1205,0,0,2,1205,0.200999000,0.5841
80.42.190.127,<->,38.71.234.211,2,144,0,0,2,144,0.200632000,0.5535
204.63.255.6,<->,136.25.188.198,0,0,2,144,2,144,0.200459000,1.2201
195.43.8.199,<->,136.25.188.175,0,0,2,102,2,102,0.199097000,0.2584
17.136.192.115,<->,8.220.200.124,0,0,2,100,2,100,0.198284000,0.0001
215.158.239.77,<->,199.20.30.245,2,112,0,0,2,112,0.198002000,0.1401
199.98.153.73,<->,136.25.189.28,0,0,2,112,2,112,0.197749000,0.0002
215.158.239.79,<->,195.55.46.208,2,100,0,0,2,100,0.197604000,0.1587
92.27.219.244,<->,29.131.188.62,2,104,0,0,2,104,0.197310000,0.0875
101.106.122.69,<->,89.183.104.172,0,0,2,276,2,276,0.197244000,0.9999
215.158.140.27,<->,29.209.4.208,2,120,0,0,2,120,0.197217000,0.0971
204.62.243.249,<->,136.25.188.55,0,0,2,1051,2,1051,0.197217000,0.1404
215.158.239.78,<->,142.228.171.164,2,100,0,0,2,100,0.197176000,0.1890
101.70.97.189,<->,53.239.1.154,2,336,0,0,2,336,0.197034000,0.7963
204.185.99.10,<->,136.25.188.46,0,0,2,112,2,112,0.196789000,0.0600
210.229.230.18,<->,46.43.202.67,2,118,0,0,2,118,0.196661000,0.2512
207.62.63.248,<->,136.25.188.54,0,0,2,100,2,100,0.196549000,0.0015
97.22.56.3,<->,8.182.226.78,0,0,2,106,2,106,0.196018000,0.1139
210.236.91.164,<->,92.162.253.193,0,0,2,418,2,418,0.195966000,0.8272
195.7.139.141,<->,136.25.188.45,0,0,2,112,2,112,0.195650000,0.0914
207.101.167.51,<->,8.252.222.62,0,0,2,106,2,106,0.195307000,0.2008
215.158.239.68,<->,195.7.109.234,2,159,0,0,2,159,0.194996000,0.5725
215.158.238.95,<->,140.138.86.214,2,1333,0,0,2,1333,0.194827000,0.2034
215.158.239.94,<->,143.53.141.154,2,201,0,0,2,201,0.194213000,0.0064
159.137.231.128,<->,134.53.247.233,2,100,0,0,2,100,0.193961000,0.2131
204.200.62.131,<->,101.224.204.164,0,0,2,100,2,100,0.193907000,0.1141
93.237.35.197,<->,92.27.27.182,0,0,2,2450,2,2450,0.193839000,0.9497
215.158.140.27,<->,123.101.54.16,2,120,0,0,2,120,0.193646000,0.1138
215.158.61.203,<->,8.176.8.240,0,0,2,1434,2,1434,0.193577000,0.0005
89.183.108.71,<->,78.44.110.102,2,100,0,0,2,100,0.193328000,1.2497
215.158.238.45,<->,130.165.253.86,2,1125,0,0,2,1125,0.193293000,0.1488
136.25.189.46,<->,113.23.66.247,2,1317,0,0,2,1317,0.192903000,0.2596
233.147.164.156,<->,50.224.76.248,0,0,2,100,2,100,0.192588000,0.0041
115.121.23.80,<->,92.27.27.165,0,0,2,108,2,108,0.192072000,0.7948
136.25.188.236,<->,30.73.96.89,2,989,0,0,2,989,0.191990000,0.0000
199.111.21.125,<->,8.182.241.177,0,0,2,100,2,100,0.191826000,1.4761
207.60.205.57,<->,136.25.188.242,0,0,2,100,2,100,0.190754000,0.1992
215.158.61.183,<->,136.25.188.42,0,0,2,713,2,713,0.190731000,0.8297
143.20.5.146,<->,136.25.188.241,0,0,2,100,2,100,0.190692000,0.2523
195.7.12.255,<->,136.25.188.55,0,0,2,201,2,201,0.190670000,1.0809
215.158.13.188,<->,99.74.26.169,0,0,2,100,2,100,0.190581000,0.0235
136.25.189.94,<->,96.156.169.238,2,1492,0,0,2,1492,0.190227000,0.0094
139.163.96.104,<->,50.22.161.1,2,248,0,0,2,248,0.189982000,0.2406
215.158.239.97,<->,195.49.12.137,2,120,0,0,2,120,0.189918000,1.7260
215.158.140.75,<->,156.165.33.9,2,1242,0,0,2,1242,0.189786000,0.2297
50.224.76.235,<->,0.104.97.43,2,106,0,0,2,106,0.189300000,0.1320
247.136.234.120,<->,8.45.253.200,2,181,0,0,2,181,0.189289000,0.0000
146.10.166.85,<->,133.178.226.61,0,0,2,112,2,112,0.189029000,0.0005
215.158.239.84,<->,204.3.254.222,2,100,0,0,2,100,0.188604000,0.5191
27.149.243.213,<->,8.182.224.248,0,0,2,100,2,100,0.188227000,0.0003
202.33.255.93,<->,136.25.188.220,0,0,2,112,2,112,0.188010000,0.0100
144.69.82.139,<->,22.50.59.223,2,147,0,0,2,147,0.187576000,0.8981
210.229.230.22,<->,149.233.202.52,2,118,0,0,2,118,0.187572000,0.4839
89.183.104.248,<->,4.241.140.29,2,108,0,0,2,108,0.187499000,0.7633
132.250.195.48,<->,6.138.238.145,0,0,2,100,2,100,0.187170000,0.0000
133.178.227.57,<->,8.221.197.107,2,1109,0,0,2,1109,0.186938000,0.2612
195.127.213.242,<->,136.25.188.238,0,0,2,143,2,143,0.186500000,0.0022
195.70.175.8,<->,136.25.188.252,0,0,2,100,2,100,0.186398000,0.1685
142.207.107.143,<->,50.224.76.230,0,0,2,108,2,108,0.186074000,1.3039
136.25.189.59,<->,126.219.49.93,2,112,0,0,2,112,0.185896000,0.0397
207.61.74.26,<->,136.25.188.163,0,0,2,112,2,112,0.185803000,0.2767
121.131.14.214,<->,80.40.25.242,0,0,2,122,2,122,0.184533000,1.1822
195.71.176.117,<->,136.25.188.54,0,0,2,124,2,124,0.184442000,0.0037
192.67.173.89,<->,54.35.100.140,2,369,0,0,2,369,0.183731000,1.7710
207.61.74.26,<->,136.25.188.176,0,0,2,112,2,112,0.183469000,0.2055
111.20.171.168,<->,101.224.89.131,0,0,2,2362,2,2362,0.183002000,1.2872
247.136.242.15,<->,40.202.65.141,2,266,0,0,2,266,0.182725000,0.5383
205.90.219.141,<->,92.27.219.247,0,0,2,104,2,104,0.182341000,0.0007
215.158.239.49,<->,199.20.31.213,2,124,0,0,2,124,0.182207000,0.1978
215.158.239.78,<->,137.199.206.19,2,1285,0,0,2,1285,0.182200000,0.1338
196.247.218.244,<->,136.25.188.45,0,0,2,112,2,112,0.181706000,1.4607
192.67.129.87,<->,33.78.121.128,2,112,0,0,2,112,0.181576000,0.0017
143.44.210.148,<->,136.25.188.237,0,0,2,124,2,124,0.181331000,0.1099
143.129.198.157,<->,136.25.188.209,0,0,2,106,2,106,0.181269000,0.1864
247.136.249.234,<->,158.50.201.152,2,104,0,0,2,104,0.180767000,0.0000
215.158.238.82,<->,131.215.37.35,2,112,0,0,2,112,0.180237000,0.0030
215.158.239.96,<->,199.20.30.73,2,100,0,0,2,100,0.180160000,0.3280
122.209.226.227,<->,92.27.219.54,0,0,2,108,2,108,0.179031000,0.5998
215.158.238.73,<->,104.3.168.214,2,1221,0,0,2,1221,0.178939000,0.2690
145.208.180.148,<->,53.213.71.13,2,838,0,0,2,838,0.178621000,1.3050
215.158.239.79,<->,199.20.4.144,2,380,0,0,2,380,0.178549000,1.2984
142.253.111.215,<->,136.25.188.174,0,0,2,202,2,202,0.178356000,0.2182
207.188.199.143,<->,136.25.188.176,0,0,2,100,2,100,0.178339000,0.0017
143.13.61.112,<->,136.25.188.175,0,0,2,135,2,135,0.178217000,0.3678
142.241.20.255,<->,136.25.188.176,0,0,2,106,2,106,0.177965000,0.1766
123.153.224.242,<->,92.162.253.108,0,0,2,100,2,100,0.177955000,0.1155
136.25.188.177,<->,41.48.192.108,2,124,0,0,2,124,0.177846000,0.1120
215.158.239.92,<->,69.132.46.142,2,1253,0,0,2,1253,0.177277000,0.3605
215.158.103.219,<->,120.155.86.176,2,154,0,0,2,154,0.177065000,0.5074
207.119.143.199,<->,0.195.210.46,0,0,2,120,2,120,0.176988000,0.7183
109.222.199.118,<->,91.40.184.34,2,112,0,0,2,112,0.176366000,0.1533
215.158.239.48,<->,196.91.5.103,2,112,0,0,2,112,0.176278000,0.0107
197.125.117.203,<->,133.178.227.40,0,0,2,1156,2,1156,0.176277000,0.1724
207.58.177.183,<->,136.25.188.253,0,0,2,100,2,100,0.176238000,0.0043
215.158.239.71,<->,106.188.253.148,2,112,0,0,2,112,0.175886000,0.0000
69.242.131.215,<->,8.252.222.46,0,0,2,100,2,100,0.175616000,0.0000
221.102.143.189,<->,102.83.155.28,0,0,2,197,2,197,0.175334000,0.0000
207.60.148.170,<->,136.25.188.241,0,0,2,100,2,100,0.175327000,0.0017
215.158.239.56,<->,196.1.219.223,2,438,0,0,2,438,0.175324000,1.4199
220.55.169.24,<->,27.202.117.216,2,100,0,0,2,100,0.175203000,1.0000
249.101.238.96,<->,105.201.219.15,2,309,0,0,2,309,0.174876000,0.0022
215.158.239.29,<->,8.222.97.97,2,1517,0,0,2,1517,0.174760000,0.2668
101.70.105.197,<->,27.11.126.141,2,176,0,0,2,176,0.174357000,1.1507
131.51.228.194,<->,50.224.76.234,0,0,2,102,2,102,0.174157000,0.2295
199.38.184.112,<->,91.231.195.125,0,0,2,208,2,208,0.174153000,0.4550
195.5.151.95,<->,136.25.188.53,0,0,2,124,2,124,0.174133000,0.2796
199.81.22.23,<->,136.25.188.253,0,0,2,157,2,157,0.172344000,0.0020
215.158.42.204,<->,8.252.221.212,0,0,2,337,2,337,0.172134000,0.0210
142.236.140.119,<->,136.25.188.252,0,0,2,143,2,143,0.172100000,0.0022
199.21.22.242,<->,50.223.3.228,0,0,2,100,2,100,0.171905000,1.1240
207.56.239.246,<->,136.25.188.254,0,0,2,100,2,100,0.171572000,0.2065
92.27.27.178,<->,76.96.121.38,2,100,0,0,2,100,0.171394000,0.0004
111.147.151.251,<->,54.53.209.53,2,120,0,0,2,120,0.170408000,0.2132
215.158.239.220,<->,215.158.61.145,2,830,0,0,2,830,0.170045000,1.3754
215.158.239.96,<->,199.20.30.17,2,944,0,0,2,944,0.170000000,0.0000
69.103.162.134,<->,8.252.222.135,0,0,2,100,2,100,0.169929000,0.0011
195.126.169.171,<->,136.25.188.255,0,0,2,100,2,100,0.169916000,0.1801
136.158.73.32,<->,133.178.226.178,0,0,2,532,2,532,0.169807000,0.0085
92.27.219.247,<->,75.95.103.248,2,104,0,0,2,104,0.169523000,0.0011
207.63.113.124,<->,136.25.188.46,0,0,2,264,2,264,0.169290000,1.0146
215.158.239.93,<->,199.20.7.13,2,1078,0,0,2,1078,0.168891000,0.6010
119.45.10.74,<->,92.162.253.96,0,0,2,270,2,270,0.168734000,0.1081
133.244.30.133,<->,27.9.159.143,2,232,0,0,2,232,0.168712000,0.1095
143.79.176.190,<->,136.25.188.174,0,0,2,106,2,106,0.168504000,0.1966
132.18.67.30,<->,101.123.187.192,0,0,2,399,2,399,0.168326000,0.0008
207.61.74.26,<->,136.25.188.45,0,0,2,112,2,112,0.168317000,0.1976
231.136.192.239,<->,136.25.188.220,0,0,2,100,2,100,0.168041000,0.0015
204.62.40.203,<->,136.25.188.53,0,0,2,228,2,228,0.167769000,0.0000
195.126.195.51,<->,136.25.188.163,0,0,2,100,2,100,0.167196000,0.1877
207.162.143.165,<->,8.182.241.177,0,0,2,100,2,100,0.166912000,0.0003
192.229.40.116,<->,136.25.188.161,0,0,2,1269,2,1269,0.166767000,0.3361
215.158.239.68,<->,195.7.4.172,2,100,0,0,2,100,0.166184000,0.2225
195.88.189.10,<->,8.182.227.180,0,0,2,106,2,106,0.165056000,0.0232
207.56.239.246,<->,136.25.188.220,0,0,2,100,2,100,0.164624000,0.1934
201.136.143.27,<->,133.178.226.90,0,0,2,112,2,112,0.164566000,0.0000
215.158.238.236,<->,8.222.2.53,2,1207,0,0,2,1207,0.163768000,0.1115
110.72.16.173,<->,89.183.104.184,0,0,2,108,2,108,0.162934000,0.5399
143.13.43.123,<->,136.25.188.252,0,0,2,106,2,106,0.162632000,0.4307
142.227.32.188,<->,136.25.188.46,0,0,2,100,2,100,0.162600000,0.2499
80.27.152.168,<->,75.92.223.98,2,100,0,0,2,100,0.162404000,0.0247
194.207.30.214,<->,50.224.76.235,0,0,2,100,2,100,0.162262000,0.0028
215.158.239.99,<->,195.83.27.255,2,106,0,0,2,106,0.161545000,1.0600
195.126.169.171,<->,136.25.188.242,0,0,2,100,2,100,0.161360000,0.1688
215.158.239.99,<->,196.91.200.233,2,128,0,0,2,128,0.161140000,0.9796
207.56.239.246,<->,136.25.188.253,0,0,2,100,2,100,0.160885000,0.1971
99.162.77.146,<->,53.213.13.72,2,801,0,0,2,801,0.160672000,0.0067
215.158.238.247,<->,113.93.93.125,2,200,0,0,2,200,0.160132000,0.9907
136.25.189.32,<->,97.243.113.36,2,1477,0,0,2,1477,0.160022000,0.1503
195.51.161.187,<->,8.182.234.113,0,0,2,100,2,100,0.159672000,0.1644
101.164.9.247,<->,8.52.181.8,0,0,2,100,2,100,0.159541000,0.0345
133.178.226.30,<->,29.212.203.155,2,1285,0,0,2,1285,0.159413000,0.1387
204.62.82.207,<->,136.25.188.54,0,0,2,136,2,136,0.159110000,0.4000
215.158.239.68,<->,195.96.152.197,2,137,0,0,2,137,0.159085000,0.0088
136.25.188.253,<->,29.211.186.214,2,1397,0,0,2,1397,0.159023000,0.2722
215.158.239.41,<->,8.222.97.79,2,1511,0,0,2,1511,0.158904000,0.1151
60.100.101.24,<->,8.252.222.30,0,0,2,100,2,100,0.158764000,0.0006
97.233.127.125,<->,8.182.141.189,0,0,2,100,2,100,0.158401000,0.0014
53.160.107.185,<->,48.53.51.110,0,0,2,678,2,678,0.158240000,0.2486
210.229.230.20,<->,83.8.21.57,2,118,0,0,2,118,0.158188000,0.0743
132.168.199.82,<->,53.84.228.210,2,112,0,0,2,112,0.158063000,1.4940
156.165.37.93,<->,133.178.227.14,0,0,2,1143,2,1143,0.157911000,0.2310
215.158.239.96,<->,199.20.28.190,2,112,0,0,2,112,0.157787000,0.0000
203.49.227.252,<->,145.252.127.155,0,0,2,878,2,878,0.157635000,0.1749
224.250.190.177,<->,39.236.210.92,0,0,2,100,2,100,0.157634000,0.4358
148.129.30.28,<->,136.25.189.32,0,0,2,1413,2,1413,0.157496000,0.1867
252.189.115.2,<->,92.162.253.126,0,0,2,100,2,100,0.156654000,0.0978
220.59.101.80,<->,100.95.200.24,0,0,2,153,2,153,0.156094000,0.0020
95.245.202.233,<->,8.252.221.196,0,0,2,112,2,112,0.156078000,0.1635
149.201.23.137,<->,89.183.104.254,0,0,2,104,2,104,0.156027000,0.0569
224.154.225.219,<->,139.193.141.139,0,0,2,176,2,176,0.155982000,1.0017
215.158.238.75,<->,136.138.112.232,2,112,0,0,2,112,0.155979000,0.0046
146.149.85.75,<->,8.252.221.205,0,0,2,385,2,385,0.155954000,0.1751
207.88.225.180,<->,8.182.136.240,0,0,2,777,2,777,0.155755000,0.2274
100.117.28.186,<->,20.207.97.131,0,0,2,128,2,128,0.155725000,0.9970
207.58.249.61,<->,136.25.188.54,0,0,2,100,2,100,0.155531000,0.2144
101.164.9.247,<->,8.52.169.61,0,0,2,100,2,100,0.154967000,0.0360
195.215.175.157,<->,92.27.27.150,0,0,2,104,2,104,0.154886000,1.5957
204.56.11.214,<->,136.25.188.175,0,0,2,805,2,805,0.154883000,0.3624
215.158.140.172,<->,195.69.70.77,2,100,0,0,2,100,0.154804000,0.6642
220.51.255.205,<->,215.158.140.201,0,0,2,657,2,657,0.154721000,0.0228
215.158.238.99,<->,80.56.73.198,2,112,0,0,2,112,0.154675000,0.0000
53.77.175.166,<->,8.228.208.183,0,0,2,271,2,271,0.154276000,0.0123
100.182.194.179,<->,50.224.89.237,0,0,2,129,2,129,0.154199000,0.0037
215.158.239.94,<->,48.131.158.247,2,112,0,0,2,112,0.154164000,0.0000
117.20.139.128,<->,92.27.219.229,0,0,2,104,2,104,0.153811000,0.0037
204.60.138.175,<->,136.25.188.52,0,0,2,112,2,112,0.153059000,0.0199
247.136.188.195,<->,96.248.234.254,2,100,0,0,2,100,0.152805000,0.3770
204.63.224.153,<->,136.25.188.44,0,0,2,136,2,136,0.152796000,1.6599
192.67.160.11,<->,48.105.167.149,2,100,0,0,2,100,0.152647000,0.0010
136.25.189.18,<->,38.104.11.3,2,1493,0,0,2,1493,0.152569000,0.2287
195.126.191.247,<->,136.25.188.177,0,0,2,100,2,100,0.152400000,0.0456
205.228.199.160,<->,92.27.219.163,0,0,2,108,2,108,0.152171000,0.3662
136.25.189.28,<->,57.226.224.23,2,1253,0,0,2,1253,0.151975000,0.0931
207.175.167.40,<->,136.25.188.242,0,0,2,1078,2,1078,0.151409000,1.5803
215.158.238.143,<->,143.155.227.33,2,1157,0,0,2,1157,0.151399000,0.1848
210.229.230.22,<->,132.123.119.173,2,136,0,0,2,136,0.150568000,0.1011
17.36.53.25,<->,8.220.200.124,0,0,2,100,2,100,0.150088000,0.0213
129.225.134.68,<->,129.225.132.224,0,0,2,100,2,100,0.149877000,0.0000
204.187.198.2,<->,136.25.188.53,0,0,2,136,2,136,0.149782000,1.5800
215.158.239.99,<->,195.4.121.48,2,100,0,0,2,100,0.149735000,0.5060
75.214.136.141,<->,8.252.221.236,0,0,2,112,2,112,0.149092000,0.0018
92.27.219.44,<->,6.79.214.215,2,176,0,0,2,176,0.148909000,1.7864
80.28.254.54,<->,8.52.181.8,0,0,2,100,2,100,0.148152000,1.8070
113.59.141.49,<->,92.27.219.46,0,0,2,506,2,506,0.147927000,0.6720
145.189.24.252,<->,8.52.222.91,0,0,2,100,2,100,0.147317000,0.0419
195.5.66.184,<->,136.25.188.176,0,0,2,106,2,106,0.147199000,0.1388
210.229.230.19,<->,192.78.170.35,2,118,0,0,2,118,0.146757000,0.2491
132.5.76.132,<->,8.52.180.162,0,0,2,604,2,604,0.146616000,0.2238
204.184.189.241,<->,136.25.188.55,0,0,2,1083,2,1083,0.145862000,0.8395
137.44.239.78,<->,8.220.202.4,0,0,2,100,2,100,0.145236000,0.0261
215.158.238.92,<->,69.132.194.106,2,112,0,0,2,112,0.145226000,0.0007
136.25.188.45,<->,113.23.104.245,2,1285,0,0,2,1285,0.145003000,0.1512
215.158.238.198,<->,29.214.69.218,2,1397,0,0,2,1397,0.144699000,0.4109
215.158.239.78,<->,196.0.74.127,2,112,0,0,2,112,0.144632000,0.6756
204.200.33.97,<->,136.25.188.226,0,0,2,100,2,100,0.144620000,0.1560
241.5.27.232,<->,215.158.239.92,0,0,2,1253,2,1253,0.144472000,0.0720
101.164.9.247,<->,8.52.185.0,0,0,2,100,2,100,0.144468000,0.0288
127.70.90.110,<->,80.38.44.96,0,0,2,184,2,184,0.144373000,0.3350
136.25.189.33,<->,72.23.6.46,2,1413,0,0,2,1413,0.144340000,1.8147
215.158.238.133,<->,192.204.123.117,2,1285,0,0,2,1285,0.143846000,0.1113
227.145.163.213,<->,129.254.122.124,0,0,2,200,2,200,0.143174000,1.0020
206.103.215.203,<->,136.25.189.81,0,0,2,1285,2,1285,0.142894000,0.0987
101.164.9.247,<->,8.52.185.118,0,0,2,100,2,100,0.142043000,0.0329
215.158.239.56,<->,207.191.78.200,2,112,0,0,2,112,0.141801000,0.2091
159.69.187.6,<->,144.108.80.170,2,136,0,0,2,136,0.141380000,0.7694
215.158.239.56,<->,199.20.6.247,2,966,0,0,2,966,0.141367000,0.0000
133.178.226.215,<->,130.36.8.133,2,824,0,0,2,824,0.141092000,0.1121
199.33.118.97,<->,136.25.188.227,0,0,2,228,2,228,0.141022000,0.0090
80.40.63.107,<->,8.55.224.156,2,197,0,0,2,197,0.140701000,0.0000
195.55.155.53,<->,136.25.188.54,0,0,2,100,2,100,0.140683000,0.1437
199.39.43.206,<->,136.25.188.252,0,0,2,120,2,120,0.140490000,0.6694
195.43.243.197,<->,136.25.188.46,0,0,2,276,2,276,0.140198000,0.2190
196.119.216.25,<->,50.223.3.228,0,0,2,136,2,136,0.140173000,1.0497
192.205.242.85,<->,133.178.226.214,0,0,2,280,2,280,0.140024000,0.0517
215.158.239.92,<->,196.106.60.11,2,112,0,0,2,112,0.139721000,0.0000
204.58.222.8,<->,136.25.188.175,0,0,2,100,2,100,0.139325000,0.1703
195.43.255.216,<->,136.25.188.174,0,0,2,106,2,106,0.139322000,0.0685
195.69.102.90,<->,136.25.188.241,0,0,2,102,2,102,0.139240000,0.7354
204.200.59.172,<->,136.25.188.240,0,0,2,112,2,112,0.139201000,0.0015
207.236.22.39,<->,136.25.188.220,0,0,2,112,2,112,0.138845000,0.0017
101.106.122.69,<->,92.27.27.178,0,0,2,378,2,378,0.138384000,0.1922
50.54.40.210,<->,8.52.254.237,0,0,2,100,2,100,0.138277000,0.0004
215.158.239.78,<->,204.226.88.73,2,112,0,0,2,112,0.138206000,0.0385
221.98.84.169,<->,98.131.228.45,2,100,0,0,2,100,0.137906000,0.0246
104.74.153.121,<->,92.27.219.224,0,0,2,120,2,120,0.137789000,1.5693
109.222.250.46,<->,38.183.158.78,2,128,0,0,2,128,0.137626000,1.5572
215.158.239.95,<->,199.20.31.26,2,224,0,0,2,224,0.137106000,0.1004
207.61.46.111,<->,136.25.188.253,0,0,2,100,2,100,0.137007000,0.0646
197.113.64.185,<->,136.25.188.45,0,0,2,112,2,112,0.136877000,0.0491
215.158.239.71,<->,65.27.220.201,2,112,0,0,2,112,0.136634000,0.0003
93.182.142.92,<->,0.195.210.42,0,0,2,135,2,135,0.136454000,0.3432
215.158.239.86,<->,149.184.89.86,2,1269,0,0,2,1269,0.136298000,0.1743
215.158.238.9,<->,192.229.40.2,2,1509,0,0,2,1509,0.135925000,0.0202
215.158.239.99,<->,125.84.55.5,2,112,0,0,2,112,0.135438000,0.0001
133.178.227.1,<->,8.219.187.248,2,1376,0,0,2,1376,0.135105000,0.0470
159.237.225.1,<->,105.124.196.37,2,104,0,0,2,104,0.134786000,0.0005
133.178.226.28,<->,106.188.253.129,2,981,0,0,2,981,0.134605000,0.1323
133.178.226.29,<->,86.151.231.8,2,1333,0,0,2,1333,0.134193000,0.2562
215.158.239.56,<->,196.109.100.176,2,100,0,0,2,100,0.133918000,0.0648
245.150.27.157,<->,8.182.136.143,0,0,2,100,2,100,0.133745000,0.1818
97.53.41.28,<->,8.182.139.235,0,0,2,431,2,431,0.133679000,1.4133
215.158.238.223,<->,114.171.18.211,2,112,0,0,2,112,0.133482000,0.0000
220.20.200.105,<->,131.45.239.178,2,345,0,0,2,345,0.133349000,0.0004
111.147.142.254,<->,54.92.206.16,2,118,0,0,2,118,0.133252000,0.0822
143.33.110.161,<->,8.182.239.190,0,0,2,100,2,100,0.133110000,0.0004
215.158.239.24,<->,111.151.137.161,2,502,0,0,2,502,0.133062000,1.2140
101.70.115.178,<->,92.22.138.195,2,108,0,0,2,108,0.132911000,0.0982
109.222.208.215,<->,103.254.210.135,2,120,0,0,2,120,0.132542000,0.4326
221.102.56.69,<->,98.128.33.24,0,0,2,350,2,350,0.132457000,0.2953
133.178.227.14,<->,8.192.205.88,2,1241,0,0,2,1241,0.132339000,0.1692
133.178.227.16,<->,131.31.183.150,2,1150,0,0,2,1150,0.132235000,0.1057
80.40.11.172,<->,0.235.78.243,2,120,0,0,2,120,0.132223000,1.2637
204.63.114.169,<->,136.25.188.222,0,0,2,837,2,837,0.131543000,0.0702
215.158.238.247,<->,192.231.44.29,2,120,0,0,2,120,0.131092000,0.0242
133.178.227.76,<->,56.100.165.119,2,1233,0,0,2,1233,0.131080000,0.2373
123.119.109.85,<->,92.27.219.54,0,0,2,108,2,108,0.130946000,0.7482
111.199.226.232,<->,0.195.210.44,0,0,2,149,2,149,0.130904000,0.1241
197.47.39.38,<->,109.222.208.215,0,0,2,120,2,120,0.130090000,0.5696
133.178.226.28,<->,131.144.115.192,2,112,0,0,2,112,0.130050000,0.0000
104.252.57.77,<->,50.224.76.234,0,0,2,102,2,102,0.129912000,0.2080
215.158.239.96,<->,207.60.109.241,2,106,0,0,2,106,0.129759000,0.0246
111.20.172.70,<->,33.233.141.0,0,0,2,574,2,574,0.129671000,0.9927
220.20.200.169,<->,129.19.135.195,2,100,0,0,2,100,0.129395000,0.0199
136.25.189.18,<->,29.211.228.213,2,124,0,0,2,124,0.128753000,0.0001
215.158.239.96,<->,196.108.11.23,2,136,0,0,2,136,0.128511000,0.6071
104.219.223.131,<->,89.183.104.176,0,0,2,108,2,108,0.128435000,0.6567
199.69.184.152,<->,136.25.188.253,0,0,2,643,2,643,0.128152000,0.3861
207.56.239.88,<->,136.25.188.174,0,0,2,106,2,106,0.127943000,0.1977
215.158.238.64,<->,104.3.161.16,2,112,0,0,2,112,0.127840000,0.0004
142.206.45.106,<->,136.25.188.178,0,0,2,106,2,106,0.127647000,0.0463
89.183.104.135,<->,40.199.4.109,2,108,0,0,2,108,0.127534000,1.3356
142.249.52.120,<->,136.25.188.253,0,0,2,100,2,100,0.127495000,0.0286
107.106.98.182,<->,50.224.89.243,0,0,2,124,2,124,0.127494000,0.0526
196.115.133.151,<->,136.25.188.44,0,0,2,112,2,112,0.126289000,0.0003
144.67.250.107,<->,108.134.98.139,0,0,2,173,2,173,0.126131000,1.3610
69.103.234.233,<->,8.252.222.134,0,0,2,118,2,118,0.126121000,0.1634
215.158.239.99,<->,207.59.15.37,2,100,0,0,2,100,0.125888000,0.8662
215.158.239.99,<->,199.20.28.166,2,224,0,0,2,224,0.125743000,0.2012
207.1.88.115,<->,98.236.219.135,0,0,2,102,2,102,0.125271000,0.1674
128.156.85.186,<->,8.176.8.109,0,0,2,112,2,112,0.124930000,0.0002
199.83.49.142,<->,136.25.188.177,0,0,2,100,2,100,0.124857000,0.0015
215.158.238.141,<->,198.226.166.143,2,112,0,0,2,112,0.124759000,0.0003
136.25.188.198,<->,120.20.132.43,2,112,0,0,2,112,0.124494000,0.0000
97.193.13.236,<->,8.52.171.120,0,0,2,659,2,659,0.124060000,0.0350
215.158.239.85,<->,118.20.100.105,2,1413,0,0,2,1413,0.123754000,0.1458
148.222.27.162,<->,133.178.227.0,0,0,2,112,2,112,0.123327000,0.0000
215.158.239.79,<->,199.20.29.132,2,112,0,0,2,112,0.123039000,1.2088
92.162.253.162,<->,0.48.110.81,2,100,0,0,2,100,0.123001000,0.1578
125.11.252.202,<->,80.42.168.43,0,0,2,104,2,104,0.122799000,0.0008
111.20.172.70,<->,33.233.141.8,0,0,2,585,2,585,0.122380000,0.9877
50.224.76.248,<->,48.129.94.134,2,112,0,0,2,112,0.122284000,0.0108
247.136.156.74,<->,100.124.212.156,2,125,0,0,2,125,0.122068000,0.0000
215.158.239.59,<->,196.0.216.209,2,152,0,0,2,152,0.121726000,0.8250
215.158.239.84,<->,207.59.59.206,2,100,0,0,2,100,0.121423000,0.0032
215.158.239.68,<->,199.20.31.19,2,246,0,0,2,246,0.121375000,0.3205
207.191.150.128,<->,136.25.188.253,0,0,2,120,2,120,0.121051000,0.3233
215.158.239.50,<->,207.17.141.61,2,106,0,0,2,106,0.120998000,0.0000
205.184.168.20,<->,80.40.56.209,0,0,2,1352,2,1352,0.120437000,0.0001
133.178.227.14,<->,61.72.108.192,2,112,0,0,2,112,0.120379000,0.0002
215.158.239.101,<->,129.222.39.128,2,112,0,0,2,112,0.120367000,0.0236
144.122.240.204,<->,144.108.80.170,2,145,0,0,2,145,0.119826000,0.7440
215.158.239.94,<->,115.157.30.159,2,1317,0,0,2,1317,0.119341000,0.1382
199.72.48.53,<->,136.25.188.222,0,0,2,100,2,100,0.119326000,0.1421
143.227.65.147,<->,136.25.188.226,0,0,2,1269,2,1269,0.119299000,1.6623
56.140.239.100,<->,56.121.58.243,0,0,2,100,2,100,0.119267000,1.1322
231.143.96.2,<->,136.25.188.198,0,0,2,118,2,118,0.117540000,1.5414
215.158.238.47,<->,29.211.186.196,2,112,0,0,2,112,0.117376000,0.0016
215.158.238.58,<->,8.222.109.108,2,1381,0,0,2,1381,0.117338000,1.6151
142.190.111.118,<->,136.25.188.225,0,0,2,100,2,100,0.117216000,0.0017
146.170.140.236,<->,80.27.157.123,0,0,2,611,2,611,0.116963000,0.4154
89.127.177.200,<->,29.211.214.82,0,0,2,174,2,174,0.116816000,0.6399
215.158.61.193,<->,8.176.8.228,0,0,2,1316,2,1316,0.116712000,0.3536
136.25.188.172,<->,33.239.214.186,2,1477,0,0,2,1477,0.116481000,0.3159
142.206.23.7,<->,136.25.188.45,0,0,2,100,2,100,0.116387000,0.1774
58.133.235.83,<->,8.252.222.63,0,0,2,100,2,100,0.116193000,0.1642
195.4.163.51,<->,136.25.188.211,0,0,2,100,2,100,0.115942000,0.0014
158.146.167.55,<->,50.224.76.230,0,0,2,106,2,106,0.115877000,0.1019
136.25.189.0,<->,68.124.221.169,2,112,0,0,2,112,0.115765000,0.0000
215.158.239.78,<->,29.213.219.42,2,1269,0,0,2,1269,0.115762000,0.1225
159.69.187.12,<->,144.108.80.170,2,141,0,0,2,141,0.115563000,0.6658
199.84.182.56,<->,0.195.210.46,0,0,2,100,2,100,0.115453000,0.0524
98.217.87.186,<->,89.183.104.130,0,0,2,104,2,104,0.114608000,0.0010
136.25.189.46,<->,91.247.40.77,2,112,0,0,2,112,0.114352000,0.0006
142.221.77.155,<->,136.25.188.225,0,0,2,100,2,100,0.114190000,0.0008
215.158.239.92,<->,199.20.31.95,2,163,0,0,2,163,0.113891000,0.0124
215.158.238.140,<->,6.116.31.30,2,112,0,0,2,112,0.113756000,0.0072
143.52.58.245,<->,136.25.188.238,0,0,2,1214,2,1214,0.111506000,1.7201
108.134.119.54,<->,38.173.223.206,2,194,0,0,2,194,0.111482000,1.1671
73.80.8.64,<->,50.224.76.248,0,0,2,106,2,106,0.111383000,0.1642
215.158.238.82,<->,192.228.30.26,2,1429,0,0,2,1429,0.111307000,0.1143
111.20.172.70,<->,101.224.89.130,0,0,2,255,2,255,0.111172000,0.0004
138.98.147.26,<->,106.18.220.73,2,100,0,0,2,100,0.110986000,0.0000
148.146.91.24,<->,133.178.226.7,0,0,2,1429,2,1429,0.110724000,0.1186
215.158.140.27,<->,140.163.223.215,2,120,0,0,2,120,0.110722000,0.2105
215.158.238.7,<->,8.188.227.111,2,149,0,0,2,149,0.110684000,0.0000
133.178.227.41,<->,100.50.96.229,2,112,0,0,2,112,0.110537000,0.0000
98.128.214.64,<->,8.45.175.127,2,282,0,0,2,282,0.110012000,0.4689
136.25.188.239,<->,76.137.117.236,2,106,0,0,2,106,0.109960000,0.3971
92.27.219.225,<->,38.253.226.186,2,104,0,0,2,104,0.109957000,0.1406
207.172.124.98,<->,136.25.188.46,0,0,2,112,2,112,0.109837000,0.0558
247.136.164.246,<->,115.186.140.175,2,272,0,0,2,272,0.109836000,1.0421
199.38.212.41,<->,136.25.188.226,0,0,2,106,2,106,0.109444000,0.2325
215.158.61.221,<->,99.74.26.116,0,0,2,861,2,861,0.108347000,1.8575
142.190.111.118,<->,136.25.188.237,0,0,2,100,2,100,0.108167000,0.0014
199.15.252.152,<->,136.25.188.225,0,0,2,100,2,100,0.107998000,0.0027
252.132.45.124,<->,8.182.224.87,0,0,2,106,2,106,0.107941000,0.1907
143.135.46.242,<->,136.25.188.55,0,0,2,100,2,100,0.107781000,0.5473
215.158.239.95,<->,207.190.102.92,2,157,0,0,2,157,0.107617000,0.1193
145.76.230.104,<->,111.20.168.24,0,0,2,112,2,112,0.107232000,0.0001
136.25.188.163,<->,108.167.152.92,2,100,0,0,2,100,0.106430000,0.2063
196.31.59.35,<->,50.224.76.235,0,0,2,106,2,106,0.106277000,0.1804
196.234.82.171,<->,8.182.231.198,0,0,2,767,2,767,0.106255000,1.0428
215.158.140.231,<->,8.57.163.149,2,1135,0,0,2,1135,0.106191000,0.0433
142.190.241.218,<->,136.25.188.237,0,0,2,120,2,120,0.106111000,0.2037
204.95.169.25,<->,89.183.104.178,0,0,2,108,2,108,0.105489000,0.7000
207.173.17.11,<->,136.25.188.174,0,0,2,124,2,124,0.105411000,0.7591
207.188.122.242,<->,136.25.188.173,0,0,2,106,2,106,0.104357000,1.4986
216.144.6.220,<->,215.158.140.195,0,0,2,100,2,100,0.104057000,0.0248
131.219.79.0,<->,100.228.42.52,0,0,2,100,2,100,0.104035000,0.2001
95.245.148.131,<->,8.252.221.207,0,0,2,112,2,112,0.103946000,0.1513
143.230.124.191,<->,129.224.112.252,0,0,2,175,2,175,0.103543000,0.5593
132.18.67.30,<->,102.83.7.112,0,0,2,106,2,106,0.101982000,0.9003
142.252.30.106,<->,136.25.188.174,0,0,2,100,2,100,0.101715000,0.0030
111.20.172.70,<->,101.224.89.222,0,0,2,396,2,396,0.101231000,0.9871
215.158.239.95,<->,194.234.179.27,2,100,0,0,2,100,0.101165000,0.0019
215.158.239.79,<->,196.89.90.150,2,100,0,0,2,100,0.100666000,0.0894
207.65.149.227,<->,50.224.76.230,0,0,2,100,2,100,0.100448000,0.0001
220.55.123.87,<->,27.11.102.242,2,128,0,0,2,128,0.100373000,1.1226
215.158.239.96,<->,196.89.244.160,2,100,0,0,2,100,0.100360000,0.0032
203.88.16.156,<->,0.195.210.46,0,0,2,465,2,465,0.100352000,0.4215
195.70.119.174,<->,136.25.188.220,0,0,2,100,2,100,0.100171000,0.0046
210.229.230.20,<->,192.166.163.67,2,118,0,0,2,118,0.100155000,0.1292
133.178.226.31,<->,113.23.104.212,2,112,0,0,2,112,0.100087000,0.0005
231.143.139.114,<->,136.25.188.198,0,0,2,124,2,124,0.100046000,0.2000
221.101.9.15,<->,207.23.75.43,2,100,0,0,2,100,0.100014000,0.2326
142.244.58.158,<->,136.25.188.209,0,0,2,100,2,100,0.099681000,0.0007
148.146.91.98,<->,136.25.189.0,0,0,2,112,2,112,0.099544000,0.0000
241.180.139.115,<->,8.52.161.33,0,0,2,100,2,100,0.099490000,1.1794
215.158.61.183,<->,8.176.8.181,0,0,2,2842,2,2842,0.099098000,0.7867
109.222.209.61,<->,53.240.255.220,2,349,0,0,2,349,0.098856000,0.0040
195.65.1.186,<->,133.178.226.28,0,0,2,1381,2,1381,0.098689000,0.1495
195.127.215.245,<->,136.25.188.46,0,0,2,106,2,106,0.098558000,0.7128
142.240.142.239,<->,136.25.188.254,0,0,2,112,2,112,0.098493000,0.0309
215.158.238.143,<->,122.159.245.165,2,112,0,0,2,112,0.097993000,0.0004
199.98.24.245,<->,8.252.222.149,0,0,2,100,2,100,0.097884000,0.0025
210.229.230.22,<->,82.146.182.113,2,118,0,0,2,118,0.097455000,0.2746
33.233.141.230,<->,17.62.194.122,2,112,0,0,2,112,0.097123000,0.0003
195.70.162.184,<->,8.52.171.120,0,0,2,100,2,100,0.096458000,0.0016
133.178.226.234,<->,111.151.239.138,2,866,0,0,2,866,0.096290000,0.0197
207.61.141.54,<->,136.25.188.176,0,0,2,100,2,100,0.096275000,0.0013
215.158.239.221,<->,215.158.61.189,2,485,0,0,2,485,0.095370000,0.5472
109.1.35.61,<->,33.57.79.33,2,100,0,0,2,100,0.095295000,0.1850
215.158.239.49,<->,8.47.120.219,2,112,0,0,2,112,0.095050000,0.0002
133.178.227.79,<->,18.202.90.200,2,1198,0,0,2,1198,0.094770000,0.3028
136.18.96.45,<->,8.182.244.237,0,0,2,106,2,106,0.094721000,0.6475
143.224.181.67,<->,0.195.210.44,0,0,2,112,2,112,0.094357000,0.0640
223.36.99.22,<->,215.158.238.250,0,0,2,112,2,112,0.094349000,0.0001
199.82.251.207,<->,136.25.188.253,0,0,2,151,2,151,0.093781000,1.5216
192.204.243.74,<->,133.178.227.134,0,0,2,1557,2,1557,0.093548000,0.0321
156.165.37.64,<->,136.25.189.59,0,0,2,1413,2,1413,0.093050000,0.2628
199.111.108.192,<->,8.182.229.19,0,0,2,100,2,100,0.092972000,0.1749
198.30.152.241,<->,133.54.17.35,0,0,2,100,2,100,0.092878000,0.0000
58.43.188.11,<->,6.72.7.129,0,0,2,462,2,462,0.092436000,0.0100
111.20.172.70,<->,101.224.89.155,0,0,2,263,2,263,0.092166000,0.0074
148.190.124.36,<->,133.178.227.27,0,0,2,1160,2,1160,0.091816000,0.3348
133.178.226.247,<->,100.224.163.93,2,613,0,0,2,613,0.091386000,0.1574
215.158.239.97,<->,199.20.30.197,2,120,0,0,2,120,0.090786000,1.2200
206.198.164.31,<->,139.163.5.140,0,0,2,100,2,100,0.090763000,0.0006
97.126.18.244,<->,53.197.137.20,2,112,0,0,2,112,0.090763000,0.0000
111.20.172.70,<->,101.224.89.228,0,0,2,589,2,589,0.090696000,1.0004
143.42.217.242,<->,136.25.188.177,0,0,2,106,2,106,0.090487000,0.2493
102.71.178.90,<->,48.53.25.210,0,0,2,2910,2,2910,0.090310000,1.4020
99.72.74.250,<->,33.78.156.234,2,104,0,0,2,104,0.089990000,0.0145
204.226.202.94,<->,50.224.76.235,0,0,2,100,2,100,0.089967000,0.2561
215.201.195.147,<->,8.182.244.237,0,0,2,106,2,106,0.089752000,0.0043
136.25.189.18,<->,114.171.18.251,2,112,0,0,2,112,0.089728000,0.0004
215.158.238.247,<->,192.231.44.28,2,120,0,0,2,120,0.089601000,0.0220
215.158.238.103,<->,100.224.166.120,2,517,0,0,2,517,0.089344000,0.7454
136.25.189.1,<->,112.220.198.119,2,112,0,0,2,112,0.088874000,0.0000
142.191.36.3,<->,136.25.188.238,0,0,2,100,2,100,0.088341000,0.0027
204.184.117.12,<->,136.25.188.237,0,0,2,112,2,112,0.088308000,0.0400
215.158.140.92,<->,29.214.69.93,2,1157,0,0,2,1157,0.088271000,0.2635
29.95.158.240,<->,20.199.198.162,0,0,2,128,2,128,0.088144000,0.9944
215.158.140.27,<->,114.150.180.191,2,120,0,0,2,120,0.087984000,0.1880
215.158.238.95,<->,88.3.1.165,2,1285,0,0,2,1285,0.087687000,1.8952
136.25.189.31,<->,29.211.228.199,2,100,0,0,2,100,0.087451000,0.0000
215.158.239.76,<->,199.20.31.208,2,112,0,0,2,112,0.087299000,0.1192
199.82.219.155,<->,136.25.188.46,0,0,2,100,2,100,0.087203000,0.1822
216.184.2.235,<->,215.158.239.69,0,0,2,112,2,112,0.087116000,0.0001
144.86.144.116,<->,128.124.13.204,2,100,0,0,2,100,0.087056000,0.0080
128.65.94.113,<->,50.224.76.234,0,0,2,100,2,100,0.086813000,0.0350
215.158.239.58,<->,199.20.30.180,2,228,0,0,2,228,0.086674000,0.0101
111.20.172.70,<->,33.233.141.32,0,0,2,264,2,264,0.086366000,1.0026
196.112.237.232,<->,136.25.189.57,0,0,2,112,2,112,0.085926000,0.0081
196.206.149.161,<->,136.25.188.243,0,0,2,100,2,100,0.085184000,0.0000
143.134.235.228,<->,136.25.188.237,0,0,2,100,2,100,0.085079000,0.2587
204.95.168.51,<->,50.224.89.243,0,0,2,1125,2,1125,0.084602000,0.2232
106.27.95.251,<->,80.40.1.240,0,0,2,129,2,129,0.083798000,0.6662
204.34.191.204,<->,50.224.76.234,0,0,2,100,2,100,0.083482000,0.0214
249.101.234.169,<->,193.46.99.189,2,162,0,0,2,162,0.083399000,0.0000
196.113.221.85,<->,0.195.210.44,0,0,2,149,2,149,0.083361000,0.3033
111.20.172.70,<->,101.224.89.139,0,0,2,290,2,290,0.082931000,1.0042
106.217.40.27,<->,22.59.31.30,0,0,2,132,2,132,0.082305000,0.3442
207.63.131.16,<->,136.25.188.226,0,0,2,106,2,106,0.082171000,0.2599
215.158.140.207,<->,131.36.105.41,2,1435,0,0,2,1435,0.082145000,0.1099
136.25.189.30,<->,131.2.102.22,2,1429,0,0,2,1429,0.082017000,0.1340
215.158.239.94,<->,199.81.179.27,2,112,0,0,2,112,0.081923000,0.0436
133.178.226.203,<->,80.47.161.166,2,767,0,0,2,767,0.081864000,0.0231
215.158.239.50,<->,29.123.209.236,2,112,0,0,2,112,0.081726000,0.0000
136.25.189.17,<->,113.143.223.213,2,112,0,0,2,112,0.081710000,0.0000
241.0.218.79,<->,215.158.140.27,0,0,2,120,2,120,0.081512000,0.0608
221.196.122.173,<->,136.25.188.226,0,0,2,112,2,112,0.081205000,0.0934
127.73.51.196,<->,50.224.89.243,0,0,2,1141,2,1141,0.081134000,0.1732
207.57.195.232,<->,136.25.188.253,0,0,2,100,2,100,0.081075000,0.0016
215.158.238.209,<->,69.132.241.242,2,112,0,0,2,112,0.080949000,0.8489
220.20.200.186,<->,193.21.28.207,2,100,0,0,2,100,0.080916000,0.1039
215.158.238.95,<->,158.247.77.104,2,112,0,0,2,112,0.080660000,0.0000
204.60.227.115,<->,136.25.188.198,0,0,2,136,2,136,0.080507000,0.6865
215.158.239.95,<->,207.191.108.204,2,112,0,0,2,112,0.080384000,0.0000
80.42.144.133,<->,48.106.37.233,2,104,0,0,2,104,0.080047000,0.5575
220.80.178.38,<->,202.206.68.225,2,266,0,0,2,266,0.080034000,1.4530
215.158.239.254,<->,111.151.142.168,2,124,0,0,2,124,0.080030000,0.0392
112.208.20.249,<->,102.51.5.223,0,0,2,326,2,326,0.079841000,0.4443
231.140.6.104,<->,215.158.239.92,0,0,2,100,2,100,0.079798000,0.0015
133.178.226.29,<->,119.196.23.26,2,1173,0,0,2,1173,0.079744000,1.0376
133.148.242.157,<->,8.220.186.82,0,0,2,106,2,106,0.079731000,0.0236
207.190.98.67,<->,136.25.188.242,0,0,2,106,2,106,0.079631000,0.1907
143.10.113.121,<->,136.25.188.254,0,0,2,100,2,100,0.079542000,0.0017
92.27.219.46,<->,27.76.47.236,2,100,0,0,2,100,0.079418000,0.1348
133.178.226.28,<->,57.31.51.199,2,1141,0,0,2,1141,0.079318000,0.1078
136.25.189.196,<->,129.222.39.112,2,112,0,0,2,112,0.079021000,0.0214
192.226.161.27,<->,133.178.226.18,0,0,2,112,2,112,0.078923000,0.0002
215.158.140.93,<->,57.31.50.234,2,112,0,0,2,112,0.078840000,0.0003
136.25.189.57,<->,98.28.95.88,2,1141,0,0,2,1141,0.078347000,0.0999
145.79.71.159,<->,8.220.181.167,0,0,2,100,2,100,0.078284000,0.0537
121.65.168.49,<->,56.121.54.220,0,0,2,136,2,136,0.078231000,1.1008
152.100.7.72,<->,50.224.80.64,0,0,2,677,2,677,0.077866000,0.1634
200.174.218.185,<->,54.58.119.149,2,100,0,0,2,100,0.077807000,0.0114
246.253.253.96,<->,147.11.11.175,2,813,0,0,2,813,0.077558000,0.2073
215.158.238.64,<->,56.161.218.20,2,112,0,0,2,112,0.077474000,0.0106
108.138.110.153,<->,0.195.210.44,0,0,2,112,2,112,0.077424000,0.4688
215.158.61.195,<->,8.176.8.212,0,0,2,2038,2,2038,0.076808000,1.4707
215.158.140.60,<->,57.199.250.215,2,112,0,0,2,112,0.075548000,0.0000
119.187.220.213,<->,92.27.219.19,0,0,2,104,2,104,0.075194000,0.7335
215.158.140.199,<->,8.240.247.73,2,502,0,0,2,502,0.075085000,1.0697
207.188.114.217,<->,136.25.188.198,0,0,2,112,2,112,0.075062000,0.8616
215.158.239.58,<->,207.61.248.76,2,106,0,0,2,106,0.074942000,0.2111
123.89.134.64,<->,92.162.253.134,0,0,2,100,2,100,0.074932000,0.1156
197.125.126.248,<->,136.25.188.223,0,0,2,112,2,112,0.074803000,0.0008
215.158.140.87,<->,119.168.0.136,2,1527,0,0,2,1527,0.074704000,0.1495
220.20.200.118,<->,144.83.60.153,2,100,0,0,2,100,0.074349000,0.0262
116.151.56.204,<->,97.126.89.196,0,0,2,120,2,120,0.074259000,0.0097
116.172.212.6,<->,50.224.76.235,0,0,2,100,2,100,0.074134000,0.0001
133.244.30.133,<->,119.111.182.129,2,151,0,0,2,151,0.073739000,0.0000
136.25.188.237,<->,132.231.109.46,2,112,0,0,2,112,0.073649000,0.0677
215.158.238.99,<->,29.212.195.10,2,112,0,0,2,112,0.073593000,0.0003
204.200.48.191,<->,136.25.188.225,0,0,2,112,2,112,0.073510000,0.0400
146.193.12.237,<->,8.252.221.197,0,0,2,100,2,100,0.073425000,1.8958
215.158.239.4,<->,102.225.141.27,2,1198,0,0,2,1198,0.073262000,0.0432
148.151.110.48,<->,97.126.31.86,0,0,2,100,2,100,0.073046000,0.1091
139.254.214.188,<->,48.107.69.154,2,2677,0,0,2,2677,0.072937000,0.0119
205.127.108.113,<->,33.233.141.68,0,0,2,602,2,602,0.072919000,0.0334
215.158.239.215,<->,128.17.205.55,2,112,0,0,2,112,0.072734000,0.0001
215.158.239.93,<->,120.154.71.72,2,112,0,0,2,112,0.072036000,0.0002
159.23.226.39,<->,73.80.222.209,2,100,0,0,2,100,0.071544000,0.2214
142.227.208.147,<->,136.25.188.209,0,0,2,100,2,100,0.071270000,0.0020
48.131.158.227,<->,8.252.223.153,0,0,2,1189,2,1189,0.070890000,0.8124
143.76.133.92,<->,8.182.243.14,0,0,2,106,2,106,0.070110000,0.1718
136.25.188.211,<->,122.158.51.91,2,112,0,0,2,112,0.070037000,0.0002
199.39.220.44,<->,136.25.188.174,0,0,2,106,2,106,0.069800000,0.2223
215.158.239.77,<->,199.72.57.71,2,102,0,0,2,102,0.069641000,0.1523
136.25.188.175,<->,6.116.31.5,2,112,0,0,2,112,0.069611000,0.0013
139.163.96.103,<->,93.208.94.184,2,922,0,0,2,922,0.069331000,1.7818
133.178.226.234,<->,115.162.222.166,2,112,0,0,2,112,0.069186000,0.1047
215.158.140.195,<->,8.222.7.162,2,1031,0,0,2,1031,0.068472000,0.0318
195.124.123.81,<->,136.25.188.45,0,0,2,953,2,953,0.067999000,0.0198
133.178.226.80,<->,96.155.60.247,2,1502,0,0,2,1502,0.067866000,0.0427
109.49.74.13,<->,8.182.136.57,0,0,2,1228,2,1228,0.067793000,0.1080
195.6.202.57,<->,136.25.188.241,0,0,2,106,2,106,0.067769000,0.0528
159.137.141.196,<->,134.252.17.141,2,1073,0,0,2,1073,0.067730000,0.3659
136.25.189.43,<->,96.156.169.239,2,379,0,0,2,379,0.067652000,0.1787
247.136.162.79,<->,136.152.86.129,2,100,0,0,2,100,0.067559000,0.0000
215.158.239.50,<->,29.214.73.92,2,1413,0,0,2,1413,0.067461000,0.2215
199.51.161.11,<->,136.25.188.255,0,0,2,100,2,100,0.066980000,0.0000
139.163.126.226,<->,17.100.3.178,2,568,0,0,2,568,0.066682000,0.2382
89.86.110.24,<->,8.252.222.204,0,0,2,1237,2,1237,0.066298000,0.1017
227.29.202.198,<->,92.27.219.36,0,0,2,657,2,657,0.066272000,0.2807
143.129.218.243,<->,136.25.188.209,0,0,2,100,2,100,0.066269000,0.2154
117.79.145.41,<->,80.41.32.57,0,0,2,104,2,104,0.066082000,0.0000
207.188.168.38,<->,136.25.188.238,0,0,2,128,2,128,0.066040000,1.0392
210.229.230.20,<->,100.51.146.119,2,118,0,0,2,118,0.065915000,0.2502
215.158.239.93,<->,143.99.86.181,2,136,0,0,2,136,0.065845000,0.0604
6.145.170.221,<->,0.195.210.44,0,0,2,112,2,112,0.065328000,0.0521
136.25.189.59,<->,33.209.219.125,2,112,0,0,2,112,0.065308000,0.0000
143.44.47.150,<->,136.25.188.209,0,0,2,149,2,149,0.065205000,0.0026
133.178.227.14,<->,8.240.116.184,2,112,0,0,2,112,0.064942000,0.0002
143.43.195.76,<->,136.25.188.236,0,0,2,149,2,149,0.064798000,0.0010
119.251.182.115,<->,92.27.219.244,0,0,2,104,2,104,0.064681000,1.7507
136.25.189.31,<->,96.156.169.215,2,1269,0,0,2,1269,0.064559000,0.1430
215.158.239.56,<->,204.0.183.124,2,168,0,0,2,168,0.064423000,0.4001
195.70.117.1,<->,136.25.188.173,0,0,2,100,2,100,0.064255000,0.0019
215.158.239.48,<->,194.201.252.29,2,100,0,0,2,100,0.064090000,0.0200
215.158.66.202,<->,133.178.227.201,0,0,2,231,2,231,0.063756000,0.9107
194.233.38.180,<->,136.25.188.238,0,0,2,136,2,136,0.063732000,0.8795
231.140.69.7,<->,215.158.239.49,0,0,2,106,2,106,0.063545000,0.1636
215.158.239.76,<->,199.20.29.2,2,112,0,0,2,112,0.063535000,0.0498
199.32.125.66,<->,136.25.188.52,0,0,2,100,2,100,0.063489000,0.0000
111.150.187.199,<->,8.252.223.106,0,0,2,100,2,100,0.063390000,0.0000
143.76.37.29,<->,136.25.188.209,0,0,2,100,2,100,0.063073000,0.0004
204.43.213.57,<->,50.224.76.234,0,0,2,112,2,112,0.062802000,0.0159
215.158.239.99,<->,207.115.72.89,2,136,0,0,2,136,0.062789000,1.4964
142.252.182.77,<->,136.25.188.163,0,0,2,124,2,124,0.062724000,0.0993
136.139.59.124,<->,133.178.226.49,0,0,2,149,2,149,0.062533000,0.0001
196.205.203.197,<->,136.25.188.243,0,0,2,228,2,228,0.062117000,0.2199
129.224.112.252,<->,27.127.251.102,2,163,0,0,2,163,0.061674000,0.0037
215.158.239.94,<->,143.13.154.68,2,106,0,0,2,106,0.061655000,0.0276
220.250.48.114,<->,139.163.66.202,0,0,2,131,2,131,0.061408000,0.2202
199.32.186.33,<->,136.25.188.241,0,0,2,100,2,100,0.061189000,0.0023
227.56.252.224,<->,139.163.96.94,0,0,2,100,2,100,0.061073000,0.7752
197.45.40.171,<->,8.52.186.161,0,0,2,100,2,100,0.060707000,0.1721
142.166.73.13,<->,136.25.188.255,0,0,2,108,2,108,0.060583000,1.7405
198.157.156.82,<->,92.27.218.252,0,0,2,780,2,780,0.060333000,1.0033
207.172.35.165,<->,136.25.188.46,0,0,2,112,2,112,0.060244000,0.0099
89.183.104.186,<->,33.57.74.146,2,100,0,0,2,100,0.059616000,0.1309
136.25.189.82,<->,113.92.151.23,2,1435,0,0,2,1435,0.059603000,1.8715
159.137.162.213,<->,117.47.221.215,2,100,0,0,2,100,0.059579000,0.1167
133.178.227.222,<->,69.31.239.50,2,244,0,0,2,244,0.059574000,0.0008
215.158.103.206,<->,131.92.221.146,2,208,0,0,2,208,0.059383000,0.3362
215.158.239.49,<->,196.108.162.185,2,128,0,0,2,128,0.059117000,1.0002
129.236.111.55,<->,129.224.112.252,0,0,2,143,2,143,0.058818000,0.0123
89.155.187.166,<->,35.56.100.182,0,0,2,112,2,112,0.058789000,0.9998
144.87.238.89,<->,8.182.239.190,0,0,2,106,2,106,0.058395000,0.0096
152.40.67.203,<->,8.252.222.60,0,0,2,112,2,112,0.058227000,0.0040
131.57.126.120,<->,108.134.95.188,0,0,2,248,2,248,0.058196000,1.0197
105.140.147.106,<->,89.183.104.163,0,0,2,104,2,104,0.058194000,0.0057
215.158.239.79,<->,156.165.37.67,2,1317,0,0,2,1317,0.058087000,0.2439
116.241.207.78,<->,50.224.76.235,0,0,2,106,2,106,0.057970000,0.1525
126.198.149.124,<->,100.93.84.183,0,0,2,394,2,394,0.057010000,0.1379
54.93.237.157,<->,48.52.156.226,0,0,2,134,2,134,0.056423000,0.2991
215.158.238.95,<->,89.80.251.7,2,1413,0,0,2,1413,0.056185000,0.1303
216.144.228.240,<->,215.158.140.193,0,0,2,106,2,106,0.055908000,0.0354
215.158.61.203,<->,8.176.8.252,0,0,2,2050,2,2050,0.055737000,0.5691
197.106.74.77,<->,8.182.227.180,0,0,2,100,2,100,0.055704000,0.0295
129.236.115.241,<->,111.20.168.122,0,0,2,1171,2,1171,0.055442000,0.0192
114.60.176.251,<->,92.27.219.236,0,0,2,108,2,108,0.055441000,0.7327
207.196.103.111,<->,8.52.247.130,0,0,2,1104,2,1104,0.055120000,1.7918
138.127.224.225,<->,33.233.141.16,0,0,2,478,2,478,0.054546000,0.0037
133.178.227.251,<->,57.4.203.23,2,112,0,0,2,112,0.054064000,0.0000
100.92.28.155,<->,8.250.36.239,2,711,0,0,2,711,0.053449000,0.9220
215.158.239.49,<->,199.20.4.1,2,112,0,0,2,112,0.053314000,0.2794
215.158.239.78,<->,6.15.207.196,2,112,0,0,2,112,0.052950000,0.0002
136.25.188.55,<->,32.183.36.250,2,112,0,0,2,112,0.052687000,0.0001
215.158.239.94,<->,196.94.171.96,2,157,0,0,2,157,0.052423000,0.4004
158.14.120.148,<->,101.224.206.46,0,0,2,163,2,163,0.052386000,0.0393
196.30.45.101,<->,50.224.76.234,0,0,2,106,2,106,0.052255000,0.1472
231.136.104.169,<->,136.25.188.160,0,0,2,136,2,136,0.052178000,0.8023
204.61.95.32,<->,8.52.185.143,0,0,2,100,2,100,0.051843000,0.1499
112.208.20.255,<->,99.72.86.96,0,0,2,375,2,375,0.051815000,0.2822
231.143.147.85,<->,136.25.188.209,0,0,2,136,2,136,0.051444000,1.1102
106.168.190.250,<->,100.92.61.156,0,0,2,798,2,798,0.051058000,0.3183
204.56.13.140,<->,136.25.188.177,0,0,2,106,2,106,0.051044000,0.4391
218.147.52.203,<->,8.182.141.189,0,0,2,112,2,112,0.051008000,0.0344
92.27.219.41,<->,65.63.1.67,2,108,0,0,2,108,0.050585000,0.8587
144.75.218.235,<->,138.127.231.148,2,731,0,0,2,731,0.050299000,0.0257
138.127.224.104,<->,101.224.89.208,0,0,2,580,2,580,0.050012000,0.0225
231.142.254.218,<->,215.158.239.97,0,0,2,120,2,120,0.049933000,0.2291
215.158.238.188,<->,123.166.46.117,2,112,0,0,2,112,0.049857000,0.0004
215.158.239.7,<->,8.219.187.249,2,1289,0,0,2,1289,0.049781000,0.4029
117.35.249.200,<->,50.224.76.230,0,0,2,100,2,100,0.049625000,0.0118
145.128.230.16,<->,8.220.235.203,0,0,2,419,2,419,0.048730000,0.2247
225.53.87.107,<->,159.137.189.208,0,0,2,100,2,100,0.048671000,0.0000
101.49.217.41,<->,50.224.80.67,0,0,2,509,2,509,0.048554000,0.0557
231.142.10.69,<->,136.25.188.253,0,0,2,100,2,100,0.047987000,0.0028
143.155.228.1,<->,133.178.226.29,0,0,2,112,2,112,0.047635000,0.0002
80.40.50.197,<->,57.47.64.50,2,135,0,0,2,135,0.047407000,0.1508
221.102.143.189,<->,80.40.251.150,0,0,2,629,2,629,0.047347000,0.0417
204.186.75.107,<->,136.25.188.222,0,0,2,100,2,100,0.046412000,0.0000
215.158.239.58,<->,199.20.7.19,2,950,0,0,2,950,0.046329000,1.9304
136.25.189.2,<->,96.156.169.254,2,112,0,0,2,112,0.046218000,0.0001
122.186.169.249,<->,8.220.195.228,0,0,2,985,2,985,0.046033000,0.3911
194.45.207.41,<->,138.98.197.173,0,0,2,100,2,100,0.045977000,0.0000
50.224.76.234,<->,38.87.84.186,2,136,0,0,2,136,0.045764000,0.0355
22.36.22.18,<->,8.182.226.78,0,0,2,100,2,100,0.045714000,0.0375
204.95.192.118,<->,50.224.96.57,0,0,2,100,2,100,0.045661000,0.1640
133.178.226.77,<->,80.47.111.10,2,112,0,0,2,112,0.045380000,0.0002
136.25.189.46,<->,29.212.199.40,2,1413,0,0,2,1413,0.045307000,0.2938
195.71.71.238,<->,136.25.188.222,0,0,2,124,2,124,0.044980000,0.0015
197.107.103.214,<->,136.25.188.176,0,0,2,100,2,100,0.044773000,0.0000
204.200.172.228,<->,136.25.188.254,0,0,2,135,2,135,0.044668000,0.1376
215.158.239.58,<->,195.4.214.13,2,100,0,0,2,100,0.044356000,1.2422
133.178.226.19,<->,113.23.104.220,2,100,0,0,2,100,0.044192000,0.0000
98.67.132.221,<->,53.176.41.158,2,150,0,0,2,150,0.044147000,0.1434
144.75.218.235,<->,8.47.122.178,2,200,0,0,2,200,0.043943000,0.3015
148.129.30.23,<->,136.25.189.16,0,0,2,112,2,112,0.042938000,0.0005
215.158.239.50,<->,199.20.28.4,2,658,0,0,2,658,0.042429000,0.5801
207.172.193.53,<->,136.25.188.176,0,0,2,853,2,853,0.041646000,0.0201
129.236.100.31,<->,129.224.112.252,0,0,2,156,2,156,0.041475000,0.0170
92.27.27.148,<->,33.57.74.151,2,100,0,0,2,100,0.041306000,0.1760
159.2.59.67,<->,8.52.222.23,0,0,2,100,2,100,0.041060000,1.3295
215.158.238.196,<->,141.134.142.217,2,1159,0,0,2,1159,0.040955000,1.8601
93.181.134.50,<->,92.27.219.253,0,0,2,131,2,131,0.040909000,0.0000
194.232.26.38,<->,136.25.188.163,0,0,2,100,2,100,0.040816000,0.1745
215.158.239.87,<->,142.236.161.65,2,112,0,0,2,112,0.040726000,1.4618
221.101.9.15,<->,192.195.124.187,2,100,0,0,2,100,0.040682000,0.5606
92.27.219.164,<->,33.57.78.94,2,100,0,0,2,100,0.040520000,0.1357
213.186.61.11,<->,50.224.110.87,0,0,2,112,2,112,0.040518000,0.0246
195.5.52.146,<->,136.25.188.243,0,0,2,100,2,100,0.040366000,0.1956
100.28.122.63,<->,50.224.80.64,0,0,2,1171,2,1171,0.040168000,0.2437
159.2.58.132,<->,8.52.171.120,0,0,2,787,2,787,0.039818000,0.0339
204.185.186.30,<->,136.25.188.198,0,0,2,338,2,338,0.039762000,1.2800
207.58.208.45,<->,136.25.188.253,0,0,2,145,2,145,0.039701000,0.1213
129.236.100.63,<->,129.224.112.252,0,0,2,182,2,182,0.039656000,0.0091
192.67.176.141,<->,134.245.148.207,2,104,0,0,2,104,0.039653000,0.0000
142.249.242.192,<->,136.25.188.255,0,0,2,157,2,157,0.039609000,0.0034
121.249.34.86,<->,97.168.105.140,0,0,2,100,2,100,0.039593000,0.1897
220.20.200.6,<->,144.83.60.136,2,100,0,0,2,100,0.039574000,0.0241
93.181.154.62,<->,92.27.27.154,0,0,2,100,2,100,0.039043000,0.1414
93.181.153.42,<->,92.27.219.184,0,0,2,100,2,100,0.039020000,0.4009
207.172.15.241,<->,136.25.188.174,0,0,2,124,2,124,0.038628000,0.8800
221.196.122.166,<->,136.25.188.173,0,0,2,112,2,112,0.038552000,0.0021
100.206.91.174,<->,33.233.141.26,0,0,2,259,2,259,0.038514000,0.0009
80.38.10.43,<->,27.151.43.169,2,112,0,0,2,112,0.038495000,0.6207
138.127.224.176,<->,111.20.168.21,0,0,2,526,2,526,0.038294000,0.0005
224.148.1.28,<->,132.18.67.29,2,112,0,0,2,112,0.037684000,0.0330
215.158.239.69,<->,8.42.43.36,2,1317,0,0,2,1317,0.037483000,0.1019
192.64.215.144,<->,33.57.78.94,2,100,0,0,2,100,0.037377000,0.1257
247.136.216.149,<->,133.128.43.238,2,112,0,0,2,112,0.037346000,1.0400
210.220.219.153,<->,139.33.175.144,2,317,0,0,2,317,0.037168000,0.0485
249.176.101.34,<->,246.254.97.230,0,0,2,112,2,112,0.036904000,0.0389
215.158.238.72,<->,38.104.11.36,2,112,0,0,2,112,0.036741000,0.0021
195.70.77.43,<->,136.25.188.53,0,0,2,100,2,100,0.036738000,0.0020
199.50.226.137,<->,136.25.188.226,0,0,2,100,2,100,0.036695000,0.2002
204.63.220.45,<->,136.25.188.52,0,0,2,124,2,124,0.036678000,1.8394
199.20.12.66,<->,92.27.194.147,0,0,2,410,2,410,0.036551000,0.4151
215.158.239.79,<->,195.41.216.49,2,149,0,0,2,149,0.036522000,0.0017
137.160.131.4,<->,8.182.244.19,0,0,2,100,2,100,0.036052000,0.0000
195.71.49.202,<->,136.25.188.254,0,0,2,124,2,124,0.035803000,0.0840
215.158.239.79,<->,142.236.161.65,2,112,0,0,2,112,0.035662000,1.4597
148.55.210.209,<->,136.25.188.55,0,0,2,112,2,112,0.035552000,0.0002
246.253.253.96,<->,145.242.124.31,2,476,0,0,2,476,0.035543000,0.1944
99.72.140.170,<->,33.78.194.97,2,100,0,0,2,100,0.035505000,0.1366
220.28.65.9,<->,215.158.239.61,0,0,2,2138,2,2138,0.034631000,0.0000
223.115.176.97,<->,8.252.221.230,0,0,2,100,2,100,0.034337000,0.1770
202.73.72.103,<->,92.27.219.224,0,0,2,686,2,686,0.034079000,0.0202
109.50.181.214,<->,8.182.225.124,0,0,2,147,2,147,0.033774000,0.0002
207.60.124.42,<->,136.25.188.227,0,0,2,106,2,106,0.033383000,0.2074
215.158.239.50,<->,199.20.28.77,2,106,0,0,2,106,0.032910000,1.6604
133.178.226.161,<->,54.52.195.79,2,165,0,0,2,165,0.032713000,0.0250
136.25.189.89,<->,114.94.161.217,2,1253,0,0,2,1253,0.032667000,0.2154
197.113.99.162,<->,136.25.188.252,0,0,2,112,2,112,0.031926000,0.0201
139.5.114.186,<->,136.25.189.84,0,0,2,1018,2,1018,0.031790000,1.0376
215.158.239.93,<->,106.155.128.76,2,1285,0,0,2,1285,0.031777000,0.1098
92.27.27.183,<->,29.134.227.81,2,108,0,0,2,108,0.031675000,0.7328
215.158.239.56,<->,207.56.191.7,2,100,0,0,2,100,0.031555000,0.0963
215.158.238.51,<->,129.222.36.56,2,112,0,0,2,112,0.030857000,0.0190
8.252.223.140,<->,8.219.187.249,2,1308,0,0,2,1308,0.030745000,0.0419
159.137.162.213,<->,125.199.182.204,2,100,0,0,2,100,0.030707000,0.0973
215.158.239.56,<->,204.21.14.230,2,124,0,0,2,124,0.030146000,0.1402
204.56.121.166,<->,136.25.188.225,0,0,2,112,2,112,0.029681000,1.7660
136.25.189.13,<->,120.154.131.7,2,1349,0,0,2,1349,0.029634000,0.1171
158.193.236.29,<->,20.192.33.104,0,0,2,128,2,128,0.029612000,1.0010
223.176.144.56,<->,8.252.222.36,0,0,2,100,2,100,0.029609000,0.0000
215.158.239.57,<->,195.83.213.141,2,112,0,0,2,112,0.029438000,0.0207
136.25.189.34,<->,96.156.169.244,2,112,0,0,2,112,0.029278000,0.0003
159.135.57.93,<->,8.52.187.74,0,0,2,100,2,100,0.029153000,0.0000
136.25.189.196,<->,129.222.39.192,2,112,0,0,2,112,0.028938000,0.0634
215.158.238.38,<->,144.253.55.121,2,760,0,0,2,760,0.028777000,0.0586
142.209.175.132,<->,136.25.188.178,0,0,2,106,2,106,0.028559000,0.2815
204.184.249.225,<->,136.25.188.53,0,0,2,112,2,112,0.028537000,0.8799
215.158.239.58,<->,199.20.6.162,2,1105,0,0,2,1105,0.028426000,0.9398
103.47.196.204,<->,8.220.176.253,0,0,2,106,2,106,0.028317000,0.0324
193.16.142.209,<->,50.224.76.235,0,0,2,120,2,120,0.028272000,0.1155
215.158.239.48,<->,196.91.74.178,2,128,0,0,2,128,0.028175000,0.9392
100.228.42.93,<->,100.19.14.54,2,100,0,0,2,100,0.028084000,0.2337
215.158.238.106,<->,131.215.37.23,2,1333,0,0,2,1333,0.028018000,0.1264
215.158.42.8,<->,133.178.226.176,0,0,2,112,2,112,0.027991000,0.0209
142.248.156.89,<->,136.25.188.177,0,0,2,112,2,112,0.027545000,0.0000
142.248.63.21,<->,136.25.188.255,0,0,2,220,2,220,0.027274000,0.1866
215.158.239.51,<->,199.20.6.158,2,757,0,0,2,757,0.027091000,0.1955
199.5.237.236,<->,50.224.96.57,0,0,2,100,2,100,0.026459000,0.1681
204.186.160.119,<->,136.25.188.54,0,0,2,128,2,128,0.026327000,1.6768
210.158.44.69,<->,193.87.5.172,2,100,0,0,2,100,0.026263000,0.1453
215.158.239.92,<->,195.40.179.127,2,124,0,0,2,124,0.026208000,0.1978
204.200.57.166,<->,136.25.188.176,0,0,2,106,2,106,0.025993000,0.0640
159.112.9.198,<->,144.87.235.222,0,0,2,131,2,131,0.025337000,1.9492
215.158.61.242,<->,8.176.8.179,0,0,2,1316,2,1316,0.024629000,1.5468
229.45.207.12,<->,53.230.44.150,2,707,0,0,2,707,0.024607000,1.3362
215.158.61.191,<->,8.176.8.240,0,0,2,741,2,741,0.024585000,0.0036
255.46.252.69,<->,109.222.246.96,0,0,2,112,2,112,0.024557000,0.0000
94.192.165.151,<->,8.252.222.37,0,0,2,112,2,112,0.024552000,0.4869
137.69.181.98,<->,8.182.227.214,0,0,2,100,2,100,0.024426000,0.0329
91.243.252.184,<->,80.41.252.59,0,0,2,184,2,184,0.024363000,0.3897
196.88.176.13,<->,136.25.188.239,0,0,2,143,2,143,0.024279000,0.0012
139.1.221.230,<->,136.25.189.18,0,0,2,1269,2,1269,0.024121000,0.1029
215.158.140.231,<->,61.35.22.249,2,1174,0,0,2,1174,0.024015000,0.2578
199.14.236.189,<->,136.25.188.240,0,0,2,100,2,100,0.023942000,0.0000
220.20.200.36,<->,131.45.239.178,2,489,0,0,2,489,0.023710000,0.0004
143.10.66.79,<->,136.25.188.45,0,0,2,228,2,228,0.023580000,0.0062
138.127.225.202,<->,33.233.141.73,0,0,2,560,2,560,0.023532000,0.0033
204.62.101.42,<->,136.25.188.239,0,0,2,112,2,112,0.023519000,0.1037
216.144.178.49,<->,215.158.140.184,0,0,2,100,2,100,0.023360000,0.0370
136.25.189.1,<->,8.47.120.153,2,112,0,0,2,112,0.022363000,0.0002
129.224.112.252,<->,92.160.15.190,2,150,0,0,2,150,0.022321000,0.0035
98.128.69.239,<->,8.55.221.134,2,125,0,0,2,125,0.021993000,0.0000
195.15.192.142,<->,136.25.188.173,0,0,2,112,2,112,0.021769000,0.4026
17.199.106.163,<->,8.220.189.81,0,0,2,100,2,100,0.021743000,0.0212
92.162.253.11,<->,89.152.226.167,2,100,0,0,2,100,0.021541000,0.0278
145.37.210.250,<->,50.224.76.235,0,0,2,100,2,100,0.021404000,0.0010
142.255.54.40,<->,136.25.188.255,0,0,2,112,2,112,0.021110000,0.0424
199.122.177.159,<->,136.25.188.225,0,0,2,100,2,100,0.020915000,0.0012
215.158.239.49,<->,196.91.85.6,2,136,0,0,2,136,0.020870000,0.2576
215.158.239.78,<->,204.21.1.62,2,228,0,0,2,228,0.020853000,0.0030
54.38.77.23,<->,48.54.50.60,0,0,2,401,2,401,0.020721000,0.0698
206.241.64.92,<->,80.41.51.42,0,0,2,269,2,269,0.020686000,0.0009
204.187.132.62,<->,136.25.188.243,0,0,2,961,2,961,0.020484000,0.0000
215.158.239.95,<->,199.20.28.169,2,100,0,0,2,100,0.020335000,0.0000
215.158.239.99,<->,199.20.28.81,2,112,0,0,2,112,0.019835000,0.0000
215.158.238.95,<->,128.180.137.170,2,1221,0,0,2,1221,0.019806000,0.1513
136.25.189.59,<->,128.69.139.94,2,1285,0,0,2,1285,0.019428000,0.2007
199.121.15.118,<->,136.25.188.226,0,0,2,112,2,112,0.019105000,0.0146
246.253.212.143,<->,109.51.250.51,2,100,0,0,2,100,0.019045000,0.0000
215.158.239.51,<->,199.20.7.145,2,143,0,0,2,143,0.018894000,0.0202
192.64.200.183,<->,0.233.39.208,2,316,0,0,2,316,0.018479000,0.9038
254.126.164.43,<->,129.224.112.252,0,0,2,152,2,152,0.018084000,1.5069
86.135.8.107,<->,8.252.222.143,0,0,2,118,2,118,0.017843000,0.2208
129.236.73.9,<->,33.233.141.6,0,0,2,688,2,688,0.017820000,0.0000
215.158.239.217,<->,215.158.61.183,2,1316,0,0,2,1316,0.017801000,0.1429
159.80.9.83,<->,8.183.25.124,0,0,2,100,2,100,0.017688000,0.0002
215.158.239.77,<->,143.132.109.119,2,112,0,0,2,112,0.017596000,0.8254
99.165.252.173,<->,8.220.176.253,0,0,2,112,2,112,0.017400000,0.0000
149.73.217.200,<->,50.224.89.243,0,0,2,1262,2,1262,0.017166000,0.1302
89.155.199.142,<->,8.182.226.78,0,0,2,609,2,609,0.017136000,0.0377
215.158.239.94,<->,199.20.31.73,2,112,0,0,2,112,0.016545000,0.5363
200.174.202.93,<->,53.161.105.187,2,964,0,0,2,964,0.016424000,1.0609
136.25.189.29,<->,61.35.124.191,2,124,0,0,2,124,0.016269000,0.0002
203.58.33.15,<->,136.25.188.239,0,0,2,112,2,112,0.016234000,0.0201
204.56.193.92,<->,136.25.188.236,0,0,2,100,2,100,0.016181000,0.1880
215.158.239.226,<->,56.97.186.124,2,100,0,0,2,100,0.015757000,0.0000
199.122.47.68,<->,136.25.188.178,0,0,2,100,2,100,0.015477000,0.5406
144.83.60.153,<->,92.162.253.70,0,0,2,564,2,564,0.015466000,0.1348
248.239.152.81,<->,8.45.175.127,2,483,0,0,2,483,0.015266000,0.0016
215.158.238.81,<->,122.158.49.195,2,1317,0,0,2,1317,0.014951000,0.1560
215.158.239.79,<->,199.20.31.132,2,128,0,0,2,128,0.014917000,1.1563
210.209.251.214,<->,137.137.124.27,0,0,2,482,2,482,0.014886000,1.0433
239.81.33.52,<->,136.25.188.220,0,0,2,100,2,100,0.014465000,0.0012
142.220.137.148,<->,136.25.188.220,0,0,2,100,2,100,0.014412000,0.6971
215.158.140.241,<->,94.164.238.233,2,112,0,0,2,112,0.014375000,0.0003
199.111.71.92,<->,50.224.76.235,0,0,2,100,2,100,0.014034000,0.0009
215.158.239.49,<->,199.20.28.9,2,100,0,0,2,100,0.013604000,0.0000
109.127.156.13,<->,8.220.176.253,0,0,2,100,2,100,0.012599000,0.0002
197.161.241.95,<->,136.25.188.225,0,0,2,264,2,264,0.012595000,0.7296
204.187.68.146,<->,136.25.188.225,0,0,2,112,2,112,0.012504000,0.0008
215.158.238.123,<->,148.129.19.245,2,112,0,0,2,112,0.012339000,0.0004
111.146.233.114,<->,50.145.196.221,2,250,0,0,2,250,0.012337000,0.8800
215.158.239.57,<->,196.95.141.97,2,989,0,0,2,989,0.011755000,0.0010
215.158.239.58,<->,199.20.30.109,2,143,0,0,2,143,0.011663000,0.0320
222.243.101.254,<->,111.20.168.6,0,0,2,297,2,297,0.011399000,0.0012
148.155.129.25,<->,101.224.89.152,0,0,2,345,2,345,0.011384000,1.0487
143.251.58.238,<->,129.78.115.208,0,0,2,112,2,112,0.011240000,1.4608
111.20.168.209,<->,17.62.194.122,2,112,0,0,2,112,0.011145000,0.0015
192.67.152.0,<->,38.111.0.61,2,100,0,0,2,100,0.011071000,0.6903
215.158.239.57,<->,159.23.130.168,2,1269,0,0,2,1269,0.010852000,0.0498
100.190.251.237,<->,8.220.176.253,0,0,2,100,2,100,0.010846000,0.0002
143.132.230.253,<->,136.25.188.45,0,0,2,948,2,948,0.010747000,0.0041
215.158.239.92,<->,195.55.179.166,2,112,0,0,2,112,0.010636000,0.0424
142.208.56.126,<->,136.25.188.226,0,0,2,220,2,220,0.010173000,0.5840
220.39.233.168,<->,215.158.238.67,0,0,2,1435,2,1435,0.010132000,0.3849
112.220.206.122,<->,82.237.235.220,0,0,2,179,2,179,0.010123000,0.0000
231.140.112.77,<->,215.158.239.76,0,0,2,112,2,112,0.010092000,0.0574
142.207.252.64,<->,136.25.188.253,0,0,2,145,2,145,0.009988000,0.1451
215.158.127.2,<->,8.176.8.85,0,0,2,655,2,655,0.009940000,0.7664
149.96.53.43,<->,136.25.188.224,0,0,2,112,2,112,0.009737000,0.0005
94.193.165.47,<->,8.252.222.46,0,0,2,112,2,112,0.009703000,0.0134
220.50.226.64,<->,136.181.43.206,0,0,2,169,2,169,0.009561000,0.0082
136.25.189.12,<->,8.215.68.80,2,1365,0,0,2,1365,0.009393000,0.0931
121.36.4.38,<->,92.27.219.244,0,0,2,104,2,104,0.009150000,1.8825
199.70.39.110,<->,136.25.188.237,0,0,2,100,2,100,0.008987000,0.0029
133.178.227.244,<->,29.214.74.153,2,112,0,0,2,112,0.008915000,0.0000
93.181.154.49,<->,92.27.27.154,0,0,2,100,2,100,0.008900000,0.1698
204.60.216.236,<->,136.25.188.196,0,0,2,136,2,136,0.008607000,1.0207
215.158.238.112,<->,122.159.31.104,2,112,0,0,2,112,0.008264000,0.0001
199.68.17.35,<->,136.25.188.252,0,0,2,106,2,106,0.008095000,0.2779
215.171.110.66,<->,8.52.181.8,0,0,2,112,2,112,0.007943000,0.0002
136.25.189.18,<->,133.56.180.11,2,1381,0,0,2,1381,0.007658000,0.0793
105.201.101.61,<->,8.220.176.253,0,0,2,112,2,112,0.007156000,0.0000
220.20.200.125,<->,35.62.67.89,2,100,0,0,2,100,0.007093000,0.0196
215.158.239.76,<->,199.20.28.59,2,112,0,0,2,112,0.006890000,0.0199
144.232.215.251,<->,8.252.221.171,0,0,2,576,2,576,0.006377000,1.8156
220.20.200.140,<->,89.153.100.60,2,106,0,0,2,106,0.005969000,0.0196
159.69.187.22,<->,144.108.64.184,2,127,0,0,2,127,0.005737000,1.0022
143.52.220.13,<->,136.25.188.53,0,0,2,100,2,100,0.005591000,0.2847
195.5.128.204,<->,136.25.188.254,0,0,2,319,2,319,0.005438000,0.6747
247.136.253.56,<->,22.250.157.130,2,112,0,0,2,112,0.005388000,0.0932
207.188.167.176,<->,136.25.188.53,0,0,2,1024,2,1024,0.005229000,1.1816
215.158.239.56,<->,199.20.29.70,2,112,0,0,2,112,0.005098000,0.0000
97.126.27.248,<->,53.83.245.42,2,125,0,0,2,125,0.004996000,0.0000
111.181.98.129,<->,8.55.195.24,2,125,0,0,2,125,0.004837000,0.0001
92.27.219.178,<->,33.57.74.163,2,100,0,0,2,100,0.004745000,0.1832
210.209.251.211,<->,192.64.106.47,0,0,2,100,2,100,0.004714000,0.0458
249.101.97.200,<->,50.145.202.200,2,165,0,0,2,165,0.004502000,0.0000
213.221.90.199,<->,144.85.170.244,0,0,2,112,2,112,0.004362000,0.6433
215.158.239.77,<->,8.255.92.180,2,1477,0,0,2,1477,0.004360000,0.0314
6.145.169.245,<->,0.195.210.44,0,0,2,143,2,143,0.004226000,0.1760
97.80.160.1,<->,8.52.169.61,0,0,2,100,2,100,0.004156000,1.1499
101.126.178.62,<->,8.55.195.24,2,147,0,0,2,147,0.004154000,0.0000
159.155.173.24,<->,50.224.80.64,0,0,2,112,2,112,0.003924000,0.6748
215.158.239.49,<->,196.1.246.204,2,338,0,0,2,338,0.003713000,0.0200
204.21.78.129,<->,136.25.188.253,0,0,2,143,2,143,0.003557000,0.0027
192.67.144.154,<->,30.179.117.60,2,149,0,0,2,149,0.003287000,0.2003
215.158.239.50,<->,114.146.74.241,2,1397,0,0,2,1397,0.003080000,1.7764
195.124.165.237,<->,136.25.188.178,0,0,2,112,2,112,0.003035000,0.9795
100.59.58.195,<->,8.220.176.253,0,0,2,106,2,106,0.003002000,0.0000
221.102.143.189,<->,220.83.54.78,0,0,2,184,2,184,0.002792000,0.9510
136.25.188.174,<->,57.247.184.229,2,112,0,0,2,112,0.002615000,0.0000
218.147.52.202,<->,8.176.60.38,0,0,2,112,2,112,0.002569000,0.0344
136.25.189.83,<->,80.56.79.87,2,1350,0,0,2,1350,0.002289000,0.0917
231.140.115.25,<->,136.25.188.45,0,0,2,106,2,106,0.002111000,0.0121
138.127.224.225,<->,33.233.141.75,0,0,2,474,2,474,0.002086000,0.0019
215.158.238.81,<->,192.228.30.86,2,112,0,0,2,112,0.001938000,0.0001
142.249.240.234,<->,136.25.188.46,0,0,2,100,2,100,0.001878000,0.1988
195.126.148.14,<->,136.25.188.53,0,0,2,157,2,157,0.001864000,0.5512
149.11.68.152,<->,92.162.253.249,0,0,2,100,2,100,0.001760000,0.0001
199.121.82.30,<->,136.25.188.255,0,0,2,143,2,143,0.001571000,0.0020
139.128.9.2,<->,8.182.224.248,0,0,2,100,2,100,0.001542000,0.0497
204.200.58.56,<->,136.25.188.176,0,0,2,100,2,100,0.001493000,0.0033
138.20.59.183,<->,98.190.125.148,0,0,2,100,2,100,0.001323000,0.0001
207.56.98.0,<->,136.25.188.176,0,0,2,106,2,106,0.001269000,1.3906
215.158.239.68,<->,195.40.235.29,2,112,0,0,2,112,0.001037000,0.0207
159.23.225.100,<->,142.247.156.43,2,144,0,0,2,144,0.000984000,0.6579
218.4.176.27,<->,8.207.172.239,2,631,0,0,2,631,0.000982000,0.0755
215.158.140.27,<->,106.188.228.48,2,120,0,0,2,120,0.000960000,0.1009
80.38.35.47,<->,33.57.119.145,2,100,0,0,2,100,0.000939000,0.0436
215.158.238.105,<->,8.191.6.84,2,112,0,0,2,112,0.000174000,0.0000
146.249.226.8,<->,8.252.222.172,0,0,2,228,2,228,0.000121000,0.0169
215.158.239.95,<->,196.91.95.183,1,56,0,0,1,56,1.999978000,0.0000
195.78.177.50,<->,100.92.78.42,0,0,1,52,1,52,1.999964000,0.0000
207.62.129.228,<->,136.25.188.163,0,0,1,50,1,50,1.999915000,0.0000
199.15.53.151,<->,136.25.188.225,0,0,1,87,1,87,1.999883000,0.0000
192.227.190.232,<->,136.25.188.194,0,0,1,106,1,106,1.999846000,0.0000
139.163.100.166,<->,119.118.53.33,1,56,0,0,1,56,1.999788000,0.0000
89.183.104.145,<->,29.138.52.78,1,159,0,0,1,159,1.999730000,0.0000
89.183.104.233,<->,50.145.212.192,1,113,0,0,1,113,1.999666000,0.0000
104.222.253.87,<->,50.224.76.234,0,0,1,68,1,68,1.999661000,0.0000
158.181.253.198,<->,137.74.92.246,0,0,1,102,1,102,1.999432000,0.0000
142.255.65.158,<->,136.25.188.253,0,0,1,56,1,56,1.999370000,0.0000
114.246.59.79,<->,97.198.118.110,0,0,1,56,1,56,1.999283000,0.0000
204.200.165.4,<->,136.25.188.198,0,0,1,64,1,64,1.999219000,0.0000
144.79.9.233,<->,92.27.26.162,0,0,1,68,1,68,1.999196000,0.0000
92.27.8.30,<->,33.213.12.50,1,64,0,0,1,64,1.999163000,0.0000
20.150.44.114,<->,0.195.25.161,1,52,0,0,1,52,1.999126000,0.0000
215.158.239.32,<->,96.135.154.128,1,1318,0,0,1,1318,1.999115000,0.0000
220.11.205.87,<->,215.158.140.207,0,0,1,1003,1,1003,1.998803000,0.0000
92.27.219.49,<->,88.1.228.33,1,52,0,0,1,52,1.998769000,0.0000
215.158.239.85,<->,199.20.28.136,1,50,0,0,1,50,1.998670000,0.0000
134.103.31.204,<->,92.27.219.131,0,0,1,56,1,56,1.998576000,0.0000
137.45.27.47,<->,92.162.252.142,0,0,1,50,1,50,1.998552000,0.0000
120.179.55.104,<->,39.22.138.81,0,0,1,52,1,52,1.998482000,0.0000
193.15.120.236,<->,102.50.153.134,0,0,1,56,1,56,1.998428000,0.0000
210.158.44.37,<->,137.45.27.47,1,50,0,0,1,50,1.998418000,0.0000
246.253.131.203,<->,124.127.239.149,1,56,0,0,1,56,1.998407000,0.0000
143.128.125.80,<->,136.25.188.163,0,0,1,64,1,64,1.998272000,0.0000
255.133.229.164,<->,111.146.144.109,0,0,1,100,1,100,1.998215000,0.0000
137.45.27.47,<->,92.162.252.30,0,0,1,370,1,370,1.998020000,0.0000
204.3.169.225,<->,136.25.188.163,0,0,1,50,1,50,1.997947000,0.0000
215.158.239.30,<->,122.159.245.155,1,1467,0,0,1,1467,1.997854000,0.0000
221.102.143.189,<->,220.83.114.215,0,0,1,75,1,75,1.997807000,0.0000
104.227.159.53,<->,20.194.26.211,0,0,1,79,1,79,1.997579000,0.0000
141.105.26.18,<->,8.252.221.198,0,0,1,50,1,50,1.997509000,0.0000
132.211.85.158,<->,98.236.90.61,0,0,1,50,1,50,1.997449000,0.0000
159.13.111.8,<->,145.116.119.49,0,0,1,50,1,50,1.997447000,0.0000
248.239.96.151,<->,8.52.183.207,0,0,1,1119,1,1119,1.997367000,0.0000
133.178.226.29,<->,29.213.195.54,1,986,0,0,1,986,1.997237000,0.0000
228.75.38.43,<->,92.162.252.233,0,0,1,50,1,50,1.997079000,0.0000
251.21.147.19,<->,92.26.139.125,0,0,1,56,1,56,1.996963000,0.0000
192.64.250.252,<->,109.219.207.11,1,50,0,0,1,50,1.996890000,0.0000
143.33.118.172,<->,8.182.253.116,0,0,1,50,1,50,1.996884000,0.0000
210.198.22.18,<->,0.195.210.46,0,0,1,56,1,56,1.996866000,0.0000
246.253.252.58,<->,137.68.121.70,1,132,0,0,1,132,1.996813000,0.0000
215.158.239.65,<->,98.219.126.140,1,64,0,0,1,64,1.996680000,0.0000
111.147.185.153,<->,53.200.100.108,1,64,0,0,1,64,1.996632000,0.0000
204.200.32.9,<->,136.25.188.52,0,0,1,93,1,93,1.996568000,0.0000
192.64.196.68,<->,125.5.189.55,1,52,0,0,1,52,1.996398000,0.0000
220.82.37.72,<->,132.18.67.26,1,50,0,0,1,50,1.996360000,0.0000
100.28.114.164,<->,50.224.76.235,0,0,1,56,1,56,1.996315000,0.0000
215.158.140.185,<->,8.222.7.187,1,976,0,0,1,976,1.996185000,0.0000
20.131.58.245,<->,0.52.14.43,1,52,0,0,1,52,1.996184000,0.0000
93.78.215.45,<->,35.56.102.223,0,0,1,64,1,64,1.996178000,0.0000
220.55.111.215,<->,76.115.75.72,1,52,0,0,1,52,1.996101000,0.0000
241.193.172.231,<->,20.227.163.227,0,0,1,50,1,50,1.996101000,0.0000
215.158.140.27,<->,131.152.227.23,1,64,0,0,1,64,1.995936000,0.0000
198.117.132.52,<->,101.224.184.81,0,0,1,57,1,57,1.995879000,0.0000
89.204.90.172,<->,8.182.136.143,0,0,1,64,1,64,1.995347000,0.0000
242.21.50.110,<->,8.182.239.144,0,0,1,50,1,50,1.995305000,0.0000
76.101.120.51,<->,8.252.222.236,0,0,1,1453,1,1453,1.995142000,0.0000
207.217.77.109,<->,8.52.164.127,0,0,1,64,1,64,1.994985000,0.0000
80.40.45.51,<->,33.184.89.31,1,149,0,0,1,149,1.994840000,0.0000
215.158.239.101,<->,129.222.39.210,1,64,0,0,1,64,1.994816000,0.0000
69.246.51.107,<->,8.252.222.29,0,0,1,68,1,68,1.994428000,0.0000
38.21.156.204,<->,20.232.230.195,0,0,1,82,1,82,1.994360000,0.0000
115.254.146.188,<->,109.222.222.203,0,0,1,74,1,74,1.994167000,0.0000
192.64.229.128,<->,0.235.158.222,1,50,0,0,1,50,1.994167000,0.0000
133.0.57.72,<->,80.40.31.57,0,0,1,56,1,56,1.994130000,0.0000
215.158.61.203,<->,8.176.8.249,0,0,1,64,1,64,1.994117000,0.0000
129.224.112.252,<->,114.145.102.35,1,80,0,0,1,80,1.994060000,0.0000
117.21.75.218,<->,8.31.37.162,0,0,1,68,1,68,1.994050000,0.0000
133.178.226.90,<->,111.151.239.91,1,64,0,0,1,64,1.993775000,0.0000
205.68.221.112,<->,97.168.64.50,0,0,1,135,1,135,1.993624000,0.0000
158.0.172.65,<->,20.80.104.99,0,0,1,76,1,76,1.993550000,0.0000
205.126.39.60,<->,20.163.79.166,0,0,1,72,1,72,1.993454000,0.0000
215.158.140.19,<->,215.158.3.139,1,56,0,0,1,56,1.993411000,0.0000
211.166.204.143,<->,89.183.104.145,0,0,1,60,1,60,1.993398000,0.0000
58.203.175.73,<->,8.252.221.199,0,0,1,68,1,68,1.993384000,0.0000
215.158.239.230,<->,29.212.43.168,1,90,0,0,1,90,1.993364000,0.0000
136.25.188.194,<->,120.154.178.37,1,135,0,0,1,135,1.993363000,0.0000
207.162.145.221,<->,8.182.230.157,0,0,1,56,1,56,1.993347000,0.0000
133.178.227.43,<->,131.173.115.67,1,1360,0,0,1,1360,1.993319000,0.0000
241.193.172.231,<->,20.134.203.193,0,0,1,50,1,50,1.993309000,0.0000
194.232.169.238,<->,136.25.188.176,0,0,1,64,1,64,1.993213000,0.0000
136.25.189.16,<->,61.34.126.165,1,1373,0,0,1,1373,1.993142000,0.0000
207.88.93.20,<->,133.178.226.80,0,0,1,1213,1,1213,1.993016000,0.0000
194.107.4.209,<->,20.179.253.243,0,0,1,64,1,64,1.992977000,0.0000
99.162.70.146,<->,54.37.162.116,1,50,0,0,1,50,1.992968000,0.0000
215.158.239.51,<->,207.56.206.102,1,50,0,0,1,50,1.992952000,0.0000
215.158.239.34,<->,139.161.104.165,1,1223,0,0,1,1223,1.992856000,0.0000
98.23.123.93,<->,8.252.222.211,0,0,1,50,1,50,1.992856000,0.0000
121.108.22.189,<->,109.222.250.46,0,0,1,52,1,52,1.992738000,0.0000
252.98.149.255,<->,137.39.55.211,1,305,0,0,1,305,1.992629000,0.0000
114.2.84.141,<->,50.224.76.234,0,0,1,56,1,56,1.992599000,0.0000
215.158.239.93,<->,196.108.252.14,1,56,0,0,1,56,1.992571000,0.0000
246.253.211.246,<->,159.140.232.210,1,50,0,0,1,50,1.992509000,0.0000
142.205.143.11,<->,99.75.122.245,0,0,1,134,1,134,1.992457000,0.0000
92.27.219.249,<->,0.238.255.238,1,68,0,0,1,68,1.992410000,0.0000
215.158.239.96,<->,199.20.5.42,1,68,0,0,1,68,1.992371000,0.0000
215.158.140.184,<->,82.25.32.253,1,56,0,0,1,56,1.992094000,0.0000
145.170.230.154,<->,8.182.239.241,0,0,1,64,1,64,1.992068000,0.0000
215.158.238.221,<->,18.202.90.165,1,1232,0,0,1,1232,1.991939000,0.0000
80.40.63.196,<->,33.241.148.5,1,104,0,0,1,104,1.991877000,0.0000
215.158.239.86,<->,194.251.113.103,1,56,0,0,1,56,1.991777000,0.0000
231.142.204.217,<->,136.25.188.163,0,0,1,797,1,797,1.991771000,0.0000
133.54.43.35,<->,88.2.255.142,1,56,0,0,1,56,1.991636000,0.0000
244.50.136.175,<->,20.112.196.245,0,0,1,50,1,50,1.991599000,0.0000
21.15.226.126,<->,20.193.16.89,0,0,1,82,1,82,1.991596000,0.0000
220.28.85.14,<->,133.178.227.10,0,0,1,56,1,56,1.991596000,0.0000
142.229.195.197,<->,136.25.188.177,0,0,1,56,1,56,1.991558000,0.0000
97.127.101.156,<->,53.201.86.104,1,56,0,0,1,56,1.991480000,0.0000
111.150.207.129,<->,8.252.222.56,0,0,1,56,1,56,1.991427000,0.0000
220.28.65.9,<->,136.25.189.5,0,0,1,56,1,56,1.991259000,0.0000
210.56.117.47,<->,8.52.187.43,0,0,1,52,1,52,1.991233000,0.0000
132.208.239.25,<->,8.204.66.217,1,56,0,0,1,56,1.991222000,0.0000
215.158.239.85,<->,196.1.146.77,1,64,0,0,1,64,1.991091000,0.0000
159.23.227.19,<->,6.75.180.167,1,50,0,0,1,50,1.991051000,0.0000
139.106.73.221,<->,8.252.222.220,0,0,1,1245,1,1245,1.990949000,0.0000
207.20.191.116,<->,8.252.222.177,0,0,1,68,1,68,1.990940000,0.0000
247.136.238.173,<->,131.34.187.34,1,56,0,0,1,56,1.990744000,0.0000
204.43.52.218,<->,133.54.31.247,0,0,1,56,1,56,1.990742000,0.0000
126.198.34.124,<->,99.73.108.110,0,0,1,330,1,330,1.990687000,0.0000
159.109.226.132,<->,74.87.157.196,1,62,0,0,1,62,1.990575000,0.0000
215.158.239.84,<->,143.88.129.170,1,89,0,0,1,89,1.990521000,0.0000
215.158.140.27,<->,198.226.166.136,1,64,0,0,1,64,1.990508000,0.0000
215.158.239.86,<->,207.57.219.52,1,781,0,0,1,781,1.990494000,0.0000
253.66.35.40,<->,8.52.171.31,0,0,1,64,1,64,1.990358000,0.0000
241.193.172.231,<->,20.217.28.78,0,0,1,50,1,50,1.990163000,0.0000
54.37.9.160,<->,48.53.95.39,0,0,1,56,1,56,1.990147000,0.0000
220.82.37.72,<->,132.18.67.28,1,50,0,0,1,50,1.990067000,0.0000
139.59.112.92,<->,8.20.87.1,0,0,1,64,1,64,1.989961000,0.0000
215.158.239.95,<->,199.20.7.5,1,56,0,0,1,56,1.989926000,0.0000
204.186.195.76,<->,136.25.188.220,0,0,1,64,1,64,1.989921000,0.0000
230.79.27.82,<->,34.53.255.128,0,0,1,52,1,52,1.989900000,0.0000
198.249.148.13,<->,98.129.91.19,0,0,1,135,1,135,1.989868000,0.0000
158.169.105.191,<->,92.27.219.253,0,0,1,100,1,100,1.989846000,0.0000
204.141.86.218,<->,144.86.149.199,0,0,1,127,1,127,1.989765000,0.0000
196.18.38.129,<->,8.20.87.254,0,0,1,50,1,50,1.989737000,0.0000
221.102.56.69,<->,80.40.51.71,0,0,1,64,1,64,1.989552000,0.0000
120.83.119.197,<->,89.183.104.255,0,0,1,326,1,326,1.989505000,0.0000
144.122.240.239,<->,144.108.80.172,1,65,0,0,1,65,1.989400000,0.0000
50.54.236.163,<->,8.220.186.82,0,0,1,64,1,64,1.989265000,0.0000
196.246.48.165,<->,136.25.188.254,0,0,1,56,1,56,1.989193000,0.0000
212.70.217.68,<->,136.25.189.17,0,0,1,1357,1,1357,1.988739000,0.0000
215.158.140.181,<->,53.231.92.194,1,56,0,0,1,56,1.988722000,0.0000
195.40.221.44,<->,136.25.188.220,0,0,1,56,1,56,1.988671000,0.0000
215.158.238.32,<->,142.205.126.4,1,1117,0,0,1,1117,1.988644000,0.0000
145.19.15.33,<->,127.255.88.114,1,82,0,0,1,82,1.988628000,0.0000
215.158.239.227,<->,111.151.107.247,1,225,0,0,1,225,1.988606000,0.0000
198.1.111.212,<->,39.18.67.96,0,0,1,52,1,52,1.988442000,0.0000
8.182.239.173,<->,6.20.48.254,1,56,0,0,1,56,1.988342000,0.0000
136.25.188.105,<->,57.51.96.228,1,115,0,0,1,115,1.988341000,0.0000
204.186.241.193,<->,136.25.188.209,0,0,1,64,1,64,1.988333000,0.0000
231.140.68.187,<->,136.25.188.209,0,0,1,50,1,50,1.988269000,0.0000
89.183.104.150,<->,59.145.182.77,1,52,0,0,1,52,1.988267000,0.0000
199.111.6.226,<->,99.75.86.46,0,0,1,80,1,80,1.988224000,0.0000
123.108.230.3,<->,20.156.215.21,0,0,1,52,1,52,1.988055000,0.0000
215.158.239.227,<->,8.220.7.92,1,165,0,0,1,165,1.987986000,0.0000
231.143.110.74,<->,136.25.188.198,0,0,1,68,1,68,1.987976000,0.0000
109.119.182.166,<->,101.70.105.13,0,0,1,50,1,50,1.987883000,0.0000
140.17.122.242,<->,92.181.189.237,0,0,1,50,1,50,1.987805000,0.0000
195.5.154.206,<->,136.25.188.175,0,0,1,64,1,64,1.987641000,0.0000
215.158.238.140,<->,29.212.195.20,1,1133,0,0,1,1133,1.987636000,0.0000
101.87.173.115,<->,100.228.42.117,0,0,1,625,1,625,1.987319000,0.0000
215.158.239.70,<->,199.20.29.147,1,64,0,0,1,64,1.987120000,0.0000
129.224.112.252,<->,97.242.126.185,1,64,0,0,1,64,1.987043000,0.0000
159.112.9.198,<->,6.122.206.12,0,0,1,81,1,81,1.986905000,0.0000
136.25.188.227,<->,30.73.101.56,1,867,0,0,1,867,1.986886000,0.0000
119.114.158.55,<->,20.167.62.152,0,0,1,64,1,64,1.986842000,0.0000
215.158.238.91,<->,98.219.126.175,1,56,0,0,1,56,1.986835000,0.0000
199.73.35.163,<->,136.25.188.177,0,0,1,56,1,56,1.986764000,0.0000
111.20.172.70,<->,101.224.89.214,0,0,1,109,1,109,1.986716000,0.0000
199.69.238.49,<->,136.25.188.54,0,0,1,85,1,85,1.986533000,0.0000
215.158.239.105,<->,215.158.61.195,1,56,0,0,1,56,1.986435000,0.0000
144.75.218.241,<->,74.87.249.24,1,84,0,0,1,84,1.986384000,0.0000
215.158.238.80,<->,29.211.186.201,1,1229,0,0,1,1229,1.986282000,0.0000
119.90.250.200,<->,20.142.78.201,0,0,1,50,1,50,1.986060000,0.0000
204.3.61.223,<->,136.25.188.253,0,0,1,68,1,68,1.985991000,0.0000
80.41.3.230,<->,40.222.159.21,1,138,0,0,1,138,1.985629000,0.0000
144.71.44.80,<->,120.241.62.116,1,50,0,0,1,50,1.985580000,0.0000
42.229.153.59,<->,8.20.87.8,0,0,1,56,1,56,1.985578000,0.0000
215.158.238.133,<->,123.166.46.234,1,957,0,0,1,957,1.985383000,0.0000
235.11.134.111,<->,92.27.26.96,0,0,1,57,1,57,1.985377000,0.0000
195.42.1.166,<->,136.25.188.54,0,0,1,64,1,64,1.985353000,0.0000
195.38.202.137,<->,111.146.248.194,0,0,1,135,1,135,1.985299000,0.0000
215.158.238.141,<->,8.223.224.53,1,1101,0,0,1,1101,1.985055000,0.0000
215.158.239.92,<->,196.110.250.206,1,68,0,0,1,68,1.985018000,0.0000
111.147.139.145,<->,53.161.72.23,1,59,0,0,1,59,1.984998000,0.0000
21.15.226.126,<->,20.193.16.28,0,0,1,82,1,82,1.984940000,0.0000
192.67.154.172,<->,111.93.103.218,1,52,0,0,1,52,1.984935000,0.0000
215.158.239.99,<->,199.20.5.49,1,117,0,0,1,117,1.984887000,0.0000
17.214.123.92,<->,8.220.190.86,0,0,1,52,1,52,1.984761000,0.0000
111.147.134.68,<->,97.46.125.149,1,56,0,0,1,56,1.984663000,0.0000
215.158.239.200,<->,96.135.155.49,1,56,0,0,1,56,1.984558000,0.0000
48.131.158.200,<->,8.252.222.205,0,0,1,1341,1,1341,1.984358000,0.0000
111.146.222.49,<->,53.245.224.206,1,50,0,0,1,50,1.984207000,0.0000
157.122.55.218,<->,139.163.81.173,0,0,1,130,1,130,1.984023000,0.0000
196.15.33.229,<->,20.52.37.66,0,0,1,60,1,60,1.983907000,0.0000
201.165.0.25,<->,92.27.219.224,0,0,1,62,1,62,1.983888000,0.0000
136.25.188.105,<->,135.79.42.213,1,421,0,0,1,421,1.983514000,0.0000
249.101.85.96,<->,56.114.235.120,1,56,0,0,1,56,1.983453000,0.0000
144.75.218.241,<->,138.127.225.228,1,365,0,0,1,365,1.983244000,0.0000
215.158.239.56,<->,199.32.147.213,1,64,0,0,1,64,1.983105000,0.0000
225.21.131.219,<->,39.229.249.211,0,0,1,64,1,64,1.983048000,0.0000
215.158.238.105,<->,8.240.123.52,1,1213,0,0,1,1213,1.982941000,0.0000
138.127.225.230,<->,101.224.89.214,0,0,1,234,1,234,1.982819000,0.0000
95.218.74.24,<->,20.181.23.119,0,0,1,90,1,90,1.982714000,0.0000
109.222.219.29,<->,54.53.82.148,1,64,0,0,1,64,1.982658000,0.0000
192.204.191.26,<->,133.32.39.1,0,0,1,64,1,64,1.982419000,0.0000
100.95.9.198,<->,80.27.153.46,1,56,0,0,1,56,1.982376000,0.0000
75.62.16.8,<->,39.168.218.49,0,0,1,50,1,50,1.982350000,0.0000
75.62.16.8,<->,39.25.12.99,0,0,1,50,1,50,1.982294000,0.0000
144.75.218.235,<->,66.121.105.164,1,272,0,0,1,272,1.982237000,0.0000
64.210.146.9,<->,8.252.221.223,0,0,1,50,1,50,1.982092000,0.0000
99.215.221.211,<->,8.182.136.41,0,0,1,50,1,50,1.981975000,0.0000
99.238.201.53,<->,92.27.219.145,0,0,1,116,1,116,1.981744000,0.0000
215.158.140.27,<->,120.155.223.237,1,64,0,0,1,64,1.981720000,0.0000
159.112.9.198,<->,89.216.126.34,0,0,1,50,1,50,1.981667000,0.0000
215.158.239.104,<->,215.158.61.145,1,56,0,0,1,56,1.981378000,0.0000
136.25.188.44,<->,91.57.162.200,1,1325,0,0,1,1325,1.981302000,0.0000
142.255.225.168,<->,136.25.188.242,0,0,1,56,1,56,1.981193000,0.0000
133.32.39.0,<->,80.47.230.86,1,64,0,0,1,64,1.981177000,0.0000
136.25.188.37,<->,60.110.124.16,1,111,0,0,1,111,1.981113000,0.0000
241.193.172.231,<->,20.57.219.146,0,0,1,50,1,50,1.981092000,0.0000
215.158.238.83,<->,97.243.113.38,1,1101,0,0,1,1101,1.980888000,0.0000
220.81.25.122,<->,112.70.205.172,1,52,0,0,1,52,1.980800000,0.0000
141.97.30.94,<->,109.222.212.23,0,0,1,52,1,52,1.980761000,0.0000
215.158.239.84,<->,199.72.69.159,1,64,0,0,1,64,1.980651000,0.0000
144.75.218.246,<->,138.127.224.194,1,190,0,0,1,190,1.980636000,0.0000
215.158.239.58,<->,207.167.198.116,1,64,0,0,1,64,1.980435000,0.0000
215.158.238.190,<->,122.216.233.213,1,1032,0,0,1,1032,1.980367000,0.0000
20.13.111.183,<->,0.200.50.50,1,60,0,0,1,60,1.980305000,0.0000
221.102.56.69,<->,6.74.104.139,0,0,1,64,1,64,1.980283000,0.0000
210.209.251.211,<->,97.126.71.96,0,0,1,50,1,50,1.980155000,0.0000
95.245.93.205,<->,34.198.150.184,0,0,1,52,1,52,1.980141000,0.0000
198.161.241.212,<->,92.162.253.78,0,0,1,56,1,56,1.980099000,0.0000
195.15.203.16,<->,136.25.188.236,0,0,1,50,1,50,1.979930000,0.0000
132.192.226.82,<->,103.151.64.177,1,68,0,0,1,68,1.979729000,0.0000
136.25.188.163,<->,97.78.199.128,1,68,0,0,1,68,1.979641000,0.0000
111.146.141.66,<->,54.43.163.228,1,56,0,0,1,56,1.979586000,0.0000
145.252.118.185,<->,122.245.134.111,1,56,0,0,1,56,1.979435000,0.0000
136.25.189.46,<->,6.29.108.20,1,1309,0,0,1,1309,1.979403000,0.0000
222.65.17.196,<->,89.90.108.122,1,56,0,0,1,56,1.979309000,0.0000
68.74.242.126,<->,8.252.221.236,0,0,1,50,1,50,1.979252000,0.0000
144.75.218.237,<->,138.127.225.96,1,289,0,0,1,289,1.979163000,0.0000
136.25.188.174,<->,6.141.187.19,1,50,0,0,1,50,1.979131000,0.0000
246.253.253.79,<->,129.245.206.220,1,736,0,0,1,736,1.979128000,0.0000
215.158.238.251,<->,8.190.217.24,1,1052,0,0,1,1052,1.978821000,0.0000
89.183.104.236,<->,0.66.204.156,1,147,0,0,1,147,1.978695000,0.0000
138.127.225.201,<->,101.224.89.170,0,0,1,245,1,245,1.978612000,0.0000
20.13.111.176,<->,0.200.50.50,1,60,0,0,1,60,1.978557000,0.0000
204.200.45.196,<->,136.25.188.177,0,0,1,56,1,56,1.978407000,0.0000
89.183.107.124,<->,35.62.70.48,1,64,0,0,1,64,1.977800000,0.0000
92.27.27.185,<->,72.52.29.6,1,718,0,0,1,718,1.977764000,0.0000
131.142.1.12,<->,20.91.67.234,0,0,1,74,1,74,1.977667000,0.0000
215.158.239.56,<->,199.20.29.198,1,64,0,0,1,64,1.977648000,0.0000
127.67.30.87,<->,39.24.93.200,0,0,1,64,1,64,1.977452000,0.0000
204.89.88.29,<->,100.92.2.40,0,0,1,56,1,56,1.977325000,0.0000
215.158.140.188,<->,8.240.246.251,1,64,0,0,1,64,1.977293000,0.0000
129.225.141.239,<->,129.225.132.87,0,0,1,56,1,56,1.977038000,0.0000
215.158.239.76,<->,204.0.249.18,1,68,0,0,1,68,1.976924000,0.0000
195.55.79.222,<->,136.25.188.252,0,0,1,50,1,50,1.976872000,0.0000
215.158.140.184,<->,97.187.188.220,1,56,0,0,1,56,1.976857000,0.0000
201.216.164.96,<->,39.2.106.170,0,0,1,64,1,64,1.976808000,0.0000
136.181.43.173,<->,53.230.100.158,1,64,0,0,1,64,1.976624000,0.0000
142.240.207.237,<->,136.25.188.176,0,0,1,56,1,56,1.976592000,0.0000
126.224.191.225,<->,20.113.0.232,0,0,1,64,1,64,1.976469000,0.0000
50.224.76.235,<->,8.142.42.110,1,56,0,0,1,56,1.976357000,0.0000
220.20.200.48,<->,127.255.84.41,1,56,0,0,1,56,1.976243000,0.0000
248.239.155.152,<->,8.45.175.127,1,56,0,0,1,56,1.975993000,0.0000
207.1.56.190,<->,100.95.213.81,0,0,1,59,1,59,1.975908000,0.0000
133.178.226.28,<->,113.23.117.52,1,1165,0,0,1,1165,1.975726000,0.0000
215.158.239.77,<->,128.194.246.149,1,1309,0,0,1,1309,1.975424000,0.0000
126.210.233.248,<->,100.93.87.235,0,0,1,136,1,136,1.975417000,0.0000
215.158.239.1,<->,96.135.154.112,1,56,0,0,1,56,1.975258000,0.0000
156.31.152.157,<->,39.128.209.5,0,0,1,80,1,80,1.975142000,0.0000
139.163.26.146,<->,122.223.107.33,1,99,0,0,1,99,1.975126000,0.0000
204.185.224.43,<->,136.25.188.45,0,0,1,64,1,64,1.975050000,0.0000
129.19.157.66,<->,89.139.241.98,0,0,1,130,1,130,1.974969000,0.0000
129.224.112.252,<->,92.162.219.75,1,92,0,0,1,92,1.974920000,0.0000
194.207.33.51,<->,100.94.11.80,0,0,1,62,1,62,1.974873000,0.0000
215.158.239.48,<->,199.20.29.254,1,68,0,0,1,68,1.974859000,0.0000
136.25.189.18,<->,125.84.55.43,1,1213,0,0,1,1213,1.974724000,0.0000
98.23.123.117,<->,8.182.250.109,0,0,1,56,1,56,1.974627000,0.0000
223.141.6.241,<->,111.146.236.254,0,0,1,56,1,56,1.974572000,0.0000
98.67.151.123,<->,54.41.177.117,1,56,0,0,1,56,1.974546000,0.0000
215.158.239.79,<->,29.211.93.15,1,1373,0,0,1,1373,1.974437000,0.0000
21.15.226.126,<->,20.193.16.194,0,0,1,82,1,82,1.974183000,0.0000
192.67.141.167,<->,40.212.154.182,1,52,0,0,1,52,1.974043000,0.0000
204.115.73.222,<->,8.228.208.181,0,0,1,125,1,125,1.974006000,0.0000
144.75.218.242,<->,140.138.71.29,1,73,0,0,1,73,1.973822000,0.0000
215.158.239.84,<->,196.91.27.235,1,64,0,0,1,64,1.973417000,0.0000
112.24.68.114,<->,80.38.35.91,0,0,1,50,1,50,1.973302000,0.0000
195.5.41.67,<->,136.25.188.196,0,0,1,56,1,56,1.973291000,0.0000
244.50.133.60,<->,39.218.157.180,0,0,1,50,1,50,1.973240000,0.0000
231.140.0.254,<->,215.158.239.69,0,0,1,64,1,64,1.973137000,0.0000
241.193.172.231,<->,20.45.99.143,0,0,1,50,1,50,1.973092000,0.0000
220.20.200.184,<->,113.173.254.227,1,50,0,0,1,50,1.973045000,0.0000
206.62.116.77,<->,80.40.50.117,0,0,1,56,1,56,1.972968000,0.0000
8.182.227.71,<->,6.20.54.210,1,50,0,0,1,50,1.972897000,0.0000
86.135.221.233,<->,8.252.222.161,0,0,1,56,1,56,1.972895000,0.0000
144.75.218.242,<->,138.127.225.176,1,264,0,0,1,264,1.972662000,0.0000
132.150.31.48,<->,8.52.245.115,0,0,1,56,1,56,1.972486000,0.0000
133.178.226.19,<->,29.212.195.22,1,1277,0,0,1,1277,1.972462000,0.0000
231.140.144.102,<->,215.158.239.79,0,0,1,56,1,56,1.972458000,0.0000
215.158.239.57,<->,123.166.46.199,1,1069,0,0,1,1069,1.972267000,0.0000
144.75.218.241,<->,143.46.2.230,1,122,0,0,1,122,1.972216000,0.0000
215.158.238.107,<->,137.199.206.19,1,1325,0,0,1,1325,1.971964000,0.0000
215.158.239.56,<->,196.0.229.34,1,56,0,0,1,56,1.971948000,0.0000
200.174.120.214,<->,53.200.172.198,1,64,0,0,1,64,1.971894000,0.0000
197.145.200.52,<->,39.63.202.2,0,0,1,64,1,64,1.971866000,0.0000
215.158.239.85,<->,196.94.6.49,1,56,0,0,1,56,1.971402000,0.0000
205.37.16.248,<->,100.95.97.95,0,0,1,321,1,321,1.971307000,0.0000
159.23.226.109,<->,74.17.139.222,1,76,0,0,1,76,1.971200000,0.0000
215.158.238.120,<->,57.210.107.19,1,1197,0,0,1,1197,1.971192000,0.0000
127.186.169.193,<->,92.27.219.235,0,0,1,351,1,351,1.971094000,0.0000
215.158.140.147,<->,8.222.7.160,1,972,0,0,1,972,1.971053000,0.0000
215.158.140.230,<->,99.75.20.97,1,50,0,0,1,50,1.970726000,0.0000
215.158.239.70,<->,194.237.186.48,1,56,0,0,1,56,1.970593000,0.0000
215.158.238.104,<->,61.72.108.212,1,1309,0,0,1,1309,1.970538000,0.0000
195.42.1.166,<->,136.25.188.225,0,0,1,765,1,765,1.970480000,0.0000
215.158.239.97,<->,143.128.238.15,1,64,0,0,1,64,1.970420000,0.0000
69.196.64.236,<->,39.147.215.76,0,0,1,64,1,64,1.970296000,0.0000
132.128.61.86,<->,6.73.197.34,0,0,1,56,1,56,1.970216000,0.0000
136.25.188.177,<->,8.42.43.25,1,1292,0,0,1,1292,1.970067000,0.0000
215.158.239.77,<->,118.9.217.201,1,1373,0,0,1,1373,1.969710000,0.0000
132.168.178.101,<->,132.149.113.27,0,0,1,69,1,69,1.969701000,0.0000
98.236.90.61,<->,54.54.128.143,1,56,0,0,1,56,1.969477000,0.0000
196.234.222.249,<->,39.238.234.210,0,0,1,64,1,64,1.969457000,0.0000
6.145.165.30,<->,0.195.210.44,0,0,1,116,1,116,1.969420000,0.0000
199.71.74.249,<->,136.25.188.255,0,0,1,64,1,64,1.969395000,0.0000
195.0.198.20,<->,50.224.76.235,0,0,1,56,1,56,1.969387000,0.0000
215.158.238.134,<->,113.23.21.196,1,1213,0,0,1,1213,1.969290000,0.0000
215.158.239.9,<->,57.185.183.147,1,56,0,0,1,56,1.969227000,0.0000
204.89.88.29,<->,100.92.2.1,0,0,1,56,1,56,1.969208000,0.0000
220.55.66.44,<->,126.198.120.245,1,196,0,0,1,196,1.969182000,0.0000
102.81.253.61,<->,8.55.213.118,1,56,0,0,1,56,1.968536000,0.0000
230.83.114.145,<->,138.73.32.96,0,0,1,133,1,133,1.968307000,0.0000
50.224.76.235,<->,18.203.251.142,1,68,0,0,1,68,1.968127000,0.0000
137.21.23.50,<->,111.150.207.99,1,100,0,0,1,100,1.968110000,0.0000
132.49.150.50,<->,54.38.65.101,1,56,0,0,1,56,1.968096000,0.0000
29.214.109.137,<->,8.252.223.175,0,0,1,1357,1,1357,1.968050000,0.0000
143.155.227.43,<->,136.25.188.239,0,0,1,1117,1,1117,1.967980000,0.0000
246.253.145.97,<->,142.92.152.234,1,50,0,0,1,50,1.967961000,0.0000
244.50.129.64,<->,39.60.99.237,0,0,1,50,1,50,1.967942000,0.0000
196.113.186.195,<->,39.246.85.153,0,0,1,64,1,64,1.967853000,0.0000
196.113.186.195,<->,39.246.85.149,0,0,1,64,1,64,1.967848000,0.0000
122.202.156.172,<->,92.27.219.203,0,0,1,1244,1,1244,1.967742000,0.0000
210.220.219.150,<->,53.180.28.29,1,56,0,0,1,56,1.967715000,0.0000
192.67.150.17,<->,126.198.147.25,1,50,0,0,1,50,1.967659000,0.0000
215.158.238.9,<->,140.139.141.135,1,1453,0,0,1,1453,1.967585000,0.0000
100.182.99.11,<->,20.179.122.28,0,0,1,52,1,52,1.967441000,0.0000
142.236.73.34,<->,136.25.188.178,0,0,1,64,1,64,1.967409000,0.0000
215.158.239.70,<->,199.20.29.250,1,68,0,0,1,68,1.967380000,0.0000
220.55.123.209,<->,57.140.246.54,1,76,0,0,1,76,1.967341000,0.0000
143.128.10.11,<->,136.25.188.225,0,0,1,56,1,56,1.967209000,0.0000
143.128.125.80,<->,136.25.188.198,0,0,1,64,1,64,1.967033000,0.0000
139.163.26.146,<->,105.116.179.226,1,99,0,0,1,99,1.967008000,0.0000
215.158.238.123,<->,29.211.186.57,1,1165,0,0,1,1165,1.966804000,0.0000
132.200.62.136,<->,132.200.51.49,1,64,0,0,1,64,1.966658000,0.0000
215.158.238.92,<->,154.183.124.180,1,1229,0,0,1,1229,1.966641000,0.0000
204.200.40.210,<->,136.25.188.241,0,0,1,50,1,50,1.966561000,0.0000
145.252.112.8,<->,100.120.38.6,1,64,0,0,1,64,1.966547000,0.0000
21.15.226.126,<->,20.193.16.198,0,0,1,82,1,82,1.966515000,0.0000
215.158.61.183,<->,136.25.188.38,0,0,1,56,1,56,1.966486000,0.0000
215.158.238.188,<->,122.159.123.90,1,1229,0,0,1,1229,1.966331000,0.0000
199.73.69.101,<->,136.25.188.177,0,0,1,56,1,56,1.966305000,0.0000
57.211.43.70,<->,6.228.19.248,0,0,1,76,1,76,1.966258000,0.0000
132.200.62.194,<->,132.200.50.118,1,64,0,0,1,64,1.966012000,0.0000
109.222.219.165,<->,8.232.96.250,1,50,0,0,1,50,1.965338000,0.0000
92.27.219.241,<->,54.39.184.254,1,50,0,0,1,50,1.965331000,0.0000
215.158.238.73,<->,143.14.191.92,1,64,0,0,1,64,1.965162000,0.0000
241.193.172.231,<->,20.252.172.188,0,0,1,50,1,50,1.964740000,0.0000
215.158.239.78,<->,199.20.28.136,1,50,0,0,1,50,1.964710000,0.0000
142.167.133.152,<->,136.25.188.220,0,0,1,68,1,68,1.964661000,0.0000
77.23.78.17,<->,8.250.155.174,0,0,1,52,1,52,1.964626000,0.0000
155.197.244.164,<->,139.163.26.146,0,0,1,99,1,99,1.964495000,0.0000
54.37.1.37,<->,48.53.108.81,0,0,1,64,1,64,1.964437000,0.0000
231.139.38.178,<->,136.25.188.196,0,0,1,56,1,56,1.964197000,0.0000
215.158.238.95,<->,140.53.100.22,1,1229,0,0,1,1229,1.964167000,0.0000
124.46.191.127,<->,92.162.253.143,0,0,1,56,1,56,1.964090000,0.0000
111.147.213.251,<->,54.36.53.189,1,64,0,0,1,64,1.963886000,0.0000
144.122.240.219,<->,144.108.80.172,1,67,0,0,1,67,1.963831000,0.0000
199.12.125.72,<->,20.11.148.83,0,0,1,64,1,64,1.963797000,0.0000
215.158.239.76,<->,199.20.7.231,1,64,0,0,1,64,1.963777000,0.0000
134.240.115.66,<->,20.28.40.159,0,0,1,75,1,75,1.963709000,0.0000
118.212.146.125,<->,92.27.219.135,0,0,1,68,1,68,1.963567000,0.0000
215.158.238.241,<->,131.219.230.235,1,1229,0,0,1,1229,1.963497000,0.0000
215.158.239.94,<->,207.115.240.48,1,68,0,0,1,68,1.963469000,0.0000
198.158.197.83,<->,20.250.232.128,0,0,1,50,1,50,1.963366000,0.0000
144.75.218.237,<->,27.9.184.49,1,50,0,0,1,50,1.963146000,0.0000
117.16.117.117,<->,50.224.76.230,0,0,1,56,1,56,1.963114000,0.0000
215.158.239.56,<->,195.83.240.149,1,64,0,0,1,64,1.963084000,0.0000
215.158.209.212,<->,8.43.213.44,0,0,1,1004,1,1004,1.963049000,0.0000
215.158.238.228,<->,0.195.237.14,1,56,0,0,1,56,1.963013000,0.0000
231.142.10.38,<->,215.158.239.49,0,0,1,56,1,56,1.962842000,0.0000
140.190.33.153,<->,133.178.227.40,0,0,1,1140,1,1140,1.962423000,0.0000
17.235.101.99,<->,8.220.191.154,0,0,1,50,1,50,1.962378000,0.0000
207.92.55.92,<->,8.182.241.53,0,0,1,50,1,50,1.962344000,0.0000
136.109.250.194,<->,97.126.11.149,0,0,1,67,1,67,1.962264000,0.0000
220.55.110.129,<->,129.213.110.99,1,481,0,0,1,481,1.962226000,0.0000
222.21.126.151,<->,129.92.116.90,0,0,1,56,1,56,1.962039000,0.0000
249.101.235.50,<->,97.110.90.234,1,52,0,0,1,52,1.962037000,0.0000
192.67.154.172,<->,92.18.109.207,1,52,0,0,1,52,1.962022000,0.0000
199.70.109.87,<->,136.25.188.177,0,0,1,64,1,64,1.961716000,0.0000
215.158.239.93,<->,196.95.172.185,1,64,0,0,1,64,1.961598000,0.0000
21.15.226.126,<->,20.193.16.200,0,0,1,82,1,82,1.961534000,0.0000
74.133.46.131,<->,39.230.66.15,0,0,1,64,1,64,1.961475000,0.0000
215.158.238.250,<->,38.104.11.117,1,1052,0,0,1,1052,1.961427000,0.0000
105.186.185.140,<->,80.41.16.79,0,0,1,149,1,149,1.961164000,0.0000
136.25.189.80,<->,113.26.84.231,1,1437,0,0,1,1437,1.961118000,0.0000
80.42.136.213,<->,66.63.73.20,1,133,0,0,1,133,1.961083000,0.0000
139.128.207.165,<->,8.182.245.10,0,0,1,50,1,50,1.961077000,0.0000
123.97.227.2,<->,20.143.217.145,0,0,1,50,1,50,1.961031000,0.0000
204.139.43.19,<->,8.182.241.177,0,0,1,50,1,50,1.960942000,0.0000
246.44.57.220,<->,215.158.209.250,1,64,0,0,1,64,1.960896000,0.0000
215.158.238.135,<->,148.255.136.200,1,1341,0,0,1,1341,1.960862000,0.0000
199.101.105.180,<->,50.224.75.112,0,0,1,68,1,68,1.960809000,0.0000
112.157.94.18,<->,22.59.22.229,0,0,1,50,1,50,1.960653000,0.0000
199.36.78.230,<->,80.41.59.155,0,0,1,56,1,56,1.960634000,0.0000
192.64.229.25,<->,105.163.85.135,1,52,0,0,1,52,1.960456000,0.0000
244.50.135.57,<->,39.43.141.70,0,0,1,50,1,50,1.960158000,0.0000
33.183.115.16,<->,20.130.12.194,0,0,1,74,1,74,1.959705000,0.0000
215.158.61.195,<->,8.176.8.208,0,0,1,1405,1,1405,1.959563000,0.0000
194.207.115.18,<->,0.195.210.46,0,0,1,64,1,64,1.959423000,0.0000
193.24.163.34,<->,98.128.56.197,0,0,1,104,1,104,1.959398000,0.0000
148.151.111.65,<->,39.30.20.140,0,0,1,60,1,60,1.959127000,0.0000
192.67.130.85,<->,139.241.58.89,1,50,0,0,1,50,1.959072000,0.0000
215.158.239.69,<->,195.54.42.195,1,64,0,0,1,64,1.958753000,0.0000
111.25.53.181,<->,109.222.208.103,0,0,1,50,1,50,1.958349000,0.0000
204.61.21.163,<->,136.25.188.198,0,0,1,56,1,56,1.958270000,0.0000
48.143.194.92,<->,8.252.221.197,0,0,1,56,1,56,1.958164000,0.0000
195.43.106.95,<->,136.25.188.255,0,0,1,765,1,765,1.957961000,0.0000
207.7.232.242,<->,136.25.188.238,0,0,1,50,1,50,1.957517000,0.0000
20.193.201.119,<->,0.54.136.108,1,52,0,0,1,52,1.957501000,0.0000
136.25.188.105,<->,135.79.32.181,1,421,0,0,1,421,1.957477000,0.0000
53.231.66.18,<->,33.233.141.29,0,0,1,56,1,56,1.957402000,0.0000
195.70.148.185,<->,136.25.188.220,0,0,1,50,1,50,1.957334000,0.0000
247.136.237.127,<->,227.29.2.32,1,461,0,0,1,461,1.957334000,0.0000
123.97.227.2,<->,20.80.52.53,0,0,1,50,1,50,1.957225000,0.0000
241.193.172.231,<->,20.24.5.183,0,0,1,50,1,50,1.957071000,0.0000
142.190.83.146,<->,136.25.188.226,0,0,1,50,1,50,1.956982000,0.0000
97.182.7.18,<->,8.20.87.155,0,0,1,50,1,50,1.956863000,0.0000
207.6.222.77,<->,92.27.27.179,0,0,1,50,1,50,1.956856000,0.0000
246.253.217.173,<->,204.130.127.20,1,56,0,0,1,56,1.956852000,0.0000
215.158.239.56,<->,199.20.4.11,1,64,0,0,1,64,1.956814000,0.0000
129.80.215.175,<->,102.231.180.247,0,0,1,50,1,50,1.956628000,0.0000
142.229.138.205,<->,136.25.188.177,0,0,1,50,1,50,1.956599000,0.0000
109.222.242.1,<->,39.53.18.121,1,79,0,0,1,79,1.956526000,0.0000
241.193.172.231,<->,20.219.60.26,0,0,1,50,1,50,1.956441000,0.0000
143.79.14.5,<->,136.25.188.45,0,0,1,64,1,64,1.956396000,0.0000
215.158.239.50,<->,199.20.28.92,1,56,0,0,1,56,1.956211000,0.0000
199.122.112.174,<->,136.25.188.54,0,0,1,64,1,64,1.956179000,0.0000
94.193.121.48,<->,8.252.221.221,0,0,1,56,1,56,1.956033000,0.0000
39.54.70.100,<->,33.96.221.241,1,103,0,0,1,103,1.956010000,0.0000
122.218.155.118,<->,97.126.114.255,0,0,1,76,1,76,1.955992000,0.0000
159.23.227.19,<->,113.16.249.135,1,50,0,0,1,50,1.955988000,0.0000
102.254.148.39,<->,20.250.25.254,0,0,1,64,1,64,1.955974000,0.0000
204.60.31.183,<->,136.25.188.222,0,0,1,64,1,64,1.955849000,0.0000
56.9.114.189,<->,8.182.226.23,0,0,1,50,1,50,1.955743000,0.0000
133.178.226.61,<->,33.221.186.184,1,1277,0,0,1,1277,1.955680000,0.0000
120.83.106.204,<->,89.183.104.146,0,0,1,326,1,326,1.955553000,0.0000
215.158.239.94,<->,142.236.76.48,1,64,0,0,1,64,1.955456000,0.0000
123.87.182.27,<->,20.207.7.39,0,0,1,179,1,179,1.955322000,0.0000
92.26.158.146,<->,42.124.209.56,1,85,0,0,1,85,1.955265000,0.0000
248.225.29.205,<->,53.246.217.9,1,64,0,0,1,64,1.955018000,0.0000
133.178.226.254,<->,113.23.56.27,1,90,0,0,1,90,1.954727000,0.0000
100.94.43.120,<->,89.205.197.79,1,50,0,0,1,50,1.954496000,0.0000
204.184.145.40,<->,136.25.188.208,0,0,1,64,1,64,1.954496000,0.0000
144.87.235.187,<->,29.211.97.161,1,142,0,0,1,142,1.954462000,0.0000
215.158.238.241,<->,197.133.131.184,1,1194,0,0,1,1194,1.954368000,0.0000
75.62.16.8,<->,39.132.161.249,0,0,1,50,1,50,1.954285000,0.0000
136.25.189.45,<->,32.183.36.100,1,1373,0,0,1,1373,1.954193000,0.0000
247.136.155.16,<->,14.30.152.17,1,64,0,0,1,64,1.954147000,0.0000
135.243.190.253,<->,8.52.182.91,0,0,1,50,1,50,1.954075000,0.0000
196.148.133.194,<->,27.64.152.81,1,50,0,0,1,50,1.953908000,0.0000
53.161.232.41,<->,48.53.205.19,0,0,1,56,1,56,1.953861000,0.0000
133.178.226.61,<->,69.132.46.246,1,1357,0,0,1,1357,1.953742000,0.0000
115.223.138.39,<->,8.228.211.21,0,0,1,79,1,79,1.953588000,0.0000
215.158.239.86,<->,57.226.224.10,1,1453,0,0,1,1453,1.953582000,0.0000
195.123.228.195,<->,99.75.237.141,0,0,1,133,1,133,1.953564000,0.0000
207.43.34.10,<->,50.224.76.230,0,0,1,56,1,56,1.953557000,0.0000
215.158.238.96,<->,126.219.196.169,1,1181,0,0,1,1181,1.953535000,0.0000
241.193.172.231,<->,20.8.200.187,0,0,1,50,1,50,1.953475000,0.0000
144.75.218.237,<->,138.127.230.88,1,284,0,0,1,284,1.953432000,0.0000
215.158.239.59,<->,201.211.113.185,1,1357,0,0,1,1357,1.953369000,0.0000
207.191.140.59,<->,136.25.188.255,0,0,1,85,1,85,1.953239000,0.0000
8.252.222.205,<->,6.9.213.201,1,68,0,0,1,68,1.953208000,0.0000
101.70.115.201,<->,89.204.234.102,1,353,0,0,1,353,1.953096000,0.0000
139.33.174.15,<->,101.70.121.141,0,0,1,50,1,50,1.953020000,0.0000
136.25.188.220,<->,131.144.116.202,1,1245,0,0,1,1245,1.952891000,0.0000
159.112.9.198,<->,100.95.43.195,0,0,1,81,1,81,1.952878000,0.0000
136.25.188.45,<->,122.159.245.157,1,1357,0,0,1,1357,1.952861000,0.0000
239.66.105.251,<->,92.27.27.155,0,0,1,50,1,50,1.952768000,0.0000
8.232.217.43,<->,8.228.215.7,0,0,1,64,1,64,1.952767000,0.0000
140.17.122.242,<->,98.200.189.252,0,0,1,50,1,50,1.952687000,0.0000
159.137.162.213,<->,107.28.211.75,1,56,0,0,1,56,1.952636000,0.0000
204.95.236.10,<->,50.223.3.228,0,0,1,50,1,50,1.952602000,0.0000
195.4.113.29,<->,136.25.188.236,0,0,1,669,1,669,1.952571000,0.0000
143.137.125.28,<->,8.220.176.253,0,0,1,50,1,50,1.952523000,0.0000
139.128.16.120,<->,8.182.235.52,0,0,1,50,1,50,1.952484000,0.0000
145.3.142.7,<->,39.237.228.63,0,0,1,64,1,64,1.952479000,0.0000
95.246.72.11,<->,8.252.222.149,0,0,1,50,1,50,1.952473000,0.0000
215.158.239.84,<->,199.20.29.134,1,68,0,0,1,68,1.952454000,0.0000
96.232.239.44,<->,92.27.27.178,0,0,1,50,1,50,1.952360000,0.0000
143.215.4.70,<->,8.182.243.141,0,0,1,68,1,68,1.952316000,0.0000
113.189.252.246,<->,20.206.136.250,0,0,1,68,1,68,1.952291000,0.0000
98.23.97.141,<->,20.194.5.86,0,0,1,50,1,50,1.952233000,0.0000
207.44.226.99,<->,80.40.34.3,0,0,1,59,1,59,1.952207000,0.0000
159.36.226.144,<->,8.52.222.23,0,0,1,50,1,50,1.952081000,0.0000
246.253.168.231,<->,119.118.171.99,1,50,0,0,1,50,1.951940000,0.0000
195.3.109.168,<->,8.20.87.206,0,0,1,50,1,50,1.951859000,0.0000
105.119.200.246,<->,8.220.206.28,0,0,1,704,1,704,1.951857000,0.0000
113.196.116.177,<->,92.27.219.203,0,0,1,52,1,52,1.951809000,0.0000
215.158.238.200,<->,131.141.218.123,1,163,0,0,1,163,1.951764000,0.0000
159.31.207.15,<->,54.58.201.137,1,56,0,0,1,56,1.951705000,0.0000
139.114.178.206,<->,99.72.214.85,0,0,1,119,1,119,1.951495000,0.0000
43.52.138.163,<->,8.252.222.36,0,0,1,614,1,614,1.951493000,0.0000
159.69.187.30,<->,144.108.64.185,1,59,0,0,1,59,1.951248000,0.0000
215.158.238.163,<->,98.166.239.40,1,134,0,0,1,134,1.951159000,0.0000
215.158.238.123,<->,27.22.184.67,1,1213,0,0,1,1213,1.951016000,0.0000
128.156.85.235,<->,8.252.221.118,0,0,1,56,1,56,1.950971000,0.0000
92.27.219.55,<->,77.49.20.48,1,62,0,0,1,62,1.950939000,0.0000
88.159.240.183,<->,80.42.185.67,0,0,1,52,1,52,1.950832000,0.0000
215.158.239.5,<->,80.57.141.213,1,1029,0,0,1,1029,1.950822000,0.0000
215.158.238.19,<->,215.158.6.245,1,85,0,0,1,85,1.950657000,0.0000
215.158.239.95,<->,199.106.86.208,1,50,0,0,1,50,1.950477000,0.0000
207.188.251.181,<->,136.25.188.45,0,0,1,68,1,68,1.950244000,0.0000
109.222.208.215,<->,80.248.212.137,1,84,0,0,1,84,1.949971000,0.0000
159.112.9.198,<->,100.95.33.52,0,0,1,81,1,81,1.949553000,0.0000
192.65.52.47,<->,8.45.168.98,1,56,0,0,1,56,1.949548000,0.0000
6.145.168.255,<->,0.195.210.44,0,0,1,56,1,56,1.949068000,0.0000
239.66.47.101,<->,144.86.146.31,0,0,1,56,1,56,1.948982000,0.0000
198.15.216.152,<->,20.207.215.219,0,0,1,64,1,64,1.948825000,0.0000
193.47.198.128,<->,8.43.212.44,0,0,1,67,1,67,1.948804000,0.0000
196.245.2.209,<->,136.25.188.177,0,0,1,76,1,76,1.948692000,0.0000
139.81.248.210,<->,8.182.121.21,1,68,0,0,1,68,1.948685000,0.0000
195.124.7.25,<->,136.25.188.227,0,0,1,56,1,56,1.948235000,0.0000
144.75.218.235,<->,138.127.225.75,1,67,0,0,1,67,1.948217000,0.0000
220.55.88.152,<->,33.57.83.147,1,56,0,0,1,56,1.948195000,0.0000
136.25.189.12,<->,120.155.8.75,1,1229,0,0,1,1229,1.948177000,0.0000
123.97.227.2,<->,20.88.252.26,0,0,1,50,1,50,1.948129000,0.0000
215.158.238.133,<->,128.123.91.104,1,1341,0,0,1,1341,1.948088000,0.0000
131.92.219.38,<->,109.1.45.255,0,0,1,50,1,50,1.948025000,0.0000
204.62.72.102,<->,136.25.188.255,0,0,1,64,1,64,1.948020000,0.0000
231.143.161.107,<->,136.25.188.53,0,0,1,56,1,56,1.947998000,0.0000
143.23.88.205,<->,136.25.188.177,0,0,1,1496,1,1496,1.947912000,0.0000
110.56.89.242,<->,97.126.114.17,0,0,1,78,1,78,1.947797000,0.0000
215.158.239.95,<->,196.109.175.222,1,64,0,0,1,64,1.947595000,0.0000
133.178.226.29,<->,104.154.137.3,1,1037,0,0,1,1037,1.947578000,0.0000
199.71.220.28,<->,136.25.188.174,0,0,1,64,1,64,1.947503000,0.0000
236.215.193.223,<->,144.122.240.200,0,0,1,70,1,70,1.947488000,0.0000
195.70.226.171,<->,136.25.188.198,0,0,1,64,1,64,1.947415000,0.0000
118.98.208.201,<->,39.251.138.176,0,0,1,64,1,64,1.947373000,0.0000
194.206.223.40,<->,8.182.241.177,0,0,1,50,1,50,1.947356000,0.0000
215.158.238.67,<->,80.47.111.107,1,1229,0,0,1,1229,1.947328000,0.0000
134.171.98.246,<->,133.178.226.30,0,0,1,1181,1,1181,1.947254000,0.0000
139.163.8.101,<->,91.69.181.188,1,56,0,0,1,56,1.947218000,0.0000
122.222.192.163,<->,39.52.51.216,0,0,1,60,1,60,1.947126000,0.0000
92.27.219.230,<->,57.224.189.60,1,325,0,0,1,325,1.947046000,0.0000
124.132.147.235,<->,92.27.219.193,0,0,1,56,1,56,1.946762000,0.0000
207.51.144.63,<->,20.181.202.148,0,0,1,75,1,75,1.946721000,0.0000
50.183.78.65,<->,8.220.189.12,0,0,1,56,1,56,1.946687000,0.0000
215.158.239.99,<->,199.68.184.64,1,64,0,0,1,64,1.946644000,0.0000
136.25.189.32,<->,65.27.220.200,1,1213,0,0,1,1213,1.946431000,0.0000
142.180.22.155,<->,8.20.87.192,0,0,1,50,1,50,1.946256000,0.0000
215.158.238.198,<->,197.133.247.170,1,1057,0,0,1,1057,1.946221000,0.0000
199.68.42.88,<->,136.25.188.55,0,0,1,50,1,50,1.946197000,0.0000
118.50.28.33,<->,92.27.219.246,0,0,1,272,1,272,1.946073000,0.0000
80.56.78.128,<->,8.182.121.229,1,85,0,0,1,85,1.946029000,0.0000
21.15.226.126,<->,20.193.17.216,0,0,1,82,1,82,1.945851000,0.0000
129.224.112.252,<->,97.242.126.197,1,64,0,0,1,64,1.945796000,0.0000
235.227.104.112,<->,50.224.76.235,0,0,1,56,1,56,1.945732000,0.0000
21.15.226.126,<->,20.193.17.255,0,0,1,82,1,82,1.945589000,0.0000
195.0.219.32,<->,50.224.76.234,0,0,1,64,1,64,1.945585000,0.0000
152.40.221.156,<->,8.252.222.140,0,0,1,68,1,68,1.945483000,0.0000
149.40.27.204,<->,20.65.103.234,0,0,1,50,1,50,1.945302000,0.0000
111.151.230.73,<->,8.252.222.219,0,0,1,284,1,284,1.945293000,0.0000
215.158.239.236,<->,29.212.43.168,1,90,0,0,1,90,1.945176000,0.0000
231.142.12.131,<->,215.158.239.97,0,0,1,64,1,64,1.945112000,0.0000
195.67.244.88,<->,39.201.89.227,0,0,1,50,1,50,1.944990000,0.0000
206.249.247.241,<->,20.92.0.191,0,0,1,64,1,64,1.944870000,0.0000
17.248.82.219,<->,8.220.179.115,0,0,1,50,1,50,1.944795000,0.0000
118.124.117.220,<->,20.69.59.180,0,0,1,98,1,98,1.944726000,0.0000
36.123.55.225,<->,8.20.87.1,0,0,1,64,1,64,1.944673000,0.0000
215.158.238.209,<->,195.65.1.160,1,1224,0,0,1,1224,1.944581000,0.0000
137.129.27.57,<->,100.50.97.15,1,98,0,0,1,98,1.944453000,0.0000
194.234.131.163,<->,136.25.188.225,0,0,1,56,1,56,1.944430000,0.0000
54.69.5.103,<->,50.224.78.60,0,0,1,69,1,69,1.944300000,0.0000
141.204.127.17,<->,133.178.226.245,0,0,1,719,1,719,1.944005000,0.0000
199.53.190.19,<->,136.25.188.242,0,0,1,64,1,64,1.943962000,0.0000
220.55.107.47,<->,126.198.186.41,1,64,0,0,1,64,1.943958000,0.0000
129.224.112.252,<->,92.162.219.30,1,98,0,0,1,98,1.943788000,0.0000
116.249.152.16,<->,50.224.76.230,0,0,1,56,1,56,1.943698000,0.0000
142.240.212.34,<->,136.25.188.238,0,0,1,56,1,56,1.943628000,0.0000
224.42.238.231,<->,20.230.128.154,0,0,1,100,1,100,1.943570000,0.0000
144.86.150.89,<->,98.219.126.36,1,64,0,0,1,64,1.943569000,0.0000
207.212.194.186,<->,92.27.27.172,0,0,1,263,1,263,1.943283000,0.0000
92.27.199.112,<->,39.5.187.195,0,0,1,52,1,52,1.943095000,0.0000
241.193.172.231,<->,20.49.212.197,0,0,1,50,1,50,1.942937000,0.0000
111.199.236.133,<->,0.195.210.44,0,0,1,87,1,87,1.942889000,0.0000
209.91.213.40,<->,8.52.142.140,0,0,1,50,1,50,1.942750000,0.0000
159.23.227.171,<->,113.16.249.135,1,296,0,0,1,296,1.942562000,0.0000
196.119.221.30,<->,92.27.194.147,0,0,1,64,1,64,1.942330000,0.0000
247.136.169.35,<->,119.159.18.186,1,50,0,0,1,50,1.942122000,0.0000
215.158.238.250,<->,8.240.116.197,1,1261,0,0,1,1261,1.942102000,0.0000
247.136.221.13,<->,8.55.197.204,1,56,0,0,1,56,1.942081000,0.0000
195.41.103.182,<->,136.25.188.225,0,0,1,56,1,56,1.942069000,0.0000
215.158.140.136,<->,128.194.246.148,1,105,0,0,1,105,1.941892000,0.0000
221.102.56.69,<->,102.81.158.156,0,0,1,64,1,64,1.941740000,0.0000
97.126.113.29,<->,91.43.65.208,1,56,0,0,1,56,1.941685000,0.0000
215.158.238.33,<->,131.215.37.23,1,1277,0,0,1,1277,1.941612000,0.0000
92.27.219.234,<->,33.240.42.133,1,309,0,0,1,309,1.941559000,0.0000
95.246.72.11,<->,8.252.222.44,0,0,1,50,1,50,1.941374000,0.0000
215.158.238.148,<->,113.23.117.86,1,64,0,0,1,64,1.941121000,0.0000
194.112.191.11,<->,39.27.113.199,0,0,1,60,1,60,1.941087000,0.0000
231.141.45.107,<->,215.158.239.76,0,0,1,653,1,653,1.940969000,0.0000
128.95.21.165,<->,39.236.57.111,0,0,1,94,1,94,1.940955000,0.0000
200.174.218.150,<->,54.59.63.210,1,50,0,0,1,50,1.940848000,0.0000
159.146.154.65,<->,132.128.61.98,1,56,0,0,1,56,1.940742000,0.0000
215.158.140.27,<->,131.1.232.239,1,64,0,0,1,64,1.940717000,0.0000
133.178.227.24,<->,131.219.230.217,1,1183,0,0,1,1183,1.940547000,0.0000
6.145.148.2,<->,0.195.210.44,0,0,1,170,1,170,1.940487000,0.0000
221.94.127.251,<->,92.27.219.207,0,0,1,64,1,64,1.940468000,0.0000
50.48.205.20,<->,8.52.188.148,0,0,1,50,1,50,1.940005000,0.0000
144.75.218.237,<->,132.208.73.30,1,186,0,0,1,186,1.939974000,0.0000
46.47.97.144,<->,8.220.176.253,0,0,1,56,1,56,1.939825000,0.0000
148.255.158.118,<->,20.44.169.38,0,0,1,76,1,76,1.939779000,0.0000
207.63.12.95,<->,20.5.20.49,0,0,1,68,1,68,1.939779000,0.0000
80.41.20.208,<->,26.218.95.80,1,50,0,0,1,50,1.939750000,0.0000
215.158.239.51,<->,199.39.127.174,1,56,0,0,1,56,1.939733000,0.0000
130.78.47.146,<->,50.224.76.234,0,0,1,56,1,56,1.939720000,0.0000
132.200.62.194,<->,132.200.51.118,1,64,0,0,1,64,1.939574000,0.0000
133.178.226.232,<->,131.244.122.215,1,64,0,0,1,64,1.939261000,0.0000
204.186.124.153,<->,136.25.188.225,0,0,1,56,1,56,1.939191000,0.0000
221.102.123.31,<->,207.86.240.212,1,50,0,0,1,50,1.939113000,0.0000
133.178.227.40,<->,8.192.205.87,1,1045,0,0,1,1045,1.939068000,0.0000
97.168.94.127,<->,50.221.176.241,1,69,0,0,1,69,1.939066000,0.0000
231.139.2.69,<->,136.25.188.162,0,0,1,56,1,56,1.938911000,0.0000
94.192.75.84,<->,8.252.221.221,0,0,1,64,1,64,1.938893000,0.0000
215.158.238.92,<->,89.84.142.39,1,1101,0,0,1,1101,1.938875000,0.0000
120.246.178.46,<->,20.159.61.248,0,0,1,64,1,64,1.938791000,0.0000
159.137.162.213,<->,126.228.240.30,1,56,0,0,1,56,1.938705000,0.0000
215.158.140.87,<->,120.247.111.110,1,50,0,0,1,50,1.938663000,0.0000
215.158.140.112,<->,111.151.142.130,1,100,0,0,1,100,1.938437000,0.0000
42.229.229.53,<->,20.115.121.156,0,0,1,68,1,68,1.938309000,0.0000
20.127.247.237,<->,6.147.69.18,1,66,0,0,1,66,1.938306000,0.0000
109.1.16.1,<->,27.188.163.162,1,444,0,0,1,444,1.938281000,0.0000
215.158.239.221,<->,215.158.61.243,1,56,0,0,1,56,1.938090000,0.0000
198.79.41.182,<->,50.224.75.42,0,0,1,56,1,56,1.938088000,0.0000
199.122.101.120,<->,136.25.188.197,0,0,1,50,1,50,1.937849000,0.0000
215.158.239.57,<->,196.88.134.223,1,960,0,0,1,960,1.937810000,0.0000
145.252.112.192,<->,98.219.117.118,1,80,0,0,1,80,1.937770000,0.0000
144.75.218.246,<->,98.101.89.6,1,809,0,0,1,809,1.937693000,0.0000
220.28.115.46,<->,215.158.140.62,0,0,1,56,1,56,1.937678000,0.0000
53.200.255.58,<->,50.224.78.62,0,0,1,68,1,68,1.937618000,0.0000
192.170.246.178,<->,99.74.26.98,0,0,1,56,1,56,1.937583000,0.0000
144.76.46.38,<->,99.75.123.162,0,0,1,50,1,50,1.937437000,0.0000
215.158.238.161,<->,98.166.239.40,1,85,0,0,1,85,1.937382000,0.0000
143.44.2.21,<->,136.25.188.44,0,0,1,64,1,64,1.937283000,0.0000
215.158.239.93,<->,207.59.68.196,1,50,0,0,1,50,1.937089000,0.0000
96.232.239.2,<->,92.27.219.36,0,0,1,50,1,50,1.936847000,0.0000
104.245.18.128,<->,50.224.76.234,0,0,1,56,1,56,1.936818000,0.0000
142.236.207.107,<->,136.25.188.225,0,0,1,50,1,50,1.936641000,0.0000
204.184.167.76,<->,136.25.188.196,0,0,1,68,1,68,1.936479000,0.0000
193.21.29.253,<->,100.94.8.152,0,0,1,50,1,50,1.936463000,0.0000
204.120.46.204,<->,8.20.87.153,0,0,1,50,1,50,1.936284000,0.0000
21.15.226.126,<->,20.193.17.238,0,0,1,82,1,82,1.936222000,0.0000
158.55.6.69,<->,20.237.57.198,0,0,1,64,1,64,1.936206000,0.0000
195.124.233.240,<->,136.25.188.46,0,0,1,56,1,56,1.936015000,0.0000
194.209.183.117,<->,39.38.165.209,0,0,1,96,1,96,1.935885000,0.0000
33.200.157.19,<->,20.129.242.221,0,0,1,74,1,74,1.935762000,0.0000
139.33.175.141,<->,111.147.142.139,0,0,1,50,1,50,1.935566000,0.0000
136.25.189.82,<->,57.227.82.200,1,1373,0,0,1,1373,1.935457000,0.0000
89.183.104.150,<->,33.245.20.181,1,52,0,0,1,52,1.935357000,0.0000
132.200.62.137,<->,132.200.51.92,1,64,0,0,1,64,1.935326000,0.0000
215.158.239.84,<->,204.227.227.81,1,260,0,0,1,260,1.935301000,0.0000
159.25.11.79,<->,157.84.87.211,1,64,0,0,1,64,1.935291000,0.0000
113.141.205.248,<->,20.76.92.69,0,0,1,64,1,64,1.935290000,0.0000
255.57.239.26,<->,80.40.15.111,0,0,1,80,1,80,1.935208000,0.0000
207.237.239.11,<->,136.25.188.242,0,0,1,101,1,101,1.935162000,0.0000
144.75.218.235,<->,138.127.230.221,1,84,0,0,1,84,1.935124000,0.0000
215.158.239.85,<->,142.207.221.239,1,765,0,0,1,765,1.935033000,0.0000
139.163.83.210,<->,120.246.238.219,1,56,0,0,1,56,1.935017000,0.0000
204.21.45.244,<->,136.25.188.243,0,0,1,50,1,50,1.934971000,0.0000
220.55.101.98,<->,132.43.156.54,1,137,0,0,1,137,1.934963000,0.0000
215.158.239.68,<->,199.20.5.45,1,64,0,0,1,64,1.934900000,0.0000
144.86.144.224,<->,92.162.218.148,1,50,0,0,1,50,1.934841000,0.0000
132.43.156.54,<->,80.38.6.51,0,0,1,799,1,799,1.934818000,0.0000
204.43.91.85,<->,50.224.76.230,0,0,1,56,1,56,1.934741000,0.0000
215.158.239.79,<->,143.135.23.206,1,68,0,0,1,68,1.934737000,0.0000
132.18.67.28,<->,6.228.9.91,0,0,1,50,1,50,1.934684000,0.0000
101.70.119.145,<->,53.144.55.136,1,115,0,0,1,115,1.934569000,0.0000
225.186.251.193,<->,109.222.238.4,0,0,1,56,1,56,1.934478000,0.0000
142.182.203.88,<->,50.224.76.234,0,0,1,50,1,50,1.934168000,0.0000
220.20.200.62,<->,127.255.90.88,1,50,0,0,1,50,1.934154000,0.0000
220.20.200.92,<->,131.45.239.178,1,327,0,0,1,327,1.934021000,0.0000
215.158.239.92,<->,207.59.68.196,1,50,0,0,1,50,1.933947000,0.0000
129.225.141.239,<->,129.225.132.93,0,0,1,56,1,56,1.933911000,0.0000
231.142.187.176,<->,215.158.239.87,0,0,1,64,1,64,1.933889000,0.0000
112.4.7.56,<->,50.224.98.60,0,0,1,56,1,56,1.933770000,0.0000
139.193.141.132,<->,120.164.124.6,1,393,0,0,1,393,1.933769000,0.0000
207.172.201.184,<->,136.25.188.242,0,0,1,68,1,68,1.933758000,0.0000
215.158.238.78,<->,8.40.50.223,1,85,0,0,1,85,1.933729000,0.0000
215.158.103.219,<->,192.171.13.190,1,98,0,0,1,98,1.933641000,0.0000
246.253.252.58,<->,6.9.39.228,1,132,0,0,1,132,1.933529000,0.0000
116.246.223.5,<->,39.46.127.110,0,0,1,68,1,68,1.933488000,0.0000
215.158.239.49,<->,207.60.200.129,1,68,0,0,1,68,1.933375000,0.0000
247.136.252.207,<->,8.55.135.127,1,56,0,0,1,56,1.933312000,0.0000
136.128.63.32,<->,102.50.53.180,0,0,1,56,1,56,1.933281000,0.0000
193.63.188.216,<->,20.203.245.216,0,0,1,52,1,52,1.933225000,0.0000
126.225.252.134,<->,20.206.209.189,0,0,1,64,1,64,1.933198000,0.0000
142.206.26.12,<->,136.25.188.196,0,0,1,56,1,56,1.933085000,0.0000
103.251.0.235,<->,8.53.0.43,0,0,1,50,1,50,1.933074000,0.0000
142.253.92.128,<->,136.25.188.253,0,0,1,50,1,50,1.932936000,0.0000
215.158.239.57,<->,196.93.194.68,1,117,0,0,1,117,1.932867000,0.0000
89.183.104.181,<->,48.107.19.135,1,52,0,0,1,52,1.932726000,0.0000
127.89.8.26,<->,80.40.41.27,0,0,1,84,1,84,1.932543000,0.0000
123.97.227.2,<->,20.255.4.45,0,0,1,50,1,50,1.932482000,0.0000
80.42.177.152,<->,38.136.68.19,1,135,0,0,1,135,1.932277000,0.0000
227.23.98.246,<->,89.183.104.128,0,0,1,53,1,53,1.932253000,0.0000
145.16.34.73,<->,137.39.55.235,1,50,0,0,1,50,1.932163000,0.0000
20.13.111.98,<->,0.200.50.50,1,60,0,0,1,60,1.932075000,0.0000
215.158.239.78,<->,199.20.7.196,1,776,0,0,1,776,1.932052000,0.0000
215.158.209.250,<->,80.27.152.113,0,0,1,64,1,64,1.931947000,0.0000
224.54.170.200,<->,192.224.198.242,0,0,1,704,1,704,1.931943000,0.0000
215.158.239.99,<->,199.20.28.224,1,68,0,0,1,68,1.931778000,0.0000
204.21.172.49,<->,136.25.188.253,0,0,1,56,1,56,1.931775000,0.0000
215.158.239.78,<->,199.20.31.2,1,781,0,0,1,781,1.931616000,0.0000
200.174.195.241,<->,54.59.134.145,1,56,0,0,1,56,1.931554000,0.0000
121.117.82.60,<->,20.148.124.9,0,0,1,56,1,56,1.931514000,0.0000
215.158.210.70,<->,29.211.214.82,0,0,1,96,1,96,1.931491000,0.0000
215.158.239.79,<->,204.61.25.219,1,64,0,0,1,64,1.931266000,0.0000
220.55.82.107,<->,27.11.149.50,1,64,0,0,1,64,1.931080000,0.0000
249.101.230.91,<->,220.20.253.202,1,56,0,0,1,56,1.931015000,0.0000
241.193.172.231,<->,20.88.22.140,0,0,1,50,1,50,1.930910000,0.0000
144.69.194.50,<->,136.25.188.105,0,0,1,283,1,283,1.930792000,0.0000
205.127.108.115,<->,101.224.89.154,0,0,1,56,1,56,1.930774000,0.0000
129.187.1.175,<->,48.53.186.12,0,0,1,50,1,50,1.930642000,0.0000
207.117.101.161,<->,8.182.226.78,0,0,1,50,1,50,1.930604000,0.0000
132.249.70.233,<->,129.176.84.9,1,86,0,0,1,86,1.930485000,0.0000
137.129.67.59,<->,92.27.219.59,0,0,1,52,1,52,1.930278000,0.0000
229.105.173.34,<->,97.198.127.201,0,0,1,97,1,97,1.930187000,0.0000
144.75.218.235,<->,138.127.231.59,1,365,0,0,1,365,1.930148000,0.0000
215.158.238.74,<->,197.125.126.182,1,1213,0,0,1,1213,1.930082000,0.0000
54.37.202.190,<->,48.54.61.16,0,0,1,50,1,50,1.930061000,0.0000
159.31.217.35,<->,67.236.244.154,1,52,0,0,1,52,1.930015000,0.0000
215.158.239.44,<->,106.188.183.109,1,56,0,0,1,56,1.930014000,0.0000
133.178.227.21,<->,133.56.180.77,1,363,0,0,1,363,1.929742000,0.0000
240.105.0.6,<->,136.25.188.105,0,0,1,183,1,183,1.929630000,0.0000
224.148.88.194,<->,84.251.154.124,1,64,0,0,1,64,1.929397000,0.0000
106.176.95.227,<->,89.183.104.225,0,0,1,64,1,64,1.929229000,0.0000
109.222.197.2,<->,53.240.214.83,1,491,0,0,1,491,1.929170000,0.0000
8.252.223.90,<->,8.240.116.17,1,56,0,0,1,56,1.928885000,0.0000
192.64.196.32,<->,132.211.48.138,1,52,0,0,1,52,1.928727000,0.0000
109.222.196.24,<->,53.201.142.135,1,64,0,0,1,64,1.928612000,0.0000
125.23.146.88,<->,109.222.203.52,0,0,1,78,1,78,1.928577000,0.0000
108.134.118.200,<->,106.213.125.221,1,64,0,0,1,64,1.928314000,0.0000
105.68.81.54,<->,20.125.235.28,0,0,1,64,1,64,1.928280000,0.0000
195.41.34.191,<->,136.25.188.252,0,0,1,56,1,56,1.928234000,0.0000
210.156.156.166,<->,77.12.175.79,1,89,0,0,1,89,1.928225000,0.0000
21.15.226.126,<->,20.193.17.240,0,0,1,82,1,82,1.928194000,0.0000
215.158.140.27,<->,143.173.13.200,1,64,0,0,1,64,1.927959000,0.0000
215.158.239.94,<->,199.20.28.191,1,717,0,0,1,717,1.927923000,0.0000
159.137.162.213,<->,105.107.49.61,1,56,0,0,1,56,1.927912000,0.0000
215.158.239.17,<->,107.96.174.48,1,50,0,0,1,50,1.927812000,0.0000
195.13.251.82,<->,136.25.188.220,0,0,1,52,1,52,1.927793000,0.0000
100.162.206.211,<->,8.52.147.123,0,0,1,56,1,56,1.927725000,0.0000
199.70.71.24,<->,136.25.188.177,0,0,1,56,1,56,1.927476000,0.0000
210.60.25.92,<->,92.162.253.102,0,0,1,50,1,50,1.927472000,0.0000
215.158.239.92,<->,204.226.92.239,1,68,0,0,1,68,1.927394000,0.0000
195.88.181.96,<->,8.182.230.157,0,0,1,50,1,50,1.927308000,0.0000
207.236.167.132,<->,136.25.188.255,0,0,1,641,1,641,1.926999000,0.0000
144.75.218.241,<->,138.127.225.234,1,254,0,0,1,254,1.926843000,0.0000
246.254.97.105,<->,139.33.174.16,1,50,0,0,1,50,1.926825000,0.0000
8.182.227.210,<->,6.21.254.254,1,617,0,0,1,617,1.926554000,0.0000
141.204.123.255,<->,109.81.202.64,0,0,1,206,1,206,1.926266000,0.0000
210.209.251.211,<->,6.75.222.242,0,0,1,50,1,50,1.926141000,0.0000
198.15.216.152,<->,20.207.215.224,0,0,1,64,1,64,1.926028000,0.0000
144.75.218.233,<->,138.127.225.215,1,347,0,0,1,347,1.925976000,0.0000
215.158.140.75,<->,8.192.205.0,1,1231,0,0,1,1231,1.925917000,0.0000
129.224.112.252,<->,60.100.161.172,1,63,0,0,1,63,1.925705000,0.0000
215.158.238.33,<->,206.103.215.232,1,1309,0,0,1,1309,1.925657000,0.0000
138.127.225.149,<->,97.126.26.70,0,0,1,246,1,246,1.925524000,0.0000
92.27.219.172,<->,33.57.78.116,1,56,0,0,1,56,1.925510000,0.0000
198.15.216.152,<->,20.207.215.225,0,0,1,64,1,64,1.925456000,0.0000
220.204.48.175,<->,210.229.230.18,0,0,1,68,1,68,1.925350000,0.0000
136.25.189.82,<->,114.94.161.196,1,1357,0,0,1,1357,1.925340000,0.0000
215.158.140.196,<->,215.158.58.223,1,1262,0,0,1,1262,1.925202000,0.0000
148.129.19.104,<->,136.25.189.77,0,0,1,1357,1,1357,1.925167000,0.0000
194.254.104.168,<->,8.252.222.30,0,0,1,56,1,56,1.924979000,0.0000
136.25.189.15,<->,29.211.5.100,1,1293,0,0,1,1293,1.924779000,0.0000
102.39.105.242,<->,50.224.76.131,0,0,1,79,1,79,1.924698000,0.0000
230.206.224.242,<->,145.19.5.99,0,0,1,50,1,50,1.924674000,0.0000
252.189.11.208,<->,50.224.76.234,0,0,1,56,1,56,1.924475000,0.0000
143.43.30.232,<->,136.25.188.177,0,0,1,64,1,64,1.924382000,0.0000
101.106.122.69,<->,89.183.104.168,0,0,1,133,1,133,1.924178000,0.0000
102.51.53.18,<->,27.253.64.47,1,50,0,0,1,50,1.924098000,0.0000
210.229.230.20,<->,107.110.214.8,1,80,0,0,1,80,1.924028000,0.0000
247.152.222.83,<->,8.43.212.15,0,0,1,50,1,50,1.923916000,0.0000
195.71.44.216,<->,136.25.188.163,0,0,1,64,1,64,1.923643000,0.0000
195.68.91.135,<->,136.25.188.178,0,0,1,56,1,56,1.923596000,0.0000
215.158.238.106,<->,111.151.70.74,1,1229,0,0,1,1229,1.923523000,0.0000
104.155.75.255,<->,50.224.110.86,0,0,1,74,1,74,1.923177000,0.0000
210.229.230.20,<->,103.249.39.16,1,68,0,0,1,68,1.923155000,0.0000
89.183.104.242,<->,29.238.7.172,1,56,0,0,1,56,1.923079000,0.0000
106.226.78.72,<->,20.215.108.123,0,0,1,64,1,64,1.923049000,0.0000
108.39.57.255,<->,74.235.94.149,1,67,0,0,1,67,1.922865000,0.0000
221.102.113.114,<->,204.140.161.69,1,50,0,0,1,50,1.922589000,0.0000
201.222.190.205,<->,80.41.58.237,0,0,1,135,1,135,1.922464000,0.0000
109.51.91.141,<->,8.182.251.151,0,0,1,50,1,50,1.922429000,0.0000
204.200.36.41,<->,136.25.188.178,0,0,1,56,1,56,1.922317000,0.0000
92.27.219.169,<->,4.130.13.37,1,240,0,0,1,240,1.922066000,0.0000
91.250.143.162,<->,39.232.109.3,0,0,1,50,1,50,1.921883000,0.0000
215.158.238.236,<->,126.219.194.4,1,1088,0,0,1,1088,1.921842000,0.0000
199.72.37.232,<->,136.25.188.53,0,0,1,653,1,653,1.921715000,0.0000
132.18.67.31,<->,97.190.216.19,0,0,1,56,1,56,1.921708000,0.0000
215.158.239.48,<->,196.92.224.128,1,64,0,0,1,64,1.921699000,0.0000
215.158.238.132,<->,29.123.209.152,1,1021,0,0,1,1021,1.921642000,0.0000
215.158.239.57,<->,199.20.29.199,1,653,0,0,1,653,1.921626000,0.0000
215.158.238.188,<->,29.213.219.74,1,1035,0,0,1,1035,1.921260000,0.0000
197.113.99.4,<->,136.25.188.52,0,0,1,64,1,64,1.921099000,0.0000
247.136.187.136,<->,118.255.99.229,1,64,0,0,1,64,1.920984000,0.0000
158.3.225.249,<->,39.173.190.157,0,0,1,64,1,64,1.920845000,0.0000
207.92.37.23,<->,8.182.227.180,0,0,1,56,1,56,1.920776000,0.0000
139.248.201.139,<->,137.69.107.44,1,80,0,0,1,80,1.920596000,0.0000
21.15.226.126,<->,20.193.17.105,0,0,1,82,1,82,1.920499000,0.0000
215.158.239.84,<->,142.220.137.30,1,170,0,0,1,170,1.920094000,0.0000
143.22.123.28,<->,8.182.224.248,0,0,1,56,1,56,1.920094000,0.0000
215.158.238.75,<->,131.1.195.244,1,1427,0,0,1,1427,1.919349000,0.0000
192.204.123.39,<->,136.25.189.45,0,0,1,1245,1,1245,1.918884000,0.0000
202.33.29.169,<->,136.25.188.236,0,0,1,50,1,50,1.918872000,0.0000
54.37.192.99,<->,48.53.196.74,0,0,1,110,1,110,1.918858000,0.0000
219.243.24.255,<->,80.38.16.208,0,0,1,56,1,56,1.918746000,0.0000
159.137.162.213,<->,117.8.24.63,1,56,0,0,1,56,1.918629000,0.0000
109.110.163.92,<->,92.27.219.156,0,0,1,84,1,84,1.918588000,0.0000
112.7.169.106,<->,8.31.37.173,0,0,1,56,1,56,1.918322000,0.0000
141.160.87.19,<->,136.25.188.255,0,0,1,68,1,68,1.917973000,0.0000
215.158.239.182,<->,128.42.173.181,1,64,0,0,1,64,1.917879000,0.0000
136.25.189.29,<->,96.156.169.221,1,1357,0,0,1,1357,1.917749000,0.0000
215.158.239.84,<->,195.41.242.63,1,56,0,0,1,56,1.917575000,0.0000
222.117.168.124,<->,215.158.239.19,0,0,1,50,1,50,1.917521000,0.0000
50.224.76.234,<->,33.246.35.173,1,56,0,0,1,56,1.917395000,0.0000
215.158.239.48,<->,199.20.7.144,1,56,0,0,1,56,1.917351000,0.0000
197.113.99.188,<->,136.25.188.209,0,0,1,56,1,56,1.917208000,0.0000
215.158.238.64,<->,113.23.21.201,1,1213,0,0,1,1213,1.916952000,0.0000
103.61.69.140,<->,20.203.160.189,0,0,1,70,1,70,1.916907000,0.0000
109.1.41.187,<->,33.218.93.130,1,56,0,0,1,56,1.916870000,0.0000
221.196.95.22,<->,192.67.140.220,0,0,1,319,1,319,1.916703000,0.0000
195.61.32.241,<->,92.27.194.147,0,0,1,64,1,64,1.916678000,0.0000
196.148.79.109,<->,8.181.37.222,1,64,0,0,1,64,1.916449000,0.0000
215.158.239.18,<->,215.158.127.170,1,1136,0,0,1,1136,1.916300000,0.0000
140.174.85.65,<->,136.25.188.252,0,0,1,1357,1,1357,1.916284000,0.0000
6.145.170.79,<->,0.195.210.44,0,0,1,109,1,109,1.916194000,0.0000
215.158.239.96,<->,199.20.31.242,1,64,0,0,1,64,1.916066000,0.0000
199.68.33.241,<->,136.25.188.253,0,0,1,834,1,834,1.915743000,0.0000
142.248.156.244,<->,136.25.188.198,0,0,1,68,1,68,1.915705000,0.0000
125.84.62.71,<->,8.220.203.35,0,0,1,704,1,704,1.915410000,0.0000
97.80.226.227,<->,8.20.87.144,0,0,1,50,1,50,1.915358000,0.0000
159.36.238.178,<->,8.52.222.23,0,0,1,50,1,50,1.915303000,0.0000
136.25.188.237,<->,126.219.194.142,1,1149,0,0,1,1149,1.915294000,0.0000
247.136.192.67,<->,193.24.112.104,1,56,0,0,1,56,1.915066000,0.0000
149.167.183.180,<->,8.252.222.204,0,0,1,1197,1,1197,1.915058000,0.0000
104.155.120.1,<->,89.183.104.189,0,0,1,319,1,319,1.915018000,0.0000
109.222.238.42,<->,53.224.71.176,1,56,0,0,1,56,1.914998000,0.0000
251.24.252.115,<->,39.169.213.111,0,0,1,64,1,64,1.914980000,0.0000
120.83.81.74,<->,89.183.104.149,0,0,1,64,1,64,1.914718000,0.0000
138.74.30.197,<->,8.55.235.136,1,52,0,0,1,52,1.914703000,0.0000
207.162.178.9,<->,8.182.253.116,0,0,1,50,1,50,1.914644000,0.0000
17.27.56.184,<->,8.220.179.94,0,0,1,1046,1,1046,1.914531000,0.0000
195.71.146.117,<->,136.25.188.176,0,0,1,93,1,93,1.914513000,0.0000
143.20.237.99,<->,136.25.188.174,0,0,1,64,1,64,1.914404000,0.0000
204.200.47.110,<->,136.25.188.255,0,0,1,64,1,64,1.914386000,0.0000
144.75.218.235,<->,138.127.230.211,1,254,0,0,1,254,1.914250000,0.0000
215.158.238.205,<->,192.230.221.194,1,1002,0,0,1,1002,1.914119000,0.0000
142.190.49.174,<->,136.25.188.196,0,0,1,56,1,56,1.914050000,0.0000
215.158.239.92,<->,199.20.29.75,1,50,0,0,1,50,1.914048000,0.0000
231.138.254.49,<->,136.25.188.178,0,0,1,56,1,56,1.914027000,0.0000
207.62.130.203,<->,136.25.188.252,0,0,1,303,1,303,1.913771000,0.0000
252.113.218.41,<->,50.224.93.122,0,0,1,82,1,82,1.913730000,0.0000
133.178.226.28,<->,42.97.54.126,1,1245,0,0,1,1245,1.912627000,0.0000
120.155.8.80,<->,8.52.129.50,0,0,1,1002,1,1002,1.912612000,0.0000
195.55.8.127,<->,136.25.188.227,0,0,1,240,1,240,1.912598000,0.0000
101.70.115.60,<->,53.200.167.125,1,64,0,0,1,64,1.912536000,0.0000
194.244.174.224,<->,8.182.227.180,0,0,1,50,1,50,1.912324000,0.0000
111.30.137.37,<->,92.27.8.3,0,0,1,56,1,56,1.912319000,0.0000
215.158.239.28,<->,113.93.9.8,1,1489,0,0,1,1489,1.912190000,0.0000
192.64.229.213,<->,159.230.56.202,1,128,0,0,1,128,1.912155000,0.0000
204.60.238.111,<->,136.25.188.222,0,0,1,64,1,64,1.912065000,0.0000
113.65.136.161,<->,39.51.246.85,0,0,1,72,1,72,1.912033000,0.0000
126.232.52.51,<->,20.108.97.42,0,0,1,64,1,64,1.911778000,0.0000
148.198.183.187,<->,108.134.127.192,0,0,1,81,1,81,1.911712000,0.0000
97.126.45.209,<->,33.248.124.218,1,62,0,0,1,62,1.911689000,0.0000
215.158.239.50,<->,195.126.22.100,1,50,0,0,1,50,1.911577000,0.0000
204.186.4.18,<->,136.25.188.198,0,0,1,68,1,68,1.911563000,0.0000
136.25.188.220,<->,72.36.124.38,1,56,0,0,1,56,1.911489000,0.0000
112.70.164.219,<->,8.52.251.213,0,0,1,1002,1,1002,1.911463000,0.0000
215.158.239.92,<->,196.93.185.246,1,93,0,0,1,93,1.911294000,0.0000
143.226.151.111,<->,8.220.201.13,0,0,1,704,1,704,1.911269000,0.0000
97.53.102.255,<->,8.182.224.248,0,0,1,50,1,50,1.911127000,0.0000
139.163.26.146,<->,122.223.191.75,1,99,0,0,1,99,1.910873000,0.0000
215.158.239.71,<->,114.25.48.40,1,1213,0,0,1,1213,1.910728000,0.0000
241.193.172.231,<->,20.25.155.217,0,0,1,50,1,50,1.910724000,0.0000
92.27.219.38,<->,42.41.254.51,1,103,0,0,1,103,1.910702000,0.0000
39.197.184.77,<->,38.188.127.90,1,64,0,0,1,64,1.910702000,0.0000
247.136.249.234,<->,121.205.113.144,1,50,0,0,1,50,1.910621000,0.0000
231.142.5.238,<->,136.25.188.175,0,0,1,50,1,50,1.910603000,0.0000
112.170.71.176,<->,20.192.37.227,0,0,1,84,1,84,1.910539000,0.0000
104.232.115.160,<->,20.171.10.224,0,0,1,64,1,64,1.910449000,0.0000
195.5.2.177,<->,136.25.188.222,0,0,1,64,1,64,1.910299000,0.0000
221.102.126.240,<->,100.241.191.25,1,50,0,0,1,50,1.910216000,0.0000
129.16.253.232,<->,102.81.224.10,0,0,1,50,1,50,1.910161000,0.0000
111.150.118.22,<->,56.121.35.12,0,0,1,68,1,68,1.910064000,0.0000
128.91.191.123,<->,80.40.50.176,0,0,1,50,1,50,1.909949000,0.0000
127.89.237.106,<->,109.222.200.25,0,0,1,77,1,77,1.909923000,0.0000
207.188.202.30,<->,136.25.188.220,0,0,1,50,1,50,1.909812000,0.0000
205.88.21.167,<->,50.224.89.241,0,0,1,50,1,50,1.909544000,0.0000
140.17.122.242,<->,98.128.202.45,0,0,1,50,1,50,1.909145000,0.0000
215.158.239.92,<->,199.20.29.52,1,68,0,0,1,68,1.908937000,0.0000
192.67.179.238,<->,109.219.207.15,1,56,0,0,1,56,1.908818000,0.0000
197.235.132.138,<->,20.185.195.160,0,0,1,78,1,78,1.908803000,0.0000
215.158.239.76,<->,204.226.119.105,1,64,0,0,1,64,1.908758000,0.0000
111.147.146.107,<->,75.101.83.45,1,69,0,0,1,69,1.908682000,0.0000
64.253.254.21,<->,39.144.12.43,0,0,1,60,1,60,1.908626000,0.0000
106.132.254.130,<->,92.27.219.171,0,0,1,56,1,56,1.908361000,0.0000
215.158.239.68,<->,196.0.122.148,1,50,0,0,1,50,1.908292000,0.0000
199.14.154.18,<->,136.25.188.226,0,0,1,64,1,64,1.908059000,0.0000
143.43.204.18,<->,20.87.86.90,0,0,1,68,1,68,1.907965000,0.0000
129.224.112.252,<->,114.145.122.218,1,80,0,0,1,80,1.907908000,0.0000
215.158.238.106,<->,141.39.23.86,1,1213,0,0,1,1213,1.907747000,0.0000
60.84.1.225,<->,39.147.2.8,0,0,1,64,1,64,1.907615000,0.0000
80.27.157.215,<->,75.94.224.161,1,60,0,0,1,60,1.907545000,0.0000
92.27.194.117,<->,27.38.169.25,1,50,0,0,1,50,1.907394000,0.0000
199.12.98.27,<->,8.252.222.237,0,0,1,50,1,50,1.907353000,0.0000
192.65.14.117,<->,27.60.82.25,1,56,0,0,1,56,1.907340000,0.0000
133.178.227.27,<->,8.53.217.77,1,1341,0,0,1,1341,1.907334000,0.0000
207.61.253.167,<->,136.25.188.46,0,0,1,50,1,50,1.907249000,0.0000
139.163.26.238,<->,33.250.75.171,1,64,0,0,1,64,1.907156000,0.0000
155.216.61.93,<->,108.39.160.74,0,0,1,130,1,130,1.907152000,0.0000
126.128.55.248,<->,111.147.95.72,0,0,1,56,1,56,1.907152000,0.0000
215.158.239.51,<->,195.7.254.154,1,56,0,0,1,56,1.907083000,0.0000
215.158.23.56,<->,111.150.207.145,1,56,0,0,1,56,1.907079000,0.0000
216.144.222.160,<->,215.158.140.205,0,0,1,50,1,50,1.906999000,0.0000
115.167.67.93,<->,109.1.48.21,0,0,1,56,1,56,1.906951000,0.0000
91.50.26.215,<->,8.220.176.253,0,0,1,50,1,50,1.906770000,0.0000
215.158.140.11,<->,128.156.85.189,1,56,0,0,1,56,1.906723000,0.0000
215.158.239.123,<->,111.151.109.41,1,100,0,0,1,100,1.906621000,0.0000
133.54.22.156,<->,131.144.248.28,1,84,0,0,1,84,1.906517000,0.0000
50.224.76.234,<->,29.223.97.220,1,56,0,0,1,56,1.906388000,0.0000
153.186.217.198,<->,34.108.191.93,0,0,1,72,1,72,1.906222000,0.0000
123.97.227.2,<->,39.158.21.254,0,0,1,50,1,50,1.906189000,0.0000
144.95.111.40,<->,111.147.77.247,0,0,1,288,1,288,1.905774000,0.0000
204.200.37.136,<->,136.25.188.252,0,0,1,64,1,64,1.905643000,0.0000
101.38.148.96,<->,97.168.94.127,0,0,1,75,1,75,1.905565000,0.0000
215.158.239.233,<->,192.227.190.250,1,90,0,0,1,90,1.905470000,0.0000
106.23.130.104,<->,8.52.222.23,0,0,1,56,1,56,1.905461000,0.0000
204.3.43.12,<->,136.25.188.238,0,0,1,64,1,64,1.905424000,0.0000
92.27.26.248,<->,33.215.4.219,1,57,0,0,1,57,1.905295000,0.0000
229.69.132.229,<->,192.67.161.91,0,0,1,56,1,56,1.905262000,0.0000
114.19.240.76,<->,98.67.159.10,0,0,1,68,1,68,1.905213000,0.0000
109.222.255.55,<->,86.13.37.241,1,69,0,0,1,69,1.905027000,0.0000
121.252.120.61,<->,8.52.186.161,0,0,1,50,1,50,1.904881000,0.0000
141.52.255.166,<->,92.27.219.198,0,0,1,68,1,68,1.904685000,0.0000
215.158.239.58,<->,199.20.20.169,1,56,0,0,1,56,1.904362000,0.0000
207.58.213.126,<->,136.25.188.53,0,0,1,50,1,50,1.904330000,0.0000
207.57.78.162,<->,136.25.188.174,0,0,1,335,1,335,1.904238000,0.0000
141.20.135.250,<->,109.222.209.116,0,0,1,50,1,50,1.904149000,0.0000
144.122.240.242,<->,137.179.251.23,1,71,0,0,1,71,1.903957000,0.0000
246.253.253.97,<->,210.209.251.214,1,481,0,0,1,481,1.903761000,0.0000
148.129.19.195,<->,133.178.226.28,0,0,1,1069,1,1069,1.903733000,0.0000
215.158.238.209,<->,149.96.60.40,1,1104,0,0,1,1104,1.903697000,0.0000
146.223.137.30,<->,8.252.222.38,0,0,1,68,1,68,1.903676000,0.0000
29.214.108.124,<->,8.252.222.18,0,0,1,56,1,56,1.903625000,0.0000
144.75.218.241,<->,65.95.70.36,1,140,0,0,1,140,1.903543000,0.0000
139.34.132.118,<->,136.25.188.72,0,0,1,1064,1,1064,1.903301000,0.0000
215.158.140.144,<->,135.243.190.253,1,56,0,0,1,56,1.903166000,0.0000
247.136.210.161,<->,105.221.82.56,1,319,0,0,1,319,1.903050000,0.0000
215.158.239.92,<->,199.20.31.36,1,64,0,0,1,64,1.902674000,0.0000
215.158.239.48,<->,199.20.29.223,1,64,0,0,1,64,1.902536000,0.0000
215.158.103.219,<->,53.227.188.6,1,253,0,0,1,253,1.902425000,0.0000
203.215.144.93,<->,118.241.252.70,1,64,0,0,1,64,1.902404000,0.0000
133.178.226.7,<->,126.219.132.192,1,1341,0,0,1,1341,1.902391000,0.0000
106.1.36.29,<->,92.27.219.241,0,0,1,135,1,135,1.902379000,0.0000
215.158.238.148,<->,8.220.51.244,1,64,0,0,1,64,1.902363000,0.0000
109.222.251.33,<->,6.88.34.156,1,77,0,0,1,77,1.902278000,0.0000
80.42.183.159,<->,26.218.94.15,1,56,0,0,1,56,1.902142000,0.0000
246.253.253.97,<->,210.209.251.223,1,481,0,0,1,481,1.902139000,0.0000
142.167.5.166,<->,136.25.188.199,0,0,1,56,1,56,1.902117000,0.0000
215.158.239.96,<->,204.1.178.17,1,56,0,0,1,56,1.901938000,0.0000
220.20.200.82,<->,144.83.60.153,1,50,0,0,1,50,1.901876000,0.0000
203.215.180.43,<->,118.241.252.70,1,64,0,0,1,64,1.901868000,0.0000
102.173.125.0,<->,80.40.31.154,0,0,1,133,1,133,1.901769000,0.0000
140.151.225.93,<->,92.27.219.128,0,0,1,52,1,52,1.901728000,0.0000
239.66.110.113,<->,203.215.177.31,0,0,1,56,1,56,1.901713000,0.0000
97.110.148.14,<->,92.162.252.12,0,0,1,139,1,139,1.901598000,0.0000
215.158.239.86,<->,196.92.161.203,1,56,0,0,1,56,1.901355000,0.0000
231.138.254.49,<->,136.25.188.241,0,0,1,56,1,56,1.901307000,0.0000
244.50.135.57,<->,39.238.132.123,0,0,1,50,1,50,1.901148000,0.0000
144.75.218.235,<->,138.127.225.194,1,237,0,0,1,237,1.901071000,0.0000
123.97.227.2,<->,39.194.104.200,0,0,1,50,1,50,1.901047000,0.0000
89.216.125.215,<->,8.235.165.103,1,56,0,0,1,56,1.901030000,0.0000
215.158.239.97,<->,143.94.231.63,1,64,0,0,1,64,1.900976000,0.0000
109.113.44.63,<->,56.121.35.77,0,0,1,224,1,224,1.900830000,0.0000
241.193.172.231,<->,20.143.45.158,0,0,1,50,1,50,1.900815000,0.0000
210.220.3.115,<->,8.252.221.249,0,0,1,50,1,50,1.900761000,0.0000
132.200.62.136,<->,132.200.51.5,1,64,0,0,1,64,1.900745000,0.0000
133.178.226.28,<->,104.3.163.105,1,1101,0,0,1,1101,1.900644000,0.0000
214.85.127.178,<->,50.224.76.235,0,0,1,64,1,64,1.900612000,0.0000
8.182.226.78,<->,6.133.208.74,1,50,0,0,1,50,1.900527000,0.0000
142.207.89.194,<->,136.25.188.178,0,0,1,765,1,765,1.900466000,0.0000
204.226.116.204,<->,136.25.188.238,0,0,1,56,1,56,1.900195000,0.0000
17.225.158.217,<->,8.220.204.234,0,0,1,56,1,56,1.900135000,0.0000
106.209.161.210,<->,89.183.104.129,0,0,1,52,1,52,1.900107000,0.0000
42.31.109.52,<->,39.162.179.136,0,0,1,70,1,70,1.899996000,0.0000
158.215.219.52,<->,138.98.157.82,0,0,1,50,1,50,1.899971000,0.0000
149.170.128.135,<->,100.92.66.100,0,0,1,130,1,130,1.899931000,0.0000
142.220.134.135,<->,136.25.188.52,0,0,1,64,1,64,1.899908000,0.0000
215.158.239.56,<->,199.20.29.178,1,64,0,0,1,64,1.899878000,0.0000
158.229.167.186,<->,20.66.117.235,0,0,1,74,1,74,1.899840000,0.0000
127.28.249.33,<->,39.48.64.153,0,0,1,52,1,52,1.899809000,0.0000
195.12.249.171,<->,136.25.188.224,0,0,1,132,1,132,1.899797000,0.0000
125.200.151.86,<->,80.40.50.197,0,0,1,52,1,52,1.899575000,0.0000
251.24.86.2,<->,8.252.222.23,0,0,1,831,1,831,1.899465000,0.0000
117.33.250.180,<->,50.224.76.230,0,0,1,56,1,56,1.899295000,0.0000
215.158.239.33,<->,131.95.192.157,1,1481,0,0,1,1481,1.898925000,0.0000
39.224.182.56,<->,33.198.147.242,1,60,0,0,1,60,1.898883000,0.0000
132.168.198.110,<->,38.98.95.10,1,135,0,0,1,135,1.898570000,0.0000
142.167.77.142,<->,136.25.188.253,0,0,1,56,1,56,1.898443000,0.0000
215.158.239.68,<->,202.33.8.182,1,50,0,0,1,50,1.898355000,0.0000
133.178.226.245,<->,8.181.148.225,1,111,0,0,1,111,1.898299000,0.0000
144.75.218.242,<->,100.185.121.91,1,87,0,0,1,87,1.898250000,0.0000
92.27.219.131,<->,82.180.168.184,1,62,0,0,1,62,1.898217000,0.0000
145.116.223.84,<->,136.25.189.63,0,0,1,104,1,104,1.898200000,0.0000
215.158.239.69,<->,196.0.65.125,1,64,0,0,1,64,1.898174000,0.0000
220.20.200.66,<->,106.23.73.58,1,50,0,0,1,50,1.897906000,0.0000
113.163.45.232,<->,50.224.76.234,0,0,1,64,1,64,1.897848000,0.0000
215.158.239.79,<->,196.92.46.128,1,56,0,0,1,56,1.897559000,0.0000
100.94.204.235,<->,33.241.241.76,1,70,0,0,1,70,1.897393000,0.0000
199.25.143.93,<->,0.195.210.44,0,0,1,109,1,109,1.897313000,0.0000
136.25.188.105,<->,131.153.125.208,1,191,0,0,1,191,1.897093000,0.0000
159.112.9.198,<->,100.95.46.113,0,0,1,50,1,50,1.896922000,0.0000
144.75.218.242,<->,89.155.210.245,1,99,0,0,1,99,1.896718000,0.0000
192.242.69.246,<->,20.144.125.58,0,0,1,104,1,104,1.896636000,0.0000
245.125.232.246,<->,221.102.113.220,0,0,1,56,1,56,1.896601000,0.0000
120.39.91.40,<->,92.27.219.215,0,0,1,80,1,80,1.896547000,0.0000
112.38.133.95,<->,50.224.89.241,0,0,1,1101,1,1101,1.896465000,0.0000
139.69.162.227,<->,29.211.214.82,0,0,1,96,1,96,1.896285000,0.0000
132.234.106.64,<->,102.224.162.245,0,0,1,209,1,209,1.896218000,0.0000
204.185.17.53,<->,136.25.188.53,0,0,1,717,1,717,1.896180000,0.0000
136.25.188.106,<->,57.108.116.104,1,60,0,0,1,60,1.896120000,0.0000
144.64.137.156,<->,143.73.162.176,1,73,0,0,1,73,1.896022000,0.0000
111.150.207.86,<->,8.252.221.75,0,0,1,56,1,56,1.895926000,0.0000
198.158.197.83,<->,20.146.37.229,0,0,1,50,1,50,1.895804000,0.0000
57.221.68.6,<->,35.56.96.142,0,0,1,599,1,599,1.895753000,0.0000
204.120.149.124,<->,0.195.210.44,0,0,1,93,1,93,1.895521000,0.0000
239.66.110.113,<->,203.215.177.30,0,0,1,56,1,56,1.895479000,0.0000
139.160.226.247,<->,136.25.188.179,0,0,1,1181,1,1181,1.895476000,0.0000
215.158.239.95,<->,196.107.30.227,1,64,0,0,1,64,1.895436000,0.0000
140.145.218.97,<->,136.25.188.253,0,0,1,1213,1,1213,1.895381000,0.0000
142.248.178.25,<->,136.25.188.227,0,0,1,56,1,56,1.895313000,0.0000
221.102.99.209,<->,195.84.192.150,1,50,0,0,1,50,1.895075000,0.0000
144.75.218.246,<->,138.127.224.167,1,242,0,0,1,242,1.894894000,0.0000
92.27.219.147,<->,40.208.235.139,1,256,0,0,1,256,1.894864000,0.0000
136.25.188.253,<->,104.3.163.80,1,1341,0,0,1,1341,1.894856000,0.0000
142.221.146.228,<->,136.25.188.243,0,0,1,56,1,56,1.894849000,0.0000
197.113.99.150,<->,136.25.188.46,0,0,1,1033,1,1033,1.894695000,0.0000
98.150.107.161,<->,97.190.215.3,0,0,1,50,1,50,1.894685000,0.0000
215.158.239.92,<->,195.80.206.114,1,72,0,0,1,72,1.894567000,0.0000
126.198.147.25,<->,80.41.24.146,0,0,1,341,1,341,1.894526000,0.0000
158.236.140.242,<->,39.47.231.79,0,0,1,52,1,52,1.894299000,0.0000
215.158.239.96,<->,199.68.37.47,1,765,0,0,1,765,1.894273000,0.0000
215.158.140.136,<->,128.194.246.149,1,134,0,0,1,134,1.894249000,0.0000
204.20.232.125,<->,136.25.188.209,0,0,1,64,1,64,1.894220000,0.0000
224.148.88.217,<->,84.251.154.124,1,64,0,0,1,64,1.894071000,0.0000
215.158.238.187,<->,111.151.142.153,1,56,0,0,1,56,1.893873000,0.0000
215.158.239.34,<->,106.188.156.149,1,1469,0,0,1,1469,1.893728000,0.0000
215.158.238.73,<->,29.212.43.231,1,1229,0,0,1,1229,1.893689000,0.0000
38.186.36.146,<->,20.100.205.74,0,0,1,52,1,52,1.893487000,0.0000
109.222.208.118,<->,0.48.112.144,1,64,0,0,1,64,1.893177000,0.0000
220.38.84.244,<->,136.25.189.16,0,0,1,1197,1,1197,1.893171000,0.0000
207.162.170.87,<->,8.182.250.109,0,0,1,50,1,50,1.893134000,0.0000
111.147.142.93,<->,54.37.211.103,1,109,0,0,1,109,1.892907000,0.0000
215.158.239.85,<->,199.20.30.34,1,68,0,0,1,68,1.892883000,0.0000
197.7.107.241,<->,8.183.25.25,0,0,1,64,1,64,1.892865000,0.0000
200.174.198.214,<->,53.160.87.174,1,56,0,0,1,56,1.892802000,0.0000
215.158.239.78,<->,196.0.79.175,1,765,0,0,1,765,1.892716000,0.0000
221.196.91.231,<->,109.222.250.145,0,0,1,136,1,136,1.892550000,0.0000
139.163.100.166,<->,117.21.139.63,1,68,0,0,1,68,1.892433000,0.0000
199.68.120.238,<->,136.25.188.160,0,0,1,56,1,56,1.892417000,0.0000
241.193.172.231,<->,80.38.62.138,0,0,1,50,1,50,1.892072000,0.0000
215.158.238.25,<->,126.219.192.39,1,1485,0,0,1,1485,1.891975000,0.0000
133.81.199.33,<->,58.132.153.38,1,1424,0,0,1,1424,1.891641000,0.0000
92.27.219.217,<->,29.143.252.140,1,62,0,0,1,62,1.891545000,0.0000
207.58.213.126,<->,136.25.188.209,0,0,1,50,1,50,1.891183000,0.0000
133.178.226.49,<->,61.35.70.248,1,1197,0,0,1,1197,1.891109000,0.0000
215.158.239.76,<->,194.251.128.115,1,307,0,0,1,307,1.891064000,0.0000
145.130.228.2,<->,8.220.200.124,0,0,1,50,1,50,1.891045000,0.0000
216.132.55.74,<->,20.194.30.147,0,0,1,52,1,52,1.890881000,0.0000
195.4.250.152,<->,136.25.188.174,0,0,1,64,1,64,1.890831000,0.0000
207.59.201.32,<->,136.25.188.196,0,0,1,710,1,710,1.890794000,0.0000
149.167.2.14,<->,8.43.154.166,0,0,1,64,1,64,1.890548000,0.0000
216.184.0.60,<->,8.252.223.195,0,0,1,97,1,97,1.890530000,0.0000
195.68.236.31,<->,136.25.188.238,0,0,1,56,1,56,1.890455000,0.0000
215.158.239.57,<->,207.191.95.181,1,50,0,0,1,50,1.890350000,0.0000
91.250.143.162,<->,39.147.127.30,0,0,1,50,1,50,1.890283000,0.0000
129.224.112.252,<->,114.186.133.50,1,74,0,0,1,74,1.890202000,0.0000
251.24.86.2,<->,8.252.222.132,0,0,1,56,1,56,1.890101000,0.0000
94.193.143.61,<->,8.252.222.158,0,0,1,56,1,56,1.889991000,0.0000
199.72.43.98,<->,136.25.188.174,0,0,1,765,1,765,1.889840000,0.0000
113.168.229.251,<->,92.162.252.6,0,0,1,56,1,56,1.889524000,0.0000
204.3.170.31,<->,136.25.188.252,0,0,1,56,1,56,1.889421000,0.0000
215.158.239.56,<->,196.90.54.3,1,56,0,0,1,56,1.889404000,0.0000
132.18.67.31,<->,8.30.102.8,0,0,1,56,1,56,1.889399000,0.0000
204.200.37.12,<->,136.25.188.162,0,0,1,64,1,64,1.889386000,0.0000
142.244.142.94,<->,136.25.188.220,0,0,1,50,1,50,1.889326000,0.0000
195.6.218.22,<->,50.224.76.234,0,0,1,56,1,56,1.889271000,0.0000
244.50.136.175,<->,20.238.12.58,0,0,1,50,1,50,1.889244000,0.0000
137.74.4.107,<->,8.222.6.50,1,56,0,0,1,56,1.889005000,0.0000
129.224.112.252,<->,92.162.219.203,1,73,0,0,1,73,1.888802000,0.0000
246.253.71.207,<->,244.50.129.64,1,50,0,0,1,50,1.888722000,0.0000
245.161.124.40,<->,8.252.222.176,0,0,1,64,1,64,1.888553000,0.0000
198.180.211.96,<->,80.41.32.162,0,0,1,138,1,138,1.888492000,0.0000
92.27.219.140,<->,66.245.103.93,1,353,0,0,1,353,1.888359000,0.0000
136.25.189.210,<->,8.57.163.164,1,111,0,0,1,111,1.888179000,0.0000
136.25.188.211,<->,126.219.194.99,1,1213,0,0,1,1213,1.888161000,0.0000
215.158.239.76,<->,196.108.62.238,1,64,0,0,1,64,1.888155000,0.0000
105.249.209.228,<->,39.42.218.248,0,0,1,56,1,56,1.888132000,0.0000
114.81.125.65,<->,39.18.36.175,0,0,1,64,1,64,1.888117000,0.0000
192.229.40.70,<->,136.25.188.59,0,0,1,85,1,85,1.887892000,0.0000
133.178.227.210,<->,80.56.91.244,1,1112,0,0,1,1112,1.887783000,0.0000
98.86.123.142,<->,20.197.150.148,0,0,1,98,1,98,1.887761000,0.0000
250.50.35.185,<->,80.40.60.88,0,0,1,74,1,74,1.887574000,0.0000
133.178.227.40,<->,8.222.212.32,1,1145,0,0,1,1145,1.887355000,0.0000
215.158.238.80,<->,57.199.250.222,1,1197,0,0,1,1197,1.887309000,0.0000
231.255.190.2,<->,92.27.219.16,0,0,1,50,1,50,1.887135000,0.0000
198.204.76.208,<->,136.25.189.80,0,0,1,1229,1,1229,1.886970000,0.0000
215.158.140.111,<->,8.191.9.38,1,1064,0,0,1,1064,1.886956000,0.0000
244.50.133.60,<->,20.189.159.17,0,0,1,50,1,50,1.886770000,0.0000
194.232.1.247,<->,136.25.188.225,0,0,1,50,1,50,1.886709000,0.0000
215.158.239.50,<->,195.42.86.9,1,56,0,0,1,56,1.886630000,0.0000
215.158.61.202,<->,8.176.8.248,0,0,1,56,1,56,1.886610000,0.0000
133.178.226.19,<->,69.150.169.181,1,1277,0,0,1,1277,1.886549000,0.0000
136.25.188.196,<->,41.153.59.35,1,68,0,0,1,68,1.886547000,0.0000
215.158.61.145,<->,136.25.189.211,0,0,1,56,1,56,1.886359000,0.0000
207.62.174.232,<->,136.25.188.175,0,0,1,64,1,64,1.886322000,0.0000
197.10.43.51,<->,101.70.109.4,0,0,1,65,1,65,1.886321000,0.0000
215.158.239.96,<->,199.20.31.159,1,56,0,0,1,56,1.886150000,0.0000
133.178.227.41,<->,114.171.18.217,1,1054,0,0,1,1054,1.886047000,0.0000
144.75.218.242,<->,139.252.1.225,1,159,0,0,1,159,1.885943000,0.0000
215.158.239.93,<->,196.108.62.238,1,56,0,0,1,56,1.885889000,0.0000
136.25.188.45,<->,29.211.186.197,1,1213,0,0,1,1213,1.885820000,0.0000
159.140.232.210,<->,96.62.130.47,0,0,1,50,1,50,1.885701000,0.0000
109.222.246.3,<->,60.89.248.196,1,73,0,0,1,73,1.885673000,0.0000
144.75.218.242,<->,138.127.231.222,1,267,0,0,1,267,1.885562000,0.0000
199.20.14.202,<->,92.27.194.147,0,0,1,56,1,56,1.885514000,0.0000
124.176.105.226,<->,92.27.219.150,0,0,1,64,1,64,1.885476000,0.0000
215.158.239.51,<->,118.20.100.183,1,1373,0,0,1,1373,1.885367000,0.0000
207.173.96.207,<->,92.27.194.147,0,0,1,56,1,56,1.885266000,0.0000
75.144.70.129,<->,8.252.221.197,0,0,1,506,1,506,1.884860000,0.0000
20.174.38.117,<->,0.83.228.26,1,64,0,0,1,64,1.884582000,0.0000
204.56.122.78,<->,136.25.188.255,0,0,1,50,1,50,1.884135000,0.0000
43.55.244.161,<->,8.252.221.205,0,0,1,64,1,64,1.884097000,0.0000
235.11.134.111,<->,101.224.191.89,0,0,1,57,1,57,1.883976000,0.0000
118.124.167.207,<->,100.94.189.56,0,0,1,68,1,68,1.883971000,0.0000
215.158.238.95,<->,116.106.60.163,1,1357,0,0,1,1357,1.883939000,0.0000
204.200.45.54,<->,136.25.188.196,0,0,1,64,1,64,1.883782000,0.0000
39.15.233.100,<->,0.54.22.103,1,86,0,0,1,86,1.883612000,0.0000
98.158.89.59,<->,8.182.245.10,0,0,1,50,1,50,1.883515000,0.0000
199.15.129.91,<->,136.25.188.176,0,0,1,64,1,64,1.883399000,0.0000
159.137.141.82,<->,27.86.197.67,1,779,0,0,1,779,1.883374000,0.0000
247.136.211.6,<->,232.31.64.94,1,56,0,0,1,56,1.883309000,0.0000
215.158.239.70,<->,204.226.31.67,1,56,0,0,1,56,1.883177000,0.0000
215.158.239.56,<->,199.20.31.162,1,64,0,0,1,64,1.882984000,0.0000
6.145.167.188,<->,0.195.210.44,0,0,1,93,1,93,1.882803000,0.0000
196.246.241.77,<->,136.25.188.177,0,0,1,669,1,669,1.882783000,0.0000
99.215.7.61,<->,20.176.121.25,0,0,1,76,1,76,1.882764000,0.0000
109.222.221.37,<->,53.68.154.194,1,64,0,0,1,64,1.882707000,0.0000
247.136.143.204,<->,75.214.216.116,1,52,0,0,1,52,1.882462000,0.0000
143.132.88.43,<->,136.25.188.254,0,0,1,64,1,64,1.882342000,0.0000
215.158.239.84,<->,195.40.179.152,1,64,0,0,1,64,1.882189000,0.0000
92.27.27.165,<->,78.49.192.10,1,52,0,0,1,52,1.882132000,0.0000
199.25.163.226,<->,159.137.226.12,0,0,1,79,1,79,1.882064000,0.0000
247.136.152.205,<->,54.44.33.166,1,99,0,0,1,99,1.881993000,0.0000
156.136.27.195,<->,39.244.64.115,0,0,1,56,1,56,1.881398000,0.0000
215.158.239.87,<->,195.15.46.101,1,64,0,0,1,64,1.881360000,0.0000
144.75.218.246,<->,53.160.253.194,1,126,0,0,1,126,1.881265000,0.0000
215.158.238.250,<->,61.35.22.195,1,1079,0,0,1,1079,1.881196000,0.0000
215.158.239.79,<->,207.62.22.34,1,68,0,0,1,68,1.881154000,0.0000
98.195.237.34,<->,8.220.186.62,0,0,1,50,1,50,1.881101000,0.0000
192.228.30.39,<->,100.93.115.102,0,0,1,56,1,56,1.881082000,0.0000
241.193.172.231,<->,20.152.56.243,0,0,1,50,1,50,1.880831000,0.0000
144.75.218.241,<->,138.127.225.113,1,366,0,0,1,366,1.880831000,0.0000
215.158.238.236,<->,158.85.50.88,1,1110,0,0,1,1110,1.880771000,0.0000
207.190.192.89,<->,136.25.188.198,0,0,1,617,1,617,1.880764000,0.0000
111.151.109.51,<->,8.252.223.81,0,0,1,56,1,56,1.880541000,0.0000
215.158.238.133,<->,142.234.196.202,1,1213,0,0,1,1213,1.880473000,0.0000
139.163.26.146,<->,0.90.243.237,1,111,0,0,1,111,1.880448000,0.0000
215.158.239.70,<->,57.236.82.251,1,1341,0,0,1,1341,1.880431000,0.0000
215.158.239.70,<->,195.54.83.223,1,64,0,0,1,64,1.880428000,0.0000
195.14.82.229,<->,136.25.188.173,0,0,1,56,1,56,1.880385000,0.0000
92.27.219.36,<->,78.46.85.213,1,1504,0,0,1,1504,1.880139000,0.0000
136.25.189.77,<->,135.228.221.199,1,1213,0,0,1,1213,1.880030000,0.0000
80.41.252.160,<->,8.45.168.98,1,141,0,0,1,141,1.879617000,0.0000
205.127.108.114,<->,33.233.141.43,0,0,1,56,1,56,1.879521000,0.0000
210.229.230.22,<->,17.11.207.216,1,68,0,0,1,68,1.879120000,0.0000
143.22.75.181,<->,8.182.226.42,0,0,1,52,1,52,1.879023000,0.0000
53.214.118.195,<->,48.53.140.76,0,0,1,1169,1,1169,1.878744000,0.0000
92.27.219.153,<->,29.134.223.74,1,52,0,0,1,52,1.878533000,0.0000
149.167.2.14,<->,8.43.154.163,0,0,1,64,1,64,1.878327000,0.0000
246.253.217.193,<->,207.80.57.99,1,56,0,0,1,56,1.878304000,0.0000
195.43.255.251,<->,136.25.188.177,0,0,1,182,1,182,1.878177000,0.0000
88.192.148.214,<->,0.195.210.24,0,0,1,56,1,56,1.878097000,0.0000
193.46.99.163,<->,109.222.250.135,0,0,1,129,1,129,1.877998000,0.0000
42.103.242.17,<->,39.200.8.4,0,0,1,84,1,84,1.877890000,0.0000
89.183.104.251,<->,53.68.95.1,1,50,0,0,1,50,1.877688000,0.0000
231.140.219.86,<->,215.158.239.56,0,0,1,64,1,64,1.877673000,0.0000
109.222.237.131,<->,50.248.185.173,1,50,0,0,1,50,1.877644000,0.0000
145.232.120.123,<->,58.43.188.36,1,50,0,0,1,50,1.877643000,0.0000
141.25.2.220,<->,133.178.226.38,0,0,1,1341,1,1341,1.877594000,0.0000
215.158.239.56,<->,199.20.29.253,1,68,0,0,1,68,1.877538000,0.0000
239.66.185.234,<->,144.71.47.67,0,0,1,140,1,140,1.877446000,0.0000
199.50.127.162,<->,136.25.188.255,0,0,1,129,1,129,1.877060000,0.0000
215.158.238.205,<->,89.76.50.211,1,84,0,0,1,84,1.877024000,0.0000
215.158.238.77,<->,118.20.100.60,1,84,0,0,1,84,1.877009000,0.0000
17.255.114.134,<->,8.52.181.8,0,0,1,50,1,50,1.876910000,0.0000
136.25.188.179,<->,118.20.114.95,1,1181,0,0,1,1181,1.876681000,0.0000
215.158.239.87,<->,142.240.103.195,1,50,0,0,1,50,1.876678000,0.0000
144.76.46.38,<->,99.72.178.167,0,0,1,135,1,135,1.876500000,0.0000
204.56.125.183,<->,136.25.188.236,0,0,1,854,1,854,1.876402000,0.0000
158.5.27.168,<->,39.35.63.117,0,0,1,52,1,52,1.876116000,0.0000
215.158.239.96,<->,142.244.120.120,1,64,0,0,1,64,1.875916000,0.0000
200.174.211.120,<->,54.37.1.37,1,56,0,0,1,56,1.875779000,0.0000
105.92.19.235,<->,20.17.179.5,0,0,1,64,1,64,1.875586000,0.0000
58.202.35.36,<->,8.252.222.143,0,0,1,56,1,56,1.875352000,0.0000
117.157.99.11,<->,109.222.199.230,0,0,1,72,1,72,1.875083000,0.0000
144.72.193.17,<->,80.40.53.29,0,0,1,50,1,50,1.875038000,0.0000
144.75.218.246,<->,138.127.225.82,1,355,0,0,1,355,1.875029000,0.0000
39.38.161.196,<->,33.56.203.251,1,94,0,0,1,94,1.875009000,0.0000
207.57.75.15,<->,136.25.188.177,0,0,1,56,1,56,1.874901000,0.0000
215.158.239.85,<->,199.20.5.45,1,64,0,0,1,64,1.874838000,0.0000
215.158.61.224,<->,8.252.222.101,0,0,1,56,1,56,1.874601000,0.0000
224.250.191.6,<->,100.94.193.188,0,0,1,68,1,68,1.874577000,0.0000
111.150.186.220,<->,8.252.222.236,0,0,1,1005,1,1005,1.874505000,0.0000
197.146.194.8,<->,136.25.188.160,0,0,1,56,1,56,1.874283000,0.0000
215.158.239.77,<->,195.43.74.178,1,68,0,0,1,68,1.874099000,0.0000
20.13.111.1,<->,0.200.50.50,1,60,0,0,1,60,1.873970000,0.0000
131.128.233.183,<->,8.52.162.215,0,0,1,1002,1,1002,1.873879000,0.0000
50.55.215.83,<->,8.52.189.207,0,0,1,50,1,50,1.873850000,0.0000
230.126.157.121,<->,192.67.73.190,0,0,1,133,1,133,1.873494000,0.0000
131.241.118.110,<->,92.27.219.135,0,0,1,56,1,56,1.873346000,0.0000
120.155.84.97,<->,92.27.219.197,0,0,1,110,1,110,1.873297000,0.0000
226.36.28.187,<->,92.27.219.156,0,0,1,84,1,84,1.873249000,0.0000
92.27.219.241,<->,0.216.248.239,1,68,0,0,1,68,1.873245000,0.0000
194.238.136.22,<->,136.25.188.55,0,0,1,68,1,68,1.873231000,0.0000
199.73.39.223,<->,136.25.188.254,0,0,1,56,1,56,1.873175000,0.0000
143.20.104.241,<->,136.25.188.225,0,0,1,50,1,50,1.872955000,0.0000
126.198.147.25,<->,102.50.91.150,0,0,1,340,1,340,1.872923000,0.0000
207.57.179.153,<->,136.25.188.46,0,0,1,50,1,50,1.872906000,0.0000
247.136.210.161,<->,125.153.53.155,1,321,0,0,1,321,1.872825000,0.0000
98.190.105.98,<->,29.214.110.52,1,1002,0,0,1,1002,1.872820000,0.0000
210.229.230.19,<->,145.214.244.32,1,68,0,0,1,68,1.872704000,0.0000
206.231.135.204,<->,89.183.104.150,0,0,1,58,1,58,1.872663000,0.0000
215.158.239.19,<->,105.113.17.195,1,50,0,0,1,50,1.872648000,0.0000
142.209.87.205,<->,136.25.188.177,0,0,1,68,1,68,1.872570000,0.0000
115.43.9.188,<->,92.27.219.204,0,0,1,59,1,59,1.872059000,0.0000
207.59.90.13,<->,136.25.188.175,0,0,1,56,1,56,1.872045000,0.0000
197.137.33.27,<->,92.27.219.36,0,0,1,52,1,52,1.871987000,0.0000
92.27.219.166,<->,33.22.37.126,1,52,0,0,1,52,1.871947000,0.0000
192.67.155.194,<->,38.173.83.126,1,52,0,0,1,52,1.871933000,0.0000
142.201.0.91,<->,8.182.243.89,0,0,1,64,1,64,1.871722000,0.0000
215.158.238.190,<->,128.194.247.55,1,1325,0,0,1,1325,1.871719000,0.0000
193.86.126.254,<->,192.67.178.158,0,0,1,50,1,50,1.871669000,0.0000
195.51.170.49,<->,8.182.224.248,0,0,1,52,1,52,1.871633000,0.0000
207.190.192.89,<->,136.25.188.242,0,0,1,617,1,617,1.871508000,0.0000
194.218.129.53,<->,192.67.167.86,0,0,1,52,1,52,1.871470000,0.0000
21.15.226.126,<->,20.193.18.21,0,0,1,82,1,82,1.871435000,0.0000
141.172.208.37,<->,8.252.221.236,0,0,1,50,1,50,1.871379000,0.0000
215.158.239.49,<->,195.54.50.211,1,64,0,0,1,64,1.871374000,0.0000
111.150.207.206,<->,8.252.223.72,0,0,1,100,1,100,1.871239000,0.0000
159.13.142.108,<->,54.92.216.150,1,118,0,0,1,118,1.870954000,0.0000
215.158.239.92,<->,199.20.29.199,1,781,0,0,1,781,1.870469000,0.0000
246.254.97.228,<->,139.33.174.68,1,50,0,0,1,50,1.870413000,0.0000
139.33.174.178,<->,97.168.65.251,0,0,1,50,1,50,1.870388000,0.0000
249.101.218.36,<->,56.114.235.120,1,56,0,0,1,56,1.870380000,0.0000
220.55.66.45,<->,126.198.120.245,1,196,0,0,1,196,1.870354000,0.0000
204.184.145.183,<->,136.25.188.222,0,0,1,64,1,64,1.870320000,0.0000
113.65.136.161,<->,39.51.246.5,0,0,1,72,1,72,1.870244000,0.0000
215.158.239.97,<->,195.15.186.168,1,64,0,0,1,64,1.870243000,0.0000
199.79.65.112,<->,20.84.237.80,0,0,1,106,1,106,1.870127000,0.0000
215.158.238.83,<->,8.188.227.68,1,1213,0,0,1,1213,1.869955000,0.0000
196.109.192.105,<->,39.228.20.193,0,0,1,106,1,106,1.869690000,0.0000
222.34.248.184,<->,92.27.27.169,0,0,1,436,1,436,1.869596000,0.0000
158.20.90.55,<->,133.178.226.245,0,0,1,116,1,116,1.869521000,0.0000
215.158.238.149,<->,156.165.37.102,1,1261,0,0,1,1261,1.869498000,0.0000
136.25.189.0,<->,27.22.184.102,1,1341,0,0,1,1341,1.869425000,0.0000
215.158.239.93,<->,142.221.199.163,1,56,0,0,1,56,1.869377000,0.0000
192.171.13.189,<->,8.176.8.229,0,0,1,112,1,112,1.869210000,0.0000
226.41.240.14,<->,129.6.83.11,0,0,1,64,1,64,1.869088000,0.0000
132.200.62.171,<->,132.200.51.118,1,64,0,0,1,64,1.869024000,0.0000
247.136.134.130,<->,205.88.59.195,1,135,0,0,1,135,1.868702000,0.0000
247.136.161.149,<->,238.11.170.11,1,298,0,0,1,298,1.868480000,0.0000
215.158.238.92,<->,192.226.161.156,1,64,0,0,1,64,1.868459000,0.0000
204.2.200.89,<->,136.25.188.163,0,0,1,50,1,50,1.868299000,0.0000
252.98.135.151,<->,205.93.50.119,1,64,0,0,1,64,1.867946000,0.0000
204.186.246.31,<->,136.25.188.52,0,0,1,76,1,76,1.867856000,0.0000
136.25.188.239,<->,69.150.168.232,1,1197,0,0,1,1197,1.867591000,0.0000
221.102.143.189,<->,213.38.178.214,0,0,1,64,1,64,1.867266000,0.0000
196.28.105.94,<->,20.83.89.44,0,0,1,64,1,64,1.867006000,0.0000
193.39.70.92,<->,136.25.188.253,0,0,1,1117,1,1117,1.867005000,0.0000
129.236.100.219,<->,129.224.112.252,0,0,1,74,1,74,1.866993000,0.0000
159.137.162.213,<->,146.89.211.89,1,56,0,0,1,56,1.866877000,0.0000
113.129.173.19,<->,50.224.76.235,0,0,1,50,1,50,1.866807000,0.0000
207.25.52.204,<->,50.223.3.228,0,0,1,56,1,56,1.866756000,0.0000
221.102.102.190,<->,199.48.68.155,1,50,0,0,1,50,1.866616000,0.0000
159.69.187.21,<->,144.108.64.179,1,67,0,0,1,67,1.866610000,0.0000
207.59.90.13,<->,136.25.188.254,0,0,1,56,1,56,1.866555000,0.0000
92.27.219.30,<->,27.172.7.238,1,52,0,0,1,52,1.866376000,0.0000
194.237.44.11,<->,136.25.188.222,0,0,1,50,1,50,1.866369000,0.0000
144.75.218.235,<->,138.127.231.222,1,238,0,0,1,238,1.866061000,0.0000
136.25.188.220,<->,29.211.6.45,1,1093,0,0,1,1093,1.866007000,0.0000
144.75.218.235,<->,138.127.231.132,1,236,0,0,1,236,1.865816000,0.0000
135.255.47.205,<->,8.252.221.171,0,0,1,64,1,64,1.865773000,0.0000
92.173.67.10,<->,20.192.127.162,0,0,1,64,1,64,1.865477000,0.0000
195.70.96.22,<->,136.25.188.252,0,0,1,50,1,50,1.865310000,0.0000
215.158.239.87,<->,196.1.206.177,1,52,0,0,1,52,1.865226000,0.0000
129.78.114.77,<->,97.182.32.123,1,50,0,0,1,50,1.865054000,0.0000
215.158.239.93,<->,199.15.89.90,1,56,0,0,1,56,1.864802000,0.0000
199.82.190.79,<->,136.25.188.178,0,0,1,50,1,50,1.864708000,0.0000
142.248.203.196,<->,136.25.188.177,0,0,1,64,1,64,1.864707000,0.0000
108.180.195.130,<->,8.53.3.213,0,0,1,50,1,50,1.864603000,0.0000
140.68.0.230,<->,8.252.222.31,0,0,1,68,1,68,1.864323000,0.0000
195.40.0.15,<->,136.25.188.255,0,0,1,64,1,64,1.864103000,0.0000
199.55.71.68,<->,8.182.138.83,0,0,1,50,1,50,1.864035000,0.0000
249.101.89.113,<->,50.145.227.155,1,93,0,0,1,93,1.864008000,0.0000
215.158.239.69,<->,199.20.29.237,1,50,0,0,1,50,1.863996000,0.0000
126.210.84.153,<->,39.203.35.145,0,0,1,75,1,75,1.863363000,0.0000
124.27.237.237,<->,39.201.32.176,0,0,1,70,1,70,1.863348000,0.0000
207.179.199.242,<->,20.190.226.180,0,0,1,52,1,52,1.863099000,0.0000
231.136.89.186,<->,136.25.188.175,0,0,1,68,1,68,1.862949000,0.0000
215.158.238.163,<->,111.151.142.130,1,56,0,0,1,56,1.862791000,0.0000
215.158.238.223,<->,18.202.90.172,1,1261,0,0,1,1261,1.862711000,0.0000
207.74.37.142,<->,50.223.3.228,0,0,1,56,1,56,1.862651000,0.0000
97.94.119.43,<->,35.56.98.12,0,0,1,50,1,50,1.862535000,0.0000
139.181.79.30,<->,8.188.179.3,1,68,0,0,1,68,1.862464000,0.0000
221.102.56.69,<->,6.74.104.58,0,0,1,294,1,294,1.862365000,0.0000
133.178.226.245,<->,8.221.197.206,1,141,0,0,1,141,1.862142000,0.0000
106.213.240.130,<->,99.72.161.129,0,0,1,135,1,135,1.862065000,0.0000
215.158.238.148,<->,122.216.233.212,1,1245,0,0,1,1245,1.861953000,0.0000
145.89.145.60,<->,144.81.142.56,1,217,0,0,1,217,1.861838000,0.0000
50.224.76.235,<->,42.108.157.227,1,64,0,0,1,64,1.861691000,0.0000
220.55.123.209,<->,57.140.246.52,1,72,0,0,1,72,1.861629000,0.0000
212.241.174.245,<->,80.27.157.123,0,0,1,50,1,50,1.861625000,0.0000
89.183.104.129,<->,48.105.40.132,1,52,0,0,1,52,1.861479000,0.0000
142.254.251.60,<->,136.25.188.174,0,0,1,50,1,50,1.861421000,0.0000
199.82.194.240,<->,136.25.188.160,0,0,1,50,1,50,1.861417000,0.0000
199.123.173.229,<->,136.25.188.163,0,0,1,50,1,50,1.861051000,0.0000
133.178.226.161,<->,0.68.1.25,1,89,0,0,1,89,1.860716000,0.0000
145.3.142.7,<->,39.237.228.132,0,0,1,64,1,64,1.860602000,0.0000
192.171.13.190,<->,8.176.8.195,0,0,1,122,1,122,1.860594000,0.0000
96.232.239.36,<->,92.27.27.178,0,0,1,50,1,50,1.860477000,0.0000
133.32.39.10,<->,111.150.207.129,1,56,0,0,1,56,1.860163000,0.0000
147.61.250.193,<->,111.147.186.234,0,0,1,138,1,138,1.859870000,0.0000
246.254.111.94,<->,205.109.193.158,1,52,0,0,1,52,1.859613000,0.0000
215.158.239.58,<->,195.41.97.118,1,68,0,0,1,68,1.859454000,0.0000
198.158.197.83,<->,20.183.89.8,0,0,1,50,1,50,1.859403000,0.0000
215.158.239.94,<->,199.20.30.254,1,64,0,0,1,64,1.859180000,0.0000
195.54.53.97,<->,136.25.188.220,0,0,1,56,1,56,1.859152000,0.0000
215.158.239.111,<->,215.158.61.189,1,56,0,0,1,56,1.859098000,0.0000
204.200.32.9,<->,136.25.188.55,0,0,1,765,1,765,1.858987000,0.0000
215.158.239.58,<->,199.20.5.116,1,749,0,0,1,749,1.858859000,0.0000
119.111.190.164,<->,97.198.97.149,0,0,1,83,1,83,1.858844000,0.0000
143.61.64.223,<->,8.220.197.41,0,0,1,704,1,704,1.858791000,0.0000
215.158.239.59,<->,195.83.170.137,1,56,0,0,1,56,1.858496000,0.0000
156.164.241.165,<->,39.212.97.199,0,0,1,64,1,64,1.858209000,0.0000
97.173.75.108,<->,39.200.99.40,0,0,1,64,1,64,1.858150000,0.0000
129.224.112.252,<->,114.145.101.174,1,80,0,0,1,80,1.857955000,0.0000
204.63.122.227,<->,136.25.188.46,0,0,1,56,1,56,1.857949000,0.0000
88.3.93.137,<->,39.145.17.48,0,0,1,64,1,64,1.857867000,0.0000
92.168.217.206,<->,50.136.141.181,1,312,0,0,1,312,1.857864000,0.0000
216.184.0.194,<->,98.232.172.60,0,0,1,90,1,90,1.857844000,0.0000
133.178.226.245,<->,122.158.247.84,1,141,0,0,1,141,1.857631000,0.0000
113.65.136.161,<->,39.51.246.6,0,0,1,72,1,72,1.857516000,0.0000
148.111.30.85,<->,144.75.218.242,0,0,1,75,1,75,1.857284000,0.0000
193.21.29.220,<->,92.27.219.28,0,0,1,326,1,326,1.857263000,0.0000
199.38.209.157,<->,136.25.188.239,0,0,1,64,1,64,1.857056000,0.0000
244.50.241.190,<->,20.169.16.143,0,0,1,50,1,50,1.857051000,0.0000
148.246.80.24,<->,80.38.6.51,0,0,1,544,1,544,1.856918000,0.0000
215.158.238.66,<->,57.199.250.202,1,1309,0,0,1,1309,1.856873000,0.0000
215.158.239.87,<->,207.190.157.96,1,64,0,0,1,64,1.856864000,0.0000
92.27.27.143,<->,78.55.109.190,1,56,0,0,1,56,1.856607000,0.0000
142.253.84.18,<->,136.25.188.252,0,0,1,50,1,50,1.856595000,0.0000
193.87.146.236,<->,192.67.167.160,0,0,1,321,1,321,1.856302000,0.0000
136.25.189.193,<->,100.224.132.237,1,797,0,0,1,797,1.856245000,0.0000
199.39.6.149,<->,136.25.188.176,0,0,1,56,1,56,1.856106000,0.0000
66.91.81.193,<->,34.47.39.226,0,0,1,60,1,60,1.855931000,0.0000
102.45.225.190,<->,97.126.26.70,0,0,1,62,1,62,1.855896000,0.0000
252.136.253.62,<->,56.121.46.158,0,0,1,50,1,50,1.855847000,0.0000
195.17.159.19,<->,136.25.189.15,0,0,1,1229,1,1229,1.855699000,0.0000
215.158.239.56,<->,196.107.142.49,1,240,0,0,1,240,1.855371000,0.0000
136.25.188.163,<->,50.51.247.223,1,50,0,0,1,50,1.855341000,0.0000
237.7.189.252,<->,111.147.166.12,0,0,1,60,1,60,1.855209000,0.0000
91.231.195.229,<->,50.57.180.49,1,72,0,0,1,72,1.854928000,0.0000
133.178.226.254,<->,8.191.0.37,1,90,0,0,1,90,1.854860000,0.0000
129.223.93.3,<->,97.126.26.71,0,0,1,699,1,699,1.854821000,0.0000
58.245.201.56,<->,39.54.0.31,0,0,1,70,1,70,1.854578000,0.0000
194.207.25.148,<->,20.89.130.235,0,0,1,64,1,64,1.854458000,0.0000
112.15.193.110,<->,92.27.27.166,0,0,1,52,1,52,1.854409000,0.0000
21.15.226.126,<->,20.193.18.209,0,0,1,82,1,82,1.854371000,0.0000
80.57.138.214,<->,8.176.8.99,0,0,1,56,1,56,1.854264000,0.0000
207.61.106.97,<->,136.25.188.253,0,0,1,129,1,129,1.854031000,0.0000
92.27.219.38,<->,33.46.220.222,1,52,0,0,1,52,1.854004000,0.0000
215.158.239.87,<->,143.132.9.178,1,64,0,0,1,64,1.853971000,0.0000
133.178.226.37,<->,29.211.186.213,1,1341,0,0,1,1341,1.853922000,0.0000
149.178.40.234,<->,144.75.218.235,0,0,1,144,1,144,1.853817000,0.0000
207.56.157.30,<->,136.25.188.163,0,0,1,64,1,64,1.853478000,0.0000
94.196.135.89,<->,92.27.219.39,0,0,1,321,1,321,1.853348000,0.0000
215.158.239.92,<->,196.91.123.145,1,56,0,0,1,56,1.853209000,0.0000
215.158.239.49,<->,126.219.191.4,1,1373,0,0,1,1373,1.853161000,0.0000
104.152.3.8,<->,20.171.59.213,0,0,1,56,1,56,1.853049000,0.0000
138.98.148.32,<->,92.162.218.66,1,863,0,0,1,863,1.853028000,0.0000
138.98.240.68,<->,27.124.47.97,1,1135,0,0,1,1135,1.852907000,0.0000
133.178.227.19,<->,112.93.136.106,1,1389,0,0,1,1389,1.852802000,0.0000
127.66.17.50,<->,39.141.80.19,0,0,1,64,1,64,1.852710000,0.0000
98.159.98.236,<->,8.182.226.194,0,0,1,50,1,50,1.852662000,0.0000
215.158.239.92,<->,199.20.6.249,1,64,0,0,1,64,1.852610000,0.0000
50.55.175.77,<->,8.220.200.124,0,0,1,764,1,764,1.852430000,0.0000
86.135.8.107,<->,8.252.222.48,0,0,1,68,1,68,1.852314000,0.0000
204.172.88.54,<->,39.11.130.186,0,0,1,103,1,103,1.852310000,0.0000
112.70.164.219,<->,8.220.205.50,0,0,1,704,1,704,1.852300000,0.0000
199.69.253.187,<->,89.183.104.158,0,0,1,52,1,52,1.852092000,0.0000
207.192.128.185,<->,39.175.29.44,0,0,1,80,1,80,1.851815000,0.0000
143.134.66.103,<->,136.25.188.238,0,0,1,56,1,56,1.851578000,0.0000
92.27.27.165,<->,78.44.97.48,1,52,0,0,1,52,1.851548000,0.0000
89.152.227.73,<->,20.155.224.208,0,0,1,50,1,50,1.851371000,0.0000
75.62.16.8,<->,20.7.227.107,0,0,1,50,1,50,1.851335000,0.0000
215.158.239.93,<->,196.94.181.75,1,56,0,0,1,56,1.851183000,0.0000
8.176.59.88,<->,0.220.251.34,1,50,0,0,1,50,1.851124000,0.0000
118.224.214.53,<->,100.94.4.233,0,0,1,56,1,56,1.851088000,0.0000
215.158.239.51,<->,196.104.134.164,1,56,0,0,1,56,1.851074000,0.0000
195.127.150.57,<->,136.25.188.53,0,0,1,56,1,56,1.850943000,0.0000
144.86.145.88,<->,132.43.156.54,1,259,0,0,1,259,1.850768000,0.0000
129.224.112.252,<->,8.61.93.25,1,80,0,0,1,80,1.850736000,0.0000
100.182.99.11,<->,20.179.123.243,0,0,1,52,1,52,1.850587000,0.0000
104.46.166.216,<->,92.27.219.54,0,0,1,52,1,52,1.850503000,0.0000
145.3.142.7,<->,39.237.228.139,0,0,1,64,1,64,1.850473000,0.0000
143.50.219.227,<->,50.224.76.235,0,0,1,60,1,60,1.850363000,0.0000
100.182.99.11,<->,20.179.124.126,0,0,1,52,1,52,1.850341000,0.0000
252.98.181.203,<->,50.150.173.184,1,56,0,0,1,56,1.850303000,0.0000
138.121.99.24,<->,8.220.238.247,0,0,1,50,1,50,1.850297000,0.0000
215.158.239.56,<->,199.20.29.57,1,76,0,0,1,76,1.850258000,0.0000
195.127.150.57,<->,136.25.188.176,0,0,1,56,1,56,1.850245000,0.0000
247.136.138.95,<->,210.209.251.214,1,481,0,0,1,481,1.850221000,0.0000
139.193.141.209,<->,115.119.81.160,1,518,0,0,1,518,1.849998000,0.0000
144.75.218.246,<->,138.127.231.122,1,253,0,0,1,253,1.849985000,0.0000
215.158.239.49,<->,196.93.180.237,1,56,0,0,1,56,1.849885000,0.0000
247.136.171.153,<->,152.35.69.219,1,100,0,0,1,100,1.849824000,0.0000
134.10.203.20,<->,80.42.172.225,0,0,1,52,1,52,1.849815000,0.0000
128.134.58.103,<->,20.214.252.198,0,0,1,72,1,72,1.849476000,0.0000
199.72.117.29,<->,136.25.188.178,0,0,1,56,1,56,1.849388000,0.0000
106.112.9.43,<->,92.27.219.139,0,0,1,52,1,52,1.849343000,0.0000
120.246.178.46,<->,20.159.61.62,0,0,1,64,1,64,1.849064000,0.0000
197.145.12.91,<->,8.20.87.187,0,0,1,64,1,64,1.848930000,0.0000
193.29.109.175,<->,20.190.177.115,0,0,1,92,1,92,1.848854000,0.0000
247.136.164.246,<->,204.232.147.92,1,56,0,0,1,56,1.848597000,0.0000
104.214.134.102,<->,20.194.31.33,0,0,1,64,1,64,1.848427000,0.0000
241.193.172.231,<->,20.51.162.142,0,0,1,50,1,50,1.848381000,0.0000
109.0.243.153,<->,105.170.45.15,1,174,0,0,1,174,1.848067000,0.0000
221.102.56.69,<->,192.66.191.203,0,0,1,56,1,56,1.847895000,0.0000
195.55.112.191,<->,136.25.188.45,0,0,1,56,1,56,1.847794000,0.0000
133.178.227.76,<->,61.35.124.227,1,1079,0,0,1,1079,1.847629000,0.0000
221.196.122.241,<->,136.25.188.173,0,0,1,50,1,50,1.847368000,0.0000
198.69.188.244,<->,92.27.27.99,0,0,1,135,1,135,1.847285000,0.0000
199.4.221.199,<->,50.224.76.235,0,0,1,68,1,68,1.847193000,0.0000
195.37.216.214,<->,92.27.194.147,0,0,1,56,1,56,1.847150000,0.0000
215.158.238.201,<->,215.158.33.107,1,570,0,0,1,570,1.847146000,0.0000
195.54.142.53,<->,136.25.188.227,0,0,1,56,1,56,1.847123000,0.0000
92.27.219.50,<->,64.214.68.218,1,135,0,0,1,135,1.847120000,0.0000
129.92.118.200,<->,91.250.55.98,1,56,0,0,1,56,1.847063000,0.0000
246.44.57.198,<->,66.88.207.130,1,68,0,0,1,68,1.847026000,0.0000
206.100.98.202,<->,192.67.160.34,0,0,1,135,1,135,1.846986000,0.0000
121.8.199.111,<->,8.220.204.215,0,0,1,704,1,704,1.846978000,0.0000
246.253.248.211,<->,53.202.56.24,1,87,0,0,1,87,1.846930000,0.0000
195.54.57.102,<->,136.25.188.236,0,0,1,50,1,50,1.846906000,0.0000
215.158.238.81,<->,104.3.168.128,1,1229,0,0,1,1229,1.846883000,0.0000
124.158.228.91,<->,20.122.102.189,0,0,1,60,1,60,1.846803000,0.0000
220.55.101.99,<->,8.47.188.160,1,132,0,0,1,132,1.846774000,0.0000
143.110.36.21,<->,136.25.188.255,0,0,1,56,1,56,1.846681000,0.0000
215.158.238.135,<->,149.163.129.232,1,1133,0,0,1,1133,1.845606000,0.0000
204.42.12.34,<->,89.183.104.246,0,0,1,321,1,321,1.845577000,0.0000
215.158.238.148,<->,30.249.194.108,1,1117,0,0,1,1117,1.845344000,0.0000
215.158.239.48,<->,195.49.157.120,1,602,0,0,1,602,1.845314000,0.0000
133.178.226.245,<->,8.252.136.247,1,141,0,0,1,141,1.845133000,0.0000
229.70.81.21,<->,109.1.16.219,0,0,1,52,1,52,1.845129000,0.0000
244.50.236.30,<->,20.87.184.184,0,0,1,50,1,50,1.845115000,0.0000
80.41.20.160,<->,53.246.158.153,1,395,0,0,1,395,1.844962000,0.0000
113.127.207.90,<->,97.126.113.14,0,0,1,64,1,64,1.844791000,0.0000
136.11.138.96,<->,8.220.190.86,0,0,1,50,1,50,1.844518000,0.0000
199.24.13.33,<->,8.53.1.205,0,0,1,84,1,84,1.844319000,0.0000
144.75.218.237,<->,138.127.231.127,1,259,0,0,1,259,1.844270000,0.0000
111.151.109.41,<->,67.174.33.171,0,0,1,100,1,100,1.844222000,0.0000
97.94.123.83,<->,89.183.104.172,0,0,1,50,1,50,1.844190000,0.0000
204.188.32.30,<->,136.25.188.45,0,0,1,68,1,68,1.844040000,0.0000
114.26.165.175,<->,92.27.219.147,0,0,1,52,1,52,1.843902000,0.0000
195.54.132.205,<->,136.25.188.54,0,0,1,64,1,64,1.843592000,0.0000
143.76.168.51,<->,8.182.139.40,0,0,1,50,1,50,1.843568000,0.0000
116.116.8.2,<->,89.183.104.246,0,0,1,138,1,138,1.843496000,0.0000
199.80.212.171,<->,136.25.188.45,0,0,1,305,1,305,1.843487000,0.0000
231.142.4.176,<->,136.25.188.160,0,0,1,865,1,865,1.843055000,0.0000
8.182.233.86,<->,6.242.11.8,1,50,0,0,1,50,1.843014000,0.0000
199.66.208.64,<->,136.25.188.222,0,0,1,64,1,64,1.842968000,0.0000
215.158.238.95,<->,57.116.165.189,1,1149,0,0,1,1149,1.842850000,0.0000
56.114.235.120,<->,35.56.97.244,0,0,1,56,1,56,1.842776000,0.0000
215.158.103.219,<->,80.56.76.189,1,566,0,0,1,566,1.842741000,0.0000
97.126.19.86,<->,58.218.173.51,1,74,0,0,1,74,1.842618000,0.0000
192.228.30.44,<->,100.92.171.77,0,0,1,50,1,50,1.842598000,0.0000
122.147.213.67,<->,20.86.191.178,0,0,1,72,1,72,1.842533000,0.0000
215.158.238.97,<->,104.3.168.214,1,1373,0,0,1,1373,1.842474000,0.0000
202.178.8.219,<->,129.78.119.192,0,0,1,64,1,64,1.842400000,0.0000
221.196.122.150,<->,136.25.188.173,0,0,1,56,1,56,1.842279000,0.0000
144.122.240.224,<->,144.108.64.179,1,75,0,0,1,75,1.842231000,0.0000
215.158.239.92,<->,204.0.168.49,1,84,0,0,1,84,1.842187000,0.0000
199.41.253.141,<->,99.75.171.124,0,0,1,50,1,50,1.841866000,0.0000
154.181.213.140,<->,8.228.214.124,0,0,1,78,1,78,1.841797000,0.0000
215.158.239.87,<->,199.20.29.43,1,781,0,0,1,781,1.841608000,0.0000
197.113.99.100,<->,136.25.188.179,0,0,1,68,1,68,1.841291000,0.0000
224.46.94.193,<->,20.18.212.115,0,0,1,64,1,64,1.840983000,0.0000
145.57.21.172,<->,133.0.67.60,0,0,1,412,1,412,1.840972000,0.0000
194.209.34.72,<->,8.250.151.29,0,0,1,704,1,704,1.840798000,0.0000
247.136.163.14,<->,48.106.148.95,1,55,0,0,1,55,1.840682000,0.0000
215.158.239.79,<->,207.188.97.64,1,64,0,0,1,64,1.840680000,0.0000
193.10.105.69,<->,92.27.219.178,0,0,1,135,1,135,1.840546000,0.0000
94.24.179.72,<->,92.27.219.244,0,0,1,50,1,50,1.840420000,0.0000
215.158.239.95,<->,199.20.31.93,1,56,0,0,1,56,1.840265000,0.0000
207.223.249.91,<->,92.27.27.176,0,0,1,52,1,52,1.840040000,0.0000
215.158.239.248,<->,111.151.107.200,1,100,0,0,1,100,1.839956000,0.0000
109.222.233.47,<->,97.119.43.23,1,68,0,0,1,68,1.839645000,0.0000
245.161.251.59,<->,8.252.222.148,0,0,1,52,1,52,1.839624000,0.0000
140.17.122.242,<->,92.170.49.231,0,0,1,50,1,50,1.839168000,0.0000
133.178.227.76,<->,131.144.116.5,1,1405,0,0,1,1405,1.839086000,0.0000
210.229.230.19,<->,100.146.76.164,1,50,0,0,1,50,1.839017000,0.0000
249.101.220.125,<->,29.214.217.95,1,106,0,0,1,106,1.838988000,0.0000
195.42.93.219,<->,20.148.166.172,0,0,1,80,1,80,1.838907000,0.0000
215.158.239.78,<->,199.20.31.42,1,68,0,0,1,68,1.838635000,0.0000
197.113.99.127,<->,136.25.188.253,0,0,1,56,1,56,1.838598000,0.0000
204.58.160.229,<->,136.25.188.242,0,0,1,50,1,50,1.838594000,0.0000
108.32.70.30,<->,92.27.219.61,0,0,1,52,1,52,1.838558000,0.0000
142.208.210.234,<->,20.171.175.31,0,0,1,52,1,52,1.838459000,0.0000
239.66.177.184,<->,100.94.63.248,0,0,1,98,1,98,1.838278000,0.0000
79.255.248.211,<->,34.97.244.196,0,0,1,62,1,62,1.838257000,0.0000
246.253.252.62,<->,6.89.30.105,1,132,0,0,1,132,1.838220000,0.0000
254.70.28.13,<->,192.67.173.65,0,0,1,213,1,213,1.838147000,0.0000
134.98.189.43,<->,80.38.54.178,0,0,1,50,1,50,1.838060000,0.0000
246.253.248.211,<->,53.187.62.98,1,89,0,0,1,89,1.838014000,0.0000
215.158.239.95,<->,199.20.29.208,1,64,0,0,1,64,1.837867000,0.0000
80.42.179.50,<->,27.193.66.236,1,77,0,0,1,77,1.837766000,0.0000
53.160.222.235,<->,48.53.175.207,0,0,1,50,1,50,1.837753000,0.0000
210.221.107.50,<->,8.222.6.255,1,64,0,0,1,64,1.837679000,0.0000
76.75.235.102,<->,39.32.47.110,0,0,1,99,1,99,1.837617000,0.0000
109.222.246.61,<->,14.224.78.123,1,79,0,0,1,79,1.837530000,0.0000
215.158.61.183,<->,136.25.188.39,0,0,1,56,1,56,1.837489000,0.0000
136.25.189.93,<->,89.86.110.252,1,83,0,0,1,83,1.837289000,0.0000
136.25.188.252,<->,84.210.24.145,1,629,0,0,1,629,1.837286000,0.0000
110.235.137.248,<->,89.183.104.227,0,0,1,123,1,123,1.837126000,0.0000
69.128.180.8,<->,54.36.219.23,1,64,0,0,1,64,1.837113000,0.0000
69.103.221.44,<->,8.252.221.198,0,0,1,56,1,56,1.837041000,0.0000
215.158.238.241,<->,131.144.116.40,1,1050,0,0,1,1050,1.836998000,0.0000
204.187.145.145,<->,136.25.188.46,0,0,1,68,1,68,1.836987000,0.0000
145.252.113.224,<->,120.245.216.61,1,753,0,0,1,753,1.836968000,0.0000
89.183.104.238,<->,76.180.48.254,1,100,0,0,1,100,1.836928000,0.0000
244.50.129.64,<->,39.214.111.138,0,0,1,50,1,50,1.836574000,0.0000
57.31.82.214,<->,8.182.251.218,0,0,1,50,1,50,1.836512000,0.0000
133.178.226.245,<->,131.148.22.184,1,183,0,0,1,183,1.836441000,0.0000
159.137.143.150,<->,100.19.49.44,1,75,0,0,1,75,1.836344000,0.0000
135.195.177.18,<->,133.54.17.57,0,0,1,56,1,56,1.836132000,0.0000
207.92.21.74,<->,92.27.219.50,0,0,1,52,1,52,1.836043000,0.0000
133.45.3.167,<->,89.183.104.146,0,0,1,64,1,64,1.835979000,0.0000
143.44.2.21,<->,136.25.188.174,0,0,1,64,1,64,1.835965000,0.0000
215.158.239.79,<->,195.55.153.11,1,64,0,0,1,64,1.835951000,0.0000
123.37.50.78,<->,8.228.214.59,0,0,1,56,1,56,1.835943000,0.0000
139.241.119.19,<->,98.235.198.99,1,93,0,0,1,93,1.835863000,0.0000
136.25.188.211,<->,8.220.51.235,1,1245,0,0,1,1245,1.835829000,0.0000
143.53.86.202,<->,136.25.188.196,0,0,1,68,1,68,1.835688000,0.0000
199.21.40.75,<->,99.72.131.232,0,0,1,52,1,52,1.835675000,0.0000
153.252.156.171,<->,109.3.157.147,0,0,1,133,1,133,1.835582000,0.0000
215.158.239.56,<->,196.108.40.153,1,64,0,0,1,64,1.835416000,0.0000
136.25.189.62,<->,96.156.169.199,1,381,0,0,1,381,1.835288000,0.0000
92.168.217.253,<->,50.136.155.152,1,536,0,0,1,536,1.835251000,0.0000
195.42.67.103,<->,136.25.188.220,0,0,1,56,1,56,1.835239000,0.0000
97.126.21.248,<->,53.231.141.126,1,50,0,0,1,50,1.834996000,0.0000
119.90.251.239,<->,20.126.176.178,0,0,1,50,1,50,1.834954000,0.0000
142.227.35.179,<->,136.25.188.255,0,0,1,353,1,353,1.834930000,0.0000
142.105.64.126,<->,39.201.125.228,0,0,1,75,1,75,1.834876000,0.0000
207.172.153.47,<->,136.25.188.174,0,0,1,382,1,382,1.834828000,0.0000
195.7.146.113,<->,136.25.188.176,0,0,1,56,1,56,1.834776000,0.0000
195.84.236.189,<->,39.167.77.109,0,0,1,70,1,70,1.834514000,0.0000
202.33.100.147,<->,136.25.188.196,0,0,1,68,1,68,1.834434000,0.0000
192.64.198.147,<->,109.119.182.180,1,52,0,0,1,52,1.834433000,0.0000
215.158.239.56,<->,204.2.57.202,1,56,0,0,1,56,1.834363000,0.0000
136.25.188.179,<->,113.24.0.167,1,1341,0,0,1,1341,1.834017000,0.0000
215.158.238.134,<->,142.234.196.201,1,1357,0,0,1,1357,1.833902000,0.0000
215.158.239.57,<->,204.0.139.105,1,284,0,0,1,284,1.833895000,0.0000
218.4.172.205,<->,198.158.197.83,1,50,0,0,1,50,1.833787000,0.0000
148.151.104.199,<->,80.38.12.231,0,0,1,76,1,76,1.833715000,0.0000
136.25.188.106,<->,123.130.129.156,1,100,0,0,1,100,1.833584000,0.0000
192.67.140.245,<->,132.60.192.128,1,52,0,0,1,52,1.833515000,0.0000
215.158.239.76,<->,196.92.59.145,1,64,0,0,1,64,1.833407000,0.0000
38.92.85.211,<->,20.214.90.17,0,0,1,64,1,64,1.833341000,0.0000
215.158.239.20,<->,53.231.110.86,1,749,0,0,1,749,1.833293000,0.0000
197.107.69.146,<->,8.182.141.189,0,0,1,561,1,561,1.833246000,0.0000
141.20.135.7,<->,137.21.3.80,0,0,1,81,1,81,1.833225000,0.0000
121.81.193.145,<->,97.126.20.201,0,0,1,52,1,52,1.833185000,0.0000
215.158.239.76,<->,207.239.48.8,1,64,0,0,1,64,1.832946000,0.0000
142.191.149.111,<->,136.25.188.252,0,0,1,56,1,56,1.832914000,0.0000
205.91.134.38,<->,39.232.98.64,0,0,1,64,1,64,1.832753000,0.0000
215.158.58.200,<->,6.73.247.151,0,0,1,56,1,56,1.832723000,0.0000
215.158.239.48,<->,143.128.203.14,1,64,0,0,1,64,1.832518000,0.0000
241.193.172.231,<->,20.229.182.159,0,0,1,50,1,50,1.832408000,0.0000
50.224.80.67,<->,29.233.87.16,1,56,0,0,1,56,1.832343000,0.0000
202.33.233.53,<->,136.25.188.225,0,0,1,50,1,50,1.832273000,0.0000
207.85.20.183,<->,8.182.244.179,0,0,1,50,1,50,1.831855000,0.0000
142.200.21.47,<->,8.52.165.54,0,0,1,1002,1,1002,1.831779000,0.0000
215.158.238.95,<->,42.226.3.103,1,1245,0,0,1,1245,1.831623000,0.0000
118.59.39.42,<->,92.27.219.223,0,0,1,351,1,351,1.831543000,0.0000
21.15.226.126,<->,20.193.19.157,0,0,1,82,1,82,1.831455000,0.0000
8.230.248.174,<->,8.220.176.253,0,0,1,50,1,50,1.831402000,0.0000
215.158.239.57,<->,196.92.244.20,1,68,0,0,1,68,1.831230000,0.0000
133.178.227.214,<->,80.47.152.53,1,156,0,0,1,156,1.831159000,0.0000
215.158.238.83,<->,8.188.227.0,1,1197,0,0,1,1197,1.831062000,0.0000
196.20.107.154,<->,89.183.104.179,0,0,1,62,1,62,1.831016000,0.0000
215.158.140.170,<->,8.220.7.141,1,96,0,0,1,96,1.830792000,0.0000
196.89.165.140,<->,136.25.188.222,0,0,1,64,1,64,1.830697000,0.0000
215.158.103.206,<->,138.127.231.137,1,249,0,0,1,249,1.830598000,0.0000
199.21.75.231,<->,99.73.155.191,0,0,1,149,1,149,1.830409000,0.0000
194.136.215.179,<->,80.42.171.60,0,0,1,64,1,64,1.830377000,0.0000
159.37.13.45,<->,145.116.119.49,0,0,1,56,1,56,1.830303000,0.0000
201.41.156.131,<->,159.115.113.93,0,0,1,56,1,56,1.830115000,0.0000
126.95.20.184,<->,92.27.219.23,0,0,1,50,1,50,1.829945000,0.0000
199.68.161.41,<->,136.25.188.45,0,0,1,68,1,68,1.829867000,0.0000
215.158.239.50,<->,199.20.5.119,1,860,0,0,1,860,1.829829000,0.0000
244.50.252.80,<->,20.145.162.140,0,0,1,50,1,50,1.829798000,0.0000
144.105.32.254,<->,64.214.57.39,1,50,0,0,1,50,1.829285000,0.0000
215.158.3.183,<->,8.176.8.47,0,0,1,1325,1,1325,1.828891000,0.0000
123.163.224.245,<->,39.210.39.96,0,0,1,56,1,56,1.828838000,0.0000
136.25.189.83,<->,29.211.228.215,1,1213,0,0,1,1213,1.828722000,0.0000
195.56.123.113,<->,8.20.87.206,0,0,1,50,1,50,1.828717000,0.0000
142.221.182.82,<->,136.25.188.174,0,0,1,56,1,56,1.828463000,0.0000
128.134.120.108,<->,20.162.44.67,0,0,1,78,1,78,1.828364000,0.0000
145.31.132.129,<->,8.220.178.166,0,0,1,50,1,50,1.828216000,0.0000
144.76.46.38,<->,99.75.83.112,0,0,1,86,1,86,1.827996000,0.0000
122.213.129.160,<->,50.224.76.234,0,0,1,68,1,68,1.827952000,0.0000
215.158.140.75,<->,126.219.194.5,1,1091,0,0,1,1091,1.827841000,0.0000
215.158.239.58,<->,199.20.31.151,1,56,0,0,1,56,1.827577000,0.0000
125.54.142.72,<->,80.42.160.210,0,0,1,135,1,135,1.827421000,0.0000
111.20.44.252,<->,97.126.4.233,0,0,1,50,1,50,1.827164000,0.0000
192.67.181.71,<->,92.175.127.61,1,56,0,0,1,56,1.827132000,0.0000
204.185.159.40,<->,136.25.188.253,0,0,1,68,1,68,1.826933000,0.0000
136.25.189.5,<->,131.36.66.69,1,84,0,0,1,84,1.826926000,0.0000
196.114.81.229,<->,8.252.222.143,0,0,1,64,1,64,1.826696000,0.0000
244.50.136.175,<->,39.50.189.246,0,0,1,50,1,50,1.826577000,0.0000
133.178.227.79,<->,29.212.182.234,1,1056,0,0,1,1056,1.826496000,0.0000
94.39.75.213,<->,39.154.116.186,0,0,1,80,1,80,1.826460000,0.0000
95.219.96.130,<->,50.224.76.235,0,0,1,64,1,64,1.826214000,0.0000
76.72.228.64,<->,39.164.106.24,0,0,1,64,1,64,1.826118000,0.0000
215.158.238.227,<->,69.31.238.219,1,64,0,0,1,64,1.825935000,0.0000
131.128.233.183,<->,8.220.193.21,0,0,1,704,1,704,1.825773000,0.0000
215.158.239.93,<->,195.126.87.110,1,64,0,0,1,64,1.825688000,0.0000
192.64.229.25,<->,112.218.200.144,1,99,0,0,1,99,1.825647000,0.0000
64.252.49.18,<->,20.210.41.91,0,0,1,64,1,64,1.825557000,0.0000
102.45.16.159,<->,61.60.31.115,1,50,0,0,1,50,1.825391000,0.0000
119.90.251.239,<->,39.226.69.18,0,0,1,50,1,50,1.825376000,0.0000
53.167.38.197,<->,48.53.135.207,0,0,1,56,1,56,1.825205000,0.0000
144.75.218.235,<->,130.229.11.147,1,136,0,0,1,136,1.825045000,0.0000
207.173.97.102,<->,136.25.188.225,0,0,1,56,1,56,1.824983000,0.0000
215.202.174.52,<->,215.158.239.85,0,0,1,1133,1,1133,1.824740000,0.0000
198.158.197.83,<->,20.169.148.14,0,0,1,50,1,50,1.824655000,0.0000
90.240.135.127,<->,54.38.65.101,1,56,0,0,1,56,1.824398000,0.0000
122.218.5.165,<->,39.157.140.203,0,0,1,60,1,60,1.824085000,0.0000
215.158.238.79,<->,118.20.100.60,1,84,0,0,1,84,1.823942000,0.0000
132.103.198.222,<->,119.121.24.104,1,64,0,0,1,64,1.823919000,0.0000
215.158.239.50,<->,207.191.21.184,1,64,0,0,1,64,1.823578000,0.0000
200.174.193.202,<->,54.37.65.21,1,50,0,0,1,50,1.823159000,0.0000
21.15.226.126,<->,20.193.19.159,0,0,1,82,1,82,1.823062000,0.0000
130.139.188.18,<->,97.198.101.226,0,0,1,56,1,56,1.823033000,0.0000
109.222.245.159,<->,80.227.44.110,1,76,0,0,1,76,1.822757000,0.0000
223.141.71.187,<->,92.27.219.205,0,0,1,62,1,62,1.822619000,0.0000
142.200.155.49,<->,20.123.155.57,0,0,1,100,1,100,1.822579000,0.0000
199.32.203.173,<->,136.25.188.163,0,0,1,56,1,56,1.822493000,0.0000
215.158.140.8,<->,69.132.241.159,1,90,0,0,1,90,1.822484000,0.0000
215.158.239.240,<->,8.240.125.62,1,90,0,0,1,90,1.822467000,0.0000
134.160.119.114,<->,80.40.14.22,0,0,1,653,1,653,1.822355000,0.0000
109.222.245.154,<->,50.238.210.101,1,50,0,0,1,50,1.822275000,0.0000
141.245.151.211,<->,136.47.66.197,1,86,0,0,1,86,1.822200000,0.0000
192.205.242.89,<->,133.178.226.202,0,0,1,56,1,56,1.822199000,0.0000
220.38.84.229,<->,133.178.226.30,0,0,1,1181,1,1181,1.822081000,0.0000
97.126.26.49,<->,76.82.133.14,1,86,0,0,1,86,1.822019000,0.0000
215.158.239.49,<->,196.109.71.193,1,68,0,0,1,68,1.821838000,0.0000
195.115.40.69,<->,92.27.219.39,0,0,1,52,1,52,1.821734000,0.0000
215.158.140.60,<->,158.85.50.93,1,1049,0,0,1,1049,1.821685000,0.0000
213.38.229.2,<->,59.36.99.236,1,351,0,0,1,351,1.821623000,0.0000
146.14.154.200,<->,133.178.226.61,0,0,1,1197,1,1197,1.821565000,0.0000
136.25.189.14,<->,131.144.115.230,1,1357,0,0,1,1357,1.821515000,0.0000
215.158.239.57,<->,196.1.222.190,1,56,0,0,1,56,1.821466000,0.0000
92.27.27.150,<->,42.31.145.160,1,319,0,0,1,319,1.821425000,0.0000
215.158.239.50,<->,199.20.30.169,1,781,0,0,1,781,1.821377000,0.0000
33.233.141.30,<->,8.182.121.33,1,68,0,0,1,68,1.821098000,0.0000
104.2.79.89,<->,20.34.58.245,0,0,1,64,1,64,1.821044000,0.0000
215.158.239.95,<->,199.20.7.153,1,56,0,0,1,56,1.820961000,0.0000
132.18.67.30,<->,80.40.53.29,0,0,1,50,1,50,1.820907000,0.0000
144.75.218.242,<->,138.127.224.59,1,285,0,0,1,285,1.820555000,0.0000
194.45.239.127,<->,89.183.104.254,0,0,1,52,1,52,1.820552000,0.0000
109.222.242.34,<->,96.191.62.123,1,75,0,0,1,75,1.820479000,0.0000
192.64.228.251,<->,123.155.89.112,1,133,0,0,1,133,1.820449000,0.0000
192.67.167.160,<->,27.147.179.30,1,331,0,0,1,331,1.820243000,0.0000
215.158.239.71,<->,29.123.209.228,1,1341,0,0,1,1341,1.819741000,0.0000
199.70.16.190,<->,136.25.188.238,0,0,1,64,1,64,1.819471000,0.0000
80.38.16.208,<->,79.129.145.13,1,56,0,0,1,56,1.819328000,0.0000
97.233.39.9,<->,8.220.234.159,0,0,1,50,1,50,1.819324000,0.0000
148.188.34.166,<->,50.224.89.237,0,0,1,79,1,79,1.819190000,0.0000
145.158.125.83,<->,54.58.153.140,1,56,0,0,1,56,1.819178000,0.0000
215.158.103.206,<->,53.178.69.33,1,140,0,0,1,140,1.818820000,0.0000
244.50.133.60,<->,218.4.183.62,0,0,1,50,1,50,1.818422000,0.0000
215.158.238.218,<->,215.158.132.227,1,611,0,0,1,611,1.818276000,0.0000
77.23.182.148,<->,6.75.224.242,0,0,1,133,1,133,1.818232000,0.0000
126.2.10.5,<->,20.154.109.237,0,0,1,86,1,86,1.818157000,0.0000
139.163.7.171,<->,138.127.225.228,1,267,0,0,1,267,1.818077000,0.0000
195.55.84.115,<->,136.25.188.176,0,0,1,56,1,56,1.818013000,0.0000
210.220.219.152,<->,50.239.49.97,1,50,0,0,1,50,1.817933000,0.0000
215.158.238.140,<->,38.104.11.54,1,1309,0,0,1,1309,1.817920000,0.0000
244.50.133.60,<->,20.110.75.146,0,0,1,50,1,50,1.817833000,0.0000
144.75.218.235,<->,138.127.224.169,1,259,0,0,1,259,1.817721000,0.0000
112.30.234.122,<->,92.168.217.228,0,0,1,56,1,56,1.817648000,0.0000
200.174.192.11,<->,53.69.246.130,1,64,0,0,1,64,1.817648000,0.0000
215.158.239.51,<->,199.20.30.191,1,64,0,0,1,64,1.817610000,0.0000
98.200.176.13,<->,70.208.156.132,1,90,0,0,1,90,1.817322000,0.0000
132.175.204.127,<->,8.52.222.23,0,0,1,50,1,50,1.817193000,0.0000
136.25.188.197,<->,8.253.128.36,1,1341,0,0,1,1341,1.817173000,0.0000
206.154.255.105,<->,192.65.148.55,0,0,1,103,1,103,1.817136000,0.0000
198.156.25.132,<->,192.64.209.42,0,0,1,57,1,57,1.816968000,0.0000
215.158.239.50,<->,196.92.69.55,1,64,0,0,1,64,1.816937000,0.0000
144.75.218.246,<->,138.127.231.26,1,366,0,0,1,366,1.816604000,0.0000
144.72.195.98,<->,100.94.118.188,0,0,1,50,1,50,1.816311000,0.0000
141.172.26.149,<->,53.201.106.213,1,56,0,0,1,56,1.816034000,0.0000
80.41.38.96,<->,42.68.246.99,1,50,0,0,1,50,1.816026000,0.0000
143.104.165.120,<->,8.182.226.78,0,0,1,50,1,50,1.815817000,0.0000
216.144.221.45,<->,215.158.140.221,0,0,1,50,1,50,1.815783000,0.0000
104.46.90.215,<->,92.27.27.147,0,0,1,357,1,357,1.815713000,0.0000
120.164.163.192,<->,89.183.104.151,0,0,1,52,1,52,1.815702000,0.0000
222.16.241.65,<->,80.42.176.33,0,0,1,56,1,56,1.815553000,0.0000
215.158.239.56,<->,199.20.30.199,1,64,0,0,1,64,1.815545000,0.0000
131.68.53.195,<->,109.1.61.202,0,0,1,60,1,60,1.815513000,0.0000
158.166.172.13,<->,136.25.188.37,0,0,1,109,1,109,1.815370000,0.0000
136.25.188.45,<->,8.179.43.59,1,1309,0,0,1,1309,1.815290000,0.0000
96.47.148.163,<->,8.52.187.74,0,0,1,50,1,50,1.815276000,0.0000
241.193.172.231,<->,20.0.227.200,0,0,1,50,1,50,1.815252000,0.0000
215.158.239.68,<->,195.13.213.160,1,765,0,0,1,765,1.815139000,0.0000
246.45.170.70,<->,159.140.232.210,1,50,0,0,1,50,1.815131000,0.0000
215.158.238.132,<->,122.159.68.201,1,1133,0,0,1,1133,1.815116000,0.0000
136.25.189.82,<->,29.212.180.213,1,1245,0,0,1,1245,1.814853000,0.0000
195.43.136.182,<->,136.25.188.53,0,0,1,50,1,50,1.814834000,0.0000
241.193.172.231,<->,20.106.190.159,0,0,1,50,1,50,1.814647000,0.0000
54.58.131.174,<->,48.54.65.205,0,0,1,64,1,64,1.814546000,0.0000
111.181.100.63,<->,52.26.227.26,1,65,0,0,1,65,1.814471000,0.0000
136.25.189.210,<->,33.209.222.135,1,111,0,0,1,111,1.814373000,0.0000
101.70.123.195,<->,53.240.179.31,1,50,0,0,1,50,1.814219000,0.0000
58.242.139.155,<->,8.252.221.236,0,0,1,68,1,68,1.814058000,0.0000
243.117.92.202,<->,80.38.46.20,0,0,1,50,1,50,1.813942000,0.0000
144.75.218.233,<->,138.127.230.128,1,236,0,0,1,236,1.813926000,0.0000
144.83.60.153,<->,92.162.253.89,0,0,1,50,1,50,1.813768000,0.0000
195.41.225.140,<->,136.25.188.253,0,0,1,64,1,64,1.813716000,0.0000
215.158.210.24,<->,29.211.214.254,0,0,1,96,1,96,1.813519000,0.0000
204.3.128.102,<->,136.25.188.222,0,0,1,824,1,824,1.813424000,0.0000
144.75.218.237,<->,138.127.231.171,1,159,0,0,1,159,1.813367000,0.0000
207.162.179.129,<->,92.27.194.147,0,0,1,56,1,56,1.812880000,0.0000
195.127.213.157,<->,136.25.188.175,0,0,1,64,1,64,1.812846000,0.0000
215.158.238.143,<->,126.219.194.122,1,1213,0,0,1,1213,1.812844000,0.0000
215.158.238.96,<->,56.102.22.3,1,1149,0,0,1,1149,1.812828000,0.0000
142.221.182.82,<->,136.25.188.55,0,0,1,56,1,56,1.812666000,0.0000
133.178.226.246,<->,8.191.0.37,1,90,0,0,1,90,1.812617000,0.0000
204.200.157.129,<->,136.25.188.176,0,0,1,50,1,50,1.812601000,0.0000
136.25.188.72,<->,111.151.106.216,1,56,0,0,1,56,1.812336000,0.0000
143.224.187.106,<->,80.38.36.144,0,0,1,52,1,52,1.811828000,0.0000
215.158.239.86,<->,195.6.161.159,1,64,0,0,1,64,1.811686000,0.0000
139.33.175.144,<->,111.147.236.79,0,0,1,50,1,50,1.811591000,0.0000
132.149.114.12,<->,53.214.238.49,1,50,0,0,1,50,1.811164000,0.0000
204.187.81.60,<->,136.25.188.237,0,0,1,68,1,68,1.810962000,0.0000
97.126.31.80,<->,29.211.224.183,1,1002,0,0,1,1002,1.810604000,0.0000
93.146.42.91,<->,39.198.190.35,0,0,1,64,1,64,1.810505000,0.0000
53.249.52.51,<->,20.202.19.26,0,0,1,64,1,64,1.810201000,0.0000
192.224.197.11,<->,73.186.221.255,1,704,0,0,1,704,1.809953000,0.0000
53.148.184.48,<->,48.54.20.117,0,0,1,56,1,56,1.809930000,0.0000
76.72.228.64,<->,39.164.106.31,0,0,1,64,1,64,1.809756000,0.0000
133.178.227.8,<->,111.151.142.233,1,56,0,0,1,56,1.809674000,0.0000
104.134.18.220,<->,97.126.107.81,0,0,1,52,1,52,1.809485000,0.0000
202.33.33.55,<->,136.25.188.220,0,0,1,50,1,50,1.809379000,0.0000
133.54.28.239,<->,59.4.229.71,1,75,0,0,1,75,1.809256000,0.0000
147.180.169.242,<->,34.229.165.106,0,0,1,132,1,132,1.809174000,0.0000
92.27.219.189,<->,42.45.91.160,1,344,0,0,1,344,1.809099000,0.0000
21.15.226.126,<->,20.193.19.107,0,0,1,82,1,82,1.808914000,0.0000
199.91.57.142,<->,39.224.191.198,0,0,1,75,1,75,1.808882000,0.0000
80.40.49.169,<->,38.65.219.171,1,50,0,0,1,50,1.808330000,0.0000
89.183.104.227,<->,33.57.79.42,1,52,0,0,1,52,1.808270000,0.0000
96.47.148.163,<->,8.52.169.207,0,0,1,50,1,50,1.808228000,0.0000
195.60.113.229,<->,8.52.246.194,0,0,1,50,1,50,1.808193000,0.0000
120.155.84.160,<->,98.190.121.68,0,0,1,108,1,108,1.808132000,0.0000
110.97.115.62,<->,92.27.26.102,0,0,1,57,1,57,1.808063000,0.0000
126.232.52.51,<->,20.108.97.86,0,0,1,64,1,64,1.808001000,0.0000
54.37.93.17,<->,48.53.7.249,0,0,1,50,1,50,1.807711000,0.0000
195.68.126.156,<->,136.25.188.254,0,0,1,68,1,68,1.807365000,0.0000
136.25.189.85,<->,29.211.206.37,1,83,0,0,1,83,1.807266000,0.0000
94.193.220.45,<->,34.47.144.136,0,0,1,52,1,52,1.807248000,0.0000
140.218.109.105,<->,136.25.189.82,0,0,1,1357,1,1357,1.807122000,0.0000
21.15.226.126,<->,20.193.19.98,0,0,1,82,1,82,1.807013000,0.0000
132.103.198.251,<->,119.121.24.104,1,64,0,0,1,64,1.806942000,0.0000
114.252.76.140,<->,20.43.111.128,0,0,1,52,1,52,1.806684000,0.0000
92.27.219.182,<->,88.12.99.63,1,1396,0,0,1,1396,1.806683000,0.0000
215.158.239.79,<->,196.93.215.178,1,56,0,0,1,56,1.806650000,0.0000
144.75.218.235,<->,138.127.230.2,1,238,0,0,1,238,1.806496000,0.0000
40.223.131.112,<->,39.149.102.89,0,0,1,56,1,56,1.806464000,0.0000
192.64.230.162,<->,125.223.21.203,1,56,0,0,1,56,1.806236000,0.0000
204.126.215.57,<->,8.53.8.233,0,0,1,84,1,84,1.806162000,0.0000
215.158.239.92,<->,199.20.30.90,1,68,0,0,1,68,1.806083000,0.0000
199.14.190.122,<->,136.25.188.236,0,0,1,64,1,64,1.805973000,0.0000
109.222.192.25,<->,94.39.140.224,1,52,0,0,1,52,1.805815000,0.0000
139.33.174.87,<->,111.147.236.79,0,0,1,50,1,50,1.805637000,0.0000
199.121.54.19,<->,136.25.188.227,0,0,1,50,1,50,1.805568000,0.0000
29.95.158.240,<->,20.199.198.90,0,0,1,64,1,64,1.805531000,0.0000
144.87.235.187,<->,8.188.179.5,1,68,0,0,1,68,1.805519000,0.0000
215.158.239.50,<->,196.93.123.153,1,64,0,0,1,64,1.805517000,0.0000
136.25.189.34,<->,118.20.100.144,1,1197,0,0,1,1197,1.805253000,0.0000
195.55.180.86,<->,136.25.188.209,0,0,1,50,1,50,1.805246000,0.0000
68.76.211.111,<->,8.252.221.207,0,0,1,56,1,56,1.805206000,0.0000
92.27.219.134,<->,64.214.57.45,1,50,0,0,1,50,1.805139000,0.0000
215.158.132.242,<->,8.252.223.4,0,0,1,56,1,56,1.804894000,0.0000
198.214.15.165,<->,138.98.197.6,0,0,1,50,1,50,1.804843000,0.0000
215.158.239.77,<->,143.99.90.95,1,56,0,0,1,56,1.804823000,0.0000
229.42.167.107,<->,92.27.27.99,0,0,1,213,1,213,1.804783000,0.0000
143.10.177.200,<->,136.25.188.222,0,0,1,56,1,56,1.804678000,0.0000
67.39.232.93,<->,8.220.181.167,0,0,1,50,1,50,1.804676000,0.0000
159.69.187.23,<->,6.147.33.6,1,73,0,0,1,73,1.804659000,0.0000
149.167.2.14,<->,8.43.154.168,0,0,1,64,1,64,1.804569000,0.0000
117.15.47.10,<->,50.224.76.230,0,0,1,50,1,50,1.804487000,0.0000
205.91.134.38,<->,39.232.98.74,0,0,1,64,1,64,1.804265000,0.0000
210.158.59.62,<->,92.27.8.159,0,0,1,50,1,50,1.804050000,0.0000
193.77.246.1,<->,20.243.143.105,0,0,1,52,1,52,1.803971000,0.0000
204.187.19.173,<->,136.25.188.226,0,0,1,56,1,56,1.803891000,0.0000
220.50.253.93,<->,144.93.132.149,0,0,1,68,1,68,1.803745000,0.0000
144.79.204.50,<->,8.182.141.189,0,0,1,50,1,50,1.803741000,0.0000
215.158.238.141,<->,8.191.6.217,1,1085,0,0,1,1085,1.803628000,0.0000
89.183.104.231,<->,0.97.210.244,1,52,0,0,1,52,1.803540000,0.0000
196.119.218.141,<->,50.224.76.230,0,0,1,56,1,56,1.803487000,0.0000
193.94.47.49,<->,109.222.226.221,0,0,1,64,1,64,1.803189000,0.0000
199.68.20.34,<->,136.25.188.238,0,0,1,725,1,725,1.802891000,0.0000
133.178.226.30,<->,89.80.251.7,1,1181,0,0,1,1181,1.802576000,0.0000
215.158.140.241,<->,141.23.229.214,1,1232,0,0,1,1232,1.802554000,0.0000
133.178.227.27,<->,42.189.53.47,1,1421,0,0,1,1421,1.802543000,0.0000
139.252.1.238,<->,39.14.27.228,0,0,1,201,1,201,1.802515000,0.0000
206.249.247.241,<->,20.92.0.160,0,0,1,64,1,64,1.802304000,0.0000
132.222.173.85,<->,132.43.156.54,1,346,0,0,1,346,1.802218000,0.0000
192.64.254.48,<->,88.113.208.14,1,56,0,0,1,56,1.802181000,0.0000
220.50.226.64,<->,20.206.7.161,0,0,1,50,1,50,1.802106000,0.0000
215.158.238.133,<->,112.220.206.127,1,1165,0,0,1,1165,1.802066000,0.0000
215.158.239.78,<->,199.20.7.15,1,50,0,0,1,50,1.802016000,0.0000
136.221.119.73,<->,20.21.128.105,0,0,1,64,1,64,1.802009000,0.0000
204.184.246.117,<->,136.25.188.176,0,0,1,84,1,84,1.801883000,0.0000
133.178.227.242,<->,126.219.136.164,1,1277,0,0,1,1277,1.801758000,0.0000
220.20.200.87,<->,136.177.72.3,1,56,0,0,1,56,1.801655000,0.0000
192.222.14.4,<->,145.252.112.67,0,0,1,50,1,50,1.801557000,0.0000
100.209.91.159,<->,92.27.219.221,0,0,1,52,1,52,1.801406000,0.0000
199.39.15.249,<->,136.25.188.175,0,0,1,64,1,64,1.801386000,0.0000
215.158.238.92,<->,197.5.160.203,1,1213,0,0,1,1213,1.801302000,0.0000
139.252.109.251,<->,80.56.78.128,0,0,1,97,1,97,1.801160000,0.0000
215.158.61.209,<->,97.126.31.75,0,0,1,327,1,327,1.800956000,0.0000
215.158.239.56,<->,199.78.39.222,1,56,0,0,1,56,1.800846000,0.0000
241.193.172.231,<->,20.167.183.128,0,0,1,50,1,50,1.800799000,0.0000
195.41.38.35,<->,8.52.228.29,0,0,1,50,1,50,1.800794000,0.0000
143.177.241.68,<->,8.182.241.177,0,0,1,547,1,547,1.800781000,0.0000
111.151.139.216,<->,67.174.33.198,0,0,1,56,1,56,1.800544000,0.0000
215.158.238.106,<->,149.96.60.153,1,1117,0,0,1,1117,1.800196000,0.0000
159.69.187.9,<->,144.108.64.179,1,66,0,0,1,66,1.800084000,0.0000
101.70.118.227,<->,56.107.48.212,1,68,0,0,1,68,1.799928000,0.0000
215.158.23.32,<->,111.150.97.97,1,64,0,0,1,64,1.799637000,0.0000
133.178.226.29,<->,61.35.124.188,1,1181,0,0,1,1181,1.799293000,0.0000
193.24.114.87,<->,111.181.122.223,0,0,1,56,1,56,1.799200000,0.0000
215.158.239.79,<->,196.1.179.99,1,903,0,0,1,903,1.799174000,0.0000
21.15.226.126,<->,20.193.19.78,0,0,1,82,1,82,1.799170000,0.0000
98.23.96.82,<->,92.27.219.45,0,0,1,56,1,56,1.798560000,0.0000
198.158.197.83,<->,20.19.228.144,0,0,1,50,1,50,1.798488000,0.0000
192.67.167.86,<->,103.239.132.45,1,56,0,0,1,56,1.798353000,0.0000
195.41.121.95,<->,136.25.188.176,0,0,1,52,1,52,1.798253000,0.0000
194.207.119.223,<->,50.223.3.228,0,0,1,56,1,56,1.798220000,0.0000
98.23.121.218,<->,92.27.219.45,0,0,1,56,1,56,1.798182000,0.0000
202.178.8.84,<->,98.190.109.178,0,0,1,64,1,64,1.798146000,0.0000
89.183.104.139,<->,64.214.57.237,1,50,0,0,1,50,1.797898000,0.0000
106.75.38.26,<->,92.27.27.173,0,0,1,300,1,300,1.797838000,0.0000
129.225.134.223,<->,129.225.132.71,0,0,1,444,1,444,1.797765000,0.0000
141.245.151.222,<->,53.244.113.73,1,305,0,0,1,305,1.797705000,0.0000
159.149.29.226,<->,8.52.222.23,0,0,1,50,1,50,1.797497000,0.0000
252.98.168.208,<->,115.85.147.28,1,64,0,0,1,64,1.797334000,0.0000
136.25.188.223,<->,8.42.43.48,1,1341,0,0,1,1341,1.797227000,0.0000
111.151.139.217,<->,8.252.222.101,0,0,1,56,1,56,1.797074000,0.0000
111.146.192.18,<->,97.160.194.93,1,65,0,0,1,65,1.797002000,0.0000
207.190.192.89,<->,136.25.188.236,0,0,1,621,1,621,1.796886000,0.0000
139.47.194.179,<->,92.27.219.169,0,0,1,50,1,50,1.796539000,0.0000
20.220.195.77,<->,18.203.151.238,1,64,0,0,1,64,1.796388000,0.0000
215.158.239.58,<->,199.20.4.249,1,701,0,0,1,701,1.796266000,0.0000
215.158.239.92,<->,196.95.66.174,1,50,0,0,1,50,1.796232000,0.0000
252.98.149.1,<->,136.128.19.192,1,56,0,0,1,56,1.796220000,0.0000
129.92.116.156,<->,53.94.35.234,1,56,0,0,1,56,1.796111000,0.0000
215.158.238.155,<->,8.191.134.189,1,72,0,0,1,72,1.796063000,0.0000
120.116.159.59,<->,39.27.119.154,0,0,1,64,1,64,1.796042000,0.0000
195.41.130.180,<->,136.25.188.163,0,0,1,701,1,701,1.795950000,0.0000
102.44.100.188,<->,53.214.237.111,1,50,0,0,1,50,1.795913000,0.0000
235.42.35.52,<->,215.158.140.76,0,0,1,1240,1,1240,1.795885000,0.0000
136.118.9.247,<->,129.221.194.218,1,165,0,0,1,165,1.795794000,0.0000
220.39.202.215,<->,215.158.238.141,0,0,1,1277,1,1277,1.795746000,0.0000
247.136.187.32,<->,197.196.75.96,1,56,0,0,1,56,1.795612000,0.0000
215.158.238.92,<->,143.227.108.23,1,1277,0,0,1,1277,1.795490000,0.0000
119.69.69.192,<->,92.27.219.222,0,0,1,52,1,52,1.795335000,0.0000
98.67.141.221,<->,49.41.242.61,1,65,0,0,1,65,1.795248000,0.0000
136.25.189.80,<->,120.154.225.197,1,1357,0,0,1,1357,1.795143000,0.0000
53.68.255.122,<->,48.53.53.225,0,0,1,56,1,56,1.794762000,0.0000
144.75.218.241,<->,138.127.231.3,1,301,0,0,1,301,1.794678000,0.0000
195.55.41.121,<->,92.27.194.147,0,0,1,56,1,56,1.794669000,0.0000
221.102.102.190,<->,207.21.165.55,1,50,0,0,1,50,1.794594000,0.0000
159.69.187.7,<->,144.108.64.179,1,69,0,0,1,69,1.794424000,0.0000
215.158.239.65,<->,6.116.31.8,1,85,0,0,1,85,1.794257000,0.0000
117.158.217.178,<->,100.92.143.157,0,0,1,50,1,50,1.794190000,0.0000
133.178.226.161,<->,29.211.126.97,1,90,0,0,1,90,1.793798000,0.0000
196.89.241.99,<->,136.25.188.241,0,0,1,683,1,683,1.793747000,0.0000
195.41.219.219,<->,136.25.188.45,0,0,1,56,1,56,1.793641000,0.0000
111.150.207.239,<->,8.252.222.182,0,0,1,100,1,100,1.793587000,0.0000
195.120.220.210,<->,39.221.65.2,0,0,1,64,1,64,1.792709000,0.0000
215.158.238.177,<->,38.20.151.94,1,1039,0,0,1,1039,1.792660000,0.0000
252.132.5.13,<->,92.27.194.117,0,0,1,50,1,50,1.792560000,0.0000
144.75.218.233,<->,129.35.251.34,1,140,0,0,1,140,1.792521000,0.0000
132.20.222.233,<->,129.224.112.253,0,0,1,63,1,63,1.792356000,0.0000
199.69.196.19,<->,136.25.188.225,0,0,1,56,1,56,1.792000000,0.0000
29.95.158.240,<->,20.199.198.86,0,0,1,64,1,64,1.791965000,0.0000
195.120.220.210,<->,39.221.65.11,0,0,1,64,1,64,1.791814000,0.0000
195.41.225.198,<->,136.25.188.53,0,0,1,50,1,50,1.791784000,0.0000
195.120.220.210,<->,39.221.65.65,0,0,1,64,1,64,1.791744000,0.0000
215.158.239.79,<->,194.232.186.33,1,64,0,0,1,64,1.791727000,0.0000
195.41.121.95,<->,136.25.188.224,0,0,1,50,1,50,1.791700000,0.0000
237.177.159.56,<->,20.178.201.252,0,0,1,64,1,64,1.791594000,0.0000
125.152.68.198,<->,39.150.207.107,0,0,1,60,1,60,1.791374000,0.0000
247.136.161.149,<->,193.87.145.139,1,319,0,0,1,319,1.791184000,0.0000
114.187.169.221,<->,111.147.75.55,0,0,1,64,1,64,1.790933000,0.0000
215.158.239.75,<->,29.212.183.183,1,85,0,0,1,85,1.790816000,0.0000
224.42.246.238,<->,20.146.99.67,0,0,1,72,1,72,1.790772000,0.0000
8.220.239.104,<->,6.101.100.212,1,50,0,0,1,50,1.790423000,0.0000
205.14.114.4,<->,92.27.219.141,0,0,1,52,1,52,1.790422000,0.0000
144.75.218.237,<->,138.127.225.8,1,248,0,0,1,248,1.789886000,0.0000
215.158.140.148,<->,111.151.107.208,1,64,0,0,1,64,1.789876000,0.0000
195.14.39.235,<->,136.25.188.53,0,0,1,50,1,50,1.789856000,0.0000
207.60.41.54,<->,136.25.188.176,0,0,1,56,1,56,1.789676000,0.0000
197.107.247.157,<->,8.252.222.149,0,0,1,56,1,56,1.789540000,0.0000
224.250.64.90,<->,99.72.84.79,0,0,1,50,1,50,1.789314000,0.0000
112.219.1.220,<->,20.48.60.212,0,0,1,64,1,64,1.789242000,0.0000
199.68.171.35,<->,136.25.188.176,0,0,1,56,1,56,1.789080000,0.0000
144.83.60.153,<->,92.162.252.74,0,0,1,626,1,626,1.788597000,0.0000
215.158.239.32,<->,149.96.53.43,1,1395,0,0,1,1395,1.788578000,0.0000
159.137.247.157,<->,38.179.129.169,1,56,0,0,1,56,1.788334000,0.0000
231.142.138.22,<->,215.158.239.79,0,0,1,56,1,56,1.788299000,0.0000
194.194.150.250,<->,102.50.172.123,0,0,1,58,1,58,1.787958000,0.0000
192.224.197.11,<->,8.182.120.235,1,704,0,0,1,704,1.787896000,0.0000
192.67.169.144,<->,117.65.167.57,1,50,0,0,1,50,1.787854000,0.0000
136.25.188.253,<->,76.100.108.223,1,1309,0,0,1,1309,1.787811000,0.0000
93.157.253.183,<->,8.52.187.45,0,0,1,1002,1,1002,1.787661000,0.0000
105.114.28.251,<->,20.214.1.71,0,0,1,56,1,56,1.787578000,0.0000
222.21.7.2,<->,20.196.99.204,0,0,1,50,1,50,1.787547000,0.0000
206.249.247.241,<->,20.92.0.170,0,0,1,64,1,64,1.787384000,0.0000
215.158.103.206,<->,129.201.176.4,1,792,0,0,1,792,1.787311000,0.0000
204.186.150.53,<->,136.25.188.255,0,0,1,76,1,76,1.787209000,0.0000
131.130.141.188,<->,20.87.123.170,0,0,1,66,1,66,1.787089000,0.0000
111.151.107.247,<->,8.252.222.117,0,0,1,134,1,134,1.786934000,0.0000
136.25.188.212,<->,120.155.222.33,1,106,0,0,1,106,1.786775000,0.0000
27.230.11.180,<->,20.118.76.229,0,0,1,50,1,50,1.786734000,0.0000
50.94.182.207,<->,8.220.205.146,0,0,1,50,1,50,1.786701000,0.0000
119.114.158.55,<->,20.167.62.188,0,0,1,64,1,64,1.786553000,0.0000
215.158.239.77,<->,196.92.135.9,1,64,0,0,1,64,1.786378000,0.0000
192.64.217.166,<->,112.177.147.253,1,52,0,0,1,52,1.786302000,0.0000
192.67.171.106,<->,135.85.163.173,1,580,0,0,1,580,1.786200000,0.0000
97.243.195.155,<->,8.182.228.20,0,0,1,56,1,56,1.785981000,0.0000
138.79.139.178,<->,109.113.104.225,0,0,1,673,1,673,1.785874000,0.0000
215.158.239.48,<->,207.115.225.243,1,64,0,0,1,64,1.785863000,0.0000
195.43.246.251,<->,136.25.188.211,0,0,1,129,1,129,1.785687000,0.0000
132.103.198.247,<->,119.121.24.104,1,64,0,0,1,64,1.785590000,0.0000
39.28.31.196,<->,0.243.15.84,1,56,0,0,1,56,1.785452000,0.0000
140.19.166.183,<->,8.52.240.220,0,0,1,1002,1,1002,1.785197000,0.0000
135.64.101.139,<->,20.59.201.50,0,0,1,60,1,60,1.785193000,0.0000
145.255.180.193,<->,144.75.218.233,0,0,1,175,1,175,1.784960000,0.0000
38.21.156.204,<->,20.232.230.156,0,0,1,82,1,82,1.784794000,0.0000
204.56.163.253,<->,136.25.188.176,0,0,1,50,1,50,1.784653000,0.0000
53.214.235.47,<->,48.55.161.113,0,0,1,648,1,648,1.784648000,0.0000
21.15.226.126,<->,20.193.20.59,0,0,1,82,1,82,1.784566000,0.0000
48.18.73.24,<->,8.252.221.196,0,0,1,50,1,50,1.784389000,0.0000
194.237.32.46,<->,136.25.188.242,0,0,1,56,1,56,1.784346000,0.0000
113.80.8.5,<->,39.61.116.154,0,0,1,136,1,136,1.784238000,0.0000
204.20.91.87,<->,136.25.188.198,0,0,1,64,1,64,1.784171000,0.0000
92.27.27.153,<->,64.214.44.88,1,50,0,0,1,50,1.784079000,0.0000
101.224.184.225,<->,38.103.13.199,1,50,0,0,1,50,1.784036000,0.0000
215.158.239.93,<->,207.236.4.43,1,765,0,0,1,765,1.783975000,0.0000
59.150.47.18,<->,39.10.71.29,0,0,1,64,1,64,1.783842000,0.0000
192.171.13.33,<->,8.252.223.8,0,0,1,96,1,96,1.783002000,0.0000
142.254.47.85,<->,136.25.188.255,0,0,1,561,1,561,1.782937000,0.0000
50.224.76.234,<->,6.208.97.53,1,68,0,0,1,68,1.782895000,0.0000
111.146.238.44,<->,54.58.99.60,1,50,0,0,1,50,1.782726000,0.0000
111.150.207.99,<->,101.65.255.237,0,0,1,56,1,56,1.782724000,0.0000
203.119.35.163,<->,80.38.24.63,0,0,1,50,1,50,1.782701000,0.0000
198.194.175.156,<->,20.82.72.239,0,0,1,60,1,60,1.782608000,0.0000
142.254.239.255,<->,136.25.188.209,0,0,1,56,1,56,1.782585000,0.0000
215.158.239.56,<->,195.49.21.78,1,64,0,0,1,64,1.782462000,0.0000
195.41.29.147,<->,136.25.188.196,0,0,1,56,1,56,1.782409000,0.0000
38.91.97.206,<->,20.167.129.12,0,0,1,64,1,64,1.781863000,0.0000
204.98.230.33,<->,39.26.196.109,0,0,1,94,1,94,1.781723000,0.0000
215.158.140.76,<->,61.35.124.180,1,1050,0,0,1,1050,1.781665000,0.0000
144.88.76.40,<->,53.148.9.226,1,125,0,0,1,125,1.781634000,0.0000
215.158.239.93,<->,106.7.35.117,1,1245,0,0,1,1245,1.781485000,0.0000
215.158.239.96,<->,143.129.7.98,1,56,0,0,1,56,1.781456000,0.0000
199.13.96.222,<->,39.152.255.125,0,0,1,60,1,60,1.781284000,0.0000
159.112.9.198,<->,101.124.238.98,0,0,1,81,1,81,1.781196000,0.0000
144.75.218.242,<->,97.94.119.43,1,77,0,0,1,77,1.780970000,0.0000
109.14.213.84,<->,80.56.78.128,0,0,1,196,1,196,1.780120000,0.0000
136.25.188.212,<->,8.253.128.68,1,106,0,0,1,106,1.779915000,0.0000
221.102.143.189,<->,192.65.248.189,0,0,1,120,1,120,1.779912000,0.0000
137.74.92.135,<->,45.186.235.53,1,65,0,0,1,65,1.779890000,0.0000
197.156.134.234,<->,89.183.104.251,0,0,1,52,1,52,1.779879000,0.0000
195.12.247.211,<->,136.25.188.209,0,0,1,60,1,60,1.779838000,0.0000
247.136.220.98,<->,88.142.1.240,1,149,0,0,1,149,1.779837000,0.0000
215.158.238.105,<->,198.226.166.143,1,1261,0,0,1,1261,1.779760000,0.0000
215.158.239.8,<->,91.237.50.181,1,365,0,0,1,365,1.779724000,0.0000
197.107.99.127,<->,136.25.188.176,0,0,1,56,1,56,1.779273000,0.0000
143.135.35.209,<->,136.25.188.53,0,0,1,56,1,56,1.779037000,0.0000
207.191.238.81,<->,136.25.188.174,0,0,1,64,1,64,1.779010000,0.0000
137.21.23.51,<->,111.151.107.247,1,225,0,0,1,225,1.778825000,0.0000
132.103.198.240,<->,119.121.24.104,1,64,0,0,1,64,1.778593000,0.0000
93.146.42.91,<->,39.198.190.44,0,0,1,64,1,64,1.778437000,0.0000
159.57.86.227,<->,144.75.218.233,0,0,1,200,1,200,1.778373000,0.0000
192.229.216.117,<->,121.252.120.61,1,476,0,0,1,476,1.778233000,0.0000
59.40.238.161,<->,6.74.97.62,0,0,1,130,1,130,1.778172000,0.0000
38.188.151.225,<->,20.151.101.68,0,0,1,103,1,103,1.778171000,0.0000
246.254.97.109,<->,210.209.251.214,1,50,0,0,1,50,1.777815000,0.0000
80.41.16.104,<->,4.123.53.96,1,130,0,0,1,130,1.777656000,0.0000
215.158.239.96,<->,195.54.72.8,1,56,0,0,1,56,1.777617000,0.0000
128.101.7.1,<->,20.225.148.178,0,0,1,52,1,52,1.777121000,0.0000
144.75.218.242,<->,97.94.148.45,1,84,0,0,1,84,1.777000000,0.0000
158.54.61.103,<->,138.98.230.77,0,0,1,96,1,96,1.776922000,0.0000
92.27.219.153,<->,78.53.141.21,1,50,0,0,1,50,1.776915000,0.0000
199.70.231.253,<->,50.224.76.234,0,0,1,56,1,56,1.776450000,0.0000
192.67.129.19,<->,136.177.116.176,1,50,0,0,1,50,1.776444000,0.0000
215.158.238.94,<->,131.144.115.218,1,56,0,0,1,56,1.776431000,0.0000
92.27.27.153,<->,4.111.11.130,1,52,0,0,1,52,1.776294000,0.0000
205.122.78.194,<->,92.27.219.211,0,0,1,56,1,56,1.776289000,0.0000
132.44.248.125,<->,50.224.76.230,0,0,1,50,1,50,1.775980000,0.0000
21.15.226.126,<->,20.193.20.39,0,0,1,82,1,82,1.775709000,0.0000
53.187.231.137,<->,39.15.169.14,0,0,1,87,1,87,1.775692000,0.0000
159.112.9.198,<->,101.124.239.79,0,0,1,50,1,50,1.775686000,0.0000
215.158.239.6,<->,8.222.97.9,1,1287,0,0,1,1287,1.775598000,0.0000
134.92.121.239,<->,92.27.219.19,0,0,1,115,1,115,1.775565000,0.0000
93.146.42.91,<->,39.198.190.118,0,0,1,64,1,64,1.775558000,0.0000
241.193.172.231,<->,20.157.46.72,0,0,1,50,1,50,1.775083000,0.0000
215.158.239.48,<->,142.236.234.16,1,309,0,0,1,309,1.775037000,0.0000
144.69.82.139,<->,33.144.162.100,1,72,0,0,1,72,1.774980000,0.0000
93.146.42.91,<->,39.198.190.126,0,0,1,64,1,64,1.774919000,0.0000
136.25.188.26,<->,111.151.109.41,1,56,0,0,1,56,1.774614000,0.0000
20.13.110.250,<->,0.200.50.50,1,60,0,0,1,60,1.774456000,0.0000
195.80.56.77,<->,20.57.96.153,0,0,1,60,1,60,1.774036000,0.0000
199.111.23.145,<->,20.7.109.134,0,0,1,95,1,95,1.774008000,0.0000
114.180.98.126,<->,89.183.104.231,0,0,1,52,1,52,1.773895000,0.0000
20.13.110.249,<->,0.200.50.50,1,60,0,0,1,60,1.773841000,0.0000
38.21.156.204,<->,20.232.230.158,0,0,1,82,1,82,1.773787000,0.0000
195.4.221.11,<->,136.25.188.54,0,0,1,50,1,50,1.773676000,0.0000
133.178.226.247,<->,96.155.60.168,1,637,0,0,1,637,1.773395000,0.0000
195.69.164.67,<->,136.25.188.241,0,0,1,56,1,56,1.773194000,0.0000
221.102.143.189,<->,80.41.100.42,0,0,1,141,1,141,1.773139000,0.0000
207.177.94.183,<->,109.222.246.96,0,0,1,52,1,52,1.772934000,0.0000
97.168.65.233,<->,53.144.197.253,1,56,0,0,1,56,1.772932000,0.0000
196.247.156.146,<->,136.25.188.255,0,0,1,378,1,378,1.772812000,0.0000
215.158.239.50,<->,199.20.28.48,1,64,0,0,1,64,1.772570000,0.0000
21.15.226.126,<->,20.193.20.71,0,0,1,82,1,82,1.772482000,0.0000
133.178.227.39,<->,133.56.180.43,1,506,0,0,1,506,1.772457000,0.0000
244.50.129.64,<->,20.163.21.3,0,0,1,50,1,50,1.772427000,0.0000
89.183.104.138,<->,32.214.170.72,1,52,0,0,1,52,1.772209000,0.0000
144.75.218.246,<->,33.238.66.4,1,489,0,0,1,489,1.771926000,0.0000
241.193.172.231,<->,20.228.246.148,0,0,1,50,1,50,1.771900000,0.0000
221.102.143.189,<->,220.83.81.58,0,0,1,120,1,120,1.771824000,0.0000
144.75.218.235,<->,138.127.231.71,1,252,0,0,1,252,1.771717000,0.0000
134.198.133.114,<->,20.207.97.123,0,0,1,64,1,64,1.771620000,0.0000
132.18.67.27,<->,111.181.101.116,0,0,1,50,1,50,1.771608000,0.0000
92.27.8.186,<->,57.170.97.96,1,79,0,0,1,79,1.771366000,0.0000
142.252.231.16,<->,136.25.188.177,0,0,1,50,1,50,1.771321000,0.0000
249.101.209.59,<->,119.131.53.203,1,52,0,0,1,52,1.770930000,0.0000
195.214.82.202,<->,111.181.96.243,0,0,1,321,1,321,1.770869000,0.0000
88.3.63.208,<->,39.34.121.117,0,0,1,64,1,64,1.770825000,0.0000
215.158.103.219,<->,114.93.159.36,1,77,0,0,1,77,1.770464000,0.0000
215.158.239.58,<->,199.20.30.191,1,68,0,0,1,68,1.770320000,0.0000
146.173.129.74,<->,133.178.226.18,0,0,1,1277,1,1277,1.770045000,0.0000
105.124.93.182,<->,92.27.219.60,0,0,1,135,1,135,1.769864000,0.0000
149.170.49.224,<->,89.183.104.249,0,0,1,56,1,56,1.769516000,0.0000
202.33.98.156,<->,136.25.188.225,0,0,1,68,1,68,1.769394000,0.0000
145.16.3.71,<->,114.82.238.234,1,225,0,0,1,225,1.769304000,0.0000
21.15.226.126,<->,20.193.20.44,0,0,1,82,1,82,1.769172000,0.0000
111.150.207.129,<->,8.252.221.181,0,0,1,56,1,56,1.768904000,0.0000
100.31.173.10,<->,80.42.135.244,0,0,1,77,1,77,1.768733000,0.0000
80.38.14.1,<->,17.60.158.28,1,80,0,0,1,80,1.768552000,0.0000
97.126.113.29,<->,53.209.187.97,1,1358,0,0,1,1358,1.768426000,0.0000
142.252.231.16,<->,136.25.188.252,0,0,1,50,1,50,1.768094000,0.0000
50.187.106.118,<->,48.54.240.26,0,0,1,52,1,52,1.767989000,0.0000
215.158.238.95,<->,197.103.151.85,1,1261,0,0,1,1261,1.767949000,0.0000
215.158.239.93,<->,207.191.10.5,1,64,0,0,1,64,1.767696000,0.0000
215.158.239.35,<->,80.47.111.144,1,1294,0,0,1,1294,1.767683000,0.0000
219.248.25.201,<->,80.38.13.144,0,0,1,56,1,56,1.767409000,0.0000
213.38.208.47,<->,132.18.67.28,1,56,0,0,1,56,1.767400000,0.0000
221.102.143.189,<->,80.41.94.184,0,0,1,141,1,141,1.767327000,0.0000
218.5.150.95,<->,144.75.218.241,0,0,1,139,1,139,1.767212000,0.0000
192.67.142.176,<->,126.196.234.152,1,133,0,0,1,133,1.767199000,0.0000
215.158.61.243,<->,8.176.8.203,0,0,1,56,1,56,1.767109000,0.0000
233.145.98.134,<->,56.121.53.35,0,0,1,564,1,564,1.766470000,0.0000
207.20.188.102,<->,39.221.27.219,0,0,1,98,1,98,1.766431000,0.0000
127.67.30.87,<->,39.24.93.156,0,0,1,64,1,64,1.766290000,0.0000
231.143.10.237,<->,136.25.188.209,0,0,1,701,1,701,1.766079000,0.0000
143.79.87.103,<->,136.25.188.242,0,0,1,56,1,56,1.766016000,0.0000
215.158.239.95,<->,199.53.110.186,1,801,0,0,1,801,1.765751000,0.0000
215.158.238.190,<->,8.222.58.181,1,1150,0,0,1,1150,1.765662000,0.0000
195.40.162.216,<->,136.25.188.172,0,0,1,765,1,765,1.765543000,0.0000
89.216.124.92,<->,53.201.161.188,1,50,0,0,1,50,1.765501000,0.0000
133.178.227.172,<->,111.151.109.25,1,100,0,0,1,100,1.764857000,0.0000
199.33.84.120,<->,136.25.188.163,0,0,1,68,1,68,1.764706000,0.0000
98.23.111.141,<->,92.27.209.105,0,0,1,50,1,50,1.764147000,0.0000
109.222.200.155,<->,53.189.46.201,1,87,0,0,1,87,1.764027000,0.0000
111.151.107.180,<->,8.176.8.224,0,0,1,100,1,100,1.763844000,0.0000
124.232.32.37,<->,39.48.158.186,0,0,1,64,1,64,1.763821000,0.0000
91.250.143.162,<->,39.139.12.168,0,0,1,50,1,50,1.763725000,0.0000
133.178.226.28,<->,57.41.134.87,1,1213,0,0,1,1213,1.763480000,0.0000
145.79.71.96,<->,8.220.200.124,0,0,1,726,1,726,1.763397000,0.0000
53.167.217.70,<->,48.54.89.178,0,0,1,64,1,64,1.763387000,0.0000
142.166.69.79,<->,136.25.188.242,0,0,1,56,1,56,1.763101000,0.0000
207.63.173.220,<->,136.25.188.243,0,0,1,50,1,50,1.763071000,0.0000
197.113.64.174,<->,136.25.188.243,0,0,1,56,1,56,1.762861000,0.0000
243.12.104.44,<->,136.25.188.105,0,0,1,136,1,136,1.762798000,0.0000
137.116.192.147,<->,92.27.219.228,0,0,1,62,1,62,1.762702000,0.0000
136.25.188.28,<->,111.151.107.247,1,114,0,0,1,114,1.762690000,0.0000
215.158.239.51,<->,199.20.7.197,1,64,0,0,1,64,1.762560000,0.0000
92.27.219.134,<->,38.68.132.30,1,52,0,0,1,52,1.762514000,0.0000
105.235.111.198,<->,80.40.48.131,0,0,1,50,1,50,1.762244000,0.0000
193.46.99.163,<->,192.64.213.70,0,0,1,129,1,129,1.762226000,0.0000
195.69.254.244,<->,136.25.188.173,0,0,1,64,1,64,1.762222000,0.0000
207.58.88.154,<->,136.25.188.253,0,0,1,790,1,790,1.762181000,0.0000
144.64.139.146,<->,57.140.246.54,1,70,0,0,1,70,1.762171000,0.0000
230.102.156.208,<->,129.224.112.252,0,0,1,78,1,78,1.762039000,0.0000
136.25.189.17,<->,89.80.251.9,1,1293,0,0,1,1293,1.762035000,0.0000
142.190.228.202,<->,136.25.188.252,0,0,1,52,1,52,1.762034000,0.0000
109.222.205.21,<->,53.189.46.201,1,75,0,0,1,75,1.761898000,0.0000
194.233.2.158,<->,136.25.188.163,0,0,1,56,1,56,1.761751000,0.0000
198.206.101.9,<->,20.23.176.109,0,0,1,138,1,138,1.761691000,0.0000
115.139.104.118,<->,89.183.104.147,0,0,1,52,1,52,1.761522000,0.0000
142.209.132.200,<->,136.25.188.220,0,0,1,994,1,994,1.761516000,0.0000
148.190.126.20,<->,133.178.227.8,0,0,1,85,1,85,1.761352000,0.0000
121.113.78.132,<->,0.195.210.15,0,0,1,158,1,158,1.760901000,0.0000
215.158.239.97,<->,194.237.111.178,1,56,0,0,1,56,1.760883000,0.0000
144.75.221.218,<->,138.98.246.1,0,0,1,123,1,123,1.760821000,0.0000
203.48.200.107,<->,39.1.58.234,0,0,1,72,1,72,1.760777000,0.0000
243.49.81.44,<->,192.67.144.171,0,0,1,50,1,50,1.760530000,0.0000
109.1.16.58,<->,27.188.163.162,1,446,0,0,1,446,1.760315000,0.0000
101.70.121.237,<->,53.180.231.130,1,76,0,0,1,76,1.760244000,0.0000
144.85.75.55,<->,53.156.60.32,1,66,0,0,1,66,1.759987000,0.0000
243.123.125.57,<->,92.162.253.23,0,0,1,1035,1,1035,1.759982000,0.0000
21.15.226.126,<->,20.193.20.137,0,0,1,82,1,82,1.759977000,0.0000
204.184.113.132,<->,136.25.188.199,0,0,1,56,1,56,1.759863000,0.0000
215.158.239.84,<->,207.16.228.175,1,64,0,0,1,64,1.759856000,0.0000
143.128.131.105,<->,136.25.188.178,0,0,1,669,1,669,1.759797000,0.0000
133.178.226.254,<->,91.57.162.49,1,91,0,0,1,91,1.759485000,0.0000
206.134.132.209,<->,89.183.104.135,0,0,1,347,1,347,1.759478000,0.0000
121.54.65.222,<->,80.41.3.230,0,0,1,135,1,135,1.759462000,0.0000
229.102.222.252,<->,20.197.122.244,0,0,1,60,1,60,1.759455000,0.0000
215.158.3.44,<->,100.94.130.39,0,0,1,56,1,56,1.759429000,0.0000
215.158.239.49,<->,159.23.130.181,1,1277,0,0,1,1277,1.759428000,0.0000
207.162.190.8,<->,8.182.227.35,0,0,1,502,1,502,1.758737000,0.0000
92.27.219.150,<->,48.108.228.77,1,52,0,0,1,52,1.758687000,0.0000
122.173.165.4,<->,100.95.138.197,0,0,1,130,1,130,1.757942000,0.0000
223.179.242.163,<->,109.222.254.165,0,0,1,94,1,94,1.757840000,0.0000
247.136.217.5,<->,127.87.26.186,1,52,0,0,1,52,1.757755000,0.0000
247.136.156.18,<->,33.215.53.77,1,103,0,0,1,103,1.757744000,0.0000
111.147.92.83,<->,104.141.98.172,1,56,0,0,1,56,1.757729000,0.0000
195.71.150.186,<->,136.25.188.243,0,0,1,64,1,64,1.757698000,0.0000
111.20.171.168,<->,101.224.89.161,0,0,1,1197,1,1197,1.757649000,0.0000
198.158.197.83,<->,20.90.50.209,0,0,1,50,1,50,1.757564000,0.0000
104.254.121.83,<->,39.0.117.159,0,0,1,52,1,52,1.757437000,0.0000
124.119.26.152,<->,39.47.255.177,0,0,1,72,1,72,1.757306000,0.0000
231.143.89.139,<->,136.25.188.46,0,0,1,56,1,56,1.757209000,0.0000
133.178.226.245,<->,111.151.107.247,1,134,0,0,1,134,1.757130000,0.0000
112.185.63.12,<->,39.174.251.232,0,0,1,68,1,68,1.756977000,0.0000
109.222.219.165,<->,66.210.2.210,1,79,0,0,1,79,1.756869000,0.0000
69.103.137.210,<->,8.252.221.236,0,0,1,50,1,50,1.756865000,0.0000
129.114.179.191,<->,8.182.226.78,0,0,1,1493,1,1493,1.756757000,0.0000
241.193.172.231,<->,20.193.141.84,0,0,1,50,1,50,1.756711000,0.0000
220.55.190.246,<->,80.40.61.250,0,0,1,149,1,149,1.756608000,0.0000
106.187.124.172,<->,80.40.15.45,0,0,1,52,1,52,1.756598000,0.0000
197.113.64.207,<->,136.25.188.242,0,0,1,56,1,56,1.756335000,0.0000
207.7.232.242,<->,136.25.188.163,0,0,1,64,1,64,1.756316000,0.0000
89.183.104.236,<->,33.73.20.124,1,64,0,0,1,64,1.756198000,0.0000
138.98.148.75,<->,38.255.124.110,1,56,0,0,1,56,1.756166000,0.0000
118.229.89.67,<->,109.222.192.55,0,0,1,52,1,52,1.756070000,0.0000
241.193.172.231,<->,20.44.113.186,0,0,1,50,1,50,1.756039000,0.0000
199.53.207.183,<->,136.25.188.225,0,0,1,50,1,50,1.755788000,0.0000
215.202.174.57,<->,215.158.239.92,0,0,1,1117,1,1117,1.755714000,0.0000
146.250.128.76,<->,129.224.112.252,0,0,1,89,1,89,1.755682000,0.0000
204.58.90.138,<->,136.25.188.46,0,0,1,50,1,50,1.755608000,0.0000
246.254.97.149,<->,37.103.76.210,1,79,0,0,1,79,1.755433000,0.0000
244.50.249.107,<->,20.134.27.246,0,0,1,50,1,50,1.755186000,0.0000
207.59.242.169,<->,136.25.188.209,0,0,1,64,1,64,1.754911000,0.0000
133.178.226.245,<->,8.191.0.37,1,90,0,0,1,90,1.754840000,0.0000
215.158.239.68,<->,199.20.22.61,1,56,0,0,1,56,1.754582000,0.0000
215.158.140.27,<->,131.36.211.148,1,84,0,0,1,84,1.754575000,0.0000
136.25.188.198,<->,73.179.110.94,1,56,0,0,1,56,1.754453000,0.0000
131.187.69.142,<->,92.27.27.147,0,0,1,273,1,273,1.754347000,0.0000
33.211.90.124,<->,20.177.85.11,0,0,1,70,1,70,1.754090000,0.0000
75.62.16.8,<->,39.160.97.236,0,0,1,50,1,50,1.754084000,0.0000
199.15.134.51,<->,136.25.188.209,0,0,1,93,1,93,1.754022000,0.0000
207.188.231.68,<->,136.25.188.209,0,0,1,637,1,637,1.753811000,0.0000
20.220.195.30,<->,18.203.151.238,1,64,0,0,1,64,1.753693000,0.0000
92.27.219.195,<->,82.99.190.137,1,52,0,0,1,52,1.753524000,0.0000
210.229.230.12,<->,158.187.177.85,1,52,0,0,1,52,1.753506000,0.0000
54.38.18.155,<->,48.55.119.121,0,0,1,56,1,56,1.753445000,0.0000
192.64.247.95,<->,103.183.118.103,1,68,0,0,1,68,1.753337000,0.0000
133.178.226.227,<->,113.24.30.218,1,50,0,0,1,50,1.753317000,0.0000
196.233.221.146,<->,8.182.250.109,0,0,1,50,1,50,1.753114000,0.0000
89.183.104.253,<->,59.53.122.87,1,50,0,0,1,50,1.752947000,0.0000
199.55.20.193,<->,8.252.222.62,0,0,1,56,1,56,1.752859000,0.0000
215.158.238.170,<->,111.151.109.20,1,56,0,0,1,56,1.752785000,0.0000
144.75.218.235,<->,109.115.48.64,1,132,0,0,1,132,1.752506000,0.0000
195.213.8.246,<->,99.72.147.6,0,0,1,149,1,149,1.752391000,0.0000
129.224.112.252,<->,127.19.235.252,1,69,0,0,1,69,1.752132000,0.0000
20.13.110.224,<->,0.200.50.50,1,60,0,0,1,60,1.752104000,0.0000
80.40.45.77,<->,33.156.227.141,1,56,0,0,1,56,1.752040000,0.0000
204.76.112.88,<->,39.192.121.15,0,0,1,96,1,96,1.752008000,0.0000
107.96.190.175,<->,50.224.76.248,0,0,1,56,1,56,1.751984000,0.0000
142.253.227.167,<->,136.25.188.225,0,0,1,56,1,56,1.751978000,0.0000
80.42.179.50,<->,78.3.177.2,1,69,0,0,1,69,1.751970000,0.0000
86.198.150.65,<->,0.195.210.24,0,0,1,68,1,68,1.751505000,0.0000
136.25.189.27,<->,96.156.169.224,1,1427,0,0,1,1427,1.751266000,0.0000
198.158.197.83,<->,20.61.69.3,0,0,1,50,1,50,1.751174000,0.0000
92.27.219.248,<->,92.19.180.10,1,353,0,0,1,353,1.751145000,0.0000
195.78.241.6,<->,100.92.54.27,0,0,1,135,1,135,1.751057000,0.0000
118.20.111.92,<->,97.126.26.70,0,0,1,100,1,100,1.750988000,0.0000
124.152.145.65,<->,109.1.55.35,0,0,1,50,1,50,1.750792000,0.0000
101.70.119.145,<->,53.239.129.38,1,490,0,0,1,490,1.750760000,0.0000
220.77.8.58,<->,20.177.253.36,0,0,1,64,1,64,1.750751000,0.0000
133.32.39.1,<->,132.206.203.137,1,50,0,0,1,50,1.750391000,0.0000
215.158.238.73,<->,33.209.217.236,1,1213,0,0,1,1213,1.750349000,0.0000
50.224.76.248,<->,38.87.221.170,1,56,0,0,1,56,1.750209000,0.0000
109.222.250.132,<->,22.47.119.98,1,76,0,0,1,76,1.750049000,0.0000
136.129.109.170,<->,20.6.49.213,0,0,1,94,1,94,1.749881000,0.0000
220.49.48.127,<->,97.126.113.108,0,0,1,56,1,56,1.749631000,0.0000
104.130.114.205,<->,92.27.219.50,0,0,1,52,1,52,1.749603000,0.0000
144.75.218.235,<->,139.252.1.230,1,90,0,0,1,90,1.749461000,0.0000
215.158.239.117,<->,57.210.104.184,1,68,0,0,1,68,1.749458000,0.0000
131.29.50.225,<->,129.224.112.221,0,0,1,59,1,59,1.749412000,0.0000
215.158.239.51,<->,195.80.100.253,1,830,0,0,1,830,1.749357000,0.0000
215.158.140.62,<->,111.150.207.137,1,56,0,0,1,56,1.749175000,0.0000
126.204.219.116,<->,99.72.71.250,0,0,1,130,1,130,1.749164000,0.0000
215.158.239.48,<->,199.20.28.207,1,64,0,0,1,64,1.749004000,0.0000
119.71.120.173,<->,92.27.219.30,0,0,1,52,1,52,1.748891000,0.0000
54.92.55.77,<->,35.41.132.61,0,0,1,118,1,118,1.748659000,0.0000
210.229.230.19,<->,145.174.196.20,1,68,0,0,1,68,1.748641000,0.0000
145.148.156.184,<->,138.98.246.1,0,0,1,118,1,118,1.748583000,0.0000
200.174.205.125,<->,54.58.60.144,1,56,0,0,1,56,1.748397000,0.0000
215.158.238.83,<->,149.250.115.7,1,1373,0,0,1,1373,1.748391000,0.0000
98.232.172.60,<->,29.214.120.107,1,88,0,0,1,88,1.748339000,0.0000
158.74.71.238,<->,20.193.5.88,0,0,1,52,1,52,1.748329000,0.0000
215.158.239.68,<->,207.213.158.151,1,56,0,0,1,56,1.748180000,0.0000
215.158.239.17,<->,6.165.213.142,1,50,0,0,1,50,1.748019000,0.0000
220.202.132.99,<->,8.52.222.23,0,0,1,50,1,50,1.747944000,0.0000
210.229.230.20,<->,112.73.158.103,1,68,0,0,1,68,1.747812000,0.0000
210.220.219.152,<->,139.33.175.85,1,50,0,0,1,50,1.747792000,0.0000
215.158.238.133,<->,131.173.115.4,1,1341,0,0,1,1341,1.747758000,0.0000
92.27.219.166,<->,78.53.233.241,1,56,0,0,1,56,1.747684000,0.0000
204.131.116.206,<->,20.18.9.25,0,0,1,60,1,60,1.747641000,0.0000
20.220.195.25,<->,18.203.151.238,1,64,0,0,1,64,1.747441000,0.0000
97.126.18.88,<->,14.172.128.222,1,80,0,0,1,80,1.747063000,0.0000
93.104.212.227,<->,39.246.79.216,0,0,1,64,1,64,1.746650000,0.0000
98.23.102.124,<->,29.211.214.82,0,0,1,86,1,86,1.746630000,0.0000
100.182.99.11,<->,20.179.124.109,0,0,1,52,1,52,1.746468000,0.0000
215.158.238.79,<->,80.56.83.82,1,56,0,0,1,56,1.746416000,0.0000
133.178.227.57,<->,126.207.73.87,1,1046,0,0,1,1046,1.746397000,0.0000
61.35.57.29,<->,39.20.154.131,0,0,1,94,1,94,1.746373000,0.0000
144.75.218.233,<->,138.127.224.239,1,366,0,0,1,366,1.746340000,0.0000
249.101.98.217,<->,76.75.223.231,1,168,0,0,1,168,1.746210000,0.0000
133.199.186.90,<->,92.162.253.135,0,0,1,507,1,507,1.746208000,0.0000
144.74.25.52,<->,136.25.188.175,0,0,1,68,1,68,1.746154000,0.0000
144.75.218.235,<->,143.204.138.236,1,177,0,0,1,177,1.745794000,0.0000
136.221.119.73,<->,20.21.128.102,0,0,1,64,1,64,1.745784000,0.0000
215.158.239.94,<->,195.80.180.183,1,64,0,0,1,64,1.745357000,0.0000
145.116.223.76,<->,133.178.226.246,0,0,1,573,1,573,1.745305000,0.0000
20.220.195.29,<->,18.203.151.238,1,64,0,0,1,64,1.745132000,0.0000
194.218.160.116,<->,80.40.9.24,0,0,1,56,1,56,1.745012000,0.0000
97.126.123.108,<->,50.145.204.138,1,125,0,0,1,125,1.744925000,0.0000
241.193.172.231,<->,20.54.83.178,0,0,1,50,1,50,1.744872000,0.0000
133.178.226.171,<->,128.156.85.186,1,56,0,0,1,56,1.744792000,0.0000
215.158.239.99,<->,204.1.152.38,1,68,0,0,1,68,1.744657000,0.0000
215.158.239.92,<->,207.167.182.176,1,68,0,0,1,68,1.744553000,0.0000
247.136.171.153,<->,40.219.7.103,1,138,0,0,1,138,1.744517000,0.0000
159.153.54.153,<->,159.69.187.31,0,0,1,69,1,69,1.744429000,0.0000
195.125.11.138,<->,136.25.188.237,0,0,1,64,1,64,1.744262000,0.0000
213.186.59.246,<->,144.85.170.208,0,0,1,56,1,56,1.744249000,0.0000
17.116.40.224,<->,8.220.189.234,0,0,1,50,1,50,1.744180000,0.0000
215.158.140.93,<->,8.53.216.15,1,1211,0,0,1,1211,1.744136000,0.0000
142.206.64.174,<->,136.25.188.227,0,0,1,765,1,765,1.744045000,0.0000
106.226.165.170,<->,20.254.64.48,0,0,1,52,1,52,1.743989000,0.0000
144.75.218.242,<->,97.232.6.180,1,145,0,0,1,145,1.743968000,0.0000
215.158.239.95,<->,196.89.235.166,1,56,0,0,1,56,1.743840000,0.0000
192.64.235.77,<->,53.222.255.226,1,1220,0,0,1,1220,1.743797000,0.0000
144.93.121.10,<->,98.151.29.220,1,50,0,0,1,50,1.743675000,0.0000
100.162.215.216,<->,8.220.176.253,0,0,1,50,1,50,1.743523000,0.0000
199.79.27.188,<->,39.49.28.0,0,0,1,106,1,106,1.743480000,0.0000
142.229.223.211,<->,136.25.188.53,0,0,1,56,1,56,1.743429000,0.0000
144.75.218.233,<->,138.24.14.249,1,93,0,0,1,93,1.743195000,0.0000
53.161.109.240,<->,48.55.107.101,0,0,1,64,1,64,1.743117000,0.0000
204.190.244.6,<->,92.27.194.147,0,0,1,64,1,64,1.742894000,0.0000
194.233.191.193,<->,136.25.188.242,0,0,1,56,1,56,1.742767000,0.0000
206.103.215.196,<->,136.25.188.175,0,0,1,1261,1,1261,1.742681000,0.0000
247.136.216.15,<->,115.181.233.214,1,50,0,0,1,50,1.742322000,0.0000
109.222.245.43,<->,8.235.244.246,1,56,0,0,1,56,1.742246000,0.0000
210.229.230.22,<->,111.94.159.26,1,68,0,0,1,68,1.742199000,0.0000
204.184.183.65,<->,136.25.188.53,0,0,1,56,1,56,1.742074000,0.0000
196.148.4.163,<->,53.243.94.134,1,64,0,0,1,64,1.741976000,0.0000
145.77.134.40,<->,136.25.188.37,0,0,1,268,1,268,1.741729000,0.0000
89.183.104.225,<->,64.214.57.39,1,50,0,0,1,50,1.741308000,0.0000
246.253.145.104,<->,117.44.174.254,1,50,0,0,1,50,1.741209000,0.0000
215.158.239.56,<->,196.132.51.57,1,50,0,0,1,50,1.741151000,0.0000
204.184.171.48,<->,136.25.188.226,0,0,1,50,1,50,1.740980000,0.0000
121.92.159.163,<->,39.45.164.231,0,0,1,88,1,88,1.740667000,0.0000
215.158.238.246,<->,111.151.106.208,1,56,0,0,1,56,1.740624000,0.0000
142.221.186.126,<->,136.25.188.220,0,0,1,56,1,56,1.740460000,0.0000
159.69.187.32,<->,144.108.80.170,1,69,0,0,1,69,1.740425000,0.0000
126.231.235.183,<->,20.135.138.239,0,0,1,52,1,52,1.740396000,0.0000
143.13.48.118,<->,136.25.188.209,0,0,1,64,1,64,1.739841000,0.0000
53.199.219.107,<->,39.15.169.14,0,0,1,88,1,88,1.739821000,0.0000
113.183.175.35,<->,109.222.199.156,0,0,1,138,1,138,1.739714000,0.0000
215.158.238.45,<->,112.235.116.43,1,1117,0,0,1,1117,1.739361000,0.0000
17.23.199.82,<->,8.220.234.61,0,0,1,50,1,50,1.739069000,0.0000
193.21.29.226,<->,99.72.180.56,0,0,1,184,1,184,1.738929000,0.0000
215.158.239.99,<->,194.232.115.95,1,50,0,0,1,50,1.738876000,0.0000
199.79.27.188,<->,39.48.43.157,0,0,1,104,1,104,1.738850000,0.0000
215.158.239.77,<->,199.20.28.164,1,64,0,0,1,64,1.738824000,0.0000
144.75.218.242,<->,138.127.231.102,1,263,0,0,1,263,1.738753000,0.0000
126.225.252.134,<->,20.206.209.244,0,0,1,64,1,64,1.738118000,0.0000
8.176.39.196,<->,6.145.149.214,1,68,0,0,1,68,1.737630000,0.0000
131.214.147.20,<->,20.223.147.81,0,0,1,126,1,126,1.737564000,0.0000
132.18.67.29,<->,100.93.141.231,0,0,1,56,1,56,1.737435000,0.0000
252.98.141.62,<->,132.43.156.56,1,537,0,0,1,537,1.737319000,0.0000
21.15.226.126,<->,20.193.20.186,0,0,1,82,1,82,1.737055000,0.0000
109.14.213.84,<->,80.56.78.92,0,0,1,90,1,90,1.736944000,0.0000
143.76.165.102,<->,8.182.241.177,0,0,1,50,1,50,1.736875000,0.0000
50.224.76.234,<->,18.201.121.175,1,50,0,0,1,50,1.736687000,0.0000
119.184.145.46,<->,89.183.104.255,0,0,1,273,1,273,1.736600000,0.0000
136.25.188.212,<->,131.31.145.149,1,135,0,0,1,135,1.736443000,0.0000
197.113.99.57,<->,136.25.188.225,0,0,1,765,1,765,1.736443000,0.0000
39.159.14.78,<->,33.200.33.116,1,64,0,0,1,64,1.736381000,0.0000
102.30.117.134,<->,92.27.27.146,0,0,1,544,1,544,1.736361000,0.0000
109.51.28.107,<->,8.182.251.151,0,0,1,50,1,50,1.736360000,0.0000
215.158.239.49,<->,195.43.74.178,1,68,0,0,1,68,1.736064000,0.0000
204.186.35.94,<->,136.25.188.236,0,0,1,64,1,64,1.735811000,0.0000
221.196.122.241,<->,136.25.188.163,0,0,1,50,1,50,1.735803000,0.0000
249.101.197.94,<->,193.46.99.163,1,300,0,0,1,300,1.735737000,0.0000
194.255.249.151,<->,144.71.41.191,0,0,1,50,1,50,1.735497000,0.0000
215.158.239.95,<->,195.55.142.231,1,765,0,0,1,765,1.735441000,0.0000
199.60.1.134,<->,80.41.44.187,0,0,1,56,1,56,1.735332000,0.0000
159.69.187.8,<->,144.108.80.170,1,68,0,0,1,68,1.735308000,0.0000
204.21.109.188,<->,136.25.188.53,0,0,1,64,1,64,1.735158000,0.0000
89.181.78.109,<->,69.169.140.254,1,133,0,0,1,133,1.735136000,0.0000
192.64.251.170,<->,112.55.69.6,1,130,0,0,1,130,1.735047000,0.0000
215.158.239.94,<->,199.122.102.32,1,64,0,0,1,64,1.735033000,0.0000
111.150.207.200,<->,8.252.221.167,0,0,1,56,1,56,1.734860000,0.0000
136.25.189.6,<->,89.86.110.252,1,83,0,0,1,83,1.734807000,0.0000
133.178.226.28,<->,104.3.169.47,1,1181,0,0,1,1181,1.734663000,0.0000
215.158.239.235,<->,97.1.150.245,1,119,0,0,1,119,1.734570000,0.0000
144.75.218.237,<->,138.127.230.226,1,241,0,0,1,241,1.734479000,0.0000
159.240.189.204,<->,159.69.187.46,0,0,1,65,1,65,1.734402000,0.0000
88.3.63.208,<->,39.34.121.232,0,0,1,64,1,64,1.734287000,0.0000
215.158.239.5,<->,115.152.34.37,1,703,0,0,1,703,1.734156000,0.0000
195.64.149.15,<->,20.61.129.254,0,0,1,64,1,64,1.733993000,0.0000
215.158.2.49,<->,8.176.8.237,0,0,1,139,1,139,1.733864000,0.0000
215.158.239.70,<->,199.20.7.10,1,64,0,0,1,64,1.733858000,0.0000
215.158.239.77,<->,196.108.109.249,1,56,0,0,1,56,1.733609000,0.0000
127.52.50.127,<->,20.215.179.208,0,0,1,74,1,74,1.733528000,0.0000
215.158.239.57,<->,199.20.6.91,1,64,0,0,1,64,1.733398000,0.0000
21.15.226.126,<->,20.193.21.200,0,0,1,82,1,82,1.733192000,0.0000
21.15.226.126,<->,20.193.21.207,0,0,1,82,1,82,1.732750000,0.0000
215.158.99.21,<->,29.211.214.254,0,0,1,96,1,96,1.732554000,0.0000
252.92.46.198,<->,8.20.87.206,0,0,1,50,1,50,1.732437000,0.0000
205.14.35.32,<->,80.42.153.35,0,0,1,130,1,130,1.732428000,0.0000
101.70.119.12,<->,48.40.197.2,1,70,0,0,1,70,1.732393000,0.0000
215.158.239.229,<->,111.150.207.86,1,56,0,0,1,56,1.732293000,0.0000
89.183.104.164,<->,29.239.126.131,1,52,0,0,1,52,1.732139000,0.0000
60.81.244.204,<->,0.195.210.44,0,0,1,64,1,64,1.732036000,0.0000
215.158.238.162,<->,136.158.73.48,1,56,0,0,1,56,1.731941000,0.0000
220.55.110.92,<->,8.47.188.160,1,95,0,0,1,95,1.731868000,0.0000
215.158.239.97,<->,199.20.29.182,1,190,0,0,1,190,1.731735000,0.0000
17.112.214.44,<->,8.220.190.86,0,0,1,68,1,68,1.731219000,0.0000
155.133.82.169,<->,20.141.54.228,0,0,1,52,1,52,1.731067000,0.0000
230.126.6.104,<->,39.227.65.70,0,0,1,52,1,52,1.731049000,0.0000
133.54.30.222,<->,38.91.28.96,1,56,0,0,1,56,1.730838000,0.0000
215.158.238.66,<->,205.122.195.42,1,1037,0,0,1,1037,1.730807000,0.0000
139.44.226.212,<->,100.230.5.11,1,50,0,0,1,50,1.730661000,0.0000
247.136.209.27,<->,235.226.212.248,1,485,0,0,1,485,1.730569000,0.0000
195.89.50.183,<->,8.252.222.62,0,0,1,50,1,50,1.730525000,0.0000
215.158.140.229,<->,143.173.13.199,1,1046,0,0,1,1046,1.730339000,0.0000
195.55.84.115,<->,136.25.188.238,0,0,1,56,1,56,1.729999000,0.0000
215.158.239.48,<->,207.58.1.70,1,56,0,0,1,56,1.729997000,0.0000
158.236.129.2,<->,39.11.131.163,0,0,1,74,1,74,1.729749000,0.0000
136.25.188.44,<->,57.199.250.198,1,1357,0,0,1,1357,1.729675000,0.0000
225.120.222.187,<->,215.158.238.99,0,0,1,1229,1,1229,1.729629000,0.0000
82.98.73.98,<->,39.135.80.214,0,0,1,52,1,52,1.728999000,0.0000
244.50.136.175,<->,20.107.190.17,0,0,1,50,1,50,1.728985000,0.0000
136.18.96.45,<->,8.182.244.177,0,0,1,56,1,56,1.728933000,0.0000
144.85.170.254,<->,98.87.146.48,1,64,0,0,1,64,1.728866000,0.0000
144.64.137.156,<->,141.95.30.10,1,89,0,0,1,89,1.728779000,0.0000
196.247.91.118,<->,136.25.188.220,0,0,1,68,1,68,1.728681000,0.0000
122.147.77.52,<->,20.134.242.239,0,0,1,64,1,64,1.728613000,0.0000
207.236.167.164,<->,136.25.188.225,0,0,1,56,1,56,1.728116000,0.0000
122.222.192.163,<->,39.52.51.84,0,0,1,60,1,60,1.728079000,0.0000
143.12.34.14,<->,136.25.188.253,0,0,1,50,1,50,1.727765000,0.0000
215.158.239.58,<->,195.40.43.9,1,765,0,0,1,765,1.727607000,0.0000
215.158.140.168,<->,113.207.62.186,1,464,0,0,1,464,1.727565000,0.0000
243.117.82.3,<->,220.55.124.65,0,0,1,50,1,50,1.727173000,0.0000
109.1.44.191,<->,100.224.242.153,1,56,0,0,1,56,1.727142000,0.0000
159.69.187.25,<->,144.108.80.164,1,74,0,0,1,74,1.727051000,0.0000
136.99.15.85,<->,78.47.35.1,1,56,0,0,1,56,1.726856000,0.0000
215.158.239.58,<->,199.20.28.245,1,907,0,0,1,907,1.726679000,0.0000
248.225.26.61,<->,53.190.60.6,1,96,0,0,1,96,1.726532000,0.0000
215.158.239.56,<->,196.110.34.218,1,64,0,0,1,64,1.726421000,0.0000
104.239.96.160,<->,50.224.76.234,0,0,1,56,1,56,1.726249000,0.0000
139.193.141.139,<->,104.190.170.77,1,50,0,0,1,50,1.726226000,0.0000
144.75.218.242,<->,33.229.58.179,1,128,0,0,1,128,1.726050000,0.0000
196.89.116.33,<->,20.104.0.55,0,0,1,56,1,56,1.725939000,0.0000
255.133.229.164,<->,22.59.31.115,0,0,1,100,1,100,1.725624000,0.0000
137.123.164.186,<->,92.27.27.181,0,0,1,56,1,56,1.725313000,0.0000
77.43.208.251,<->,8.238.100.28,0,0,1,133,1,133,1.725288000,0.0000
21.15.226.126,<->,20.193.21.222,0,0,1,82,1,82,1.725281000,0.0000
215.158.238.92,<->,116.106.60.148,1,1277,0,0,1,1277,1.725053000,0.0000
215.158.239.85,<->,207.228.96.195,1,64,0,0,1,64,1.724916000,0.0000
114.186.201.118,<->,20.227.141.13,0,0,1,52,1,52,1.724880000,0.0000
144.75.218.242,<->,98.192.190.17,1,233,0,0,1,233,1.724540000,0.0000
92.27.219.240,<->,40.208.251.226,1,52,0,0,1,52,1.724497000,0.0000
21.15.226.126,<->,20.193.21.218,0,0,1,82,1,82,1.724168000,0.0000
204.128.217.52,<->,39.52.63.66,0,0,1,74,1,74,1.724156000,0.0000
241.193.172.231,<->,20.242.124.141,0,0,1,50,1,50,1.723728000,0.0000
215.158.239.48,<->,196.92.220.44,1,56,0,0,1,56,1.723680000,0.0000
192.64.217.166,<->,117.79.29.177,1,52,0,0,1,52,1.723548000,0.0000
145.177.18.14,<->,20.225.97.201,0,0,1,97,1,97,1.723544000,0.0000
197.113.64.179,<->,136.25.188.54,0,0,1,64,1,64,1.723386000,0.0000
207.61.73.229,<->,136.25.188.243,0,0,1,64,1,64,1.723239000,0.0000
136.25.189.15,<->,68.124.221.187,1,1245,0,0,1,1245,1.723233000,0.0000
121.252.25.54,<->,56.121.58.220,0,0,1,385,1,385,1.723213000,0.0000
192.178.155.130,<->,145.242.126.41,0,0,1,80,1,80,1.723109000,0.0000
143.170.100.10,<->,8.53.14.227,0,0,1,84,1,84,1.723083000,0.0000
220.20.200.36,<->,99.164.76.232,1,50,0,0,1,50,1.723003000,0.0000
215.158.238.205,<->,8.223.246.237,1,1002,0,0,1,1002,1.722977000,0.0000
113.65.136.161,<->,39.51.246.8,0,0,1,72,1,72,1.722966000,0.0000
99.164.76.232,<->,92.162.252.195,0,0,1,50,1,50,1.722846000,0.0000
215.158.239.87,<->,199.20.31.241,1,64,0,0,1,64,1.722843000,0.0000
255.133.229.164,<->,39.202.171.223,0,0,1,100,1,100,1.722818000,0.0000
121.210.101.87,<->,20.128.113.78,0,0,1,64,1,64,1.722812000,0.0000
97.126.19.12,<->,87.58.45.107,1,77,0,0,1,77,1.722308000,0.0000
215.158.140.216,<->,192.171.13.190,1,297,0,0,1,297,1.721929000,0.0000
80.56.91.244,<->,8.252.223.158,0,0,1,1112,1,1112,1.721727000,0.0000
215.158.239.92,<->,207.166.61.216,1,68,0,0,1,68,1.721580000,0.0000
195.124.76.210,<->,136.25.188.175,0,0,1,68,1,68,1.721465000,0.0000
142.255.168.235,<->,97.68.226.205,0,0,1,68,1,68,1.721369000,0.0000
215.158.239.99,<->,207.188.231.68,1,635,0,0,1,635,1.721276000,0.0000
220.20.200.37,<->,99.164.76.232,1,50,0,0,1,50,1.721274000,0.0000
124.232.32.37,<->,39.48.158.189,0,0,1,64,1,64,1.721249000,0.0000
204.185.64.99,<->,136.25.188.222,0,0,1,50,1,50,1.720940000,0.0000
144.75.218.237,<->,140.2.100.1,1,111,0,0,1,111,1.720682000,0.0000
121.20.123.137,<->,100.95.174.75,0,0,1,56,1,56,1.720376000,0.0000
192.229.216.117,<->,6.134.176.36,1,50,0,0,1,50,1.720098000,0.0000
92.181.148.15,<->,66.208.116.91,1,273,0,0,1,273,1.720083000,0.0000
202.33.230.12,<->,136.25.188.179,0,0,1,50,1,50,1.719960000,0.0000
215.158.239.97,<->,199.20.30.127,1,68,0,0,1,68,1.719868000,0.0000
133.178.227.24,<->,48.131.159.95,1,1085,0,0,1,1085,1.719778000,0.0000
215.158.239.50,<->,207.115.144.72,1,50,0,0,1,50,1.719376000,0.0000
215.158.106.41,<->,136.25.189.137,0,0,1,1004,1,1004,1.719138000,0.0000
133.85.3.240,<->,92.27.219.239,0,0,1,245,1,245,1.719117000,0.0000
29.211.110.56,<->,8.220.176.226,0,0,1,704,1,704,1.719081000,0.0000
132.249.70.233,<->,127.106.198.124,1,82,0,0,1,82,1.719002000,0.0000
249.101.99.176,<->,111.20.62.72,1,50,0,0,1,50,1.718821000,0.0000
106.170.107.166,<->,80.40.34.206,0,0,1,130,1,130,1.718773000,0.0000
215.158.238.97,<->,76.100.108.255,1,1357,0,0,1,1357,1.718765000,0.0000
215.158.239.78,<->,196.90.53.82,1,50,0,0,1,50,1.718762000,0.0000
215.158.239.96,<->,143.44.228.56,1,56,0,0,1,56,1.718427000,0.0000
111.150.207.80,<->,8.252.222.107,0,0,1,56,1,56,1.718421000,0.0000
119.126.206.28,<->,20.32.196.149,0,0,1,64,1,64,1.718405000,0.0000
102.45.238.207,<->,101.126.182.182,0,0,1,56,1,56,1.717956000,0.0000
195.40.46.190,<->,136.25.188.52,0,0,1,669,1,669,1.717653000,0.0000
136.25.188.160,<->,104.154.137.249,1,1325,0,0,1,1325,1.717618000,0.0000
141.108.105.215,<->,20.18.119.54,0,0,1,50,1,50,1.717533000,0.0000
215.158.239.95,<->,199.20.30.180,1,64,0,0,1,64,1.717493000,0.0000
121.40.40.193,<->,92.27.219.41,0,0,1,56,1,56,1.717346000,0.0000
192.204.170.196,<->,136.25.188.176,0,0,1,1079,1,1079,1.716949000,0.0000
202.33.230.104,<->,136.25.188.252,0,0,1,56,1,56,1.716617000,0.0000
115.32.78.106,<->,97.168.67.159,0,0,1,73,1,73,1.716609000,0.0000
127.212.85.77,<->,92.27.27.143,0,0,1,52,1,52,1.716582000,0.0000
133.178.226.72,<->,133.56.180.93,1,506,0,0,1,506,1.716513000,0.0000
149.172.30.236,<->,144.75.218.242,0,0,1,134,1,134,1.716371000,0.0000
54.59.63.210,<->,48.53.165.47,0,0,1,50,1,50,1.716191000,0.0000
79.252.112.249,<->,34.37.77.138,0,0,1,64,1,64,1.716143000,0.0000
215.158.238.190,<->,8.40.51.183,1,1042,0,0,1,1042,1.715994000,0.0000
144.75.218.242,<->,138.127.224.222,1,365,0,0,1,365,1.715725000,0.0000
143.128.215.217,<->,20.204.85.16,0,0,1,76,1,76,1.715620000,0.0000
215.158.239.78,<->,196.109.243.189,1,64,0,0,1,64,1.715556000,0.0000
124.69.188.3,<->,92.27.27.165,0,0,1,79,1,79,1.715540000,0.0000
248.239.187.198,<->,116.38.118.146,1,60,0,0,1,60,1.715508000,0.0000
210.220.219.153,<->,138.127.225.156,1,288,0,0,1,288,1.715422000,0.0000
92.27.219.36,<->,66.1.48.254,1,68,0,0,1,68,1.715413000,0.0000
247.136.180.232,<->,65.58.158.114,1,135,0,0,1,135,1.715406000,0.0000
112.208.20.167,<->,97.190.192.217,0,0,1,178,1,178,1.715305000,0.0000
139.163.86.251,<->,38.98.206.254,1,50,0,0,1,50,1.715239000,0.0000
53.213.63.210,<->,48.53.159.235,0,0,1,93,1,93,1.715177000,0.0000
215.158.239.56,<->,195.80.104.234,1,64,0,0,1,64,1.714935000,0.0000
215.158.239.84,<->,195.80.40.202,1,50,0,0,1,50,1.714807000,0.0000
215.158.239.56,<->,199.20.29.185,1,609,0,0,1,609,1.714803000,0.0000
158.147.252.44,<->,145.252.120.138,0,0,1,60,1,60,1.714784000,0.0000
246.253.252.17,<->,111.2.139.12,1,132,0,0,1,132,1.714506000,0.0000
75.148.253.44,<->,39.21.163.43,0,0,1,52,1,52,1.714467000,0.0000
109.113.93.29,<->,8.182.244.179,0,0,1,50,1,50,1.714365000,0.0000
114.243.20.92,<->,39.30.46.223,0,0,1,88,1,88,1.714246000,0.0000
144.83.60.153,<->,92.162.253.139,0,0,1,471,1,471,1.714181000,0.0000
80.41.34.78,<->,38.169.174.244,1,72,0,0,1,72,1.713897000,0.0000
133.54.43.82,<->,112.30.36.128,1,206,0,0,1,206,1.713896000,0.0000
93.92.135.178,<->,80.42.140.207,0,0,1,52,1,52,1.713888000,0.0000
75.139.231.146,<->,39.233.251.76,0,0,1,62,1,62,1.713477000,0.0000
132.107.83.63,<->,89.183.104.189,0,0,1,52,1,52,1.713292000,0.0000
195.57.66.213,<->,92.27.219.224,0,0,1,52,1,52,1.713263000,0.0000
92.27.219.36,<->,33.156.10.96,1,351,0,0,1,351,1.713252000,0.0000
215.158.140.60,<->,61.35.22.166,1,1108,0,0,1,1108,1.713237000,0.0000
215.158.239.99,<->,196.95.70.90,1,56,0,0,1,56,1.713179000,0.0000
215.158.239.68,<->,204.0.209.27,1,50,0,0,1,50,1.713137000,0.0000
121.20.248.113,<->,99.72.148.194,0,0,1,135,1,135,1.712978000,0.0000
215.158.2.49,<->,8.176.8.188,0,0,1,139,1,139,1.712930000,0.0000
141.249.135.210,<->,92.27.219.224,0,0,1,52,1,52,1.712692000,0.0000
193.46.99.139,<->,192.67.161.171,0,0,1,129,1,129,1.712575000,0.0000
108.134.116.175,<->,105.67.237.226,1,64,0,0,1,64,1.712503000,0.0000
241.193.172.231,<->,20.117.167.53,0,0,1,50,1,50,1.712463000,0.0000
95.104.30.132,<->,39.33.64.254,0,0,1,108,1,108,1.712438000,0.0000
198.158.197.83,<->,20.121.108.29,0,0,1,50,1,50,1.712408000,0.0000
144.75.218.246,<->,138.127.231.246,1,269,0,0,1,269,1.712225000,0.0000
215.158.238.205,<->,8.245.10.23,1,704,0,0,1,704,1.711943000,0.0000
132.103.198.235,<->,119.121.24.104,1,64,0,0,1,64,1.711769000,0.0000
21.15.226.126,<->,20.193.21.148,0,0,1,82,1,82,1.711739000,0.0000
207.11.207.11,<->,39.8.21.74,0,0,1,108,1,108,1.711538000,0.0000
21.15.226.126,<->,20.193.21.151,0,0,1,82,1,82,1.711181000,0.0000
206.165.196.61,<->,92.27.27.182,0,0,1,52,1,52,1.711020000,0.0000
122.222.192.163,<->,39.52.51.22,0,0,1,60,1,60,1.710740000,0.0000
21.15.226.126,<->,20.193.21.167,0,0,1,82,1,82,1.710517000,0.0000
29.95.158.240,<->,20.199.198.55,0,0,1,64,1,64,1.710467000,0.0000
159.137.142.17,<->,135.207.217.74,1,78,0,0,1,78,1.710006000,0.0000
215.158.238.198,<->,113.23.14.192,1,1389,0,0,1,1389,1.709870000,0.0000
197.32.92.22,<->,39.33.90.159,0,0,1,52,1,52,1.709797000,0.0000
145.16.53.98,<->,42.68.246.99,1,50,0,0,1,50,1.709732000,0.0000
223.139.104.157,<->,39.154.108.219,0,0,1,64,1,64,1.709336000,0.0000
196.113.186.195,<->,39.246.85.189,0,0,1,64,1,64,1.709247000,0.0000
53.251.63.173,<->,39.15.169.14,0,0,1,87,1,87,1.709110000,0.0000
21.15.226.126,<->,20.193.21.144,0,0,1,82,1,82,1.709089000,0.0000
124.158.228.91,<->,20.122.102.244,0,0,1,60,1,60,1.709072000,0.0000
241.193.172.231,<->,20.212.63.20,0,0,1,50,1,50,1.708960000,0.0000
215.158.238.64,<->,113.23.21.212,1,1197,0,0,1,1197,1.708782000,0.0000
100.182.99.11,<->,20.179.122.130,0,0,1,52,1,52,1.708759000,0.0000
200.177.71.212,<->,97.126.4.233,0,0,1,97,1,97,1.708758000,0.0000
249.101.218.38,<->,40.154.48.215,1,340,0,0,1,340,1.708685000,0.0000
129.225.132.224,<->,129.225.131.140,1,630,0,0,1,630,1.708667000,0.0000
98.23.96.92,<->,92.27.219.48,0,0,1,56,1,56,1.708592000,0.0000
247.136.229.50,<->,144.46.53.180,1,99,0,0,1,99,1.708532000,0.0000
215.158.239.99,<->,199.20.31.21,1,64,0,0,1,64,1.708293000,0.0000
142.248.247.80,<->,136.25.188.209,0,0,1,50,1,50,1.708270000,0.0000
200.175.116.3,<->,54.38.193.155,1,64,0,0,1,64,1.708044000,0.0000
195.78.209.21,<->,99.75.149.84,0,0,1,66,1,66,1.707342000,0.0000
195.69.43.52,<->,20.123.2.65,0,0,1,74,1,74,1.707061000,0.0000
215.158.239.56,<->,207.236.218.252,1,56,0,0,1,56,1.706975000,0.0000
136.25.188.105,<->,135.228.158.61,1,268,0,0,1,268,1.706875000,0.0000
215.158.239.97,<->,196.109.14.153,1,777,0,0,1,777,1.706781000,0.0000
138.98.233.218,<->,98.8.90.134,1,60,0,0,1,60,1.706581000,0.0000
215.158.103.219,<->,138.127.224.38,1,355,0,0,1,355,1.706557000,0.0000
113.65.136.161,<->,39.51.246.18,0,0,1,72,1,72,1.706474000,0.0000
249.101.120.43,<->,53.148.24.110,1,125,0,0,1,125,1.706419000,0.0000
215.158.239.97,<->,199.20.30.134,1,64,0,0,1,64,1.706236000,0.0000
192.67.152.234,<->,38.85.241.241,1,52,0,0,1,52,1.706087000,0.0000
159.69.187.18,<->,144.108.80.170,1,66,0,0,1,66,1.705981000,0.0000
124.123.208.85,<->,39.135.223.159,0,0,1,94,1,94,1.705578000,0.0000
124.30.39.58,<->,92.27.219.42,0,0,1,116,1,116,1.705196000,0.0000
204.200.34.79,<->,8.252.222.205,0,0,1,50,1,50,1.705186000,0.0000
116.226.161.204,<->,20.129.44.50,0,0,1,68,1,68,1.705074000,0.0000
215.158.239.86,<->,196.93.124.105,1,64,0,0,1,64,1.705055000,0.0000
195.69.166.65,<->,136.25.188.176,0,0,1,64,1,64,1.704982000,0.0000
136.25.189.52,<->,131.173.115.1,1,704,0,0,1,704,1.704862000,0.0000
215.158.238.92,<->,128.194.247.212,1,1229,0,0,1,1229,1.704739000,0.0000
106.216.124.242,<->,20.80.232.32,0,0,1,60,1,60,1.704530000,0.0000
129.224.112.252,<->,114.145.64.123,1,83,0,0,1,83,1.704519000,0.0000
144.75.218.235,<->,138.127.230.84,1,366,0,0,1,366,1.704485000,0.0000
196.63.105.214,<->,92.27.194.147,0,0,1,64,1,64,1.704466000,0.0000
199.13.212.3,<->,39.153.33.20,0,0,1,94,1,94,1.704418000,0.0000
197.113.64.166,<->,136.25.188.198,0,0,1,781,1,781,1.704315000,0.0000
204.184.41.206,<->,136.25.188.255,0,0,1,56,1,56,1.704048000,0.0000
39.203.5.164,<->,0.48.111.58,1,50,0,0,1,50,1.703998000,0.0000
246.254.97.149,<->,8.240.125.22,1,93,0,0,1,93,1.703835000,0.0000
215.158.238.83,<->,122.159.68.201,1,1229,0,0,1,1229,1.703063000,0.0000
215.158.239.56,<->,199.15.17.169,1,56,0,0,1,56,1.702756000,0.0000
159.109.245.39,<->,53.149.247.244,1,79,0,0,1,79,1.702428000,0.0000
144.75.218.241,<->,131.65.15.83,1,141,0,0,1,141,1.702332000,0.0000
215.158.239.84,<->,196.1.49.84,1,68,0,0,1,68,1.702183000,0.0000
21.15.226.126,<->,20.193.21.174,0,0,1,82,1,82,1.701998000,0.0000
215.158.239.56,<->,199.20.30.186,1,64,0,0,1,64,1.701911000,0.0000
133.231.56.221,<->,50.224.76.234,0,0,1,50,1,50,1.701833000,0.0000
195.69.29.32,<->,136.25.188.52,0,0,1,56,1,56,1.701705000,0.0000
251.21.173.35,<->,109.222.231.87,0,0,1,129,1,129,1.701655000,0.0000
197.113.99.96,<->,136.25.188.243,0,0,1,709,1,709,1.701272000,0.0000
205.37.52.56,<->,102.50.96.106,0,0,1,351,1,351,1.701197000,0.0000
109.127.156.13,<->,8.52.155.194,0,0,1,934,1,934,1.701052000,0.0000
136.47.66.197,<->,111.146.146.108,0,0,1,80,1,80,1.700959000,0.0000
194.53.234.58,<->,80.40.9.24,0,0,1,56,1,56,1.700749000,0.0000
146.220.125.81,<->,129.224.112.252,0,0,1,90,1,90,1.700702000,0.0000
116.254.173.62,<->,50.224.76.234,0,0,1,50,1,50,1.700580000,0.0000
144.122.240.202,<->,144.108.64.179,1,71,0,0,1,71,1.700314000,0.0000
92.27.219.185,<->,67.240.227.196,1,62,0,0,1,62,1.700173000,0.0000
195.4.112.113,<->,136.25.188.179,0,0,1,85,1,85,1.700068000,0.0000
199.55.134.60,<->,8.182.227.180,0,0,1,56,1,56,1.699987000,0.0000
196.89.116.33,<->,20.104.0.133,0,0,1,56,1,56,1.699926000,0.0000
136.25.188.237,<->,29.213.216.245,1,1341,0,0,1,1341,1.699774000,0.0000
142.255.12.30,<->,136.25.188.44,0,0,1,56,1,56,1.699712000,0.0000
215.158.239.56,<->,204.3.114.18,1,56,0,0,1,56,1.699648000,0.0000
199.69.72.231,<->,136.25.188.243,0,0,1,68,1,68,1.699494000,0.0000
215.158.238.113,<->,141.39.23.100,1,1357,0,0,1,1357,1.699484000,0.0000
197.113.99.56,<->,136.25.188.177,0,0,1,64,1,64,1.699275000,0.0000
133.178.226.37,<->,131.2.115.236,1,1181,0,0,1,1181,1.699273000,0.0000
17.46.87.216,<->,8.220.176.253,0,0,1,50,1,50,1.698837000,0.0000
192.252.224.95,<->,136.181.50.99,0,0,1,293,1,293,1.698522000,0.0000
215.158.239.69,<->,199.106.62.174,1,56,0,0,1,56,1.698358000,0.0000
144.87.238.89,<->,8.252.223.222,0,0,1,297,1,297,1.698322000,0.0000
136.25.188.105,<->,63.73.200.51,1,137,0,0,1,137,1.698072000,0.0000
142.182.45.50,<->,136.25.188.243,0,0,1,50,1,50,1.697951000,0.0000
247.136.161.187,<->,131.78.5.109,1,50,0,0,1,50,1.697857000,0.0000
215.158.239.57,<->,196.108.9.105,1,50,0,0,1,50,1.697585000,0.0000
197.113.64.183,<->,136.25.188.241,0,0,1,64,1,64,1.697576000,0.0000
111.146.236.23,<->,53.245.233.72,1,64,0,0,1,64,1.697403000,0.0000
244.50.252.80,<->,20.243.219.251,0,0,1,50,1,50,1.696818000,0.0000
139.252.1.244,<->,136.25.188.164,0,0,1,184,1,184,1.696757000,0.0000
215.158.239.48,<->,199.20.28.244,1,64,0,0,1,64,1.696570000,0.0000
149.221.157.147,<->,0.195.210.42,0,0,1,85,1,85,1.696434000,0.0000
106.23.130.104,<->,8.52.182.91,0,0,1,50,1,50,1.696326000,0.0000
252.98.137.210,<->,132.18.67.28,1,56,0,0,1,56,1.696211000,0.0000
98.67.131.97,<->,65.44.36.70,1,68,0,0,1,68,1.696028000,0.0000
117.155.169.79,<->,99.75.239.34,0,0,1,100,1,100,1.695792000,0.0000
97.203.37.94,<->,8.183.25.124,0,0,1,56,1,56,1.695348000,0.0000
144.75.218.237,<->,53.149.3.155,1,81,0,0,1,81,1.695269000,0.0000
247.136.152.230,<->,104.50.172.179,1,344,0,0,1,344,1.694925000,0.0000
204.63.140.18,<->,136.25.188.227,0,0,1,64,1,64,1.694772000,0.0000
136.14.200.42,<->,20.111.98.239,0,0,1,60,1,60,1.694430000,0.0000
215.158.239.57,<->,194.202.182.67,1,56,0,0,1,56,1.694360000,0.0000
215.158.239.84,<->,143.135.22.62,1,56,0,0,1,56,1.694311000,0.0000
215.158.238.162,<->,111.151.106.201,1,56,0,0,1,56,1.694242000,0.0000
241.193.172.231,<->,20.60.80.56,0,0,1,50,1,50,1.694209000,0.0000
159.25.30.7,<->,64.253.134.141,1,52,0,0,1,52,1.694110000,0.0000
210.231.140.48,<->,80.40.23.33,0,0,1,50,1,50,1.694103000,0.0000
215.158.239.68,<->,199.20.30.167,1,50,0,0,1,50,1.694041000,0.0000
192.64.238.102,<->,110.4.15.52,1,353,0,0,1,353,1.693813000,0.0000
250.62.101.8,<->,92.27.219.236,0,0,1,52,1,52,1.693804000,0.0000
215.158.238.81,<->,131.144.116.84,1,1229,0,0,1,1229,1.693792000,0.0000
132.123.119.160,<->,8.52.189.200,0,0,1,50,1,50,1.693766000,0.0000
241.193.172.231,<->,20.33.11.113,0,0,1,50,1,50,1.693700000,0.0000
109.2.108.59,<->,8.45.168.98,1,97,0,0,1,97,1.693622000,0.0000
196.113.186.195,<->,20.122.167.156,0,0,1,64,1,64,1.693608000,0.0000
196.89.116.33,<->,20.104.0.56,0,0,1,56,1,56,1.693606000,0.0000
145.170.227.223,<->,8.52.222.23,0,0,1,50,1,50,1.693552000,0.0000
195.6.200.217,<->,136.25.188.199,0,0,1,561,1,561,1.693394000,0.0000
132.43.156.56,<->,89.139.241.98,0,0,1,167,1,167,1.693305000,0.0000
159.69.187.55,<->,144.108.80.170,1,64,0,0,1,64,1.693212000,0.0000
221.102.143.189,<->,98.128.214.64,0,0,1,87,1,87,1.693133000,0.0000
204.187.211.86,<->,136.25.188.160,0,0,1,56,1,56,1.692940000,0.0000
215.158.239.50,<->,196.92.173.187,1,56,0,0,1,56,1.692906000,0.0000
144.75.218.241,<->,116.126.255.82,1,89,0,0,1,89,1.692707000,0.0000
109.1.16.50,<->,27.188.163.162,1,447,0,0,1,447,1.692565000,0.0000
193.82.221.142,<->,20.76.165.128,0,0,1,64,1,64,1.692449000,0.0000
194.233.1.153,<->,136.25.188.209,0,0,1,56,1,56,1.692204000,0.0000
205.107.153.253,<->,80.42.171.176,0,0,1,50,1,50,1.691996000,0.0000
102.51.52.249,<->,93.137.103.10,1,629,0,0,1,629,1.691955000,0.0000
215.158.140.230,<->,100.221.233.115,1,50,0,0,1,50,1.691871000,0.0000
92.27.219.199,<->,57.141.2.1,1,53,0,0,1,53,1.691753000,0.0000
215.158.239.94,<->,204.226.8.29,1,50,0,0,1,50,1.691741000,0.0000
100.94.122.11,<->,98.57.212.246,1,56,0,0,1,56,1.691594000,0.0000
192.64.240.138,<->,113.23.48.174,1,50,0,0,1,50,1.691564000,0.0000
243.49.82.173,<->,192.64.249.52,0,0,1,256,1,256,1.690426000,0.0000
39.56.125.224,<->,0.230.182.210,1,56,0,0,1,56,1.690401000,0.0000
199.24.104.232,<->,20.116.253.231,0,0,1,64,1,64,1.690263000,0.0000
215.158.239.79,<->,199.82.208.6,1,56,0,0,1,56,1.690251000,0.0000
135.81.77.209,<->,92.27.219.216,0,0,1,135,1,135,1.690155000,0.0000
230.80.188.183,<->,80.42.177.161,0,0,1,133,1,133,1.690142000,0.0000
215.158.239.79,<->,199.20.31.25,1,68,0,0,1,68,1.690033000,0.0000
92.27.219.145,<->,35.33.20.54,1,78,0,0,1,78,1.689976000,0.0000
215.158.239.68,<->,199.20.63.99,1,781,0,0,1,781,1.689957000,0.0000
215.158.140.240,<->,192.170.158.219,1,704,0,0,1,704,1.689752000,0.0000
124.158.228.91,<->,20.122.102.228,0,0,1,60,1,60,1.689634000,0.0000
158.55.226.34,<->,89.183.104.134,0,0,1,80,1,80,1.689560000,0.0000
159.28.159.6,<->,129.224.112.252,0,0,1,89,1,89,1.689552000,0.0000
141.21.158.209,<->,20.135.157.252,0,0,1,74,1,74,1.689312000,0.0000
144.75.218.235,<->,138.127.230.78,1,365,0,0,1,365,1.689285000,0.0000
199.20.220.230,<->,136.25.188.105,0,0,1,139,1,139,1.689182000,0.0000
136.25.189.86,<->,89.86.110.252,1,83,0,0,1,83,1.688744000,0.0000
215.158.239.76,<->,199.20.31.29,1,56,0,0,1,56,1.688202000,0.0000
144.122.240.242,<->,101.176.22.220,1,87,0,0,1,87,1.688197000,0.0000
159.31.220.52,<->,48.107.86.169,1,1244,0,0,1,1244,1.688144000,0.0000
247.157.201.195,<->,77.47.138.255,1,133,0,0,1,133,1.688022000,0.0000
131.144.248.251,<->,129.224.112.252,0,0,1,74,1,74,1.687811000,0.0000
104.136.71.239,<->,102.51.73.163,0,0,1,149,1,149,1.687695000,0.0000
138.98.178.182,<->,116.108.172.2,1,50,0,0,1,50,1.687668000,0.0000
111.151.109.51,<->,8.252.222.59,0,0,1,100,1,100,1.687456000,0.0000
241.193.172.231,<->,20.175.104.134,0,0,1,50,1,50,1.687450000,0.0000
53.161.183.44,<->,48.53.183.102,0,0,1,64,1,64,1.687383000,0.0000
199.33.84.120,<->,136.25.188.254,0,0,1,68,1,68,1.686950000,0.0000
200.174.165.247,<->,53.148.90.97,1,93,0,0,1,93,1.686278000,0.0000
144.75.218.237,<->,8.47.123.78,1,132,0,0,1,132,1.686266000,0.0000
133.8.10.152,<->,111.20.168.23,0,0,1,305,1,305,1.686062000,0.0000
142.252.19.139,<->,136.25.188.253,0,0,1,56,1,56,1.685963000,0.0000
20.13.110.223,<->,0.200.50.50,1,60,0,0,1,60,1.685928000,0.0000
255.133.39.74,<->,29.209.14.200,1,1004,0,0,1,1004,1.685819000,0.0000
199.66.208.243,<->,39.162.166.120,0,0,1,101,1,101,1.685696000,0.0000
215.158.61.236,<->,8.252.221.218,0,0,1,56,1,56,1.685593000,0.0000
80.42.174.132,<->,38.71.242.128,1,50,0,0,1,50,1.685201000,0.0000
143.194.24.245,<->,92.27.194.147,0,0,1,56,1,56,1.684887000,0.0000
20.191.230.158,<->,18.195.16.153,1,140,0,0,1,140,1.684715000,0.0000
223.122.185.191,<->,8.43.220.234,0,0,1,704,1,704,1.684670000,0.0000
92.27.219.226,<->,80.233.117.143,1,52,0,0,1,52,1.684263000,0.0000
198.74.176.149,<->,20.159.221.187,0,0,1,64,1,64,1.683907000,0.0000
61.95.120.154,<->,34.106.38.67,0,0,1,52,1,52,1.683807000,0.0000
53.244.59.104,<->,48.52.115.144,0,0,1,64,1,64,1.683755000,0.0000
145.130.199.211,<->,8.182.233.43,0,0,1,50,1,50,1.683720000,0.0000
247.136.139.153,<->,33.184.193.180,1,56,0,0,1,56,1.683674000,0.0000
142.253.143.85,<->,136.25.188.226,0,0,1,56,1,56,1.683623000,0.0000
194.233.148.250,<->,136.25.188.198,0,0,1,50,1,50,1.683217000,0.0000
145.16.29.114,<->,138.127.230.158,1,301,0,0,1,301,1.683145000,0.0000
132.51.6.109,<->,119.158.24.205,1,60,0,0,1,60,1.683057000,0.0000
215.158.239.78,<->,199.20.28.160,1,56,0,0,1,56,1.683008000,0.0000
109.1.25.177,<->,27.87.88.245,1,135,0,0,1,135,1.682964000,0.0000
204.200.51.179,<->,136.25.188.220,0,0,1,56,1,56,1.682831000,0.0000
92.27.27.165,<->,38.227.135.0,1,52,0,0,1,52,1.682658000,0.0000
207.172.118.63,<->,136.25.188.54,0,0,1,97,1,97,1.682294000,0.0000
17.61.177.228,<->,8.228.213.135,0,0,1,50,1,50,1.682209000,0.0000
195.83.166.40,<->,39.147.89.158,0,0,1,60,1,60,1.681877000,0.0000
223.122.185.191,<->,8.43.209.194,0,0,1,704,1,704,1.681838000,0.0000
129.34.166.15,<->,101.224.183.195,0,0,1,86,1,86,1.681802000,0.0000
207.62.180.98,<->,136.25.188.46,0,0,1,56,1,56,1.681746000,0.0000
82.165.200.247,<->,80.40.41.29,0,0,1,52,1,52,1.681562000,0.0000
230.91.97.101,<->,92.181.151.40,0,0,1,94,1,94,1.681089000,0.0000
39.44.78.240,<->,0.104.29.105,1,64,0,0,1,64,1.680880000,0.0000
21.15.226.126,<->,20.193.21.16,0,0,1,82,1,82,1.680878000,0.0000
229.73.239.30,<->,133.54.31.182,0,0,1,50,1,50,1.680718000,0.0000
92.27.219.172,<->,35.33.19.191,1,78,0,0,1,78,1.680265000,0.0000
135.241.174.242,<->,89.183.104.178,0,0,1,135,1,135,1.679966000,0.0000
105.92.210.236,<->,80.38.30.46,0,0,1,50,1,50,1.679847000,0.0000
195.15.208.13,<->,136.25.188.46,0,0,1,56,1,56,1.679680000,0.0000
159.140.232.210,<->,41.162.129.42,0,0,1,50,1,50,1.679416000,0.0000
194.248.50.194,<->,39.15.83.238,0,0,1,67,1,67,1.679225000,0.0000
149.195.49.108,<->,132.51.6.109,0,0,1,64,1,64,1.679102000,0.0000
195.41.46.91,<->,136.25.188.220,0,0,1,331,1,331,1.679022000,0.0000
204.184.171.48,<->,136.25.188.175,0,0,1,50,1,50,1.678981000,0.0000
194.233.147.92,<->,136.25.188.175,0,0,1,56,1,56,1.678978000,0.0000
133.178.227.39,<->,133.56.180.93,1,541,0,0,1,541,1.678560000,0.0000
215.158.2.49,<->,80.56.78.92,0,0,1,87,1,87,1.678554000,0.0000
215.158.238.243,<->,68.231.26.202,1,1090,0,0,1,1090,1.678452000,0.0000
159.240.189.205,<->,159.69.187.44,0,0,1,67,1,67,1.678423000,0.0000
144.75.218.235,<->,138.127.224.190,1,242,0,0,1,242,1.678348000,0.0000
244.50.229.157,<->,20.218.236.242,0,0,1,50,1,50,1.678069000,0.0000
192.64.246.137,<->,125.42.242.109,1,50,0,0,1,50,1.677998000,0.0000
144.75.218.246,<->,139.252.1.219,1,87,0,0,1,87,1.677961000,0.0000
221.102.143.189,<->,6.228.23.67,0,0,1,141,1,141,1.677886000,0.0000
144.75.218.241,<->,138.127.230.247,1,345,0,0,1,345,1.677820000,0.0000
104.241.56.221,<->,39.42.64.37,0,0,1,92,1,92,1.677744000,0.0000
206.55.150.194,<->,192.64.193.89,0,0,1,135,1,135,1.677706000,0.0000
111.147.130.105,<->,53.245.116.237,1,56,0,0,1,56,1.677554000,0.0000
198.158.197.83,<->,20.179.236.220,0,0,1,50,1,50,1.677268000,0.0000
204.63.129.248,<->,136.25.188.209,0,0,1,64,1,64,1.676989000,0.0000
129.19.157.66,<->,80.38.62.126,0,0,1,130,1,130,1.676854000,0.0000
114.250.29.227,<->,20.40.80.181,0,0,1,84,1,84,1.676724000,0.0000
143.125.33.18,<->,20.241.43.58,0,0,1,75,1,75,1.676693000,0.0000
144.72.25.37,<->,136.25.189.210,0,0,1,140,1,140,1.676646000,0.0000
17.166.0.253,<->,8.220.190.86,0,0,1,50,1,50,1.676440000,0.0000
101.171.64.75,<->,92.26.129.210,1,140,0,0,1,140,1.676217000,0.0000
202.33.25.164,<->,136.25.188.178,0,0,1,56,1,56,1.676145000,0.0000
198.158.197.83,<->,20.179.124.4,0,0,1,50,1,50,1.676100000,0.0000
111.150.207.207,<->,8.252.221.192,0,0,1,56,1,56,1.676070000,0.0000
210.209.251.211,<->,192.66.156.29,0,0,1,50,1,50,1.675598000,0.0000
194.248.50.194,<->,39.15.83.196,0,0,1,67,1,67,1.675579000,0.0000
192.229.223.2,<->,149.199.118.25,1,704,0,0,1,704,1.675388000,0.0000
80.41.23.15,<->,38.71.251.202,1,68,0,0,1,68,1.675346000,0.0000
26.200.214.204,<->,8.220.188.158,0,0,1,50,1,50,1.675318000,0.0000
195.42.125.201,<->,136.25.188.239,0,0,1,50,1,50,1.675176000,0.0000
220.55.111.214,<->,112.14.199.242,1,60,0,0,1,60,1.674951000,0.0000
204.63.5.183,<->,136.25.188.178,0,0,1,68,1,68,1.674685000,0.0000
231.138.232.202,<->,136.25.188.46,0,0,1,68,1,68,1.674682000,0.0000
111.151.106.217,<->,8.252.222.101,0,0,1,56,1,56,1.674674000,0.0000
132.7.214.52,<->,80.41.31.9,0,0,1,169,1,169,1.674669000,0.0000
105.243.185.25,<->,0.195.210.42,0,0,1,50,1,50,1.674566000,0.0000
199.121.85.131,<->,20.224.159.82,0,0,1,52,1,52,1.674235000,0.0000
244.50.129.64,<->,20.206.76.5,0,0,1,50,1,50,1.674176000,0.0000
194.248.50.194,<->,39.15.83.195,0,0,1,67,1,67,1.673999000,0.0000
215.158.238.95,<->,144.253.73.85,1,1225,0,0,1,1225,1.673564000,0.0000
54.37.202.190,<->,48.54.43.172,0,0,1,50,1,50,1.673425000,0.0000
56.121.35.12,<->,8.32.89.211,1,84,0,0,1,84,1.673248000,0.0000
95.246.115.70,<->,8.252.221.237,0,0,1,50,1,50,1.673063000,0.0000
149.167.2.14,<->,8.43.154.173,0,0,1,64,1,64,1.673051000,0.0000
122.208.197.9,<->,50.224.76.234,0,0,1,50,1,50,1.672803000,0.0000
246.253.157.20,<->,116.179.231.181,1,50,0,0,1,50,1.672720000,0.0000
249.101.211.150,<->,193.21.29.234,1,342,0,0,1,342,1.672597000,0.0000
204.144.56.71,<->,39.158.19.99,0,0,1,104,1,104,1.672515000,0.0000
253.107.163.208,<->,139.163.1.154,0,0,1,50,1,50,1.672310000,0.0000
119.95.205.11,<->,20.223.116.61,0,0,1,531,1,531,1.672274000,0.0000
194.248.50.194,<->,39.15.83.129,0,0,1,67,1,67,1.672169000,0.0000
241.193.172.231,<->,20.231.73.228,0,0,1,50,1,50,1.672010000,0.0000
199.82.247.64,<->,136.25.188.209,0,0,1,50,1,50,1.671885000,0.0000
246.253.145.104,<->,0.34.54.41,1,50,0,0,1,50,1.671608000,0.0000
230.115.138.250,<->,50.128.49.96,0,0,1,130,1,130,1.671525000,0.0000
92.27.219.60,<->,38.246.57.185,1,52,0,0,1,52,1.671381000,0.0000
50.224.76.234,<->,30.189.151.18,1,56,0,0,1,56,1.671366000,0.0000
125.216.38.51,<->,8.43.212.233,0,0,1,704,1,704,1.671245000,0.0000
54.39.40.181,<->,48.53.8.41,0,0,1,52,1,52,1.671117000,0.0000
136.25.189.95,<->,109.205.55.54,1,84,0,0,1,84,1.671076000,0.0000
133.178.226.29,<->,113.23.117.117,1,1277,0,0,1,1277,1.670725000,0.0000
215.158.239.76,<->,195.43.89.232,1,68,0,0,1,68,1.670699000,0.0000
253.107.163.252,<->,139.163.1.154,0,0,1,50,1,50,1.670498000,0.0000
215.158.239.127,<->,215.158.61.145,1,56,0,0,1,56,1.670366000,0.0000
208.49.209.130,<->,92.27.27.172,0,0,1,64,1,64,1.669957000,0.0000
251.24.170.25,<->,8.182.227.180,0,0,1,56,1,56,1.669663000,0.0000
215.158.239.92,<->,196.92.18.110,1,84,0,0,1,84,1.669609000,0.0000
201.216.164.96,<->,39.2.106.184,0,0,1,64,1,64,1.669393000,0.0000
98.67.155.114,<->,26.215.169.221,1,294,0,0,1,294,1.669211000,0.0000
195.42.93.18,<->,136.25.188.177,0,0,1,56,1,56,1.669188000,0.0000
207.194.68.122,<->,8.182.227.180,0,0,1,50,1,50,1.668977000,0.0000
194.114.227.242,<->,39.243.109.23,0,0,1,64,1,64,1.668924000,0.0000
92.27.27.183,<->,64.214.44.94,1,50,0,0,1,50,1.668823000,0.0000
253.107.167.117,<->,139.163.1.154,0,0,1,50,1,50,1.668648000,0.0000
247.136.220.79,<->,199.12.111.105,1,86,0,0,1,86,1.668593000,0.0000
21.15.226.126,<->,20.193.22.96,0,0,1,82,1,82,1.668488000,0.0000
204.77.93.74,<->,39.199.197.135,0,0,1,106,1,106,1.668478000,0.0000
207.58.209.240,<->,136.25.188.177,0,0,1,56,1,56,1.668271000,0.0000
199.83.110.179,<->,136.25.188.239,0,0,1,561,1,561,1.668216000,0.0000
80.27.154.144,<->,48.106.1.249,1,50,0,0,1,50,1.667972000,0.0000
132.208.70.62,<->,92.27.219.204,0,0,1,647,1,647,1.667852000,0.0000
144.122.240.210,<->,144.108.64.179,1,73,0,0,1,73,1.667824000,0.0000
95.246.83.54,<->,8.252.221.197,0,0,1,56,1,56,1.667730000,0.0000
122.212.149.92,<->,20.115.175.168,0,0,1,64,1,64,1.667697000,0.0000
92.27.219.253,<->,50.67.158.242,1,56,0,0,1,56,1.667602000,0.0000
215.158.239.77,<->,196.91.253.126,1,64,0,0,1,64,1.667574000,0.0000
132.188.102.244,<->,8.220.188.50,0,0,1,50,1,50,1.667451000,0.0000
59.32.3.142,<->,34.175.70.188,0,0,1,52,1,52,1.667346000,0.0000
215.158.61.183,<->,8.176.8.206,0,0,1,56,1,56,1.666926000,0.0000
204.184.235.141,<->,136.25.188.196,0,0,1,56,1,56,1.666919000,0.0000
97.58.199.147,<->,80.40.50.197,0,0,1,56,1,56,1.666907000,0.0000
221.102.143.189,<->,220.80.24.204,0,0,1,141,1,141,1.666900000,0.0000
136.221.119.73,<->,20.21.128.100,0,0,1,64,1,64,1.666895000,0.0000
144.75.218.242,<->,138.127.225.202,1,281,0,0,1,281,1.666801000,0.0000
144.75.218.246,<->,138.127.230.199,1,156,0,0,1,156,1.666622000,0.0000
244.50.136.175,<->,20.125.158.174,0,0,1,50,1,50,1.666252000,0.0000
89.183.104.184,<->,75.92.131.181,1,60,0,0,1,60,1.666105000,0.0000
136.25.188.167,<->,111.151.142.231,1,100,0,0,1,100,1.666057000,0.0000
76.2.251.232,<->,8.220.195.10,0,0,1,704,1,704,1.666007000,0.0000
194.247.3.25,<->,39.17.148.81,0,0,1,64,1,64,1.665710000,0.0000
196.121.84.74,<->,39.12.217.198,0,0,1,64,1,64,1.665284000,0.0000
137.69.131.139,<->,8.182.253.73,0,0,1,50,1,50,1.665261000,0.0000
138.127.229.105,<->,99.74.26.170,0,0,1,202,1,202,1.665107000,0.0000
59.48.50.193,<->,39.246.50.147,0,0,1,75,1,75,1.665038000,0.0000
215.158.238.241,<->,8.192.205.1,1,1405,0,0,1,1405,1.664942000,0.0000
215.158.239.51,<->,29.212.199.5,1,1437,0,0,1,1437,1.664568000,0.0000
137.68.202.255,<->,92.27.219.244,0,0,1,52,1,52,1.664473000,0.0000
56.121.61.107,<->,45.144.219.2,1,78,0,0,1,78,1.664457000,0.0000
21.15.226.126,<->,20.193.22.105,0,0,1,82,1,82,1.663848000,0.0000
215.158.239.58,<->,199.20.5.242,1,64,0,0,1,64,1.663724000,0.0000
92.27.219.246,<->,78.45.216.107,1,50,0,0,1,50,1.663571000,0.0000
199.110.99.106,<->,20.193.205.74,0,0,1,52,1,52,1.663563000,0.0000
195.79.196.122,<->,100.94.21.80,0,0,1,52,1,52,1.663512000,0.0000
215.158.238.82,<->,112.93.136.119,1,1085,0,0,1,1085,1.663262000,0.0000
195.71.152.173,<->,136.25.188.54,0,0,1,50,1,50,1.663140000,0.0000
207.52.161.205,<->,92.27.8.182,0,0,1,137,1,137,1.663129000,0.0000
144.75.218.233,<->,114.145.99.171,1,252,0,0,1,252,1.662982000,0.0000
29.157.34.92,<->,20.96.230.181,0,0,1,65,1,65,1.662671000,0.0000
215.158.239.79,<->,199.20.28.92,1,378,0,0,1,378,1.662495000,0.0000
105.133.122.237,<->,20.121.152.35,0,0,1,64,1,64,1.662322000,0.0000
215.158.239.56,<->,196.92.25.180,1,64,0,0,1,64,1.662053000,0.0000
194.206.106.251,<->,20.172.50.83,0,0,1,101,1,101,1.661653000,0.0000
202.33.243.206,<->,136.25.188.220,0,0,1,50,1,50,1.661637000,0.0000
144.122.240.161,<->,144.108.64.179,1,64,0,0,1,64,1.661439000,0.0000
145.87.244.210,<->,132.151.132.170,0,0,1,50,1,50,1.661365000,0.0000
215.158.239.49,<->,199.20.29.127,1,64,0,0,1,64,1.661181000,0.0000
205.174.128.121,<->,39.195.244.14,0,0,1,60,1,60,1.661129000,0.0000
144.75.218.242,<->,102.45.225.190,1,71,0,0,1,71,1.661092000,0.0000
124.69.12.108,<->,39.148.38.40,0,0,1,68,1,68,1.660964000,0.0000
207.6.180.170,<->,20.59.1.124,0,0,1,66,1,66,1.660950000,0.0000
215.158.239.50,<->,204.2.69.100,1,50,0,0,1,50,1.660868000,0.0000
91.54.17.76,<->,8.20.87.11,0,0,1,50,1,50,1.660771000,0.0000
249.101.111.216,<->,50.145.214.5,1,1330,0,0,1,1330,1.660549000,0.0000
144.70.197.252,<->,100.123.122.202,1,50,0,0,1,50,1.660490000,0.0000
75.62.16.8,<->,20.25.33.212,0,0,1,50,1,50,1.660127000,0.0000
199.71.221.72,<->,136.25.188.252,0,0,1,64,1,64,1.660052000,0.0000
207.115.229.20,<->,20.139.79.137,0,0,1,102,1,102,1.659761000,0.0000
111.151.106.254,<->,99.74.87.227,0,0,1,100,1,100,1.659498000,0.0000
110.16.19.26,<->,109.222.250.46,0,0,1,133,1,133,1.659358000,0.0000
76.179.174.172,<->,8.252.222.158,0,0,1,64,1,64,1.659355000,0.0000
132.200.62.136,<->,132.200.50.12,1,540,0,0,1,540,1.659293000,0.0000
141.19.255.22,<->,20.182.201.244,0,0,1,70,1,70,1.659289000,0.0000
144.76.43.234,<->,80.56.78.94,0,0,1,94,1,94,1.659281000,0.0000
215.158.238.251,<->,149.250.115.20,1,1357,0,0,1,1357,1.658787000,0.0000
244.50.242.201,<->,20.252.174.212,0,0,1,50,1,50,1.658629000,0.0000
210.220.219.153,<->,136.42.3.53,1,305,0,0,1,305,1.658579000,0.0000
132.103.198.123,<->,119.121.24.104,1,64,0,0,1,64,1.658508000,0.0000
221.102.143.189,<->,102.81.148.183,0,0,1,141,1,141,1.658177000,0.0000
92.27.27.143,<->,64.214.57.231,1,50,0,0,1,50,1.658088000,0.0000
215.158.239.87,<->,142.182.132.235,1,68,0,0,1,68,1.657956000,0.0000
194.210.200.249,<->,39.199.163.137,0,0,1,64,1,64,1.657928000,0.0000
38.244.9.195,<->,20.157.173.78,0,0,1,68,1,68,1.657881000,0.0000
142.223.140.161,<->,136.25.188.241,0,0,1,705,1,705,1.657687000,0.0000
122.252.105.253,<->,39.206.221.49,0,0,1,106,1,106,1.657607000,0.0000
195.70.143.162,<->,136.25.188.241,0,0,1,64,1,64,1.657573000,0.0000
215.158.239.50,<->,199.20.30.123,1,190,0,0,1,190,1.657567000,0.0000
129.175.139.146,<->,29.211.214.254,0,0,1,90,1,90,1.657542000,0.0000
220.76.219.196,<->,20.3.94.150,0,0,1,70,1,70,1.657297000,0.0000
109.222.234.11,<->,22.73.14.11,1,66,0,0,1,66,1.657000000,0.0000
215.158.239.19,<->,89.143.239.124,1,56,0,0,1,56,1.656992000,0.0000
196.114.224.239,<->,20.2.189.148,0,0,1,56,1,56,1.656990000,0.0000
192.64.234.225,<->,125.44.173.36,1,50,0,0,1,50,1.656968000,0.0000
89.216.124.92,<->,8.235.230.154,1,210,0,0,1,210,1.656314000,0.0000
199.20.248.41,<->,129.224.112.252,0,0,1,66,1,66,1.656309000,0.0000
144.75.218.237,<->,141.37.226.95,1,86,0,0,1,86,1.655838000,0.0000
138.74.30.45,<->,111.150.58.148,1,81,0,0,1,81,1.655080000,0.0000
105.200.247.154,<->,98.236.254.250,0,0,1,77,1,77,1.654132000,0.0000
219.231.211.109,<->,20.120.254.0,0,0,1,64,1,64,1.654019000,0.0000
195.7.71.158,<->,136.25.188.178,0,0,1,68,1,68,1.653867000,0.0000
194.247.3.25,<->,39.17.148.65,0,0,1,64,1,64,1.653519000,0.0000
197.1.230.13,<->,109.1.52.14,0,0,1,135,1,135,1.653519000,0.0000
152.43.88.177,<->,8.252.221.239,0,0,1,1177,1,1177,1.653178000,0.0000
215.158.239.79,<->,199.20.29.75,1,56,0,0,1,56,1.652984000,0.0000
136.25.188.173,<->,84.214.235.178,1,863,0,0,1,863,1.652741000,0.0000
121.85.12.78,<->,20.26.136.39,0,0,1,52,1,52,1.652579000,0.0000
109.222.222.50,<->,103.5.47.180,1,66,0,0,1,66,1.652481000,0.0000
221.102.143.189,<->,109.1.84.71,0,0,1,87,1,87,1.651931000,0.0000
132.103.198.121,<->,119.121.24.104,1,64,0,0,1,64,1.651708000,0.0000
207.100.101.153,<->,39.160.55.137,0,0,1,56,1,56,1.651691000,0.0000
129.26.255.153,<->,53.201.48.187,1,56,0,0,1,56,1.651510000,0.0000
92.27.27.149,<->,69.175.112.209,1,99,0,0,1,99,1.651437000,0.0000
210.229.230.19,<->,80.92.242.123,1,50,0,0,1,50,1.651423000,0.0000
192.67.179.218,<->,93.165.188.179,1,105,0,0,1,105,1.650982000,0.0000
248.225.27.2,<->,29.214.217.95,1,141,0,0,1,141,1.650946000,0.0000
249.101.211.150,<->,213.154.103.208,1,64,0,0,1,64,1.650721000,0.0000
120.155.86.237,<->,8.252.222.232,0,0,1,134,1,134,1.650611000,0.0000
215.158.140.137,<->,111.151.109.36,1,56,0,0,1,56,1.650533000,0.0000
6.145.170.220,<->,0.195.210.44,0,0,1,56,1,56,1.650281000,0.0000
94.25.236.249,<->,50.224.76.235,0,0,1,50,1,50,1.650175000,0.0000
105.163.84.63,<->,22.61.158.5,0,0,1,52,1,52,1.650152000,0.0000
111.151.106.235,<->,8.252.223.83,0,0,1,56,1,56,1.650059000,0.0000
75.62.16.8,<->,39.228.135.168,0,0,1,50,1,50,1.649898000,0.0000
195.126.207.196,<->,136.25.188.174,0,0,1,50,1,50,1.649838000,0.0000
99.75.7.32,<->,8.240.117.23,1,56,0,0,1,56,1.649838000,0.0000
27.2.254.221,<->,20.116.199.147,0,0,1,106,1,106,1.649717000,0.0000
141.252.251.222,<->,80.57.138.214,1,56,0,0,1,56,1.649642000,0.0000
199.51.158.11,<->,136.25.188.252,0,0,1,56,1,56,1.649558000,0.0000
237.7.172.101,<->,99.73.143.215,0,0,1,84,1,84,1.649546000,0.0000
109.222.242.102,<->,8.224.46.33,1,74,0,0,1,74,1.648885000,0.0000
196.114.201.194,<->,39.146.221.234,0,0,1,105,1,105,1.648778000,0.0000
125.31.133.96,<->,80.41.32.57,0,0,1,321,1,321,1.648561000,0.0000
196.15.236.179,<->,39.200.37.227,0,0,1,60,1,60,1.648552000,0.0000
38.92.87.149,<->,20.204.122.115,0,0,1,64,1,64,1.648306000,0.0000
145.13.164.41,<->,136.25.189.210,0,0,1,111,1,111,1.647978000,0.0000
247.136.209.27,<->,158.150.64.93,1,501,0,0,1,501,1.647908000,0.0000
126.2.6.102,<->,39.128.168.188,0,0,1,96,1,96,1.647740000,0.0000
109.206.164.233,<->,50.224.92.54,0,0,1,161,1,161,1.647485000,0.0000
136.25.188.241,<->,41.141.98.117,1,56,0,0,1,56,1.647177000,0.0000
142.174.206.25,<->,8.52.245.115,0,0,1,50,1,50,1.647081000,0.0000
145.3.142.7,<->,39.237.228.154,0,0,1,64,1,64,1.646490000,0.0000
215.158.61.145,<->,8.176.8.241,0,0,1,56,1,56,1.646362000,0.0000
144.75.218.241,<->,50.149.206.89,1,126,0,0,1,126,1.646038000,0.0000
215.158.239.17,<->,69.196.17.249,1,50,0,0,1,50,1.645995000,0.0000
210.226.165.189,<->,53.244.1.230,1,87,0,0,1,87,1.645994000,0.0000
220.20.200.7,<->,127.255.84.41,1,573,0,0,1,573,1.645455000,0.0000
215.158.238.178,<->,192.170.179.2,1,1064,0,0,1,1064,1.645421000,0.0000
145.89.157.42,<->,67.219.231.169,1,130,0,0,1,130,1.645220000,0.0000
92.162.253.195,<->,27.199.161.199,1,56,0,0,1,56,1.645144000,0.0000
122.146.163.156,<->,39.55.75.1,0,0,1,52,1,52,1.644650000,0.0000
194.124.8.102,<->,39.144.84.198,0,0,1,76,1,76,1.644286000,0.0000
198.151.3.63,<->,22.59.13.208,0,0,1,72,1,72,1.644161000,0.0000
204.61.12.49,<->,136.25.188.179,0,0,1,56,1,56,1.643909000,0.0000
129.224.112.220,<->,114.186.133.55,1,86,0,0,1,86,1.643727000,0.0000
215.158.238.69,<->,128.156.85.234,1,56,0,0,1,56,1.643066000,0.0000
120.217.184.87,<->,20.156.140.197,0,0,1,52,1,52,1.642877000,0.0000
97.126.2.116,<->,95.89.187.66,1,66,0,0,1,66,1.642561000,0.0000
221.102.143.189,<->,102.81.178.78,0,0,1,141,1,141,1.642501000,0.0000
221.102.56.46,<->,192.67.160.76,0,0,1,1504,1,1504,1.642289000,0.0000
195.42.93.18,<->,136.25.188.175,0,0,1,56,1,56,1.642156000,0.0000
116.158.247.114,<->,92.27.219.250,0,0,1,64,1,64,1.641885000,0.0000
197.33.13.60,<->,39.173.168.54,0,0,1,52,1,52,1.641844000,0.0000
97.173.81.147,<->,39.138.159.99,0,0,1,102,1,102,1.641774000,0.0000
215.158.239.99,<->,195.96.156.37,1,56,0,0,1,56,1.641289000,0.0000
207.60.67.3,<->,136.25.188.175,0,0,1,56,1,56,1.641198000,0.0000
199.25.50.198,<->,39.172.210.51,0,0,1,64,1,64,1.641123000,0.0000
117.53.59.186,<->,50.224.76.234,0,0,1,50,1,50,1.641039000,0.0000
111.151.107.194,<->,8.176.8.241,0,0,1,56,1,56,1.640970000,0.0000
159.165.39.68,<->,8.220.178.8,0,0,1,704,1,704,1.640676000,0.0000
136.141.149.197,<->,111.146.248.118,0,0,1,245,1,245,1.640600000,0.0000
142.206.66.136,<->,136.25.188.177,0,0,1,50,1,50,1.640541000,0.0000
193.41.82.236,<->,20.192.194.65,0,0,1,106,1,106,1.640476000,0.0000
113.114.28.98,<->,89.183.104.135,0,0,1,52,1,52,1.640328000,0.0000
57.220.150.11,<->,8.220.190.86,0,0,1,50,1,50,1.640183000,0.0000
215.158.34.160,<->,136.25.189.94,0,0,1,1064,1,1064,1.639982000,0.0000
105.66.35.149,<->,20.0.44.141,0,0,1,64,1,64,1.639594000,0.0000
215.158.61.145,<->,8.176.8.219,0,0,1,56,1,56,1.639359000,0.0000
247.136.217.189,<->,38.136.248.91,1,50,0,0,1,50,1.638747000,0.0000
215.158.140.205,<->,82.99.214.214,1,50,0,0,1,50,1.638686000,0.0000
210.209.251.214,<->,111.146.163.17,0,0,1,369,1,369,1.638639000,0.0000
194.232.172.16,<->,136.25.188.199,0,0,1,50,1,50,1.638583000,0.0000
126.225.190.106,<->,20.42.116.71,0,0,1,64,1,64,1.638563000,0.0000
207.191.198.47,<->,136.25.188.253,0,0,1,64,1,64,1.638391000,0.0000
241.193.172.231,<->,20.196.116.155,0,0,1,50,1,50,1.638348000,0.0000
120.4.61.182,<->,80.42.191.110,0,0,1,321,1,321,1.638060000,0.0000
103.145.39.205,<->,8.220.188.50,0,0,1,50,1,50,1.637731000,0.0000
80.42.181.14,<->,77.101.137.113,1,79,0,0,1,79,1.637704000,0.0000
138.127.224.104,<->,92.27.219.227,0,0,1,371,1,371,1.637507000,0.0000
111.151.106.200,<->,6.73.247.138,0,0,1,56,1,56,1.637466000,0.0000
144.85.170.254,<->,98.87.145.69,1,68,0,0,1,68,1.637460000,0.0000
144.70.164.220,<->,101.224.172.116,0,0,1,68,1,68,1.637387000,0.0000
211.237.79.208,<->,105.72.221.109,1,64,0,0,1,64,1.637324000,0.0000
202.33.98.156,<->,136.25.188.178,0,0,1,68,1,68,1.637313000,0.0000
88.3.63.208,<->,39.34.121.114,0,0,1,64,1,64,1.637157000,0.0000
120.185.120.54,<->,20.213.93.4,0,0,1,52,1,52,1.636976000,0.0000
204.60.187.80,<->,136.25.188.226,0,0,1,68,1,68,1.636650000,0.0000
215.158.2.59,<->,159.123.32.28,0,0,1,89,1,89,1.636548000,0.0000
227.56.35.246,<->,144.75.218.237,0,0,1,150,1,150,1.636302000,0.0000
139.193.141.139,<->,119.200.27.68,1,50,0,0,1,50,1.636189000,0.0000
140.21.17.68,<->,20.234.93.132,0,0,1,68,1,68,1.635988000,0.0000
207.162.231.21,<->,39.44.243.207,0,0,1,52,1,52,1.635969000,0.0000
244.50.133.60,<->,39.47.155.137,0,0,1,50,1,50,1.635887000,0.0000
144.75.218.237,<->,128.8.21.253,1,159,0,0,1,159,1.635809000,0.0000
69.246.57.22,<->,34.2.220.7,0,0,1,60,1,60,1.635752000,0.0000
215.158.239.85,<->,199.39.190.65,1,307,0,0,1,307,1.635749000,0.0000
59.72.20.179,<->,6.95.19.48,0,0,1,52,1,52,1.635740000,0.0000
215.158.238.77,<->,144.56.210.43,1,84,0,0,1,84,1.635250000,0.0000
207.239.187.93,<->,136.25.188.173,0,0,1,56,1,56,1.635179000,0.0000
133.178.227.238,<->,111.150.207.137,1,100,0,0,1,100,1.634975000,0.0000
8.220.186.82,<->,6.101.100.5,1,56,0,0,1,56,1.634851000,0.0000
192.64.101.241,<->,105.170.162.64,1,98,0,0,1,98,1.634801000,0.0000
144.75.218.233,<->,138.127.230.15,1,366,0,0,1,366,1.634525000,0.0000
248.239.171.119,<->,8.45.170.216,1,56,0,0,1,56,1.634452000,0.0000
39.254.3.217,<->,27.114.181.217,1,88,0,0,1,88,1.633818000,0.0000
133.178.227.24,<->,8.188.227.24,1,1082,0,0,1,1082,1.633768000,0.0000
252.72.198.243,<->,53.148.22.141,1,125,0,0,1,125,1.633622000,0.0000
128.156.85.235,<->,8.252.223.169,0,0,1,56,1,56,1.633586000,0.0000
53.161.71.169,<->,48.54.128.170,0,0,1,50,1,50,1.633408000,0.0000
100.16.23.197,<->,92.27.219.34,0,0,1,369,1,369,1.633249000,0.0000
149.201.160.73,<->,137.21.23.55,0,0,1,1002,1,1002,1.632649000,0.0000
207.77.96.246,<->,20.239.153.103,0,0,1,52,1,52,1.632473000,0.0000
133.178.226.28,<->,29.213.218.232,1,1133,0,0,1,1133,1.632159000,0.0000
144.75.218.235,<->,120.155.84.208,1,150,0,0,1,150,1.632004000,0.0000
146.239.255.80,<->,0.195.210.42,0,0,1,50,1,50,1.631825000,0.0000
215.158.61.243,<->,8.176.8.194,0,0,1,429,1,429,1.631809000,0.0000
210.220.219.153,<->,53.214.119.149,1,50,0,0,1,50,1.631299000,0.0000
202.50.168.2,<->,92.27.219.50,0,0,1,56,1,56,1.631013000,0.0000
131.238.203.44,<->,92.27.219.19,0,0,1,80,1,80,1.630573000,0.0000
73.89.20.239,<->,39.233.87.102,0,0,1,60,1,60,1.630371000,0.0000
121.5.78.51,<->,50.224.76.248,0,0,1,56,1,56,1.630069000,0.0000
89.216.125.35,<->,53.231.156.17,1,50,0,0,1,50,1.629996000,0.0000
118.44.93.84,<->,101.224.204.193,0,0,1,227,1,227,1.629487000,0.0000
111.82.141.173,<->,80.41.15.57,0,0,1,138,1,138,1.629454000,0.0000
215.158.239.95,<->,199.20.29.178,1,56,0,0,1,56,1.629335000,0.0000
105.140.23.31,<->,20.121.178.182,0,0,1,64,1,64,1.629269000,0.0000
221.102.123.23,<->,207.64.27.140,1,50,0,0,1,50,1.628957000,0.0000
203.92.184.4,<->,39.50.184.201,0,0,1,52,1,52,1.628904000,0.0000
76.75.2.254,<->,39.233.125.46,0,0,1,56,1,56,1.628639000,0.0000
129.224.112.252,<->,80.27.155.182,1,74,0,0,1,74,1.628344000,0.0000
215.158.239.58,<->,196.90.5.223,1,68,0,0,1,68,1.628005000,0.0000
192.64.196.68,<->,38.64.17.71,1,52,0,0,1,52,1.627438000,0.0000
195.6.100.153,<->,136.25.188.236,0,0,1,50,1,50,1.627373000,0.0000
205.91.134.38,<->,39.232.98.77,0,0,1,64,1,64,1.627338000,0.0000
134.161.237.45,<->,92.27.219.39,0,0,1,52,1,52,1.627322000,0.0000
8.222.105.7,<->,8.52.235.218,0,0,1,1002,1,1002,1.627104000,0.0000
106.126.137.134,<->,89.183.104.171,0,0,1,105,1,105,1.627095000,0.0000
105.120.9.210,<->,92.27.219.195,0,0,1,56,1,56,1.626602000,0.0000
99.175.105.137,<->,53.149.98.170,1,50,0,0,1,50,1.626395000,0.0000
133.178.227.4,<->,111.151.142.210,1,100,0,0,1,100,1.626334000,0.0000
106.158.67.80,<->,92.27.219.189,0,0,1,52,1,52,1.626298000,0.0000
75.62.16.8,<->,20.136.141.49,0,0,1,50,1,50,1.626031000,0.0000
121.209.106.187,<->,92.27.219.130,0,0,1,99,1,99,1.625717000,0.0000
207.162.187.228,<->,8.182.226.78,0,0,1,50,1,50,1.625579000,0.0000
158.198.102.239,<->,50.224.76.235,0,0,1,50,1,50,1.625521000,0.0000
219.249.163.103,<->,80.38.16.211,0,0,1,50,1,50,1.625467000,0.0000
111.151.109.19,<->,8.176.8.176,0,0,1,100,1,100,1.625458000,0.0000
215.158.103.219,<->,129.223.93.3,1,795,0,0,1,795,1.624806000,0.0000
215.158.239.95,<->,199.20.7.47,1,64,0,0,1,64,1.624703000,0.0000
138.86.243.67,<->,20.185.113.162,0,0,1,66,1,66,1.624630000,0.0000
91.43.41.108,<->,89.216.124.92,0,0,1,50,1,50,1.624400000,0.0000
192.67.165.98,<->,57.248.174.7,1,52,0,0,1,52,1.624344000,0.0000
207.100.101.153,<->,108.134.119.230,0,0,1,56,1,56,1.624032000,0.0000
215.158.239.78,<->,199.20.30.198,1,64,0,0,1,64,1.623883000,0.0000
111.151.142.130,<->,8.252.223.245,0,0,1,56,1,56,1.623127000,0.0000
116.145.113.34,<->,80.41.36.78,0,0,1,130,1,130,1.623068000,0.0000
195.5.41.67,<->,136.25.188.254,0,0,1,56,1,56,1.623056000,0.0000
215.158.239.56,<->,199.20.29.69,1,68,0,0,1,68,1.622612000,0.0000
246.254.97.228,<->,210.231.140.48,1,50,0,0,1,50,1.622337000,0.0000
33.220.0.56,<->,8.52.168.54,0,0,1,1002,1,1002,1.622232000,0.0000
194.247.3.25,<->,39.17.148.71,0,0,1,64,1,64,1.621771000,0.0000
199.50.78.127,<->,136.25.188.174,0,0,1,56,1,56,1.621040000,0.0000
102.255.4.215,<->,56.121.46.149,0,0,1,50,1,50,1.620917000,0.0000
215.158.238.140,<->,148.123.222.73,1,1101,0,0,1,1101,1.620859000,0.0000
215.158.239.77,<->,196.94.186.202,1,68,0,0,1,68,1.620425000,0.0000
215.158.239.84,<->,199.68.192.32,1,68,0,0,1,68,1.620365000,0.0000
215.158.239.237,<->,8.191.134.109,1,72,0,0,1,72,1.620311000,0.0000
140.145.90.254,<->,39.129.92.211,0,0,1,70,1,70,1.620014000,0.0000
215.158.239.68,<->,195.80.115.179,1,76,0,0,1,76,1.619890000,0.0000
207.213.142.242,<->,39.38.105.44,0,0,1,100,1,100,1.619837000,0.0000
220.82.62.48,<->,100.230.7.117,1,50,0,0,1,50,1.619799000,0.0000
195.54.186.3,<->,50.224.76.230,0,0,1,56,1,56,1.619720000,0.0000
50.224.76.235,<->,33.251.204.238,1,50,0,0,1,50,1.619689000,0.0000
91.251.100.85,<->,8.55.211.213,1,64,0,0,1,64,1.619662000,0.0000
92.27.219.216,<->,48.105.201.130,1,1437,0,0,1,1437,1.619182000,0.0000
132.149.113.27,<->,64.214.57.236,1,50,0,0,1,50,1.618719000,0.0000
138.73.251.106,<->,8.204.75.120,1,56,0,0,1,56,1.618650000,0.0000
192.229.214.186,<->,97.175.119.51,1,50,0,0,1,50,1.618347000,0.0000
241.193.172.231,<->,20.45.237.208,0,0,1,50,1,50,1.617955000,0.0000
215.158.238.66,<->,140.145.218.196,1,1085,0,0,1,1085,1.617679000,0.0000
192.67.161.143,<->,105.71.224.108,1,130,0,0,1,130,1.616931000,0.0000
247.136.249.234,<->,124.19.52.147,1,332,0,0,1,332,1.616494000,0.0000
249.101.103.55,<->,127.187.63.72,1,56,0,0,1,56,1.616041000,0.0000
105.113.53.216,<->,97.168.89.179,0,0,1,78,1,78,1.615493000,0.0000
106.42.39.78,<->,89.183.104.235,0,0,1,52,1,52,1.615149000,0.0000
144.117.176.71,<->,8.52.222.23,0,0,1,56,1,56,1.614984000,0.0000
144.64.139.146,<->,141.95.30.8,1,78,0,0,1,78,1.614940000,0.0000
113.80.107.218,<->,39.41.185.141,0,0,1,60,1,60,1.614850000,0.0000
195.54.152.2,<->,136.25.188.52,0,0,1,56,1,56,1.614415000,0.0000
241.193.172.231,<->,20.251.154.1,0,0,1,50,1,50,1.614190000,0.0000
92.27.219.211,<->,29.170.153.193,1,52,0,0,1,52,1.613614000,0.0000
136.25.188.212,<->,122.158.53.79,1,106,0,0,1,106,1.613255000,0.0000
119.90.250.200,<->,39.28.220.58,0,0,1,50,1,50,1.613166000,0.0000
133.178.227.4,<->,120.190.31.252,1,85,0,0,1,85,1.612790000,0.0000
109.222.233.46,<->,50.213.212.120,1,72,0,0,1,72,1.612618000,0.0000
199.21.138.28,<->,8.182.241.177,0,0,1,50,1,50,1.612566000,0.0000
194.248.157.78,<->,80.42.184.239,0,0,1,273,1,273,1.612563000,0.0000
193.46.99.104,<->,92.27.219.58,0,0,1,129,1,129,1.612422000,0.0000
204.62.31.170,<->,136.25.188.222,0,0,1,64,1,64,1.612311000,0.0000
200.175.211.132,<->,53.200.51.184,1,285,0,0,1,285,1.611894000,0.0000
210.44.70.145,<->,20.62.0.70,0,0,1,64,1,64,1.611622000,0.0000
195.40.126.203,<->,136.25.188.253,0,0,1,829,1,829,1.611450000,0.0000
134.34.66.140,<->,92.27.194.147,0,0,1,56,1,56,1.611390000,0.0000
132.216.20.202,<->,109.1.8.45,0,0,1,50,1,50,1.611308000,0.0000
220.87.90.39,<->,77.10.246.184,1,130,0,0,1,130,1.611286000,0.0000
215.158.239.70,<->,204.0.189.249,1,64,0,0,1,64,1.611045000,0.0000
144.85.170.246,<->,91.69.185.136,1,56,0,0,1,56,1.610719000,0.0000
139.252.1.254,<->,92.27.27.144,0,0,1,371,1,371,1.610345000,0.0000
246.253.248.211,<->,53.165.88.118,1,87,0,0,1,87,1.610302000,0.0000
111.151.142.153,<->,97.126.31.85,0,0,1,56,1,56,1.610052000,0.0000
105.69.52.216,<->,20.224.91.117,0,0,1,108,1,108,1.609648000,0.0000
196.63.33.154,<->,39.197.80.179,0,0,1,102,1,102,1.609323000,0.0000
111.147.103.177,<->,74.143.202.144,1,133,0,0,1,133,1.608962000,0.0000
215.158.239.41,<->,57.227.82.181,1,1404,0,0,1,1404,1.608735000,0.0000
192.64.245.55,<->,64.145.129.216,1,133,0,0,1,133,1.608688000,0.0000
33.98.7.246,<->,20.211.27.230,0,0,1,60,1,60,1.608677000,0.0000
111.147.98.205,<->,54.38.63.88,1,167,0,0,1,167,1.608551000,0.0000
235.236.66.193,<->,20.116.228.206,0,0,1,103,1,103,1.608500000,0.0000
38.21.156.204,<->,20.232.230.111,0,0,1,82,1,82,1.608433000,0.0000
158.197.29.201,<->,132.249.70.62,0,0,1,79,1,79,1.608361000,0.0000
194.238.228.96,<->,136.25.188.241,0,0,1,56,1,56,1.608270000,0.0000
21.15.226.126,<->,20.193.23.29,0,0,1,82,1,82,1.608183000,0.0000
84.203.57.77,<->,39.172.81.49,0,0,1,50,1,50,1.608033000,0.0000
144.75.218.242,<->,53.245.2.193,1,389,0,0,1,389,1.607938000,0.0000
104.255.147.100,<->,80.41.8.174,0,0,1,56,1,56,1.607887000,0.0000
109.222.242.9,<->,33.122.48.183,1,135,0,0,1,135,1.607627000,0.0000
215.158.239.48,<->,199.39.188.153,1,56,0,0,1,56,1.606698000,0.0000
133.178.226.37,<->,69.31.238.37,1,1357,0,0,1,1357,1.606563000,0.0000
246.253.168.231,<->,27.48.49.149,1,50,0,0,1,50,1.606437000,0.0000
207.86.19.243,<->,80.40.29.132,0,0,1,107,1,107,1.606388000,0.0000
17.136.211.157,<->,8.220.189.81,0,0,1,50,1,50,1.606218000,0.0000
100.182.99.11,<->,20.179.122.167,0,0,1,52,1,52,1.606053000,0.0000
111.150.207.112,<->,8.252.222.106,0,0,1,100,1,100,1.605829000,0.0000
133.178.227.6,<->,69.132.194.25,1,85,0,0,1,85,1.604721000,0.0000
75.62.16.8,<->,20.67.118.211,0,0,1,50,1,50,1.604696000,0.0000
253.244.247.39,<->,20.192.253.166,0,0,1,104,1,104,1.603946000,0.0000
104.137.94.112,<->,100.93.156.236,0,0,1,52,1,52,1.603653000,0.0000
107.124.169.151,<->,20.108.208.6,0,0,1,138,1,138,1.603393000,0.0000
195.18.35.108,<->,20.199.175.244,0,0,1,100,1,100,1.603323000,0.0000
215.158.239.93,<->,196.91.145.97,1,117,0,0,1,117,1.602902000,0.0000
144.75.218.237,<->,143.204.138.237,1,147,0,0,1,147,1.602866000,0.0000
144.75.218.233,<->,139.252.1.240,1,176,0,0,1,176,1.602829000,0.0000
207.79.237.54,<->,80.42.179.14,0,0,1,133,1,133,1.602740000,0.0000
107.27.243.242,<->,92.27.209.223,0,0,1,64,1,64,1.602726000,0.0000
199.33.119.86,<->,50.224.76.234,0,0,1,50,1,50,1.602611000,0.0000
100.122.33.101,<->,8.182.250.109,0,0,1,50,1,50,1.601332000,0.0000
92.27.219.31,<->,48.106.6.25,1,52,0,0,1,52,1.601276000,0.0000
192.64.229.17,<->,125.22.183.127,1,50,0,0,1,50,1.601022000,0.0000
136.25.189.202,<->,96.135.155.57,1,514,0,0,1,514,1.600923000,0.0000
129.224.112.252,<->,6.255.241.212,1,71,0,0,1,71,1.600850000,0.0000
215.158.239.80,<->,80.57.138.196,1,56,0,0,1,56,1.600825000,0.0000
89.183.104.248,<->,65.63.203.208,1,52,0,0,1,52,1.600624000,0.0000
207.6.237.59,<->,50.224.76.234,0,0,1,50,1,50,1.600611000,0.0000
111.150.207.159,<->,99.74.27.37,0,0,1,56,1,56,1.600540000,0.0000
148.145.2.123,<->,80.38.23.182,0,0,1,83,1,83,1.600117000,0.0000
98.67.150.9,<->,54.54.217.193,1,988,0,0,1,988,1.600097000,0.0000
241.193.172.231,<->,20.72.118.59,0,0,1,50,1,50,1.600094000,0.0000
21.15.226.126,<->,20.193.23.151,0,0,1,82,1,82,1.600078000,0.0000
98.129.205.127,<->,50.224.76.201,0,0,1,50,1,50,1.600068000,0.0000
54.54.130.183,<->,8.228.216.104,0,0,1,56,1,56,1.599832000,0.0000
200.174.206.99,<->,54.37.82.231,1,56,0,0,1,56,1.599075000,0.0000
204.200.47.117,<->,136.25.188.53,0,0,1,50,1,50,1.599053000,0.0000
215.158.239.76,<->,195.55.143.134,1,56,0,0,1,56,1.598659000,0.0000
139.205.45.247,<->,80.27.157.131,0,0,1,50,1,50,1.598426000,0.0000
104.232.149.213,<->,92.27.219.242,0,0,1,1470,1,1470,1.598402000,0.0000
112.6.230.243,<->,39.33.57.111,0,0,1,52,1,52,1.598395000,0.0000
145.3.142.7,<->,39.237.228.149,0,0,1,64,1,64,1.598392000,0.0000
247.136.245.208,<->,38.164.213.201,1,80,0,0,1,80,1.598283000,0.0000
215.158.197.2,<->,29.211.214.32,0,0,1,95,1,95,1.597690000,0.0000
144.75.218.237,<->,132.107.75.195,1,139,0,0,1,139,1.597683000,0.0000
193.46.97.52,<->,144.75.218.241,0,0,1,255,1,255,1.597646000,0.0000
215.158.239.96,<->,196.108.60.23,1,56,0,0,1,56,1.597497000,0.0000
229.69.133.160,<->,192.67.157.233,0,0,1,52,1,52,1.597348000,0.0000
241.193.172.231,<->,20.49.68.5,0,0,1,50,1,50,1.597068000,0.0000
223.146.105.210,<->,39.203.182.22,0,0,1,56,1,56,1.597066000,0.0000
207.82.255.101,<->,100.94.116.200,0,0,1,133,1,133,1.596787000,0.0000
207.7.124.235,<->,92.27.194.147,0,0,1,56,1,56,1.596724000,0.0000
248.239.72.227,<->,230.126.217.254,1,52,0,0,1,52,1.596537000,0.0000
20.13.110.159,<->,0.200.50.50,1,60,0,0,1,60,1.596399000,0.0000
208.197.123.108,<->,144.75.218.237,0,0,1,173,1,173,1.596277000,0.0000
101.106.122.69,<->,92.27.219.153,0,0,1,135,1,135,1.596082000,0.0000
192.64.229.25,<->,121.229.58.235,1,56,0,0,1,56,1.595914000,0.0000
148.174.57.174,<->,20.253.43.110,0,0,1,75,1,75,1.595799000,0.0000
215.158.103.219,<->,138.12.41.133,1,260,0,0,1,260,1.595636000,0.0000
8.49.69.216,<->,6.74.82.148,0,0,1,382,1,382,1.595535000,0.0000
215.158.239.49,<->,204.2.135.179,1,1099,0,0,1,1099,1.595446000,0.0000
132.43.156.81,<->,99.72.128.44,0,0,1,140,1,140,1.594971000,0.0000
145.164.64.60,<->,8.52.171.31,0,0,1,50,1,50,1.594841000,0.0000
126.224.70.25,<->,20.10.65.165,0,0,1,64,1,64,1.594820000,0.0000
80.56.91.244,<->,8.176.8.66,0,0,1,1112,1,1112,1.594815000,0.0000
215.158.239.56,<->,196.95.53.228,1,50,0,0,1,50,1.594623000,0.0000
143.134.244.58,<->,136.25.188.255,0,0,1,50,1,50,1.594599000,0.0000
215.158.239.70,<->,199.20.29.19,1,64,0,0,1,64,1.594397000,0.0000
76.72.228.64,<->,39.164.106.133,0,0,1,64,1,64,1.594217000,0.0000
105.78.55.110,<->,20.83.50.217,0,0,1,64,1,64,1.594121000,0.0000
108.42.106.231,<->,20.83.31.66,0,0,1,66,1,66,1.594100000,0.0000
126.224.233.68,<->,20.29.190.130,0,0,1,64,1,64,1.594091000,0.0000
220.187.88.96,<->,92.27.219.166,0,0,1,101,1,101,1.593879000,0.0000
133.178.226.161,<->,50.50.242.205,1,86,0,0,1,86,1.593203000,0.0000
215.158.238.241,<->,89.76.109.244,1,1357,0,0,1,1357,1.593059000,0.0000
125.207.112.141,<->,92.27.219.193,0,0,1,52,1,52,1.592773000,0.0000
50.224.76.234,<->,38.255.244.151,1,56,0,0,1,56,1.592718000,0.0000
215.158.239.68,<->,199.20.31.231,1,56,0,0,1,56,1.592605000,0.0000
215.158.239.86,<->,195.83.104.137,1,50,0,0,1,50,1.591887000,0.0000
204.1.195.12,<->,136.25.188.236,0,0,1,107,1,107,1.591762000,0.0000
192.170.150.50,<->,6.73.247.16,0,0,1,704,1,704,1.591715000,0.0000
75.62.16.8,<->,39.232.239.46,0,0,1,50,1,50,1.591479000,0.0000
152.139.138.6,<->,20.65.179.36,0,0,1,120,1,120,1.591441000,0.0000
215.158.239.96,<->,207.60.79.10,1,56,0,0,1,56,1.591236000,0.0000
210.158.44.7,<->,112.219.53.218,1,101,0,0,1,101,1.591226000,0.0000
80.42.162.247,<->,8.20.81.3,1,56,0,0,1,56,1.591211000,0.0000
215.158.140.228,<->,83.224.121.185,1,50,0,0,1,50,1.590999000,0.0000
144.75.218.235,<->,54.38.169.95,1,126,0,0,1,126,1.590857000,0.0000
207.236.236.50,<->,136.25.188.252,0,0,1,50,1,50,1.590779000,0.0000
100.182.99.11,<->,20.179.122.183,0,0,1,52,1,52,1.590324000,0.0000
35.56.97.170,<->,33.238.199.104,1,56,0,0,1,56,1.590026000,0.0000
244.50.133.60,<->,39.4.169.213,0,0,1,50,1,50,1.589983000,0.0000
215.158.239.76,<->,142.254.64.146,1,64,0,0,1,64,1.589858000,0.0000
149.99.133.169,<->,39.131.216.132,0,0,1,75,1,75,1.589670000,0.0000
215.158.239.56,<->,199.20.30.0,1,64,0,0,1,64,1.589640000,0.0000
196.83.184.54,<->,39.133.102.99,0,0,1,100,1,100,1.589605000,0.0000
98.67.137.59,<->,53.69.76.224,1,56,0,0,1,56,1.589388000,0.0000
143.72.126.147,<->,136.25.188.176,0,0,1,295,1,295,1.589348000,0.0000
205.122.195.32,<->,8.220.198.219,0,0,1,704,1,704,1.589187000,0.0000
110.243.222.128,<->,92.27.27.144,0,0,1,135,1,135,1.589025000,0.0000
111.151.142.231,<->,101.65.255.235,0,0,1,100,1,100,1.589003000,0.0000
144.75.218.237,<->,138.127.224.106,1,351,0,0,1,351,1.588698000,0.0000
109.1.16.32,<->,27.188.163.162,1,444,0,0,1,444,1.588608000,0.0000
215.158.140.184,<->,107.236.158.8,1,56,0,0,1,56,1.588127000,0.0000
199.33.117.166,<->,136.25.188.241,0,0,1,50,1,50,1.588064000,0.0000
202.178.8.208,<->,137.21.3.65,0,0,1,78,1,78,1.587992000,0.0000
215.158.238.123,<->,69.150.169.224,1,1133,0,0,1,1133,1.587699000,0.0000
106.126.193.90,<->,92.27.27.165,0,0,1,52,1,52,1.587580000,0.0000
244.50.133.60,<->,39.4.223.48,0,0,1,50,1,50,1.587542000,0.0000
124.119.26.152,<->,39.160.108.83,0,0,1,70,1,70,1.587476000,0.0000
139.163.71.59,<->,38.72.138.91,1,50,0,0,1,50,1.587471000,0.0000
144.75.218.241,<->,96.129.66.231,1,100,0,0,1,100,1.587376000,0.0000
159.81.94.27,<->,159.42.43.78,1,56,0,0,1,56,1.587262000,0.0000
42.91.85.54,<->,39.52.38.25,0,0,1,52,1,52,1.587257000,0.0000
98.232.172.60,<->,38.93.187.200,1,84,0,0,1,84,1.587233000,0.0000
93.181.154.55,<->,92.27.219.18,0,0,1,263,1,263,1.587113000,0.0000
145.252.126.19,<->,129.252.19.109,1,64,0,0,1,64,1.587040000,0.0000
152.111.129.170,<->,109.0.243.153,0,0,1,133,1,133,1.586983000,0.0000
255.133.229.164,<->,39.220.108.12,0,0,1,100,1,100,1.586956000,0.0000
100.182.67.204,<->,8.52.163.19,0,0,1,50,1,50,1.586952000,0.0000
241.193.172.231,<->,20.82.2.41,0,0,1,50,1,50,1.586929000,0.0000
121.36.81.175,<->,92.27.219.244,0,0,1,52,1,52,1.586829000,0.0000
159.64.148.27,<->,80.38.7.6,0,0,1,73,1,73,1.586101000,0.0000
57.156.192.130,<->,20.56.46.101,0,0,1,68,1,68,1.585617000,0.0000
159.224.185.221,<->,8.52.183.58,0,0,1,50,1,50,1.585591000,0.0000
198.158.197.83,<->,20.173.221.71,0,0,1,50,1,50,1.585539000,0.0000
241.193.172.231,<->,20.240.112.77,0,0,1,50,1,50,1.585330000,0.0000
109.1.16.130,<->,27.188.163.162,1,443,0,0,1,443,1.585328000,0.0000
97.126.113.124,<->,20.149.248.50,1,75,0,0,1,75,1.585099000,0.0000
235.149.63.46,<->,136.25.188.105,0,0,1,534,1,534,1.584890000,0.0000
144.75.218.235,<->,128.124.28.90,1,126,0,0,1,126,1.584701000,0.0000
243.117.125.52,<->,129.224.112.252,0,0,1,76,1,76,1.584701000,0.0000
196.30.1.198,<->,20.135.40.102,0,0,1,64,1,64,1.584586000,0.0000
255.133.229.164,<->,39.169.17.209,0,0,1,100,1,100,1.584573000,0.0000
198.158.197.83,<->,20.115.78.13,0,0,1,50,1,50,1.584131000,0.0000
215.158.239.33,<->,149.96.53.39,1,1492,0,0,1,1492,1.582955000,0.0000
98.198.28.253,<->,8.53.11.58,0,0,1,84,1,84,1.582798000,0.0000
111.151.107.247,<->,8.176.8.191,0,0,1,154,1,154,1.582332000,0.0000
97.199.179.77,<->,53.148.22.166,1,125,0,0,1,125,1.581895000,0.0000
111.146.139.157,<->,53.148.24.110,1,125,0,0,1,125,1.581793000,0.0000
215.158.238.141,<->,104.3.169.122,1,1149,0,0,1,1149,1.581131000,0.0000
192.64.215.241,<->,0.236.1.58,1,130,0,0,1,130,1.581009000,0.0000
103.186.213.175,<->,20.30.19.163,0,0,1,60,1,60,1.580952000,0.0000
241.193.172.231,<->,20.45.143.57,0,0,1,50,1,50,1.580919000,0.0000
204.187.66.34,<->,136.25.188.55,0,0,1,50,1,50,1.580662000,0.0000
249.85.53.53,<->,144.75.218.246,0,0,1,155,1,155,1.580476000,0.0000
132.123.44.18,<->,8.37.248.140,1,56,0,0,1,56,1.580227000,0.0000
89.183.104.131,<->,64.214.54.11,1,56,0,0,1,56,1.580152000,0.0000
133.178.226.19,<->,126.219.190.132,1,1197,0,0,1,1197,1.580096000,0.0000
111.151.109.46,<->,8.252.223.247,0,0,1,100,1,100,1.579873000,0.0000
158.162.95.63,<->,39.26.173.111,0,0,1,52,1,52,1.579855000,0.0000
204.182.95.230,<->,39.142.105.230,0,0,1,98,1,98,1.579457000,0.0000
193.46.99.193,<->,101.70.98.5,0,0,1,300,1,300,1.579447000,0.0000
192.242.74.229,<->,20.206.185.169,0,0,1,96,1,96,1.579382000,0.0000
204.58.253.15,<->,136.25.188.243,0,0,1,50,1,50,1.579199000,0.0000
115.190.178.7,<->,80.41.31.15,0,0,1,52,1,52,1.579153000,0.0000
194.233.13.74,<->,136.25.188.178,0,0,1,56,1,56,1.578736000,0.0000
133.54.28.219,<->,119.5.13.52,1,79,0,0,1,79,1.578524000,0.0000
221.58.3.168,<->,136.25.188.161,0,0,1,50,1,50,1.578211000,0.0000
112.165.137.197,<->,99.74.48.23,0,0,1,64,1,64,1.577909000,0.0000
89.183.106.30,<->,42.119.36.141,1,64,0,0,1,64,1.577832000,0.0000
86.151.231.2,<->,8.220.177.253,0,0,1,704,1,704,1.577785000,0.0000
17.136.211.157,<->,8.220.181.167,0,0,1,56,1,56,1.577781000,0.0000
38.21.156.204,<->,20.232.230.97,0,0,1,82,1,82,1.577444000,0.0000
136.25.188.105,<->,128.171.253.114,1,87,0,0,1,87,1.577350000,0.0000
115.188.244.99,<->,80.41.8.174,0,0,1,84,1,84,1.577176000,0.0000
116.227.172.225,<->,20.134.11.149,0,0,1,88,1,88,1.576926000,0.0000
215.158.239.87,<->,196.94.227.74,1,68,0,0,1,68,1.576763000,0.0000
136.95.254.242,<->,136.25.188.40,0,0,1,103,1,103,1.576500000,0.0000
199.72.62.245,<->,136.25.188.197,0,0,1,129,1,129,1.576305000,0.0000
206.130.208.12,<->,8.228.208.40,0,0,1,97,1,97,1.576173000,0.0000
139.249.90.204,<->,92.27.51.139,1,80,0,0,1,80,1.576146000,0.0000
159.146.64.210,<->,109.1.13.143,0,0,1,91,1,91,1.575586000,0.0000
142.208.38.53,<->,136.25.188.175,0,0,1,64,1,64,1.575363000,0.0000
50.49.88.242,<->,8.52.169.61,0,0,1,50,1,50,1.575249000,0.0000
204.200.50.113,<->,136.25.188.46,0,0,1,132,1,132,1.574848000,0.0000
215.158.103.219,<->,193.119.135.81,1,162,0,0,1,162,1.574744000,0.0000
106.225.62.213,<->,20.181.110.138,0,0,1,56,1,56,1.574545000,0.0000
53.187.46.37,<->,39.15.169.14,0,0,1,88,1,88,1.574316000,0.0000
107.10.167.97,<->,8.52.249.199,0,0,1,50,1,50,1.574292000,0.0000
248.239.149.59,<->,123.237.154.160,1,319,0,0,1,319,1.574246000,0.0000
100.182.99.11,<->,20.179.122.210,0,0,1,52,1,52,1.574150000,0.0000
101.106.122.69,<->,89.183.104.239,0,0,1,99,1,99,1.574081000,0.0000
98.67.155.63,<->,53.176.119.172,1,125,0,0,1,125,1.573979000,0.0000
80.38.16.208,<->,66.63.106.149,1,50,0,0,1,50,1.573658000,0.0000
199.15.22.238,<->,136.25.188.225,0,0,1,68,1,68,1.573527000,0.0000
144.75.218.233,<->,137.250.6.109,1,108,0,0,1,108,1.573384000,0.0000
126.224.233.68,<->,20.29.190.143,0,0,1,64,1,64,1.573244000,0.0000
145.242.126.178,<->,53.77.205.113,1,220,0,0,1,220,1.573017000,0.0000
50.186.19.114,<->,48.53.216.116,0,0,1,120,1,120,1.572792000,0.0000
215.158.239.49,<->,207.16.229.237,1,117,0,0,1,117,1.572362000,0.0000
194.210.146.134,<->,50.224.76.235,0,0,1,56,1,56,1.572336000,0.0000
251.24.48.90,<->,100.93.135.55,0,0,1,52,1,52,1.572279000,0.0000
215.158.239.56,<->,196.93.180.237,1,56,0,0,1,56,1.571957000,0.0000
215.158.239.56,<->,199.14.12.169,1,801,0,0,1,801,1.571950000,0.0000
128.146.85.176,<->,50.224.96.35,0,0,1,68,1,68,1.571893000,0.0000
101.70.114.108,<->,59.150.70.161,1,64,0,0,1,64,1.571876000,0.0000
220.55.123.183,<->,126.231.183.55,1,84,0,0,1,84,1.571488000,0.0000
141.37.242.255,<->,92.27.219.238,0,0,1,133,1,133,1.570337000,0.0000
142.227.35.32,<->,136.25.188.222,0,0,1,50,1,50,1.570275000,0.0000
195.65.1.162,<->,101.224.204.141,0,0,1,91,1,91,1.570239000,0.0000
144.75.218.235,<->,138.127.231.195,1,276,0,0,1,276,1.570212000,0.0000
204.63.69.130,<->,136.25.188.53,0,0,1,825,1,825,1.570130000,0.0000
244.50.133.60,<->,20.181.76.242,0,0,1,50,1,50,1.570010000,0.0000
89.183.104.182,<->,29.220.173.205,1,1434,0,0,1,1434,1.569889000,0.0000
204.63.195.164,<->,136.25.188.253,0,0,1,68,1,68,1.569857000,0.0000
215.158.140.177,<->,97.59.52.60,1,50,0,0,1,50,1.569746000,0.0000
215.158.239.49,<->,196.90.198.150,1,260,0,0,1,260,1.569586000,0.0000
149.167.2.14,<->,8.43.154.198,0,0,1,64,1,64,1.569020000,0.0000
117.40.68.126,<->,92.27.27.99,0,0,1,64,1,64,1.568613000,0.0000
196.88.181.167,<->,50.224.76.235,0,0,1,56,1,56,1.568410000,0.0000
196.148.4.163,<->,53.243.94.43,1,64,0,0,1,64,1.568265000,0.0000
98.23.111.141,<->,92.27.209.104,0,0,1,50,1,50,1.568212000,0.0000
149.133.155.217,<->,8.220.181.149,0,0,1,50,1,50,1.568127000,0.0000
50.157.72.242,<->,20.193.129.246,0,0,1,56,1,56,1.567546000,0.0000
144.75.218.235,<->,53.214.223.92,1,93,0,0,1,93,1.567525000,0.0000
105.133.122.237,<->,20.121.152.128,0,0,1,64,1,64,1.567441000,0.0000
192.67.175.129,<->,134.94.29.164,1,56,0,0,1,56,1.567192000,0.0000
248.239.158.247,<->,231.255.222.140,1,50,0,0,1,50,1.567136000,0.0000
196.107.118.140,<->,20.0.254.190,0,0,1,107,1,107,1.566583000,0.0000
80.56.91.244,<->,6.73.247.8,0,0,1,1112,1,1112,1.566556000,0.0000
201.216.164.96,<->,39.2.106.177,0,0,1,64,1,64,1.566311000,0.0000
144.87.238.89,<->,80.38.19.223,0,0,1,50,1,50,1.566276000,0.0000
29.213.216.193,<->,8.52.171.60,0,0,1,1002,1,1002,1.565933000,0.0000
210.156.112.182,<->,157.208.214.27,1,130,0,0,1,130,1.565717000,0.0000
141.185.45.159,<->,136.25.188.177,0,0,1,56,1,56,1.565669000,0.0000
241.193.172.231,<->,20.127.234.170,0,0,1,50,1,50,1.565669000,0.0000
144.64.137.156,<->,100.225.82.253,1,83,0,0,1,83,1.565586000,0.0000
194.192.45.212,<->,100.92.117.152,0,0,1,52,1,52,1.565293000,0.0000
249.101.211.202,<->,53.214.126.11,1,93,0,0,1,93,1.565289000,0.0000
215.158.61.191,<->,136.25.189.243,0,0,1,781,1,781,1.564774000,0.0000
20.13.110.112,<->,0.200.50.50,1,60,0,0,1,60,1.564647000,0.0000
100.182.99.11,<->,20.179.123.25,0,0,1,52,1,52,1.564575000,0.0000
101.224.183.152,<->,92.169.158.35,1,87,0,0,1,87,1.564495000,0.0000
215.158.61.192,<->,8.252.221.213,0,0,1,56,1,56,1.564370000,0.0000
143.12.99.207,<->,136.25.188.241,0,0,1,64,1,64,1.564091000,0.0000
144.232.207.19,<->,8.182.224.87,0,0,1,50,1,50,1.563966000,0.0000
215.158.239.96,<->,143.135.22.62,1,56,0,0,1,56,1.563844000,0.0000
202.33.47.14,<->,136.25.188.236,0,0,1,50,1,50,1.563823000,0.0000
73.118.63.24,<->,8.252.222.224,0,0,1,56,1,56,1.563604000,0.0000
196.148.4.163,<->,53.243.94.251,1,64,0,0,1,64,1.563015000,0.0000
231.138.53.226,<->,136.25.188.252,0,0,1,64,1,64,1.562982000,0.0000
195.39.175.170,<->,20.249.182.33,0,0,1,64,1,64,1.562683000,0.0000
222.20.221.15,<->,20.207.99.127,0,0,1,64,1,64,1.562452000,0.0000
246.254.97.149,<->,48.131.156.46,1,93,0,0,1,93,1.562242000,0.0000
66.244.79.32,<->,16.137.241.141,0,0,1,68,1,68,1.562149000,0.0000
133.178.227.235,<->,111.150.207.59,1,56,0,0,1,56,1.562042000,0.0000
148.26.203.60,<->,89.183.104.136,0,0,1,367,1,367,1.562017000,0.0000
139.193.141.132,<->,27.83.49.190,1,50,0,0,1,50,1.561999000,0.0000
215.158.239.218,<->,126.219.197.235,1,90,0,0,1,90,1.561974000,0.0000
126.219.197.235,<->,99.74.87.243,0,0,1,91,1,91,1.561885000,0.0000
144.95.158.205,<->,144.75.218.242,0,0,1,126,1,126,1.561594000,0.0000
133.178.227.165,<->,112.40.39.255,1,704,0,0,1,704,1.561585000,0.0000
131.210.124.194,<->,89.183.104.255,0,0,1,62,1,62,1.561532000,0.0000
210.228.29.4,<->,139.163.13.117,0,0,1,113,1,113,1.561450000,0.0000
215.158.239.56,<->,142.228.224.77,1,52,0,0,1,52,1.561051000,0.0000
135.243.190.253,<->,8.52.169.61,0,0,1,50,1,50,1.560887000,0.0000
218.4.180.66,<->,8.20.81.32,1,56,0,0,1,56,1.560660000,0.0000
195.4.107.6,<->,136.25.188.174,0,0,1,56,1,56,1.560455000,0.0000
143.135.13.76,<->,136.25.188.243,0,0,1,678,1,678,1.560240000,0.0000
196.121.84.74,<->,39.12.217.192,0,0,1,64,1,64,1.560146000,0.0000
109.1.31.44,<->,40.204.4.71,1,351,0,0,1,351,1.560071000,0.0000
144.83.60.153,<->,92.162.253.43,0,0,1,627,1,627,1.560038000,0.0000
144.75.218.233,<->,100.185.121.91,1,128,0,0,1,128,1.559870000,0.0000
101.65.240.218,<->,56.114.235.120,1,50,0,0,1,50,1.559559000,0.0000
120.116.159.59,<->,39.27.119.156,0,0,1,64,1,64,1.559131000,0.0000
204.186.42.147,<->,136.25.188.53,0,0,1,765,1,765,1.559008000,0.0000
125.198.243.52,<->,20.132.131.36,0,0,1,52,1,52,1.558914000,0.0000
50.224.121.116,<->,6.124.44.105,1,70,0,0,1,70,1.558765000,0.0000
136.25.188.212,<->,111.20.61.178,1,80,0,0,1,80,1.558701000,0.0000
143.89.172.107,<->,136.25.188.236,0,0,1,56,1,56,1.558039000,0.0000
215.158.238.145,<->,136.169.91.98,1,1064,0,0,1,1064,1.558025000,0.0000
20.13.110.101,<->,0.200.50.50,1,60,0,0,1,60,1.557996000,0.0000
192.171.13.190,<->,8.252.222.118,0,0,1,128,1,128,1.557869000,0.0000
144.75.218.237,<->,138.127.230.213,1,177,0,0,1,177,1.557167000,0.0000
117.61.60.232,<->,20.163.203.39,0,0,1,64,1,64,1.557099000,0.0000
146.226.246.84,<->,129.224.112.252,0,0,1,66,1,66,1.556932000,0.0000
148.213.184.134,<->,39.163.210.75,0,0,1,95,1,95,1.556841000,0.0000
139.241.75.106,<->,136.25.188.212,0,0,1,134,1,134,1.556803000,0.0000
244.50.241.190,<->,20.25.136.252,0,0,1,50,1,50,1.556369000,0.0000
144.75.218.235,<->,138.127.225.87,1,355,0,0,1,355,1.556160000,0.0000
251.24.245.5,<->,8.250.159.134,0,0,1,52,1,52,1.556027000,0.0000
244.50.136.175,<->,20.133.196.254,0,0,1,50,1,50,1.555930000,0.0000
220.55.175.210,<->,98.23.111.141,1,50,0,0,1,50,1.555768000,0.0000
199.25.247.19,<->,92.27.8.182,0,0,1,162,1,162,1.554744000,0.0000
144.122.240.230,<->,144.108.64.181,1,67,0,0,1,67,1.554649000,0.0000
134.97.242.140,<->,92.27.219.41,0,0,1,52,1,52,1.554629000,0.0000
75.62.16.8,<->,20.149.153.242,0,0,1,50,1,50,1.554553000,0.0000
143.22.127.186,<->,20.238.50.141,0,0,1,72,1,72,1.554499000,0.0000
255.133.225.73,<->,255.133.225.3,0,0,1,168,1,168,1.554212000,0.0000
246.253.135.36,<->,32.218.153.233,1,50,0,0,1,50,1.553957000,0.0000
196.148.4.163,<->,53.243.94.129,1,64,0,0,1,64,1.553938000,0.0000
195.65.65.233,<->,8.182.250.65,0,0,1,50,1,50,1.553795000,0.0000
133.135.214.46,<->,129.6.83.11,0,0,1,253,1,253,1.553123000,0.0000
80.40.31.154,<->,58.164.24.130,1,130,0,0,1,130,1.553057000,0.0000
121.73.90.20,<->,80.40.45.77,0,0,1,52,1,52,1.552771000,0.0000
215.158.239.253,<->,80.56.91.244,1,1112,0,0,1,1112,1.552571000,0.0000
109.222.214.116,<->,29.94.101.68,1,325,0,0,1,325,1.551803000,0.0000
210.209.251.211,<->,137.137.105.214,0,0,1,50,1,50,1.551785000,0.0000
247.136.252.191,<->,198.182.27.178,1,133,0,0,1,133,1.551632000,0.0000
207.72.122.121,<->,8.252.222.142,0,0,1,56,1,56,1.551626000,0.0000
111.151.142.129,<->,99.74.26.165,0,0,1,56,1,56,1.551479000,0.0000
136.14.215.87,<->,8.182.244.237,0,0,1,50,1,50,1.551456000,0.0000
129.224.112.252,<->,100.185.124.124,1,61,0,0,1,61,1.550413000,0.0000
92.27.219.244,<->,27.77.34.89,1,50,0,0,1,50,1.550404000,0.0000
92.180.16.22,<->,89.183.104.172,0,0,1,52,1,52,1.550215000,0.0000
142.105.212.148,<->,39.1.99.125,0,0,1,52,1,52,1.549993000,0.0000
116.254.112.84,<->,89.183.104.154,0,0,1,53,1,53,1.549812000,0.0000
144.75.218.235,<->,138.127.231.213,1,240,0,0,1,240,1.549539000,0.0000
53.91.176.230,<->,6.95.141.246,0,0,1,111,1,111,1.549536000,0.0000
123.157.236.45,<->,20.255.192.44,0,0,1,64,1,64,1.549532000,0.0000
100.50.100.169,<->,8.252.223.203,0,0,1,97,1,97,1.549388000,0.0000
138.53.86.206,<->,129.224.112.252,0,0,1,62,1,62,1.549019000,0.0000
133.178.227.246,<->,8.35.106.240,1,988,0,0,1,988,1.548939000,0.0000
20.174.38.113,<->,0.83.228.26,1,64,0,0,1,64,1.548795000,0.0000
132.249.70.213,<->,101.229.93.34,1,106,0,0,1,106,1.548777000,0.0000
131.5.161.231,<->,20.178.191.190,0,0,1,52,1,52,1.548672000,0.0000
145.3.142.7,<->,39.237.228.167,0,0,1,64,1,64,1.548414000,0.0000
142.209.130.161,<->,136.25.188.44,0,0,1,68,1,68,1.548343000,0.0000
102.82.77.160,<->,92.27.219.53,0,0,1,300,1,300,1.547896000,0.0000
89.183.104.242,<->,38.242.5.161,1,80,0,0,1,80,1.547647000,0.0000
80.42.199.36,<->,8.45.170.216,1,56,0,0,1,56,1.547403000,0.0000
133.178.226.18,<->,61.35.22.166,1,1357,0,0,1,1357,1.547396000,0.0000
111.146.169.0,<->,33.219.156.216,1,138,0,0,1,138,1.547284000,0.0000
143.135.41.59,<->,136.25.188.163,0,0,1,64,1,64,1.547270000,0.0000
215.158.239.69,<->,199.20.30.68,1,765,0,0,1,765,1.546674000,0.0000
111.151.109.41,<->,8.252.223.137,0,0,1,100,1,100,1.546517000,0.0000
104.216.222.133,<->,39.148.99.213,0,0,1,52,1,52,1.546445000,0.0000
204.89.88.29,<->,100.92.2.248,0,0,1,56,1,56,1.546375000,0.0000
146.15.20.243,<->,139.254.214.115,0,0,1,50,1,50,1.546245000,0.0000
109.222.223.88,<->,57.191.84.224,1,75,0,0,1,75,1.546137000,0.0000
252.98.129.41,<->,123.165.236.76,1,64,0,0,1,64,1.546112000,0.0000
199.123.43.28,<->,136.25.188.198,0,0,1,56,1,56,1.545930000,0.0000
119.115.173.150,<->,111.147.164.221,0,0,1,61,1,61,1.545913000,0.0000
206.96.216.84,<->,50.224.76.234,0,0,1,50,1,50,1.545905000,0.0000
192.64.201.230,<->,40.221.208.240,1,102,0,0,1,102,1.545607000,0.0000
197.229.163.191,<->,39.230.77.30,0,0,1,64,1,64,1.545582000,0.0000
244.50.249.107,<->,20.124.208.54,0,0,1,50,1,50,1.545523000,0.0000
118.119.253.178,<->,89.183.104.237,0,0,1,260,1,260,1.545261000,0.0000
204.63.59.226,<->,136.25.188.176,0,0,1,56,1,56,1.545222000,0.0000
238.127.3.152,<->,220.55.174.117,0,0,1,57,1,57,1.545204000,0.0000
92.27.219.138,<->,48.105.8.84,1,56,0,0,1,56,1.545168000,0.0000
139.105.159.223,<->,114.88.250.79,1,95,0,0,1,95,1.545052000,0.0000
131.208.217.29,<->,39.146.43.127,0,0,1,74,1,74,1.544869000,0.0000
130.122.183.251,<->,8.43.217.33,0,0,1,50,1,50,1.544725000,0.0000
147.177.54.28,<->,34.245.12.50,0,0,1,80,1,80,1.544642000,0.0000
119.103.17.195,<->,89.183.104.173,0,0,1,263,1,263,1.544546000,0.0000
215.158.103.206,<->,159.151.93.228,1,120,0,0,1,120,1.544044000,0.0000
192.67.167.86,<->,103.132.197.0,1,52,0,0,1,52,1.543994000,0.0000
130.173.16.208,<->,39.235.152.130,0,0,1,67,1,67,1.543878000,0.0000
215.158.239.71,<->,126.219.49.136,1,1213,0,0,1,1213,1.543247000,0.0000
141.92.221.22,<->,129.224.112.252,0,0,1,74,1,74,1.543104000,0.0000
194.218.9.246,<->,99.75.65.137,0,0,1,112,1,112,1.543009000,0.0000
215.158.239.56,<->,199.20.28.191,1,76,0,0,1,76,1.542958000,0.0000
98.23.96.87,<->,89.183.104.227,0,0,1,56,1,56,1.542712000,0.0000
220.202.52.77,<->,92.27.219.54,0,0,1,317,1,317,1.542598000,0.0000
139.163.26.146,<->,117.130.31.76,1,111,0,0,1,111,1.542576000,0.0000
199.82.215.142,<->,136.25.188.44,0,0,1,89,1,89,1.542433000,0.0000
149.50.187.76,<->,20.199.243.196,0,0,1,64,1,64,1.541866000,0.0000
206.195.34.165,<->,8.52.134.221,0,0,1,56,1,56,1.541658000,0.0000
100.182.99.11,<->,20.179.124.36,0,0,1,52,1,52,1.541470000,0.0000
100.182.99.11,<->,20.179.124.56,0,0,1,52,1,52,1.541456000,0.0000
135.87.163.103,<->,92.27.27.148,0,0,1,135,1,135,1.541453000,0.0000
205.236.111.245,<->,92.27.27.165,0,0,1,52,1,52,1.541242000,0.0000
127.254.164.47,<->,20.238.205.133,0,0,1,52,1,52,1.541223000,0.0000
80.41.53.34,<->,40.202.64.181,1,158,0,0,1,158,1.540726000,0.0000
246.253.253.213,<->,142.178.7.13,1,50,0,0,1,50,1.540605000,0.0000
207.58.55.6,<->,136.25.188.54,0,0,1,129,1,129,1.540323000,0.0000
132.103.198.195,<->,119.121.24.104,1,64,0,0,1,64,1.540313000,0.0000
159.112.9.198,<->,139.249.95.234,0,0,1,50,1,50,1.540305000,0.0000
137.68.217.95,<->,20.209.165.121,0,0,1,64,1,64,1.540068000,0.0000
100.123.121.233,<->,80.40.55.24,0,0,1,50,1,50,1.539933000,0.0000
136.50.56.221,<->,6.122.155.162,0,0,1,50,1,50,1.539875000,0.0000
106.219.100.218,<->,92.27.219.175,0,0,1,373,1,373,1.539691000,0.0000
144.75.218.242,<->,138.127.224.106,1,351,0,0,1,351,1.539606000,0.0000
105.116.240.79,<->,50.224.76.234,0,0,1,56,1,56,1.539462000,0.0000
39.38.26.213,<->,0.52.16.104,1,94,0,0,1,94,1.539307000,0.0000
221.102.103.73,<->,207.23.66.140,1,50,0,0,1,50,1.539144000,0.0000
215.158.239.56,<->,199.15.116.154,1,781,0,0,1,781,1.538912000,0.0000
137.171.199.224,<->,126.219.141.190,1,99,0,0,1,99,1.538803000,0.0000
198.158.197.83,<->,20.234.241.193,0,0,1,50,1,50,1.538755000,0.0000
98.23.96.86,<->,89.183.104.227,0,0,1,56,1,56,1.538574000,0.0000
136.25.188.105,<->,112.60.14.238,1,233,0,0,1,233,1.538444000,0.0000
97.243.206.157,<->,89.183.104.227,0,0,1,56,1,56,1.538410000,0.0000
21.15.226.126,<->,20.193.24.49,0,0,1,82,1,82,1.537970000,0.0000
111.151.142.246,<->,99.74.26.117,0,0,1,56,1,56,1.537777000,0.0000
113.23.56.112,<->,8.220.193.21,0,0,1,704,1,704,1.537635000,0.0000
210.156.125.55,<->,59.46.180.152,1,133,0,0,1,133,1.537618000,0.0000
141.185.45.159,<->,136.25.188.174,0,0,1,56,1,56,1.537594000,0.0000
247.136.180.110,<->,42.68.246.99,1,50,0,0,1,50,1.537374000,0.0000
207.190.36.143,<->,136.25.188.177,0,0,1,50,1,50,1.536877000,0.0000
100.182.99.11,<->,20.179.124.49,0,0,1,52,1,52,1.536853000,0.0000
56.121.47.18,<->,54.46.185.4,1,56,0,0,1,56,1.536572000,0.0000
129.254.99.157,<->,129.224.112.252,0,0,1,68,1,68,1.536338000,0.0000
139.163.68.55,<->,138.126.101.172,1,51,0,0,1,51,1.536333000,0.0000
124.113.103.168,<->,92.27.219.50,0,0,1,56,1,56,1.536300000,0.0000
89.216.126.106,<->,29.143.180.235,1,138,0,0,1,138,1.536206000,0.0000
215.158.103.219,<->,206.226.66.178,1,84,0,0,1,84,1.535867000,0.0000
148.139.107.99,<->,39.0.193.227,0,0,1,74,1,74,1.535490000,0.0000
218.4.176.103,<->,8.20.81.65,1,92,0,0,1,92,1.535475000,0.0000
126.207.139.3,<->,20.8.210.209,0,0,1,50,1,50,1.535436000,0.0000
145.16.77.164,<->,143.174.17.44,1,56,0,0,1,56,1.535187000,0.0000
100.182.99.11,<->,20.179.124.5,0,0,1,52,1,52,1.534840000,0.0000
148.241.93.224,<->,89.139.241.98,0,0,1,190,1,190,1.534593000,0.0000
194.207.25.148,<->,20.89.130.239,0,0,1,64,1,64,1.534440000,0.0000
95.245.72.124,<->,8.252.221.222,0,0,1,50,1,50,1.534044000,0.0000
137.173.8.122,<->,8.53.0.175,0,0,1,50,1,50,1.533614000,0.0000
247.136.208.244,<->,127.87.18.39,1,52,0,0,1,52,1.532853000,0.0000
98.67.141.11,<->,53.190.201.207,1,172,0,0,1,172,1.532829000,0.0000
123.136.84.103,<->,89.183.104.156,0,0,1,321,1,321,1.532729000,0.0000
116.235.64.146,<->,89.183.104.243,0,0,1,62,1,62,1.532549000,0.0000
224.154.101.235,<->,20.202.18.54,0,0,1,50,1,50,1.532395000,0.0000
149.50.187.76,<->,20.199.243.203,0,0,1,64,1,64,1.532361000,0.0000
195.56.165.122,<->,8.52.176.241,0,0,1,56,1,56,1.532346000,0.0000
210.221.111.210,<->,106.170.251.39,1,100,0,0,1,100,1.532321000,0.0000
207.162.181.164,<->,8.182.251.218,0,0,1,50,1,50,1.532001000,0.0000
198.33.76.44,<->,89.183.104.225,0,0,1,68,1,68,1.531955000,0.0000
215.158.239.56,<->,196.0.149.119,1,56,0,0,1,56,1.531859000,0.0000
139.163.26.146,<->,50.163.241.220,1,99,0,0,1,99,1.531279000,0.0000
144.75.218.242,<->,138.127.230.47,1,366,0,0,1,366,1.531194000,0.0000
247.136.249.234,<->,149.110.42.130,1,401,0,0,1,401,1.531191000,0.0000
196.121.84.74,<->,39.12.217.205,0,0,1,64,1,64,1.531144000,0.0000
129.175.139.193,<->,29.211.214.254,0,0,1,92,1,92,1.530710000,0.0000
98.23.96.93,<->,92.27.27.164,0,0,1,56,1,56,1.530681000,0.0000
92.27.219.243,<->,8.47.188.160,1,92,0,0,1,92,1.530616000,0.0000
129.224.112.252,<->,114.145.102.4,1,80,0,0,1,80,1.530522000,0.0000
30.212.236.23,<->,20.79.124.170,0,0,1,64,1,64,1.530427000,0.0000
136.25.188.105,<->,131.49.122.22,1,121,0,0,1,121,1.530386000,0.0000
207.190.207.138,<->,136.25.188.178,0,0,1,593,1,593,1.530234000,0.0000
215.158.239.49,<->,215.158.44.231,1,1357,0,0,1,1357,1.530218000,0.0000
195.102.160.187,<->,20.188.180.53,0,0,1,72,1,72,1.530192000,0.0000
192.67.161.228,<->,144.72.64.8,1,676,0,0,1,676,1.530187000,0.0000
158.164.134.203,<->,39.32.36.158,0,0,1,72,1,72,1.529995000,0.0000
60.93.108.205,<->,39.172.86.27,0,0,1,50,1,50,1.529953000,0.0000
251.21.232.45,<->,109.222.231.152,0,0,1,134,1,134,1.529859000,0.0000
137.148.176.213,<->,97.126.26.70,0,0,1,83,1,83,1.528961000,0.0000
200.174.124.138,<->,53.214.81.160,1,641,0,0,1,641,1.528932000,0.0000
210.209.251.211,<->,97.190.216.119,0,0,1,50,1,50,1.528866000,0.0000
195.126.40.180,<->,136.25.188.175,0,0,1,56,1,56,1.528865000,0.0000
111.151.106.252,<->,6.73.247.7,0,0,1,56,1,56,1.528856000,0.0000
210.209.251.214,<->,137.21.22.50,0,0,1,50,1,50,1.528746000,0.0000
77.42.255.238,<->,34.189.255.223,0,0,1,52,1,52,1.528658000,0.0000
98.23.96.82,<->,92.27.219.210,0,0,1,56,1,56,1.528627000,0.0000
144.122.240.196,<->,136.64.7.221,1,74,0,0,1,74,1.528606000,0.0000
215.158.239.85,<->,207.190.160.214,1,918,0,0,1,918,1.528073000,0.0000
58.143.130.33,<->,34.187.59.238,0,0,1,78,1,78,1.527833000,0.0000
144.75.218.241,<->,138.127.224.136,1,318,0,0,1,318,1.527483000,0.0000
79.56.32.131,<->,8.43.155.247,0,0,1,50,1,50,1.527291000,0.0000
199.33.90.202,<->,136.25.188.241,0,0,1,56,1,56,1.526951000,0.0000
247.136.161.17,<->,50.94.83.219,1,56,0,0,1,56,1.526705000,0.0000
200.175.139.231,<->,53.213.12.173,1,87,0,0,1,87,1.526479000,0.0000
195.41.210.142,<->,136.25.188.255,0,0,1,56,1,56,1.526400000,0.0000
131.63.23.44,<->,129.224.112.252,0,0,1,74,1,74,1.526370000,0.0000
247.136.135.169,<->,125.36.246.176,1,341,0,0,1,341,1.526254000,0.0000
204.1.247.229,<->,136.25.188.236,0,0,1,765,1,765,1.526168000,0.0000
29.211.93.144,<->,8.220.201.13,0,0,1,704,1,704,1.526129000,0.0000
69.196.219.217,<->,39.172.87.102,0,0,1,96,1,96,1.526026000,0.0000
21.15.226.126,<->,20.193.24.155,0,0,1,82,1,82,1.525947000,0.0000
207.203.152.190,<->,39.58.246.97,0,0,1,64,1,64,1.525800000,0.0000
144.75.218.237,<->,132.43.156.54,1,177,0,0,1,177,1.525641000,0.0000
129.16.253.244,<->,109.0.231.174,0,0,1,56,1,56,1.525114000,0.0000
246.253.248.210,<->,224.213.241.54,1,79,0,0,1,79,1.525097000,0.0000
215.158.238.66,<->,106.188.193.36,1,1101,0,0,1,1101,1.524946000,0.0000
196.121.84.74,<->,39.12.217.206,0,0,1,64,1,64,1.524935000,0.0000
133.183.154.103,<->,60.108.145.249,1,52,0,0,1,52,1.524870000,0.0000
136.25.189.95,<->,111.151.107.210,1,56,0,0,1,56,1.524744000,0.0000
144.75.218.242,<->,138.127.230.152,1,366,0,0,1,366,1.524688000,0.0000
117.77.12.217,<->,80.41.4.141,0,0,1,56,1,56,1.524606000,0.0000
159.109.242.255,<->,111.151.109.41,1,100,0,0,1,100,1.524583000,0.0000
111.151.139.216,<->,8.252.221.193,0,0,1,56,1,56,1.524384000,0.0000
215.158.239.57,<->,196.109.123.164,1,781,0,0,1,781,1.524348000,0.0000
139.163.26.146,<->,112.9.220.178,1,99,0,0,1,99,1.524262000,0.0000
220.55.173.92,<->,132.60.192.137,1,52,0,0,1,52,1.524094000,0.0000
136.25.189.87,<->,111.150.207.87,1,56,0,0,1,56,1.523917000,0.0000
195.3.97.103,<->,8.182.138.83,0,0,1,50,1,50,1.523758000,0.0000
109.112.167.71,<->,104.157.23.202,1,76,0,0,1,76,1.523721000,0.0000
140.58.12.242,<->,39.46.137.28,0,0,1,60,1,60,1.523583000,0.0000
89.183.104.166,<->,66.244.63.171,1,52,0,0,1,52,1.523527000,0.0000
215.158.239.76,<->,196.108.169.133,1,56,0,0,1,56,1.523488000,0.0000
111.151.106.254,<->,99.74.27.191,0,0,1,100,1,100,1.523486000,0.0000
111.151.106.232,<->,8.176.8.100,0,0,1,56,1,56,1.523451000,0.0000
158.191.11.136,<->,99.73.163.224,0,0,1,135,1,135,1.523244000,0.0000
21.15.226.126,<->,20.193.24.168,0,0,1,82,1,82,1.523206000,0.0000
215.158.239.69,<->,199.20.6.165,1,68,0,0,1,68,1.522942000,0.0000
115.78.175.171,<->,39.249.2.230,0,0,1,64,1,64,1.522833000,0.0000
204.184.235.241,<->,136.25.188.177,0,0,1,56,1,56,1.522776000,0.0000
215.158.103.219,<->,206.226.68.41,1,84,0,0,1,84,1.522744000,0.0000
215.158.238.93,<->,57.236.82.233,1,1197,0,0,1,1197,1.522625000,0.0000
98.67.141.39,<->,96.93.140.98,1,80,0,0,1,80,1.522562000,0.0000
207.190.60.49,<->,136.25.188.197,0,0,1,50,1,50,1.522469000,0.0000
143.32.146.75,<->,39.153.0.161,0,0,1,66,1,66,1.522366000,0.0000
133.8.10.152,<->,111.20.168.21,0,0,1,305,1,305,1.522293000,0.0000
199.51.101.209,<->,136.25.188.220,0,0,1,64,1,64,1.521925000,0.0000
79.56.95.12,<->,34.15.85.130,0,0,1,74,1,74,1.521608000,0.0000
207.246.51.55,<->,20.206.124.139,0,0,1,98,1,98,1.521421000,0.0000
144.75.218.242,<->,138.127.231.130,1,250,0,0,1,250,1.521299000,0.0000
254.75.54.22,<->,89.183.104.179,0,0,1,62,1,62,1.520802000,0.0000
146.249.227.32,<->,8.252.222.51,0,0,1,101,1,101,1.520638000,0.0000
69.221.164.108,<->,8.252.221.236,0,0,1,50,1,50,1.520154000,0.0000
241.193.172.231,<->,20.214.229.238,0,0,1,50,1,50,1.519566000,0.0000
204.0.200.16,<->,136.25.188.236,0,0,1,68,1,68,1.519539000,0.0000
137.254.129.50,<->,80.56.78.128,0,0,1,94,1,94,1.519448000,0.0000
215.158.239.56,<->,199.20.30.255,1,1120,0,0,1,1120,1.519235000,0.0000
122.221.208.44,<->,50.224.76.235,0,0,1,50,1,50,1.519183000,0.0000
215.158.239.95,<->,199.20.31.161,1,64,0,0,1,64,1.519151000,0.0000
69.246.55.231,<->,39.204.213.172,0,0,1,60,1,60,1.519014000,0.0000
69.246.196.32,<->,8.43.197.220,0,0,1,704,1,704,1.519007000,0.0000
112.3.223.209,<->,92.27.219.151,0,0,1,99,1,99,1.518952000,0.0000
97.168.66.53,<->,53.209.238.110,1,362,0,0,1,362,1.518859000,0.0000
246.253.252.62,<->,136.221.246.140,1,132,0,0,1,132,1.518630000,0.0000
33.74.131.244,<->,20.89.152.253,0,0,1,64,1,64,1.518487000,0.0000
247.136.249.234,<->,149.94.151.115,1,52,0,0,1,52,1.518467000,0.0000
141.97.16.205,<->,8.252.221.204,0,0,1,50,1,50,1.518457000,0.0000
100.182.99.11,<->,20.179.124.155,0,0,1,52,1,52,1.518279000,0.0000
100.182.99.11,<->,20.179.124.172,0,0,1,52,1,52,1.518254000,0.0000
69.196.64.236,<->,39.147.215.88,0,0,1,64,1,64,1.518062000,0.0000
80.101.245.49,<->,50.224.62.69,0,0,1,76,1,76,1.517676000,0.0000
125.3.159.4,<->,92.27.219.218,0,0,1,52,1,52,1.517522000,0.0000
75.62.16.8,<->,20.18.192.241,0,0,1,50,1,50,1.517383000,0.0000
127.183.60.166,<->,8.228.208.38,0,0,1,351,1,351,1.517168000,0.0000
144.75.218.242,<->,139.252.1.230,1,90,0,0,1,90,1.516995000,0.0000
253.107.167.235,<->,139.163.1.154,0,0,1,50,1,50,1.516947000,0.0000
215.158.239.226,<->,53.84.175.252,1,343,0,0,1,343,1.516912000,0.0000
144.76.46.38,<->,100.92.129.50,0,0,1,204,1,204,1.516842000,0.0000
231.143.132.166,<->,136.25.188.163,0,0,1,64,1,64,1.516674000,0.0000
142.241.13.237,<->,136.25.188.225,0,0,1,64,1,64,1.516313000,0.0000
98.67.141.156,<->,15.76.174.124,1,68,0,0,1,68,1.515656000,0.0000
90.240.135.107,<->,84.4.9.87,1,56,0,0,1,56,1.515386000,0.0000
215.158.239.99,<->,207.56.214.26,1,798,0,0,1,798,1.515141000,0.0000
144.75.218.237,<->,138.127.231.77,1,254,0,0,1,254,1.514726000,0.0000
89.183.104.132,<->,33.156.71.15,1,52,0,0,1,52,1.514725000,0.0000
199.39.148.151,<->,136.25.188.53,0,0,1,129,1,129,1.514066000,0.0000
198.206.5.108,<->,138.98.181.238,0,0,1,78,1,78,1.513308000,0.0000
199.12.125.72,<->,20.11.148.42,0,0,1,64,1,64,1.513026000,0.0000
111.151.107.208,<->,97.126.31.64,0,0,1,100,1,100,1.513012000,0.0000
215.158.239.97,<->,199.20.31.21,1,1438,0,0,1,1438,1.512855000,0.0000
194.206.106.251,<->,20.238.92.151,0,0,1,100,1,100,1.512676000,0.0000
215.158.238.133,<->,29.211.186.137,1,1277,0,0,1,1277,1.512675000,0.0000
207.56.232.220,<->,136.25.188.208,0,0,1,56,1,56,1.512651000,0.0000
97.112.208.251,<->,8.220.197.41,0,0,1,704,1,704,1.512399000,0.0000
133.32.2.37,<->,0.81.95.103,1,393,0,0,1,393,1.511849000,0.0000
247.136.211.163,<->,193.23.159.238,1,56,0,0,1,56,1.511847000,0.0000
159.69.187.51,<->,144.108.64.184,1,71,0,0,1,71,1.511322000,0.0000
120.111.89.250,<->,20.172.186.225,0,0,1,52,1,52,1.511192000,0.0000
21.15.226.126,<->,20.193.24.249,0,0,1,82,1,82,1.510832000,0.0000
117.163.209.244,<->,92.27.219.248,0,0,1,52,1,52,1.510788000,0.0000
215.158.239.48,<->,196.91.30.78,1,68,0,0,1,68,1.510593000,0.0000
35.55.212.4,<->,8.182.226.78,0,0,1,56,1,56,1.510472000,0.0000
113.38.34.176,<->,50.224.103.30,0,0,1,50,1,50,1.510035000,0.0000
138.127.230.142,<->,97.126.26.70,0,0,1,231,1,231,1.509563000,0.0000
109.112.164.45,<->,100.230.5.7,1,50,0,0,1,50,1.509336000,0.0000
249.101.95.17,<->,137.39.55.81,1,50,0,0,1,50,1.509258000,0.0000
72.129.206.52,<->,20.207.90.89,0,0,1,72,1,72,1.509254000,0.0000
140.147.60.30,<->,39.62.96.24,0,0,1,60,1,60,1.509224000,0.0000
247.136.177.11,<->,127.80.215.53,1,52,0,0,1,52,1.508982000,0.0000
192.227.18.69,<->,98.236.90.77,0,0,1,50,1,50,1.508859000,0.0000
215.158.238.100,<->,100.224.166.158,1,506,0,0,1,506,1.508783000,0.0000
38.188.82.117,<->,20.43.248.163,0,0,1,64,1,64,1.508395000,0.0000
220.20.200.93,<->,144.83.60.153,1,678,0,0,1,678,1.507786000,0.0000
192.67.158.2,<->,38.140.182.62,1,402,0,0,1,402,1.507429000,0.0000
199.110.162.56,<->,20.31.201.129,0,0,1,95,1,95,1.507224000,0.0000
252.98.135.143,<->,116.123.165.184,1,50,0,0,1,50,1.506738000,0.0000
132.18.67.31,<->,101.70.127.229,0,0,1,50,1,50,1.506502000,0.0000
133.178.227.9,<->,69.132.194.25,1,85,0,0,1,85,1.506311000,0.0000
231.143.143.0,<->,136.25.188.238,0,0,1,64,1,64,1.506251000,0.0000
115.87.129.74,<->,39.142.195.139,0,0,1,64,1,64,1.506092000,0.0000
29.214.69.231,<->,8.52.241.18,0,0,1,1002,1,1002,1.505865000,0.0000
76.82.62.202,<->,20.21.152.161,0,0,1,74,1,74,1.505806000,0.0000
80.42.136.224,<->,68.185.184.17,1,77,0,0,1,77,1.505793000,0.0000
144.76.43.245,<->,39.248.134.206,0,0,1,87,1,87,1.505762000,0.0000
215.158.239.56,<->,195.83.166.58,1,56,0,0,1,56,1.505755000,0.0000
111.147.147.164,<->,38.171.123.218,1,80,0,0,1,80,1.505687000,0.0000
228.3.236.196,<->,39.28.184.158,0,0,1,52,1,52,1.505105000,0.0000
192.64.208.147,<->,38.105.160.195,1,102,0,0,1,102,1.505042000,0.0000
218.38.100.178,<->,8.182.139.197,0,0,1,50,1,50,1.504729000,0.0000
48.129.132.228,<->,8.252.222.211,0,0,1,1213,1,1213,1.504672000,0.0000
158.164.134.203,<->,39.32.36.159,0,0,1,72,1,72,1.504105000,0.0000
143.42.143.177,<->,136.25.188.240,0,0,1,825,1,825,1.503697000,0.0000
86.194.115.211,<->,0.195.210.24,0,0,1,56,1,56,1.503505000,0.0000
193.46.99.197,<->,132.168.196.169,0,0,1,129,1,129,1.503501000,0.0000
142.238.41.239,<->,92.27.27.158,0,0,1,52,1,52,1.503385000,0.0000
144.75.218.242,<->,128.203.247.100,1,88,0,0,1,88,1.503121000,0.0000
109.222.252.217,<->,100.180.142.104,1,68,0,0,1,68,1.502572000,0.0000
215.158.239.31,<->,134.3.169.245,1,50,0,0,1,50,1.502313000,0.0000
92.27.219.50,<->,78.55.247.203,1,62,0,0,1,62,1.501942000,0.0000
109.222.245.45,<->,6.210.30.49,1,67,0,0,1,67,1.501698000,0.0000
139.163.26.146,<->,92.181.226.174,1,99,0,0,1,99,1.501487000,0.0000
38.188.82.117,<->,20.43.248.160,0,0,1,64,1,64,1.501454000,0.0000
205.65.50.131,<->,92.27.219.203,0,0,1,62,1,62,1.501247000,0.0000
124.42.155.137,<->,109.112.164.138,0,0,1,128,1,128,1.500951000,0.0000
247.136.241.120,<->,127.15.90.195,1,90,0,0,1,90,1.500910000,0.0000
195.18.40.94,<->,20.85.197.248,0,0,1,98,1,98,1.500893000,0.0000
21.15.226.126,<->,20.193.25.175,0,0,1,82,1,82,1.500564000,0.0000
159.190.87.59,<->,8.182.245.110,0,0,1,68,1,68,1.500496000,0.0000
159.137.162.213,<->,126.237.62.49,1,56,0,0,1,56,1.500178000,0.0000
111.146.239.200,<->,54.38.186.126,1,50,0,0,1,50,1.500153000,0.0000
248.225.27.92,<->,159.112.9.198,1,50,0,0,1,50,1.499910000,0.0000
21.15.226.126,<->,20.193.25.166,0,0,1,82,1,82,1.499494000,0.0000
215.158.23.24,<->,111.150.207.179,1,56,0,0,1,56,1.499404000,0.0000
247.136.153.195,<->,227.29.191.41,1,50,0,0,1,50,1.499315000,0.0000
144.75.218.235,<->,138.127.224.254,1,341,0,0,1,341,1.499307000,0.0000
241.193.172.231,<->,20.67.95.125,0,0,1,50,1,50,1.499273000,0.0000
109.222.245.45,<->,102.208.213.203,1,67,0,0,1,67,1.499271000,0.0000
215.158.140.240,<->,29.214.68.246,1,704,0,0,1,704,1.499168000,0.0000
215.158.239.56,<->,199.106.18.64,1,56,0,0,1,56,1.499007000,0.0000
93.224.205.64,<->,92.27.219.143,0,0,1,52,1,52,1.499005000,0.0000
100.182.99.11,<->,20.179.125.255,0,0,1,52,1,52,1.498783000,0.0000
139.193.141.139,<->,112.21.90.211,1,50,0,0,1,50,1.498679000,0.0000
215.158.239.76,<->,196.93.212.255,1,64,0,0,1,64,1.498526000,0.0000
204.185.135.78,<->,136.25.188.196,0,0,1,56,1,56,1.498461000,0.0000
133.54.16.152,<->,27.53.120.111,1,64,0,0,1,64,1.498460000,0.0000
241.193.172.231,<->,20.217.192.190,0,0,1,50,1,50,1.498349000,0.0000
92.26.147.44,<->,50.224.90.227,0,0,1,50,1,50,1.498348000,0.0000
128.163.110.232,<->,109.1.60.149,0,0,1,97,1,97,1.497834000,0.0000
206.154.108.149,<->,89.183.104.236,0,0,1,147,1,147,1.497613000,0.0000
136.25.188.174,<->,38.88.108.108,1,56,0,0,1,56,1.497610000,0.0000
249.101.239.70,<->,57.211.43.71,1,68,0,0,1,68,1.497577000,0.0000
199.125.153.115,<->,39.24.39.33,0,0,1,50,1,50,1.497079000,0.0000
199.12.125.72,<->,20.11.148.40,0,0,1,64,1,64,1.496273000,0.0000
143.27.152.40,<->,109.1.35.56,0,0,1,52,1,52,1.496257000,0.0000
247.136.250.61,<->,198.41.102.232,1,68,0,0,1,68,1.496244000,0.0000
215.158.239.59,<->,207.167.250.74,1,68,0,0,1,68,1.496099000,0.0000
138.127.224.104,<->,97.126.26.71,0,0,1,281,1,281,1.495540000,0.0000
105.141.167.75,<->,39.25.150.182,0,0,1,52,1,52,1.495385000,0.0000
92.27.27.185,<->,87.52.183.37,1,719,0,0,1,719,1.495356000,0.0000
195.42.129.38,<->,136.25.188.253,0,0,1,56,1,56,1.495194000,0.0000
195.68.76.200,<->,136.25.188.163,0,0,1,50,1,50,1.494797000,0.0000
92.27.219.166,<->,48.110.114.26,1,52,0,0,1,52,1.494605000,0.0000
249.101.239.70,<->,57.211.43.70,1,68,0,0,1,68,1.494469000,0.0000
92.27.27.150,<->,42.129.191.23,1,52,0,0,1,52,1.494450000,0.0000
146.10.166.252,<->,80.27.157.12,0,0,1,50,1,50,1.494404000,0.0000
92.27.219.141,<->,29.45.178.57,1,50,0,0,1,50,1.494392000,0.0000
215.158.239.95,<->,196.94.105.139,1,68,0,0,1,68,1.493726000,0.0000
210.209.251.214,<->,192.64.210.129,0,0,1,50,1,50,1.493711000,0.0000
215.158.140.204,<->,41.137.208.195,1,50,0,0,1,50,1.493655000,0.0000
152.134.94.238,<->,39.154.194.32,0,0,1,130,1,130,1.493366000,0.0000
249.62.31.124,<->,92.27.219.158,0,0,1,50,1,50,1.493328000,0.0000
198.158.197.83,<->,20.11.58.141,0,0,1,50,1,50,1.493175000,0.0000
206.123.219.254,<->,92.27.219.39,0,0,1,321,1,321,1.492612000,0.0000
215.158.239.49,<->,131.144.115.100,1,1229,0,0,1,1229,1.492582000,0.0000
199.69.229.146,<->,136.25.188.46,0,0,1,56,1,56,1.491665000,0.0000
102.45.20.234,<->,54.69.141.102,1,99,0,0,1,99,1.491452000,0.0000
21.15.226.126,<->,20.193.25.192,0,0,1,82,1,82,1.491065000,0.0000
141.99.73.111,<->,20.135.132.217,0,0,1,135,1,135,1.491049000,0.0000
199.51.155.162,<->,136.25.188.242,0,0,1,56,1,56,1.491020000,0.0000
54.37.130.82,<->,48.55.91.104,0,0,1,50,1,50,1.490890000,0.0000
210.220.219.152,<->,54.52.166.147,1,56,0,0,1,56,1.490847000,0.0000
195.43.136.145,<->,136.25.188.255,0,0,1,56,1,56,1.490774000,0.0000
235.234.223.74,<->,89.183.106.29,0,0,1,50,1,50,1.490647000,0.0000
100.182.99.11,<->,20.179.124.198,0,0,1,52,1,52,1.490577000,0.0000
132.123.161.122,<->,98.236.254.250,0,0,1,61,1,61,1.489969000,0.0000
215.158.239.97,<->,199.20.31.242,1,1438,0,0,1,1438,1.489853000,0.0000
54.58.119.149,<->,48.53.65.124,0,0,1,56,1,56,1.489827000,0.0000
218.31.5.40,<->,129.224.112.252,0,0,1,76,1,76,1.489752000,0.0000
215.158.238.132,<->,29.211.122.180,1,1181,0,0,1,1181,1.489691000,0.0000
109.1.51.11,<->,64.214.45.152,1,405,0,0,1,405,1.489508000,0.0000
194.247.3.25,<->,39.17.148.222,0,0,1,64,1,64,1.489492000,0.0000
215.158.140.230,<->,145.160.76.93,1,50,0,0,1,50,1.489484000,0.0000
144.75.218.241,<->,144.69.195.30,1,102,0,0,1,102,1.489187000,0.0000
195.12.240.150,<->,136.25.188.243,0,0,1,64,1,64,1.489182000,0.0000
197.158.156.45,<->,20.186.94.202,0,0,1,52,1,52,1.489138000,0.0000
89.93.82.208,<->,8.43.212.233,0,0,1,704,1,704,1.489088000,0.0000
106.149.105.235,<->,92.27.219.161,0,0,1,309,1,309,1.489074000,0.0000
21.15.226.126,<->,20.193.25.202,0,0,1,82,1,82,1.488946000,0.0000
133.213.24.220,<->,8.52.148.104,0,0,1,50,1,50,1.488503000,0.0000
100.182.99.11,<->,20.179.124.246,0,0,1,52,1,52,1.488277000,0.0000
98.236.90.77,<->,8.37.124.174,1,97,0,0,1,97,1.488022000,0.0000
33.74.131.244,<->,20.89.152.63,0,0,1,64,1,64,1.487893000,0.0000
144.75.218.241,<->,136.99.66.245,1,174,0,0,1,174,1.487700000,0.0000
192.171.13.190,<->,8.176.8.196,0,0,1,97,1,97,1.487556000,0.0000
196.148.128.5,<->,115.120.161.24,1,52,0,0,1,52,1.487477000,0.0000
38.188.82.117,<->,20.43.248.161,0,0,1,64,1,64,1.487461000,0.0000
89.86.110.196,<->,8.252.222.105,0,0,1,135,1,135,1.486905000,0.0000
38.21.156.204,<->,20.232.230.81,0,0,1,82,1,82,1.486431000,0.0000
101.224.169.22,<->,0.35.171.199,1,110,0,0,1,110,1.486298000,0.0000
144.75.218.233,<->,53.165.133.164,1,80,0,0,1,80,1.486133000,0.0000
215.158.239.73,<->,143.88.15.74,1,84,0,0,1,84,1.486096000,0.0000
195.212.97.109,<->,50.224.76.230,0,0,1,50,1,50,1.486064000,0.0000
109.1.56.55,<->,57.46.39.166,1,50,0,0,1,50,1.485846000,0.0000
207.162.143.204,<->,8.182.226.78,0,0,1,50,1,50,1.485803000,0.0000
215.158.61.242,<->,136.25.188.39,0,0,1,1392,1,1392,1.485626000,0.0000
143.134.97.75,<->,136.25.188.178,0,0,1,624,1,624,1.485183000,0.0000
111.150.207.59,<->,99.74.26.147,0,0,1,56,1,56,1.485177000,0.0000
89.183.104.229,<->,6.75.130.11,1,56,0,0,1,56,1.484996000,0.0000
215.158.239.94,<->,207.61.203.69,1,85,0,0,1,85,1.484811000,0.0000
111.147.76.87,<->,53.148.24.110,1,125,0,0,1,125,1.484745000,0.0000
98.23.111.141,<->,92.27.209.196,0,0,1,50,1,50,1.484736000,0.0000
194.215.244.40,<->,80.42.160.104,0,0,1,215,1,215,1.484629000,0.0000
133.178.226.98,<->,6.29.108.86,1,1064,0,0,1,1064,1.484328000,0.0000
126.232.54.214,<->,20.54.106.168,0,0,1,64,1,64,1.484135000,0.0000
215.158.239.95,<->,199.20.28.106,1,685,0,0,1,685,1.484061000,0.0000
118.224.132.179,<->,109.1.22.16,0,0,1,138,1,138,1.483896000,0.0000
137.69.196.172,<->,8.52.169.61,0,0,1,50,1,50,1.483778000,0.0000
207.72.252.122,<->,39.15.169.14,0,0,1,86,1,86,1.483756000,0.0000
131.103.129.114,<->,20.159.36.64,0,0,1,52,1,52,1.483616000,0.0000
100.182.99.11,<->,20.179.124.241,0,0,1,52,1,52,1.483558000,0.0000
54.39.184.254,<->,48.55.119.121,0,0,1,50,1,50,1.483383000,0.0000
116.106.35.71,<->,8.52.136.253,0,0,1,1002,1,1002,1.483281000,0.0000
126.232.52.51,<->,20.108.97.31,0,0,1,64,1,64,1.483249000,0.0000
215.158.239.58,<->,195.5.208.21,1,50,0,0,1,50,1.482766000,0.0000
93.181.153.59,<->,92.27.219.155,0,0,1,56,1,56,1.482472000,0.0000
241.193.172.231,<->,20.162.203.103,0,0,1,50,1,50,1.482287000,0.0000
159.87.104.238,<->,138.127.198.233,1,75,0,0,1,75,1.482149000,0.0000
215.158.239.57,<->,195.83.80.21,1,56,0,0,1,56,1.482149000,0.0000
235.229.204.198,<->,92.27.27.153,0,0,1,62,1,62,1.482046000,0.0000
143.234.10.140,<->,8.182.138.83,0,0,1,50,1,50,1.481902000,0.0000
159.69.187.29,<->,144.108.80.172,1,71,0,0,1,71,1.481839000,0.0000
144.75.218.235,<->,140.142.131.1,1,77,0,0,1,77,1.481780000,0.0000
215.158.199.224,<->,138.73.248.205,0,0,1,129,1,129,1.481410000,0.0000
56.112.226.51,<->,8.176.34.109,0,0,1,50,1,50,1.481356000,0.0000
215.158.239.92,<->,207.115.73.228,1,56,0,0,1,56,1.480725000,0.0000
126.232.54.214,<->,20.54.106.172,0,0,1,64,1,64,1.480630000,0.0000
97.168.67.236,<->,63.255.106.50,1,80,0,0,1,80,1.480528000,0.0000
255.133.229.164,<->,98.67.154.65,0,0,1,100,1,100,1.480318000,0.0000
231.143.102.160,<->,136.25.188.220,0,0,1,50,1,50,1.480210000,0.0000
199.81.234.44,<->,136.25.188.223,0,0,1,56,1,56,1.480177000,0.0000
136.18.96.147,<->,8.183.25.124,0,0,1,50,1,50,1.480151000,0.0000
199.15.133.244,<->,136.25.188.227,0,0,1,602,1,602,1.480105000,0.0000
148.177.30.57,<->,39.193.207.217,0,0,1,1257,1,1257,1.480081000,0.0000
92.27.219.140,<->,91.231.209.45,1,89,0,0,1,89,1.479986000,0.0000
207.88.232.90,<->,8.182.229.19,0,0,1,50,1,50,1.479836000,0.0000
105.64.71.172,<->,20.86.113.253,0,0,1,104,1,104,1.479782000,0.0000
195.41.24.134,<->,136.25.188.178,0,0,1,68,1,68,1.479703000,0.0000
132.168.198.202,<->,52.60.231.223,1,65,0,0,1,65,1.479564000,0.0000
97.168.67.236,<->,93.2.217.58,1,80,0,0,1,80,1.479472000,0.0000
92.27.219.156,<->,87.49.215.40,1,84,0,0,1,84,1.479437000,0.0000
98.230.195.67,<->,8.182.227.210,0,0,1,50,1,50,1.479263000,0.0000
215.158.239.58,<->,194.234.250.232,1,85,0,0,1,85,1.478234000,0.0000
111.147.128.184,<->,53.68.91.57,1,56,0,0,1,56,1.477969000,0.0000
129.224.112.252,<->,56.125.221.95,1,63,0,0,1,63,1.477360000,0.0000
120.51.13.182,<->,89.183.104.145,0,0,1,328,1,328,1.477176000,0.0000
215.158.61.195,<->,8.176.8.213,0,0,1,56,1,56,1.477062000,0.0000
139.163.13.98,<->,122.209.227.154,1,50,0,0,1,50,1.476789000,0.0000
144.76.46.36,<->,102.50.179.112,0,0,1,130,1,130,1.476194000,0.0000
138.31.199.102,<->,53.212.149.246,1,74,0,0,1,74,1.476050000,0.0000
247.136.188.245,<->,148.196.121.220,1,130,0,0,1,130,1.475960000,0.0000
80.38.51.167,<->,8.47.188.160,1,148,0,0,1,148,1.475914000,0.0000
192.64.246.117,<->,98.150.107.181,1,50,0,0,1,50,1.475797000,0.0000
194.232.160.138,<->,136.25.188.177,0,0,1,188,1,188,1.475676000,0.0000
206.243.225.26,<->,109.222.210.27,0,0,1,50,1,50,1.475258000,0.0000
221.95.60.220,<->,77.8.75.237,1,135,0,0,1,135,1.475163000,0.0000
207.192.232.125,<->,39.157.186.151,0,0,1,97,1,97,1.475114000,0.0000
159.112.9.198,<->,111.146.211.230,0,0,1,81,1,81,1.474712000,0.0000
196.193.145.119,<->,39.208.214.31,0,0,1,60,1,60,1.474631000,0.0000
109.1.71.12,<->,8.49.69.216,1,353,0,0,1,353,1.474625000,0.0000
144.76.42.205,<->,144.64.138.24,0,0,1,76,1,76,1.474469000,0.0000
103.151.144.208,<->,8.220.205.146,0,0,1,50,1,50,1.474279000,0.0000
241.193.172.231,<->,20.160.135.248,0,0,1,50,1,50,1.473907000,0.0000
198.232.32.156,<->,92.27.219.229,0,0,1,52,1,52,1.473704000,0.0000
215.158.239.99,<->,195.97.49.31,1,68,0,0,1,68,1.473587000,0.0000
124.56.156.93,<->,109.222.202.37,0,0,1,79,1,79,1.473091000,0.0000
33.237.187.37,<->,20.206.1.110,0,0,1,52,1,52,1.473090000,0.0000
92.27.27.182,<->,29.138.102.202,1,56,0,0,1,56,1.473001000,0.0000
89.183.104.173,<->,18.201.237.149,1,60,0,0,1,60,1.472987000,0.0000
111.65.121.95,<->,92.27.219.38,0,0,1,80,1,80,1.472824000,0.0000
144.75.218.233,<->,98.101.89.7,1,82,0,0,1,82,1.472774000,0.0000
144.75.218.237,<->,138.127.224.17,1,294,0,0,1,294,1.472713000,0.0000
215.158.239.84,<->,195.43.255.92,1,56,0,0,1,56,1.472703000,0.0000
206.89.65.32,<->,8.43.154.226,0,0,1,704,1,704,1.472497000,0.0000
29.214.193.75,<->,8.43.219.55,0,0,1,704,1,704,1.472493000,0.0000
203.11.144.44,<->,92.27.27.157,0,0,1,52,1,52,1.472458000,0.0000
132.123.44.21,<->,8.222.6.160,1,64,0,0,1,64,1.472452000,0.0000
199.25.50.198,<->,39.172.210.56,0,0,1,64,1,64,1.472323000,0.0000
80.93.31.157,<->,20.203.230.201,0,0,1,56,1,56,1.472254000,0.0000
89.183.104.189,<->,38.87.154.202,1,52,0,0,1,52,1.472188000,0.0000
129.224.112.252,<->,99.187.125.196,1,78,0,0,1,78,1.471985000,0.0000
207.190.194.222,<->,8.220.176.253,0,0,1,50,1,50,1.471832000,0.0000
76.72.228.64,<->,39.164.106.143,0,0,1,64,1,64,1.471345000,0.0000
196.148.133.194,<->,93.151.38.73,1,52,0,0,1,52,1.471207000,0.0000
132.185.111.50,<->,20.211.220.249,0,0,1,88,1,88,1.471164000,0.0000
215.158.239.56,<->,199.20.29.67,1,602,0,0,1,602,1.471096000,0.0000
222.34.236.101,<->,139.193.141.139,0,0,1,50,1,50,1.470940000,0.0000
247.136.139.153,<->,119.76.158.162,1,62,0,0,1,62,1.470719000,0.0000
215.158.239.99,<->,196.94.139.126,1,653,0,0,1,653,1.470659000,0.0000
204.109.185.118,<->,39.246.168.218,0,0,1,106,1,106,1.470630000,0.0000
105.115.185.87,<->,102.50.219.230,0,0,1,393,1,393,1.469844000,0.0000
143.128.251.145,<->,136.25.188.255,0,0,1,68,1,68,1.469082000,0.0000
144.75.218.233,<->,138.127.224.174,1,67,0,0,1,67,1.469051000,0.0000
113.24.27.181,<->,97.126.31.80,0,0,1,1002,1,1002,1.468936000,0.0000
127.190.126.87,<->,56.121.48.108,0,0,1,74,1,74,1.468819000,0.0000
142.167.1.136,<->,136.25.188.53,0,0,1,68,1,68,1.468718000,0.0000
108.180.193.84,<->,8.53.0.222,0,0,1,50,1,50,1.468652000,0.0000
113.167.79.244,<->,20.116.112.253,0,0,1,60,1,60,1.468579000,0.0000
109.222.204.60,<->,109.36.8.231,1,77,0,0,1,77,1.468125000,0.0000
218.4.182.90,<->,159.42.43.112,1,56,0,0,1,56,1.467791000,0.0000
249.101.238.135,<->,94.233.224.195,1,133,0,0,1,133,1.467747000,0.0000
106.226.78.72,<->,20.215.108.126,0,0,1,64,1,64,1.467628000,0.0000
104.157.21.26,<->,39.205.60.126,0,0,1,70,1,70,1.467308000,0.0000
215.158.239.48,<->,204.0.147.7,1,64,0,0,1,64,1.466610000,0.0000
42.48.37.101,<->,39.52.144.139,0,0,1,52,1,52,1.466572000,0.0000
111.60.203.97,<->,109.222.195.232,0,0,1,71,1,71,1.466557000,0.0000
101.224.183.152,<->,97.193.106.236,1,68,0,0,1,68,1.466500000,0.0000
100.182.99.11,<->,20.179.123.155,0,0,1,52,1,52,1.466374000,0.0000
199.20.77.150,<->,109.222.195.53,0,0,1,52,1,52,1.466161000,0.0000
215.158.239.70,<->,207.114.98.247,1,96,0,0,1,96,1.466137000,0.0000
202.33.77.136,<->,136.25.188.178,0,0,1,50,1,50,1.465942000,0.0000
144.75.218.235,<->,138.127.231.194,1,365,0,0,1,365,1.465898000,0.0000
144.75.218.235,<->,132.200.120.209,1,142,0,0,1,142,1.465285000,0.0000
138.127.224.169,<->,97.126.26.70,0,0,1,252,1,252,1.465248000,0.0000
92.27.219.61,<->,88.45.125.170,1,52,0,0,1,52,1.465247000,0.0000
111.151.107.247,<->,8.252.222.246,0,0,1,155,1,155,1.465128000,0.0000
193.46.99.105,<->,109.1.34.223,0,0,1,304,1,304,1.464657000,0.0000
92.27.219.58,<->,0.66.204.255,1,149,0,0,1,149,1.464616000,0.0000
202.33.245.28,<->,136.25.188.240,0,0,1,50,1,50,1.464438000,0.0000
215.158.239.97,<->,195.49.241.78,1,50,0,0,1,50,1.464186000,0.0000
132.103.198.103,<->,119.121.24.104,1,64,0,0,1,64,1.463945000,0.0000
129.224.112.252,<->,114.145.122.138,1,80,0,0,1,80,1.463813000,0.0000
200.174.106.10,<->,54.37.53.245,1,56,0,0,1,56,1.463728000,0.0000
72.195.7.193,<->,39.231.47.182,0,0,1,64,1,64,1.463604000,0.0000
145.252.125.198,<->,97.110.148.19,1,87,0,0,1,87,1.463511000,0.0000
144.84.231.127,<->,50.224.75.42,0,0,1,64,1,64,1.463364000,0.0000
197.113.99.174,<->,136.25.188.55,0,0,1,56,1,56,1.463023000,0.0000
144.107.24.11,<->,91.231.194.48,0,0,1,68,1,68,1.462927000,0.0000
80.9.14.182,<->,48.53.90.113,0,0,1,323,1,323,1.462838000,0.0000
144.75.218.242,<->,138.127.231.29,1,254,0,0,1,254,1.462559000,0.0000
155.18.131.13,<->,20.169.96.107,0,0,1,64,1,64,1.462554000,0.0000
108.40.175.121,<->,20.40.5.45,0,0,1,64,1,64,1.462420000,0.0000
121.13.225.160,<->,109.222.214.116,0,0,1,99,1,99,1.462352000,0.0000
109.1.16.158,<->,27.188.163.162,1,445,0,0,1,445,1.462296000,0.0000
127.28.135.140,<->,39.23.141.102,0,0,1,52,1,52,1.462171000,0.0000
159.112.9.198,<->,111.181.112.48,0,0,1,81,1,81,1.462154000,0.0000
131.141.160.18,<->,20.197.31.46,0,0,1,106,1,106,1.462073000,0.0000
92.162.177.72,<->,92.27.27.171,0,0,1,64,1,64,1.462005000,0.0000
38.30.47.28,<->,20.116.161.33,0,0,1,100,1,100,1.461924000,0.0000
133.32.39.1,<->,111.150.207.167,1,56,0,0,1,56,1.461762000,0.0000
220.55.111.215,<->,112.14.222.61,1,50,0,0,1,50,1.461500000,0.0000
241.193.172.231,<->,20.246.196.67,0,0,1,50,1,50,1.461019000,0.0000
140.68.10.122,<->,8.252.222.158,0,0,1,132,1,132,1.460941000,0.0000
215.158.239.93,<->,195.83.80.21,1,68,0,0,1,68,1.460855000,0.0000
111.146.175.27,<->,27.158.211.45,1,50,0,0,1,50,1.460814000,0.0000
206.195.52.10,<->,100.95.143.25,0,0,1,56,1,56,1.460713000,0.0000
80.56.91.248,<->,8.252.223.247,0,0,1,56,1,56,1.460577000,0.0000
215.158.123.32,<->,136.25.189.94,0,0,1,1064,1,1064,1.460512000,0.0000
111.151.142.208,<->,99.74.87.240,0,0,1,56,1,56,1.460503000,0.0000
195.86.156.214,<->,20.31.149.15,0,0,1,100,1,100,1.460321000,0.0000
201.220.28.91,<->,109.1.36.149,0,0,1,135,1,135,1.460226000,0.0000
97.203.33.81,<->,8.182.226.78,0,0,1,56,1,56,1.460223000,0.0000
92.27.219.131,<->,48.109.4.185,1,50,0,0,1,50,1.459488000,0.0000
215.158.239.4,<->,96.166.222.241,1,50,0,0,1,50,1.459466000,0.0000
98.67.143.207,<->,58.20.165.33,1,79,0,0,1,79,1.459425000,0.0000
215.158.239.95,<->,207.115.125.111,1,56,0,0,1,56,1.458866000,0.0000
221.98.74.9,<->,111.48.44.18,1,50,0,0,1,50,1.458865000,0.0000
120.155.87.66,<->,8.176.8.96,0,0,1,157,1,157,1.458597000,0.0000
207.162.163.246,<->,8.182.138.83,0,0,1,261,1,261,1.458512000,0.0000
133.178.227.8,<->,111.150.207.168,1,100,0,0,1,100,1.458451000,0.0000
215.158.140.207,<->,199.47.179.172,1,501,0,0,1,501,1.458376000,0.0000
215.158.239.92,<->,199.39.126.136,1,50,0,0,1,50,1.458166000,0.0000
109.222.195.216,<->,105.18.118.50,1,74,0,0,1,74,1.458093000,0.0000
197.108.67.239,<->,129.224.112.252,0,0,1,74,1,74,1.457714000,0.0000
215.158.239.101,<->,215.158.61.145,1,56,0,0,1,56,1.457355000,0.0000
57.236.181.228,<->,39.150.98.123,0,0,1,106,1,106,1.457343000,0.0000
156.180.238.191,<->,39.33.251.202,0,0,1,52,1,52,1.457304000,0.0000
210.209.251.214,<->,102.83.50.79,0,0,1,50,1,50,1.456873000,0.0000
192.64.255.44,<->,134.241.245.8,1,50,0,0,1,50,1.456643000,0.0000
205.224.85.74,<->,99.73.59.147,0,0,1,50,1,50,1.456512000,0.0000
99.162.65.136,<->,53.245.244.92,1,257,0,0,1,257,1.456489000,0.0000
192.67.142.109,<->,0.68.165.164,1,80,0,0,1,80,1.456356000,0.0000
89.183.104.227,<->,38.97.21.210,1,56,0,0,1,56,1.456000000,0.0000
99.175.107.24,<->,53.214.235.71,1,417,0,0,1,417,1.455456000,0.0000
192.231.166.85,<->,99.73.63.149,0,0,1,52,1,52,1.455099000,0.0000
131.92.219.38,<->,98.129.94.67,0,0,1,50,1,50,1.455003000,0.0000
119.68.182.212,<->,89.183.104.231,0,0,1,52,1,52,1.454963000,0.0000
241.193.172.231,<->,20.93.183.242,0,0,1,50,1,50,1.454865000,0.0000
206.222.59.10,<->,89.183.104.167,0,0,1,52,1,52,1.454865000,0.0000
158.55.120.187,<->,144.75.218.246,0,0,1,162,1,162,1.454856000,0.0000
247.136.242.239,<->,132.216.20.254,1,56,0,0,1,56,1.454320000,0.0000
98.67.133.87,<->,92.34.2.222,1,71,0,0,1,71,1.454201000,0.0000
112.208.20.246,<->,100.93.119.230,0,0,1,163,1,163,1.454006000,0.0000
215.158.239.92,<->,199.20.31.226,1,64,0,0,1,64,1.453976000,0.0000
123.19.57.43,<->,92.27.219.239,0,0,1,373,1,373,1.453965000,0.0000
21.15.226.126,<->,20.193.25.48,0,0,1,82,1,82,1.453650000,0.0000
111.147.137.183,<->,54.58.106.235,1,56,0,0,1,56,1.453493000,0.0000
215.158.239.97,<->,199.20.30.90,1,781,0,0,1,781,1.453433000,0.0000
105.204.179.226,<->,50.224.76.234,0,0,1,50,1,50,1.453400000,0.0000
105.168.108.183,<->,92.27.27.175,0,0,1,80,1,80,1.453183000,0.0000
157.25.158.25,<->,144.75.218.246,0,0,1,87,1,87,1.453045000,0.0000
144.75.218.233,<->,138.127.225.78,1,269,0,0,1,269,1.452942000,0.0000
109.222.250.46,<->,38.25.250.39,1,80,0,0,1,80,1.452826000,0.0000
112.54.73.92,<->,97.126.18.23,0,0,1,71,1,71,1.452756000,0.0000
223.138.178.113,<->,39.152.189.205,0,0,1,56,1,56,1.452543000,0.0000
72.195.7.193,<->,39.231.47.184,0,0,1,64,1,64,1.452212000,0.0000
215.158.239.229,<->,128.156.85.186,1,100,0,0,1,100,1.452139000,0.0000
144.75.218.233,<->,138.127.231.139,1,366,0,0,1,366,1.451790000,0.0000
112.212.96.222,<->,20.188.21.207,0,0,1,539,1,539,1.451283000,0.0000
120.188.17.43,<->,39.143.92.27,0,0,1,136,1,136,1.450935000,0.0000
108.36.183.151,<->,89.183.104.253,0,0,1,221,1,221,1.450876000,0.0000
215.158.238.200,<->,144.90.218.168,1,1002,0,0,1,1002,1.450708000,0.0000
231.178.9.244,<->,39.248.89.72,0,0,1,56,1,56,1.450557000,0.0000
207.63.155.175,<->,136.25.188.177,0,0,1,68,1,68,1.449941000,0.0000
200.174.103.225,<->,53.213.148.81,1,50,0,0,1,50,1.449834000,0.0000
218.176.18.66,<->,29.211.214.32,0,0,1,87,1,87,1.449513000,0.0000
198.69.238.131,<->,20.90.202.134,0,0,1,64,1,64,1.449421000,0.0000
144.75.218.242,<->,138.127.225.88,1,366,0,0,1,366,1.449125000,0.0000
94.39.46.138,<->,39.51.105.2,0,0,1,64,1,64,1.448790000,0.0000
215.158.238.161,<->,118.20.100.200,1,84,0,0,1,84,1.448682000,0.0000
6.145.148.93,<->,0.195.210.46,0,0,1,56,1,56,1.448615000,0.0000
241.193.172.231,<->,20.179.205.119,0,0,1,50,1,50,1.448608000,0.0000
215.158.239.121,<->,215.158.61.183,1,56,0,0,1,56,1.448357000,0.0000
199.12.125.72,<->,20.11.148.28,0,0,1,64,1,64,1.448272000,0.0000
247.136.131.55,<->,210.209.251.214,1,481,0,0,1,481,1.447940000,0.0000
194.233.159.16,<->,136.25.188.54,0,0,1,50,1,50,1.447900000,0.0000
215.158.239.85,<->,196.94.61.238,1,68,0,0,1,68,1.447684000,0.0000
132.249.70.233,<->,57.29.149.23,1,157,0,0,1,157,1.447673000,0.0000
198.204.78.16,<->,8.52.223.43,0,0,1,1002,1,1002,1.447636000,0.0000
144.64.137.156,<->,57.140.246.52,1,71,0,0,1,71,1.447510000,0.0000
109.1.16.149,<->,27.188.163.162,1,445,0,0,1,445,1.447424000,0.0000
21.15.226.126,<->,20.193.26.8,0,0,1,82,1,82,1.446973000,0.0000
106.187.250.29,<->,8.228.223.193,0,0,1,60,1,60,1.446865000,0.0000
121.231.63.172,<->,39.216.213.92,0,0,1,100,1,100,1.446809000,0.0000
192.64.234.189,<->,29.201.141.148,1,50,0,0,1,50,1.446578000,0.0000
215.158.239.95,<->,196.88.134.223,1,561,0,0,1,561,1.446377000,0.0000
241.193.172.231,<->,20.220.143.197,0,0,1,50,1,50,1.446331000,0.0000
215.158.239.92,<->,143.10.57.201,1,50,0,0,1,50,1.446207000,0.0000
113.131.107.29,<->,109.222.255.59,0,0,1,75,1,75,1.445587000,0.0000
215.158.239.85,<->,207.213.226.100,1,68,0,0,1,68,1.444979000,0.0000
220.38.84.202,<->,133.178.226.28,0,0,1,1213,1,1213,1.444903000,0.0000
192.67.140.85,<->,123.153.228.35,1,50,0,0,1,50,1.444712000,0.0000
123.49.16.66,<->,89.183.104.245,0,0,1,321,1,321,1.444699000,0.0000
204.20.246.70,<->,136.25.188.252,0,0,1,64,1,64,1.444658000,0.0000
152.110.93.110,<->,34.246.35.155,0,0,1,52,1,52,1.444172000,0.0000
86.194.117.90,<->,0.195.210.24,0,0,1,56,1,56,1.444154000,0.0000
119.90.251.239,<->,20.225.6.118,0,0,1,50,1,50,1.443912000,0.0000
113.163.114.210,<->,20.6.42.212,0,0,1,99,1,99,1.443857000,0.0000
141.108.34.33,<->,20.216.214.17,0,0,1,136,1,136,1.443822000,0.0000
118.224.227.82,<->,111.147.76.145,0,0,1,319,1,319,1.443765000,0.0000
247.136.154.209,<->,134.201.197.42,1,130,0,0,1,130,1.443714000,0.0000
64.252.113.196,<->,39.158.64.219,0,0,1,52,1,52,1.443521000,0.0000
120.186.232.218,<->,80.41.59.67,0,0,1,129,1,129,1.443457000,0.0000
210.220.219.153,<->,84.200.124.13,1,319,0,0,1,319,1.443278000,0.0000
215.158.103.219,<->,138.127.224.210,1,274,0,0,1,274,1.442605000,0.0000
198.69.238.131,<->,20.90.203.120,0,0,1,64,1,64,1.442319000,0.0000
204.20.217.1,<->,136.25.188.238,0,0,1,64,1,64,1.442305000,0.0000
231.138.204.68,<->,136.25.188.173,0,0,1,64,1,64,1.441914000,0.0000
225.41.159.53,<->,138.98.246.1,0,0,1,120,1,120,1.441865000,0.0000
204.184.14.168,<->,136.25.188.255,0,0,1,56,1,56,1.441727000,0.0000
111.151.107.247,<->,8.252.222.118,0,0,1,134,1,134,1.441586000,0.0000
39.59.163.117,<->,38.75.253.23,1,70,0,0,1,70,1.441418000,0.0000
58.59.40.252,<->,20.234.57.9,0,0,1,136,1,136,1.441346000,0.0000
133.178.226.29,<->,29.123.209.149,1,1277,0,0,1,1277,1.441286000,0.0000
194.251.77.128,<->,8.20.87.206,0,0,1,50,1,50,1.441158000,0.0000
230.126.191.235,<->,98.128.199.38,0,0,1,130,1,130,1.441109000,0.0000
215.158.239.57,<->,199.106.190.76,1,50,0,0,1,50,1.440865000,0.0000
101.106.122.69,<->,92.27.219.138,0,0,1,138,1,138,1.440765000,0.0000
215.158.239.58,<->,196.90.119.118,1,64,0,0,1,64,1.440647000,0.0000
215.158.140.112,<->,111.150.207.167,1,56,0,0,1,56,1.440362000,0.0000
149.159.108.67,<->,20.214.223.135,0,0,1,72,1,72,1.440154000,0.0000
248.239.77.185,<->,48.19.203.121,1,133,0,0,1,133,1.440121000,0.0000
120.23.198.205,<->,39.33.217.21,0,0,1,52,1,52,1.440059000,0.0000
205.242.102.181,<->,192.229.213.169,0,0,1,60,1,60,1.440043000,0.0000
21.15.226.126,<->,20.193.26.38,0,0,1,82,1,82,1.440032000,0.0000
144.75.218.246,<->,138.127.231.114,1,289,0,0,1,289,1.440010000,0.0000
140.44.64.171,<->,92.27.27.177,0,0,1,90,1,90,1.439881000,0.0000
97.80.230.43,<->,8.220.188.43,0,0,1,50,1,50,1.439850000,0.0000
128.156.85.234,<->,97.126.31.65,0,0,1,56,1,56,1.439843000,0.0000
119.25.160.163,<->,109.1.34.223,0,0,1,325,1,325,1.439774000,0.0000
144.75.218.237,<->,53.244.198.185,1,86,0,0,1,86,1.439706000,0.0000
215.158.239.92,<->,199.20.29.11,1,56,0,0,1,56,1.439564000,0.0000
105.200.247.154,<->,89.139.240.18,0,0,1,74,1,74,1.439521000,0.0000
142.253.237.85,<->,136.25.188.160,0,0,1,50,1,50,1.438864000,0.0000
144.75.218.233,<->,138.127.224.203,1,182,0,0,1,182,1.438857000,0.0000
149.250.99.138,<->,39.203.116.110,0,0,1,60,1,60,1.438848000,0.0000
195.41.243.184,<->,136.25.188.209,0,0,1,50,1,50,1.438820000,0.0000
104.232.115.160,<->,20.171.10.162,0,0,1,64,1,64,1.438795000,0.0000
102.83.25.171,<->,33.156.232.44,1,169,0,0,1,169,1.438744000,0.0000
145.3.142.7,<->,39.237.228.170,0,0,1,64,1,64,1.438560000,0.0000
97.183.201.92,<->,8.222.7.179,1,56,0,0,1,56,1.438457000,0.0000
131.91.78.19,<->,109.222.242.9,0,0,1,136,1,136,1.438423000,0.0000
53.245.65.149,<->,48.54.250.126,0,0,1,50,1,50,1.438377000,0.0000
38.21.156.204,<->,20.232.230.10,0,0,1,82,1,82,1.438087000,0.0000
215.158.140.74,<->,83.248.10.49,1,137,0,0,1,137,1.438083000,0.0000
68.65.175.143,<->,34.165.178.132,0,0,1,74,1,74,1.438048000,0.0000
136.88.52.114,<->,20.204.98.130,0,0,1,80,1,80,1.437809000,0.0000
204.82.113.15,<->,39.154.165.188,0,0,1,96,1,96,1.437651000,0.0000
241.193.172.231,<->,20.87.161.0,0,0,1,50,1,50,1.437087000,0.0000
220.31.194.162,<->,145.116.119.49,0,0,1,95,1,95,1.437051000,0.0000
200.174.207.170,<->,80.9.234.254,1,144,0,0,1,144,1.436924000,0.0000
129.224.112.252,<->,100.185.124.114,1,57,0,0,1,57,1.436613000,0.0000
247.136.237.185,<->,100.124.212.156,1,50,0,0,1,50,1.436326000,0.0000
215.158.238.74,<->,131.144.113.180,1,1245,0,0,1,1245,1.436257000,0.0000
215.158.239.87,<->,199.20.31.113,1,64,0,0,1,64,1.436009000,0.0000
212.164.131.84,<->,119.135.216.72,1,92,0,0,1,92,1.435827000,0.0000
139.163.26.146,<->,118.90.58.35,1,99,0,0,1,99,1.435804000,0.0000
195.5.123.209,<->,20.222.114.179,0,0,1,102,1,102,1.435614000,0.0000
119.226.233.38,<->,92.27.219.51,0,0,1,351,1,351,1.435327000,0.0000
130.13.184.58,<->,20.177.4.48,0,0,1,101,1,101,1.435097000,0.0000
97.190.209.215,<->,48.18.195.101,1,133,0,0,1,133,1.434926000,0.0000
215.158.239.75,<->,143.88.15.74,1,84,0,0,1,84,1.434162000,0.0000
145.252.126.18,<->,136.221.27.98,1,96,0,0,1,96,1.434121000,0.0000
132.227.248.252,<->,8.220.179.115,0,0,1,50,1,50,1.433643000,0.0000
210.226.166.19,<->,159.112.9.198,1,50,0,0,1,50,1.433620000,0.0000
195.3.157.139,<->,129.224.112.220,0,0,1,88,1,88,1.433619000,0.0000
133.32.2.38,<->,129.245.60.234,1,131,0,0,1,131,1.433473000,0.0000
201.216.164.96,<->,39.2.106.196,0,0,1,64,1,64,1.433372000,0.0000
35.17.219.123,<->,8.52.223.67,0,0,1,50,1,50,1.433235000,0.0000
143.252.87.189,<->,20.46.159.59,0,0,1,75,1,75,1.433212000,0.0000
139.163.68.55,<->,56.9.27.149,1,51,0,0,1,51,1.433058000,0.0000
144.75.218.241,<->,138.127.225.28,1,254,0,0,1,254,1.432697000,0.0000
144.75.218.235,<->,132.43.156.54,1,148,0,0,1,148,1.432423000,0.0000
215.158.239.70,<->,196.94.121.54,1,68,0,0,1,68,1.432358000,0.0000
39.1.99.54,<->,38.92.90.238,1,52,0,0,1,52,1.432327000,0.0000
244.50.133.60,<->,39.196.139.20,0,0,1,50,1,50,1.432203000,0.0000
192.224.199.2,<->,29.214.65.5,1,704,0,0,1,704,1.432174000,0.0000
246.108.109.36,<->,100.94.137.213,0,0,1,61,1,61,1.432060000,0.0000
98.3.15.248,<->,8.182.226.78,0,0,1,50,1,50,1.430950000,0.0000
92.27.27.150,<->,4.111.14.58,1,52,0,0,1,52,1.430436000,0.0000
122.9.224.81,<->,109.222.205.228,0,0,1,73,1,73,1.430365000,0.0000
215.158.239.41,<->,192.170.245.163,1,914,0,0,1,914,1.430053000,0.0000
82.216.237.67,<->,8.220.176.253,0,0,1,50,1,50,1.429935000,0.0000
99.175.115.144,<->,53.69.209.31,1,125,0,0,1,125,1.429869000,0.0000
145.213.37.27,<->,129.224.112.252,0,0,1,80,1,80,1.429838000,0.0000
206.69.88.245,<->,89.183.104.132,0,0,1,56,1,56,1.429707000,0.0000
138.98.251.122,<->,57.108.116.73,1,60,0,0,1,60,1.429673000,0.0000
21.15.226.126,<->,20.193.26.47,0,0,1,82,1,82,1.429630000,0.0000
144.75.218.242,<->,104.157.133.177,1,245,0,0,1,245,1.429568000,0.0000
159.137.189.208,<->,121.21.77.8,1,50,0,0,1,50,1.428465000,0.0000
215.158.239.70,<->,195.49.161.117,1,56,0,0,1,56,1.428035000,0.0000
210.229.230.19,<->,102.91.127.161,1,50,0,0,1,50,1.427661000,0.0000
156.25.203.110,<->,39.165.220.234,0,0,1,126,1,126,1.427550000,0.0000
21.15.226.126,<->,20.193.26.52,0,0,1,82,1,82,1.427512000,0.0000
132.249.70.201,<->,53.76.66.87,1,220,0,0,1,220,1.427491000,0.0000
195.85.172.107,<->,92.27.194.147,0,0,1,56,1,56,1.427450000,0.0000
206.17.243.41,<->,192.67.167.86,0,0,1,52,1,52,1.427326000,0.0000
248.239.130.16,<->,132.18.67.30,1,56,0,0,1,56,1.427306000,0.0000
215.158.239.49,<->,117.155.166.216,1,1229,0,0,1,1229,1.427048000,0.0000
98.221.132.61,<->,98.67.140.42,0,0,1,68,1,68,1.426812000,0.0000
246.253.253.99,<->,205.209.150.135,1,50,0,0,1,50,1.426514000,0.0000
195.78.233.48,<->,20.239.101.187,0,0,1,52,1,52,1.426383000,0.0000
94.24.92.161,<->,92.27.219.182,0,0,1,1470,1,1470,1.426294000,0.0000
244.50.133.60,<->,39.2.62.41,0,0,1,50,1,50,1.426131000,0.0000
133.73.194.44,<->,98.128.213.98,0,0,1,50,1,50,1.425948000,0.0000
220.60.81.165,<->,136.25.189.137,0,0,1,1064,1,1064,1.425843000,0.0000
198.69.238.131,<->,20.90.203.113,0,0,1,64,1,64,1.425799000,0.0000
109.1.16.146,<->,27.188.163.162,1,445,0,0,1,445,1.425590000,0.0000
125.16.190.46,<->,89.183.104.168,0,0,1,52,1,52,1.425433000,0.0000
152.46.164.158,<->,20.207.60.222,0,0,1,52,1,52,1.425383000,0.0000
138.31.199.22,<->,135.196.81.226,1,71,0,0,1,71,1.424991000,0.0000
140.174.85.72,<->,136.25.189.46,0,0,1,1325,1,1325,1.424930000,0.0000
142.221.188.66,<->,136.25.188.253,0,0,1,303,1,303,1.424860000,0.0000
200.174.30.120,<->,129.187.1.168,1,50,0,0,1,50,1.424754000,0.0000
46.130.98.87,<->,20.131.160.129,0,0,1,80,1,80,1.424612000,0.0000
199.21.97.120,<->,8.183.24.79,0,0,1,50,1,50,1.424332000,0.0000
145.252.116.252,<->,67.128.20.230,1,64,0,0,1,64,1.424190000,0.0000
53.69.143.15,<->,48.55.110.73,0,0,1,81,1,81,1.424157000,0.0000
92.27.219.137,<->,27.64.155.243,1,64,0,0,1,64,1.424019000,0.0000
131.249.19.234,<->,39.33.250.45,0,0,1,68,1,68,1.423926000,0.0000
143.90.198.69,<->,92.27.194.147,0,0,1,56,1,56,1.423216000,0.0000
235.228.134.154,<->,89.183.104.226,0,0,1,52,1,52,1.422834000,0.0000
230.74.202.4,<->,98.128.220.206,0,0,1,94,1,94,1.422773000,0.0000
204.58.137.121,<->,136.25.188.196,0,0,1,50,1,50,1.422413000,0.0000
145.61.86.82,<->,8.182.239.159,0,0,1,50,1,50,1.422228000,0.0000
215.158.239.97,<->,199.20.4.254,1,749,0,0,1,749,1.421961000,0.0000
97.126.103.29,<->,96.207.170.56,1,384,0,0,1,384,1.421879000,0.0000
53.89.220.45,<->,39.15.169.14,0,0,1,87,1,87,1.421806000,0.0000
198.245.131.47,<->,97.198.118.110,0,0,1,50,1,50,1.421506000,0.0000
148.57.209.154,<->,20.139.29.247,0,0,1,64,1,64,1.421477000,0.0000
126.253.26.254,<->,20.10.173.10,0,0,1,64,1,64,1.421283000,0.0000
148.91.20.8,<->,92.27.219.62,0,0,1,56,1,56,1.420993000,0.0000
119.124.169.175,<->,20.194.218.50,0,0,1,64,1,64,1.420968000,0.0000
39.164.12.41,<->,38.182.85.209,1,107,0,0,1,107,1.420508000,0.0000
210.229.230.12,<->,123.195.212.52,1,52,0,0,1,52,1.420439000,0.0000
119.90.250.200,<->,39.17.141.18,0,0,1,50,1,50,1.420270000,0.0000
215.158.239.48,<->,204.226.48.181,1,312,0,0,1,312,1.420178000,0.0000
192.64.226.189,<->,64.214.44.95,1,50,0,0,1,50,1.419820000,0.0000
104.253.252.177,<->,20.169.51.107,0,0,1,52,1,52,1.419704000,0.0000
106.162.99.24,<->,20.138.185.24,0,0,1,79,1,79,1.419553000,0.0000
204.200.32.96,<->,136.25.188.220,0,0,1,56,1,56,1.419381000,0.0000
132.151.129.234,<->,118.10.0.235,1,77,0,0,1,77,1.418846000,0.0000
201.216.164.96,<->,39.2.106.193,0,0,1,64,1,64,1.418839000,0.0000
127.92.137.146,<->,109.1.23.39,0,0,1,357,1,357,1.418520000,0.0000
252.72.199.121,<->,53.148.21.222,1,125,0,0,1,125,1.418287000,0.0000
144.75.218.242,<->,138.127.230.26,1,254,0,0,1,254,1.418192000,0.0000
92.27.194.117,<->,38.69.45.207,1,64,0,0,1,64,1.417740000,0.0000
204.16.203.227,<->,102.50.141.39,0,0,1,147,1,147,1.417585000,0.0000
136.209.190.221,<->,80.56.78.92,0,0,1,100,1,100,1.417561000,0.0000
215.158.239.58,<->,207.62.35.138,1,50,0,0,1,50,1.417504000,0.0000
246.253.234.180,<->,241.193.172.231,1,50,0,0,1,50,1.417446000,0.0000
69.128.107.113,<->,53.214.77.100,1,115,0,0,1,115,1.417102000,0.0000
139.163.26.146,<->,92.180.160.229,1,99,0,0,1,99,1.416805000,0.0000
199.122.1.27,<->,136.25.188.222,0,0,1,56,1,56,1.416728000,0.0000
59.49.73.35,<->,56.121.55.242,0,0,1,64,1,64,1.416684000,0.0000
112.226.101.215,<->,80.42.168.43,0,0,1,1213,1,1213,1.416584000,0.0000
144.75.218.237,<->,93.181.133.172,1,159,0,0,1,159,1.416495000,0.0000
80.38.11.142,<->,36.117.120.239,1,56,0,0,1,56,1.416402000,0.0000
192.67.182.87,<->,104.246.28.67,1,56,0,0,1,56,1.416399000,0.0000
118.208.189.32,<->,89.183.104.250,0,0,1,52,1,52,1.416305000,0.0000
126.224.233.68,<->,20.29.190.57,0,0,1,64,1,64,1.416118000,0.0000
75.62.16.8,<->,39.194.107.54,0,0,1,50,1,50,1.415773000,0.0000
89.183.104.141,<->,33.240.17.69,1,52,0,0,1,52,1.415584000,0.0000
207.114.13.176,<->,39.214.99.120,0,0,1,60,1,60,1.415010000,0.0000
244.50.229.157,<->,20.143.184.254,0,0,1,50,1,50,1.414825000,0.0000
215.158.239.92,<->,196.104.42.192,1,64,0,0,1,64,1.414667000,0.0000
198.101.112.240,<->,92.27.219.169,0,0,1,315,1,315,1.414354000,0.0000
69.246.51.253,<->,34.232.145.108,0,0,1,60,1,60,1.414019000,0.0000
232.117.172.125,<->,220.55.99.127,0,0,1,50,1,50,1.413970000,0.0000
199.12.125.72,<->,20.11.148.26,0,0,1,64,1,64,1.413594000,0.0000
129.92.117.130,<->,53.247.178.225,1,50,0,0,1,50,1.413245000,0.0000
196.250.234.88,<->,20.140.166.229,0,0,1,64,1,64,1.413191000,0.0000
109.1.56.197,<->,8.179.135.180,1,64,0,0,1,64,1.413004000,0.0000
215.158.61.191,<->,8.176.8.255,0,0,1,861,1,861,1.412945000,0.0000
104.254.207.183,<->,20.255.101.28,0,0,1,52,1,52,1.412713000,0.0000
136.25.189.93,<->,29.211.206.37,1,83,0,0,1,83,1.412694000,0.0000
215.158.239.97,<->,207.57.17.96,1,93,0,0,1,93,1.412610000,0.0000
109.0.213.196,<->,33.219.189.220,1,355,0,0,1,355,1.412347000,0.0000
57.199.250.208,<->,8.52.187.45,0,0,1,1002,1,1002,1.412004000,0.0000
123.166.192.199,<->,20.249.174.226,0,0,1,64,1,64,1.411829000,0.0000
226.162.38.40,<->,99.75.4.225,0,0,1,145,1,145,1.411580000,0.0000
207.176.222.178,<->,89.183.104.137,0,0,1,52,1,52,1.411044000,0.0000
112.42.120.15,<->,92.27.219.160,0,0,1,68,1,68,1.411032000,0.0000
207.172.169.238,<->,136.25.188.163,0,0,1,117,1,117,1.411022000,0.0000
136.221.119.73,<->,20.21.128.227,0,0,1,64,1,64,1.410996000,0.0000
200.174.209.71,<->,53.212.203.200,1,64,0,0,1,64,1.410960000,0.0000
246.253.253.96,<->,210.209.251.214,1,50,0,0,1,50,1.410380000,0.0000
98.23.96.93,<->,89.183.104.255,0,0,1,56,1,56,1.410344000,0.0000
139.163.1.75,<->,38.49.236.26,1,50,0,0,1,50,1.410282000,0.0000
98.246.18.142,<->,20.127.54.118,0,0,1,50,1,50,1.410267000,0.0000
92.27.131.126,<->,89.183.104.255,0,0,1,56,1,56,1.410144000,0.0000
224.46.94.193,<->,20.18.212.15,0,0,1,64,1,64,1.410018000,0.0000
98.23.121.218,<->,89.183.104.255,0,0,1,56,1,56,1.409873000,0.0000
66.56.90.215,<->,34.225.106.243,0,0,1,52,1,52,1.409679000,0.0000
92.27.219.233,<->,33.250.48.170,1,326,0,0,1,326,1.409527000,0.0000
143.252.204.233,<->,129.224.112.252,0,0,1,76,1,76,1.409526000,0.0000
82.99.240.203,<->,8.220.203.35,0,0,1,704,1,704,1.409060000,0.0000
215.158.140.14,<->,192.171.13.188,1,167,0,0,1,167,1.408874000,0.0000
92.27.27.165,<->,33.73.66.169,1,56,0,0,1,56,1.408871000,0.0000
97.126.26.40,<->,53.167.244.138,1,126,0,0,1,126,1.408769000,0.0000
159.69.187.49,<->,144.108.64.185,1,66,0,0,1,66,1.408721000,0.0000
152.44.123.253,<->,92.27.235.58,0,0,1,133,1,133,1.408370000,0.0000
98.23.96.95,<->,89.183.104.255,0,0,1,56,1,56,1.408319000,0.0000
123.129.21.51,<->,100.92.137.60,0,0,1,56,1,56,1.408250000,0.0000
136.25.188.105,<->,100.185.121.91,1,119,0,0,1,119,1.407799000,0.0000
33.119.247.97,<->,20.203.209.207,0,0,1,76,1,76,1.407625000,0.0000
142.177.62.236,<->,50.223.3.228,0,0,1,50,1,50,1.406725000,0.0000
142.236.192.102,<->,136.25.188.242,0,0,1,859,1,859,1.406703000,0.0000
202.33.243.89,<->,136.25.188.240,0,0,1,50,1,50,1.406566000,0.0000
114.75.170.84,<->,8.52.169.61,0,0,1,56,1,56,1.406462000,0.0000
109.222.212.23,<->,69.196.212.63,1,1470,0,0,1,1470,1.406407000,0.0000
98.67.137.59,<->,53.195.60.13,1,56,0,0,1,56,1.405908000,0.0000
90.240.3.29,<->,53.244.102.135,1,56,0,0,1,56,1.405733000,0.0000
89.183.104.159,<->,75.95.12.84,1,52,0,0,1,52,1.405585000,0.0000
129.224.112.252,<->,92.162.219.215,1,74,0,0,1,74,1.405575000,0.0000
139.163.26.238,<->,29.222.101.237,1,50,0,0,1,50,1.405572000,0.0000
136.25.188.105,<->,33.223.144.204,1,88,0,0,1,88,1.405534000,0.0000
98.210.125.9,<->,8.52.181.8,0,0,1,68,1,68,1.405533000,0.0000
98.246.18.142,<->,20.217.201.146,0,0,1,50,1,50,1.405004000,0.0000
204.60.247.252,<->,136.25.188.198,0,0,1,56,1,56,1.404767000,0.0000
204.184.39.76,<->,136.25.188.52,0,0,1,84,1,84,1.404720000,0.0000
145.252.115.36,<->,112.6.251.74,1,50,0,0,1,50,1.404565000,0.0000
96.45.105.226,<->,8.52.222.23,0,0,1,50,1,50,1.404486000,0.0000
222.21.15.70,<->,109.222.220.116,0,0,1,82,1,82,1.404296000,0.0000
215.158.239.95,<->,199.20.29.151,1,765,0,0,1,765,1.404177000,0.0000
99.75.85.95,<->,8.55.194.232,1,56,0,0,1,56,1.403976000,0.0000
206.195.34.165,<->,192.229.216.117,0,0,1,56,1,56,1.403515000,0.0000
204.143.125.121,<->,20.80.245.70,0,0,1,56,1,56,1.403449000,0.0000
127.212.165.217,<->,89.183.104.159,0,0,1,378,1,378,1.403364000,0.0000
220.20.200.135,<->,144.83.60.153,1,50,0,0,1,50,1.403289000,0.0000
136.25.188.242,<->,76.127.207.59,1,56,0,0,1,56,1.403200000,0.0000
199.50.28.3,<->,92.27.219.235,0,0,1,52,1,52,1.403166000,0.0000
149.217.70.251,<->,8.228.215.123,0,0,1,135,1,135,1.403080000,0.0000
119.90.219.166,<->,39.172.28.65,0,0,1,76,1,76,1.403068000,0.0000
124.232.32.37,<->,39.48.158.191,0,0,1,64,1,64,1.402903000,0.0000
192.171.13.190,<->,133.178.226.222,0,0,1,153,1,153,1.402655000,0.0000
218.38.100.178,<->,8.182.250.109,0,0,1,50,1,50,1.402560000,0.0000
241.193.172.231,<->,20.86.89.103,0,0,1,50,1,50,1.402450000,0.0000
203.49.212.41,<->,129.224.112.252,0,0,1,79,1,79,1.402316000,0.0000
111.151.142.231,<->,99.74.26.102,0,0,1,56,1,56,1.402306000,0.0000
159.213.211.217,<->,144.86.122.246,1,76,0,0,1,76,1.402200000,0.0000
64.151.28.80,<->,39.136.184.119,0,0,1,100,1,100,1.402156000,0.0000
136.18.70.77,<->,8.182.253.116,0,0,1,50,1,50,1.401939000,0.0000
123.88.254.57,<->,8.220.176.226,0,0,1,84,1,84,1.401700000,0.0000
137.68.217.95,<->,20.209.165.106,0,0,1,64,1,64,1.401587000,0.0000
98.23.107.90,<->,92.27.27.233,0,0,1,86,1,86,1.401572000,0.0000
139.193.141.200,<->,50.17.161.217,1,50,0,0,1,50,1.400954000,0.0000
215.158.239.85,<->,196.94.109.52,1,717,0,0,1,717,1.400829000,0.0000
210.209.251.211,<->,98.129.77.37,0,0,1,50,1,50,1.400624000,0.0000
21.15.226.126,<->,20.193.26.213,0,0,1,82,1,82,1.400474000,0.0000
159.57.90.83,<->,137.129.41.249,0,0,1,50,1,50,1.400108000,0.0000
8.52.187.232,<->,6.228.239.25,1,50,0,0,1,50,1.399772000,0.0000
39.15.158.240,<->,30.249.67.98,1,52,0,0,1,52,1.399637000,0.0000
195.120.55.242,<->,20.159.32.62,0,0,1,71,1,71,1.399504000,0.0000
120.178.25.236,<->,20.240.200.154,0,0,1,52,1,52,1.399395000,0.0000
198.158.197.83,<->,20.185.191.161,0,0,1,50,1,50,1.399318000,0.0000
204.130.115.164,<->,29.211.214.32,0,0,1,106,1,106,1.399224000,0.0000
136.25.188.238,<->,76.136.20.73,1,56,0,0,1,56,1.399150000,0.0000
204.184.220.37,<->,136.25.188.226,0,0,1,56,1,56,1.399081000,0.0000
137.81.65.53,<->,101.87.248.102,1,76,0,0,1,76,1.398491000,0.0000
106.208.59.165,<->,39.162.9.20,0,0,1,68,1,68,1.398229000,0.0000
17.235.224.55,<->,8.220.238.247,0,0,1,50,1,50,1.398192000,0.0000
119.125.118.44,<->,20.44.126.160,0,0,1,64,1,64,1.398184000,0.0000
136.25.188.106,<->,26.180.97.85,1,60,0,0,1,60,1.397983000,0.0000
39.28.204.157,<->,35.56.74.27,1,52,0,0,1,52,1.397941000,0.0000
247.136.153.202,<->,104.53.162.197,1,97,0,0,1,97,1.397722000,0.0000
73.118.12.112,<->,34.106.63.130,0,0,1,50,1,50,1.397550000,0.0000
159.137.226.12,<->,142.246.30.12,1,75,0,0,1,75,1.397503000,0.0000
89.183.104.138,<->,88.5.193.50,1,52,0,0,1,52,1.397498000,0.0000
193.94.47.49,<->,8.52.181.39,0,0,1,64,1,64,1.397400000,0.0000
254.70.160.124,<->,80.42.185.67,0,0,1,135,1,135,1.396976000,0.0000
92.27.219.187,<->,78.55.239.161,1,52,0,0,1,52,1.396937000,0.0000
102.51.147.16,<->,38.177.5.39,1,102,0,0,1,102,1.396675000,0.0000
111.147.166.45,<->,53.149.44.254,1,125,0,0,1,125,1.396597000,0.0000
50.224.76.235,<->,18.51.233.128,1,50,0,0,1,50,1.396569000,0.0000
144.75.218.241,<->,138.127.231.226,1,250,0,0,1,250,1.396503000,0.0000
89.71.27.68,<->,56.121.47.18,0,0,1,56,1,56,1.396492000,0.0000
207.194.74.176,<->,80.42.179.161,0,0,1,64,1,64,1.396378000,0.0000
198.158.197.83,<->,20.75.147.19,0,0,1,50,1,50,1.396084000,0.0000
221.102.143.189,<->,80.40.17.42,0,0,1,87,1,87,1.395794000,0.0000
92.27.219.147,<->,33.57.74.156,1,50,0,0,1,50,1.395578000,0.0000
143.44.160.188,<->,8.52.171.120,0,0,1,50,1,50,1.395573000,0.0000
92.27.219.156,<->,78.49.228.11,1,52,0,0,1,52,1.395203000,0.0000
192.239.189.216,<->,8.20.87.155,0,0,1,50,1,50,1.395009000,0.0000
143.252.204.234,<->,97.68.226.205,0,0,1,74,1,74,1.394919000,0.0000
124.29.255.45,<->,20.253.243.154,0,0,1,64,1,64,1.394454000,0.0000
104.113.118.13,<->,80.40.34.206,0,0,1,97,1,97,1.394453000,0.0000
195.68.154.205,<->,136.25.188.198,0,0,1,602,1,602,1.394054000,0.0000
196.119.218.37,<->,8.52.147.137,0,0,1,50,1,50,1.393956000,0.0000
229.96.180.117,<->,205.225.112.16,1,50,0,0,1,50,1.393811000,0.0000
120.83.81.74,<->,92.27.27.152,0,0,1,64,1,64,1.393739000,0.0000
198.158.197.83,<->,20.222.167.248,0,0,1,50,1,50,1.393574000,0.0000
241.193.172.231,<->,20.33.108.82,0,0,1,50,1,50,1.393556000,0.0000
8.252.221.231,<->,4.122.179.11,1,50,0,0,1,50,1.393519000,0.0000
192.67.178.12,<->,120.214.189.111,1,130,0,0,1,130,1.393263000,0.0000
69.196.64.236,<->,39.147.215.5,0,0,1,64,1,64,1.393218000,0.0000
195.54.136.117,<->,92.27.219.31,0,0,1,56,1,56,1.393195000,0.0000
215.158.61.193,<->,136.25.188.40,0,0,1,781,1,781,1.392851000,0.0000
215.158.239.97,<->,207.190.46.182,1,64,0,0,1,64,1.392627000,0.0000
8.235.54.44,<->,8.228.219.242,0,0,1,50,1,50,1.392532000,0.0000
215.158.140.180,<->,111.151.106.202,1,56,0,0,1,56,1.392079000,0.0000
231.143.107.87,<->,136.25.188.226,0,0,1,107,1,107,1.391797000,0.0000
199.32.212.173,<->,136.25.188.175,0,0,1,56,1,56,1.391458000,0.0000
214.237.183.200,<->,0.195.210.46,0,0,1,56,1,56,1.391305000,0.0000
39.149.74.56,<->,0.48.111.58,1,50,0,0,1,50,1.391157000,0.0000
215.158.239.84,<->,196.88.163.81,1,56,0,0,1,56,1.391104000,0.0000
204.255.100.40,<->,39.17.249.238,0,0,1,108,1,108,1.391046000,0.0000
193.46.99.139,<->,111.147.173.47,0,0,1,129,1,129,1.390872000,0.0000
204.93.197.173,<->,100.92.12.131,0,0,1,52,1,52,1.390757000,0.0000
231.140.209.175,<->,215.158.239.69,0,0,1,64,1,64,1.390506000,0.0000
140.17.122.242,<->,80.42.230.174,0,0,1,50,1,50,1.390432000,0.0000
195.71.69.147,<->,136.25.188.176,0,0,1,50,1,50,1.390342000,0.0000
215.158.195.11,<->,111.150.207.194,1,56,0,0,1,56,1.390282000,0.0000
215.158.42.84,<->,133.178.226.246,0,0,1,56,1,56,1.390191000,0.0000
98.158.91.22,<->,8.182.248.147,0,0,1,50,1,50,1.390118000,0.0000
39.236.188.165,<->,0.48.111.58,1,50,0,0,1,50,1.390100000,0.0000
144.75.218.233,<->,138.127.230.52,1,169,0,0,1,169,1.389880000,0.0000
253.107.166.218,<->,139.163.1.154,0,0,1,50,1,50,1.389817000,0.0000
109.222.255.199,<->,97.4.17.33,1,50,0,0,1,50,1.389811000,0.0000
144.87.235.187,<->,80.47.23.44,1,68,0,0,1,68,1.389608000,0.0000
144.75.218.237,<->,96.45.188.119,1,84,0,0,1,84,1.389256000,0.0000
144.75.218.237,<->,97.6.59.193,1,194,0,0,1,194,1.389238000,0.0000
105.201.172.83,<->,100.93.171.75,0,0,1,90,1,90,1.389214000,0.0000
93.184.235.2,<->,39.38.178.11,0,0,1,52,1,52,1.389025000,0.0000
106.150.234.231,<->,92.27.27.185,0,0,1,213,1,213,1.388663000,0.0000
93.0.159.217,<->,92.27.27.151,0,0,1,133,1,133,1.388568000,0.0000
215.158.239.95,<->,196.94.114.231,1,56,0,0,1,56,1.388463000,0.0000
197.68.57.83,<->,39.167.39.74,0,0,1,64,1,64,1.388421000,0.0000
144.75.218.235,<->,138.127.224.19,1,366,0,0,1,366,1.388140000,0.0000
92.27.219.239,<->,77.49.51.18,1,293,0,0,1,293,1.387476000,0.0000
222.68.68.146,<->,144.95.111.109,1,71,0,0,1,71,1.386610000,0.0000
144.75.218.235,<->,138.127.231.185,1,366,0,0,1,366,1.386134000,0.0000
215.158.239.97,<->,196.106.26.214,1,602,0,0,1,602,1.386020000,0.0000
112.54.57.158,<->,39.135.54.44,0,0,1,108,1,108,1.385881000,0.0000
139.7.96.246,<->,92.27.234.104,0,0,1,56,1,56,1.385609000,0.0000
109.1.58.244,<->,48.107.238.147,1,56,0,0,1,56,1.385091000,0.0000
109.222.253.182,<->,84.2.158.229,1,68,0,0,1,68,1.384998000,0.0000
54.39.195.17,<->,48.53.91.32,0,0,1,50,1,50,1.384723000,0.0000
97.126.4.233,<->,53.196.130.109,1,385,0,0,1,385,1.384636000,0.0000
247.136.144.152,<->,92.160.68.225,1,50,0,0,1,50,1.384510000,0.0000
255.133.39.74,<->,220.49.48.127,1,50,0,0,1,50,1.384419000,0.0000
109.1.61.153,<->,53.167.159.127,1,57,0,0,1,57,1.384348000,0.0000
21.15.226.126,<->,20.193.27.63,0,0,1,82,1,82,1.383762000,0.0000
113.127.207.90,<->,97.126.113.135,0,0,1,64,1,64,1.383611000,0.0000
119.114.158.55,<->,20.167.62.247,0,0,1,64,1,64,1.383502000,0.0000
123.130.135.16,<->,8.250.153.211,0,0,1,704,1,704,1.383483000,0.0000
193.51.220.212,<->,98.236.90.102,0,0,1,50,1,50,1.383320000,0.0000
136.25.189.210,<->,80.47.43.233,1,89,0,0,1,89,1.382977000,0.0000
132.103.198.70,<->,119.121.24.104,1,64,0,0,1,64,1.382822000,0.0000
215.158.239.70,<->,199.20.23.229,1,50,0,0,1,50,1.382611000,0.0000
144.75.218.241,<->,100.215.74.232,1,128,0,0,1,128,1.381803000,0.0000
53.149.94.1,<->,48.55.122.251,0,0,1,56,1,56,1.381258000,0.0000
198.151.28.229,<->,20.144.24.125,0,0,1,64,1,64,1.381238000,0.0000
215.158.239.85,<->,199.20.4.252,1,1128,0,0,1,1128,1.381159000,0.0000
92.27.219.231,<->,57.62.62.79,1,325,0,0,1,325,1.381153000,0.0000
144.75.218.241,<->,138.127.230.1,1,365,0,0,1,365,1.380979000,0.0000
143.148.189.199,<->,20.126.76.167,0,0,1,106,1,106,1.380815000,0.0000
144.75.218.233,<->,138.127.224.111,1,366,0,0,1,366,1.380485000,0.0000
248.239.170.17,<->,124.26.85.55,1,130,0,0,1,130,1.380194000,0.0000
145.16.10.145,<->,144.85.169.246,1,1424,0,0,1,1424,1.380171000,0.0000
199.71.218.4,<->,136.25.188.225,0,0,1,50,1,50,1.379522000,0.0000
92.27.219.62,<->,80.38.154.203,1,52,0,0,1,52,1.379520000,0.0000
139.150.137.84,<->,8.52.189.207,0,0,1,50,1,50,1.379454000,0.0000
193.47.198.229,<->,8.52.222.230,0,0,1,67,1,67,1.379434000,0.0000
244.50.129.64,<->,39.56.168.93,0,0,1,50,1,50,1.379190000,0.0000
136.109.250.193,<->,97.126.11.149,0,0,1,78,1,78,1.378623000,0.0000
21.15.226.126,<->,20.193.27.28,0,0,1,82,1,82,1.378526000,0.0000
194.209.152.253,<->,39.24.140.88,0,0,1,108,1,108,1.378491000,0.0000
232.31.162.70,<->,99.75.139.232,0,0,1,50,1,50,1.378279000,0.0000
88.3.63.208,<->,39.34.121.106,0,0,1,64,1,64,1.378233000,0.0000
195.39.175.170,<->,20.249.182.102,0,0,1,64,1,64,1.378173000,0.0000
215.158.103.206,<->,138.127.224.10,1,242,0,0,1,242,1.378017000,0.0000
111.147.180.135,<->,54.37.105.75,1,50,0,0,1,50,1.377954000,0.0000
220.55.106.26,<->,120.247.80.243,1,50,0,0,1,50,1.377705000,0.0000
111.150.207.167,<->,8.176.8.189,0,0,1,56,1,56,1.377699000,0.0000
210.229.230.21,<->,111.93.85.22,1,68,0,0,1,68,1.377493000,0.0000
207.175.241.62,<->,136.25.188.47,0,0,1,56,1,56,1.377397000,0.0000
215.158.239.57,<->,199.20.4.207,1,68,0,0,1,68,1.377322000,0.0000
123.130.135.16,<->,8.220.204.215,0,0,1,704,1,704,1.377104000,0.0000
218.138.240.252,<->,8.220.191.118,0,0,1,50,1,50,1.376928000,0.0000
106.184.11.222,<->,92.27.219.31,0,0,1,52,1,52,1.376926000,0.0000
153.241.226.86,<->,144.105.43.34,0,0,1,133,1,133,1.376583000,0.0000
109.127.156.13,<->,8.220.191.251,0,0,1,50,1,50,1.376286000,0.0000
100.144.209.34,<->,8.220.189.236,0,0,1,50,1,50,1.376025000,0.0000
215.158.238.223,<->,100.50.96.239,1,1117,0,0,1,1117,1.376016000,0.0000
159.14.215.42,<->,133.32.39.1,0,0,1,1004,1,1004,1.375959000,0.0000
144.75.218.237,<->,138.127.231.76,1,261,0,0,1,261,1.375937000,0.0000
247.136.240.193,<->,122.116.49.171,1,321,0,0,1,321,1.375578000,0.0000
215.158.103.206,<->,148.111.30.85,1,75,0,0,1,75,1.375286000,0.0000
6.145.168.170,<->,0.195.210.46,0,0,1,68,1,68,1.374425000,0.0000
126.253.26.254,<->,20.10.173.20,0,0,1,64,1,64,1.374132000,0.0000
136.18.96.45,<->,8.182.253.116,0,0,1,56,1,56,1.373928000,0.0000
207.56.98.0,<->,136.25.188.55,0,0,1,56,1,56,1.373927000,0.0000
94.39.58.57,<->,92.27.219.214,0,0,1,64,1,64,1.373808000,0.0000
246.253.248.211,<->,140.143.190.248,1,86,0,0,1,86,1.373651000,0.0000
21.15.226.126,<->,20.193.27.47,0,0,1,82,1,82,1.373551000,0.0000
212.119.15.90,<->,144.75.218.242,0,0,1,84,1,84,1.373365000,0.0000
133.178.226.227,<->,111.151.139.217,1,56,0,0,1,56,1.373337000,0.0000
94.25.103.250,<->,92.27.27.175,0,0,1,52,1,52,1.372979000,0.0000
96.232.43.155,<->,92.27.219.55,0,0,1,50,1,50,1.372900000,0.0000
137.69.196.28,<->,8.182.244.237,0,0,1,50,1,50,1.372895000,0.0000
6.145.153.218,<->,0.195.210.44,0,0,1,173,1,173,1.372865000,0.0000
241.228.121.155,<->,140.17.122.242,1,50,0,0,1,50,1.372615000,0.0000
74.172.12.255,<->,50.224.76.234,0,0,1,50,1,50,1.372549000,0.0000
144.122.240.237,<->,144.76.43.238,1,75,0,0,1,75,1.372479000,0.0000
97.68.226.205,<->,50.131.177.136,1,79,0,0,1,79,1.372445000,0.0000
207.200.207.63,<->,8.252.222.225,0,0,1,580,1,580,1.372415000,0.0000
215.158.239.19,<->,198.233.198.222,1,50,0,0,1,50,1.372407000,0.0000
247.136.254.97,<->,121.179.37.149,1,149,0,0,1,149,1.372048000,0.0000
89.178.121.124,<->,50.224.76.230,0,0,1,50,1,50,1.371480000,0.0000
159.69.187.23,<->,144.108.64.181,1,78,0,0,1,78,1.371172000,0.0000
17.41.129.150,<->,8.53.2.255,0,0,1,50,1,50,1.370021000,0.0000
133.32.39.22,<->,111.150.207.125,1,56,0,0,1,56,1.369505000,0.0000
144.75.218.233,<->,138.127.230.151,1,68,0,0,1,68,1.369276000,0.0000
215.158.239.32,<->,142.227.121.175,1,50,0,0,1,50,1.369235000,0.0000
136.25.188.105,<->,56.112.1.18,1,129,0,0,1,129,1.369052000,0.0000
144.75.218.237,<->,138.127.225.225,1,366,0,0,1,366,1.368994000,0.0000
192.64.206.242,<->,64.214.57.1,1,55,0,0,1,55,1.368662000,0.0000
80.40.33.147,<->,8.55.135.127,1,394,0,0,1,394,1.368571000,0.0000
144.75.218.242,<->,139.252.1.219,1,87,0,0,1,87,1.368222000,0.0000
223.138.245.37,<->,111.147.149.36,0,0,1,106,1,106,1.368096000,0.0000
121.129.65.147,<->,20.213.26.98,0,0,1,107,1,107,1.367723000,0.0000
199.69.165.34,<->,136.25.188.241,0,0,1,56,1,56,1.367629000,0.0000
145.158.81.92,<->,53.167.126.0,1,56,0,0,1,56,1.367300000,0.0000
243.135.166.6,<->,20.176.192.246,0,0,1,52,1,52,1.367175000,0.0000
144.75.218.235,<->,138.127.230.46,1,366,0,0,1,366,1.366557000,0.0000
215.158.239.56,<->,196.92.209.107,1,50,0,0,1,50,1.366398000,0.0000
97.126.114.17,<->,69.32.87.30,1,80,0,0,1,80,1.366257000,0.0000
200.175.133.69,<->,53.69.18.13,1,87,0,0,1,87,1.366196000,0.0000
249.101.207.245,<->,131.99.111.30,1,389,0,0,1,389,1.366012000,0.0000
136.25.188.72,<->,111.151.142.200,1,56,0,0,1,56,1.366005000,0.0000
131.130.178.255,<->,92.27.219.16,0,0,1,343,1,343,1.365911000,0.0000
194.193.224.9,<->,89.183.104.137,0,0,1,52,1,52,1.365891000,0.0000
80.41.44.150,<->,42.68.246.99,1,50,0,0,1,50,1.365275000,0.0000
244.50.136.175,<->,20.1.220.149,0,0,1,50,1,50,1.365187000,0.0000
146.243.39.232,<->,133.53.173.234,0,0,1,133,1,133,1.364985000,0.0000
133.178.227.6,<->,111.150.207.240,1,56,0,0,1,56,1.364964000,0.0000
122.212.149.92,<->,20.115.175.116,0,0,1,64,1,64,1.364893000,0.0000
131.5.161.231,<->,20.178.191.183,0,0,1,52,1,52,1.364731000,0.0000
125.84.145.15,<->,8.43.223.42,0,0,1,704,1,704,1.364608000,0.0000
89.183.104.229,<->,0.246.11.19,1,130,0,0,1,130,1.364374000,0.0000
93.104.212.227,<->,39.246.79.210,0,0,1,64,1,64,1.364246000,0.0000
193.46.99.139,<->,92.27.27.176,0,0,1,90,1,90,1.364098000,0.0000
215.158.239.57,<->,199.20.29.156,1,64,0,0,1,64,1.364005000,0.0000
230.61.211.6,<->,98.128.96.179,0,0,1,138,1,138,1.363951000,0.0000
138.0.9.133,<->,109.1.60.149,0,0,1,56,1,56,1.363718000,0.0000
215.158.239.70,<->,196.90.57.83,1,50,0,0,1,50,1.363641000,0.0000
8.182.251.218,<->,6.242.3.167,1,56,0,0,1,56,1.363620000,0.0000
215.158.239.56,<->,142.166.40.166,1,456,0,0,1,456,1.363543000,0.0000
133.178.227.229,<->,111.52.90.166,1,50,0,0,1,50,1.363360000,0.0000
246.253.248.211,<->,126.219.191.103,1,79,0,0,1,79,1.362986000,0.0000
21.15.226.126,<->,20.193.27.11,0,0,1,82,1,82,1.362974000,0.0000
205.89.142.184,<->,39.7.91.215,0,0,1,52,1,52,1.362720000,0.0000
215.158.239.49,<->,196.90.30.168,1,64,0,0,1,64,1.362587000,0.0000
159.69.187.31,<->,144.108.64.183,1,68,0,0,1,68,1.362546000,0.0000
192.64.211.88,<->,75.93.160.227,1,68,0,0,1,68,1.362491000,0.0000
145.252.119.241,<->,109.50.86.163,1,50,0,0,1,50,1.362098000,0.0000
149.230.224.252,<->,20.253.18.223,0,0,1,76,1,76,1.361815000,0.0000
139.254.208.193,<->,58.132.150.196,1,93,0,0,1,93,1.361785000,0.0000
21.15.226.126,<->,20.193.27.12,0,0,1,82,1,82,1.361660000,0.0000
248.225.27.2,<->,139.123.56.52,1,150,0,0,1,150,1.361584000,0.0000
206.195.248.172,<->,108.134.118.112,0,0,1,56,1,56,1.361077000,0.0000
247.136.235.7,<->,131.2.232.121,1,56,0,0,1,56,1.360872000,0.0000
241.193.172.231,<->,20.100.210.235,0,0,1,50,1,50,1.360654000,0.0000
141.252.217.88,<->,58.43.188.34,1,50,0,0,1,50,1.360536000,0.0000
111.151.142.210,<->,99.74.26.147,0,0,1,56,1,56,1.360316000,0.0000
144.75.218.242,<->,138.127.225.123,1,182,0,0,1,182,1.360010000,0.0000
192.67.154.172,<->,133.202.63.154,1,52,0,0,1,52,1.359582000,0.0000
215.158.239.76,<->,199.20.28.114,1,50,0,0,1,50,1.359493000,0.0000
144.72.193.201,<->,99.74.36.20,0,0,1,50,1,50,1.359334000,0.0000
144.75.218.242,<->,138.127.230.243,1,252,0,0,1,252,1.359144000,0.0000
120.111.89.250,<->,39.236.164.5,0,0,1,52,1,52,1.359136000,0.0000
144.85.170.254,<->,91.69.181.227,1,56,0,0,1,56,1.359117000,0.0000
136.98.166.244,<->,20.200.103.220,0,0,1,52,1,52,1.358868000,0.0000
247.136.216.15,<->,127.163.229.198,1,50,0,0,1,50,1.358795000,0.0000
129.123.31.5,<->,20.84.249.144,0,0,1,60,1,60,1.358723000,0.0000
17.255.114.121,<->,8.220.185.4,0,0,1,50,1,50,1.358615000,0.0000
215.158.239.56,<->,196.93.213.212,1,68,0,0,1,68,1.358370000,0.0000
215.158.239.50,<->,199.20.31.13,1,56,0,0,1,56,1.358315000,0.0000
142.221.188.66,<->,136.25.188.209,0,0,1,316,1,316,1.358220000,0.0000
133.178.227.54,<->,8.220.7.31,1,120,0,0,1,120,1.358123000,0.0000
92.27.219.166,<->,90.40.190.167,1,135,0,0,1,135,1.357883000,0.0000
198.70.252.33,<->,39.54.235.145,0,0,1,78,1,78,1.357730000,0.0000
196.251.249.205,<->,20.192.75.70,0,0,1,64,1,64,1.357552000,0.0000
215.158.61.183,<->,136.25.189.221,0,0,1,56,1,56,1.357468000,0.0000
121.93.243.7,<->,20.160.39.53,0,0,1,84,1,84,1.357460000,0.0000
139.163.84.114,<->,47.197.43.218,1,65,0,0,1,65,1.357362000,0.0000
137.74.95.14,<->,116.89.156.110,1,76,0,0,1,76,1.357169000,0.0000
59.51.25.129,<->,39.56.224.78,0,0,1,70,1,70,1.357125000,0.0000
243.117.82.214,<->,203.214.79.56,0,0,1,50,1,50,1.357049000,0.0000
144.122.240.237,<->,144.76.43.234,1,81,0,0,1,81,1.356994000,0.0000
199.12.125.72,<->,20.11.148.17,0,0,1,64,1,64,1.356966000,0.0000
113.214.85.27,<->,89.183.104.238,0,0,1,52,1,52,1.355976000,0.0000
204.185.45.182,<->,136.25.188.255,0,0,1,68,1,68,1.355865000,0.0000
114.48.32.71,<->,101.70.183.154,0,0,1,50,1,50,1.355570000,0.0000
136.25.188.173,<->,132.123.119.108,1,50,0,0,1,50,1.355345000,0.0000
192.67.129.30,<->,33.61.182.2,1,50,0,0,1,50,1.355315000,0.0000
144.75.218.246,<->,132.107.75.195,1,139,0,0,1,139,1.355206000,0.0000
98.156.192.214,<->,8.182.244.237,0,0,1,50,1,50,1.355175000,0.0000
17.248.138.62,<->,8.220.239.84,0,0,1,50,1,50,1.355113000,0.0000
207.92.35.87,<->,8.182.229.19,0,0,1,50,1,50,1.355113000,0.0000
56.110.160.138,<->,39.202.172.174,0,0,1,64,1,64,1.354871000,0.0000
241.193.172.231,<->,20.83.90.214,0,0,1,50,1,50,1.354819000,0.0000
93.181.154.109,<->,89.183.104.165,0,0,1,50,1,50,1.354554000,0.0000
215.158.239.85,<->,207.228.145.49,1,56,0,0,1,56,1.354118000,0.0000
142.222.45.79,<->,92.27.194.147,0,0,1,56,1,56,1.353865000,0.0000
57.145.136.234,<->,20.149.15.99,0,0,1,52,1,52,1.353848000,0.0000
112.70.86.223,<->,111.147.167.22,0,0,1,130,1,130,1.353826000,0.0000
254.78.46.138,<->,139.193.141.200,0,0,1,50,1,50,1.353700000,0.0000
192.64.196.19,<->,105.92.102.28,1,138,0,0,1,138,1.353662000,0.0000
123.167.67.17,<->,20.101.11.88,0,0,1,78,1,78,1.353609000,0.0000
215.158.239.58,<->,196.93.17.221,1,56,0,0,1,56,1.353389000,0.0000
138.98.231.23,<->,100.120.38.110,1,56,0,0,1,56,1.353191000,0.0000
198.54.166.189,<->,92.27.219.38,0,0,1,52,1,52,1.353127000,0.0000
144.75.218.242,<->,138.127.224.239,1,366,0,0,1,366,1.353065000,0.0000
127.81.2.139,<->,92.27.27.178,0,0,1,135,1,135,1.352208000,0.0000
144.86.148.17,<->,84.214.213.100,1,50,0,0,1,50,1.352069000,0.0000
118.20.111.94,<->,89.183.104.142,0,0,1,117,1,117,1.351721000,0.0000
143.72.76.156,<->,136.25.188.252,0,0,1,50,1,50,1.351619000,0.0000
126.225.252.134,<->,20.206.209.194,0,0,1,64,1,64,1.351605000,0.0000
126.224.165.180,<->,20.52.19.92,0,0,1,64,1,64,1.351542000,0.0000
205.125.255.72,<->,98.67.130.130,0,0,1,50,1,50,1.351298000,0.0000
97.126.100.53,<->,54.55.56.239,1,337,0,0,1,337,1.351119000,0.0000
215.158.239.84,<->,199.20.28.152,1,56,0,0,1,56,1.350520000,0.0000
89.216.125.82,<->,22.1.74.1,1,80,0,0,1,80,1.349760000,0.0000
220.80.148.178,<->,202.236.106.249,1,130,0,0,1,130,1.349487000,0.0000
146.87.6.182,<->,50.224.118.107,0,0,1,72,1,72,1.349485000,0.0000
56.51.219.42,<->,8.52.222.91,0,0,1,50,1,50,1.349468000,0.0000
207.194.74.176,<->,80.42.179.253,0,0,1,64,1,64,1.349439000,0.0000
215.158.239.77,<->,199.82.186.225,1,50,0,0,1,50,1.349098000,0.0000
135.247.123.8,<->,92.27.219.45,0,0,1,62,1,62,1.348873000,0.0000
196.113.186.195,<->,39.246.85.196,0,0,1,64,1,64,1.348846000,0.0000
109.222.251.159,<->,104.224.175.8,1,70,0,0,1,70,1.348762000,0.0000
144.83.60.153,<->,92.162.253.110,0,0,1,626,1,626,1.347840000,0.0000
203.63.18.111,<->,136.25.188.227,0,0,1,50,1,50,1.347593000,0.0000
215.158.239.87,<->,199.20.5.71,1,797,0,0,1,797,1.347320000,0.0000
144.75.218.241,<->,138.127.224.115,1,337,0,0,1,337,1.347037000,0.0000
196.113.186.195,<->,39.246.85.195,0,0,1,64,1,64,1.346846000,0.0000
112.234.147.188,<->,80.41.32.57,0,0,1,135,1,135,1.346806000,0.0000
21.15.226.126,<->,20.193.27.145,0,0,1,82,1,82,1.346578000,0.0000
192.67.133.141,<->,29.221.88.147,1,52,0,0,1,52,1.346551000,0.0000
204.200.34.97,<->,136.25.188.162,0,0,1,132,1,132,1.346225000,0.0000
215.158.239.85,<->,143.52.21.138,1,340,0,0,1,340,1.345557000,0.0000
158.55.6.69,<->,20.64.17.77,0,0,1,64,1,64,1.345536000,0.0000
113.156.134.6,<->,111.147.232.81,0,0,1,73,1,73,1.345501000,0.0000
223.143.99.201,<->,89.183.110.85,0,0,1,130,1,130,1.345408000,0.0000
135.198.22.176,<->,20.149.111.109,0,0,1,60,1,60,1.344962000,0.0000
215.158.238.194,<->,56.100.165.6,1,556,0,0,1,556,1.344754000,0.0000
136.25.189.47,<->,91.57.168.91,1,704,0,0,1,704,1.344715000,0.0000
93.104.212.227,<->,39.246.79.208,0,0,1,64,1,64,1.344580000,0.0000
69.196.64.236,<->,39.147.215.2,0,0,1,64,1,64,1.344383000,0.0000
215.158.239.58,<->,199.20.29.188,1,68,0,0,1,68,1.343778000,0.0000
111.199.227.171,<->,0.195.210.44,0,0,1,56,1,56,1.343754000,0.0000
195.60.113.229,<->,8.52.222.23,0,0,1,50,1,50,1.343601000,0.0000
80.42.138.200,<->,53.157.65.184,1,188,0,0,1,188,1.343535000,0.0000
193.65.5.242,<->,92.27.219.224,0,0,1,325,1,325,1.343358000,0.0000
21.15.226.126,<->,20.193.27.152,0,0,1,82,1,82,1.343232000,0.0000
195.124.252.224,<->,136.25.188.253,0,0,1,50,1,50,1.343096000,0.0000
109.222.255.208,<->,101.181.221.23,1,79,0,0,1,79,1.342743000,0.0000
144.75.218.233,<->,138.127.224.241,1,303,0,0,1,303,1.342594000,0.0000
195.124.92.160,<->,136.25.188.55,0,0,1,68,1,68,1.342560000,0.0000
99.252.59.208,<->,50.224.80.64,0,0,1,50,1,50,1.342461000,0.0000
136.181.51.178,<->,53.195.228.158,1,56,0,0,1,56,1.342423000,0.0000
139.236.94.152,<->,20.249.155.2,0,0,1,80,1,80,1.342264000,0.0000
110.98.222.240,<->,89.183.104.141,0,0,1,351,1,351,1.342232000,0.0000
207.87.26.21,<->,129.224.112.252,0,0,1,68,1,68,1.341973000,0.0000
144.85.170.244,<->,91.69.185.135,1,56,0,0,1,56,1.341942000,0.0000
200.174.214.160,<->,50.189.251.185,1,319,0,0,1,319,1.341915000,0.0000
207.100.101.153,<->,39.160.55.139,0,0,1,56,1,56,1.341868000,0.0000
54.59.120.90,<->,6.95.133.147,0,0,1,50,1,50,1.341849000,0.0000
253.19.79.103,<->,80.40.57.229,0,0,1,135,1,135,1.341609000,0.0000
192.242.190.84,<->,20.30.189.31,0,0,1,102,1,102,1.341463000,0.0000
215.158.239.84,<->,195.55.44.158,1,56,0,0,1,56,1.341439000,0.0000
159.109.188.255,<->,80.42.151.34,0,0,1,50,1,50,1.341260000,0.0000
207.162.154.102,<->,8.182.235.164,0,0,1,50,1,50,1.340836000,0.0000
198.69.238.131,<->,20.90.202.186,0,0,1,64,1,64,1.340817000,0.0000
115.87.122.210,<->,39.33.127.188,0,0,1,84,1,84,1.340331000,0.0000
76.2.232.35,<->,39.154.179.227,0,0,1,60,1,60,1.340131000,0.0000
215.158.239.122,<->,215.158.61.195,1,56,0,0,1,56,1.339242000,0.0000
254.242.184.68,<->,120.0.221.105,1,64,0,0,1,64,1.339200000,0.0000
114.60.176.251,<->,92.27.219.239,0,0,1,52,1,52,1.339108000,0.0000
215.158.239.58,<->,207.191.80.141,1,68,0,0,1,68,1.338827000,0.0000
138.127.230.221,<->,97.126.26.40,0,0,1,84,1,84,1.338791000,0.0000
198.163.47.226,<->,20.221.86.62,0,0,1,69,1,69,1.338680000,0.0000
195.68.226.21,<->,136.25.188.54,0,0,1,765,1,765,1.338422000,0.0000
148.199.95.14,<->,8.220.188.205,0,0,1,84,1,84,1.337623000,0.0000
224.195.124.88,<->,192.229.216.117,0,0,1,50,1,50,1.337622000,0.0000
199.69.165.34,<->,136.25.188.237,0,0,1,56,1,56,1.337546000,0.0000
192.67.149.88,<->,38.84.60.6,1,52,0,0,1,52,1.337305000,0.0000
100.254.226.147,<->,20.18.2.102,0,0,1,68,1,68,1.337298000,0.0000
111.151.142.208,<->,6.73.247.4,0,0,1,100,1,100,1.337143000,0.0000
136.25.188.39,<->,111.151.109.37,1,56,0,0,1,56,1.337117000,0.0000
139.163.26.146,<->,110.87.180.223,1,99,0,0,1,99,1.337082000,0.0000
152.133.60.221,<->,8.238.112.20,0,0,1,130,1,130,1.336771000,0.0000
142.125.81.115,<->,20.0.1.10,0,0,1,75,1,75,1.336601000,0.0000
21.15.226.126,<->,20.193.27.223,0,0,1,82,1,82,1.336482000,0.0000
93.181.154.23,<->,92.27.27.171,0,0,1,147,1,147,1.335994000,0.0000
144.75.218.235,<->,53.165.133.164,1,83,0,0,1,83,1.335919000,0.0000
215.158.239.56,<->,199.20.28.235,1,64,0,0,1,64,1.335787000,0.0000
35.17.217.11,<->,8.52.181.95,0,0,1,56,1,56,1.335732000,0.0000
104.230.236.175,<->,92.27.219.224,0,0,1,62,1,62,1.335667000,0.0000
21.15.226.126,<->,20.193.27.202,0,0,1,82,1,82,1.335261000,0.0000
212.105.232.45,<->,109.222.207.181,0,0,1,119,1,119,1.335034000,0.0000
255.133.229.164,<->,39.130.149.25,0,0,1,100,1,100,1.334667000,0.0000
253.19.85.146,<->,92.27.219.205,0,0,1,52,1,52,1.334615000,0.0000
215.158.61.182,<->,8.176.8.213,0,0,1,1407,1,1407,1.334564000,0.0000
144.64.138.9,<->,27.11.34.178,1,333,0,0,1,333,1.333929000,0.0000
199.69.165.34,<->,136.25.188.178,0,0,1,56,1,56,1.333829000,0.0000
144.75.218.233,<->,140.142.187.19,1,76,0,0,1,76,1.333808000,0.0000
215.158.239.49,<->,204.3.242.18,1,765,0,0,1,765,1.333478000,0.0000
143.245.251.139,<->,8.20.87.153,0,0,1,50,1,50,1.333382000,0.0000
139.163.26.238,<->,122.208.104.215,1,50,0,0,1,50,1.333186000,0.0000
247.136.216.15,<->,149.156.171.10,1,50,0,0,1,50,1.332969000,0.0000
89.220.119.29,<->,8.52.171.120,0,0,1,50,1,50,1.332875000,0.0000
255.133.229.164,<->,39.145.30.84,0,0,1,100,1,100,1.332794000,0.0000
204.187.148.195,<->,136.25.188.177,0,0,1,64,1,64,1.332783000,0.0000
245.125.203.41,<->,20.124.191.6,0,0,1,100,1,100,1.332703000,0.0000
215.158.239.229,<->,8.181.148.227,1,141,0,0,1,141,1.332460000,0.0000
92.27.219.128,<->,38.113.224.85,1,52,0,0,1,52,1.332015000,0.0000
203.48.152.122,<->,0.195.210.44,0,0,1,93,1,93,1.331947000,0.0000
92.27.219.235,<->,67.225.64.201,1,60,0,0,1,60,1.331922000,0.0000
97.156.36.137,<->,20.150.198.76,0,0,1,52,1,52,1.331898000,0.0000
198.231.134.212,<->,100.93.245.167,0,0,1,166,1,166,1.331806000,0.0000
144.122.240.224,<->,144.76.43.237,1,74,0,0,1,74,1.331577000,0.0000
254.126.121.15,<->,92.27.219.128,0,0,1,56,1,56,1.331384000,0.0000
222.8.40.74,<->,8.52.253.52,0,0,1,50,1,50,1.331147000,0.0000
207.56.132.45,<->,136.25.188.54,0,0,1,68,1,68,1.330992000,0.0000
212.241.174.245,<->,80.27.152.230,0,0,1,50,1,50,1.330908000,0.0000
141.30.139.33,<->,50.224.76.235,0,0,1,56,1,56,1.330817000,0.0000
246.253.248.211,<->,54.61.158.158,1,88,0,0,1,88,1.330623000,0.0000
198.196.28.146,<->,192.64.248.243,0,0,1,64,1,64,1.330466000,0.0000
215.158.103.219,<->,192.178.163.107,1,114,0,0,1,114,1.329815000,0.0000
92.27.219.153,<->,27.72.144.170,1,52,0,0,1,52,1.329682000,0.0000
204.92.95.245,<->,192.67.143.62,0,0,1,77,1,77,1.329636000,0.0000
207.7.83.126,<->,39.57.249.220,0,0,1,104,1,104,1.329445000,0.0000
98.246.18.142,<->,20.221.162.71,0,0,1,50,1,50,1.329434000,0.0000
29.211.214.32,<->,8.35.106.238,1,122,0,0,1,122,1.329333000,0.0000
215.158.239.56,<->,207.16.200.70,1,68,0,0,1,68,1.329251000,0.0000
243.117.93.192,<->,159.137.243.250,0,0,1,50,1,50,1.329049000,0.0000
196.204.3.158,<->,136.25.188.197,0,0,1,68,1,68,1.328750000,0.0000
204.139.150.193,<->,20.16.102.31,0,0,1,64,1,64,1.328624000,0.0000
136.25.188.35,<->,114.142.109.74,1,142,0,0,1,142,1.328033000,0.0000
149.11.173.11,<->,111.146.229.38,0,0,1,1161,1,1161,1.327926000,0.0000
204.139.150.193,<->,20.16.102.18,0,0,1,64,1,64,1.327747000,0.0000
157.25.158.25,<->,144.75.218.242,0,0,1,86,1,86,1.327452000,0.0000
194.232.233.188,<->,136.25.188.220,0,0,1,50,1,50,1.327408000,0.0000
118.234.35.12,<->,50.224.76.234,0,0,1,56,1,56,1.327229000,0.0000
218.4.190.6,<->,159.112.9.198,1,81,0,0,1,81,1.327087000,0.0000
159.112.9.198,<->,98.67.130.180,0,0,1,50,1,50,1.326815000,0.0000
111.146.236.167,<->,53.243.10.49,1,50,0,0,1,50,1.326683000,0.0000
125.223.91.142,<->,20.33.115.254,0,0,1,64,1,64,1.326618000,0.0000
152.10.81.148,<->,92.27.219.50,0,0,1,124,1,124,1.326276000,0.0000
244.50.135.57,<->,39.165.120.82,0,0,1,50,1,50,1.326242000,0.0000
144.75.218.246,<->,138.127.231.48,1,239,0,0,1,239,1.326184000,0.0000
111.80.138.164,<->,8.228.214.124,0,0,1,78,1,78,1.325712000,0.0000
21.15.226.126,<->,20.193.28.82,0,0,1,82,1,82,1.325601000,0.0000
204.63.40.38,<->,136.25.188.226,0,0,1,56,1,56,1.325597000,0.0000
220.81.53.185,<->,106.213.164.217,1,321,0,0,1,321,1.325435000,0.0000
136.25.188.105,<->,135.88.170.10,1,137,0,0,1,137,1.325217000,0.0000
124.52.9.239,<->,39.170.215.132,0,0,1,108,1,108,1.325213000,0.0000
92.181.174.221,<->,69.170.195.175,1,181,0,0,1,181,1.325037000,0.0000
132.123.40.75,<->,75.62.16.8,1,50,0,0,1,50,1.324845000,0.0000
111.48.213.85,<->,8.182.244.237,0,0,1,50,1,50,1.324543000,0.0000
59.49.203.92,<->,39.56.33.14,0,0,1,72,1,72,1.324253000,0.0000
207.58.193.167,<->,136.25.188.198,0,0,1,68,1,68,1.324167000,0.0000
21.15.226.126,<->,20.193.27.199,0,0,1,82,1,82,1.324090000,0.0000
119.104.70.230,<->,100.93.189.226,0,0,1,52,1,52,1.324036000,0.0000
195.125.180.215,<->,136.25.188.238,0,0,1,50,1,50,1.323920000,0.0000
92.27.219.154,<->,78.45.187.189,1,50,0,0,1,50,1.323524000,0.0000
207.74.43.177,<->,8.20.87.95,0,0,1,50,1,50,1.323354000,0.0000
246.253.248.211,<->,148.195.254.219,1,75,0,0,1,75,1.323313000,0.0000
126.232.54.214,<->,20.54.106.121,0,0,1,64,1,64,1.323034000,0.0000
136.25.188.27,<->,111.151.106.235,1,100,0,0,1,100,1.322812000,0.0000
197.153.64.198,<->,39.243.94.186,0,0,1,68,1,68,1.322782000,0.0000
196.148.133.194,<->,29.155.156.81,1,1504,0,0,1,1504,1.322725000,0.0000
92.27.219.186,<->,92.27.131.123,1,56,0,0,1,56,1.322685000,0.0000
92.27.219.203,<->,33.63.141.162,1,133,0,0,1,133,1.322581000,0.0000
111.146.173.51,<->,53.149.163.61,1,56,0,0,1,56,1.321745000,0.0000
224.235.33.176,<->,39.246.193.33,0,0,1,101,1,101,1.321738000,0.0000
210.209.251.223,<->,144.87.235.222,0,0,1,50,1,50,1.321729000,0.0000
207.58.193.167,<->,136.25.188.227,0,0,1,68,1,68,1.321685000,0.0000
93.104.212.227,<->,39.246.79.127,0,0,1,64,1,64,1.321629000,0.0000
144.122.240.211,<->,144.108.64.185,1,70,0,0,1,70,1.321613000,0.0000
111.147.166.52,<->,53.148.21.215,1,125,0,0,1,125,1.321566000,0.0000
249.101.206.222,<->,201.8.119.226,1,133,0,0,1,133,1.321507000,0.0000
112.150.154.177,<->,97.126.19.185,0,0,1,321,1,321,1.321325000,0.0000
248.225.31.13,<->,50.233.39.151,1,50,0,0,1,50,1.321217000,0.0000
139.163.26.146,<->,108.3.160.18,1,99,0,0,1,99,1.320858000,0.0000
132.249.71.241,<->,132.249.70.154,0,0,1,220,1,220,1.320619000,0.0000
133.178.227.82,<->,99.138.103.57,1,50,0,0,1,50,1.320546000,0.0000
38.21.156.204,<->,20.232.230.46,0,0,1,82,1,82,1.320411000,0.0000
215.158.103.206,<->,139.252.1.255,1,191,0,0,1,191,1.320372000,0.0000
119.121.82.21,<->,20.196.244.65,0,0,1,64,1,64,1.320209000,0.0000
192.64.224.151,<->,155.19.248.167,1,300,0,0,1,300,1.320087000,0.0000
100.144.209.34,<->,8.220.178.166,0,0,1,50,1,50,1.319971000,0.0000
215.158.239.94,<->,199.20.30.108,1,64,0,0,1,64,1.319767000,0.0000
247.136.147.108,<->,38.28.33.62,1,50,0,0,1,50,1.319291000,0.0000
220.191.108.54,<->,8.220.176.253,0,0,1,50,1,50,1.319266000,0.0000
142.241.43.152,<->,136.25.188.253,0,0,1,50,1,50,1.318831000,0.0000
115.57.42.104,<->,109.1.46.25,0,0,1,58,1,58,1.318435000,0.0000
101.164.87.250,<->,4.133.108.1,1,133,0,0,1,133,1.318255000,0.0000
241.193.172.231,<->,20.236.129.154,0,0,1,50,1,50,1.318177000,0.0000
207.101.123.253,<->,109.1.61.240,0,0,1,56,1,56,1.317917000,0.0000
215.158.239.79,<->,207.58.51.40,1,50,0,0,1,50,1.317656000,0.0000
207.236.43.187,<->,136.25.188.177,0,0,1,50,1,50,1.316928000,0.0000
144.75.220.241,<->,50.224.103.166,0,0,1,81,1,81,1.316721000,0.0000
104.137.223.226,<->,102.50.80.105,0,0,1,58,1,58,1.316579000,0.0000
42.45.93.32,<->,20.28.40.123,0,0,1,64,1,64,1.316564000,0.0000
247.136.180.232,<->,134.97.14.154,1,52,0,0,1,52,1.316435000,0.0000
144.75.218.241,<->,138.127.224.21,1,289,0,0,1,289,1.316199000,0.0000
109.105.211.52,<->,8.220.202.151,0,0,1,50,1,50,1.316135000,0.0000
129.224.112.252,<->,56.9.177.179,1,81,0,0,1,81,1.315959000,0.0000
122.8.229.86,<->,89.183.104.226,0,0,1,60,1,60,1.315856000,0.0000
92.27.219.155,<->,42.124.197.42,1,80,0,0,1,80,1.315795000,0.0000
192.229.216.117,<->,102.88.212.190,1,50,0,0,1,50,1.315785000,0.0000
199.91.76.35,<->,20.8.71.202,0,0,1,74,1,74,1.315636000,0.0000
207.236.43.187,<->,136.25.188.225,0,0,1,50,1,50,1.314924000,0.0000
215.158.140.182,<->,111.151.109.36,1,56,0,0,1,56,1.314913000,0.0000
215.158.239.59,<->,196.93.107.95,1,50,0,0,1,50,1.314874000,0.0000
136.181.33.57,<->,27.126.142.151,1,349,0,0,1,349,1.314751000,0.0000
136.25.189.63,<->,95.44.82.123,1,64,0,0,1,64,1.314727000,0.0000
146.206.41.163,<->,34.140.83.85,0,0,1,140,1,140,1.314665000,0.0000
159.109.227.110,<->,54.59.129.47,1,56,0,0,1,56,1.314483000,0.0000
204.200.43.82,<->,136.25.188.45,0,0,1,56,1,56,1.314110000,0.0000
195.102.11.87,<->,39.164.2.247,0,0,1,64,1,64,1.314098000,0.0000
207.11.124.46,<->,20.126.125.212,0,0,1,75,1,75,1.313873000,0.0000
157.211.4.30,<->,39.63.180.220,0,0,1,130,1,130,1.313427000,0.0000
8.43.155.247,<->,4.240.133.150,1,50,0,0,1,50,1.313386000,0.0000
137.68.217.95,<->,20.209.165.14,0,0,1,64,1,64,1.313323000,0.0000
249.101.85.94,<->,92.27.51.141,1,80,0,0,1,80,1.312861000,0.0000
136.25.188.163,<->,132.123.119.108,1,50,0,0,1,50,1.312760000,0.0000
104.143.87.40,<->,100.93.96.116,0,0,1,309,1,309,1.312717000,0.0000
144.75.218.233,<->,138.127.224.136,1,334,0,0,1,334,1.312698000,0.0000
121.8.199.86,<->,8.252.222.35,0,0,1,83,1,83,1.312515000,0.0000
215.158.61.182,<->,8.176.8.191,0,0,1,861,1,861,1.312307000,0.0000
59.50.118.206,<->,39.129.248.66,0,0,1,75,1,75,1.312199000,0.0000
200.175.34.127,<->,6.187.59.90,1,52,0,0,1,52,1.312140000,0.0000
200.174.174.113,<->,53.148.173.181,1,80,0,0,1,80,1.311965000,0.0000
119.90.251.239,<->,20.87.113.22,0,0,1,50,1,50,1.311924000,0.0000
215.158.239.99,<->,199.20.4.84,1,68,0,0,1,68,1.311834000,0.0000
204.139.51.94,<->,8.182.248.147,0,0,1,50,1,50,1.311611000,0.0000
144.20.224.147,<->,8.220.202.4,0,0,1,56,1,56,1.311559000,0.0000
94.39.46.138,<->,39.51.105.71,0,0,1,64,1,64,1.311515000,0.0000
215.158.140.24,<->,111.150.207.168,1,100,0,0,1,100,1.311490000,0.0000
97.126.22.117,<->,29.54.21.217,1,69,0,0,1,69,1.311410000,0.0000
200.174.207.15,<->,53.160.87.174,1,56,0,0,1,56,1.310879000,0.0000
215.158.140.25,<->,58.11.224.13,1,84,0,0,1,84,1.310583000,0.0000
215.158.238.18,<->,111.150.207.98,1,56,0,0,1,56,1.310505000,0.0000
207.236.11.244,<->,136.25.188.178,0,0,1,50,1,50,1.310320000,0.0000
74.133.46.131,<->,39.203.247.5,0,0,1,64,1,64,1.310307000,0.0000
215.158.239.76,<->,199.20.30.159,1,52,0,0,1,52,1.310206000,0.0000
106.122.241.132,<->,80.41.12.201,0,0,1,133,1,133,1.310180000,0.0000
215.158.239.84,<->,196.92.121.12,1,56,0,0,1,56,1.310000000,0.0000
250.50.34.183,<->,20.110.153.116,0,0,1,50,1,50,1.309972000,0.0000
122.222.66.154,<->,39.174.200.174,0,0,1,60,1,60,1.309805000,0.0000
105.69.107.244,<->,20.239.49.55,0,0,1,96,1,96,1.309482000,0.0000
146.240.59.16,<->,129.224.112.252,0,0,1,71,1,71,1.309283000,0.0000
109.222.253.182,<->,40.169.181.94,1,66,0,0,1,66,1.309273000,0.0000
249.101.92.224,<->,53.160.20.106,1,85,0,0,1,85,1.308683000,0.0000
144.75.218.233,<->,132.43.156.81,1,154,0,0,1,154,1.308499000,0.0000
112.166.162.194,<->,8.220.189.253,0,0,1,84,1,84,1.308187000,0.0000
224.148.240.12,<->,148.241.23.5,1,64,0,0,1,64,1.308025000,0.0000
215.158.239.48,<->,199.20.4.243,1,64,0,0,1,64,1.307932000,0.0000
224.93.21.34,<->,8.52.163.19,0,0,1,50,1,50,1.307932000,0.0000
137.163.62.83,<->,8.182.251.218,0,0,1,56,1,56,1.307784000,0.0000
230.52.215.218,<->,220.87.53.31,0,0,1,138,1,138,1.307775000,0.0000
222.68.69.80,<->,50.224.34.245,1,50,0,0,1,50,1.307689000,0.0000
193.51.220.212,<->,98.236.90.206,0,0,1,50,1,50,1.307376000,0.0000
76.75.43.15,<->,39.4.211.113,0,0,1,64,1,64,1.307277000,0.0000
21.15.226.126,<->,20.193.28.137,0,0,1,82,1,82,1.307153000,0.0000
110.21.0.12,<->,92.27.219.58,0,0,1,197,1,197,1.306992000,0.0000
205.165.51.118,<->,92.27.219.188,0,0,1,344,1,344,1.306984000,0.0000
127.182.104.174,<->,80.41.16.213,0,0,1,135,1,135,1.306789000,0.0000
220.20.200.249,<->,121.74.207.64,1,50,0,0,1,50,1.306712000,0.0000
144.75.218.233,<->,140.114.135.111,1,139,0,0,1,139,1.306710000,0.0000
122.169.160.21,<->,39.203.137.15,0,0,1,60,1,60,1.306688000,0.0000
159.115.117.197,<->,8.188.179.5,1,68,0,0,1,68,1.306267000,0.0000
158.164.134.203,<->,39.32.36.190,0,0,1,72,1,72,1.306165000,0.0000
207.159.193.224,<->,50.224.76.235,0,0,1,50,1,50,1.305875000,0.0000
109.14.213.84,<->,29.211.214.191,0,0,1,75,1,75,1.305321000,0.0000
132.18.67.27,<->,100.95.39.8,0,0,1,50,1,50,1.305231000,0.0000
109.222.242.51,<->,53.85.78.187,1,362,0,0,1,362,1.305138000,0.0000
194.201.10.244,<->,92.27.194.147,0,0,1,56,1,56,1.305048000,0.0000
192.229.213.201,<->,60.110.158.164,1,84,0,0,1,84,1.304987000,0.0000
205.225.237.193,<->,109.1.34.223,0,0,1,304,1,304,1.304622000,0.0000
92.27.219.147,<->,53.244.243.75,1,56,0,0,1,56,1.304510000,0.0000
98.246.18.142,<->,20.7.238.252,0,0,1,50,1,50,1.304455000,0.0000
109.222.254.231,<->,53.159.168.165,1,56,0,0,1,56,1.304429000,0.0000
144.75.218.246,<->,138.127.224.83,1,170,0,0,1,170,1.304056000,0.0000
241.193.172.231,<->,20.161.111.36,0,0,1,50,1,50,1.303850000,0.0000
203.114.28.227,<->,136.25.188.227,0,0,1,64,1,64,1.303791000,0.0000
122.189.124.157,<->,101.70.126.222,0,0,1,67,1,67,1.303748000,0.0000
199.69.72.231,<->,136.25.188.225,0,0,1,68,1,68,1.303654000,0.0000
218.4.179.129,<->,159.112.9.198,1,50,0,0,1,50,1.303534000,0.0000
215.158.239.78,<->,199.20.31.32,1,1106,0,0,1,1106,1.303453000,0.0000
82.198.203.138,<->,37.49.230.49,1,52,0,0,1,52,1.303337000,0.0000
215.158.239.95,<->,195.81.42.127,1,64,0,0,1,64,1.303334000,0.0000
144.76.46.38,<->,99.75.36.192,0,0,1,528,1,528,1.303059000,0.0000
195.36.113.17,<->,8.182.244.179,0,0,1,50,1,50,1.302891000,0.0000
207.92.62.85,<->,20.102.126.7,0,0,1,64,1,64,1.302685000,0.0000
215.158.239.85,<->,143.128.204.145,1,56,0,0,1,56,1.302589000,0.0000
50.224.121.247,<->,4.241.88.57,1,50,0,0,1,50,1.301685000,0.0000
143.72.70.154,<->,136.25.188.241,0,0,1,64,1,64,1.301171000,0.0000
118.112.193.88,<->,92.27.219.166,0,0,1,135,1,135,1.300622000,0.0000
92.27.219.63,<->,33.59.148.87,1,62,0,0,1,62,1.300596000,0.0000
144.75.218.241,<->,129.35.250.197,1,147,0,0,1,147,1.300410000,0.0000
22.36.22.243,<->,8.182.253.127,0,0,1,50,1,50,1.300148000,0.0000
75.62.16.8,<->,39.55.131.151,0,0,1,50,1,50,1.299546000,0.0000
198.157.56.197,<->,39.33.164.247,0,0,1,64,1,64,1.299352000,0.0000
123.109.29.48,<->,97.126.45.209,0,0,1,52,1,52,1.299320000,0.0000
133.20.191.58,<->,8.52.183.207,0,0,1,56,1,56,1.299144000,0.0000
105.201.254.176,<->,80.42.128.224,0,0,1,50,1,50,1.299057000,0.0000
144.75.218.237,<->,138.127.230.93,1,315,0,0,1,315,1.298638000,0.0000
195.55.87.0,<->,136.25.188.46,0,0,1,52,1,52,1.298565000,0.0000
215.158.239.81,<->,143.88.15.74,1,84,0,0,1,84,1.298356000,0.0000
144.75.221.204,<->,139.163.86.189,0,0,1,77,1,77,1.297170000,0.0000
109.222.255.32,<->,76.227.20.83,1,69,0,0,1,69,1.297041000,0.0000
129.254.100.56,<->,129.224.112.252,0,0,1,72,1,72,1.296885000,0.0000
92.27.219.218,<->,0.243.138.167,1,62,0,0,1,62,1.296704000,0.0000
143.53.64.213,<->,136.25.188.46,0,0,1,50,1,50,1.296406000,0.0000
197.106.108.51,<->,8.182.227.5,0,0,1,50,1,50,1.296167000,0.0000
116.236.72.221,<->,39.22.112.242,0,0,1,52,1,52,1.295773000,0.0000
144.93.22.181,<->,99.73.155.42,0,0,1,50,1,50,1.295761000,0.0000
109.222.197.239,<->,54.53.12.57,1,59,0,0,1,59,1.295759000,0.0000
138.127.224.168,<->,97.126.26.70,0,0,1,303,1,303,1.295724000,0.0000
100.180.208.148,<->,92.27.219.46,0,0,1,52,1,52,1.295350000,0.0000
247.136.220.38,<->,110.88.138.231,1,64,0,0,1,64,1.294911000,0.0000
246.253.253.210,<->,199.36.151.146,1,125,0,0,1,125,1.294857000,0.0000
75.62.16.8,<->,39.23.193.111,0,0,1,50,1,50,1.294800000,0.0000
143.99.83.7,<->,136.25.188.196,0,0,1,64,1,64,1.294525000,0.0000
92.27.27.181,<->,89.166.53.86,1,397,0,0,1,397,1.294420000,0.0000
114.56.102.221,<->,20.157.109.194,0,0,1,60,1,60,1.294378000,0.0000
244.50.133.60,<->,39.205.160.70,0,0,1,50,1,50,1.294362000,0.0000
207.87.232.230,<->,8.182.250.65,0,0,1,50,1,50,1.294323000,0.0000
215.158.239.76,<->,196.90.196.130,1,765,0,0,1,765,1.293957000,0.0000
129.224.112.252,<->,114.145.122.251,1,80,0,0,1,80,1.293881000,0.0000
104.95.121.154,<->,98.129.112.137,0,0,1,97,1,97,1.293654000,0.0000
109.222.244.46,<->,55.221.163.100,1,70,0,0,1,70,1.293478000,0.0000
195.125.11.138,<->,136.25.188.174,0,0,1,64,1,64,1.292965000,0.0000
215.158.239.48,<->,143.129.22.48,1,56,0,0,1,56,1.292939000,0.0000
192.67.169.243,<->,119.184.133.19,1,50,0,0,1,50,1.292859000,0.0000
210.156.155.20,<->,156.29.237.157,1,130,0,0,1,130,1.292049000,0.0000
104.14.114.164,<->,89.183.106.29,0,0,1,50,1,50,1.291950000,0.0000
120.18.126.117,<->,109.222.234.241,0,0,1,70,1,70,1.290647000,0.0000
207.42.94.41,<->,39.217.0.88,0,0,1,106,1,106,1.290577000,0.0000
21.15.226.126,<->,20.193.28.182,0,0,1,82,1,82,1.290306000,0.0000
114.199.58.229,<->,109.222.192.25,0,0,1,52,1,52,1.290148000,0.0000
247.136.216.62,<->,38.65.197.7,1,52,0,0,1,52,1.289949000,0.0000
198.158.197.83,<->,20.72.184.131,0,0,1,50,1,50,1.289801000,0.0000
93.20.89.159,<->,89.183.104.238,0,0,1,224,1,224,1.289567000,0.0000
111.150.207.192,<->,8.252.221.165,0,0,1,100,1,100,1.289557000,0.0000
21.15.226.126,<->,20.193.28.175,0,0,1,82,1,82,1.289515000,0.0000
143.129.42.59,<->,136.25.188.253,0,0,1,50,1,50,1.289392000,0.0000
195.105.9.194,<->,20.97.188.185,0,0,1,64,1,64,1.289308000,0.0000
149.96.75.138,<->,20.248.60.239,0,0,1,52,1,52,1.289241000,0.0000
144.75.218.241,<->,138.127.225.198,1,289,0,0,1,289,1.289016000,0.0000
247.136.226.219,<->,27.75.209.190,1,485,0,0,1,485,1.288632000,0.0000
215.158.239.95,<->,195.55.178.184,1,545,0,0,1,545,1.288259000,0.0000
149.167.2.14,<->,8.43.154.202,0,0,1,64,1,64,1.287957000,0.0000
220.38.84.85,<->,215.158.140.11,0,0,1,90,1,90,1.287933000,0.0000
116.141.53.250,<->,8.176.49.182,0,0,1,50,1,50,1.287891000,0.0000
109.222.255.50,<->,10.185.194.151,1,78,0,0,1,78,1.287562000,0.0000
99.74.27.16,<->,8.58.151.38,1,704,0,0,1,704,1.287561000,0.0000
218.154.30.233,<->,8.52.182.119,0,0,1,50,1,50,1.287492000,0.0000
21.15.226.126,<->,20.193.28.177,0,0,1,82,1,82,1.287359000,0.0000
199.111.214.254,<->,39.24.236.92,0,0,1,50,1,50,1.287215000,0.0000
202.33.41.25,<->,136.25.188.174,0,0,1,288,1,288,1.287176000,0.0000
215.158.140.74,<->,83.242.160.253,1,50,0,0,1,50,1.287155000,0.0000
89.183.104.145,<->,64.214.57.252,1,50,0,0,1,50,1.287110000,0.0000
215.158.238.135,<->,134.172.158.199,1,1165,0,0,1,1165,1.286604000,0.0000
201.216.164.96,<->,39.2.106.204,0,0,1,64,1,64,1.286547000,0.0000
195.41.45.182,<->,136.25.188.253,0,0,1,50,1,50,1.286273000,0.0000
205.122.195.32,<->,8.52.178.7,0,0,1,1002,1,1002,1.286234000,0.0000
192.67.161.166,<->,134.254.80.75,1,135,0,0,1,135,1.285825000,0.0000
126.241.59.6,<->,80.40.45.77,0,0,1,56,1,56,1.285701000,0.0000
109.1.16.168,<->,27.188.163.162,1,446,0,0,1,446,1.285535000,0.0000
109.1.49.223,<->,74.239.239.153,1,133,0,0,1,133,1.285528000,0.0000
192.224.146.246,<->,133.178.226.107,0,0,1,1064,1,1064,1.285358000,0.0000
117.47.247.89,<->,20.205.88.156,0,0,1,52,1,52,1.285100000,0.0000
210.226.165.98,<->,53.84.186.205,1,56,0,0,1,56,1.284949000,0.0000
215.158.61.183,<->,8.176.8.249,0,0,1,56,1,56,1.284469000,0.0000
92.27.219.192,<->,8.20.81.65,1,56,0,0,1,56,1.284387000,0.0000
127.255.93.100,<->,8.43.197.87,0,0,1,50,1,50,1.284358000,0.0000
215.158.140.113,<->,111.150.207.200,1,56,0,0,1,56,1.284291000,0.0000
197.160.85.21,<->,8.182.138.83,0,0,1,50,1,50,1.284205000,0.0000
192.67.154.172,<->,87.48.222.207,1,52,0,0,1,52,1.283969000,0.0000
124.145.93.246,<->,20.161.62.69,0,0,1,64,1,64,1.283822000,0.0000
103.237.215.117,<->,92.27.219.208,0,0,1,52,1,52,1.283784000,0.0000
197.160.85.21,<->,8.182.234.114,0,0,1,50,1,50,1.283678000,0.0000
192.67.156.17,<->,100.123.121.232,1,50,0,0,1,50,1.283473000,0.0000
112.208.20.238,<->,102.51.80.93,0,0,1,260,1,260,1.283331000,0.0000
241.193.172.231,<->,20.104.219.176,0,0,1,50,1,50,1.283231000,0.0000
101.70.107.137,<->,82.136.228.64,1,70,0,0,1,70,1.282915000,0.0000
133.191.124.35,<->,129.175.139.119,1,88,0,0,1,88,1.282885000,0.0000
100.182.99.11,<->,20.179.125.131,0,0,1,52,1,52,1.282795000,0.0000
100.182.99.11,<->,20.179.125.207,0,0,1,52,1,52,1.282794000,0.0000
94.193.238.104,<->,8.252.221.238,0,0,1,68,1,68,1.282678000,0.0000
128.153.37.180,<->,20.183.64.44,0,0,1,72,1,72,1.282329000,0.0000
192.67.179.218,<->,89.183.104.233,0,0,1,263,1,263,1.282146000,0.0000
215.158.103.219,<->,138.127.231.206,1,155,0,0,1,155,1.282097000,0.0000
230.87.239.94,<->,109.3.163.238,0,0,1,351,1,351,1.281689000,0.0000
53.200.99.253,<->,48.52.85.160,0,0,1,93,1,93,1.281525000,0.0000
136.25.189.243,<->,102.42.102.64,1,329,0,0,1,329,1.281484000,0.0000
132.249.70.233,<->,128.231.178.26,1,158,0,0,1,158,1.281306000,0.0000
80.93.31.157,<->,20.203.223.31,0,0,1,56,1,56,1.281001000,0.0000
223.140.87.220,<->,8.228.214.124,0,0,1,98,1,98,1.280774000,0.0000
202.33.18.213,<->,136.25.188.179,0,0,1,56,1,56,1.280675000,0.0000
142.228.63.61,<->,136.25.188.53,0,0,1,56,1,56,1.280315000,0.0000
148.240.72.153,<->,20.192.126.65,0,0,1,52,1,52,1.279894000,0.0000
215.158.103.206,<->,129.221.194.239,1,525,0,0,1,525,1.279837000,0.0000
136.221.119.73,<->,20.21.128.75,0,0,1,64,1,64,1.279833000,0.0000
146.154.162.236,<->,39.171.2.46,0,0,1,74,1,74,1.279797000,0.0000
246.253.128.176,<->,206.157.125.24,1,64,0,0,1,64,1.279716000,0.0000
92.27.219.37,<->,33.57.79.34,1,135,0,0,1,135,1.279152000,0.0000
101.224.185.49,<->,48.104.80.96,1,57,0,0,1,57,1.278977000,0.0000
241.193.172.231,<->,20.162.199.227,0,0,1,50,1,50,1.278670000,0.0000
215.158.140.207,<->,192.187.241.249,1,50,0,0,1,50,1.278559000,0.0000
89.183.104.172,<->,42.246.37.114,1,52,0,0,1,52,1.278405000,0.0000
237.177.159.56,<->,20.178.201.247,0,0,1,64,1,64,1.278101000,0.0000
8.182.239.159,<->,6.33.2.154,1,50,0,0,1,50,1.277991000,0.0000
98.246.18.142,<->,20.42.42.44,0,0,1,50,1,50,1.277957000,0.0000
255.133.229.164,<->,39.12.83.214,0,0,1,100,1,100,1.277913000,0.0000
133.135.217.206,<->,129.6.83.11,0,0,1,589,1,589,1.277547000,0.0000
215.158.239.51,<->,196.90.196.130,1,765,0,0,1,765,1.277483000,0.0000
215.158.239.77,<->,195.13.185.137,1,50,0,0,1,50,1.277368000,0.0000
144.75.218.242,<->,140.136.104.193,1,121,0,0,1,121,1.276900000,0.0000
8.182.138.83,<->,6.133.194.38,1,50,0,0,1,50,1.276738000,0.0000
118.32.219.118,<->,97.126.89.73,0,0,1,64,1,64,1.276221000,0.0000
111.147.222.196,<->,54.58.49.91,1,110,0,0,1,110,1.275985000,0.0000
119.90.250.200,<->,20.125.47.83,0,0,1,50,1,50,1.275968000,0.0000
248.225.27.2,<->,53.239.32.16,1,257,0,0,1,257,1.275925000,0.0000
139.241.115.2,<->,80.56.78.94,0,0,1,84,1,84,1.275839000,0.0000
21.15.226.126,<->,20.193.28.247,0,0,1,82,1,82,1.275721000,0.0000
111.151.106.229,<->,8.252.221.110,0,0,1,56,1,56,1.275715000,0.0000
193.46.99.107,<->,89.183.104.136,0,0,1,90,1,90,1.275621000,0.0000
120.155.87.47,<->,8.252.222.181,0,0,1,132,1,132,1.275278000,0.0000
215.158.239.57,<->,199.20.31.15,1,68,0,0,1,68,1.275141000,0.0000
254.82.206.131,<->,221.150.250.237,0,0,1,134,1,134,1.274844000,0.0000
123.154.2.195,<->,92.27.219.20,0,0,1,50,1,50,1.274636000,0.0000
109.222.235.84,<->,105.83.237.194,1,79,0,0,1,79,1.274528000,0.0000
195.4.94.194,<->,136.25.188.226,0,0,1,50,1,50,1.274279000,0.0000
227.56.190.69,<->,144.75.218.233,0,0,1,63,1,63,1.274271000,0.0000
98.86.124.45,<->,20.41.215.170,0,0,1,107,1,107,1.273905000,0.0000
144.89.113.56,<->,129.224.112.252,0,0,1,76,1,76,1.273885000,0.0000
207.198.142.213,<->,92.27.219.33,0,0,1,52,1,52,1.273693000,0.0000
210.220.218.36,<->,78.126.223.125,1,68,0,0,1,68,1.273665000,0.0000
194.118.48.211,<->,39.220.32.117,0,0,1,60,1,60,1.273602000,0.0000
118.20.111.94,<->,8.176.8.85,0,0,1,161,1,161,1.273233000,0.0000
148.110.144.28,<->,20.200.169.39,0,0,1,103,1,103,1.272793000,0.0000
215.158.239.79,<->,199.76.53.180,1,56,0,0,1,56,1.272461000,0.0000
199.83.231.147,<->,136.25.188.173,0,0,1,68,1,68,1.272387000,0.0000
132.103.198.89,<->,119.121.24.104,1,64,0,0,1,64,1.272346000,0.0000
141.93.238.50,<->,129.224.112.252,0,0,1,80,1,80,1.272248000,0.0000
119.114.158.55,<->,20.167.62.243,0,0,1,64,1,64,1.271947000,0.0000
221.102.122.48,<->,199.12.111.19,1,50,0,0,1,50,1.271884000,0.0000
144.106.237.27,<->,139.163.114.182,0,0,1,116,1,116,1.271761000,0.0000
199.39.210.177,<->,136.25.188.176,0,0,1,68,1,68,1.270979000,0.0000
224.115.136.169,<->,111.146.249.17,0,0,1,129,1,129,1.270439000,0.0000
76.73.2.13,<->,39.130.202.200,0,0,1,106,1,106,1.270311000,0.0000
207.60.153.205,<->,20.209.211.182,0,0,1,75,1,75,1.270304000,0.0000
205.44.229.55,<->,20.194.30.195,0,0,1,52,1,52,1.269629000,0.0000
156.152.130.177,<->,129.224.112.252,0,0,1,77,1,77,1.269480000,0.0000
82.228.154.114,<->,8.55.216.166,1,56,0,0,1,56,1.269476000,0.0000
111.151.106.235,<->,6.73.247.133,0,0,1,56,1,56,1.269134000,0.0000
122.212.149.92,<->,20.115.175.103,0,0,1,64,1,64,1.268985000,0.0000
89.183.104.136,<->,80.38.160.160,1,68,0,0,1,68,1.268933000,0.0000
195.5.40.103,<->,136.25.188.178,0,0,1,56,1,56,1.268850000,0.0000
80.56.91.248,<->,8.252.223.139,0,0,1,56,1,56,1.268701000,0.0000
105.140.23.31,<->,20.121.178.39,0,0,1,64,1,64,1.268309000,0.0000
207.3.114.143,<->,8.220.189.68,0,0,1,50,1,50,1.268302000,0.0000
144.75.218.233,<->,54.38.169.95,1,126,0,0,1,126,1.268192000,0.0000
54.37.239.123,<->,48.53.113.44,0,0,1,56,1,56,1.267913000,0.0000
129.224.112.252,<->,106.213.35.197,1,73,0,0,1,73,1.267525000,0.0000
215.158.239.79,<->,195.55.133.34,1,56,0,0,1,56,1.267445000,0.0000
215.158.52.232,<->,159.112.9.198,1,50,0,0,1,50,1.267402000,0.0000
144.75.218.241,<->,115.151.47.145,1,203,0,0,1,203,1.267334000,0.0000
246.254.97.149,<->,148.215.253.0,1,84,0,0,1,84,1.267331000,0.0000
21.15.226.126,<->,20.193.28.194,0,0,1,82,1,82,1.267161000,0.0000
104.239.175.143,<->,20.110.44.94,0,0,1,64,1,64,1.267115000,0.0000
215.158.140.8,<->,29.212.192.189,1,90,0,0,1,90,1.266889000,0.0000
199.12.103.135,<->,8.252.222.221,0,0,1,50,1,50,1.266857000,0.0000
252.136.244.22,<->,97.68.226.205,0,0,1,77,1,77,1.266400000,0.0000
210.220.219.175,<->,53.210.233.122,1,50,0,0,1,50,1.266363000,0.0000
125.60.211.179,<->,89.183.104.178,0,0,1,62,1,62,1.266184000,0.0000
197.113.65.29,<->,136.25.188.253,0,0,1,50,1,50,1.265916000,0.0000
215.158.239.84,<->,199.20.30.237,1,64,0,0,1,64,1.265893000,0.0000
247.136.255.233,<->,210.209.251.214,1,50,0,0,1,50,1.265743000,0.0000
143.99.27.229,<->,20.97.6.71,0,0,1,76,1,76,1.265706000,0.0000
207.173.80.211,<->,136.25.188.178,0,0,1,64,1,64,1.265097000,0.0000
104.2.79.89,<->,20.34.58.228,0,0,1,64,1,64,1.264923000,0.0000
53.188.219.53,<->,8.228.220.12,0,0,1,50,1,50,1.264830000,0.0000
215.158.140.74,<->,83.252.79.125,1,50,0,0,1,50,1.264761000,0.0000
215.158.239.95,<->,195.49.114.26,1,56,0,0,1,56,1.264718000,0.0000
206.188.93.145,<->,192.64.247.45,0,0,1,103,1,103,1.264714000,0.0000
192.64.217.166,<->,122.102.188.46,1,52,0,0,1,52,1.264670000,0.0000
92.27.219.46,<->,69.196.187.52,1,52,0,0,1,52,1.264438000,0.0000
215.158.239.93,<->,196.92.194.31,1,68,0,0,1,68,1.264307000,0.0000
210.8.111.76,<->,8.220.206.230,0,0,1,50,1,50,1.264250000,0.0000
99.248.12.145,<->,92.27.219.196,0,0,1,135,1,135,1.263799000,0.0000
120.178.111.142,<->,92.27.219.20,0,0,1,62,1,62,1.263782000,0.0000
99.72.132.173,<->,27.151.38.15,1,62,0,0,1,62,1.263733000,0.0000
215.158.239.92,<->,196.92.205.203,1,64,0,0,1,64,1.263666000,0.0000
21.15.226.126,<->,20.193.29.211,0,0,1,82,1,82,1.263639000,0.0000
220.55.70.6,<->,143.252.64.235,1,72,0,0,1,72,1.263527000,0.0000
97.168.79.89,<->,93.68.182.75,1,50,0,0,1,50,1.263484000,0.0000
203.142.79.172,<->,92.27.27.183,0,0,1,52,1,52,1.263412000,0.0000
215.158.239.229,<->,113.23.83.211,1,141,0,0,1,141,1.263044000,0.0000
215.158.103.206,<->,159.151.90.195,1,138,0,0,1,138,1.262981000,0.0000
158.254.147.43,<->,20.98.74.96,0,0,1,105,1,105,1.262975000,0.0000
199.12.125.72,<->,20.11.148.12,0,0,1,64,1,64,1.262768000,0.0000
123.153.231.98,<->,92.162.252.179,0,0,1,50,1,50,1.262349000,0.0000
117.254.120.156,<->,89.183.104.233,0,0,1,263,1,263,1.261867000,0.0000
200.175.151.21,<->,54.59.173.98,1,56,0,0,1,56,1.261590000,0.0000
119.90.251.239,<->,39.24.5.27,0,0,1,50,1,50,1.261229000,0.0000
226.73.1.36,<->,133.178.227.86,0,0,1,50,1,50,1.261011000,0.0000
109.124.22.45,<->,8.183.25.124,0,0,1,50,1,50,1.260944000,0.0000
135.225.138.249,<->,92.27.219.205,0,0,1,52,1,52,1.260840000,0.0000
192.171.13.33,<->,8.252.222.189,0,0,1,95,1,95,1.260717000,0.0000
159.69.187.47,<->,144.108.80.167,1,73,0,0,1,73,1.260681000,0.0000
126.83.231.6,<->,20.194.30.195,0,0,1,52,1,52,1.260237000,0.0000
97.80.226.249,<->,8.182.239.140,0,0,1,50,1,50,1.260231000,0.0000
128.156.85.186,<->,8.176.8.227,0,0,1,100,1,100,1.260150000,0.0000
199.90.130.244,<->,144.75.218.241,0,0,1,165,1,165,1.260047000,0.0000
199.21.222.80,<->,8.182.234.113,0,0,1,50,1,50,1.259588000,0.0000
196.206.193.146,<->,136.25.188.46,0,0,1,101,1,101,1.259563000,0.0000
137.137.115.85,<->,132.18.67.27,1,50,0,0,1,50,1.259492000,0.0000
109.1.60.170,<->,33.240.107.135,1,52,0,0,1,52,1.259467000,0.0000
119.2.213.36,<->,39.29.91.231,0,0,1,90,1,90,1.259027000,0.0000
215.158.239.48,<->,196.92.8.226,1,50,0,0,1,50,1.258842000,0.0000
204.61.134.201,<->,136.25.188.225,0,0,1,52,1,52,1.258755000,0.0000
192.229.219.20,<->,107.10.175.50,1,50,0,0,1,50,1.258567000,0.0000
111.2.158.124,<->,8.182.239.140,0,0,1,50,1,50,1.258526000,0.0000
122.42.0.96,<->,92.27.235.58,0,0,1,97,1,97,1.257936000,0.0000
215.158.140.83,<->,29.211.122.251,1,1167,0,0,1,1167,1.257789000,0.0000
241.193.172.231,<->,144.71.43.42,0,0,1,50,1,50,1.257671000,0.0000
141.92.221.223,<->,129.224.112.252,0,0,1,74,1,74,1.257607000,0.0000
204.184.92.235,<->,136.25.188.163,0,0,1,56,1,56,1.257447000,0.0000
144.75.218.235,<->,138.127.224.208,1,253,0,0,1,253,1.257295000,0.0000
143.42.147.180,<->,136.25.188.178,0,0,1,56,1,56,1.257103000,0.0000
100.192.167.54,<->,8.52.179.217,0,0,1,50,1,50,1.256577000,0.0000
232.31.241.227,<->,100.93.171.224,0,0,1,50,1,50,1.256344000,0.0000
89.183.104.246,<->,38.183.250.139,1,52,0,0,1,52,1.256299000,0.0000
113.42.172.90,<->,92.27.219.250,0,0,1,52,1,52,1.255967000,0.0000
194.232.97.46,<->,136.25.188.238,0,0,1,56,1,56,1.255754000,0.0000
132.60.192.138,<->,8.52.137.54,0,0,1,52,1,52,1.255203000,0.0000
136.11.90.204,<->,8.220.190.86,0,0,1,50,1,50,1.255155000,0.0000
126.224.165.180,<->,20.52.19.86,0,0,1,64,1,64,1.254873000,0.0000
80.38.25.116,<->,64.252.99.101,1,56,0,0,1,56,1.254868000,0.0000
80.38.16.211,<->,37.117.35.8,1,56,0,0,1,56,1.254864000,0.0000
112.208.20.199,<->,98.128.186.137,0,0,1,147,1,147,1.254824000,0.0000
99.168.117.210,<->,8.220.178.8,0,0,1,84,1,84,1.254649000,0.0000
134.90.116.231,<->,39.145.152.187,0,0,1,100,1,100,1.254582000,0.0000
112.172.123.2,<->,8.52.187.224,0,0,1,50,1,50,1.254290000,0.0000
223.138.235.78,<->,39.15.158.240,0,0,1,52,1,52,1.253825000,0.0000
194.244.149.235,<->,20.186.90.234,0,0,1,75,1,75,1.253727000,0.0000
134.103.25.100,<->,92.27.219.189,0,0,1,50,1,50,1.253718000,0.0000
204.200.56.148,<->,136.25.188.209,0,0,1,508,1,508,1.253405000,0.0000
144.69.82.139,<->,113.186.98.254,1,69,0,0,1,69,1.253381000,0.0000
144.86.144.224,<->,92.162.221.88,1,50,0,0,1,50,1.253363000,0.0000
142.222.200.25,<->,20.203.147.151,0,0,1,56,1,56,1.253090000,0.0000
204.186.174.127,<->,136.25.188.241,0,0,1,56,1,56,1.252705000,0.0000
145.242.126.218,<->,123.153.228.125,1,50,0,0,1,50,1.252376000,0.0000
133.178.226.2,<->,111.150.207.228,1,56,0,0,1,56,1.252331000,0.0000
105.168.127.76,<->,98.236.254.250,0,0,1,76,1,76,1.252166000,0.0000
138.126.75.85,<->,136.25.188.47,0,0,1,1149,1,1149,1.251857000,0.0000
144.75.218.235,<->,100.117.19.29,1,81,0,0,1,81,1.251757000,0.0000
111.150.207.168,<->,8.252.221.65,0,0,1,56,1,56,1.251672000,0.0000
89.183.104.246,<->,82.130.48.245,1,56,0,0,1,56,1.251429000,0.0000
142.200.128.84,<->,39.0.84.115,0,0,1,105,1,105,1.251184000,0.0000
126.242.231.201,<->,20.204.244.191,0,0,1,64,1,64,1.250793000,0.0000
39.17.43.138,<->,37.49.116.88,1,103,0,0,1,103,1.250494000,0.0000
192.64.213.91,<->,53.195.184.75,1,56,0,0,1,56,1.250484000,0.0000
105.105.16.74,<->,50.224.76.234,0,0,1,50,1,50,1.250470000,0.0000
204.200.51.94,<->,136.25.188.243,0,0,1,132,1,132,1.249932000,0.0000
156.151.249.107,<->,34.17.114.255,0,0,1,72,1,72,1.249924000,0.0000
145.242.126.137,<->,123.153.228.125,1,50,0,0,1,50,1.249792000,0.0000
199.57.42.100,<->,100.92.103.47,0,0,1,56,1,56,1.249476000,0.0000
145.242.126.197,<->,123.153.228.125,1,50,0,0,1,50,1.249367000,0.0000
92.27.219.41,<->,50.98.176.213,1,309,0,0,1,309,1.249349000,0.0000
129.224.112.252,<->,117.159.118.99,1,75,0,0,1,75,1.249166000,0.0000
145.242.126.140,<->,123.153.228.125,1,50,0,0,1,50,1.248723000,0.0000
203.63.8.114,<->,80.42.149.110,0,0,1,52,1,52,1.248506000,0.0000
122.212.149.92,<->,20.115.175.100,0,0,1,64,1,64,1.247990000,0.0000
111.146.212.59,<->,53.245.93.66,1,50,0,0,1,50,1.247864000,0.0000
118.99.11.205,<->,39.196.81.187,0,0,1,64,1,64,1.247764000,0.0000
129.92.114.135,<->,29.216.97.203,1,73,0,0,1,73,1.247548000,0.0000
207.92.62.85,<->,20.102.126.11,0,0,1,64,1,64,1.247048000,0.0000
93.174.159.233,<->,80.41.12.225,0,0,1,321,1,321,1.246919000,0.0000
215.158.239.84,<->,199.20.31.21,1,56,0,0,1,56,1.246900000,0.0000
120.174.245.10,<->,39.206.71.15,0,0,1,74,1,74,1.246678000,0.0000
116.25.226.190,<->,98.129.64.162,0,0,1,97,1,97,1.246632000,0.0000
80.42.169.109,<->,53.157.226.171,1,64,0,0,1,64,1.246570000,0.0000
112.9.81.79,<->,20.146.97.206,0,0,1,52,1,52,1.246354000,0.0000
124.232.32.37,<->,39.48.158.173,0,0,1,64,1,64,1.246290000,0.0000
139.163.26.238,<->,0.164.109.191,1,56,0,0,1,56,1.245847000,0.0000
102.254.148.39,<->,20.250.25.233,0,0,1,64,1,64,1.245826000,0.0000
144.75.218.237,<->,58.134.5.66,1,178,0,0,1,178,1.245720000,0.0000
147.58.148.219,<->,20.144.37.110,0,0,1,60,1,60,1.245675000,0.0000
111.151.107.247,<->,8.252.222.105,0,0,1,224,1,224,1.245102000,0.0000
215.158.239.48,<->,199.69.65.114,1,56,0,0,1,56,1.245048000,0.0000
91.250.143.162,<->,39.137.96.51,0,0,1,50,1,50,1.245044000,0.0000
221.102.112.165,<->,207.86.242.64,1,50,0,0,1,50,1.245026000,0.0000
146.193.72.97,<->,8.252.222.151,0,0,1,56,1,56,1.244885000,0.0000
145.242.126.208,<->,123.153.228.125,1,50,0,0,1,50,1.244873000,0.0000
215.158.239.49,<->,195.80.85.122,1,56,0,0,1,56,1.244456000,0.0000
247.136.157.61,<->,127.91.126.8,1,52,0,0,1,52,1.244356000,0.0000
205.224.50.169,<->,100.92.105.127,0,0,1,50,1,50,1.244317000,0.0000
109.222.209.61,<->,50.233.50.26,1,768,0,0,1,768,1.244295000,0.0000
143.91.217.78,<->,136.25.188.209,0,0,1,701,1,701,1.244061000,0.0000
38.21.156.204,<->,20.232.228.127,0,0,1,82,1,82,1.243936000,0.0000
145.242.126.6,<->,123.153.228.125,1,50,0,0,1,50,1.243778000,0.0000
145.242.126.14,<->,123.153.228.125,1,50,0,0,1,50,1.243768000,0.0000
141.129.193.22,<->,101.224.89.139,0,0,1,255,1,255,1.243746000,0.0000
206.232.36.243,<->,20.228.39.132,0,0,1,64,1,64,1.243730000,0.0000
201.216.164.96,<->,39.2.106.206,0,0,1,64,1,64,1.243699000,0.0000
111.151.107.208,<->,6.73.247.132,0,0,1,56,1,56,1.243614000,0.0000
246.253.34.209,<->,40.100.176.197,1,64,0,0,1,64,1.243409000,0.0000
254.126.164.43,<->,97.68.226.205,0,0,1,77,1,77,1.243347000,0.0000
145.242.126.101,<->,123.153.228.125,1,50,0,0,1,50,1.243185000,0.0000
231.140.2.184,<->,136.25.188.225,0,0,1,56,1,56,1.243162000,0.0000
241.193.172.231,<->,20.242.85.177,0,0,1,50,1,50,1.243137000,0.0000
124.232.32.37,<->,39.48.158.172,0,0,1,64,1,64,1.243121000,0.0000
220.196.92.246,<->,8.52.171.120,0,0,1,50,1,50,1.242940000,0.0000
145.242.126.139,<->,123.153.228.125,1,50,0,0,1,50,1.242927000,0.0000
146.172.31.165,<->,20.187.8.225,0,0,1,56,1,56,1.242895000,0.0000
159.133.61.244,<->,53.149.236.92,1,129,0,0,1,129,1.242660000,0.0000
215.158.239.74,<->,143.88.15.74,1,84,0,0,1,84,1.242446000,0.0000
138.127.229.147,<->,132.222.173.36,0,0,1,355,1,355,1.242239000,0.0000
145.16.88.248,<->,123.86.166.9,1,68,0,0,1,68,1.241863000,0.0000
197.197.245.29,<->,139.207.222.11,0,0,1,89,1,89,1.241846000,0.0000
138.127.225.194,<->,109.222.238.0,0,0,1,216,1,216,1.241814000,0.0000
225.21.131.219,<->,39.229.251.182,0,0,1,64,1,64,1.241713000,0.0000
126.253.26.254,<->,20.10.173.24,0,0,1,64,1,64,1.241511000,0.0000
145.242.126.248,<->,123.153.228.125,1,50,0,0,1,50,1.241235000,0.0000
38.88.61.181,<->,20.3.36.209,0,0,1,76,1,76,1.241007000,0.0000
145.242.126.57,<->,123.153.228.125,1,50,0,0,1,50,1.240842000,0.0000
145.242.126.64,<->,123.153.228.125,1,50,0,0,1,50,1.240840000,0.0000
114.235.254.115,<->,92.27.219.183,0,0,1,135,1,135,1.240737000,0.0000
145.242.126.206,<->,123.153.228.125,1,50,0,0,1,50,1.240583000,0.0000
246.253.253.211,<->,196.28.180.242,1,125,0,0,1,125,1.240528000,0.0000
145.242.126.41,<->,123.153.228.125,1,50,0,0,1,50,1.240269000,0.0000
197.120.245.140,<->,129.224.112.252,0,0,1,78,1,78,1.240210000,0.0000
200.175.248.186,<->,53.200.28.121,1,56,0,0,1,56,1.239976000,0.0000
145.242.126.85,<->,123.153.228.125,1,50,0,0,1,50,1.239756000,0.0000
127.175.8.34,<->,8.220.206.28,0,0,1,84,1,84,1.239628000,0.0000
145.242.126.175,<->,123.153.228.125,1,50,0,0,1,50,1.239559000,0.0000
145.242.126.100,<->,123.153.228.125,1,50,0,0,1,50,1.239503000,0.0000
145.242.126.5,<->,123.153.228.125,1,50,0,0,1,50,1.239435000,0.0000
114.91.22.178,<->,80.40.61.163,0,0,1,99,1,99,1.239349000,0.0000
145.242.126.11,<->,123.153.228.125,1,50,0,0,1,50,1.239320000,0.0000
220.55.173.143,<->,53.192.240.221,1,161,0,0,1,161,1.239200000,0.0000
139.163.66.236,<->,102.61.253.160,1,50,0,0,1,50,1.239136000,0.0000
145.242.126.74,<->,123.153.228.125,1,50,0,0,1,50,1.239129000,0.0000
215.158.238.134,<->,57.210.107.27,1,1309,0,0,1,1309,1.238968000,0.0000
38.92.87.149,<->,20.204.122.101,0,0,1,64,1,64,1.238891000,0.0000
17.65.212.114,<->,8.220.200.124,0,0,1,50,1,50,1.238557000,0.0000
124.232.32.37,<->,39.48.158.174,0,0,1,64,1,64,1.238168000,0.0000
122.212.149.92,<->,20.115.175.91,0,0,1,64,1,64,1.237965000,0.0000
132.60.192.139,<->,8.250.145.247,0,0,1,52,1,52,1.237831000,0.0000
199.68.22.68,<->,136.25.188.46,0,0,1,56,1,56,1.237815000,0.0000
111.151.106.211,<->,8.252.223.80,0,0,1,56,1,56,1.237690000,0.0000
126.198.141.74,<->,80.40.31.32,0,0,1,68,1,68,1.237554000,0.0000
149.139.66.62,<->,20.134.201.118,0,0,1,64,1,64,1.237351000,0.0000
17.6.58.27,<->,8.220.239.84,0,0,1,50,1,50,1.237260000,0.0000
122.212.149.92,<->,20.115.175.89,0,0,1,64,1,64,1.236035000,0.0000
104.2.79.89,<->,20.34.58.101,0,0,1,64,1,64,1.236011000,0.0000
199.85.73.162,<->,20.223.181.115,0,0,1,52,1,52,1.235895000,0.0000
194.237.108.185,<->,136.25.188.53,0,0,1,56,1,56,1.235799000,0.0000
215.158.239.96,<->,207.63.32.226,1,50,0,0,1,50,1.235517000,0.0000
42.246.245.245,<->,39.140.116.193,0,0,1,104,1,104,1.235397000,0.0000
210.158.44.208,<->,120.49.223.215,1,671,0,0,1,671,1.235296000,0.0000
215.158.239.99,<->,196.92.216.137,1,56,0,0,1,56,1.235208000,0.0000
235.253.218.229,<->,215.158.238.132,0,0,1,1373,1,1373,1.234708000,0.0000
206.16.149.155,<->,192.64.217.166,0,0,1,52,1,52,1.234293000,0.0000
122.33.24.86,<->,92.27.219.175,0,0,1,190,1,190,1.234095000,0.0000
197.113.64.153,<->,136.25.188.238,0,0,1,56,1,56,1.234066000,0.0000
215.158.239.93,<->,199.106.232.76,1,56,0,0,1,56,1.233761000,0.0000
109.222.214.116,<->,87.11.192.79,1,325,0,0,1,325,1.232988000,0.0000
215.158.239.229,<->,210.140.5.233,1,136,0,0,1,136,1.232966000,0.0000
197.225.152.32,<->,92.27.219.155,0,0,1,50,1,50,1.232459000,0.0000
241.189.29.155,<->,144.75.218.241,0,0,1,125,1,125,1.232324000,0.0000
96.34.107.198,<->,8.220.176.253,0,0,1,50,1,50,1.232193000,0.0000
21.15.226.126,<->,20.193.29.155,0,0,1,82,1,82,1.232147000,0.0000
215.158.239.87,<->,204.226.100.90,1,56,0,0,1,56,1.232114000,0.0000
121.75.40.195,<->,39.20.181.84,0,0,1,52,1,52,1.232035000,0.0000
143.79.155.165,<->,136.25.188.163,0,0,1,56,1,56,1.231858000,0.0000
144.75.218.241,<->,138.127.230.220,1,257,0,0,1,257,1.231696000,0.0000
195.15.193.133,<->,136.25.188.174,0,0,1,56,1,56,1.231603000,0.0000
139.163.102.5,<->,50.27.36.74,1,50,0,0,1,50,1.231592000,0.0000
192.64.232.219,<->,0.97.121.82,1,52,0,0,1,52,1.231452000,0.0000
221.99.11.55,<->,136.25.189.47,0,0,1,704,1,704,1.231136000,0.0000
109.222.241.76,<->,53.80.195.21,1,64,0,0,1,64,1.230996000,0.0000
144.71.44.64,<->,89.230.228.202,1,50,0,0,1,50,1.230923000,0.0000
136.192.244.243,<->,8.182.250.192,0,0,1,50,1,50,1.230862000,0.0000
215.158.239.231,<->,53.157.243.122,1,237,0,0,1,237,1.230847000,0.0000
54.59.75.111,<->,48.54.97.29,0,0,1,56,1,56,1.230615000,0.0000
113.127.190.72,<->,89.183.104.156,0,0,1,99,1,99,1.230593000,0.0000
125.154.210.13,<->,92.27.219.193,0,0,1,52,1,52,1.230463000,0.0000
204.200.53.81,<->,136.25.188.52,0,0,1,56,1,56,1.230416000,0.0000
111.2.152.14,<->,8.182.226.78,0,0,1,50,1,50,1.230192000,0.0000
197.113.65.0,<->,136.25.188.178,0,0,1,50,1,50,1.230129000,0.0000
198.35.143.131,<->,139.163.26.146,0,0,1,99,1,99,1.229917000,0.0000
17.69.235.28,<->,8.220.176.253,0,0,1,50,1,50,1.229748000,0.0000
110.65.225.22,<->,50.224.76.235,0,0,1,50,1,50,1.229627000,0.0000
159.237.225.1,<->,121.227.142.184,1,52,0,0,1,52,1.229122000,0.0000
136.6.171.142,<->,20.243.42.146,0,0,1,64,1,64,1.228824000,0.0000
38.21.156.204,<->,20.232.228.122,0,0,1,82,1,82,1.228724000,0.0000
130.13.228.200,<->,8.220.233.50,0,0,1,84,1,84,1.228683000,0.0000
61.34.184.240,<->,8.52.135.2,0,0,1,1002,1,1002,1.228244000,0.0000
105.69.82.59,<->,20.35.165.146,0,0,1,56,1,56,1.228108000,0.0000
39.131.74.104,<->,0.48.111.58,1,50,0,0,1,50,1.227961000,0.0000
215.158.239.93,<->,199.76.70.154,1,132,0,0,1,132,1.227004000,0.0000
194.118.48.211,<->,39.220.32.3,0,0,1,60,1,60,1.226646000,0.0000
106.155.153.9,<->,8.250.153.211,0,0,1,84,1,84,1.226563000,0.0000
100.93.182.97,<->,35.55.218.106,1,56,0,0,1,56,1.226452000,0.0000
206.20.245.151,<->,92.27.219.17,0,0,1,52,1,52,1.226270000,0.0000
111.75.58.59,<->,56.121.48.108,0,0,1,74,1,74,1.226181000,0.0000
196.89.116.33,<->,20.104.0.187,0,0,1,56,1,56,1.225798000,0.0000
108.134.120.120,<->,42.68.246.99,1,50,0,0,1,50,1.225783000,0.0000
114.56.125.199,<->,101.224.204.193,0,0,1,147,1,147,1.225748000,0.0000
246.45.220.34,<->,75.62.16.8,1,50,0,0,1,50,1.225708000,0.0000
204.186.199.78,<->,136.25.188.209,0,0,1,765,1,765,1.225535000,0.0000
207.239.187.93,<->,136.25.188.176,0,0,1,56,1,56,1.225464000,0.0000
196.30.163.164,<->,97.126.110.171,0,0,1,64,1,64,1.225457000,0.0000
246.253.253.12,<->,57.18.136.2,1,116,0,0,1,116,1.225441000,0.0000
251.21.173.35,<->,109.222.232.22,0,0,1,134,1,134,1.225394000,0.0000
92.56.187.144,<->,8.220.205.146,0,0,1,50,1,50,1.225325000,0.0000
143.89.31.115,<->,136.25.188.53,0,0,1,56,1,56,1.225239000,0.0000
133.178.226.244,<->,131.36.201.66,1,90,0,0,1,90,1.225083000,0.0000
244.50.129.64,<->,20.94.254.40,0,0,1,50,1,50,1.225060000,0.0000
126.232.52.51,<->,20.108.97.39,0,0,1,64,1,64,1.225021000,0.0000
194.237.7.80,<->,136.25.188.178,0,0,1,56,1,56,1.224911000,0.0000
114.214.71.64,<->,92.27.219.220,0,0,1,56,1,56,1.224151000,0.0000
124.20.24.245,<->,20.197.26.142,0,0,1,52,1,52,1.224133000,0.0000
124.149.71.236,<->,92.27.219.20,0,0,1,50,1,50,1.224125000,0.0000
144.75.218.246,<->,138.127.225.234,1,254,0,0,1,254,1.224002000,0.0000
211.177.72.97,<->,33.233.141.230,0,0,1,92,1,92,1.223486000,0.0000
110.105.241.193,<->,80.42.165.111,0,0,1,52,1,52,1.223370000,0.0000
145.144.99.3,<->,123.135.85.172,1,64,0,0,1,64,1.223366000,0.0000
112.68.118.164,<->,8.220.205.50,0,0,1,84,1,84,1.223291000,0.0000
246.253.248.211,<->,53.212.189.88,1,87,0,0,1,87,1.222807000,0.0000
109.119.182.188,<->,109.1.56.197,0,0,1,64,1,64,1.222806000,0.0000
252.92.6.61,<->,8.252.222.134,0,0,1,50,1,50,1.222548000,0.0000
215.158.239.92,<->,199.20.6.133,1,64,0,0,1,64,1.222031000,0.0000
246.253.253.99,<->,56.114.235.120,1,50,0,0,1,50,1.222021000,0.0000
244.50.135.57,<->,20.167.188.43,0,0,1,50,1,50,1.221835000,0.0000
215.158.238.233,<->,126.219.234.254,1,100,0,0,1,100,1.221521000,0.0000
129.92.115.12,<->,38.97.37.162,1,56,0,0,1,56,1.221458000,0.0000
215.158.239.84,<->,199.20.7.225,1,160,0,0,1,160,1.221423000,0.0000
120.252.12.7,<->,111.146.132.89,0,0,1,78,1,78,1.221330000,0.0000
133.8.10.152,<->,33.233.141.121,0,0,1,284,1,284,1.221251000,0.0000
250.50.35.185,<->,92.27.219.53,0,0,1,74,1,74,1.221057000,0.0000
111.199.236.88,<->,0.195.210.44,0,0,1,50,1,50,1.220643000,0.0000
215.158.239.84,<->,207.190.170.184,1,76,0,0,1,76,1.220482000,0.0000
136.25.188.105,<->,124.63.211.122,1,236,0,0,1,236,1.220259000,0.0000
54.36.174.41,<->,48.53.146.152,0,0,1,52,1,52,1.219769000,0.0000
113.127.207.90,<->,97.126.113.136,0,0,1,64,1,64,1.219666000,0.0000
206.195.208.165,<->,101.70.106.97,0,0,1,64,1,64,1.219461000,0.0000
92.27.219.189,<->,27.117.27.216,1,317,0,0,1,317,1.219248000,0.0000
207.172.10.180,<->,136.25.188.225,0,0,1,105,1,105,1.218733000,0.0000
215.158.239.49,<->,199.72.67.188,1,64,0,0,1,64,1.218460000,0.0000
202.226.243.164,<->,145.89.157.42,0,0,1,130,1,130,1.218103000,0.0000
111.147.202.234,<->,54.58.210.172,1,50,0,0,1,50,1.217714000,0.0000
237.7.182.243,<->,39.220.72.194,0,0,1,64,1,64,1.217513000,0.0000
109.222.243.161,<->,48.120.106.220,1,80,0,0,1,80,1.217351000,0.0000
137.69.181.98,<->,8.182.226.78,0,0,1,50,1,50,1.217218000,0.0000
127.241.179.190,<->,20.206.72.252,0,0,1,60,1,60,1.217207000,0.0000
139.163.26.238,<->,105.108.142.132,1,50,0,0,1,50,1.217039000,0.0000
198.158.197.83,<->,20.191.33.84,0,0,1,50,1,50,1.216321000,0.0000
158.59.135.25,<->,92.27.219.38,0,0,1,52,1,52,1.215909000,0.0000
136.25.188.174,<->,132.123.119.116,1,56,0,0,1,56,1.215130000,0.0000
192.171.13.188,<->,8.176.8.207,0,0,1,101,1,101,1.215074000,0.0000
119.45.235.115,<->,89.183.104.149,0,0,1,309,1,309,1.215070000,0.0000
109.119.182.166,<->,17.25.193.30,0,0,1,56,1,56,1.214933000,0.0000
207.77.155.149,<->,8.182.227.180,0,0,1,50,1,50,1.214886000,0.0000
145.200.204.19,<->,8.182.224.248,0,0,1,50,1,50,1.214036000,0.0000
136.25.188.162,<->,4.135.107.21,1,56,0,0,1,56,1.213807000,0.0000
194.245.206.108,<->,39.149.97.33,0,0,1,96,1,96,1.213770000,0.0000
195.110.170.238,<->,99.72.240.156,0,0,1,50,1,50,1.213746000,0.0000
121.79.53.224,<->,111.147.100.68,0,0,1,150,1,150,1.213633000,0.0000
252.189.112.136,<->,98.236.223.238,0,0,1,56,1,56,1.213526000,0.0000
148.145.2.122,<->,101.224.204.141,0,0,1,80,1,80,1.213063000,0.0000
202.33.22.71,<->,136.25.188.52,0,0,1,56,1,56,1.213046000,0.0000
144.69.82.139,<->,100.120.38.126,1,75,0,0,1,75,1.212577000,0.0000
117.53.237.214,<->,0.195.210.42,0,0,1,50,1,50,1.212508000,0.0000
196.89.116.33,<->,20.104.0.185,0,0,1,56,1,56,1.212455000,0.0000
21.15.226.126,<->,20.193.30.1,0,0,1,82,1,82,1.212103000,0.0000
194.237.250.168,<->,136.25.188.236,0,0,1,68,1,68,1.212003000,0.0000
159.115.66.251,<->,78.51.80.203,1,52,0,0,1,52,1.211821000,0.0000
195.68.21.191,<->,136.25.188.226,0,0,1,56,1,56,1.211775000,0.0000
195.70.102.233,<->,136.25.188.241,0,0,1,50,1,50,1.211750000,0.0000
27.158.181.113,<->,20.179.52.222,0,0,1,52,1,52,1.211673000,0.0000
248.239.185.182,<->,106.168.190.67,1,56,0,0,1,56,1.211605000,0.0000
92.27.219.182,<->,66.247.36.243,1,136,0,0,1,136,1.211447000,0.0000
61.72.108.231,<->,8.43.210.250,0,0,1,84,1,84,1.211407000,0.0000
6.145.166.251,<->,0.195.210.44,0,0,1,56,1,56,1.211285000,0.0000
53.161.63.110,<->,48.53.32.145,0,0,1,56,1,56,1.211029000,0.0000
215.158.140.75,<->,80.47.152.201,1,1084,0,0,1,1084,1.210686000,0.0000
215.158.61.242,<->,8.176.8.255,0,0,1,56,1,56,1.210680000,0.0000
207.194.74.176,<->,80.42.179.227,0,0,1,64,1,64,1.210489000,0.0000
80.47.23.44,<->,8.176.8.70,0,0,1,68,1,68,1.210337000,0.0000
143.200.139.20,<->,129.224.112.252,0,0,1,80,1,80,1.210243000,0.0000
220.55.91.56,<->,139.155.70.249,1,149,0,0,1,149,1.210212000,0.0000
144.75.218.241,<->,138.127.231.83,1,253,0,0,1,253,1.210199000,0.0000
195.39.84.208,<->,8.182.224.180,0,0,1,50,1,50,1.209807000,0.0000
72.210.211.251,<->,33.233.141.84,0,0,1,572,1,572,1.209789000,0.0000
120.83.1.71,<->,92.27.219.224,0,0,1,129,1,129,1.209786000,0.0000
59.49.73.35,<->,56.121.55.213,0,0,1,64,1,64,1.209612000,0.0000
97.126.17.109,<->,50.233.108.108,1,68,0,0,1,68,1.209433000,0.0000
215.158.239.79,<->,195.6.27.168,1,50,0,0,1,50,1.209425000,0.0000
144.85.170.208,<->,98.87.146.172,1,64,0,0,1,64,1.208686000,0.0000
101.70.107.210,<->,53.224.117.32,1,50,0,0,1,50,1.208614000,0.0000
198.25.75.198,<->,80.40.57.229,0,0,1,130,1,130,1.208491000,0.0000
192.64.210.96,<->,126.119.197.36,1,319,0,0,1,319,1.208454000,0.0000
54.59.75.111,<->,48.52.80.13,0,0,1,93,1,93,1.208314000,0.0000
243.117.125.26,<->,203.214.79.56,0,0,1,50,1,50,1.208271000,0.0000
89.183.104.178,<->,38.87.182.252,1,62,0,0,1,62,1.208115000,0.0000
92.27.219.204,<->,29.169.76.213,1,1452,0,0,1,1452,1.208038000,0.0000
103.158.196.174,<->,8.220.200.124,0,0,1,50,1,50,1.208014000,0.0000
145.213.37.25,<->,136.129.94.109,0,0,1,84,1,84,1.207910000,0.0000
243.123.125.57,<->,210.158.44.41,0,0,1,1035,1,1035,1.207208000,0.0000
215.158.239.182,<->,111.151.109.34,1,56,0,0,1,56,1.206756000,0.0000
136.25.188.161,<->,113.20.94.83,1,1229,0,0,1,1229,1.206453000,0.0000
74.132.92.246,<->,39.18.156.122,0,0,1,64,1,64,1.206244000,0.0000
241.193.172.231,<->,20.182.216.128,0,0,1,50,1,50,1.206191000,0.0000
132.249.70.233,<->,53.178.104.39,1,87,0,0,1,87,1.205859000,0.0000
109.122.222.210,<->,8.228.216.50,0,0,1,56,1,56,1.205794000,0.0000
109.105.152.232,<->,8.220.191.154,0,0,1,50,1,50,1.205713000,0.0000
220.80.166.154,<->,8.55.224.156,1,92,0,0,1,92,1.204456000,0.0000
121.165.58.251,<->,20.181.37.56,0,0,1,52,1,52,1.204236000,0.0000
75.131.21.137,<->,8.252.222.48,0,0,1,50,1,50,1.203093000,0.0000
142.207.240.33,<->,136.25.188.176,0,0,1,50,1,50,1.203073000,0.0000
133.178.226.246,<->,80.57.138.214,1,56,0,0,1,56,1.203026000,0.0000
215.158.239.92,<->,199.20.31.42,1,64,0,0,1,64,1.202076000,0.0000
215.158.140.207,<->,132.208.30.213,1,50,0,0,1,50,1.201946000,0.0000
196.233.166.79,<->,8.182.241.177,0,0,1,50,1,50,1.201750000,0.0000
134.53.87.42,<->,109.1.16.210,0,0,1,64,1,64,1.201725000,0.0000
111.147.153.228,<->,53.221.175.173,1,125,0,0,1,125,1.201703000,0.0000
196.126.208.63,<->,92.27.219.242,0,0,1,52,1,52,1.201362000,0.0000
144.75.218.237,<->,138.127.230.5,1,279,0,0,1,279,1.201318000,0.0000
92.27.27.183,<->,33.245.146.245,1,52,0,0,1,52,1.200676000,0.0000
33.182.213.211,<->,20.61.49.107,0,0,1,80,1,80,1.200411000,0.0000
136.116.28.240,<->,8.53.32.195,1,704,0,0,1,704,1.200015000,0.0000
72.198.225.4,<->,39.227.147.56,0,0,1,66,1,66,1.199850000,0.0000
241.193.172.231,<->,20.181.89.149,0,0,1,50,1,50,1.199788000,0.0000
96.232.117.46,<->,92.27.219.128,0,0,1,151,1,151,1.199490000,0.0000
53.161.180.137,<->,48.55.59.102,0,0,1,50,1,50,1.199479000,0.0000
196.233.211.160,<->,8.182.241.177,0,0,1,50,1,50,1.199344000,0.0000
207.193.113.167,<->,8.252.222.29,0,0,1,95,1,95,1.199329000,0.0000
138.74.30.197,<->,109.119.182.171,1,50,0,0,1,50,1.199290000,0.0000
205.91.195.56,<->,89.183.104.191,0,0,1,52,1,52,1.198596000,0.0000
210.220.219.150,<->,91.43.106.196,1,93,0,0,1,93,1.198273000,0.0000
111.151.142.230,<->,8.252.221.232,0,0,1,100,1,100,1.197881000,0.0000
215.158.140.87,<->,83.239.1.55,1,50,0,0,1,50,1.197207000,0.0000
192.67.147.28,<->,130.186.148.68,1,50,0,0,1,50,1.197010000,0.0000
215.158.238.133,<->,123.130.141.150,1,1277,0,0,1,1277,1.196874000,0.0000
91.51.5.19,<->,20.159.98.14,0,0,1,52,1,52,1.196706000,0.0000
207.191.168.51,<->,136.25.188.222,0,0,1,132,1,132,1.196435000,0.0000
50.116.119.252,<->,8.52.132.187,0,0,1,50,1,50,1.196417000,0.0000
148.141.109.98,<->,8.228.214.59,0,0,1,112,1,112,1.196360000,0.0000
145.16.30.242,<->,137.39.55.24,1,50,0,0,1,50,1.196321000,0.0000
137.44.211.250,<->,8.250.148.227,0,0,1,84,1,84,1.196236000,0.0000
200.174.202.105,<->,6.186.47.64,1,273,0,0,1,273,1.195972000,0.0000
119.219.189.202,<->,80.41.53.34,0,0,1,325,1,325,1.195709000,0.0000
194.107.29.92,<->,20.169.41.156,0,0,1,174,1,174,1.195349000,0.0000
91.231.204.248,<->,20.189.48.191,0,0,1,52,1,52,1.195239000,0.0000
118.228.219.119,<->,50.224.76.235,0,0,1,56,1,56,1.195097000,0.0000
144.72.194.209,<->,102.50.203.224,0,0,1,50,1,50,1.194918000,0.0000
17.140.223.133,<->,8.220.202.151,0,0,1,50,1,50,1.194675000,0.0000
215.158.239.48,<->,204.226.8.205,1,50,0,0,1,50,1.194624000,0.0000
144.75.218.237,<->,130.61.250.229,1,126,0,0,1,126,1.194614000,0.0000
215.158.239.124,<->,112.88.209.14,1,140,0,0,1,140,1.194535000,0.0000
152.134.187.138,<->,39.18.16.156,0,0,1,541,1,541,1.194525000,0.0000
156.183.165.18,<->,39.15.158.95,0,0,1,52,1,52,1.194185000,0.0000
144.75.218.233,<->,138.127.225.15,1,197,0,0,1,197,1.194018000,0.0000
207.172.230.255,<->,136.25.188.53,0,0,1,781,1,781,1.193723000,0.0000
144.75.218.235,<->,139.252.1.234,1,180,0,0,1,180,1.193509000,0.0000
215.158.239.79,<->,194.251.71.223,1,50,0,0,1,50,1.193416000,0.0000
142.236.65.50,<->,136.25.188.175,0,0,1,56,1,56,1.193401000,0.0000
132.216.20.177,<->,101.126.180.212,0,0,1,50,1,50,1.193327000,0.0000
127.27.251.233,<->,39.166.150.51,0,0,1,128,1,128,1.193210000,0.0000
215.158.239.229,<->,8.47.188.160,1,151,0,0,1,151,1.193197000,0.0000
220.199.57.13,<->,8.220.176.253,0,0,1,50,1,50,1.193194000,0.0000
215.158.239.78,<->,196.95.52.160,1,64,0,0,1,64,1.192962000,0.0000
238.125.29.51,<->,136.25.188.105,0,0,1,138,1,138,1.192781000,0.0000
92.27.219.20,<->,33.57.77.155,1,50,0,0,1,50,1.192585000,0.0000
198.158.197.83,<->,20.0.116.31,0,0,1,50,1,50,1.192437000,0.0000
255.133.229.164,<->,39.173.227.135,0,0,1,100,1,100,1.192045000,0.0000
38.21.156.204,<->,20.232.228.104,0,0,1,82,1,82,1.192013000,0.0000
241.193.172.231,<->,20.136.130.59,0,0,1,50,1,50,1.191952000,0.0000
133.178.226.220,<->,100.224.163.94,1,557,0,0,1,557,1.191881000,0.0000
97.126.39.127,<->,57.141.118.57,1,97,0,0,1,97,1.191800000,0.0000
197.113.99.228,<->,136.25.188.162,0,0,1,56,1,56,1.191762000,0.0000
195.89.13.0,<->,8.182.136.217,0,0,1,50,1,50,1.191723000,0.0000
133.178.227.7,<->,29.211.165.84,1,85,0,0,1,85,1.191720000,0.0000
111.147.66.19,<->,54.37.127.247,1,56,0,0,1,56,1.191258000,0.0000
144.75.218.233,<->,138.127.224.73,1,184,0,0,1,184,1.190830000,0.0000
103.70.169.26,<->,8.220.176.253,0,0,1,50,1,50,1.190805000,0.0000
221.102.143.189,<->,192.64.244.13,0,0,1,141,1,141,1.190163000,0.0000
215.158.239.95,<->,196.92.85.69,1,68,0,0,1,68,1.190073000,0.0000
75.62.16.8,<->,20.224.61.53,0,0,1,50,1,50,1.189953000,0.0000
196.209.198.58,<->,8.20.87.153,0,0,1,50,1,50,1.189935000,0.0000
144.75.218.237,<->,33.229.58.179,1,127,0,0,1,127,1.189792000,0.0000
146.253.87.247,<->,136.25.188.105,0,0,1,126,1,126,1.189777000,0.0000
109.222.234.213,<->,26.239.129.100,1,72,0,0,1,72,1.189647000,0.0000
192.67.154.172,<->,6.194.98.213,1,56,0,0,1,56,1.189567000,0.0000
105.68.81.54,<->,20.125.235.16,0,0,1,64,1,64,1.189496000,0.0000
92.27.219.63,<->,29.165.54.202,1,52,0,0,1,52,1.189399000,0.0000
139.163.26.146,<->,136.116.9.17,1,99,0,0,1,99,1.189063000,0.0000
143.144.238.3,<->,20.177.82.121,0,0,1,52,1,52,1.189062000,0.0000
207.194.74.176,<->,80.42.179.223,0,0,1,64,1,64,1.189021000,0.0000
220.55.126.117,<->,220.28.104.139,1,76,0,0,1,76,1.188756000,0.0000
117.7.164.34,<->,39.32.47.103,0,0,1,84,1,84,1.188724000,0.0000
144.93.121.83,<->,131.2.34.14,1,104,0,0,1,104,1.188580000,0.0000
144.69.82.139,<->,35.62.71.37,1,58,0,0,1,58,1.188378000,0.0000
215.158.239.78,<->,196.93.130.50,1,56,0,0,1,56,1.188111000,0.0000
111.2.141.22,<->,39.28.155.53,0,0,1,89,1,89,1.188003000,0.0000
140.147.122.52,<->,8.250.157.211,0,0,1,84,1,84,1.187875000,0.0000
206.103.168.166,<->,133.32.39.0,0,0,1,84,1,84,1.187787000,0.0000
101.70.123.195,<->,17.242.78.228,1,56,0,0,1,56,1.187774000,0.0000
75.62.16.8,<->,20.23.15.18,0,0,1,50,1,50,1.187739000,0.0000
127.79.61.116,<->,89.183.104.155,0,0,1,149,1,149,1.187416000,0.0000
215.158.239.56,<->,142.166.51.238,1,64,0,0,1,64,1.187283000,0.0000
207.173.86.38,<->,136.25.188.174,0,0,1,681,1,681,1.187226000,0.0000
113.127.207.90,<->,97.126.113.56,0,0,1,64,1,64,1.186897000,0.0000
92.27.219.228,<->,74.168.49.116,1,64,0,0,1,64,1.186789000,0.0000
136.116.28.199,<->,8.193.74.84,1,1064,0,0,1,1064,1.186278000,0.0000
215.158.239.56,<->,199.20.29.75,1,68,0,0,1,68,1.186116000,0.0000
80.93.6.117,<->,20.90.193.148,0,0,1,52,1,52,1.185994000,0.0000
207.64.129.119,<->,92.27.194.147,0,0,1,56,1,56,1.185851000,0.0000
124.40.23.147,<->,92.27.219.49,0,0,1,52,1,52,1.185810000,0.0000
241.193.172.231,<->,20.74.221.16,0,0,1,50,1,50,1.185772000,0.0000
8.182.245.10,<->,6.242.43.51,1,50,0,0,1,50,1.185738000,0.0000
139.47.249.71,<->,109.192.136.250,0,0,1,50,1,50,1.185612000,0.0000
120.102.210.174,<->,20.234.131.124,0,0,1,52,1,52,1.185512000,0.0000
210.209.251.214,<->,109.222.238.4,0,0,1,481,1,481,1.185454000,0.0000
101.195.32.10,<->,8.220.176.253,0,0,1,56,1,56,1.185419000,0.0000
109.1.16.245,<->,27.188.163.162,1,443,0,0,1,443,1.185232000,0.0000
207.230.26.226,<->,109.112.164.219,0,0,1,72,1,72,1.185204000,0.0000
194.247.3.25,<->,39.17.148.51,0,0,1,64,1,64,1.185134000,0.0000
192.67.149.88,<->,117.111.143.108,1,853,0,0,1,853,1.184909000,0.0000
97.126.7.170,<->,53.190.133.102,1,134,0,0,1,134,1.184547000,0.0000
215.158.140.181,<->,111.151.107.247,1,96,0,0,1,96,1.184016000,0.0000
144.75.218.233,<->,138.127.224.184,1,365,0,0,1,365,1.183739000,0.0000
241.193.172.231,<->,20.187.9.83,0,0,1,50,1,50,1.183731000,0.0000
8.182.226.78,<->,6.242.3.177,1,50,0,0,1,50,1.183594000,0.0000
215.158.239.99,<->,196.104.62.175,1,190,0,0,1,190,1.183496000,0.0000
210.156.127.28,<->,94.194.6.39,1,133,0,0,1,133,1.183285000,0.0000
119.90.251.239,<->,20.147.241.98,0,0,1,50,1,50,1.183202000,0.0000
204.186.127.48,<->,136.25.188.222,0,0,1,717,1,717,1.182900000,0.0000
121.212.205.4,<->,92.27.219.169,0,0,1,110,1,110,1.182686000,0.0000
108.134.111.22,<->,57.31.51.159,1,83,0,0,1,83,1.182551000,0.0000
207.194.74.176,<->,80.42.179.136,0,0,1,64,1,64,1.182022000,0.0000
57.31.49.198,<->,39.14.27.228,0,0,1,125,1,125,1.182000000,0.0000
105.198.248.213,<->,39.36.82.115,0,0,1,52,1,52,1.181734000,0.0000
196.113.186.195,<->,39.246.85.215,0,0,1,64,1,64,1.181712000,0.0000
109.1.61.116,<->,74.245.228.7,1,133,0,0,1,133,1.181709000,0.0000
105.92.5.230,<->,20.122.133.235,0,0,1,80,1,80,1.181417000,0.0000
139.241.119.211,<->,39.15.169.14,0,0,1,86,1,86,1.181371000,0.0000
101.195.32.10,<->,8.220.177.81,0,0,1,56,1,56,1.181162000,0.0000
247.136.176.220,<->,144.72.195.98,1,50,0,0,1,50,1.180999000,0.0000
233.145.101.62,<->,109.222.236.213,0,0,1,50,1,50,1.180876000,0.0000
249.101.102.77,<->,233.116.130.93,1,50,0,0,1,50,1.180551000,0.0000
120.194.177.4,<->,92.27.27.164,0,0,1,103,1,103,1.180321000,0.0000
215.158.239.59,<->,199.20.30.218,1,56,0,0,1,56,1.180316000,0.0000
140.68.4.197,<->,8.252.222.47,0,0,1,68,1,68,1.180021000,0.0000
137.179.183.36,<->,53.167.113.10,1,705,0,0,1,705,1.179993000,0.0000
215.158.238.130,<->,126.219.234.254,1,56,0,0,1,56,1.179914000,0.0000
21.15.226.126,<->,20.193.30.67,0,0,1,82,1,82,1.179385000,0.0000
135.197.3.172,<->,132.249.70.233,0,0,1,120,1,120,1.179289000,0.0000
130.42.10.219,<->,97.126.26.70,0,0,1,173,1,173,1.178745000,0.0000
215.158.239.76,<->,196.0.148.202,1,50,0,0,1,50,1.178706000,0.0000
133.178.226.29,<->,126.219.132.218,1,1149,0,0,1,1149,1.178547000,0.0000
247.136.177.71,<->,0.79.56.179,1,56,0,0,1,56,1.178416000,0.0000
101.195.32.10,<->,8.220.202.59,0,0,1,56,1,56,1.178298000,0.0000
142.207.123.49,<->,136.25.188.253,0,0,1,50,1,50,1.177450000,0.0000
210.235.164.182,<->,119.49.244.243,1,124,0,0,1,124,1.177142000,0.0000
194.210.193.149,<->,8.182.224.87,0,0,1,50,1,50,1.177129000,0.0000
205.91.179.235,<->,89.183.104.150,0,0,1,52,1,52,1.176962000,0.0000
133.171.115.110,<->,130.170.125.252,1,88,0,0,1,88,1.176693000,0.0000
153.99.69.27,<->,20.147.15.136,0,0,1,62,1,62,1.176584000,0.0000
215.158.61.193,<->,136.25.188.35,0,0,1,381,1,381,1.176463000,0.0000
215.158.140.8,<->,109.126.137.221,1,56,0,0,1,56,1.176436000,0.0000
17.198.78.172,<->,8.220.239.104,0,0,1,50,1,50,1.176427000,0.0000
192.64.250.118,<->,115.179.112.80,1,50,0,0,1,50,1.176304000,0.0000
215.158.239.57,<->,207.16.33.252,1,64,0,0,1,64,1.175958000,0.0000
207.124.255.140,<->,80.40.9.24,0,0,1,56,1,56,1.175926000,0.0000
140.147.42.5,<->,8.252.222.95,0,0,1,68,1,68,1.175897000,0.0000
115.167.81.247,<->,111.20.168.4,0,0,1,110,1,110,1.175883000,0.0000
97.126.18.233,<->,80.200.62.165,1,70,0,0,1,70,1.175724000,0.0000
114.224.195.75,<->,109.222.193.244,0,0,1,77,1,77,1.175528000,0.0000
95.30.133.114,<->,8.228.217.218,0,0,1,67,1,67,1.175485000,0.0000
131.94.186.165,<->,20.233.129.168,0,0,1,102,1,102,1.175309000,0.0000
100.182.99.11,<->,20.179.123.165,0,0,1,52,1,52,1.174750000,0.0000
148.155.129.25,<->,101.224.89.180,0,0,1,173,1,173,1.174740000,0.0000
127.127.18.186,<->,20.212.65.115,0,0,1,56,1,56,1.174702000,0.0000
215.158.140.193,<->,127.255.93.100,1,50,0,0,1,50,1.174176000,0.0000
198.158.197.83,<->,20.144.100.6,0,0,1,50,1,50,1.174159000,0.0000
120.83.117.77,<->,89.183.104.168,0,0,1,309,1,309,1.174149000,0.0000
54.60.142.223,<->,48.52.83.251,0,0,1,52,1,52,1.173346000,0.0000
149.26.172.124,<->,8.43.212.233,0,0,1,84,1,84,1.173258000,0.0000
195.78.202.163,<->,109.222.249.216,0,0,1,99,1,99,1.173154000,0.0000
93.209.205.221,<->,89.183.104.237,0,0,1,84,1,84,1.172801000,0.0000
39.41.151.76,<->,38.124.124.207,1,64,0,0,1,64,1.172731000,0.0000
199.71.81.191,<->,136.25.188.174,0,0,1,64,1,64,1.172711000,0.0000
221.102.143.189,<->,98.129.25.93,0,0,1,87,1,87,1.172456000,0.0000
220.185.99.203,<->,89.183.104.146,0,0,1,351,1,351,1.172331000,0.0000
142.43.184.230,<->,39.166.182.149,0,0,1,64,1,64,1.172238000,0.0000
156.143.159.82,<->,20.2.234.129,0,0,1,68,1,68,1.172137000,0.0000
92.27.219.189,<->,48.106.243.183,1,135,0,0,1,135,1.171477000,0.0000
197.7.107.239,<->,8.182.138.83,0,0,1,50,1,50,1.171085000,0.0000
199.111.200.145,<->,100.93.64.127,0,0,1,138,1,138,1.171075000,0.0000
93.254.16.169,<->,92.27.219.63,0,0,1,52,1,52,1.171042000,0.0000
136.25.188.171,<->,111.150.207.201,1,100,0,0,1,100,1.170904000,0.0000
60.101.47.173,<->,8.252.221.236,0,0,1,50,1,50,1.170853000,0.0000
132.216.20.152,<->,101.112.199.36,0,0,1,56,1,56,1.170838000,0.0000
136.25.188.173,<->,91.54.18.26,1,50,0,0,1,50,1.170733000,0.0000
194.233.35.194,<->,136.25.188.196,0,0,1,64,1,64,1.170720000,0.0000
133.178.226.232,<->,111.150.207.201,1,100,0,0,1,100,1.170194000,0.0000
119.90.251.239,<->,39.20.178.42,0,0,1,50,1,50,1.170114000,0.0000
241.193.172.231,<->,20.122.154.169,0,0,1,50,1,50,1.169808000,0.0000
109.222.250.174,<->,109.124.187.222,1,76,0,0,1,76,1.169627000,0.0000
92.27.27.184,<->,29.217.237.116,1,52,0,0,1,52,1.169624000,0.0000
159.69.187.22,<->,144.76.43.246,1,76,0,0,1,76,1.169575000,0.0000
93.92.74.120,<->,80.41.35.54,0,0,1,52,1,52,1.169491000,0.0000
145.116.118.25,<->,110.195.195.90,1,133,0,0,1,133,1.169458000,0.0000
192.67.152.128,<->,120.118.162.203,1,54,0,0,1,54,1.169420000,0.0000
92.162.253.233,<->,27.199.161.199,1,56,0,0,1,56,1.169278000,0.0000
144.75.218.233,<->,138.127.231.39,1,256,0,0,1,256,1.169155000,0.0000
199.21.184.24,<->,8.182.138.83,0,0,1,50,1,50,1.169009000,0.0000
111.20.44.252,<->,109.222.201.157,0,0,1,52,1,52,1.168786000,0.0000
231.140.6.134,<->,215.158.239.96,0,0,1,56,1,56,1.168542000,0.0000
144.71.44.73,<->,124.125.130.196,1,116,0,0,1,116,1.168166000,0.0000
199.114.230.219,<->,39.53.168.180,0,0,1,60,1,60,1.168005000,0.0000
115.65.147.17,<->,92.27.27.179,0,0,1,330,1,330,1.167852000,0.0000
57.205.148.213,<->,50.224.76.234,0,0,1,50,1,50,1.167642000,0.0000
197.81.130.216,<->,39.5.176.34,0,0,1,126,1,126,1.167099000,0.0000
241.193.172.231,<->,20.32.29.184,0,0,1,50,1,50,1.166783000,0.0000
104.141.11.186,<->,102.51.24.236,0,0,1,130,1,130,1.166734000,0.0000
89.183.104.159,<->,38.139.96.253,1,52,0,0,1,52,1.166285000,0.0000
192.64.229.25,<->,124.149.71.236,1,77,0,0,1,77,1.166157000,0.0000
192.67.143.167,<->,8.179.135.180,1,50,0,0,1,50,1.166129000,0.0000
241.193.172.231,<->,20.21.142.63,0,0,1,50,1,50,1.166009000,0.0000
204.40.75.199,<->,99.75.19.169,0,0,1,102,1,102,1.165973000,0.0000
100.95.230.73,<->,27.13.81.64,1,50,0,0,1,50,1.165883000,0.0000
126.117.71.100,<->,92.27.219.48,0,0,1,97,1,97,1.165738000,0.0000
129.224.112.252,<->,114.145.109.163,1,80,0,0,1,80,1.165596000,0.0000
196.119.218.25,<->,92.27.194.147,0,0,1,56,1,56,1.165564000,0.0000
221.102.107.147,<->,100.230.7.100,1,50,0,0,1,50,1.165285000,0.0000
204.58.159.134,<->,136.25.188.224,0,0,1,56,1,56,1.165011000,0.0000
141.166.138.70,<->,39.8.240.172,0,0,1,126,1,126,1.164838000,0.0000
111.146.229.202,<->,42.119.56.135,1,168,0,0,1,168,1.164645000,0.0000
141.16.220.122,<->,80.27.153.8,0,0,1,56,1,56,1.164618000,0.0000
249.229.108.96,<->,8.220.239.66,0,0,1,50,1,50,1.164558000,0.0000
195.55.44.213,<->,136.25.188.210,0,0,1,50,1,50,1.164416000,0.0000
159.57.90.68,<->,109.222.208.59,0,0,1,50,1,50,1.164303000,0.0000
246.253.168.231,<->,27.90.46.154,1,50,0,0,1,50,1.164296000,0.0000
192.67.157.233,<->,38.173.177.222,1,56,0,0,1,56,1.164287000,0.0000
231.255.191.44,<->,192.64.91.37,0,0,1,50,1,50,1.164238000,0.0000
227.56.35.246,<->,33.233.141.123,0,0,1,167,1,167,1.163990000,0.0000
207.194.74.176,<->,80.42.179.222,0,0,1,64,1,64,1.163697000,0.0000
144.75.218.242,<->,144.44.177.217,1,162,0,0,1,162,1.163645000,0.0000
215.158.140.77,<->,111.151.106.235,1,56,0,0,1,56,1.163587000,0.0000
220.205.25.218,<->,218.4.168.6,0,0,1,80,1,80,1.163241000,0.0000
136.25.188.82,<->,111.151.109.51,1,56,0,0,1,56,1.162982000,0.0000
136.25.188.105,<->,132.4.136.122,1,166,0,0,1,166,1.162956000,0.0000
215.158.239.76,<->,142.166.218.113,1,50,0,0,1,50,1.162863000,0.0000
247.136.220.38,<->,207.159.191.231,1,52,0,0,1,52,1.162862000,0.0000
215.158.239.17,<->,114.238.202.214,1,50,0,0,1,50,1.162788000,0.0000
127.232.174.72,<->,39.239.109.202,0,0,1,70,1,70,1.162487000,0.0000
253.19.1.153,<->,80.40.24.220,0,0,1,54,1,54,1.162167000,0.0000
100.230.13.247,<->,56.121.36.163,0,0,1,50,1,50,1.161775000,0.0000
38.21.156.204,<->,20.232.228.99,0,0,1,82,1,82,1.161529000,0.0000
215.158.61.253,<->,8.252.221.245,0,0,1,1157,1,1157,1.160856000,0.0000
247.136.164.16,<->,57.241.133.147,1,97,0,0,1,97,1.160778000,0.0000
114.194.29.182,<->,89.183.104.146,0,0,1,322,1,322,1.160452000,0.0000
144.75.218.235,<->,138.127.224.83,1,229,0,0,1,229,1.160323000,0.0000
246.23.236.58,<->,136.25.188.27,0,0,1,1004,1,1004,1.160249000,0.0000
97.126.24.188,<->,53.231.179.172,1,97,0,0,1,97,1.160239000,0.0000
215.158.239.124,<->,131.65.15.204,1,715,0,0,1,715,1.160153000,0.0000
139.33.175.144,<->,92.27.219.28,0,0,1,50,1,50,1.159423000,0.0000
109.3.145.240,<->,61.51.212.221,1,133,0,0,1,133,1.159376000,0.0000
244.50.129.64,<->,39.165.75.213,0,0,1,50,1,50,1.159240000,0.0000
199.81.232.212,<->,136.25.188.176,0,0,1,50,1,50,1.158956000,0.0000
196.17.104.47,<->,80.42.160.104,0,0,1,52,1,52,1.158897000,0.0000
220.16.130.142,<->,89.183.109.94,0,0,1,56,1,56,1.158644000,0.0000
235.224.120.198,<->,192.64.215.178,0,0,1,136,1,136,1.158565000,0.0000
133.178.227.97,<->,111.151.142.182,1,56,0,0,1,56,1.158519000,0.0000
111.147.135.6,<->,53.148.22.108,1,125,0,0,1,125,1.158484000,0.0000
149.57.27.184,<->,89.183.104.177,0,0,1,263,1,263,1.158353000,0.0000
207.21.18.251,<->,20.214.92.24,0,0,1,52,1,52,1.158083000,0.0000
215.158.140.206,<->,130.101.149.241,1,50,0,0,1,50,1.158067000,0.0000
144.253.73.246,<->,133.178.227.228,0,0,1,285,1,285,1.157757000,0.0000
132.71.226.173,<->,101.70.126.154,0,0,1,52,1,52,1.157324000,0.0000
73.105.159.245,<->,20.121.101.176,0,0,1,64,1,64,1.157101000,0.0000
220.55.123.208,<->,27.11.34.178,1,85,0,0,1,85,1.156701000,0.0000
230.94.201.201,<->,100.182.191.235,0,0,1,138,1,138,1.156649000,0.0000
196.233.179.59,<->,8.182.250.109,0,0,1,50,1,50,1.156475000,0.0000
123.106.105.212,<->,20.185.77.89,0,0,1,68,1,68,1.156309000,0.0000
215.158.239.93,<->,196.107.154.18,1,56,0,0,1,56,1.156260000,0.0000
75.137.148.199,<->,8.252.221.198,0,0,1,524,1,524,1.155950000,0.0000
93.214.143.185,<->,50.224.76.234,0,0,1,50,1,50,1.155729000,0.0000
104.232.115.160,<->,20.171.10.208,0,0,1,64,1,64,1.155506000,0.0000
199.100.74.170,<->,50.224.76.230,0,0,1,50,1,50,1.155033000,0.0000
89.183.104.181,<->,48.110.90.1,1,56,0,0,1,56,1.154989000,0.0000
144.75.218.246,<->,97.110.148.13,1,67,0,0,1,67,1.154964000,0.0000
215.158.239.85,<->,207.58.0.254,1,56,0,0,1,56,1.154934000,0.0000
248.225.26.34,<->,95.221.85.227,1,893,0,0,1,893,1.154820000,0.0000
114.236.240.176,<->,92.27.219.28,0,0,1,319,1,319,1.154637000,0.0000
80.57.138.196,<->,8.252.221.165,0,0,1,100,1,100,1.154124000,0.0000
111.181.122.223,<->,89.70.233.152,1,56,0,0,1,56,1.153683000,0.0000
138.127.226.109,<->,129.179.50.133,0,0,1,222,1,222,1.153267000,0.0000
194.233.58.159,<->,136.25.188.178,0,0,1,68,1,68,1.153092000,0.0000
207.194.74.176,<->,80.42.179.213,0,0,1,64,1,64,1.153064000,0.0000
144.75.218.235,<->,65.95.70.36,1,140,0,0,1,140,1.152839000,0.0000
207.41.151.242,<->,39.61.209.87,0,0,1,100,1,100,1.152806000,0.0000
21.15.226.126,<->,20.193.30.195,0,0,1,82,1,82,1.152709000,0.0000
144.75.218.242,<->,139.252.1.232,1,151,0,0,1,151,1.152648000,0.0000
241.193.172.231,<->,20.47.86.33,0,0,1,50,1,50,1.152569000,0.0000
116.98.161.10,<->,109.1.61.190,0,0,1,149,1,149,1.152508000,0.0000
210.56.117.49,<->,8.52.177.25,0,0,1,52,1,52,1.152324000,0.0000
158.255.94.12,<->,129.224.112.252,0,0,1,71,1,71,1.152184000,0.0000
138.45.88.195,<->,136.25.189.215,0,0,1,90,1,90,1.151243000,0.0000
196.247.200.153,<->,136.25.188.46,0,0,1,64,1,64,1.151208000,0.0000
99.162.65.136,<->,53.214.235.71,1,257,0,0,1,257,1.150992000,0.0000
127.179.185.76,<->,89.183.104.172,0,0,1,52,1,52,1.150612000,0.0000
109.222.206.93,<->,37.150.196.39,1,80,0,0,1,80,1.150523000,0.0000
133.178.227.173,<->,111.151.142.181,1,56,0,0,1,56,1.150430000,0.0000
139.254.214.188,<->,129.243.217.199,1,56,0,0,1,56,1.150155000,0.0000
92.27.219.218,<->,57.50.83.249,1,330,0,0,1,330,1.149742000,0.0000
241.228.129.126,<->,153.189.34.81,1,293,0,0,1,293,1.149501000,0.0000
132.43.156.54,<->,129.13.225.151,0,0,1,351,1,351,1.149008000,0.0000
199.39.73.116,<->,92.27.27.145,0,0,1,52,1,52,1.148942000,0.0000
196.112.116.141,<->,20.255.89.113,0,0,1,64,1,64,1.148851000,0.0000
193.23.0.8,<->,92.27.27.182,0,0,1,52,1,52,1.148791000,0.0000
196.120.85.20,<->,39.28.34.214,0,0,1,80,1,80,1.148714000,0.0000
159.69.187.24,<->,144.69.101.196,1,80,0,0,1,80,1.148516000,0.0000
215.158.239.95,<->,199.20.31.181,1,64,0,0,1,64,1.148406000,0.0000
121.92.106.82,<->,39.9.31.78,0,0,1,86,1,86,1.148088000,0.0000
111.147.216.130,<->,53.148.22.112,1,125,0,0,1,125,1.148070000,0.0000
129.26.243.201,<->,112.208.20.140,1,163,0,0,1,163,1.148039000,0.0000
196.112.116.141,<->,20.255.89.114,0,0,1,64,1,64,1.148031000,0.0000
196.148.133.194,<->,123.86.109.137,1,321,0,0,1,321,1.147760000,0.0000
118.96.239.21,<->,20.187.188.146,0,0,1,104,1,104,1.147727000,0.0000
113.174.26.210,<->,99.75.149.54,0,0,1,133,1,133,1.147577000,0.0000
195.54.132.67,<->,136.25.188.177,0,0,1,50,1,50,1.147287000,0.0000
38.79.163.48,<->,8.43.222.27,0,0,1,704,1,704,1.147237000,0.0000
100.157.156.56,<->,8.52.222.23,0,0,1,50,1,50,1.146991000,0.0000
92.27.219.189,<->,84.14.255.50,1,64,0,0,1,64,1.146843000,0.0000
207.213.190.31,<->,39.19.67.136,0,0,1,94,1,94,1.146729000,0.0000
199.51.27.54,<->,136.25.188.239,0,0,1,56,1,56,1.146708000,0.0000
48.131.157.46,<->,8.176.8.84,0,0,1,89,1,89,1.146656000,0.0000
131.22.113.247,<->,8.52.222.211,0,0,1,1002,1,1002,1.146518000,0.0000
136.181.42.3,<->,107.13.12.217,1,56,0,0,1,56,1.146390000,0.0000
144.75.218.233,<->,138.127.230.149,1,366,0,0,1,366,1.146384000,0.0000
57.98.56.162,<->,39.223.126.153,0,0,1,104,1,104,1.145719000,0.0000
105.240.208.149,<->,50.224.76.234,0,0,1,50,1,50,1.145587000,0.0000
121.165.232.142,<->,20.234.179.82,0,0,1,52,1,52,1.145423000,0.0000
136.25.188.35,<->,98.28.95.54,1,111,0,0,1,111,1.145230000,0.0000
114.215.120.41,<->,92.27.219.143,0,0,1,56,1,56,1.145187000,0.0000
247.136.254.102,<->,117.91.158.107,1,52,0,0,1,52,1.145160000,0.0000
249.129.136.215,<->,111.151.109.33,1,56,0,0,1,56,1.145120000,0.0000
124.80.226.111,<->,100.92.42.66,0,0,1,321,1,321,1.145089000,0.0000
138.23.198.132,<->,8.219.186.186,1,90,0,0,1,90,1.144984000,0.0000
99.75.106.231,<->,35.55.176.154,1,56,0,0,1,56,1.144691000,0.0000
214.254.89.225,<->,8.220.202.13,0,0,1,84,1,84,1.144539000,0.0000
215.158.239.220,<->,48.131.157.46,1,90,0,0,1,90,1.144338000,0.0000
215.158.239.100,<->,111.150.207.169,1,56,0,0,1,56,1.144298000,0.0000
159.137.231.132,<->,158.230.16.101,1,50,0,0,1,50,1.143865000,0.0000
194.184.194.81,<->,39.1.75.247,0,0,1,60,1,60,1.143683000,0.0000
89.183.108.72,<->,78.48.0.51,1,50,0,0,1,50,1.143638000,0.0000
21.15.226.126,<->,20.193.30.220,0,0,1,82,1,82,1.143612000,0.0000
131.69.188.185,<->,92.162.253.159,0,0,1,50,1,50,1.143527000,0.0000
204.1.250.200,<->,136.25.188.198,0,0,1,129,1,129,1.143412000,0.0000
142.107.179.243,<->,39.196.88.45,0,0,1,96,1,96,1.143226000,0.0000
196.233.185.76,<->,8.182.230.157,0,0,1,50,1,50,1.143217000,0.0000
136.25.189.139,<->,111.151.109.20,1,100,0,0,1,100,1.143205000,0.0000
194.227.183.39,<->,8.52.187.74,0,0,1,56,1,56,1.143119000,0.0000
146.217.134.27,<->,101.224.169.159,0,0,1,57,1,57,1.143091000,0.0000
122.9.235.166,<->,99.73.166.232,0,0,1,52,1,52,1.143034000,0.0000
21.15.226.126,<->,20.193.30.218,0,0,1,82,1,82,1.142830000,0.0000
112.14.197.240,<->,39.132.59.86,0,0,1,64,1,64,1.142755000,0.0000
136.181.42.3,<->,111.25.52.96,1,56,0,0,1,56,1.142320000,0.0000
246.253.253.101,<->,54.37.162.116,1,794,0,0,1,794,1.142192000,0.0000
132.249.70.23,<->,8.222.6.181,1,56,0,0,1,56,1.142029000,0.0000
139.163.16.148,<->,102.240.109.181,1,50,0,0,1,50,1.141940000,0.0000
192.64.222.89,<->,109.119.182.188,1,52,0,0,1,52,1.141807000,0.0000
89.183.106.29,<->,69.174.20.51,1,50,0,0,1,50,1.141795000,0.0000
120.214.255.54,<->,101.70.103.119,0,0,1,100,1,100,1.141521000,0.0000
215.158.61.79,<->,137.21.23.51,0,0,1,1004,1,1004,1.141276000,0.0000
143.54.56.189,<->,50.223.3.228,0,0,1,50,1,50,1.141140000,0.0000
149.98.215.206,<->,8.182.136.217,0,0,1,56,1,56,1.141107000,0.0000
99.175.119.241,<->,53.149.30.218,1,125,0,0,1,125,1.140836000,0.0000
196.112.116.141,<->,20.255.89.120,0,0,1,64,1,64,1.140610000,0.0000
80.41.12.225,<->,38.136.169.74,1,52,0,0,1,52,1.140508000,0.0000
136.25.188.176,<->,56.18.174.56,1,56,0,0,1,56,1.140504000,0.0000
220.80.150.62,<->,119.230.159.219,1,133,0,0,1,133,1.140484000,0.0000
89.181.75.64,<->,74.249.239.112,1,293,0,0,1,293,1.140474000,0.0000
105.140.209.76,<->,20.143.42.40,0,0,1,52,1,52,1.140358000,0.0000
243.48.23.128,<->,144.75.218.235,0,0,1,152,1,152,1.140358000,0.0000
133.178.226.87,<->,111.151.109.16,1,56,0,0,1,56,1.140189000,0.0000
220.51.253.121,<->,133.32.39.0,0,0,1,50,1,50,1.140124000,0.0000
141.81.120.167,<->,33.233.141.32,0,0,1,78,1,78,1.139327000,0.0000
144.122.240.241,<->,144.108.64.183,1,69,0,0,1,69,1.139223000,0.0000
98.23.96.86,<->,92.27.219.229,0,0,1,56,1,56,1.139168000,0.0000
21.15.226.126,<->,20.193.30.222,0,0,1,82,1,82,1.139142000,0.0000
92.27.219.229,<->,92.27.131.122,1,56,0,0,1,56,1.139089000,0.0000
194.118.48.211,<->,39.220.32.172,0,0,1,60,1,60,1.138934000,0.0000
199.32.92.75,<->,20.239.97.190,0,0,1,52,1,52,1.138835000,0.0000
215.158.61.191,<->,8.176.8.245,0,0,1,56,1,56,1.138591000,0.0000
207.194.74.176,<->,80.42.179.158,0,0,1,64,1,64,1.138477000,0.0000
144.75.218.235,<->,138.127.224.125,1,348,0,0,1,348,1.138399000,0.0000
114.195.47.224,<->,89.183.104.135,0,0,1,62,1,62,1.138281000,0.0000
133.77.208.63,<->,129.224.112.252,0,0,1,65,1,65,1.138168000,0.0000
215.158.239.96,<->,204.226.11.55,1,64,0,0,1,64,1.137884000,0.0000
94.192.235.148,<->,80.38.16.208,0,0,1,50,1,50,1.137646000,0.0000
196.101.191.102,<->,109.1.58.78,0,0,1,80,1,80,1.137470000,0.0000
21.15.226.126,<->,20.193.31.250,0,0,1,82,1,82,1.137391000,0.0000
215.158.239.58,<->,196.0.148.202,1,50,0,0,1,50,1.137307000,0.0000
118.48.49.43,<->,8.182.233.86,0,0,1,50,1,50,1.137262000,0.0000
66.194.126.28,<->,8.228.214.59,0,0,1,52,1,52,1.137181000,0.0000
105.170.175.134,<->,39.38.253.185,0,0,1,52,1,52,1.137114000,0.0000
144.75.218.241,<->,143.204.138.236,1,177,0,0,1,177,1.137043000,0.0000
105.132.154.243,<->,92.27.219.237,0,0,1,177,1,177,1.136798000,0.0000
27.11.253.9,<->,8.52.134.29,0,0,1,56,1,56,1.136550000,0.0000
20.13.108.169,<->,0.200.50.50,1,60,0,0,1,60,1.136502000,0.0000
109.222.252.122,<->,53.231.158.110,1,511,0,0,1,511,1.136154000,0.0000
202.222.96.52,<->,8.238.168.0,0,0,1,133,1,133,1.136034000,0.0000
247.190.8.64,<->,8.220.176.253,0,0,1,50,1,50,1.135925000,0.0000
215.158.239.57,<->,204.1.169.99,1,50,0,0,1,50,1.135891000,0.0000
195.121.133.16,<->,8.182.235.164,0,0,1,50,1,50,1.135790000,0.0000
215.158.239.87,<->,207.167.132.42,1,68,0,0,1,68,1.135789000,0.0000
198.158.197.83,<->,20.152.228.192,0,0,1,50,1,50,1.135477000,0.0000
215.158.239.56,<->,199.20.28.102,1,56,0,0,1,56,1.135433000,0.0000
98.23.96.88,<->,92.27.219.128,0,0,1,56,1,56,1.135275000,0.0000
105.69.173.13,<->,20.227.80.25,0,0,1,64,1,64,1.135141000,0.0000
147.49.3.183,<->,39.243.208.129,0,0,1,52,1,52,1.135104000,0.0000
193.41.49.218,<->,39.248.102.79,0,0,1,64,1,64,1.134988000,0.0000
127.255.80.157,<->,92.27.219.49,0,0,1,52,1,52,1.134933000,0.0000
21.15.226.126,<->,20.193.31.229,0,0,1,82,1,82,1.134859000,0.0000
207.162.150.151,<->,8.182.136.217,0,0,1,50,1,50,1.134852000,0.0000
98.23.121.218,<->,92.27.219.128,0,0,1,56,1,56,1.134768000,0.0000
129.224.112.252,<->,92.162.219.51,1,90,0,0,1,90,1.134683000,0.0000
207.246.90.252,<->,39.167.240.97,0,0,1,60,1,60,1.134625000,0.0000
92.27.27.172,<->,64.214.44.89,1,50,0,0,1,50,1.134199000,0.0000
193.41.49.218,<->,39.15.89.32,0,0,1,64,1,64,1.134190000,0.0000
109.222.250.16,<->,17.142.246.251,1,72,0,0,1,72,1.134108000,0.0000
192.171.13.190,<->,8.252.222.54,0,0,1,138,1,138,1.134101000,0.0000
149.151.71.253,<->,80.42.156.128,0,0,1,135,1,135,1.133973000,0.0000
247.136.234.205,<->,75.95.145.227,1,84,0,0,1,84,1.133891000,0.0000
159.133.57.200,<->,64.214.57.45,1,50,0,0,1,50,1.133518000,0.0000
138.127.224.104,<->,136.25.188.29,0,0,1,286,1,286,1.133424000,0.0000
196.240.255.160,<->,136.25.188.176,0,0,1,56,1,56,1.133336000,0.0000
93.106.128.79,<->,80.42.146.105,0,0,1,52,1,52,1.133332000,0.0000
144.75.218.241,<->,138.127.224.185,1,366,0,0,1,366,1.133089000,0.0000
255.133.229.164,<->,39.154.138.43,0,0,1,100,1,100,1.133070000,0.0000
192.64.229.25,<->,121.196.222.187,1,99,0,0,1,99,1.132425000,0.0000
215.158.239.56,<->,195.81.20.30,1,64,0,0,1,64,1.132189000,0.0000
144.75.218.235,<->,138.127.225.222,1,366,0,0,1,366,1.132085000,0.0000
215.158.239.96,<->,199.20.31.248,1,172,0,0,1,172,1.131717000,0.0000
136.108.33.19,<->,39.144.127.89,1,77,0,0,1,77,1.131154000,0.0000
131.210.124.160,<->,111.20.168.141,0,0,1,203,1,203,1.131137000,0.0000
200.175.234.79,<->,53.214.237.69,1,50,0,0,1,50,1.130983000,0.0000
196.112.116.141,<->,20.255.89.148,0,0,1,64,1,64,1.130706000,0.0000
129.197.127.35,<->,97.126.117.98,0,0,1,170,1,170,1.130039000,0.0000
195.69.125.104,<->,20.103.184.243,0,0,1,66,1,66,1.130015000,0.0000
91.250.143.162,<->,39.201.169.207,0,0,1,50,1,50,1.129916000,0.0000
215.158.238.95,<->,201.211.113.163,1,1165,0,0,1,1165,1.129690000,0.0000
132.168.197.226,<->,129.245.206.220,1,723,0,0,1,723,1.129654000,0.0000
196.31.72.120,<->,111.181.116.40,0,0,1,52,1,52,1.129546000,0.0000
193.41.49.218,<->,39.249.182.73,0,0,1,64,1,64,1.129249000,0.0000
193.41.49.218,<->,39.248.25.83,0,0,1,64,1,64,1.129220000,0.0000
146.47.97.127,<->,39.10.45.15,0,0,1,52,1,52,1.129063000,0.0000
215.158.238.252,<->,111.150.207.80,1,56,0,0,1,56,1.129017000,0.0000
53.199.199.220,<->,39.15.169.14,0,0,1,86,1,86,1.128982000,0.0000
126.224.165.180,<->,20.52.19.80,0,0,1,64,1,64,1.128778000,0.0000
118.213.4.154,<->,92.27.219.150,0,0,1,52,1,52,1.128774000,0.0000
207.188.242.89,<->,20.167.128.198,0,0,1,68,1,68,1.128651000,0.0000
136.25.188.174,<->,41.129.26.187,1,50,0,0,1,50,1.128327000,0.0000
89.183.104.178,<->,27.40.186.140,1,52,0,0,1,52,1.128202000,0.0000
39.227.71.103,<->,0.48.111.58,1,50,0,0,1,50,1.127969000,0.0000
159.28.226.233,<->,132.123.40.70,0,0,1,70,1,70,1.127864000,0.0000
6.145.164.0,<->,0.195.210.44,0,0,1,182,1,182,1.127630000,0.0000
193.41.49.218,<->,39.248.153.191,0,0,1,64,1,64,1.127602000,0.0000
134.161.205.169,<->,92.27.27.175,0,0,1,52,1,52,1.127418000,0.0000
193.41.49.218,<->,39.248.230.141,0,0,1,64,1,64,1.127179000,0.0000
94.39.46.138,<->,39.51.105.13,0,0,1,64,1,64,1.126950000,0.0000
57.189.17.115,<->,39.231.195.68,0,0,1,74,1,74,1.126729000,0.0000
106.227.44.110,<->,39.7.244.173,0,0,1,52,1,52,1.126716000,0.0000
88.200.131.144,<->,80.38.0.9,0,0,1,50,1,50,1.126632000,0.0000
131.238.255.160,<->,97.126.0.28,0,0,1,56,1,56,1.126335000,0.0000
249.101.114.5,<->,50.145.214.5,1,56,0,0,1,56,1.126206000,0.0000
220.55.123.208,<->,206.195.194.146,1,83,0,0,1,83,1.126200000,0.0000
113.23.56.112,<->,8.52.130.205,0,0,1,1002,1,1002,1.126181000,0.0000
204.181.22.73,<->,20.105.166.91,0,0,1,98,1,98,1.126162000,0.0000
53.148.168.215,<->,48.53.100.211,0,0,1,1504,1,1504,1.125993000,0.0000
136.25.188.171,<->,111.150.207.200,1,56,0,0,1,56,1.125953000,0.0000
145.16.34.35,<->,132.175.159.89,1,56,0,0,1,56,1.125536000,0.0000
111.150.207.159,<->,8.252.223.164,0,0,1,56,1,56,1.125371000,0.0000
199.15.122.164,<->,136.25.188.198,0,0,1,50,1,50,1.125262000,0.0000
75.62.16.8,<->,20.42.7.5,0,0,1,50,1,50,1.124858000,0.0000
194.203.153.2,<->,20.197.66.186,0,0,1,60,1,60,1.124475000,0.0000
143.42.29.137,<->,136.25.188.162,0,0,1,68,1,68,1.124105000,0.0000
243.117.93.219,<->,159.137.243.250,0,0,1,50,1,50,1.123892000,0.0000
139.163.26.146,<->,110.243.138.180,1,99,0,0,1,99,1.123669000,0.0000
215.158.239.78,<->,196.94.126.173,1,56,0,0,1,56,1.123262000,0.0000
252.98.138.108,<->,159.112.9.198,1,81,0,0,1,81,1.123235000,0.0000
196.112.116.141,<->,20.255.89.187,0,0,1,64,1,64,1.123126000,0.0000
80.42.203.252,<->,66.210.105.224,1,130,0,0,1,130,1.122954000,0.0000
53.69.112.6,<->,33.233.141.19,0,0,1,124,1,124,1.122522000,0.0000
39.171.66.98,<->,0.48.111.58,1,50,0,0,1,50,1.122399000,0.0000
215.158.239.102,<->,78.128.203.59,1,116,0,0,1,116,1.122203000,0.0000
80.38.16.208,<->,66.92.232.159,1,56,0,0,1,56,1.121874000,0.0000
126.86.170.240,<->,20.20.251.226,0,0,1,76,1,76,1.121672000,0.0000
57.126.7.237,<->,39.138.199.229,0,0,1,68,1,68,1.121508000,0.0000
241.193.172.231,<->,20.61.197.161,0,0,1,50,1,50,1.121085000,0.0000
112.86.106.238,<->,20.79.120.53,0,0,1,64,1,64,1.121072000,0.0000
100.93.178.201,<->,33.78.156.246,1,56,0,0,1,56,1.121059000,0.0000
192.64.240.67,<->,33.107.91.35,1,52,0,0,1,52,1.120843000,0.0000
129.236.100.166,<->,129.224.112.252,0,0,1,76,1,76,1.120753000,0.0000
111.20.172.70,<->,33.233.141.33,0,0,1,290,1,290,1.120485000,0.0000
17.27.56.184,<->,8.220.191.154,0,0,1,50,1,50,1.120454000,0.0000
141.224.220.201,<->,80.27.159.59,0,0,1,50,1,50,1.120073000,0.0000
192.67.151.80,<->,97.4.116.46,1,50,0,0,1,50,1.119671000,0.0000
109.1.61.116,<->,104.236.121.73,1,149,0,0,1,149,1.119540000,0.0000
105.140.227.39,<->,20.144.155.44,0,0,1,52,1,52,1.119475000,0.0000
198.158.197.83,<->,20.242.248.70,0,0,1,50,1,50,1.119377000,0.0000
133.178.226.160,<->,111.151.142.233,1,100,0,0,1,100,1.119320000,0.0000
131.232.94.211,<->,8.43.180.200,0,0,1,84,1,84,1.119194000,0.0000
148.155.129.25,<->,33.233.141.39,0,0,1,170,1,170,1.119020000,0.0000
111.88.145.220,<->,92.27.219.248,0,0,1,149,1,149,1.119011000,0.0000
97.126.18.233,<->,15.15.125.115,1,72,0,0,1,72,1.118751000,0.0000
123.97.227.2,<->,39.150.3.182,0,0,1,50,1,50,1.118603000,0.0000
132.249.70.213,<->,53.152.211.127,1,116,0,0,1,116,1.118407000,0.0000
101.238.103.211,<->,8.55.221.148,1,81,0,0,1,81,1.118342000,0.0000
215.158.239.227,<->,53.245.246.122,1,1133,0,0,1,1133,1.118232000,0.0000
144.75.218.246,<->,140.142.187.19,1,77,0,0,1,77,1.117685000,0.0000
92.27.219.137,<->,64.214.57.96,1,50,0,0,1,50,1.117551000,0.0000
38.21.156.204,<->,20.232.228.86,0,0,1,82,1,82,1.117374000,0.0000
192.229.216.117,<->,50.49.177.26,1,50,0,0,1,50,1.117193000,0.0000
247.136.146.16,<->,126.198.69.217,1,321,0,0,1,321,1.116966000,0.0000
193.41.49.218,<->,39.251.105.37,0,0,1,64,1,64,1.116761000,0.0000
244.50.136.175,<->,20.200.199.82,0,0,1,50,1,50,1.116739000,0.0000
17.115.168.36,<->,8.220.190.86,0,0,1,50,1,50,1.116700000,0.0000
123.97.227.2,<->,39.62.126.143,0,0,1,50,1,50,1.116699000,0.0000
92.181.50.174,<->,74.249.120.178,1,130,0,0,1,130,1.116515000,0.0000
249.101.95.241,<->,54.53.120.141,1,125,0,0,1,125,1.116448000,0.0000
194.223.51.91,<->,99.75.183.47,0,0,1,97,1,97,1.116214000,0.0000
39.219.71.174,<->,0.48.111.58,1,50,0,0,1,50,1.116157000,0.0000
195.12.225.0,<->,136.25.188.209,0,0,1,50,1,50,1.116093000,0.0000
193.41.49.218,<->,39.255.166.97,0,0,1,64,1,64,1.115988000,0.0000
130.94.125.208,<->,80.41.21.72,0,0,1,136,1,136,1.115973000,0.0000
75.62.16.8,<->,39.146.216.159,0,0,1,50,1,50,1.115775000,0.0000
137.68.217.95,<->,20.209.165.28,0,0,1,64,1,64,1.115671000,0.0000
210.229.227.19,<->,145.208.183.77,0,0,1,68,1,68,1.115595000,0.0000
207.173.234.158,<->,136.25.188.252,0,0,1,64,1,64,1.115523000,0.0000
111.20.172.70,<->,111.20.168.215,0,0,1,288,1,288,1.115435000,0.0000
159.87.104.238,<->,100.211.114.205,1,87,0,0,1,87,1.115183000,0.0000
194.206.210.251,<->,8.182.138.83,0,0,1,50,1,50,1.114993000,0.0000
131.103.234.27,<->,39.45.58.107,0,0,1,75,1,75,1.114800000,0.0000
139.163.26.146,<->,117.45.143.145,1,111,0,0,1,111,1.114687000,0.0000
196.30.163.164,<->,97.126.110.127,0,0,1,64,1,64,1.114562000,0.0000
111.150.207.202,<->,8.176.8.102,0,0,1,100,1,100,1.114532000,0.0000
132.250.195.48,<->,98.200.185.43,0,0,1,50,1,50,1.114415000,0.0000
241.193.172.231,<->,20.225.239.69,0,0,1,50,1,50,1.114361000,0.0000
21.15.226.126,<->,20.193.31.101,0,0,1,82,1,82,1.114296000,0.0000
123.97.227.2,<->,39.219.53.37,0,0,1,50,1,50,1.114266000,0.0000
193.41.49.218,<->,39.251.134.239,0,0,1,64,1,64,1.114256000,0.0000
235.224.44.109,<->,20.166.103.132,0,0,1,64,1,64,1.113546000,0.0000
86.198.146.24,<->,0.195.210.24,0,0,1,56,1,56,1.113537000,0.0000
144.75.218.242,<->,138.127.225.234,1,254,0,0,1,254,1.113517000,0.0000
143.134.14.45,<->,136.25.188.176,0,0,1,50,1,50,1.113499000,0.0000
138.127.230.89,<->,132.168.197.226,0,0,1,156,1,156,1.113382000,0.0000
100.95.46.59,<->,27.13.70.75,1,52,0,0,1,52,1.113104000,0.0000
193.41.49.218,<->,39.251.185.149,0,0,1,64,1,64,1.112995000,0.0000
153.184.132.240,<->,34.202.57.49,0,0,1,52,1,52,1.112487000,0.0000
229.61.97.86,<->,192.67.182.48,0,0,1,61,1,61,1.112476000,0.0000
145.242.126.150,<->,144.43.70.2,1,76,0,0,1,76,1.112434000,0.0000
109.222.213.25,<->,54.48.24.50,1,75,0,0,1,75,1.112344000,0.0000
39.3.89.10,<->,38.69.22.246,1,75,0,0,1,75,1.112281000,0.0000
192.64.237.108,<->,64.214.57.47,1,50,0,0,1,50,1.112124000,0.0000
204.89.88.29,<->,100.92.2.240,0,0,1,56,1,56,1.112108000,0.0000
21.15.226.126,<->,20.193.31.104,0,0,1,82,1,82,1.112015000,0.0000
136.25.188.173,<->,108.167.152.92,1,50,0,0,1,50,1.111773000,0.0000
215.158.103.219,<->,193.41.156.225,1,810,0,0,1,810,1.111076000,0.0000
38.21.156.204,<->,20.232.228.83,0,0,1,82,1,82,1.110984000,0.0000
111.236.84.195,<->,8.52.243.47,0,0,1,50,1,50,1.110904000,0.0000
93.104.212.227,<->,39.246.79.123,0,0,1,64,1,64,1.110859000,0.0000
204.200.34.203,<->,136.25.188.54,0,0,1,56,1,56,1.110709000,0.0000
200.174.196.50,<->,54.58.129.4,1,64,0,0,1,64,1.110615000,0.0000
142.235.117.143,<->,80.40.1.240,0,0,1,62,1,62,1.110482000,0.0000
8.55.211.213,<->,6.74.195.54,0,0,1,184,1,184,1.110447000,0.0000
243.49.81.45,<->,39.32.47.225,0,0,1,50,1,50,1.110025000,0.0000
215.158.238.133,<->,8.240.116.229,1,56,0,0,1,56,1.109960000,0.0000
140.17.122.242,<->,66.0.155.46,0,0,1,50,1,50,1.109874000,0.0000
193.36.4.222,<->,98.236.223.167,0,0,1,50,1,50,1.109815000,0.0000
136.181.46.177,<->,50.238.245.100,1,87,0,0,1,87,1.109258000,0.0000
92.27.219.182,<->,42.78.196.77,1,170,0,0,1,170,1.109021000,0.0000
22.45.111.16,<->,8.228.217.98,0,0,1,124,1,124,1.108958000,0.0000
193.41.49.218,<->,39.254.198.1,0,0,1,64,1,64,1.108866000,0.0000
111.147.191.165,<->,54.69.101.127,1,125,0,0,1,125,1.108735000,0.0000
98.23.96.82,<->,89.183.104.175,0,0,1,56,1,56,1.108582000,0.0000
69.196.64.236,<->,39.147.215.61,0,0,1,64,1,64,1.108370000,0.0000
197.107.3.206,<->,136.25.188.238,0,0,1,132,1,132,1.108257000,0.0000
159.69.187.17,<->,144.76.43.246,1,80,0,0,1,80,1.107971000,0.0000
97.126.26.40,<->,53.75.247.118,1,122,0,0,1,122,1.107675000,0.0000
215.158.239.117,<->,68.231.30.247,1,68,0,0,1,68,1.107625000,0.0000
193.41.49.218,<->,39.254.88.234,0,0,1,64,1,64,1.107594000,0.0000
125.223.91.142,<->,20.33.115.244,0,0,1,64,1,64,1.107445000,0.0000
132.250.195.48,<->,80.40.72.159,0,0,1,50,1,50,1.107390000,0.0000
215.158.239.125,<->,128.156.85.146,1,56,0,0,1,56,1.107364000,0.0000
21.15.226.126,<->,20.193.31.111,0,0,1,82,1,82,1.107300000,0.0000
205.80.207.253,<->,8.52.182.119,0,0,1,56,1,56,1.107192000,0.0000
99.175.109.166,<->,66.195.127.30,1,369,0,0,1,369,1.106534000,0.0000
92.27.131.126,<->,89.183.104.175,0,0,1,56,1,56,1.106509000,0.0000
111.150.207.51,<->,8.252.223.67,0,0,1,100,1,100,1.106354000,0.0000
207.78.112.114,<->,50.224.76.234,0,0,1,50,1,50,1.106320000,0.0000
111.20.172.70,<->,33.233.141.20,0,0,1,108,1,108,1.106256000,0.0000
92.27.131.123,<->,89.183.104.175,0,0,1,56,1,56,1.106174000,0.0000
101.70.107.178,<->,54.52.48.70,1,88,0,0,1,88,1.106144000,0.0000
193.41.49.218,<->,39.253.135.15,0,0,1,64,1,64,1.106098000,0.0000
140.17.122.242,<->,108.38.76.199,0,0,1,50,1,50,1.105760000,0.0000
129.236.114.39,<->,101.224.89.186,0,0,1,56,1,56,1.105753000,0.0000
195.106.192.106,<->,39.26.61.138,0,0,1,70,1,70,1.105711000,0.0000
193.41.49.218,<->,39.252.183.34,0,0,1,64,1,64,1.105679000,0.0000
111.147.185.215,<->,53.161.125.14,1,104,0,0,1,104,1.105338000,0.0000
53.214.235.47,<->,48.55.115.26,0,0,1,50,1,50,1.105063000,0.0000
196.30.163.164,<->,97.126.110.125,0,0,1,64,1,64,1.104841000,0.0000
193.41.49.218,<->,39.252.216.220,0,0,1,64,1,64,1.104803000,0.0000
193.41.49.218,<->,39.254.71.37,0,0,1,64,1,64,1.104798000,0.0000
144.75.218.246,<->,126.231.170.67,1,226,0,0,1,226,1.104743000,0.0000
201.216.164.96,<->,39.2.106.213,0,0,1,64,1,64,1.104702000,0.0000
246.254.97.149,<->,131.1.232.48,1,93,0,0,1,93,1.104638000,0.0000
193.41.49.218,<->,39.253.151.14,0,0,1,64,1,64,1.104369000,0.0000
199.39.90.161,<->,136.25.188.198,0,0,1,56,1,56,1.104020000,0.0000
126.4.72.154,<->,39.31.107.23,0,0,1,52,1,52,1.103901000,0.0000
109.222.254.87,<->,61.45.126.114,1,79,0,0,1,79,1.103463000,0.0000
199.83.103.210,<->,136.25.188.222,0,0,1,50,1,50,1.103414000,0.0000
117.54.27.6,<->,92.27.219.224,0,0,1,263,1,263,1.102765000,0.0000
100.216.212.67,<->,8.52.168.247,0,0,1,50,1,50,1.102599000,0.0000
215.158.239.70,<->,199.106.190.76,1,50,0,0,1,50,1.102477000,0.0000
119.109.148.56,<->,20.103.210.61,0,0,1,50,1,50,1.102414000,0.0000
118.37.169.38,<->,89.183.104.233,0,0,1,147,1,147,1.102148000,0.0000
123.97.227.2,<->,20.222.101.110,0,0,1,149,1,149,1.101854000,0.0000
76.72.228.64,<->,39.164.106.155,0,0,1,64,1,64,1.101756000,0.0000
215.158.238.76,<->,115.232.101.107,1,83,0,0,1,83,1.101397000,0.0000
121.20.26.123,<->,100.94.146.138,0,0,1,97,1,97,1.101163000,0.0000
155.133.39.148,<->,78.123.16.211,0,0,1,325,1,325,1.101074000,0.0000
111.20.172.70,<->,101.224.89.251,0,0,1,101,1,101,1.101034000,0.0000
74.132.92.246,<->,39.18.156.102,0,0,1,64,1,64,1.100721000,0.0000
194.118.48.211,<->,39.220.32.201,0,0,1,60,1,60,1.100614000,0.0000
118.209.10.43,<->,92.27.219.155,0,0,1,56,1,56,1.100420000,0.0000
215.158.140.168,<->,111.151.107.247,1,146,0,0,1,146,1.099848000,0.0000
215.158.61.222,<->,8.252.222.246,0,0,1,360,1,360,1.099836000,0.0000
204.60.255.84,<->,136.25.188.177,0,0,1,50,1,50,1.099587000,0.0000
82.98.73.98,<->,39.9.207.14,0,0,1,52,1,52,1.099586000,0.0000
99.74.27.138,<->,80.56.91.248,1,56,0,0,1,56,1.099562000,0.0000
215.158.239.97,<->,143.94.214.230,1,64,0,0,1,64,1.099252000,0.0000
221.102.123.23,<->,56.112.225.140,1,50,0,0,1,50,1.099083000,0.0000
210.220.219.182,<->,53.239.167.143,1,56,0,0,1,56,1.098804000,0.0000
149.164.189.49,<->,144.75.218.235,0,0,1,87,1,87,1.098022000,0.0000
198.69.238.131,<->,20.90.202.240,0,0,1,64,1,64,1.097924000,0.0000
129.224.112.252,<->,27.127.251.59,1,77,0,0,1,77,1.097758000,0.0000
198.69.238.131,<->,20.90.202.242,0,0,1,64,1,64,1.097688000,0.0000
142.246.25.203,<->,97.126.31.80,0,0,1,1002,1,1002,1.097603000,0.0000
192.67.161.171,<->,114.132.77.146,1,52,0,0,1,52,1.097570000,0.0000
53.203.244.13,<->,33.233.141.69,0,0,1,148,1,148,1.097547000,0.0000
136.50.41.34,<->,98.129.80.186,0,0,1,56,1,56,1.097494000,0.0000
220.28.109.99,<->,144.69.82.139,0,0,1,79,1,79,1.097477000,0.0000
92.27.219.159,<->,4.240.232.244,1,317,0,0,1,317,1.097281000,0.0000
215.158.239.40,<->,130.101.149.241,1,50,0,0,1,50,1.096843000,0.0000
215.158.61.36,<->,80.56.78.92,0,0,1,96,1,96,1.096829000,0.0000
56.8.55.61,<->,8.182.226.78,0,0,1,50,1,50,1.096780000,0.0000
230.84.118.155,<->,39.128.56.254,0,0,1,56,1,56,1.096603000,0.0000
246.253.248.211,<->,54.61.179.29,1,87,0,0,1,87,1.096595000,0.0000
149.250.234.17,<->,92.27.219.218,0,0,1,659,1,659,1.096511000,0.0000
129.224.112.252,<->,92.162.219.101,1,103,0,0,1,103,1.096467000,0.0000
201.192.219.121,<->,129.224.112.252,0,0,1,75,1,75,1.096140000,0.0000
141.86.1.26,<->,133.183.157.3,0,0,1,56,1,56,1.095998000,0.0000
111.20.172.70,<->,101.224.89.171,0,0,1,292,1,292,1.095885000,0.0000
111.151.239.56,<->,92.27.219.43,0,0,1,56,1,56,1.095850000,0.0000
98.67.136.236,<->,18.215.146.2,1,76,0,0,1,76,1.095425000,0.0000
133.229.224.241,<->,80.56.78.128,0,0,1,95,1,95,1.094850000,0.0000
247.136.139.38,<->,100.124.212.251,1,50,0,0,1,50,1.094848000,0.0000
114.187.169.221,<->,111.147.75.10,0,0,1,64,1,64,1.094803000,0.0000
241.193.172.231,<->,20.118.146.11,0,0,1,50,1,50,1.094680000,0.0000
20.131.58.248,<->,0.48.111.58,1,50,0,0,1,50,1.094652000,0.0000
210.221.107.50,<->,111.151.238.97,1,64,0,0,1,64,1.094142000,0.0000
206.77.122.132,<->,109.1.24.90,0,0,1,64,1,64,1.093658000,0.0000
119.90.250.200,<->,20.40.172.22,0,0,1,50,1,50,1.093459000,0.0000
115.167.81.247,<->,33.233.141.56,0,0,1,113,1,113,1.093436000,0.0000
120.246.24.8,<->,20.234.133.151,0,0,1,94,1,94,1.093371000,0.0000
80.47.33.8,<->,29.211.214.82,0,0,1,86,1,86,1.093163000,0.0000
80.40.48.131,<->,66.127.213.175,1,50,0,0,1,50,1.093063000,0.0000
202.124.171.233,<->,108.39.208.231,0,0,1,138,1,138,1.092732000,0.0000
215.158.103.219,<->,158.189.38.26,1,88,0,0,1,88,1.092440000,0.0000
237.79.102.33,<->,20.214.82.212,0,0,1,52,1,52,1.092285000,0.0000
132.249.70.213,<->,53.80.105.51,1,116,0,0,1,116,1.092122000,0.0000
100.92.60.72,<->,33.250.81.54,1,56,0,0,1,56,1.092119000,0.0000
241.193.172.231,<->,20.184.231.2,0,0,1,50,1,50,1.092114000,0.0000
224.148.240.36,<->,148.241.23.5,1,64,0,0,1,64,1.092064000,0.0000
193.41.49.218,<->,39.246.216.251,0,0,1,64,1,64,1.091706000,0.0000
76.72.228.64,<->,39.164.106.156,0,0,1,64,1,64,1.091659000,0.0000
39.28.31.198,<->,0.243.15.84,1,52,0,0,1,52,1.091316000,0.0000
247.136.132.126,<->,99.46.152.189,1,60,0,0,1,60,1.091186000,0.0000
193.41.49.218,<->,39.244.231.71,0,0,1,64,1,64,1.091083000,0.0000
106.22.92.216,<->,8.52.182.30,0,0,1,50,1,50,1.090918000,0.0000
245.158.165.61,<->,39.42.250.197,0,0,1,64,1,64,1.090723000,0.0000
216.144.221.98,<->,215.158.140.205,0,0,1,50,1,50,1.090532000,0.0000
193.41.49.218,<->,39.245.216.180,0,0,1,64,1,64,1.090524000,0.0000
158.169.138.222,<->,101.224.172.135,0,0,1,57,1,57,1.090288000,0.0000
193.41.49.218,<->,39.244.247.90,0,0,1,64,1,64,1.089597000,0.0000
141.111.200.214,<->,80.38.16.211,0,0,1,50,1,50,1.089449000,0.0000
220.55.169.121,<->,33.121.161.19,1,50,0,0,1,50,1.089427000,0.0000
159.69.187.22,<->,144.108.64.183,1,68,0,0,1,68,1.089425000,0.0000
126.245.187.49,<->,80.40.45.77,0,0,1,52,1,52,1.089035000,0.0000
80.42.148.46,<->,22.63.36.212,1,56,0,0,1,56,1.088970000,0.0000
215.158.239.93,<->,196.90.153.95,1,50,0,0,1,50,1.088823000,0.0000
121.214.196.4,<->,39.18.56.245,0,0,1,104,1,104,1.088560000,0.0000
202.33.54.235,<->,136.25.188.178,0,0,1,50,1,50,1.088260000,0.0000
247.136.137.133,<->,205.239.143.251,1,50,0,0,1,50,1.088224000,0.0000
239.66.89.165,<->,102.51.131.202,0,0,1,50,1,50,1.088224000,0.0000
192.64.229.128,<->,134.248.13.131,1,50,0,0,1,50,1.088045000,0.0000
144.75.218.246,<->,138.127.231.151,1,253,0,0,1,253,1.088000000,0.0000
207.74.210.18,<->,99.73.183.72,0,0,1,96,1,96,1.087806000,0.0000
199.82.246.91,<->,136.25.188.176,0,0,1,50,1,50,1.087702000,0.0000
215.158.103.206,<->,113.188.130.131,1,122,0,0,1,122,1.087406000,0.0000
122.143.161.166,<->,80.41.58.237,0,0,1,319,1,319,1.087256000,0.0000
138.127.224.225,<->,101.224.89.252,0,0,1,231,1,231,1.087222000,0.0000
194.207.16.202,<->,39.171.77.160,0,0,1,108,1,108,1.086976000,0.0000
118.38.71.77,<->,20.233.54.222,0,0,1,66,1,66,1.086859000,0.0000
53.231.85.230,<->,33.233.141.39,0,0,1,50,1,50,1.086370000,0.0000
105.201.127.130,<->,20.204.46.15,0,0,1,100,1,100,1.086130000,0.0000
139.36.120.120,<->,136.25.189.193,0,0,1,56,1,56,1.086059000,0.0000
138.127.224.102,<->,33.233.141.93,0,0,1,240,1,240,1.086034000,0.0000
53.160.193.35,<->,48.53.186.56,0,0,1,50,1,50,1.085806000,0.0000
220.55.106.26,<->,122.253.153.253,1,50,0,0,1,50,1.085702000,0.0000
136.47.51.209,<->,8.176.34.109,0,0,1,50,1,50,1.085694000,0.0000
92.27.209.249,<->,53.157.11.198,1,209,0,0,1,209,1.085325000,0.0000
132.128.61.15,<->,6.75.159.119,0,0,1,56,1,56,1.085099000,0.0000
215.158.239.48,<->,199.20.6.42,1,50,0,0,1,50,1.085074000,0.0000
195.71.146.117,<->,136.25.188.252,0,0,1,56,1,56,1.084818000,0.0000
148.155.129.25,<->,33.233.141.1,0,0,1,170,1,170,1.084607000,0.0000
92.173.80.90,<->,92.27.27.99,0,0,1,52,1,52,1.084485000,0.0000
138.127.231.205,<->,132.168.197.226,0,0,1,157,1,157,1.084433000,0.0000
221.150.250.237,<->,97.22.32.10,1,178,0,0,1,178,1.084424000,0.0000
126.253.26.254,<->,20.10.173.34,0,0,1,64,1,64,1.084367000,0.0000
111.20.172.70,<->,101.224.89.168,0,0,1,299,1,299,1.084209000,0.0000
105.229.251.213,<->,92.27.219.146,0,0,1,349,1,349,1.083958000,0.0000
195.68.204.193,<->,136.25.188.242,0,0,1,113,1,113,1.083940000,0.0000
159.137.139.218,<->,136.25.189.2,0,0,1,1064,1,1064,1.083730000,0.0000
139.163.26.146,<->,6.72.204.164,1,111,0,0,1,111,1.083630000,0.0000
20.13.108.243,<->,0.200.50.50,1,60,0,0,1,60,1.083585000,0.0000
21.15.226.126,<->,20.193.56.77,0,0,1,82,1,82,1.083445000,0.0000
215.201.233.125,<->,8.182.251.218,0,0,1,50,1,50,1.083379000,0.0000
192.64.238.102,<->,120.250.240.90,1,349,0,0,1,349,1.083194000,0.0000
248.225.27.2,<->,100.161.107.233,1,56,0,0,1,56,1.083116000,0.0000
193.41.49.218,<->,39.241.167.226,0,0,1,64,1,64,1.083092000,0.0000
111.20.172.70,<->,33.233.141.4,0,0,1,288,1,288,1.082784000,0.0000
193.41.49.218,<->,39.243.24.84,0,0,1,64,1,64,1.082749000,0.0000
127.234.11.180,<->,39.18.204.0,0,0,1,95,1,95,1.082740000,0.0000
246.253.253.170,<->,139.33.174.24,1,50,0,0,1,50,1.082497000,0.0000
144.64.137.5,<->,115.151.119.225,1,74,0,0,1,74,1.082469000,0.0000
193.41.49.218,<->,39.241.103.191,0,0,1,64,1,64,1.082464000,0.0000
136.25.188.225,<->,41.154.253.186,1,56,0,0,1,56,1.082292000,0.0000
95.246.109.14,<->,8.252.222.38,0,0,1,64,1,64,1.082083000,0.0000
246.253.253.215,<->,142.246.133.215,1,50,0,0,1,50,1.081913000,0.0000
205.39.1.120,<->,0.195.210.15,0,0,1,158,1,158,1.081821000,0.0000
243.134.123.69,<->,8.182.251.218,0,0,1,50,1,50,1.081589000,0.0000
143.251.225.129,<->,39.225.208.109,0,0,1,99,1,99,1.081572000,0.0000
53.70.202.108,<->,48.54.43.188,0,0,1,68,1,68,1.081435000,0.0000
199.71.115.136,<->,136.25.188.225,0,0,1,50,1,50,1.081274000,0.0000
116.238.228.1,<->,39.157.36.128,0,0,1,92,1,92,1.081102000,0.0000
148.155.129.25,<->,101.224.89.248,0,0,1,170,1,170,1.080895000,0.0000
204.34.97.122,<->,159.137.212.194,0,0,1,64,1,64,1.080875000,0.0000
132.107.75.195,<->,111.147.202.234,0,0,1,360,1,360,1.080862000,0.0000
247.136.188.124,<->,93.172.27.17,1,52,0,0,1,52,1.080751000,0.0000
76.178.34.101,<->,50.224.76.235,0,0,1,50,1,50,1.080730000,0.0000
215.158.239.58,<->,199.20.28.52,1,56,0,0,1,56,1.080141000,0.0000
111.20.172.70,<->,33.233.141.231,0,0,1,107,1,107,1.080026000,0.0000
136.181.46.82,<->,111.25.58.238,1,56,0,0,1,56,1.080011000,0.0000
141.125.172.113,<->,39.131.11.141,0,0,1,80,1,80,1.079965000,0.0000
155.196.27.92,<->,39.4.3.119,0,0,1,50,1,50,1.079945000,0.0000
198.158.197.83,<->,20.25.146.51,0,0,1,50,1,50,1.079773000,0.0000
193.41.49.218,<->,39.241.152.123,0,0,1,64,1,64,1.079756000,0.0000
159.133.57.200,<->,56.0.39.108,1,92,0,0,1,92,1.079163000,0.0000
21.137.251.81,<->,20.201.26.204,0,0,1,100,1,100,1.078731000,0.0000
101.224.89.157,<->,57.176.113.202,1,101,0,0,1,101,1.078453000,0.0000
197.8.203.28,<->,92.27.219.198,0,0,1,52,1,52,1.078274000,0.0000
89.216.125.82,<->,22.1.79.14,1,60,0,0,1,60,1.078221000,0.0000
230.59.65.170,<->,192.64.114.92,0,0,1,130,1,130,1.078187000,0.0000
148.155.131.220,<->,101.224.89.178,0,0,1,172,1,172,1.077950000,0.0000
97.126.113.45,<->,82.195.35.44,1,50,0,0,1,50,1.077876000,0.0000
138.127.225.156,<->,33.233.141.64,0,0,1,281,1,281,1.077822000,0.0000
131.233.225.105,<->,39.248.134.206,0,0,1,82,1,82,1.077426000,0.0000
132.250.195.39,<->,33.233.141.71,0,0,1,183,1,183,1.077400000,0.0000
193.41.49.218,<->,39.242.215.252,0,0,1,64,1,64,1.077150000,0.0000
89.183.104.145,<->,64.214.57.45,1,50,0,0,1,50,1.076899000,0.0000
159.15.122.2,<->,8.52.222.220,0,0,1,50,1,50,1.076400000,0.0000
144.75.218.242,<->,138.127.225.175,1,366,0,0,1,366,1.075968000,0.0000
144.75.218.242,<->,141.37.226.95,1,86,0,0,1,86,1.075959000,0.0000
80.38.49.145,<->,48.115.121.162,1,82,0,0,1,82,1.075603000,0.0000
142.248.250.197,<->,20.106.72.13,0,0,1,74,1,74,1.074801000,0.0000
97.126.17.147,<->,54.92.217.131,1,118,0,0,1,118,1.074783000,0.0000
203.9.50.3,<->,39.14.98.247,0,0,1,56,1,56,1.074556000,0.0000
198.69.238.131,<->,20.90.202.229,0,0,1,64,1,64,1.074484000,0.0000
215.158.103.219,<->,136.103.157.90,1,123,0,0,1,123,1.074467000,0.0000
99.73.184.38,<->,27.12.26.177,1,168,0,0,1,168,1.074302000,0.0000
221.98.90.26,<->,130.78.11.165,1,84,0,0,1,84,1.073543000,0.0000
158.169.138.222,<->,101.224.191.186,0,0,1,57,1,57,1.073523000,0.0000
104.217.126.247,<->,80.40.56.197,0,0,1,90,1,90,1.073479000,0.0000
193.41.49.218,<->,39.231.231.144,0,0,1,64,1,64,1.073340000,0.0000
8.220.189.234,<->,6.101.12.73,1,50,0,0,1,50,1.073146000,0.0000
8.250.158.7,<->,6.15.117.9,1,84,0,0,1,84,1.072965000,0.0000
193.41.49.218,<->,39.242.183.129,0,0,1,64,1,64,1.072600000,0.0000
210.229.230.19,<->,110.44.9.116,1,50,0,0,1,50,1.072580000,0.0000
220.81.47.237,<->,140.17.122.242,1,50,0,0,1,50,1.072510000,0.0000
192.67.182.48,<->,120.235.249.7,1,56,0,0,1,56,1.072163000,0.0000
210.209.251.211,<->,111.146.138.251,0,0,1,50,1,50,1.072120000,0.0000
127.203.163.101,<->,92.27.219.190,0,0,1,399,1,399,1.072030000,0.0000
199.83.104.20,<->,136.25.188.54,0,0,1,64,1,64,1.071966000,0.0000
144.95.106.180,<->,8.182.136.217,0,0,1,50,1,50,1.071926000,0.0000
193.41.49.218,<->,39.242.199.228,0,0,1,64,1,64,1.071910000,0.0000
92.27.117.27,<->,89.183.107.0,0,0,1,109,1,109,1.071851000,0.0000
121.229.1.215,<->,39.55.118.14,0,0,1,56,1,56,1.071576000,0.0000
138.127.225.122,<->,33.233.141.112,0,0,1,73,1,73,1.071552000,0.0000
91.231.194.48,<->,8.222.6.254,1,50,0,0,1,50,1.071337000,0.0000
21.15.226.126,<->,20.193.56.48,0,0,1,82,1,82,1.071182000,0.0000
136.25.188.42,<->,111.151.107.247,1,149,0,0,1,149,1.070962000,0.0000
144.54.192.229,<->,137.74.92.84,0,0,1,52,1,52,1.070886000,0.0000
204.60.60.134,<->,136.25.188.236,0,0,1,56,1,56,1.070717000,0.0000
145.16.34.73,<->,84.22.52.96,1,56,0,0,1,56,1.070672000,0.0000
20.192.240.91,<->,0.195.209.34,1,128,0,0,1,128,1.070632000,0.0000
111.151.107.247,<->,8.176.8.180,0,0,1,111,1,111,1.070572000,0.0000
207.233.32.246,<->,99.73.7.63,0,0,1,56,1,56,1.070338000,0.0000
137.68.217.95,<->,20.209.165.30,0,0,1,64,1,64,1.070337000,0.0000
193.41.49.218,<->,39.230.248.6,0,0,1,64,1,64,1.070332000,0.0000
80.40.45.109,<->,0.41.236.81,1,100,0,0,1,100,1.070267000,0.0000
193.41.49.218,<->,39.231.248.84,0,0,1,64,1,64,1.070266000,0.0000
86.194.117.156,<->,0.195.210.24,0,0,1,56,1,56,1.070247000,0.0000
144.75.218.235,<->,95.244.145.61,1,185,0,0,1,185,1.069904000,0.0000
215.158.140.240,<->,89.70.190.184,1,704,0,0,1,704,1.069605000,0.0000
195.71.54.116,<->,136.25.188.255,0,0,1,95,1,95,1.069520000,0.0000
215.158.238.205,<->,193.29.116.75,1,1002,0,0,1,1002,1.069432000,0.0000
111.146.144.47,<->,54.39.180.173,1,125,0,0,1,125,1.069088000,0.0000
241.193.172.231,<->,20.125.73.168,0,0,1,50,1,50,1.069052000,0.0000
195.123.85.191,<->,99.75.101.204,0,0,1,56,1,56,1.068771000,0.0000
111.146.168.112,<->,53.213.158.211,1,56,0,0,1,56,1.068570000,0.0000
196.1.181.164,<->,39.163.208.57,0,0,1,100,1,100,1.068567000,0.0000
202.33.112.96,<->,136.25.188.220,0,0,1,50,1,50,1.068462000,0.0000
204.50.214.41,<->,39.53.61.242,0,0,1,60,1,60,1.068361000,0.0000
144.122.240.201,<->,144.108.64.184,1,65,0,0,1,65,1.068099000,0.0000
192.67.129.30,<->,141.57.73.220,1,56,0,0,1,56,1.067912000,0.0000
127.225.116.243,<->,100.94.125.243,0,0,1,50,1,50,1.067910000,0.0000
145.252.127.155,<->,132.43.156.54,1,802,0,0,1,802,1.067749000,0.0000
193.41.49.218,<->,39.228.8.89,0,0,1,64,1,64,1.067540000,0.0000
215.158.238.143,<->,113.23.104.215,1,1133,0,0,1,1133,1.067308000,0.0000
138.127.225.120,<->,33.233.141.94,0,0,1,254,1,254,1.067274000,0.0000
108.161.81.157,<->,8.52.222.117,0,0,1,50,1,50,1.067096000,0.0000
129.236.100.69,<->,129.224.112.252,0,0,1,74,1,74,1.067096000,0.0000
215.158.61.145,<->,8.176.8.97,0,0,1,56,1,56,1.066644000,0.0000
210.220.219.115,<->,159.112.9.198,1,50,0,0,1,50,1.066589000,0.0000
132.168.196.95,<->,40.114.68.23,1,71,0,0,1,71,1.066403000,0.0000
195.41.134.179,<->,136.25.188.252,0,0,1,50,1,50,1.066299000,0.0000
207.101.151.225,<->,39.141.13.87,0,0,1,68,1,68,1.066207000,0.0000
197.113.99.186,<->,136.25.188.179,0,0,1,56,1,56,1.066094000,0.0000
121.159.234.165,<->,92.27.219.42,0,0,1,52,1,52,1.065644000,0.0000
207.79.116.9,<->,50.223.3.228,0,0,1,56,1,56,1.065518000,0.0000
241.75.69.206,<->,8.20.87.216,0,0,1,50,1,50,1.065425000,0.0000
192.65.58.210,<->,105.170.238.230,1,130,0,0,1,130,1.065094000,0.0000
215.158.239.85,<->,199.20.30.103,1,68,0,0,1,68,1.064892000,0.0000
93.181.154.9,<->,89.183.104.245,0,0,1,56,1,56,1.064890000,0.0000
215.158.239.70,<->,142.167.45.13,1,68,0,0,1,68,1.064485000,0.0000
138.31.199.102,<->,53.162.162.35,1,74,0,0,1,74,1.064381000,0.0000
194.216.190.29,<->,39.193.225.237,0,0,1,64,1,64,1.064270000,0.0000
193.41.49.218,<->,39.230.135.196,0,0,1,64,1,64,1.064260000,0.0000
17.58.99.34,<->,8.53.4.255,0,0,1,50,1,50,1.063884000,0.0000
33.223.161.138,<->,20.241.95.5,0,0,1,52,1,52,1.063808000,0.0000
215.158.239.48,<->,196.109.44.152,1,50,0,0,1,50,1.063506000,0.0000
193.41.49.218,<->,39.228.199.213,0,0,1,64,1,64,1.063480000,0.0000
215.158.140.8,<->,215.158.61.183,1,56,0,0,1,56,1.063465000,0.0000
121.210.191.90,<->,111.147.129.36,0,0,1,56,1,56,1.063331000,0.0000
137.21.23.51,<->,111.150.207.51,1,100,0,0,1,100,1.062930000,0.0000
127.184.46.90,<->,20.147.57.232,0,0,1,64,1,64,1.062336000,0.0000
192.64.221.208,<->,38.64.18.154,1,50,0,0,1,50,1.062135000,0.0000
204.153.192.206,<->,8.182.227.180,0,0,1,50,1,50,1.062081000,0.0000
33.223.161.138,<->,20.186.249.181,0,0,1,52,1,52,1.061339000,0.0000
193.41.49.218,<->,39.229.88.88,0,0,1,64,1,64,1.061221000,0.0000
122.126.214.15,<->,80.41.8.174,0,0,1,51,1,51,1.061221000,0.0000
74.132.92.246,<->,39.18.156.68,0,0,1,64,1,64,1.060890000,0.0000
213.21.35.42,<->,8.220.189.182,0,0,1,56,1,56,1.060808000,0.0000
129.236.100.86,<->,129.224.112.252,0,0,1,78,1,78,1.060469000,0.0000
143.193.11.15,<->,20.11.13.82,0,0,1,64,1,64,1.060437000,0.0000
143.251.116.55,<->,39.14.29.45,0,0,1,87,1,87,1.060079000,0.0000
195.40.218.124,<->,136.25.188.177,0,0,1,64,1,64,1.059898000,0.0000
148.155.129.25,<->,111.20.168.215,0,0,1,165,1,165,1.059385000,0.0000
215.158.239.4,<->,142.227.121.175,1,50,0,0,1,50,1.059321000,0.0000
244.50.129.64,<->,20.109.181.134,0,0,1,50,1,50,1.059313000,0.0000
29.211.214.82,<->,8.240.120.169,1,85,0,0,1,85,1.058848000,0.0000
93.181.153.52,<->,92.27.27.171,0,0,1,50,1,50,1.058682000,0.0000
207.84.40.148,<->,39.230.176.240,0,0,1,108,1,108,1.058595000,0.0000
132.18.67.31,<->,99.74.164.54,0,0,1,350,1,350,1.058441000,0.0000
121.85.12.78,<->,20.26.136.19,0,0,1,52,1,52,1.058075000,0.0000
74.132.92.246,<->,39.18.156.70,0,0,1,64,1,64,1.058027000,0.0000
193.41.49.218,<->,39.224.232.12,0,0,1,64,1,64,1.058000000,0.0000
215.158.239.57,<->,196.106.79.216,1,56,0,0,1,56,1.057978000,0.0000
123.97.227.2,<->,20.126.127.116,0,0,1,50,1,50,1.057895000,0.0000
140.30.2.28,<->,66.11.238.118,0,0,1,50,1,50,1.057777000,0.0000
218.4.180.238,<->,144.76.46.38,1,128,0,0,1,128,1.057766000,0.0000
74.132.92.246,<->,39.18.156.66,0,0,1,64,1,64,1.057415000,0.0000
111.151.139.187,<->,8.252.221.175,0,0,1,56,1,56,1.057005000,0.0000
210.236.205.21,<->,82.237.234.25,0,0,1,50,1,50,1.056745000,0.0000
109.222.200.93,<->,105.233.101.111,1,56,0,0,1,56,1.056745000,0.0000
101.124.237.218,<->,79.132.31.6,1,79,0,0,1,79,1.056674000,0.0000
132.18.67.31,<->,111.146.138.251,0,0,1,56,1,56,1.056482000,0.0000
248.239.175.62,<->,133.73.194.24,1,50,0,0,1,50,1.056452000,0.0000
246.254.97.149,<->,8.33.227.9,1,93,0,0,1,93,1.055938000,0.0000
53.221.175.155,<->,8.30.107.52,0,0,1,125,1,125,1.055905000,0.0000
139.47.193.207,<->,33.233.141.1,0,0,1,50,1,50,1.055661000,0.0000
195.71.79.16,<->,136.25.188.252,0,0,1,50,1,50,1.055571000,0.0000
138.127.224.139,<->,109.222.238.0,0,0,1,218,1,218,1.055482000,0.0000
192.228.30.193,<->,8.176.8.237,0,0,1,111,1,111,1.055389000,0.0000
139.163.71.18,<->,48.130.166.133,1,68,0,0,1,68,1.055017000,0.0000
8.252.221.220,<->,4.121.220.22,1,56,0,0,1,56,1.054903000,0.0000
220.40.166.218,<->,215.158.238.140,0,0,1,1213,1,1213,1.054803000,0.0000
124.137.212.241,<->,39.15.250.7,0,0,1,70,1,70,1.054625000,0.0000
105.140.23.31,<->,20.121.178.173,0,0,1,64,1,64,1.054575000,0.0000
136.129.94.30,<->,6.145.167.203,1,64,0,0,1,64,1.054567000,0.0000
129.224.112.252,<->,92.160.14.119,1,77,0,0,1,77,1.053861000,0.0000
130.34.187.113,<->,20.32.37.250,0,0,1,80,1,80,1.053428000,0.0000
126.210.84.155,<->,39.57.19.30,0,0,1,80,1,80,1.053188000,0.0000
159.50.145.49,<->,89.183.104.177,0,0,1,101,1,101,1.052901000,0.0000
194.201.104.102,<->,39.12.12.151,0,0,1,108,1,108,1.052777000,0.0000
149.148.18.67,<->,39.9.181.205,0,0,1,97,1,97,1.052735000,0.0000
215.171.79.195,<->,8.52.169.61,0,0,1,50,1,50,1.052689000,0.0000
221.54.10.148,<->,92.27.194.147,0,0,1,56,1,56,1.052455000,0.0000
100.190.29.184,<->,8.220.178.203,0,0,1,50,1,50,1.052304000,0.0000
192.173.107.178,<->,8.220.205.216,0,0,1,50,1,50,1.052271000,0.0000
215.158.239.50,<->,199.20.31.34,1,422,0,0,1,422,1.052202000,0.0000
122.252.94.13,<->,20.242.117.110,0,0,1,75,1,75,1.051947000,0.0000
138.127.225.223,<->,111.20.168.215,0,0,1,236,1,236,1.051806000,0.0000
195.15.148.9,<->,136.25.188.220,0,0,1,282,1,282,1.051773000,0.0000
215.158.239.56,<->,207.188.16.1,1,68,0,0,1,68,1.051770000,0.0000
98.158.89.211,<->,8.182.227.214,0,0,1,50,1,50,1.051426000,0.0000
215.158.239.182,<->,111.151.142.230,1,56,0,0,1,56,1.051000000,0.0000
193.41.49.218,<->,39.226.98.18,0,0,1,64,1,64,1.050703000,0.0000
193.41.49.218,<->,39.226.169.22,0,0,1,64,1,64,1.050671000,0.0000
102.50.154.84,<->,27.15.128.177,1,321,0,0,1,321,1.050472000,0.0000
111.146.254.148,<->,53.245.233.186,1,109,0,0,1,109,1.050351000,0.0000
148.91.248.5,<->,111.147.92.83,0,0,1,52,1,52,1.050321000,0.0000
144.75.218.233,<->,138.127.225.49,1,365,0,0,1,365,1.050244000,0.0000
210.234.195.241,<->,105.166.47.20,1,56,0,0,1,56,1.050241000,0.0000
139.163.68.55,<->,0.97.212.203,1,51,0,0,1,51,1.050083000,0.0000
192.67.149.50,<->,40.204.139.122,1,56,0,0,1,56,1.050071000,0.0000
73.70.158.157,<->,20.42.38.105,0,0,1,130,1,130,1.050047000,0.0000
124.17.249.27,<->,20.17.136.36,0,0,1,74,1,74,1.049878000,0.0000
193.41.49.218,<->,39.226.186.213,0,0,1,64,1,64,1.049870000,0.0000
119.184.224.85,<->,109.1.24.200,0,0,1,851,1,851,1.049760000,0.0000
111.151.109.27,<->,97.126.31.86,0,0,1,56,1,56,1.049713000,0.0000
230.126.147.103,<->,8.238.93.151,0,0,1,133,1,133,1.049697000,0.0000
201.194.125.234,<->,20.94.75.215,0,0,1,52,1,52,1.049555000,0.0000
132.51.6.188,<->,121.232.73.135,1,71,0,0,1,71,1.049465000,0.0000
92.27.131.127,<->,89.183.104.250,0,0,1,56,1,56,1.049395000,0.0000
111.151.107.247,<->,8.176.8.237,0,0,1,126,1,126,1.049151000,0.0000
97.243.199.12,<->,89.183.104.250,0,0,1,56,1,56,1.049100000,0.0000
192.67.157.242,<->,103.164.150.13,1,50,0,0,1,50,1.049095000,0.0000
17.254.111.210,<->,8.220.200.124,0,0,1,56,1,56,1.048845000,0.0000
202.163.175.199,<->,20.194.30.147,0,0,1,133,1,133,1.048559000,0.0000
217.11.189.9,<->,109.222.237.159,0,0,1,446,1,446,1.048409000,0.0000
132.51.185.8,<->,8.52.222.23,0,0,1,50,1,50,1.048172000,0.0000
132.249.70.213,<->,111.27.182.215,1,117,0,0,1,117,1.048170000,0.0000
193.41.49.218,<->,39.226.17.255,0,0,1,64,1,64,1.047868000,0.0000
215.158.239.57,<->,199.20.31.255,1,157,0,0,1,157,1.047721000,0.0000
113.20.94.199,<->,8.220.202.13,0,0,1,704,1,704,1.047619000,0.0000
249.127.47.127,<->,80.42.162.159,0,0,1,138,1,138,1.047595000,0.0000
246.253.253.208,<->,196.22.168.122,1,125,0,0,1,125,1.047447000,0.0000
75.62.16.8,<->,20.229.40.171,0,0,1,50,1,50,1.047169000,0.0000
215.158.238.105,<->,120.154.177.197,1,1133,0,0,1,1133,1.047106000,0.0000
109.222.222.44,<->,91.41.25.109,1,56,0,0,1,56,1.046950000,0.0000
89.183.104.177,<->,33.57.79.42,1,80,0,0,1,80,1.046864000,0.0000
118.12.226.110,<->,50.224.76.248,0,0,1,56,1,56,1.046563000,0.0000
97.126.106.44,<->,54.52.248.208,1,50,0,0,1,50,1.046510000,0.0000
145.3.142.7,<->,39.237.228.176,0,0,1,64,1,64,1.046505000,0.0000
75.62.16.8,<->,20.200.134.62,0,0,1,50,1,50,1.046475000,0.0000
203.48.230.0,<->,20.202.16.220,0,0,1,74,1,74,1.046453000,0.0000
205.121.92.104,<->,39.145.180.229,0,0,1,70,1,70,1.046226000,0.0000
123.187.46.131,<->,92.27.219.207,0,0,1,52,1,52,1.045909000,0.0000
247.136.192.204,<->,134.53.44.185,1,52,0,0,1,52,1.045906000,0.0000
89.183.104.251,<->,75.95.64.72,1,52,0,0,1,52,1.045630000,0.0000
57.81.32.230,<->,20.253.71.162,0,0,1,108,1,108,1.045612000,0.0000
109.2.71.61,<->,92.27.5.85,1,53,0,0,1,53,1.045419000,0.0000
195.39.175.170,<->,20.249.182.142,0,0,1,64,1,64,1.045391000,0.0000
192.67.179.212,<->,118.71.90.92,1,331,0,0,1,331,1.045282000,0.0000
122.2.181.221,<->,89.183.104.146,0,0,1,351,1,351,1.045192000,0.0000
115.111.170.178,<->,80.42.186.32,0,0,1,113,1,113,1.045025000,0.0000
138.127.225.129,<->,33.233.141.116,0,0,1,241,1,241,1.044953000,0.0000
101.70.121.243,<->,91.42.97.85,1,50,0,0,1,50,1.044852000,0.0000
109.50.26.221,<->,20.71.150.181,0,0,1,52,1,52,1.044679000,0.0000
97.168.93.219,<->,30.214.60.217,1,68,0,0,1,68,1.044430000,0.0000
194.158.215.119,<->,89.183.104.249,0,0,1,148,1,148,1.044030000,0.0000
74.132.92.246,<->,39.18.156.72,0,0,1,64,1,64,1.044001000,0.0000
138.127.224.152,<->,101.224.89.244,0,0,1,295,1,295,1.043725000,0.0000
153.138.22.47,<->,8.250.150.192,0,0,1,704,1,704,1.043664000,0.0000
158.23.79.221,<->,80.40.24.193,0,0,1,317,1,317,1.043543000,0.0000
136.181.43.173,<->,8.197.219.110,1,64,0,0,1,64,1.043526000,0.0000
17.255.107.2,<->,8.220.176.253,0,0,1,56,1,56,1.043226000,0.0000
193.41.49.218,<->,39.233.6.198,0,0,1,64,1,64,1.042883000,0.0000
207.93.162.88,<->,8.182.227.206,0,0,1,50,1,50,1.042864000,0.0000
194.234.176.154,<->,136.25.188.209,0,0,1,50,1,50,1.042701000,0.0000
215.158.239.92,<->,195.14.19.63,1,56,0,0,1,56,1.042573000,0.0000
249.101.199.233,<->,53.160.96.20,1,56,0,0,1,56,1.042483000,0.0000
201.218.172.234,<->,109.222.250.107,0,0,1,119,1,119,1.042275000,0.0000
97.126.24.188,<->,53.198.157.71,1,362,0,0,1,362,1.042245000,0.0000
109.50.26.221,<->,20.71.150.182,0,0,1,52,1,52,1.042143000,0.0000
138.127.225.253,<->,101.224.89.244,0,0,1,251,1,251,1.042118000,0.0000
134.160.225.14,<->,89.183.104.159,0,0,1,263,1,263,1.041666000,0.0000
143.238.206.42,<->,39.235.17.232,0,0,1,104,1,104,1.041502000,0.0000
241.193.172.231,<->,20.9.153.215,0,0,1,50,1,50,1.041489000,0.0000
64.253.117.102,<->,39.32.193.211,0,0,1,52,1,52,1.041282000,0.0000
144.93.68.154,<->,20.252.151.89,0,0,1,52,1,52,1.041278000,0.0000
192.64.211.100,<->,14.30.152.105,1,56,0,0,1,56,1.041064000,0.0000
195.88.194.210,<->,8.182.241.177,0,0,1,50,1,50,1.040928000,0.0000
89.183.104.236,<->,29.163.12.197,1,52,0,0,1,52,1.040927000,0.0000
193.41.49.218,<->,39.233.194.78,0,0,1,64,1,64,1.040869000,0.0000
138.127.225.156,<->,101.224.89.251,0,0,1,338,1,338,1.040798000,0.0000
202.218.18.146,<->,34.138.142.207,0,0,1,100,1,100,1.040608000,0.0000
109.1.16.196,<->,27.188.163.162,1,445,0,0,1,445,1.040561000,0.0000
215.158.239.48,<->,207.57.52.88,1,894,0,0,1,894,1.040508000,0.0000
92.27.219.50,<->,38.94.100.115,1,52,0,0,1,52,1.040333000,0.0000
241.193.172.231,<->,20.41.194.253,0,0,1,50,1,50,1.040226000,0.0000
129.224.112.252,<->,27.127.251.103,1,78,0,0,1,78,1.040095000,0.0000
96.56.184.229,<->,8.53.4.24,0,0,1,50,1,50,1.039853000,0.0000
92.27.219.49,<->,33.215.68.189,1,52,0,0,1,52,1.039698000,0.0000
220.55.138.47,<->,8.182.232.138,0,0,1,56,1,56,1.039409000,0.0000
192.67.178.214,<->,132.211.48.21,1,59,0,0,1,59,1.039396000,0.0000
118.228.81.59,<->,102.231.178.198,0,0,1,141,1,141,1.039285000,0.0000
159.123.6.141,<->,144.81.142.50,1,154,0,0,1,154,1.038920000,0.0000
21.15.226.126,<->,20.193.56.216,0,0,1,82,1,82,1.038874000,0.0000
138.127.224.45,<->,33.233.141.228,0,0,1,242,1,242,1.038737000,0.0000
220.72.69.21,<->,8.220.191.154,0,0,1,50,1,50,1.038725000,0.0000
130.139.247.36,<->,50.224.76.234,0,0,1,50,1,50,1.038393000,0.0000
138.127.224.44,<->,33.233.141.27,0,0,1,234,1,234,1.037931000,0.0000
138.127.224.138,<->,111.20.168.58,0,0,1,267,1,267,1.037811000,0.0000
75.62.16.8,<->,39.248.169.181,0,0,1,50,1,50,1.037697000,0.0000
139.163.161.166,<->,133.178.226.255,0,0,1,90,1,90,1.037587000,0.0000
89.204.72.95,<->,8.182.232.70,0,0,1,68,1,68,1.037484000,0.0000
67.236.49.213,<->,34.217.112.95,0,0,1,52,1,52,1.037425000,0.0000
144.75.218.237,<->,53.146.81.135,1,227,0,0,1,227,1.037063000,0.0000
108.137.47.66,<->,89.183.104.175,0,0,1,52,1,52,1.036798000,0.0000
192.67.134.61,<->,121.31.106.231,1,50,0,0,1,50,1.036773000,0.0000
141.174.241.48,<->,80.38.16.208,0,0,1,50,1,50,1.036597000,0.0000
247.136.216.62,<->,117.87.250.107,1,52,0,0,1,52,1.036467000,0.0000
54.38.201.255,<->,48.53.253.228,0,0,1,56,1,56,1.036432000,0.0000
204.232.153.60,<->,89.183.104.233,0,0,1,127,1,127,1.036114000,0.0000
53.161.180.137,<->,48.53.209.206,0,0,1,50,1,50,1.036081000,0.0000
207.162.188.221,<->,8.182.226.78,0,0,1,50,1,50,1.035989000,0.0000
129.92.117.26,<->,54.52.191.63,1,93,0,0,1,93,1.035919000,0.0000
195.42.222.39,<->,136.25.188.241,0,0,1,50,1,50,1.035908000,0.0000
54.38.197.120,<->,48.54.248.0,0,0,1,56,1,56,1.035843000,0.0000
198.228.83.211,<->,102.51.75.158,0,0,1,135,1,135,1.035676000,0.0000
104.154.171.250,<->,20.117.32.68,0,0,1,70,1,70,1.035581000,0.0000
192.67.149.167,<->,128.154.153.92,1,50,0,0,1,50,1.035349000,0.0000
193.41.49.218,<->,39.239.159.148,0,0,1,64,1,64,1.035246000,0.0000
193.41.49.218,<->,39.239.140.143,0,0,1,64,1,64,1.035128000,0.0000
126.232.82.91,<->,20.240.146.235,0,0,1,96,1,96,1.035070000,0.0000
146.172.25.90,<->,16.138.108.247,0,0,1,52,1,52,1.034940000,0.0000
192.64.247.91,<->,122.114.203.218,1,52,0,0,1,52,1.034911000,0.0000
215.158.28.164,<->,113.5.159.26,1,84,0,0,1,84,1.034890000,0.0000
247.136.187.194,<->,8.179.135.180,1,56,0,0,1,56,1.034808000,0.0000
135.86.49.19,<->,50.224.76.234,0,0,1,50,1,50,1.034757000,0.0000
21.15.226.126,<->,20.193.56.196,0,0,1,82,1,82,1.034481000,0.0000
119.214.19.142,<->,39.211.101.151,0,0,1,94,1,94,1.034445000,0.0000
201.216.164.96,<->,39.2.106.215,0,0,1,64,1,64,1.034357000,0.0000
125.42.81.5,<->,80.41.29.200,0,0,1,684,1,684,1.034037000,0.0000
231.142.227.229,<->,215.158.239.58,0,0,1,56,1,56,1.033945000,0.0000
138.127.224.44,<->,33.233.141.20,0,0,1,234,1,234,1.033945000,0.0000
198.240.209.3,<->,20.135.245.176,0,0,1,52,1,52,1.033168000,0.0000
159.69.187.24,<->,144.108.64.184,1,67,0,0,1,67,1.033008000,0.0000
138.127.224.44,<->,101.224.89.150,0,0,1,234,1,234,1.033005000,0.0000
198.145.77.70,<->,111.146.137.31,0,0,1,136,1,136,1.032939000,0.0000
129.236.100.43,<->,129.224.112.252,0,0,1,73,1,73,1.032768000,0.0000
109.222.253.202,<->,48.175.134.33,1,74,0,0,1,74,1.032111000,0.0000
138.127.224.44,<->,111.20.168.21,0,0,1,234,1,234,1.032050000,0.0000
127.233.67.123,<->,109.222.251.204,0,0,1,69,1,69,1.031925000,0.0000
109.222.218.172,<->,53.191.2.60,1,50,0,0,1,50,1.031916000,0.0000
97.68.226.205,<->,91.100.190.227,1,70,0,0,1,70,1.031349000,0.0000
98.67.154.211,<->,53.148.102.101,1,97,0,0,1,97,1.031322000,0.0000
41.156.17.148,<->,14.71.95.171,0,0,1,1298,1,1298,1.031164000,0.0000
218.4.181.154,<->,58.43.188.11,1,50,0,0,1,50,1.031162000,0.0000
120.185.42.214,<->,20.167.236.99,0,0,1,64,1,64,1.030857000,0.0000
142.206.38.99,<->,136.25.188.253,0,0,1,56,1,56,1.030780000,0.0000
118.228.5.130,<->,99.75.168.154,0,0,1,325,1,325,1.030639000,0.0000
239.66.125.236,<->,92.27.27.178,0,0,1,50,1,50,1.030583000,0.0000
118.154.0.217,<->,98.128.251.58,0,0,1,99,1,99,1.030155000,0.0000
92.27.219.228,<->,38.177.141.214,1,52,0,0,1,52,1.029715000,0.0000
111.151.142.216,<->,6.73.247.6,0,0,1,56,1,56,1.029663000,0.0000
111.151.142.210,<->,8.252.223.245,0,0,1,56,1,56,1.029662000,0.0000
138.127.224.254,<->,101.224.89.171,0,0,1,255,1,255,1.029464000,0.0000
98.23.96.95,<->,92.27.219.211,0,0,1,56,1,56,1.029420000,0.0000
99.171.95.136,<->,8.182.226.23,0,0,1,50,1,50,1.029314000,0.0000
207.84.192.23,<->,20.33.63.69,0,0,1,100,1,100,1.028881000,0.0000
249.101.193.243,<->,53.167.139.245,1,50,0,0,1,50,1.028793000,0.0000
128.198.71.156,<->,92.27.27.179,0,0,1,367,1,367,1.028614000,0.0000
198.102.18.25,<->,99.72.107.172,0,0,1,136,1,136,1.028519000,0.0000
215.158.239.58,<->,195.49.200.57,1,50,0,0,1,50,1.028318000,0.0000
138.127.225.156,<->,33.233.141.107,0,0,1,284,1,284,1.028042000,0.0000
111.20.62.109,<->,101.70.127.229,0,0,1,50,1,50,1.027858000,0.0000
8.182.244.237,<->,6.26.249.110,1,56,0,0,1,56,1.027814000,0.0000
219.248.26.25,<->,80.38.37.157,0,0,1,52,1,52,1.027754000,0.0000
100.208.47.97,<->,78.54.198.249,1,99,0,0,1,99,1.027526000,0.0000
247.136.186.213,<->,193.51.144.80,1,56,0,0,1,56,1.027390000,0.0000
21.15.226.126,<->,20.193.57.252,0,0,1,82,1,82,1.027312000,0.0000
224.93.21.37,<->,8.52.181.232,0,0,1,50,1,50,1.027273000,0.0000
92.27.194.147,<->,0.37.173.190,1,56,0,0,1,56,1.027231000,0.0000
95.169.31.12,<->,39.135.82.233,0,0,1,56,1,56,1.027161000,0.0000
120.185.42.214,<->,20.167.236.93,0,0,1,64,1,64,1.026960000,0.0000
215.158.239.48,<->,196.90.192.245,1,1054,0,0,1,1054,1.026804000,0.0000
253.107.164.6,<->,139.163.1.154,0,0,1,50,1,50,1.026766000,0.0000
207.172.134.178,<->,136.25.188.208,0,0,1,64,1,64,1.025918000,0.0000
215.158.239.56,<->,207.115.219.24,1,50,0,0,1,50,1.025860000,0.0000
215.158.239.234,<->,53.157.243.122,1,333,0,0,1,333,1.025291000,0.0000
120.83.106.49,<->,92.27.219.146,0,0,1,324,1,324,1.025237000,0.0000
195.54.153.245,<->,136.25.188.252,0,0,1,56,1,56,1.025109000,0.0000
198.72.184.220,<->,39.130.111.23,0,0,1,94,1,94,1.025070000,0.0000
80.40.232.211,<->,33.219.133.71,1,135,0,0,1,135,1.025059000,0.0000
193.21.28.204,<->,92.27.219.155,0,0,1,64,1,64,1.025008000,0.0000
115.166.122.250,<->,101.224.89.168,0,0,1,56,1,56,1.024735000,0.0000
109.103.233.173,<->,92.27.219.171,0,0,1,78,1,78,1.024720000,0.0000
97.243.199.12,<->,89.183.104.251,0,0,1,56,1,56,1.024607000,0.0000
98.23.121.218,<->,89.183.104.251,0,0,1,56,1,56,1.024524000,0.0000
106.8.173.4,<->,89.183.104.173,0,0,1,385,1,385,1.024228000,0.0000
102.231.179.98,<->,8.55.195.124,1,50,0,0,1,50,1.024181000,0.0000
159.137.140.219,<->,100.230.7.102,1,50,0,0,1,50,1.024112000,0.0000
215.158.103.219,<->,138.127.224.55,1,250,0,0,1,250,1.023800000,0.0000
146.224.248.193,<->,20.158.8.215,0,0,1,78,1,78,1.023759000,0.0000
124.48.195.122,<->,20.23.40.135,0,0,1,64,1,64,1.023594000,0.0000
159.140.232.210,<->,98.129.76.230,0,0,1,50,1,50,1.023311000,0.0000
236.227.128.37,<->,144.75.218.242,0,0,1,116,1,116,1.023271000,0.0000
223.141.220.222,<->,39.162.123.181,0,0,1,64,1,64,1.023175000,0.0000
89.183.104.146,<->,33.58.232.13,1,351,0,0,1,351,1.022788000,0.0000
59.49.73.35,<->,56.121.55.136,0,0,1,64,1,64,1.022699000,0.0000
215.158.61.195,<->,8.176.8.180,0,0,1,1386,1,1386,1.022421000,0.0000
98.67.154.55,<->,53.210.236.172,1,76,0,0,1,76,1.022214000,0.0000
221.196.123.233,<->,111.147.240.74,0,0,1,97,1,97,1.022174000,0.0000
195.43.46.154,<->,50.224.76.234,0,0,1,50,1,50,1.022157000,0.0000
98.246.18.142,<->,20.17.34.100,0,0,1,50,1,50,1.021877000,0.0000
89.183.104.157,<->,6.85.11.53,1,101,0,0,1,101,1.021783000,0.0000
192.67.128.244,<->,119.87.77.32,1,149,0,0,1,149,1.021660000,0.0000
138.127.224.63,<->,33.233.141.101,0,0,1,283,1,283,1.021532000,0.0000
149.200.188.84,<->,80.41.16.28,0,0,1,52,1,52,1.021378000,0.0000
126.237.211.201,<->,92.27.219.207,0,0,1,263,1,263,1.021166000,0.0000
127.59.203.242,<->,20.21.136.84,0,0,1,64,1,64,1.021127000,0.0000
241.193.172.231,<->,20.9.98.107,0,0,1,50,1,50,1.020879000,0.0000
216.223.54.63,<->,133.32.39.39,0,0,1,50,1,50,1.020831000,0.0000
215.158.239.17,<->,18.202.17.98,1,50,0,0,1,50,1.020664000,0.0000
213.38.142.227,<->,91.231.135.160,1,101,0,0,1,101,1.019855000,0.0000
111.151.139.187,<->,67.174.33.180,0,0,1,64,1,64,1.019667000,0.0000
213.154.101.1,<->,137.81.65.54,0,0,1,81,1,81,1.019508000,0.0000
206.195.34.188,<->,8.52.169.61,0,0,1,56,1,56,1.019466000,0.0000
198.37.0.165,<->,89.183.104.159,0,0,1,263,1,263,1.019141000,0.0000
92.27.27.156,<->,42.27.224.194,1,94,0,0,1,94,1.019038000,0.0000
117.158.226.123,<->,99.75.102.6,0,0,1,80,1,80,1.018955000,0.0000
138.127.225.87,<->,33.233.141.117,0,0,1,251,1,251,1.018802000,0.0000
201.220.11.61,<->,39.236.78.253,0,0,1,56,1,56,1.018763000,0.0000
129.254.99.105,<->,129.224.112.252,0,0,1,68,1,68,1.018224000,0.0000
133.32.39.31,<->,111.151.106.200,1,100,0,0,1,100,1.017952000,0.0000
125.201.133.17,<->,89.183.104.184,0,0,1,1394,1,1394,1.017901000,0.0000
114.243.231.163,<->,92.27.219.133,0,0,1,135,1,135,1.017857000,0.0000
80.28.241.105,<->,8.52.182.119,0,0,1,50,1,50,1.017520000,0.0000
215.158.239.49,<->,196.93.231.115,1,56,0,0,1,56,1.017475000,0.0000
138.127.225.202,<->,33.233.141.101,0,0,1,277,1,277,1.017467000,0.0000
215.201.233.125,<->,8.182.253.73,0,0,1,50,1,50,1.017258000,0.0000
194.41.83.206,<->,22.59.23.224,0,0,1,56,1,56,1.017241000,0.0000
107.28.208.38,<->,92.27.219.228,0,0,1,80,1,80,1.017241000,0.0000
21.15.226.126,<->,20.193.57.234,0,0,1,82,1,82,1.017236000,0.0000
102.83.209.113,<->,8.45.162.111,1,87,0,0,1,87,1.017192000,0.0000
144.75.218.233,<->,138.127.224.188,1,365,0,0,1,365,1.016734000,0.0000
244.50.135.57,<->,39.249.234.246,0,0,1,50,1,50,1.016719000,0.0000
91.250.143.162,<->,39.7.205.202,0,0,1,50,1,50,1.016417000,0.0000
144.75.218.242,<->,138.127.224.83,1,253,0,0,1,253,1.016375000,0.0000
120.185.42.214,<->,20.167.236.86,0,0,1,64,1,64,1.016181000,0.0000
120.185.42.214,<->,20.167.236.89,0,0,1,64,1,64,1.016111000,0.0000
242.22.195.239,<->,144.75.218.237,0,0,1,146,1,146,1.015958000,0.0000
17.28.87.58,<->,8.220.179.115,0,0,1,50,1,50,1.015950000,0.0000
192.171.13.80,<->,8.252.222.104,0,0,1,155,1,155,1.015590000,0.0000
133.178.227.173,<->,111.150.207.137,1,56,0,0,1,56,1.014978000,0.0000
215.158.238.41,<->,111.151.142.164,1,100,0,0,1,100,1.014900000,0.0000
215.158.239.77,<->,199.20.31.79,1,64,0,0,1,64,1.014898000,0.0000
193.82.221.142,<->,20.76.165.102,0,0,1,64,1,64,1.014858000,0.0000
192.171.13.190,<->,8.176.8.192,0,0,1,149,1,149,1.014645000,0.0000
73.94.136.231,<->,20.169.213.25,0,0,1,52,1,52,1.014450000,0.0000
109.1.57.207,<->,8.159.21.186,1,50,0,0,1,50,1.014389000,0.0000
145.11.5.168,<->,136.25.188.105,0,0,1,175,1,175,1.014072000,0.0000
159.69.187.44,<->,144.108.64.184,1,73,0,0,1,73,1.014055000,0.0000
243.117.125.27,<->,129.224.112.252,0,0,1,71,1,71,1.013990000,0.0000
144.75.218.246,<->,129.227.132.30,1,76,0,0,1,76,1.013181000,0.0000
88.221.159.45,<->,50.224.76.248,0,0,1,64,1,64,1.013045000,0.0000
192.171.13.190,<->,8.176.8.202,0,0,1,170,1,170,1.012993000,0.0000
215.158.239.86,<->,196.109.61.99,1,68,0,0,1,68,1.012939000,0.0000
212.164.131.150,<->,103.146.186.197,1,50,0,0,1,50,1.012820000,0.0000
207.7.215.98,<->,39.59.18.154,0,0,1,106,1,106,1.012796000,0.0000
75.62.16.8,<->,39.147.129.90,0,0,1,50,1,50,1.012705000,0.0000
208.238.47.197,<->,39.31.154.16,0,0,1,60,1,60,1.012664000,0.0000
133.85.23.86,<->,92.27.219.128,0,0,1,84,1,84,1.012442000,0.0000
207.236.166.161,<->,136.25.188.176,0,0,1,50,1,50,1.012319000,0.0000
198.69.238.131,<->,20.90.202.237,0,0,1,64,1,64,1.012102000,0.0000
220.20.200.9,<->,144.83.60.153,1,50,0,0,1,50,1.012089000,0.0000
74.132.92.246,<->,39.18.156.78,0,0,1,64,1,64,1.012007000,0.0000
98.101.82.178,<->,8.182.136.167,0,0,1,50,1,50,1.011930000,0.0000
243.49.82.0,<->,99.72.165.242,0,0,1,56,1,56,1.011891000,0.0000
215.158.140.87,<->,210.209.188.204,1,56,0,0,1,56,1.011759000,0.0000
251.24.86.17,<->,221.102.113.220,0,0,1,50,1,50,1.011738000,0.0000
152.12.176.111,<->,92.27.219.132,0,0,1,213,1,213,1.011685000,0.0000
129.224.112.252,<->,109.212.125.157,1,77,0,0,1,77,1.011638000,0.0000
148.161.234.68,<->,139.193.141.132,0,0,1,50,1,50,1.011638000,0.0000
92.27.219.189,<->,42.59.238.156,1,80,0,0,1,80,1.011318000,0.0000
97.243.206.148,<->,92.27.219.181,0,0,1,56,1,56,1.011041000,0.0000
192.171.13.33,<->,8.252.222.56,0,0,1,95,1,95,1.010839000,0.0000
113.127.207.90,<->,97.126.113.33,0,0,1,64,1,64,1.010499000,0.0000
252.98.135.151,<->,54.46.135.141,1,64,0,0,1,64,1.010387000,0.0000
118.12.181.150,<->,39.51.227.114,0,0,1,52,1,52,1.010290000,0.0000
92.27.199.112,<->,39.2.50.93,0,0,1,52,1,52,1.010200000,0.0000
133.178.226.2,<->,111.151.142.152,1,56,0,0,1,56,1.010105000,0.0000
75.62.16.8,<->,20.117.134.2,0,0,1,50,1,50,1.010062000,0.0000
99.162.77.146,<->,53.167.48.249,1,56,0,0,1,56,1.009898000,0.0000
147.61.24.130,<->,129.224.112.252,0,0,1,74,1,74,1.009782000,0.0000
138.126.42.228,<->,50.224.76.235,0,0,1,50,1,50,1.009733000,0.0000
215.158.239.86,<->,199.20.31.30,1,56,0,0,1,56,1.009714000,0.0000
136.25.188.72,<->,111.15.98.226,1,1064,0,0,1,1064,1.009122000,0.0000
229.69.149.153,<->,192.67.154.211,0,0,1,52,1,52,1.008791000,0.0000
17.243.35.226,<->,8.220.202.4,0,0,1,50,1,50,1.008688000,0.0000
133.178.226.233,<->,111.151.142.130,1,56,0,0,1,56,1.008687000,0.0000
92.27.219.180,<->,78.53.131.215,1,69,0,0,1,69,1.008458000,0.0000
215.158.103.206,<->,8.220.7.31,1,150,0,0,1,150,1.008446000,0.0000
111.151.107.247,<->,8.176.8.192,0,0,1,155,1,155,1.008296000,0.0000
200.174.223.60,<->,53.148.128.124,1,56,0,0,1,56,1.008186000,0.0000
132.107.75.195,<->,97.126.26.71,0,0,1,377,1,377,1.007969000,0.0000
133.178.227.202,<->,111.151.139.187,1,64,0,0,1,64,1.007762000,0.0000
220.55.101.99,<->,140.142.131.2,1,76,0,0,1,76,1.007566000,0.0000
220.20.200.59,<->,144.83.60.153,1,627,0,0,1,627,1.007401000,0.0000
76.130.139.161,<->,34.192.17.207,0,0,1,52,1,52,1.007392000,0.0000
99.162.77.146,<->,54.58.32.144,1,56,0,0,1,56,1.007119000,0.0000
215.158.239.49,<->,199.20.31.30,1,240,0,0,1,240,1.006685000,0.0000
194.234.176.154,<->,136.25.188.46,0,0,1,50,1,50,1.006667000,0.0000
139.253.132.92,<->,20.163.70.221,0,0,1,135,1,135,1.006645000,0.0000
192.67.134.112,<->,63.3.46.143,1,65,0,0,1,65,1.006499000,0.0000
119.53.11.236,<->,20.66.246.29,0,0,1,100,1,100,1.006434000,0.0000
247.136.245.5,<->,87.52.69.178,1,99,0,0,1,99,1.006150000,0.0000
195.54.14.51,<->,136.25.188.163,0,0,1,56,1,56,1.006139000,0.0000
132.128.61.174,<->,6.122.200.0,0,0,1,141,1,141,1.005985000,0.0000
241.193.172.231,<->,20.152.197.139,0,0,1,50,1,50,1.005888000,0.0000
144.75.218.237,<->,138.127.231.255,1,268,0,0,1,268,1.005501000,0.0000
138.127.224.104,<->,111.20.168.1,0,0,1,286,1,286,1.005396000,0.0000
148.155.129.25,<->,33.233.141.77,0,0,1,173,1,173,1.005232000,0.0000
109.222.217.163,<->,82.193.202.117,1,56,0,0,1,56,1.005056000,0.0000
104.137.158.250,<->,20.163.221.5,0,0,1,64,1,64,1.004947000,0.0000
119.226.24.74,<->,109.1.60.13,0,0,1,80,1,80,1.004880000,0.0000
206.249.247.241,<->,20.92.0.228,0,0,1,64,1,64,1.004554000,0.0000
195.70.207.64,<->,136.25.188.254,0,0,1,68,1,68,1.004517000,0.0000
210.150.233.86,<->,50.224.76.131,0,0,1,79,1,79,1.004331000,0.0000
217.9.223.242,<->,89.183.104.170,0,0,1,50,1,50,1.003917000,0.0000
139.241.75.26,<->,29.211.214.82,0,0,1,90,1,90,1.003847000,0.0000
102.232.51.191,<->,97.126.3.177,0,0,1,67,1,67,1.003618000,0.0000
57.107.97.185,<->,22.59.13.208,0,0,1,64,1,64,1.003507000,0.0000
109.127.101.16,<->,56.121.34.176,0,0,1,56,1,56,1.003383000,0.0000
255.133.229.164,<->,39.197.190.13,0,0,1,100,1,100,1.003327000,0.0000
89.183.104.246,<->,51.249.86.31,1,321,0,0,1,321,1.002487000,0.0000
215.158.238.2,<->,144.253.55.170,1,56,0,0,1,56,1.002485000,0.0000
138.127.224.44,<->,33.233.141.66,0,0,1,234,1,234,1.002447000,0.0000
221.102.143.189,<->,192.64.212.208,0,0,1,92,1,92,1.001799000,0.0000
115.211.211.9,<->,89.183.104.236,0,0,1,147,1,147,1.001782000,0.0000
117.27.6.236,<->,8.252.222.204,0,0,1,50,1,50,1.001738000,0.0000
146.226.226.226,<->,144.75.218.241,0,0,1,85,1,85,1.001582000,0.0000
247.136.137.133,<->,122.100.180.56,1,62,0,0,1,62,1.001528000,0.0000
244.50.135.57,<->,39.236.231.33,0,0,1,50,1,50,1.001354000,0.0000
131.144.248.194,<->,129.224.112.252,0,0,1,75,1,75,1.000952000,0.0000
101.70.121.187,<->,54.55.110.117,1,50,0,0,1,50,1.000737000,0.0000
192.64.217.166,<->,93.162.13.46,1,52,0,0,1,52,1.000709000,0.0000
159.109.242.247,<->,8.182.123.121,1,68,0,0,1,68,1.000591000,0.0000
230.84.236.133,<->,92.170.252.76,0,0,1,133,1,133,1.000165000,0.0000
143.193.11.15,<->,20.11.13.171,0,0,1,64,1,64,1.000157000,0.0000
199.127.205.2,<->,8.20.87.88,0,0,1,50,1,50,1.000146000,0.0000
207.117.110.113,<->,39.22.184.229,0,0,1,52,1,52,0.999785000,0.0000
84.20.80.213,<->,0.195.210.24,0,0,1,50,1,50,0.999456000,0.0000
120.155.84.97,<->,33.233.141.227,0,0,1,103,1,103,0.999417000,0.0000
144.75.218.237,<->,129.35.251.34,1,147,0,0,1,147,0.998722000,0.0000
215.158.239.99,<->,199.78.115.150,1,68,0,0,1,68,0.998519000,0.0000
210.56.117.49,<->,8.52.188.226,0,0,1,52,1,52,0.998412000,0.0000
215.158.239.58,<->,199.20.30.174,1,56,0,0,1,56,0.998398000,0.0000
144.87.235.187,<->,138.127.224.104,1,293,0,0,1,293,0.998111000,0.0000
192.64.217.166,<->,134.227.83.143,1,52,0,0,1,52,0.998083000,0.0000
132.249.70.46,<->,110.37.156.14,1,52,0,0,1,52,0.998023000,0.0000
124.118.9.237,<->,101.122.134.124,0,0,1,50,1,50,0.997916000,0.0000
111.147.93.197,<->,92.27.108.192,1,56,0,0,1,56,0.997736000,0.0000
112.151.63.215,<->,92.27.219.54,0,0,1,52,1,52,0.997711000,0.0000
139.114.178.207,<->,100.92.48.99,0,0,1,77,1,77,0.997676000,0.0000
94.24.111.59,<->,92.27.219.250,0,0,1,62,1,62,0.997401000,0.0000
119.39.61.63,<->,8.52.224.215,0,0,1,1002,1,1002,0.997018000,0.0000
74.17.219.15,<->,66.11.15.168,0,0,1,243,1,243,0.996853000,0.0000
98.67.150.212,<->,74.71.225.42,1,60,0,0,1,60,0.996690000,0.0000
134.92.64.170,<->,20.163.197.248,0,0,1,75,1,75,0.996675000,0.0000
204.145.55.177,<->,39.168.197.90,0,0,1,106,1,106,0.996597000,0.0000
142.254.97.115,<->,136.25.188.46,0,0,1,56,1,56,0.996395000,0.0000
21.15.226.126,<->,20.193.57.139,0,0,1,82,1,82,0.996369000,0.0000
138.127.225.122,<->,33.233.141.77,0,0,1,73,1,73,0.996159000,0.0000
196.30.1.198,<->,20.135.40.65,0,0,1,64,1,64,0.995974000,0.0000
138.127.224.121,<->,33.233.141.3,0,0,1,217,1,217,0.995917000,0.0000
134.252.110.236,<->,80.41.15.77,0,0,1,50,1,50,0.995708000,0.0000
218.138.21.44,<->,8.220.179.115,0,0,1,50,1,50,0.995295000,0.0000
195.80.61.254,<->,39.248.95.177,0,0,1,94,1,94,0.994819000,0.0000
231.143.48.207,<->,136.25.188.52,0,0,1,64,1,64,0.994655000,0.0000
132.217.25.155,<->,100.197.98.222,0,0,1,89,1,89,0.994547000,0.0000
104.137.158.250,<->,20.163.221.131,0,0,1,64,1,64,0.994294000,0.0000
139.163.26.146,<->,109.0.217.13,1,157,0,0,1,157,0.994060000,0.0000
21.15.226.126,<->,20.193.57.129,0,0,1,82,1,82,0.993973000,0.0000
215.158.239.79,<->,199.20.30.23,1,56,0,0,1,56,0.993965000,0.0000
207.63.92.245,<->,136.25.188.197,0,0,1,50,1,50,0.993860000,0.0000
201.47.169.72,<->,101.224.167.119,0,0,1,58,1,58,0.993749000,0.0000
53.187.62.98,<->,39.15.169.14,0,0,1,85,1,85,0.993474000,0.0000
142.43.184.230,<->,39.166.182.124,0,0,1,64,1,64,0.992894000,0.0000
111.146.163.167,<->,42.68.246.99,1,50,0,0,1,50,0.992758000,0.0000
115.77.7.36,<->,39.37.142.16,0,0,1,52,1,52,0.992611000,0.0000
193.46.99.244,<->,109.1.51.39,0,0,1,129,1,129,0.992555000,0.0000
21.15.226.126,<->,20.193.57.63,0,0,1,82,1,82,0.992517000,0.0000
104.137.158.250,<->,20.163.221.129,0,0,1,64,1,64,0.992486000,0.0000
221.104.152.204,<->,99.74.27.16,0,0,1,704,1,704,0.992406000,0.0000
108.32.75.237,<->,92.27.219.56,0,0,1,340,1,340,0.992343000,0.0000
247.136.244.38,<->,27.14.102.33,1,181,0,0,1,181,0.992292000,0.0000
111.151.142.231,<->,99.74.26.94,0,0,1,56,1,56,0.991653000,0.0000
195.40.101.231,<->,136.25.188.252,0,0,1,56,1,56,0.991531000,0.0000
192.67.181.112,<->,42.80.251.187,1,50,0,0,1,50,0.991268000,0.0000
104.242.139.65,<->,39.219.79.13,0,0,1,84,1,84,0.991151000,0.0000
109.1.16.205,<->,27.188.163.162,1,445,0,0,1,445,0.991126000,0.0000
148.155.131.164,<->,101.224.89.214,0,0,1,172,1,172,0.990678000,0.0000
138.127.224.225,<->,101.224.89.157,0,0,1,233,1,233,0.990495000,0.0000
192.242.74.225,<->,20.126.28.155,0,0,1,93,1,93,0.990448000,0.0000
144.75.218.233,<->,138.127.224.78,1,365,0,0,1,365,0.990154000,0.0000
127.59.203.242,<->,20.21.136.93,0,0,1,64,1,64,0.990030000,0.0000
124.119.134.91,<->,39.203.10.205,0,0,1,52,1,52,0.989744000,0.0000
215.158.239.19,<->,89.212.131.152,1,50,0,0,1,50,0.989668000,0.0000
144.87.235.187,<->,138.127.225.111,1,261,0,0,1,261,0.989567000,0.0000
198.46.187.93,<->,20.22.255.223,0,0,1,64,1,64,0.989518000,0.0000
215.158.61.202,<->,8.176.8.96,0,0,1,1401,1,1401,0.989497000,0.0000
215.158.239.92,<->,196.7.147.224,1,172,0,0,1,172,0.988877000,0.0000
8.191.134.120,<->,8.176.8.185,0,0,1,72,1,72,0.988774000,0.0000
21.15.226.126,<->,20.193.57.23,0,0,1,82,1,82,0.988615000,0.0000
145.242.126.212,<->,126.151.110.115,1,78,0,0,1,78,0.988236000,0.0000
136.221.119.73,<->,20.21.128.132,0,0,1,64,1,64,0.988168000,0.0000
194.124.56.24,<->,20.189.245.103,0,0,1,95,1,95,0.987986000,0.0000
159.13.225.41,<->,75.36.105.41,1,50,0,0,1,50,0.987973000,0.0000
20.54.182.237,<->,4.123.179.128,1,52,0,0,1,52,0.987885000,0.0000
92.27.219.34,<->,42.204.7.69,1,320,0,0,1,320,0.987774000,0.0000
124.50.117.2,<->,80.38.44.248,0,0,1,52,1,52,0.987728000,0.0000
138.98.147.21,<->,38.16.228.146,1,1344,0,0,1,1344,0.987612000,0.0000
21.15.226.126,<->,20.193.57.60,0,0,1,82,1,82,0.987559000,0.0000
224.250.64.91,<->,100.94.188.19,0,0,1,68,1,68,0.987522000,0.0000
193.87.147.104,<->,89.183.104.146,0,0,1,322,1,322,0.987285000,0.0000
204.186.150.53,<->,136.25.188.252,0,0,1,64,1,64,0.987150000,0.0000
92.170.27.61,<->,64.144.33.216,1,130,0,0,1,130,0.987041000,0.0000
119.90.250.200,<->,20.65.169.223,0,0,1,50,1,50,0.986873000,0.0000
142.253.237.85,<->,136.25.188.221,0,0,1,50,1,50,0.986562000,0.0000
159.137.138.173,<->,144.76.43.242,1,84,0,0,1,84,0.986487000,0.0000
109.222.246.3,<->,43.6.133.220,1,71,0,0,1,71,0.986457000,0.0000
215.158.238.137,<->,80.56.76.30,1,127,0,0,1,127,0.986455000,0.0000
89.183.104.231,<->,78.49.139.79,1,52,0,0,1,52,0.986413000,0.0000
207.42.58.78,<->,20.213.79.245,0,0,1,64,1,64,0.986283000,0.0000
126.204.106.102,<->,89.183.104.188,0,0,1,52,1,52,0.985981000,0.0000
208.238.232.243,<->,39.237.178.193,0,0,1,64,1,64,0.985966000,0.0000
197.158.73.222,<->,20.59.67.2,0,0,1,75,1,75,0.985679000,0.0000
204.56.143.176,<->,136.25.188.222,0,0,1,56,1,56,0.985453000,0.0000
144.75.218.241,<->,139.252.1.219,1,87,0,0,1,87,0.985387000,0.0000
144.76.42.205,<->,144.64.138.25,0,0,1,76,1,76,0.984986000,0.0000
80.41.5.161,<->,8.55.211.213,1,68,0,0,1,68,0.984823000,0.0000
206.16.207.74,<->,192.67.162.92,0,0,1,52,1,52,0.984793000,0.0000
107.245.169.4,<->,97.126.116.15,0,0,1,73,1,73,0.984268000,0.0000
224.33.81.227,<->,192.64.200.222,0,0,1,101,1,101,0.984243000,0.0000
120.187.147.183,<->,6.75.156.217,0,0,1,133,1,133,0.984220000,0.0000
223.137.189.161,<->,39.166.59.155,0,0,1,78,1,78,0.983858000,0.0000
127.184.46.90,<->,39.224.156.174,0,0,1,64,1,64,0.983851000,0.0000
29.135.50.95,<->,20.116.2.50,0,0,1,64,1,64,0.983570000,0.0000
249.229.107.171,<->,8.52.154.93,0,0,1,50,1,50,0.983479000,0.0000
159.69.187.1,<->,144.108.80.163,1,74,0,0,1,74,0.983277000,0.0000
125.23.154.213,<->,109.1.16.21,0,0,1,50,1,50,0.983179000,0.0000
192.171.13.190,<->,8.176.8.69,0,0,1,114,1,114,0.982715000,0.0000
196.113.186.195,<->,20.122.167.176,0,0,1,64,1,64,0.982191000,0.0000
207.68.17.26,<->,39.52.44.181,0,0,1,102,1,102,0.982153000,0.0000
124.69.199.94,<->,92.27.219.49,0,0,1,62,1,62,0.982147000,0.0000
246.253.248.211,<->,53.164.37.149,1,87,0,0,1,87,0.981965000,0.0000
231.137.153.0,<->,136.25.188.220,0,0,1,68,1,68,0.981744000,0.0000
144.75.218.235,<->,97.110.148.11,1,84,0,0,1,84,0.981705000,0.0000
92.27.219.237,<->,33.36.35.205,1,344,0,0,1,344,0.981416000,0.0000
220.20.200.5,<->,144.83.60.153,1,395,0,0,1,395,0.981360000,0.0000
144.75.218.241,<->,138.127.230.170,1,254,0,0,1,254,0.981339000,0.0000
255.133.229.164,<->,39.17.239.147,0,0,1,100,1,100,0.981312000,0.0000
130.143.130.253,<->,39.133.32.7,0,0,1,70,1,70,0.981142000,0.0000
243.49.81.42,<->,213.38.145.249,0,0,1,256,1,256,0.980891000,0.0000
231.138.6.93,<->,136.25.188.177,0,0,1,68,1,68,0.980876000,0.0000
215.158.61.203,<->,8.176.8.196,0,0,1,56,1,56,0.980854000,0.0000
195.54.85.192,<->,136.25.188.176,0,0,1,56,1,56,0.980486000,0.0000
193.46.99.113,<->,111.146.212.68,0,0,1,90,1,90,0.980478000,0.0000
136.181.47.74,<->,0.197.90.160,1,135,0,0,1,135,0.980098000,0.0000
104.137.158.250,<->,20.163.221.21,0,0,1,64,1,64,0.979982000,0.0000
111.147.154.115,<->,42.68.246.99,1,50,0,0,1,50,0.979869000,0.0000
241.193.172.231,<->,20.122.112.235,0,0,1,50,1,50,0.979818000,0.0000
122.206.71.162,<->,20.214.27.152,0,0,1,64,1,64,0.979714000,0.0000
195.12.132.138,<->,20.6.146.190,0,0,1,68,1,68,0.978445000,0.0000
88.3.63.208,<->,39.34.121.201,0,0,1,64,1,64,0.978393000,0.0000
148.241.122.20,<->,89.183.104.172,0,0,1,52,1,52,0.978200000,0.0000
197.107.204.54,<->,136.25.188.197,0,0,1,68,1,68,0.978174000,0.0000
143.23.214.247,<->,136.25.188.198,0,0,1,64,1,64,0.978107000,0.0000
216.144.228.219,<->,215.158.140.205,0,0,1,50,1,50,0.977595000,0.0000
142.190.250.121,<->,136.25.188.227,0,0,1,76,1,76,0.977551000,0.0000
192.64.250.118,<->,122.126.97.27,1,50,0,0,1,50,0.976665000,0.0000
105.102.103.207,<->,100.95.247.23,0,0,1,135,1,135,0.976649000,0.0000
120.155.84.160,<->,109.222.236.213,0,0,1,119,1,119,0.976224000,0.0000
105.201.216.195,<->,100.94.40.183,0,0,1,330,1,330,0.975895000,0.0000
117.234.36.52,<->,92.27.219.212,0,0,1,52,1,52,0.975718000,0.0000
21.15.226.126,<->,20.193.57.33,0,0,1,82,1,82,0.975630000,0.0000
105.78.55.110,<->,20.83.50.136,0,0,1,64,1,64,0.975595000,0.0000
101.70.119.147,<->,66.68.27.29,1,73,0,0,1,73,0.975483000,0.0000
215.158.239.77,<->,204.61.106.122,1,56,0,0,1,56,0.975263000,0.0000
111.151.239.49,<->,97.183.193.182,0,0,1,50,1,50,0.975103000,0.0000
54.39.227.121,<->,48.52.89.17,0,0,1,50,1,50,0.975040000,0.0000
205.170.79.59,<->,20.64.226.120,0,0,1,60,1,60,0.974023000,0.0000
204.153.206.219,<->,8.182.235.164,0,0,1,50,1,50,0.973840000,0.0000
97.168.64.50,<->,54.92.55.77,1,118,0,0,1,118,0.973740000,0.0000
194.200.121.191,<->,39.60.248.131,0,0,1,108,1,108,0.973371000,0.0000
111.151.239.15,<->,97.183.193.182,0,0,1,50,1,50,0.972975000,0.0000
215.158.239.96,<->,196.93.227.149,1,64,0,0,1,64,0.972719000,0.0000
38.21.156.204,<->,20.232.228.23,0,0,1,82,1,82,0.972155000,0.0000
210.209.251.223,<->,80.40.247.46,0,0,1,50,1,50,0.972112000,0.0000
195.76.227.52,<->,50.223.3.228,0,0,1,56,1,56,0.972073000,0.0000
107.255.248.47,<->,97.168.92.35,0,0,1,74,1,74,0.971911000,0.0000
144.75.218.233,<->,120.87.222.172,1,133,0,0,1,133,0.971836000,0.0000
215.158.239.37,<->,111.150.207.201,1,56,0,0,1,56,0.971431000,0.0000
207.227.57.137,<->,39.34.233.92,0,0,1,78,1,78,0.971321000,0.0000
215.158.140.218,<->,53.246.31.6,1,367,0,0,1,367,0.971253000,0.0000
199.61.66.134,<->,20.82.99.93,0,0,1,72,1,72,0.971128000,0.0000
111.151.142.168,<->,97.126.31.85,0,0,1,56,1,56,0.971078000,0.0000
215.158.239.50,<->,196.91.55.158,1,50,0,0,1,50,0.970908000,0.0000
212.153.191.28,<->,8.220.176.253,0,0,1,50,1,50,0.970532000,0.0000
119.90.250.200,<->,39.6.217.170,0,0,1,50,1,50,0.970526000,0.0000
54.58.207.20,<->,48.53.68.163,0,0,1,136,1,136,0.970277000,0.0000
144.75.218.233,<->,138.127.224.132,1,249,0,0,1,249,0.970233000,0.0000
129.254.99.204,<->,129.224.112.252,0,0,1,64,1,64,0.970231000,0.0000
120.95.224.25,<->,92.27.219.166,0,0,1,135,1,135,0.970185000,0.0000
131.4.121.44,<->,20.244.178.60,0,0,1,52,1,52,0.969227000,0.0000
199.15.128.14,<->,136.25.188.176,0,0,1,64,1,64,0.969026000,0.0000
142.203.50.212,<->,50.224.76.235,0,0,1,50,1,50,0.968870000,0.0000
241.193.172.231,<->,20.96.98.41,0,0,1,50,1,50,0.968860000,0.0000
207.61.111.71,<->,136.25.188.52,0,0,1,721,1,721,0.968829000,0.0000
144.83.60.153,<->,92.162.253.143,0,0,1,50,1,50,0.968815000,0.0000
215.158.239.86,<->,196.91.57.226,1,56,0,0,1,56,0.968800000,0.0000
89.183.104.145,<->,36.120.170.69,1,349,0,0,1,349,0.968783000,0.0000
122.117.249.126,<->,92.27.219.237,0,0,1,330,1,330,0.968781000,0.0000
144.72.195.98,<->,100.95.171.81,0,0,1,50,1,50,0.968740000,0.0000
247.136.232.233,<->,53.148.22.85,1,125,0,0,1,125,0.968641000,0.0000
92.27.219.159,<->,54.38.18.155,1,50,0,0,1,50,0.968392000,0.0000
89.183.104.137,<->,27.50.133.40,1,52,0,0,1,52,0.968327000,0.0000
193.46.99.163,<->,192.67.183.76,0,0,1,300,1,300,0.967225000,0.0000
98.129.96.103,<->,33.156.177.142,1,255,0,0,1,255,0.967063000,0.0000
192.64.194.95,<->,148.145.88.210,1,133,0,0,1,133,0.966456000,0.0000
196.113.186.195,<->,39.246.85.221,0,0,1,64,1,64,0.966228000,0.0000
133.178.226.20,<->,0.195.237.14,1,56,0,0,1,56,0.966161000,0.0000
233.145.158.169,<->,80.40.57.143,0,0,1,50,1,50,0.965700000,0.0000
198.187.30.136,<->,39.25.100.31,0,0,1,50,1,50,0.965655000,0.0000
96.22.117.221,<->,8.220.181.15,0,0,1,56,1,56,0.965619000,0.0000
198.107.161.237,<->,102.51.181.240,0,0,1,136,1,136,0.965596000,0.0000
145.62.238.247,<->,144.75.218.233,0,0,1,112,1,112,0.965575000,0.0000
80.56.78.128,<->,8.188.179.8,1,98,0,0,1,98,0.965543000,0.0000
80.40.4.150,<->,53.77.231.27,1,52,0,0,1,52,0.965271000,0.0000
215.158.58.168,<->,6.73.247.117,0,0,1,56,1,56,0.965217000,0.0000
197.113.64.199,<->,136.25.188.55,0,0,1,50,1,50,0.965210000,0.0000
215.158.239.56,<->,199.20.29.204,1,50,0,0,1,50,0.965157000,0.0000
192.64.86.74,<->,8.55.213.118,1,56,0,0,1,56,0.965047000,0.0000
196.240.214.14,<->,136.25.188.255,0,0,1,50,1,50,0.965031000,0.0000
241.193.172.231,<->,20.118.253.65,0,0,1,50,1,50,0.964882000,0.0000
158.134.2.131,<->,8.220.189.165,0,0,1,50,1,50,0.964339000,0.0000
149.167.2.14,<->,8.43.154.201,0,0,1,64,1,64,0.964287000,0.0000
92.27.219.161,<->,77.147.19.155,1,135,0,0,1,135,0.964232000,0.0000
144.75.218.242,<->,141.192.67.251,1,144,0,0,1,144,0.964193000,0.0000
80.38.36.164,<->,53.233.145.111,1,75,0,0,1,75,0.963831000,0.0000
89.183.104.166,<->,78.44.34.243,1,62,0,0,1,62,0.963677000,0.0000
255.133.229.164,<->,39.47.99.30,0,0,1,100,1,100,0.963313000,0.0000
144.76.42.211,<->,144.64.138.25,0,0,1,76,1,76,0.962941000,0.0000
80.38.36.156,<->,53.249.181.146,1,75,0,0,1,75,0.962927000,0.0000
104.227.4.214,<->,20.179.212.228,0,0,1,52,1,52,0.962519000,0.0000
200.175.140.55,<->,53.200.64.202,1,56,0,0,1,56,0.962437000,0.0000
241.193.172.231,<->,20.130.106.180,0,0,1,50,1,50,0.962419000,0.0000
80.93.31.157,<->,20.203.223.67,0,0,1,52,1,52,0.961908000,0.0000
104.217.65.191,<->,80.41.42.158,0,0,1,52,1,52,0.961826000,0.0000
125.216.39.13,<->,8.52.172.227,0,0,1,1002,1,1002,0.961699000,0.0000
145.208.190.219,<->,66.87.55.243,1,130,0,0,1,130,0.961633000,0.0000
215.158.238.134,<->,8.53.216.76,1,1229,0,0,1,1229,0.961541000,0.0000
203.89.237.143,<->,39.14.156.237,0,0,1,52,1,52,0.961437000,0.0000
159.67.88.187,<->,89.183.104.249,0,0,1,323,1,323,0.961362000,0.0000
118.67.109.18,<->,92.27.219.234,0,0,1,99,1,99,0.961222000,0.0000
120.246.107.53,<->,20.31.122.39,0,0,1,64,1,64,0.960817000,0.0000
195.15.145.186,<->,136.25.188.162,0,0,1,84,1,84,0.960531000,0.0000
80.41.16.226,<->,38.87.248.58,1,112,0,0,1,112,0.960173000,0.0000
98.236.193.132,<->,97.242.126.200,1,88,0,0,1,88,0.959972000,0.0000
195.68.21.191,<->,136.25.188.255,0,0,1,56,1,56,0.959604000,0.0000
246.253.248.211,<->,53.212.138.208,1,86,0,0,1,86,0.959596000,0.0000
198.69.238.131,<->,20.90.202.211,0,0,1,64,1,64,0.959349000,0.0000
244.50.136.175,<->,20.151.27.138,0,0,1,50,1,50,0.959055000,0.0000
132.208.68.222,<->,132.168.197.226,0,0,1,729,1,729,0.959009000,0.0000
239.71.80.165,<->,129.187.1.168,1,50,0,0,1,50,0.958791000,0.0000
215.158.140.113,<->,192.170.246.179,1,56,0,0,1,56,0.958546000,0.0000
121.85.84.62,<->,39.13.192.98,0,0,1,94,1,94,0.958410000,0.0000
100.214.121.114,<->,75.70.20.154,1,77,0,0,1,77,0.958030000,0.0000
144.75.218.237,<->,138.127.225.234,1,281,0,0,1,281,0.957122000,0.0000
126.234.198.25,<->,20.1.177.169,0,0,1,64,1,64,0.956950000,0.0000
144.75.218.235,<->,98.184.9.185,1,97,0,0,1,97,0.956353000,0.0000
80.27.110.162,<->,8.182.226.78,0,0,1,50,1,50,0.955987000,0.0000
118.42.3.133,<->,99.73.150.56,0,0,1,50,1,50,0.955985000,0.0000
198.71.42.62,<->,159.137.201.71,0,0,1,50,1,50,0.955580000,0.0000
236.27.8.176,<->,8.220.177.253,0,0,1,704,1,704,0.954868000,0.0000
144.75.218.233,<->,138.127.225.46,1,329,0,0,1,329,0.954735000,0.0000
195.54.137.100,<->,136.25.188.44,0,0,1,56,1,56,0.954713000,0.0000
204.89.225.171,<->,50.224.76.235,0,0,1,50,1,50,0.954682000,0.0000
198.158.197.83,<->,8.52.166.220,0,0,1,50,1,50,0.953773000,0.0000
194.205.102.239,<->,8.220.205.50,0,0,1,704,1,704,0.953537000,0.0000
143.89.238.210,<->,92.27.219.237,0,0,1,351,1,351,0.953446000,0.0000
20.13.109.166,<->,0.200.50.50,1,60,0,0,1,60,0.953178000,0.0000
215.158.239.58,<->,199.20.28.72,1,50,0,0,1,50,0.953178000,0.0000
124.64.83.37,<->,89.183.104.164,0,0,1,369,1,369,0.952467000,0.0000
159.58.54.98,<->,89.183.104.135,0,0,1,50,1,50,0.951904000,0.0000
142.222.204.12,<->,39.50.175.27,0,0,1,64,1,64,0.951465000,0.0000
104.251.247.194,<->,20.196.99.206,0,0,1,64,1,64,0.951297000,0.0000
134.160.147.115,<->,92.27.219.230,0,0,1,52,1,52,0.951127000,0.0000
144.75.218.246,<->,138.127.225.188,1,352,0,0,1,352,0.951022000,0.0000
104.137.158.250,<->,20.163.221.174,0,0,1,64,1,64,0.950973000,0.0000
97.168.64.50,<->,40.153.136.228,1,130,0,0,1,130,0.950961000,0.0000
21.15.226.126,<->,20.193.58.37,0,0,1,82,1,82,0.950959000,0.0000
91.250.143.162,<->,39.150.176.84,0,0,1,50,1,50,0.950938000,0.0000
101.106.122.69,<->,92.27.27.179,0,0,1,136,1,136,0.950509000,0.0000
53.245.127.102,<->,48.52.155.79,0,0,1,50,1,50,0.950471000,0.0000
213.186.52.88,<->,144.71.46.221,0,0,1,56,1,56,0.950415000,0.0000
202.33.244.183,<->,136.25.188.240,0,0,1,50,1,50,0.950281000,0.0000
93.223.130.31,<->,8.43.204.226,0,0,1,704,1,704,0.950026000,0.0000
54.59.78.157,<->,48.53.33.202,0,0,1,50,1,50,0.949999000,0.0000
111.150.207.201,<->,8.252.221.119,0,0,1,56,1,56,0.949889000,0.0000
215.158.239.79,<->,195.70.16.142,1,68,0,0,1,68,0.949877000,0.0000
215.158.103.206,<->,138.127.231.113,1,263,0,0,1,263,0.949718000,0.0000
112.38.250.104,<->,92.27.219.187,0,0,1,52,1,52,0.949431000,0.0000
195.41.141.31,<->,136.25.188.226,0,0,1,50,1,50,0.948809000,0.0000
123.165.45.181,<->,20.208.96.223,0,0,1,72,1,72,0.948767000,0.0000
133.178.227.10,<->,131.1.235.233,1,85,0,0,1,85,0.948500000,0.0000
110.69.109.109,<->,8.220.205.146,0,0,1,50,1,50,0.948227000,0.0000
8.182.238.21,<->,8.20.100.179,1,50,0,0,1,50,0.947965000,0.0000
192.67.129.253,<->,81.108.138.135,1,72,0,0,1,72,0.947936000,0.0000
92.27.27.180,<->,59.146.67.216,1,81,0,0,1,81,0.947925000,0.0000
142.182.19.240,<->,50.224.76.230,0,0,1,50,1,50,0.947667000,0.0000
218.4.170.61,<->,216.76.218.35,1,56,0,0,1,56,0.947288000,0.0000
215.158.30.23,<->,29.211.214.254,0,0,1,92,1,92,0.946799000,0.0000
194.233.16.93,<->,136.25.188.163,0,0,1,64,1,64,0.946689000,0.0000
128.243.145.254,<->,80.38.4.56,0,0,1,945,1,945,0.946562000,0.0000
194.228.3.111,<->,20.175.14.141,0,0,1,98,1,98,0.946245000,0.0000
113.160.227.65,<->,20.122.197.0,0,0,1,60,1,60,0.946234000,0.0000
192.67.134.61,<->,133.225.140.219,1,50,0,0,1,50,0.946179000,0.0000
192.171.13.190,<->,8.252.222.246,0,0,1,159,1,159,0.945940000,0.0000
196.24.193.173,<->,102.51.41.126,0,0,1,135,1,135,0.945680000,0.0000
149.182.161.13,<->,20.79.105.212,0,0,1,70,1,70,0.945624000,0.0000
247.136.145.89,<->,199.61.51.14,1,50,0,0,1,50,0.945602000,0.0000
89.183.104.141,<->,84.251.2.16,1,64,0,0,1,64,0.945132000,0.0000
127.25.104.19,<->,20.111.132.186,0,0,1,134,1,134,0.944885000,0.0000
247.136.136.51,<->,40.192.85.12,1,52,0,0,1,52,0.944859000,0.0000
247.136.192.107,<->,8.20.81.121,1,56,0,0,1,56,0.944781000,0.0000
123.154.23.86,<->,92.27.219.231,0,0,1,370,1,370,0.944776000,0.0000
133.178.226.181,<->,91.247.40.69,1,1064,0,0,1,1064,0.944636000,0.0000
121.9.18.9,<->,92.27.219.148,0,0,1,64,1,64,0.944370000,0.0000
144.69.82.139,<->,99.168.30.209,1,73,0,0,1,73,0.944301000,0.0000
139.33.174.20,<->,111.147.83.196,0,0,1,50,1,50,0.944090000,0.0000
199.69.176.0,<->,136.25.188.225,0,0,1,84,1,84,0.943962000,0.0000
215.158.239.74,<->,122.158.51.62,1,83,0,0,1,83,0.943834000,0.0000
17.204.25.210,<->,8.220.239.84,0,0,1,50,1,50,0.943662000,0.0000
231.255.128.152,<->,159.137.255.68,0,0,1,97,1,97,0.943215000,0.0000
144.92.40.106,<->,132.18.67.29,1,50,0,0,1,50,0.942910000,0.0000
232.31.231.154,<->,80.40.47.26,0,0,1,56,1,56,0.942837000,0.0000
21.15.226.126,<->,20.193.58.44,0,0,1,82,1,82,0.942772000,0.0000
215.158.195.73,<->,111.151.109.41,1,100,0,0,1,100,0.942602000,0.0000
133.178.227.8,<->,133.56.180.37,1,541,0,0,1,541,0.942517000,0.0000
136.25.189.86,<->,133.73.8.230,1,83,0,0,1,83,0.942507000,0.0000
109.222.238.4,<->,53.195.188.179,1,56,0,0,1,56,0.942408000,0.0000
246.254.97.149,<->,131.233.225.105,1,88,0,0,1,88,0.942326000,0.0000
192.64.204.144,<->,33.207.16.95,1,50,0,0,1,50,0.942147000,0.0000
137.129.47.161,<->,53.202.90.238,1,64,0,0,1,64,0.942122000,0.0000
215.158.239.246,<->,111.151.142.211,1,56,0,0,1,56,0.942115000,0.0000
206.147.242.252,<->,80.41.39.119,0,0,1,321,1,321,0.941940000,0.0000
99.162.77.146,<->,53.69.140.220,1,234,0,0,1,234,0.941887000,0.0000
241.228.109.55,<->,230.60.108.54,1,181,0,0,1,181,0.941845000,0.0000
139.33.174.21,<->,111.147.83.196,0,0,1,50,1,50,0.941728000,0.0000
131.24.254.37,<->,39.167.31.1,0,0,1,91,1,91,0.941498000,0.0000
210.229.230.22,<->,89.241.175.253,1,80,0,0,1,80,0.941279000,0.0000
215.158.238.73,<->,143.227.65.185,1,1069,0,0,1,1069,0.941268000,0.0000
92.181.50.157,<->,77.29.50.38,1,140,0,0,1,140,0.941226000,0.0000
241.193.172.231,<->,20.110.101.184,0,0,1,50,1,50,0.941088000,0.0000
144.122.240.207,<->,144.108.80.163,1,64,0,0,1,64,0.940883000,0.0000
105.73.227.170,<->,20.223.114.189,0,0,1,64,1,64,0.940874000,0.0000
21.15.226.126,<->,20.193.58.55,0,0,1,82,1,82,0.940315000,0.0000
144.75.218.241,<->,139.252.1.237,1,163,0,0,1,163,0.940086000,0.0000
116.141.143.35,<->,92.27.219.227,0,0,1,56,1,56,0.939781000,0.0000
204.146.255.169,<->,39.208.143.32,0,0,1,106,1,106,0.939584000,0.0000
213.186.52.65,<->,144.85.170.244,0,0,1,56,1,56,0.939218000,0.0000
195.5.67.184,<->,50.224.52.70,0,0,1,80,1,80,0.939206000,0.0000
116.243.131.172,<->,109.1.9.205,0,0,1,56,1,56,0.939205000,0.0000
197.33.188.100,<->,192.64.251.202,0,0,1,135,1,135,0.939155000,0.0000
149.111.213.145,<->,109.1.61.240,0,0,1,351,1,351,0.939032000,0.0000
247.136.188.124,<->,0.233.104.95,1,52,0,0,1,52,0.938956000,0.0000
192.67.167.244,<->,144.54.95.244,1,136,0,0,1,136,0.938745000,0.0000
64.151.30.204,<->,50.162.21.37,0,0,1,133,1,133,0.938350000,0.0000
98.67.131.10,<->,54.43.1.179,1,173,0,0,1,173,0.938185000,0.0000
192.67.184.130,<->,50.248.185.173,1,369,0,0,1,369,0.938093000,0.0000
199.111.214.254,<->,39.7.198.136,0,0,1,50,1,50,0.938042000,0.0000
221.101.181.217,<->,145.128.201.178,1,50,0,0,1,50,0.937871000,0.0000
204.159.151.35,<->,20.65.182.35,0,0,1,104,1,104,0.937611000,0.0000
201.213.115.37,<->,92.27.219.182,0,0,1,56,1,56,0.937350000,0.0000
207.83.213.252,<->,133.54.31.247,0,0,1,64,1,64,0.937170000,0.0000
113.160.25.231,<->,111.146.228.213,0,0,1,56,1,56,0.937141000,0.0000
54.59.177.47,<->,48.54.79.176,0,0,1,64,1,64,0.937072000,0.0000
140.146.161.239,<->,111.147.245.114,0,0,1,50,1,50,0.936957000,0.0000
132.43.156.54,<->,132.10.25.131,0,0,1,358,1,358,0.936609000,0.0000
145.3.142.7,<->,39.237.228.194,0,0,1,64,1,64,0.936403000,0.0000
203.212.95.67,<->,92.27.219.21,0,0,1,52,1,52,0.936256000,0.0000
101.112.197.61,<->,64.162.251.79,1,50,0,0,1,50,0.936123000,0.0000
215.158.238.92,<->,111.150.187.55,1,1165,0,0,1,1165,0.936060000,0.0000
194.202.218.12,<->,20.70.242.215,0,0,1,60,1,60,0.936045000,0.0000
143.252.64.235,<->,129.224.112.252,0,0,1,71,1,71,0.935974000,0.0000
109.222.195.52,<->,53.69.81.44,1,125,0,0,1,125,0.935886000,0.0000
141.86.219.67,<->,20.240.40.74,0,0,1,99,1,99,0.935534000,0.0000
144.75.218.246,<->,138.127.224.230,1,366,0,0,1,366,0.935474000,0.0000
82.99.240.203,<->,8.52.136.253,0,0,1,1002,1,1002,0.935146000,0.0000
142.227.194.228,<->,136.25.188.253,0,0,1,50,1,50,0.935132000,0.0000
80.42.168.43,<->,33.61.126.211,1,293,0,0,1,293,0.935053000,0.0000
132.168.199.163,<->,93.223.122.242,1,349,0,0,1,349,0.935012000,0.0000
144.75.218.235,<->,138.127.224.46,1,253,0,0,1,253,0.934764000,0.0000
144.75.218.242,<->,132.43.156.54,1,135,0,0,1,135,0.934557000,0.0000
198.39.23.16,<->,92.27.219.246,0,0,1,100,1,100,0.934274000,0.0000
92.27.219.209,<->,92.27.131.126,1,56,0,0,1,56,0.934001000,0.0000
241.193.172.231,<->,20.115.101.209,0,0,1,50,1,50,0.933377000,0.0000
215.158.239.1,<->,215.158.127.165,1,56,0,0,1,56,0.933289000,0.0000
92.27.219.34,<->,29.251.197.165,1,64,0,0,1,64,0.933250000,0.0000
159.194.92.138,<->,8.52.222.23,0,0,1,56,1,56,0.932729000,0.0000
195.14.62.158,<->,92.27.194.147,0,0,1,56,1,56,0.932652000,0.0000
122.218.5.165,<->,39.157.140.239,0,0,1,60,1,60,0.932580000,0.0000
246.253.253.79,<->,129.203.66.31,1,633,0,0,1,633,0.932174000,0.0000
80.41.51.34,<->,42.241.204.187,1,56,0,0,1,56,0.932157000,0.0000
215.158.103.219,<->,138.127.225.198,1,355,0,0,1,355,0.932119000,0.0000
97.243.199.12,<->,92.27.219.209,0,0,1,56,1,56,0.931985000,0.0000
21.15.226.126,<->,20.193.58.141,0,0,1,82,1,82,0.931819000,0.0000
104.143.10.103,<->,100.92.94.31,0,0,1,64,1,64,0.931708000,0.0000
72.195.57.40,<->,20.155.56.72,0,0,1,64,1,64,0.931046000,0.0000
112.84.33.83,<->,20.138.190.167,0,0,1,64,1,64,0.930959000,0.0000
134.6.77.156,<->,92.27.219.141,0,0,1,145,1,145,0.930785000,0.0000
50.224.76.230,<->,33.251.112.218,1,50,0,0,1,50,0.930578000,0.0000
224.250.64.90,<->,100.94.111.50,0,0,1,68,1,68,0.930446000,0.0000
144.75.218.237,<->,138.127.225.89,1,366,0,0,1,366,0.930323000,0.0000
146.188.219.80,<->,92.27.219.175,0,0,1,52,1,52,0.930250000,0.0000
144.75.218.241,<->,138.127.224.169,1,261,0,0,1,261,0.930210000,0.0000
144.75.218.242,<->,138.127.230.199,1,176,0,0,1,176,0.929846000,0.0000
94.193.75.249,<->,8.252.221.204,0,0,1,56,1,56,0.929781000,0.0000
215.158.239.58,<->,204.1.189.93,1,68,0,0,1,68,0.929755000,0.0000
200.174.178.216,<->,54.36.175.102,1,56,0,0,1,56,0.928984000,0.0000
75.36.65.235,<->,33.233.141.49,0,0,1,178,1,178,0.928963000,0.0000
92.27.131.122,<->,89.183.104.128,0,0,1,56,1,56,0.928552000,0.0000
104.252.233.173,<->,39.37.44.229,0,0,1,52,1,52,0.928316000,0.0000
122.142.5.111,<->,89.183.104.150,0,0,1,52,1,52,0.928273000,0.0000
111.150.207.228,<->,8.252.223.165,0,0,1,56,1,56,0.928033000,0.0000
192.171.13.190,<->,8.252.222.11,0,0,1,146,1,146,0.927780000,0.0000
50.136.222.83,<->,8.20.87.95,0,0,1,262,1,262,0.927288000,0.0000
122.147.77.52,<->,20.134.242.106,0,0,1,64,1,64,0.927223000,0.0000
192.64.247.91,<->,113.40.87.21,1,64,0,0,1,64,0.926876000,0.0000
144.76.42.201,<->,101.224.183.152,0,0,1,74,1,74,0.926753000,0.0000
204.184.109.211,<->,136.25.188.175,0,0,1,50,1,50,0.926682000,0.0000
69.246.48.77,<->,39.174.169.119,0,0,1,60,1,60,0.926595000,0.0000
145.3.142.7,<->,39.237.228.193,0,0,1,64,1,64,0.926517000,0.0000
247.136.164.234,<->,8.55.211.213,1,64,0,0,1,64,0.926320000,0.0000
136.25.188.198,<->,30.73.224.106,1,56,0,0,1,56,0.926033000,0.0000
120.246.107.53,<->,20.31.122.57,0,0,1,64,1,64,0.925943000,0.0000
145.110.55.59,<->,144.82.14.49,1,73,0,0,1,73,0.925886000,0.0000
109.222.214.116,<->,93.208.12.164,1,293,0,0,1,293,0.925588000,0.0000
111.150.207.83,<->,8.176.8.201,0,0,1,162,1,162,0.925537000,0.0000
215.158.103.206,<->,132.43.156.56,1,535,0,0,1,535,0.925206000,0.0000
144.75.218.233,<->,138.127.224.80,1,268,0,0,1,268,0.925114000,0.0000
241.193.172.231,<->,20.164.177.64,0,0,1,50,1,50,0.924654000,0.0000
123.97.227.2,<->,39.229.22.196,0,0,1,50,1,50,0.924385000,0.0000
204.51.48.163,<->,20.144.133.86,0,0,1,60,1,60,0.924353000,0.0000
93.90.120.100,<->,20.43.161.253,0,0,1,64,1,64,0.924199000,0.0000
135.243.190.253,<->,8.52.183.58,0,0,1,50,1,50,0.924018000,0.0000
126.219.197.183,<->,8.176.8.83,0,0,1,112,1,112,0.923794000,0.0000
159.194.91.13,<->,48.110.179.206,1,52,0,0,1,52,0.923789000,0.0000
53.148.22.108,<->,35.41.132.79,0,0,1,125,1,125,0.923719000,0.0000
144.75.218.242,<->,138.127.230.2,1,238,0,0,1,238,0.923256000,0.0000
109.222.255.59,<->,68.91.45.69,1,79,0,0,1,79,0.923231000,0.0000
144.75.218.242,<->,97.68.93.11,1,707,0,0,1,707,0.922535000,0.0000
102.83.18.158,<->,8.45.175.127,1,56,0,0,1,56,0.922495000,0.0000
56.8.148.82,<->,8.182.239.2,0,0,1,50,1,50,0.922382000,0.0000
101.70.119.102,<->,50.49.60.53,1,74,0,0,1,74,0.921928000,0.0000
80.28.27.166,<->,8.182.224.248,0,0,1,50,1,50,0.921637000,0.0000
144.75.218.235,<->,138.127.230.242,1,230,0,0,1,230,0.921438000,0.0000
220.20.200.9,<->,27.199.161.199,1,56,0,0,1,56,0.920765000,0.0000
111.150.207.239,<->,99.74.26.166,0,0,1,56,1,56,0.920720000,0.0000
109.1.18.191,<->,100.124.212.156,1,337,0,0,1,337,0.920423000,0.0000
196.233.128.246,<->,92.27.219.54,0,0,1,52,1,52,0.920237000,0.0000
220.209.172.183,<->,215.158.140.87,0,0,1,50,1,50,0.919921000,0.0000
8.52.179.217,<->,6.100.226.175,1,50,0,0,1,50,0.919894000,0.0000
104.143.10.103,<->,100.92.94.134,0,0,1,64,1,64,0.919548000,0.0000
99.175.119.121,<->,53.149.20.33,1,125,0,0,1,125,0.919383000,0.0000
230.87.31.198,<->,192.65.58.253,0,0,1,133,1,133,0.919357000,0.0000
80.41.65.175,<->,50.224.75.42,0,0,1,64,1,64,0.919274000,0.0000
198.240.153.152,<->,20.7.200.28,0,0,1,64,1,64,0.919139000,0.0000
145.166.30.228,<->,8.252.221.249,0,0,1,50,1,50,0.919046000,0.0000
247.136.251.232,<->,122.78.204.6,1,52,0,0,1,52,0.918842000,0.0000
20.198.105.222,<->,4.129.137.231,1,52,0,0,1,52,0.918663000,0.0000
244.50.129.64,<->,20.44.38.192,0,0,1,50,1,50,0.918660000,0.0000
114.228.208.175,<->,89.183.104.253,0,0,1,84,1,84,0.918537000,0.0000
215.158.103.206,<->,124.55.106.24,1,121,0,0,1,121,0.918502000,0.0000
119.186.32.127,<->,89.183.104.224,0,0,1,52,1,52,0.918353000,0.0000
194.107.4.209,<->,20.179.253.122,0,0,1,64,1,64,0.918325000,0.0000
246.253.168.231,<->,117.13.139.87,1,50,0,0,1,50,0.918301000,0.0000
112.90.30.190,<->,109.1.8.71,0,0,1,62,1,62,0.918143000,0.0000
199.37.1.124,<->,39.205.105.158,0,0,1,98,1,98,0.918100000,0.0000
141.92.221.59,<->,129.224.112.252,0,0,1,73,1,73,0.917984000,0.0000
207.101.163.204,<->,8.182.224.248,0,0,1,56,1,56,0.917942000,0.0000
109.222.199.132,<->,83.96.53.127,1,80,0,0,1,80,0.917886000,0.0000
192.67.115.18,<->,8.45.168.98,1,56,0,0,1,56,0.917541000,0.0000
220.55.111.95,<->,145.49.157.237,1,52,0,0,1,52,0.917144000,0.0000
200.174.210.216,<->,53.160.193.35,1,50,0,0,1,50,0.917138000,0.0000
246.122.1.44,<->,8.52.169.61,0,0,1,50,1,50,0.916785000,0.0000
215.158.239.49,<->,142.253.109.23,1,672,0,0,1,672,0.916783000,0.0000
129.224.112.252,<->,114.186.133.56,1,85,0,0,1,85,0.916639000,0.0000
111.150.207.137,<->,8.252.223.10,0,0,1,56,1,56,0.916482000,0.0000
92.27.219.23,<->,76.178.130.217,1,56,0,0,1,56,0.916403000,0.0000
204.200.59.77,<->,136.25.188.253,0,0,1,132,1,132,0.916123000,0.0000
215.158.195.11,<->,111.151.109.51,1,56,0,0,1,56,0.916089000,0.0000
207.173.26.223,<->,136.25.188.53,0,0,1,50,1,50,0.916039000,0.0000
247.136.165.38,<->,119.77.92.156,1,138,0,0,1,138,0.916031000,0.0000
53.239.75.116,<->,8.228.215.8,0,0,1,257,1,257,0.915808000,0.0000
132.149.114.9,<->,89.71.0.216,1,84,0,0,1,84,0.915491000,0.0000
215.158.239.117,<->,215.158.42.24,1,68,0,0,1,68,0.915364000,0.0000
59.49.73.35,<->,56.121.55.155,0,0,1,64,1,64,0.914884000,0.0000
207.239.54.116,<->,136.25.188.209,0,0,1,50,1,50,0.914736000,0.0000
27.11.233.71,<->,8.220.176.253,0,0,1,56,1,56,0.914226000,0.0000
220.6.7.195,<->,0.195.210.44,0,0,1,56,1,56,0.913811000,0.0000
196.88.170.92,<->,136.25.188.196,0,0,1,50,1,50,0.913648000,0.0000
143.215.6.0,<->,8.182.226.78,0,0,1,50,1,50,0.913294000,0.0000
215.158.238.130,<->,111.150.207.240,1,56,0,0,1,56,0.913137000,0.0000
38.227.130.5,<->,20.135.180.25,0,0,1,68,1,68,0.913118000,0.0000
144.75.218.233,<->,138.127.225.255,1,553,0,0,1,553,0.912574000,0.0000
192.228.30.44,<->,102.51.55.63,0,0,1,56,1,56,0.912371000,0.0000
199.39.38.119,<->,136.25.188.163,0,0,1,56,1,56,0.910723000,0.0000
200.174.7.150,<->,50.145.3.84,1,129,0,0,1,129,0.910582000,0.0000
111.151.107.247,<->,8.176.8.195,0,0,1,109,1,109,0.910484000,0.0000
152.105.120.36,<->,8.252.222.173,0,0,1,56,1,56,0.910420000,0.0000
249.101.84.132,<->,53.231.92.29,1,50,0,0,1,50,0.910405000,0.0000
220.181.93.52,<->,8.220.176.253,0,0,1,50,1,50,0.910336000,0.0000
109.1.16.161,<->,64.214.44.91,1,50,0,0,1,50,0.910250000,0.0000
144.122.240.239,<->,144.108.64.179,1,71,0,0,1,71,0.909595000,0.0000
33.122.93.211,<->,20.4.216.75,0,0,1,70,1,70,0.909421000,0.0000
241.193.172.231,<->,20.16.120.95,0,0,1,50,1,50,0.909123000,0.0000
111.151.142.211,<->,8.252.221.232,0,0,1,56,1,56,0.908697000,0.0000
198.158.197.83,<->,20.145.24.31,0,0,1,50,1,50,0.908592000,0.0000
155.134.111.140,<->,20.227.82.82,0,0,1,99,1,99,0.908576000,0.0000
21.15.226.126,<->,20.193.59.231,0,0,1,82,1,82,0.907632000,0.0000
100.93.121.49,<->,27.2.218.0,1,141,0,0,1,141,0.907570000,0.0000
215.158.238.233,<->,111.151.142.235,1,100,0,0,1,100,0.907448000,0.0000
123.97.227.2,<->,20.40.6.226,0,0,1,50,1,50,0.907344000,0.0000
149.199.215.87,<->,20.163.13.184,0,0,1,52,1,52,0.907100000,0.0000
109.14.213.84,<->,80.56.78.208,0,0,1,76,1,76,0.906991000,0.0000
215.158.239.92,<->,199.20.6.85,1,56,0,0,1,56,0.906937000,0.0000
215.158.239.77,<->,196.108.88.245,1,586,0,0,1,586,0.906546000,0.0000
89.183.104.128,<->,29.122.193.23,1,64,0,0,1,64,0.906331000,0.0000
140.147.61.107,<->,34.6.219.234,0,0,1,60,1,60,0.906202000,0.0000
129.236.115.172,<->,98.236.245.223,0,0,1,81,1,81,0.906042000,0.0000
53.200.217.243,<->,48.54.89.201,0,0,1,50,1,50,0.905900000,0.0000
137.68.217.95,<->,20.209.165.97,0,0,1,64,1,64,0.905588000,0.0000
192.64.114.92,<->,119.33.213.28,1,74,0,0,1,74,0.905553000,0.0000
204.183.160.72,<->,39.22.75.169,0,0,1,98,1,98,0.905482000,0.0000
139.163.26.146,<->,136.91.153.222,1,99,0,0,1,99,0.905339000,0.0000
207.62.133.51,<->,136.25.188.239,0,0,1,56,1,56,0.905140000,0.0000
120.246.107.53,<->,20.31.122.71,0,0,1,64,1,64,0.905023000,0.0000
21.15.226.126,<->,20.193.59.225,0,0,1,82,1,82,0.904832000,0.0000
129.236.120.197,<->,101.120.23.64,0,0,1,497,1,497,0.904416000,0.0000
207.57.43.17,<->,136.25.188.241,0,0,1,56,1,56,0.904319000,0.0000
231.137.251.216,<->,136.25.188.52,0,0,1,50,1,50,0.904214000,0.0000
144.75.218.242,<->,138.127.225.198,1,289,0,0,1,289,0.904043000,0.0000
250.50.34.183,<->,39.200.95.54,0,0,1,50,1,50,0.903873000,0.0000
144.76.46.38,<->,100.93.18.30,0,0,1,130,1,130,0.903496000,0.0000
215.158.238.205,<->,126.219.128.233,1,704,0,0,1,704,0.903455000,0.0000
80.41.21.72,<->,66.245.95.147,1,135,0,0,1,135,0.903421000,0.0000
215.158.140.184,<->,98.249.65.3,1,50,0,0,1,50,0.902793000,0.0000
196.15.212.97,<->,20.97.98.198,0,0,1,60,1,60,0.902624000,0.0000
132.249.71.156,<->,102.51.175.212,0,0,1,56,1,56,0.902560000,0.0000
195.68.224.24,<->,136.25.188.222,0,0,1,64,1,64,0.900836000,0.0000
136.25.188.80,<->,111.151.106.254,1,100,0,0,1,100,0.900831000,0.0000
105.69.173.13,<->,20.227.80.48,0,0,1,64,1,64,0.900666000,0.0000
121.235.141.249,<->,80.42.173.192,0,0,1,141,1,141,0.900482000,0.0000
241.193.172.231,<->,20.156.149.172,0,0,1,50,1,50,0.899804000,0.0000
122.131.226.250,<->,39.145.119.9,0,0,1,64,1,64,0.899772000,0.0000
38.191.127.133,<->,20.76.243.231,0,0,1,52,1,52,0.899337000,0.0000
215.158.239.92,<->,199.20.29.8,1,64,0,0,1,64,0.899303000,0.0000
109.1.16.221,<->,27.188.163.162,1,444,0,0,1,444,0.899235000,0.0000
138.98.157.82,<->,82.230.230.8,1,50,0,0,1,50,0.899169000,0.0000
222.76.103.168,<->,66.26.4.171,1,73,0,0,1,73,0.898710000,0.0000
255.133.229.164,<->,39.23.81.12,0,0,1,100,1,100,0.898693000,0.0000
221.95.55.203,<->,77.16.192.127,1,94,0,0,1,94,0.898429000,0.0000
215.158.103.206,<->,119.159.23.44,1,83,0,0,1,83,0.897983000,0.0000
215.158.140.207,<->,134.3.169.245,1,56,0,0,1,56,0.897618000,0.0000
227.20.65.122,<->,205.41.7.4,1,52,0,0,1,52,0.897355000,0.0000
159.115.27.135,<->,140.17.122.242,1,50,0,0,1,50,0.897292000,0.0000
204.61.12.222,<->,136.25.188.236,0,0,1,56,1,56,0.897257000,0.0000
206.60.37.109,<->,192.64.195.195,0,0,1,56,1,56,0.896882000,0.0000
133.32.39.8,<->,111.150.207.168,1,100,0,0,1,100,0.896857000,0.0000
106.248.210.12,<->,101.224.186.79,0,0,1,57,1,57,0.896800000,0.0000
223.138.247.86,<->,92.27.219.165,0,0,1,52,1,52,0.896663000,0.0000
123.156.103.111,<->,20.238.136.83,0,0,1,64,1,64,0.896535000,0.0000
195.68.160.70,<->,136.25.188.162,0,0,1,50,1,50,0.896304000,0.0000
215.158.239.93,<->,199.20.30.86,1,64,0,0,1,64,0.896001000,0.0000
144.75.218.242,<->,138.57.179.198,1,102,0,0,1,102,0.895987000,0.0000
215.158.239.103,<->,8.50.118.106,1,111,0,0,1,111,0.895749000,0.0000
133.77.211.180,<->,98.67.130.55,0,0,1,50,1,50,0.895664000,0.0000
136.25.188.161,<->,89.93.82.60,1,56,0,0,1,56,0.894995000,0.0000
215.158.239.84,<->,199.20.29.219,1,56,0,0,1,56,0.894903000,0.0000
144.93.134.237,<->,19.249.77.2,1,76,0,0,1,76,0.894619000,0.0000
135.80.142.179,<->,50.224.76.248,0,0,1,50,1,50,0.894515000,0.0000
109.222.243.255,<->,104.77.185.182,1,97,0,0,1,97,0.894460000,0.0000
103.56.162.76,<->,92.27.219.175,0,0,1,52,1,52,0.894282000,0.0000
105.140.23.31,<->,20.121.178.55,0,0,1,64,1,64,0.894196000,0.0000
74.17.214.117,<->,66.11.15.28,0,0,1,130,1,130,0.894141000,0.0000
102.168.7.100,<->,8.220.205.146,0,0,1,50,1,50,0.894015000,0.0000
105.83.153.163,<->,20.206.222.97,0,0,1,64,1,64,0.893721000,0.0000
42.47.112.146,<->,20.191.140.132,0,0,1,64,1,64,0.893527000,0.0000
21.15.226.126,<->,20.193.59.219,0,0,1,82,1,82,0.893506000,0.0000
207.60.250.4,<->,136.25.188.54,0,0,1,50,1,50,0.893463000,0.0000
97.126.24.188,<->,50.239.27.120,1,269,0,0,1,269,0.892987000,0.0000
198.158.197.83,<->,20.153.20.57,0,0,1,50,1,50,0.892847000,0.0000
192.67.138.66,<->,122.111.197.164,1,209,0,0,1,209,0.892620000,0.0000
118.34.147.242,<->,20.223.212.74,0,0,1,100,1,100,0.892053000,0.0000
149.172.146.71,<->,8.52.254.194,0,0,1,1002,1,1002,0.892011000,0.0000
133.178.226.245,<->,111.151.109.35,1,100,0,0,1,100,0.891989000,0.0000
131.144.248.196,<->,129.224.112.252,0,0,1,79,1,79,0.891865000,0.0000
99.160.127.69,<->,92.27.219.138,0,0,1,330,1,330,0.891294000,0.0000
221.102.154.17,<->,192.64.236.238,0,0,1,141,1,141,0.891117000,0.0000
104.143.10.103,<->,100.92.94.147,0,0,1,64,1,64,0.890970000,0.0000
144.75.218.242,<->,8.4.159.141,1,130,0,0,1,130,0.890621000,0.0000
207.57.180.6,<->,136.25.188.46,0,0,1,669,1,669,0.890207000,0.0000
96.31.78.38,<->,8.188.179.4,1,68,0,0,1,68,0.889663000,0.0000
159.69.187.8,<->,144.108.64.179,1,72,0,0,1,72,0.889592000,0.0000
215.158.239.74,<->,133.73.8.230,1,84,0,0,1,84,0.889573000,0.0000
137.194.170.5,<->,129.78.116.244,0,0,1,84,1,84,0.889505000,0.0000
194.233.92.141,<->,136.25.188.177,0,0,1,68,1,68,0.889466000,0.0000
127.169.192.137,<->,39.243.241.119,0,0,1,64,1,64,0.889391000,0.0000
117.156.53.41,<->,100.92.40.90,0,0,1,56,1,56,0.889326000,0.0000
215.158.238.133,<->,104.3.168.149,1,1341,0,0,1,1341,0.889288000,0.0000
215.158.239.58,<->,196.92.10.218,1,56,0,0,1,56,0.889268000,0.0000
80.40.34.240,<->,50.248.185.204,1,353,0,0,1,353,0.889062000,0.0000
104.143.10.103,<->,100.92.94.163,0,0,1,64,1,64,0.888577000,0.0000
215.158.43.138,<->,133.178.227.119,0,0,1,93,1,93,0.888323000,0.0000
207.236.200.87,<->,136.25.188.176,0,0,1,56,1,56,0.888294000,0.0000
145.242.126.212,<->,129.34.149.207,1,84,0,0,1,84,0.888094000,0.0000
208.238.232.243,<->,39.237.178.121,0,0,1,64,1,64,0.887969000,0.0000
195.55.44.213,<->,136.25.188.227,0,0,1,50,1,50,0.887918000,0.0000
148.189.137.47,<->,8.43.208.242,0,0,1,704,1,704,0.887813000,0.0000
139.193.141.139,<->,106.216.64.64,1,56,0,0,1,56,0.887664000,0.0000
215.158.239.49,<->,195.6.27.5,1,50,0,0,1,50,0.887447000,0.0000
97.27.254.35,<->,8.52.189.207,0,0,1,50,1,50,0.887243000,0.0000
159.167.254.101,<->,56.121.44.13,0,0,1,50,1,50,0.887218000,0.0000
212.118.0.79,<->,144.75.218.235,0,0,1,91,1,91,0.887099000,0.0000
139.1.221.199,<->,8.52.129.50,0,0,1,1002,1,1002,0.887031000,0.0000
111.73.148.160,<->,80.40.57.96,0,0,1,213,1,213,0.887030000,0.0000
199.25.155.118,<->,39.13.199.97,0,0,1,103,1,103,0.886896000,0.0000
120.178.130.146,<->,20.212.190.189,0,0,1,75,1,75,0.886787000,0.0000
104.143.10.103,<->,100.92.94.144,0,0,1,64,1,64,0.886707000,0.0000
107.252.198.177,<->,39.152.58.6,0,0,1,60,1,60,0.886236000,0.0000
195.5.155.158,<->,136.25.188.227,0,0,1,68,1,68,0.886219000,0.0000
53.250.138.165,<->,39.15.169.14,0,0,1,86,1,86,0.886182000,0.0000
139.163.26.146,<->,113.123.210.253,1,111,0,0,1,111,0.885906000,0.0000
136.25.188.53,<->,80.47.111.87,1,56,0,0,1,56,0.885295000,0.0000
207.60.250.4,<->,136.25.188.253,0,0,1,50,1,50,0.885288000,0.0000
130.196.240.215,<->,89.183.104.135,0,0,1,52,1,52,0.885049000,0.0000
215.158.239.56,<->,199.20.7.138,1,56,0,0,1,56,0.884900000,0.0000
98.158.149.215,<->,50.224.76.248,0,0,1,50,1,50,0.884723000,0.0000
136.25.188.198,<->,35.111.182.92,1,56,0,0,1,56,0.884574000,0.0000
144.75.218.241,<->,66.90.38.226,1,159,0,0,1,159,0.884526000,0.0000
215.158.239.95,<->,207.190.47.35,1,68,0,0,1,68,0.884411000,0.0000
139.163.66.167,<->,98.204.166.50,1,50,0,0,1,50,0.884346000,0.0000
111.147.75.52,<->,50.145.12.104,1,50,0,0,1,50,0.884336000,0.0000
105.67.125.59,<->,20.161.75.111,0,0,1,64,1,64,0.884298000,0.0000
247.136.150.11,<->,88.13.7.38,1,55,0,0,1,55,0.884247000,0.0000
145.129.253.82,<->,39.35.177.63,0,0,1,86,1,86,0.883979000,0.0000
199.73.232.192,<->,136.25.188.174,0,0,1,56,1,56,0.883920000,0.0000
192.64.217.166,<->,125.16.223.239,1,52,0,0,1,52,0.883752000,0.0000
198.158.197.83,<->,20.132.154.236,0,0,1,50,1,50,0.883584000,0.0000
144.75.218.235,<->,138.127.225.146,1,276,0,0,1,276,0.883449000,0.0000
215.158.132.144,<->,6.228.6.58,0,0,1,102,1,102,0.883296000,0.0000
204.26.38.62,<->,39.254.248.197,0,0,1,50,1,50,0.883130000,0.0000
113.141.205.248,<->,20.76.92.16,0,0,1,64,1,64,0.883092000,0.0000
144.75.218.235,<->,139.252.1.253,1,148,0,0,1,148,0.883014000,0.0000
158.3.225.249,<->,39.173.190.174,0,0,1,64,1,64,0.882951000,0.0000
205.106.90.26,<->,192.66.168.179,0,0,1,50,1,50,0.882828000,0.0000
21.15.226.126,<->,20.193.59.83,0,0,1,82,1,82,0.882785000,0.0000
132.18.67.31,<->,100.93.216.39,0,0,1,56,1,56,0.882735000,0.0000
248.225.26.243,<->,100.185.121.91,1,236,0,0,1,236,0.882702000,0.0000
76.72.228.64,<->,39.164.106.173,0,0,1,64,1,64,0.882695000,0.0000
200.175.71.90,<->,53.148.184.48,1,50,0,0,1,50,0.882588000,0.0000
144.75.218.241,<->,6.73.13.34,1,288,0,0,1,288,0.882326000,0.0000
195.54.136.129,<->,136.25.188.44,0,0,1,50,1,50,0.882315000,0.0000
142.43.184.230,<->,39.166.182.173,0,0,1,64,1,64,0.882183000,0.0000
133.178.226.30,<->,69.150.169.247,1,56,0,0,1,56,0.882167000,0.0000
104.143.10.103,<->,100.92.94.172,0,0,1,64,1,64,0.882082000,0.0000
199.37.89.181,<->,39.21.251.25,0,0,1,52,1,52,0.882049000,0.0000
204.51.210.14,<->,39.8.146.234,0,0,1,60,1,60,0.881971000,0.0000
224.213.241.201,<->,144.75.218.242,0,0,1,336,1,336,0.881757000,0.0000
144.69.82.139,<->,33.98.46.95,1,73,0,0,1,73,0.881623000,0.0000
145.16.95.20,<->,111.151.138.245,1,68,0,0,1,68,0.881575000,0.0000
82.246.87.234,<->,20.237.75.42,0,0,1,91,1,91,0.881303000,0.0000
255.133.229.164,<->,39.138.56.223,0,0,1,100,1,100,0.881174000,0.0000
109.1.17.6,<->,27.188.163.162,1,446,0,0,1,446,0.881130000,0.0000
136.25.188.105,<->,98.114.18.76,1,140,0,0,1,140,0.881104000,0.0000
76.101.165.75,<->,8.252.222.141,0,0,1,68,1,68,0.880866000,0.0000
251.122.146.57,<->,136.41.13.4,0,0,1,116,1,116,0.880813000,0.0000
148.215.222.173,<->,136.25.188.105,0,0,1,143,1,143,0.880573000,0.0000
56.20.54.141,<->,20.246.199.217,0,0,1,91,1,91,0.880440000,0.0000
142.236.2.116,<->,136.25.188.226,0,0,1,50,1,50,0.880063000,0.0000
196.246.70.156,<->,136.25.188.54,0,0,1,56,1,56,0.879782000,0.0000
198.158.197.83,<->,20.50.24.69,0,0,1,50,1,50,0.879553000,0.0000
144.75.218.241,<->,97.94.119.43,1,72,0,0,1,72,0.879354000,0.0000
133.178.227.214,<->,89.77.198.191,1,156,0,0,1,156,0.879326000,0.0000
144.76.46.38,<->,100.92.64.28,0,0,1,168,1,168,0.879237000,0.0000
196.250.234.88,<->,20.140.166.126,0,0,1,64,1,64,0.878995000,0.0000
210.220.219.179,<->,8.232.198.216,1,242,0,0,1,242,0.878876000,0.0000
207.204.114.71,<->,102.51.41.126,0,0,1,135,1,135,0.878387000,0.0000
122.158.177.249,<->,8.220.197.41,0,0,1,704,1,704,0.878186000,0.0000
144.86.144.4,<->,4.187.50.170,1,80,0,0,1,80,0.877823000,0.0000
215.158.103.219,<->,92.57.203.43,1,154,0,0,1,154,0.877656000,0.0000
110.65.132.226,<->,92.27.219.189,0,0,1,325,1,325,0.877621000,0.0000
133.32.39.0,<->,111.151.142.130,1,56,0,0,1,56,0.877529000,0.0000
21.15.226.126,<->,20.193.59.179,0,0,1,82,1,82,0.877525000,0.0000
134.198.176.78,<->,20.224.160.101,0,0,1,103,1,103,0.877133000,0.0000
194.210.64.211,<->,8.182.224.87,0,0,1,50,1,50,0.877124000,0.0000
109.222.250.222,<->,18.69.22.36,1,74,0,0,1,74,0.876525000,0.0000
130.13.216.49,<->,39.18.45.147,0,0,1,80,1,80,0.876274000,0.0000
136.25.188.42,<->,128.156.85.186,1,56,0,0,1,56,0.876210000,0.0000
194.210.66.160,<->,8.182.241.177,0,0,1,50,1,50,0.876205000,0.0000
114.187.169.221,<->,111.147.75.13,0,0,1,64,1,64,0.875839000,0.0000
111.151.237.34,<->,97.183.199.229,0,0,1,50,1,50,0.875688000,0.0000
138.127.229.13,<->,133.32.2.38,0,0,1,240,1,240,0.875253000,0.0000
133.171.115.67,<->,131.133.154.154,1,84,0,0,1,84,0.875098000,0.0000
192.67.227.187,<->,8.52.178.109,0,0,1,50,1,50,0.874478000,0.0000
222.76.40.76,<->,8.52.185.168,0,0,1,50,1,50,0.874095000,0.0000
132.103.198.192,<->,119.121.24.104,1,64,0,0,1,64,0.874058000,0.0000
210.158.44.231,<->,109.119.182.216,1,119,0,0,1,119,0.873868000,0.0000
195.59.215.206,<->,100.93.81.9,0,0,1,130,1,130,0.873765000,0.0000
110.5.186.21,<->,109.222.218.217,0,0,1,80,1,80,0.873645000,0.0000
126.242.231.201,<->,20.204.244.171,0,0,1,64,1,64,0.873632000,0.0000
244.50.135.57,<->,39.214.147.229,0,0,1,50,1,50,0.873273000,0.0000
192.67.154.172,<->,109.97.32.1,1,52,0,0,1,52,0.873044000,0.0000
89.183.104.243,<->,18.203.228.30,1,1456,0,0,1,1456,0.872349000,0.0000
207.64.196.54,<->,8.182.226.78,0,0,1,50,1,50,0.872337000,0.0000
152.43.101.238,<->,8.252.221.197,0,0,1,50,1,50,0.872246000,0.0000
117.220.20.168,<->,108.134.118.71,0,0,1,60,1,60,0.871557000,0.0000
246.253.248.211,<->,53.150.231.79,1,89,0,0,1,89,0.871457000,0.0000
144.122.240.200,<->,144.108.80.170,1,74,0,0,1,74,0.870900000,0.0000
210.221.107.50,<->,111.151.237.14,1,64,0,0,1,64,0.870624000,0.0000
206.55.134.66,<->,80.42.140.207,0,0,1,121,1,121,0.870165000,0.0000
215.158.238.85,<->,141.204.127.17,1,772,0,0,1,772,0.869915000,0.0000
58.46.203.2,<->,20.151.73.24,0,0,1,76,1,76,0.869761000,0.0000
140.17.122.243,<->,39.3.77.163,0,0,1,50,1,50,0.869538000,0.0000
192.67.161.146,<->,74.252.52.17,1,77,0,0,1,77,0.869213000,0.0000
207.173.170.28,<->,136.25.188.254,0,0,1,56,1,56,0.869134000,0.0000
247.136.236.50,<->,113.207.254.105,1,280,0,0,1,280,0.868652000,0.0000
145.3.142.7,<->,39.237.228.203,0,0,1,64,1,64,0.868384000,0.0000
124.42.155.231,<->,109.112.164.94,0,0,1,64,1,64,0.868126000,0.0000
192.64.250.118,<->,112.90.36.143,1,279,0,0,1,279,0.868024000,0.0000
119.42.194.105,<->,39.139.143.112,0,0,1,76,1,76,0.867819000,0.0000
21.15.226.126,<->,20.193.59.5,0,0,1,82,1,82,0.867497000,0.0000
8.182.227.180,<->,6.33.10.25,1,50,0,0,1,50,0.867113000,0.0000
195.55.176.8,<->,136.25.188.55,0,0,1,50,1,50,0.867065000,0.0000
98.67.140.71,<->,91.42.246.36,1,56,0,0,1,56,0.867015000,0.0000
194.107.4.209,<->,20.179.253.120,0,0,1,64,1,64,0.866753000,0.0000
38.21.156.204,<->,20.232.228.55,0,0,1,82,1,82,0.866738000,0.0000
109.121.177.146,<->,69.171.220.179,1,133,0,0,1,133,0.866378000,0.0000
139.163.26.146,<->,104.189.27.196,1,157,0,0,1,157,0.865639000,0.0000
231.140.203.139,<->,136.25.188.227,0,0,1,50,1,50,0.865487000,0.0000
137.68.217.95,<->,20.209.165.94,0,0,1,64,1,64,0.865157000,0.0000
204.62.246.213,<->,136.25.188.225,0,0,1,64,1,64,0.864957000,0.0000
141.203.81.200,<->,20.151.228.71,0,0,1,75,1,75,0.864744000,0.0000
109.1.37.147,<->,105.201.228.55,1,56,0,0,1,56,0.864564000,0.0000
148.74.255.93,<->,20.146.20.10,0,0,1,70,1,70,0.864367000,0.0000
132.51.6.250,<->,22.34.2.52,1,186,0,0,1,186,0.863690000,0.0000
148.162.54.31,<->,35.56.102.252,0,0,1,138,1,138,0.863682000,0.0000
92.27.219.18,<->,33.57.77.143,1,52,0,0,1,52,0.863664000,0.0000
210.104.195.137,<->,133.178.226.254,0,0,1,90,1,90,0.863439000,0.0000
109.222.250.37,<->,8.232.74.206,1,296,0,0,1,296,0.863256000,0.0000
105.115.183.34,<->,100.93.179.222,0,0,1,106,1,106,0.863114000,0.0000
192.171.13.188,<->,109.222.230.12,0,0,1,98,1,98,0.863032000,0.0000
144.75.218.237,<->,138.127.230.158,1,202,0,0,1,202,0.862627000,0.0000
198.158.197.83,<->,20.188.175.160,0,0,1,50,1,50,0.862574000,0.0000
154.151.15.59,<->,39.26.64.156,0,0,1,52,1,52,0.862543000,0.0000
230.63.142.3,<->,91.251.82.156,0,0,1,130,1,130,0.862293000,0.0000
159.48.29.115,<->,8.220.233.76,0,0,1,50,1,50,0.862038000,0.0000
127.179.247.114,<->,39.223.193.152,0,0,1,56,1,56,0.861934000,0.0000
204.21.237.232,<->,8.220.176.253,0,0,1,50,1,50,0.861842000,0.0000
159.64.148.27,<->,29.211.214.82,0,0,1,89,1,89,0.861368000,0.0000
122.34.93.206,<->,89.183.104.135,0,0,1,52,1,52,0.861312000,0.0000
128.156.85.146,<->,8.176.8.208,0,0,1,100,1,100,0.861145000,0.0000
215.158.239.92,<->,142.221.190.192,1,50,0,0,1,50,0.861145000,0.0000
98.67.140.71,<->,53.240.86.156,1,56,0,0,1,56,0.861024000,0.0000
215.158.239.57,<->,199.20.29.100,1,172,0,0,1,172,0.860772000,0.0000
27.179.156.245,<->,8.53.15.23,0,0,1,84,1,84,0.860624000,0.0000
215.158.239.78,<->,196.93.169.71,1,64,0,0,1,64,0.860573000,0.0000
215.158.239.97,<->,196.89.34.232,1,56,0,0,1,56,0.860233000,0.0000
227.23.98.210,<->,89.183.104.150,0,0,1,52,1,52,0.860078000,0.0000
144.75.222.203,<->,144.69.82.139,0,0,1,74,1,74,0.860053000,0.0000
109.222.241.155,<->,98.197.187.143,1,56,0,0,1,56,0.860039000,0.0000
195.43.49.234,<->,136.25.188.196,0,0,1,56,1,56,0.860038000,0.0000
27.76.37.32,<->,8.31.37.163,0,0,1,56,1,56,0.859822000,0.0000
119.90.251.239,<->,39.249.192.126,0,0,1,50,1,50,0.859663000,0.0000
159.176.32.29,<->,144.75.218.246,0,0,1,76,1,76,0.859532000,0.0000
111.154.13.141,<->,109.222.255.85,0,0,1,78,1,78,0.859318000,0.0000
159.69.187.19,<->,144.108.80.170,1,73,0,0,1,73,0.859196000,0.0000
120.179.77.216,<->,39.57.6.254,0,0,1,52,1,52,0.859052000,0.0000
192.97.212.177,<->,8.52.186.210,0,0,1,50,1,50,0.858277000,0.0000
221.98.77.247,<->,146.196.193.192,1,84,0,0,1,84,0.858180000,0.0000
215.158.239.68,<->,199.20.30.187,1,56,0,0,1,56,0.857917000,0.0000
197.113.99.197,<->,136.25.188.242,0,0,1,132,1,132,0.857703000,0.0000
207.100.101.153,<->,108.134.119.253,0,0,1,56,1,56,0.857660000,0.0000
144.75.218.242,<->,132.156.82.239,1,156,0,0,1,156,0.857628000,0.0000
144.75.218.241,<->,138.127.224.140,1,365,0,0,1,365,0.857374000,0.0000
39.39.105.200,<->,33.236.38.254,1,52,0,0,1,52,0.857140000,0.0000
132.168.198.210,<->,116.173.88.56,1,72,0,0,1,72,0.856981000,0.0000
138.127.231.62,<->,97.126.26.70,0,0,1,282,1,282,0.856774000,0.0000
133.178.226.160,<->,111.151.107.208,1,100,0,0,1,100,0.856717000,0.0000
144.75.218.241,<->,138.127.230.136,1,366,0,0,1,366,0.856635000,0.0000
80.40.72.239,<->,8.45.175.127,1,56,0,0,1,56,0.856566000,0.0000
144.75.218.242,<->,132.43.156.81,1,154,0,0,1,154,0.856406000,0.0000
20.13.109.215,<->,0.200.50.50,1,60,0,0,1,60,0.856336000,0.0000
192.64.196.112,<->,119.219.188.63,1,52,0,0,1,52,0.855985000,0.0000
144.75.218.237,<->,53.245.2.193,1,110,0,0,1,110,0.855571000,0.0000
195.13.80.89,<->,136.25.188.243,0,0,1,64,1,64,0.855543000,0.0000
144.75.218.233,<->,138.127.230.12,1,186,0,0,1,186,0.855276000,0.0000
241.193.172.231,<->,20.180.137.87,0,0,1,50,1,50,0.854955000,0.0000
144.75.218.233,<->,108.134.82.93,1,206,0,0,1,206,0.854228000,0.0000
198.70.220.74,<->,39.134.146.48,0,0,1,72,1,72,0.854053000,0.0000
122.145.210.242,<->,80.42.179.209,0,0,1,133,1,133,0.853892000,0.0000
124.69.27.27,<->,39.12.84.160,0,0,1,74,1,74,0.853679000,0.0000
129.224.112.252,<->,114.187.51.237,1,72,0,0,1,72,0.853364000,0.0000
136.181.47.216,<->,53.190.247.74,1,93,0,0,1,93,0.853154000,0.0000
247.136.154.209,<->,38.173.226.37,1,52,0,0,1,52,0.852862000,0.0000
222.62.219.94,<->,48.53.227.245,0,0,1,321,1,321,0.852850000,0.0000
121.20.242.142,<->,111.146.147.173,0,0,1,345,1,345,0.852601000,0.0000
114.255.181.160,<->,20.215.62.54,0,0,1,52,1,52,0.852391000,0.0000
111.151.142.230,<->,99.74.87.242,0,0,1,56,1,56,0.852270000,0.0000
97.53.59.77,<->,8.182.251.218,0,0,1,50,1,50,0.852131000,0.0000
235.231.66.42,<->,92.27.219.33,0,0,1,351,1,351,0.851488000,0.0000
212.164.131.166,<->,75.62.16.8,1,50,0,0,1,50,0.851151000,0.0000
215.158.239.94,<->,199.20.31.45,1,1125,0,0,1,1125,0.850899000,0.0000
98.246.18.142,<->,20.178.79.194,0,0,1,50,1,50,0.850672000,0.0000
134.103.235.251,<->,133.54.22.122,0,0,1,50,1,50,0.850412000,0.0000
100.182.99.11,<->,20.179.123.251,0,0,1,52,1,52,0.850114000,0.0000
222.254.150.132,<->,144.75.218.233,0,0,1,128,1,128,0.849924000,0.0000
75.62.16.8,<->,39.247.34.142,0,0,1,50,1,50,0.849705000,0.0000
144.75.218.246,<->,136.144.124.253,1,77,0,0,1,77,0.849681000,0.0000
204.185.45.0,<->,136.25.188.163,0,0,1,56,1,56,0.848854000,0.0000
21.15.226.126,<->,20.193.59.46,0,0,1,82,1,82,0.848657000,0.0000
247.136.152.218,<->,125.149.87.164,1,56,0,0,1,56,0.848499000,0.0000
215.158.61.191,<->,8.176.8.178,0,0,1,1421,1,1421,0.848495000,0.0000
204.185.97.231,<->,136.25.188.255,0,0,1,64,1,64,0.848337000,0.0000
215.158.239.78,<->,204.226.94.126,1,56,0,0,1,56,0.848276000,0.0000
105.66.35.149,<->,20.0.44.117,0,0,1,64,1,64,0.848267000,0.0000
144.75.218.237,<->,102.45.225.190,1,85,0,0,1,85,0.848203000,0.0000
72.156.97.240,<->,0.195.210.42,0,0,1,50,1,50,0.847692000,0.0000
215.158.239.68,<->,196.0.167.105,1,50,0,0,1,50,0.847312000,0.0000
124.29.255.45,<->,20.253.243.204,0,0,1,64,1,64,0.847161000,0.0000
80.28.242.225,<->,8.52.182.119,0,0,1,50,1,50,0.847103000,0.0000
93.90.89.141,<->,80.40.45.77,0,0,1,52,1,52,0.847058000,0.0000
100.182.99.11,<->,20.179.124.117,0,0,1,52,1,52,0.846955000,0.0000
112.75.196.109,<->,92.27.219.43,0,0,1,325,1,325,0.846815000,0.0000
17.115.168.36,<->,8.53.4.76,0,0,1,50,1,50,0.846125000,0.0000
215.158.239.57,<->,142.241.222.107,1,56,0,0,1,56,0.845687000,0.0000
144.75.218.233,<->,138.127.230.53,1,365,0,0,1,365,0.845649000,0.0000
93.104.212.227,<->,39.246.79.97,0,0,1,64,1,64,0.845583000,0.0000
197.113.99.125,<->,136.25.188.46,0,0,1,56,1,56,0.845466000,0.0000
215.158.239.99,<->,199.68.10.148,1,50,0,0,1,50,0.845429000,0.0000
121.36.34.191,<->,92.27.219.171,0,0,1,135,1,135,0.845173000,0.0000
142.255.125.144,<->,136.25.188.209,0,0,1,56,1,56,0.845027000,0.0000
231.143.181.188,<->,136.25.188.175,0,0,1,64,1,64,0.844856000,0.0000
136.25.189.4,<->,98.219.126.140,1,56,0,0,1,56,0.844813000,0.0000
93.146.42.245,<->,20.108.207.79,0,0,1,64,1,64,0.844738000,0.0000
195.68.119.111,<->,136.25.188.197,0,0,1,56,1,56,0.844645000,0.0000
122.195.249.211,<->,50.224.76.234,0,0,1,50,1,50,0.844631000,0.0000
194.253.180.29,<->,8.182.243.35,0,0,1,50,1,50,0.844592000,0.0000
215.158.239.93,<->,207.191.38.140,1,56,0,0,1,56,0.844490000,0.0000
138.23.113.45,<->,78.128.203.59,1,151,0,0,1,151,0.844349000,0.0000
133.33.130.54,<->,80.27.157.123,0,0,1,50,1,50,0.844218000,0.0000
115.119.23.83,<->,39.28.201.8,0,0,1,52,1,52,0.844090000,0.0000
126.224.165.180,<->,20.52.19.42,0,0,1,64,1,64,0.844046000,0.0000
111.146.149.244,<->,53.149.29.29,1,125,0,0,1,125,0.844034000,0.0000
115.85.241.227,<->,0.195.210.15,0,0,1,158,1,158,0.843955000,0.0000
221.102.143.189,<->,80.41.80.157,0,0,1,141,1,141,0.843740000,0.0000
115.119.54.194,<->,39.45.140.204,0,0,1,52,1,52,0.843204000,0.0000
138.127.231.249,<->,97.126.26.71,0,0,1,282,1,282,0.843000000,0.0000
144.122.240.213,<->,144.108.64.179,1,70,0,0,1,70,0.842923000,0.0000
109.1.2.246,<->,26.218.94.112,1,50,0,0,1,50,0.842902000,0.0000
215.158.103.206,<->,138.127.230.24,1,259,0,0,1,259,0.842225000,0.0000
207.58.247.223,<->,136.25.188.253,0,0,1,50,1,50,0.842219000,0.0000
111.147.208.7,<->,53.214.99.190,1,56,0,0,1,56,0.842186000,0.0000
245.127.125.163,<->,0.195.210.43,0,0,1,50,1,50,0.842115000,0.0000
200.174.205.190,<->,53.160.87.174,1,56,0,0,1,56,0.842089000,0.0000
136.181.53.35,<->,104.140.75.204,1,135,0,0,1,135,0.841924000,0.0000
215.158.140.205,<->,109.217.123.11,1,50,0,0,1,50,0.841670000,0.0000
144.75.218.241,<->,132.43.156.56,1,151,0,0,1,151,0.841628000,0.0000
114.172.236.63,<->,92.27.219.232,0,0,1,60,1,60,0.841470000,0.0000
91.206.247.51,<->,56.121.46.220,0,0,1,68,1,68,0.840941000,0.0000
232.31.132.12,<->,102.51.170.190,0,0,1,52,1,52,0.840931000,0.0000
98.128.233.83,<->,64.146.18.101,1,130,0,0,1,130,0.840794000,0.0000
252.189.81.45,<->,8.182.226.78,0,0,1,50,1,50,0.840738000,0.0000
237.177.159.56,<->,20.178.201.238,0,0,1,64,1,64,0.840525000,0.0000
207.225.144.168,<->,192.224.198.242,0,0,1,704,1,704,0.840363000,0.0000
215.158.61.191,<->,8.176.8.183,0,0,1,1197,1,1197,0.840360000,0.0000
192.67.152.0,<->,38.170.162.131,1,52,0,0,1,52,0.839716000,0.0000
109.222.250.219,<->,99.237.92.17,1,341,0,0,1,341,0.839545000,0.0000
220.28.104.193,<->,136.25.188.213,0,0,1,56,1,56,0.839418000,0.0000
215.158.103.206,<->,138.127.230.221,1,84,0,0,1,84,0.839394000,0.0000
100.182.234.231,<->,8.52.132.185,0,0,1,50,1,50,0.839315000,0.0000
145.242.126.85,<->,144.75.221.206,1,81,0,0,1,81,0.839181000,0.0000
111.151.142.191,<->,98.232.172.88,0,0,1,64,1,64,0.838783000,0.0000
220.55.101.100,<->,128.203.247.101,1,76,0,0,1,76,0.838751000,0.0000
97.243.223.84,<->,6.75.250.3,0,0,1,193,1,193,0.838502000,0.0000
215.158.239.92,<->,196.89.67.83,1,50,0,0,1,50,0.838344000,0.0000
113.129.159.40,<->,89.183.104.132,0,0,1,52,1,52,0.838310000,0.0000
111.181.118.201,<->,8.55.195.124,1,141,0,0,1,141,0.838229000,0.0000
109.222.211.98,<->,53.188.156.97,1,56,0,0,1,56,0.837952000,0.0000
158.164.134.203,<->,39.32.36.250,0,0,1,72,1,72,0.837096000,0.0000
111.147.117.247,<->,54.37.105.75,1,50,0,0,1,50,0.837094000,0.0000
109.222.230.140,<->,54.38.71.73,1,56,0,0,1,56,0.836975000,0.0000
159.57.90.68,<->,97.199.170.13,0,0,1,50,1,50,0.836555000,0.0000
144.122.240.201,<->,144.108.64.183,1,63,0,0,1,63,0.836541000,0.0000
144.122.240.197,<->,144.108.80.170,1,72,0,0,1,72,0.836109000,0.0000
111.146.151.210,<->,17.61.177.228,1,56,0,0,1,56,0.835644000,0.0000
99.227.90.140,<->,92.27.27.161,0,0,1,52,1,52,0.835578000,0.0000
198.158.197.83,<->,20.18.140.33,0,0,1,50,1,50,0.835414000,0.0000
204.184.91.6,<->,136.25.188.255,0,0,1,272,1,272,0.835166000,0.0000
159.69.187.50,<->,144.108.64.179,1,77,0,0,1,77,0.835014000,0.0000
144.75.218.242,<->,97.68.93.9,1,707,0,0,1,707,0.834017000,0.0000
142.220.235.178,<->,136.25.188.55,0,0,1,50,1,50,0.833876000,0.0000
38.57.77.192,<->,35.32.11.193,0,0,1,52,1,52,0.833415000,0.0000
215.158.239.69,<->,199.20.29.219,1,50,0,0,1,50,0.833253000,0.0000
215.158.238.232,<->,100.216.78.145,1,56,0,0,1,56,0.832982000,0.0000
97.11.170.243,<->,54.58.32.144,1,87,0,0,1,87,0.832938000,0.0000
215.158.239.58,<->,195.80.247.61,1,68,0,0,1,68,0.832898000,0.0000
117.206.109.192,<->,89.183.104.141,0,0,1,62,1,62,0.832871000,0.0000
204.60.25.205,<->,136.25.188.162,0,0,1,68,1,68,0.832562000,0.0000
142.167.108.163,<->,136.25.188.252,0,0,1,653,1,653,0.832553000,0.0000
88.45.148.185,<->,80.40.56.209,0,0,1,135,1,135,0.832530000,0.0000
21.15.226.126,<->,20.193.60.101,0,0,1,82,1,82,0.832396000,0.0000
159.251.74.73,<->,136.25.188.72,0,0,1,1064,1,1064,0.832350000,0.0000
116.95.44.46,<->,80.40.47.132,0,0,1,64,1,64,0.832157000,0.0000
206.249.247.241,<->,20.92.0.241,0,0,1,64,1,64,0.831944000,0.0000
215.158.239.95,<->,199.68.10.148,1,50,0,0,1,50,0.831850000,0.0000
241.193.172.231,<->,20.138.236.64,0,0,1,50,1,50,0.831773000,0.0000
132.168.196.227,<->,126.229.209.161,1,77,0,0,1,77,0.831704000,0.0000
222.65.25.154,<->,132.18.67.29,1,56,0,0,1,56,0.831702000,0.0000
215.158.239.58,<->,199.20.29.180,1,56,0,0,1,56,0.831635000,0.0000
131.5.161.231,<->,20.178.191.238,0,0,1,52,1,52,0.831364000,0.0000
231.255.157.46,<->,215.158.239.117,0,0,1,100,1,100,0.831219000,0.0000
209.91.163.76,<->,8.53.4.76,0,0,1,50,1,50,0.831158000,0.0000
215.158.61.242,<->,136.25.189.210,0,0,1,657,1,657,0.830923000,0.0000
148.247.194.50,<->,20.55.0.110,0,0,1,135,1,135,0.830810000,0.0000
141.125.218.183,<->,132.49.149.140,0,0,1,1424,1,1424,0.830602000,0.0000
204.186.11.67,<->,136.25.188.209,0,0,1,64,1,64,0.830220000,0.0000
204.186.14.136,<->,136.25.188.177,0,0,1,68,1,68,0.830150000,0.0000
159.69.187.49,<->,144.108.80.170,1,78,0,0,1,78,0.830134000,0.0000
126.236.200.252,<->,20.185.108.33,0,0,1,98,1,98,0.829921000,0.0000
111.150.207.202,<->,8.176.8.90,0,0,1,56,1,56,0.829905000,0.0000
100.179.203.102,<->,92.162.252.1,0,0,1,50,1,50,0.829903000,0.0000
129.78.113.144,<->,121.127.151.114,1,50,0,0,1,50,0.829891000,0.0000
198.231.232.65,<->,6.122.154.156,0,0,1,52,1,52,0.829816000,0.0000
119.90.251.239,<->,20.139.108.113,0,0,1,50,1,50,0.829806000,0.0000
159.69.187.42,<->,144.108.80.170,1,71,0,0,1,71,0.829734000,0.0000
113.177.30.121,<->,20.105.243.223,0,0,1,78,1,78,0.829632000,0.0000
38.21.156.204,<->,20.232.228.154,0,0,1,82,1,82,0.829393000,0.0000
120.85.11.244,<->,20.193.179.208,0,0,1,50,1,50,0.828664000,0.0000
109.222.250.107,<->,95.104.59.228,1,50,0,0,1,50,0.828249000,0.0000
115.172.108.243,<->,109.1.46.25,0,0,1,97,1,97,0.828163000,0.0000
206.195.198.162,<->,102.50.194.26,0,0,1,309,1,309,0.828035000,0.0000
120.100.37.17,<->,20.134.136.182,0,0,1,52,1,52,0.827999000,0.0000
117.22.133.81,<->,89.183.108.143,0,0,1,133,1,133,0.827857000,0.0000
100.182.99.11,<->,20.179.125.121,0,0,1,52,1,52,0.827733000,0.0000
109.1.17.10,<->,27.188.163.162,1,446,0,0,1,446,0.827695000,0.0000
159.194.43.140,<->,48.54.33.224,0,0,1,133,1,133,0.827650000,0.0000
109.222.249.16,<->,80.12.152.248,1,78,0,0,1,78,0.827593000,0.0000
247.136.255.192,<->,129.211.15.11,1,56,0,0,1,56,0.827558000,0.0000
217.11.189.9,<->,35.32.8.129,0,0,1,439,1,439,0.827522000,0.0000
136.25.188.163,<->,6.101.168.108,1,50,0,0,1,50,0.827502000,0.0000
145.79.67.244,<->,8.220.176.253,0,0,1,50,1,50,0.827380000,0.0000
121.19.253.144,<->,108.134.118.200,0,0,1,64,1,64,0.827281000,0.0000
195.105.9.194,<->,20.97.188.182,0,0,1,64,1,64,0.827176000,0.0000
215.158.238.89,<->,56.20.122.91,1,508,0,0,1,508,0.827174000,0.0000
210.156.156.214,<->,74.239.244.43,1,130,0,0,1,130,0.826913000,0.0000
192.170.241.103,<->,8.252.221.167,0,0,1,56,1,56,0.826800000,0.0000
92.27.219.19,<->,27.155.166.226,1,80,0,0,1,80,0.826672000,0.0000
99.72.93.0,<->,27.13.144.80,1,56,0,0,1,56,0.826520000,0.0000
123.123.221.21,<->,89.183.104.151,0,0,1,52,1,52,0.826464000,0.0000
144.76.46.38,<->,100.94.196.208,0,0,1,68,1,68,0.826200000,0.0000
230.49.174.178,<->,220.83.21.43,0,0,1,130,1,130,0.826185000,0.0000
136.18.240.58,<->,8.182.244.74,0,0,1,50,1,50,0.826108000,0.0000
213.155.77.98,<->,136.25.188.177,0,0,1,56,1,56,0.825849000,0.0000
136.18.240.58,<->,8.182.224.87,0,0,1,50,1,50,0.825811000,0.0000
153.99.215.31,<->,34.178.109.47,0,0,1,50,1,50,0.825763000,0.0000
139.148.88.154,<->,8.182.244.237,0,0,1,50,1,50,0.825681000,0.0000
100.182.99.11,<->,20.179.125.105,0,0,1,52,1,52,0.825200000,0.0000
92.27.219.50,<->,75.92.68.235,1,52,0,0,1,52,0.825087000,0.0000
129.47.117.232,<->,102.44.126.170,0,0,1,50,1,50,0.825050000,0.0000
142.178.151.102,<->,50.224.76.234,0,0,1,50,1,50,0.824994000,0.0000
109.222.250.16,<->,42.233.156.138,1,70,0,0,1,70,0.824857000,0.0000
195.55.67.217,<->,136.25.188.239,0,0,1,56,1,56,0.824813000,0.0000
98.246.18.142,<->,20.128.137.162,0,0,1,50,1,50,0.824738000,0.0000
231.143.237.152,<->,136.25.188.160,0,0,1,68,1,68,0.824585000,0.0000
131.92.219.38,<->,98.129.74.38,0,0,1,50,1,50,0.824536000,0.0000
215.158.239.50,<->,199.20.28.75,1,68,0,0,1,68,0.824148000,0.0000
118.38.145.3,<->,97.168.105.154,0,0,1,1470,1,1470,0.824008000,0.0000
195.13.7.154,<->,136.25.188.255,0,0,1,56,1,56,0.824002000,0.0000
98.101.71.246,<->,8.182.227.71,0,0,1,50,1,50,0.823915000,0.0000
138.98.203.225,<->,122.192.129.142,1,50,0,0,1,50,0.823893000,0.0000
120.240.25.29,<->,20.228.179.70,0,0,1,64,1,64,0.823891000,0.0000
92.162.253.223,<->,92.27.44.83,1,586,0,0,1,586,0.823642000,0.0000
247.136.225.7,<->,53.160.175.12,1,56,0,0,1,56,0.823640000,0.0000
145.252.112.120,<->,117.23.71.110,1,50,0,0,1,50,0.822778000,0.0000
215.158.61.183,<->,8.176.8.228,0,0,1,1421,1,1421,0.822721000,0.0000
142.236.213.69,<->,136.25.188.226,0,0,1,50,1,50,0.822504000,0.0000
239.227.66.217,<->,221.102.143.189,1,141,0,0,1,141,0.822477000,0.0000
42.146.133.4,<->,20.242.183.249,0,0,1,76,1,76,0.822121000,0.0000
192.64.67.126,<->,8.45.168.98,1,68,0,0,1,68,0.822087000,0.0000
144.75.218.246,<->,138.127.224.105,1,366,0,0,1,366,0.822060000,0.0000
192.67.183.227,<->,128.180.33.172,1,52,0,0,1,52,0.821763000,0.0000
138.79.143.196,<->,111.147.166.87,0,0,1,50,1,50,0.821533000,0.0000
196.206.250.133,<->,136.25.188.54,0,0,1,50,1,50,0.821517000,0.0000
143.14.181.63,<->,8.20.87.206,0,0,1,50,1,50,0.821513000,0.0000
144.75.218.241,<->,138.127.225.8,1,366,0,0,1,366,0.821491000,0.0000
144.75.218.242,<->,97.110.148.11,1,138,0,0,1,138,0.821490000,0.0000
138.121.99.24,<->,8.220.202.24,0,0,1,50,1,50,0.821470000,0.0000
75.62.16.8,<->,8.176.51.248,0,0,1,50,1,50,0.821313000,0.0000
140.91.154.183,<->,92.27.27.186,0,0,1,135,1,135,0.820953000,0.0000
109.222.193.0,<->,75.62.16.8,1,50,0,0,1,50,0.820588000,0.0000
215.158.239.68,<->,202.33.12.19,1,50,0,0,1,50,0.820297000,0.0000
200.175.193.127,<->,54.37.187.116,1,50,0,0,1,50,0.820037000,0.0000
106.248.210.12,<->,92.27.209.159,0,0,1,57,1,57,0.819983000,0.0000
53.214.237.0,<->,8.30.107.64,0,0,1,50,1,50,0.819723000,0.0000
215.158.239.57,<->,204.2.92.145,1,56,0,0,1,56,0.819455000,0.0000
247.136.211.104,<->,92.62.110.238,1,84,0,0,1,84,0.818985000,0.0000
215.158.239.84,<->,207.114.202.99,1,68,0,0,1,68,0.818879000,0.0000
106.248.210.12,<->,92.27.26.178,0,0,1,57,1,57,0.818798000,0.0000
215.158.239.95,<->,204.226.6.197,1,50,0,0,1,50,0.818724000,0.0000
252.36.107.253,<->,20.103.143.148,0,0,1,98,1,98,0.818683000,0.0000
215.158.239.58,<->,195.80.56.104,1,50,0,0,1,50,0.818632000,0.0000
69.246.56.234,<->,34.234.134.77,0,0,1,60,1,60,0.818043000,0.0000
192.67.167.181,<->,132.216.20.184,1,50,0,0,1,50,0.817721000,0.0000
221.102.143.189,<->,192.64.72.222,0,0,1,141,1,141,0.817513000,0.0000
159.69.187.16,<->,144.108.80.170,1,68,0,0,1,68,0.816828000,0.0000
195.13.130.115,<->,136.25.188.209,0,0,1,68,1,68,0.816801000,0.0000
142.207.222.163,<->,136.25.188.174,0,0,1,50,1,50,0.816416000,0.0000
104.143.10.103,<->,100.92.94.213,0,0,1,64,1,64,0.816343000,0.0000
114.76.105.99,<->,92.27.27.169,0,0,1,64,1,64,0.816115000,0.0000
136.25.188.164,<->,111.151.106.232,1,56,0,0,1,56,0.816079000,0.0000
21.15.226.126,<->,20.193.60.141,0,0,1,82,1,82,0.816000000,0.0000
120.155.86.33,<->,8.176.8.97,0,0,1,111,1,111,0.815747000,0.0000
50.49.177.26,<->,8.43.215.120,0,0,1,50,1,50,0.815690000,0.0000
65.180.180.196,<->,50.224.96.136,0,0,1,76,1,76,0.815442000,0.0000
197.68.57.83,<->,39.167.39.244,0,0,1,64,1,64,0.815236000,0.0000
104.143.10.103,<->,100.92.94.208,0,0,1,64,1,64,0.815033000,0.0000
136.25.188.105,<->,130.28.164.201,1,139,0,0,1,139,0.814962000,0.0000
225.21.131.219,<->,39.229.251.162,0,0,1,64,1,64,0.814954000,0.0000
99.75.122.179,<->,38.57.141.132,1,80,0,0,1,80,0.814750000,0.0000
142.220.235.178,<->,136.25.188.236,0,0,1,50,1,50,0.814643000,0.0000
144.75.218.233,<->,128.8.18.241,1,298,0,0,1,298,0.814567000,0.0000
145.3.142.7,<->,39.237.228.210,0,0,1,64,1,64,0.814508000,0.0000
138.98.240.68,<->,134.53.114.127,1,50,0,0,1,50,0.814143000,0.0000
92.27.219.50,<->,88.0.112.42,1,52,0,0,1,52,0.813972000,0.0000
195.50.2.240,<->,8.53.5.41,0,0,1,84,1,84,0.813927000,0.0000
195.120.220.210,<->,39.221.65.40,0,0,1,64,1,64,0.813901000,0.0000
148.205.108.81,<->,80.42.154.197,0,0,1,79,1,79,0.813613000,0.0000
128.163.57.179,<->,109.1.44.191,0,0,1,50,1,50,0.813364000,0.0000
239.66.15.243,<->,99.72.145.246,0,0,1,64,1,64,0.813190000,0.0000
241.193.172.231,<->,20.172.197.22,0,0,1,50,1,50,0.813100000,0.0000
136.181.53.150,<->,127.200.10.57,1,149,0,0,1,149,0.812599000,0.0000
198.229.228.232,<->,20.179.229.46,0,0,1,52,1,52,0.812522000,0.0000
205.225.94.212,<->,39.230.94.212,0,0,1,64,1,64,0.812297000,0.0000
195.120.220.210,<->,39.221.65.59,0,0,1,64,1,64,0.812276000,0.0000
92.27.27.99,<->,88.4.164.151,1,52,0,0,1,52,0.812172000,0.0000
129.224.112.252,<->,92.162.219.175,1,73,0,0,1,73,0.812111000,0.0000
145.242.126.212,<->,98.57.209.158,1,78,0,0,1,78,0.811890000,0.0000
126.138.59.22,<->,89.183.104.168,0,0,1,263,1,263,0.811848000,0.0000
144.70.164.220,<->,8.228.222.96,0,0,1,132,1,132,0.811364000,0.0000
104.210.192.24,<->,20.9.5.37,0,0,1,104,1,104,0.811333000,0.0000
146.174.253.116,<->,39.237.72.157,0,0,1,56,1,56,0.811218000,0.0000
127.179.50.224,<->,20.233.151.0,0,0,1,52,1,52,0.811133000,0.0000
195.120.220.210,<->,39.221.65.53,0,0,1,64,1,64,0.811098000,0.0000
215.158.239.99,<->,196.92.244.20,1,1080,0,0,1,1080,0.810664000,0.0000
144.75.218.237,<->,139.252.1.234,1,87,0,0,1,87,0.810608000,0.0000
201.67.55.83,<->,129.92.114.141,0,0,1,50,1,50,0.810564000,0.0000
192.74.123.212,<->,92.27.219.182,0,0,1,176,1,176,0.810286000,0.0000
97.126.4.233,<->,54.45.77.80,1,64,0,0,1,64,0.810187000,0.0000
144.75.218.237,<->,138.127.225.67,1,366,0,0,1,366,0.809982000,0.0000
69.240.233.230,<->,39.195.94.33,0,0,1,60,1,60,0.809860000,0.0000
242.121.18.213,<->,138.98.134.1,0,0,1,79,1,79,0.809695000,0.0000
132.216.20.238,<->,82.237.234.42,0,0,1,56,1,56,0.809663000,0.0000
92.27.27.165,<->,78.51.214.152,1,52,0,0,1,52,0.809514000,0.0000
106.226.116.16,<->,39.7.63.66,0,0,1,52,1,52,0.809351000,0.0000
195.120.220.210,<->,39.221.65.51,0,0,1,64,1,64,0.809265000,0.0000
132.18.67.29,<->,80.41.205.81,0,0,1,50,1,50,0.809081000,0.0000
199.121.243.232,<->,136.25.188.237,0,0,1,56,1,56,0.808896000,0.0000
132.216.20.179,<->,101.112.193.200,0,0,1,56,1,56,0.808718000,0.0000
92.27.219.160,<->,53.214.238.61,1,50,0,0,1,50,0.808662000,0.0000
139.128.243.194,<->,8.182.136.146,0,0,1,50,1,50,0.808596000,0.0000
195.120.220.210,<->,39.221.67.252,0,0,1,64,1,64,0.808586000,0.0000
116.143.80.64,<->,92.27.219.230,0,0,1,133,1,133,0.808348000,0.0000
105.78.55.110,<->,20.83.50.119,0,0,1,64,1,64,0.808146000,0.0000
195.120.220.210,<->,39.221.67.251,0,0,1,64,1,64,0.807925000,0.0000
204.185.42.135,<->,136.25.188.54,0,0,1,56,1,56,0.807790000,0.0000
143.42.52.16,<->,136.25.188.53,0,0,1,50,1,50,0.807589000,0.0000
197.7.74.19,<->,8.182.239.190,0,0,1,50,1,50,0.807232000,0.0000
132.168.196.227,<->,93.163.135.26,1,79,0,0,1,79,0.806860000,0.0000
195.83.190.20,<->,39.40.222.150,0,0,1,104,1,104,0.806859000,0.0000
92.27.219.241,<->,53.214.239.188,1,419,0,0,1,419,0.806439000,0.0000
109.1.17.14,<->,27.188.163.162,1,444,0,0,1,444,0.805921000,0.0000
195.39.175.170,<->,20.249.182.155,0,0,1,64,1,64,0.805648000,0.0000
29.212.43.244,<->,8.252.222.202,0,0,1,105,1,105,0.805606000,0.0000
241.193.172.231,<->,20.44.1.143,0,0,1,50,1,50,0.805596000,0.0000
136.25.188.106,<->,26.180.89.205,1,60,0,0,1,60,0.805513000,0.0000
142.244.0.64,<->,136.25.188.237,0,0,1,56,1,56,0.805398000,0.0000
206.22.162.192,<->,192.64.195.195,0,0,1,52,1,52,0.804824000,0.0000
92.27.219.229,<->,80.226.83.121,1,80,0,0,1,80,0.804802000,0.0000
241.193.172.231,<->,20.38.40.243,0,0,1,50,1,50,0.804607000,0.0000
143.23.168.28,<->,136.25.188.211,0,0,1,56,1,56,0.804598000,0.0000
132.249.141.243,<->,8.52.222.23,0,0,1,50,1,50,0.804537000,0.0000
21.15.226.126,<->,20.193.60.212,0,0,1,82,1,82,0.804377000,0.0000
254.241.226.209,<->,20.78.92.41,0,0,1,100,1,100,0.804238000,0.0000
222.65.19.163,<->,129.19.164.75,1,75,0,0,1,75,0.804135000,0.0000
215.158.61.145,<->,8.176.8.240,0,0,1,1421,1,1421,0.803998000,0.0000
75.62.16.8,<->,39.51.118.138,0,0,1,50,1,50,0.803803000,0.0000
241.193.172.231,<->,20.171.61.225,0,0,1,50,1,50,0.803798000,0.0000
215.158.239.78,<->,199.20.30.129,1,797,0,0,1,797,0.803562000,0.0000
38.21.156.204,<->,20.232.228.157,0,0,1,82,1,82,0.803494000,0.0000
207.5.99.21,<->,192.67.181.192,0,0,1,98,1,98,0.803421000,0.0000
21.15.226.126,<->,20.193.60.220,0,0,1,82,1,82,0.803408000,0.0000
142.194.19.30,<->,136.25.188.178,0,0,1,50,1,50,0.803245000,0.0000
69.246.49.61,<->,34.10.142.245,0,0,1,60,1,60,0.803091000,0.0000
109.1.15.30,<->,93.160.237.240,1,152,0,0,1,152,0.802987000,0.0000
207.190.60.49,<->,136.25.188.255,0,0,1,50,1,50,0.802962000,0.0000
197.132.142.28,<->,92.27.219.50,0,0,1,135,1,135,0.802707000,0.0000
104.143.10.103,<->,100.92.94.235,0,0,1,64,1,64,0.802500000,0.0000
79.134.27.76,<->,35.56.103.56,0,0,1,50,1,50,0.802442000,0.0000
92.27.219.186,<->,48.105.172.255,1,52,0,0,1,52,0.802422000,0.0000
144.75.218.237,<->,58.48.88.117,1,93,0,0,1,93,0.802369000,0.0000
105.254.61.156,<->,92.27.27.165,0,0,1,52,1,52,0.802123000,0.0000
120.48.131.33,<->,20.172.45.171,0,0,1,78,1,78,0.801962000,0.0000
159.69.187.45,<->,144.76.43.234,1,75,0,0,1,75,0.801815000,0.0000
127.152.207.195,<->,92.27.219.49,0,0,1,52,1,52,0.801200000,0.0000
21.15.226.126,<->,20.193.60.176,0,0,1,82,1,82,0.801193000,0.0000
138.127.227.65,<->,136.99.137.179,0,0,1,243,1,243,0.801082000,0.0000
196.18.149.149,<->,92.27.27.166,0,0,1,52,1,52,0.800993000,0.0000
29.209.248.233,<->,20.202.19.104,0,0,1,64,1,64,0.800890000,0.0000
234.182.169.148,<->,133.32.2.37,0,0,1,82,1,82,0.800710000,0.0000
208.186.230.2,<->,132.200.62.147,0,0,1,72,1,72,0.800695000,0.0000
215.158.238.163,<->,131.95.192.187,1,85,0,0,1,85,0.800665000,0.0000
195.50.67.42,<->,39.41.165.253,0,0,1,60,1,60,0.800591000,0.0000
204.140.167.28,<->,8.182.239.140,0,0,1,50,1,50,0.800390000,0.0000
144.75.218.246,<->,139.114.208.35,1,132,0,0,1,132,0.800361000,0.0000
89.183.104.152,<->,66.13.115.56,1,153,0,0,1,153,0.800157000,0.0000
142.209.163.177,<->,136.25.188.239,0,0,1,56,1,56,0.800006000,0.0000
227.23.98.223,<->,92.27.219.231,0,0,1,53,1,53,0.799893000,0.0000
89.183.104.226,<->,35.33.16.78,1,78,0,0,1,78,0.799830000,0.0000
109.1.40.226,<->,29.239.233.207,1,99,0,0,1,99,0.799467000,0.0000
114.207.42.114,<->,92.27.219.46,0,0,1,52,1,52,0.799307000,0.0000
143.148.102.19,<->,20.16.122.94,0,0,1,72,1,72,0.799017000,0.0000
215.158.239.79,<->,195.55.135.23,1,56,0,0,1,56,0.799006000,0.0000
210.220.219.151,<->,53.208.110.227,1,397,0,0,1,397,0.799002000,0.0000
111.25.58.238,<->,109.222.211.123,0,0,1,56,1,56,0.798912000,0.0000
194.40.2.133,<->,92.27.219.21,0,0,1,52,1,52,0.798751000,0.0000
215.158.140.87,<->,46.38.63.170,1,50,0,0,1,50,0.798646000,0.0000
143.10.74.23,<->,136.25.188.44,0,0,1,52,1,52,0.798324000,0.0000
38.188.127.67,<->,20.26.255.163,0,0,1,64,1,64,0.797948000,0.0000
247.118.206.241,<->,8.182.251.218,0,0,1,50,1,50,0.797753000,0.0000
8.182.227.233,<->,6.20.10.228,1,50,0,0,1,50,0.797529000,0.0000
210.209.251.214,<->,80.41.205.81,0,0,1,50,1,50,0.797516000,0.0000
247.136.226.75,<->,104.99.156.136,1,97,0,0,1,97,0.797223000,0.0000
112.86.106.238,<->,20.79.120.139,0,0,1,64,1,64,0.797157000,0.0000
203.215.115.170,<->,118.241.252.70,1,64,0,0,1,64,0.796988000,0.0000
215.158.239.76,<->,196.90.247.27,1,501,0,0,1,501,0.796931000,0.0000
75.217.19.32,<->,39.45.163.249,0,0,1,68,1,68,0.796337000,0.0000
105.121.173.108,<->,80.41.16.207,0,0,1,133,1,133,0.796299000,0.0000
114.28.148.5,<->,92.27.219.238,0,0,1,149,1,149,0.795890000,0.0000
112.5.12.77,<->,20.181.69.66,0,0,1,72,1,72,0.795517000,0.0000
192.170.157.185,<->,136.62.168.88,0,0,1,141,1,141,0.795483000,0.0000
204.185.119.153,<->,136.25.188.55,0,0,1,717,1,717,0.795360000,0.0000
33.144.109.234,<->,20.105.2.76,0,0,1,64,1,64,0.795209000,0.0000
102.45.16.209,<->,78.45.210.42,1,52,0,0,1,52,0.795166000,0.0000
207.191.27.65,<->,136.25.188.236,0,0,1,50,1,50,0.795139000,0.0000
21.15.226.126,<->,20.193.60.211,0,0,1,82,1,82,0.794879000,0.0000
144.122.240.218,<->,144.108.80.170,1,72,0,0,1,72,0.794731000,0.0000
215.158.239.48,<->,199.20.6.196,1,56,0,0,1,56,0.794526000,0.0000
101.235.69.116,<->,100.123.122.203,1,50,0,0,1,50,0.794479000,0.0000
215.158.239.57,<->,196.91.74.178,1,757,0,0,1,757,0.794449000,0.0000
111.146.235.42,<->,0.195.216.195,1,93,0,0,1,93,0.794040000,0.0000
254.126.105.137,<->,220.81.19.119,0,0,1,56,1,56,0.793938000,0.0000
248.225.27.2,<->,53.208.247.245,1,349,0,0,1,349,0.793693000,0.0000
129.224.112.252,<->,92.162.219.96,1,76,0,0,1,76,0.793258000,0.0000
215.158.239.6,<->,212.70.75.129,1,1080,0,0,1,1080,0.793022000,0.0000
104.143.10.103,<->,100.92.94.233,0,0,1,64,1,64,0.792782000,0.0000
104.131.160.56,<->,20.84.125.49,0,0,1,50,1,50,0.792777000,0.0000
98.246.18.142,<->,20.225.122.181,0,0,1,50,1,50,0.792707000,0.0000
144.75.218.233,<->,17.197.194.60,1,163,0,0,1,163,0.792437000,0.0000
136.51.113.141,<->,8.52.138.239,0,0,1,50,1,50,0.792428000,0.0000
132.133.159.111,<->,8.183.25.25,0,0,1,50,1,50,0.792338000,0.0000
120.155.86.33,<->,8.176.8.83,0,0,1,131,1,131,0.792261000,0.0000
92.27.219.134,<->,64.214.57.126,1,50,0,0,1,50,0.791932000,0.0000
92.27.219.42,<->,29.11.138.97,1,174,0,0,1,174,0.791521000,0.0000
105.83.153.163,<->,20.206.222.134,0,0,1,64,1,64,0.791355000,0.0000
206.198.190.233,<->,92.27.219.140,0,0,1,319,1,319,0.791293000,0.0000
122.135.83.219,<->,89.183.104.160,0,0,1,332,1,332,0.791202000,0.0000
193.21.29.244,<->,100.94.40.183,0,0,1,335,1,335,0.790817000,0.0000
231.143.237.213,<->,136.25.188.53,0,0,1,282,1,282,0.790780000,0.0000
215.158.140.120,<->,111.150.207.168,1,100,0,0,1,100,0.790718000,0.0000
215.158.239.56,<->,196.0.135.226,1,64,0,0,1,64,0.790685000,0.0000
215.158.239.49,<->,195.49.255.243,1,50,0,0,1,50,0.790304000,0.0000
215.158.103.206,<->,129.221.194.218,1,801,0,0,1,801,0.789952000,0.0000
118.99.185.65,<->,89.183.104.138,0,0,1,213,1,213,0.789113000,0.0000
199.96.138.28,<->,50.224.76.234,0,0,1,50,1,50,0.788580000,0.0000
215.158.239.69,<->,204.1.205.234,1,50,0,0,1,50,0.788271000,0.0000
144.75.218.237,<->,138.127.225.252,1,356,0,0,1,356,0.787977000,0.0000
198.72.185.252,<->,39.238.52.248,0,0,1,102,1,102,0.787943000,0.0000
243.49.81.32,<->,101.123.191.104,0,0,1,56,1,56,0.787634000,0.0000
157.98.1.54,<->,129.224.112.252,0,0,1,82,1,82,0.787494000,0.0000
196.68.53.205,<->,39.159.132.13,0,0,1,102,1,102,0.787383000,0.0000
123.86.217.151,<->,39.2.20.121,0,0,1,56,1,56,0.787094000,0.0000
120.238.165.207,<->,101.224.172.52,0,0,1,57,1,57,0.786966000,0.0000
144.122.240.212,<->,144.76.43.234,1,77,0,0,1,77,0.786803000,0.0000
149.200.188.95,<->,80.40.24.130,0,0,1,490,1,490,0.786793000,0.0000
159.69.187.28,<->,99.168.117.210,1,72,0,0,1,72,0.786514000,0.0000
98.246.18.142,<->,20.26.105.20,0,0,1,50,1,50,0.786504000,0.0000
136.18.16.95,<->,8.182.245.10,0,0,1,50,1,50,0.786423000,0.0000
105.69.173.13,<->,20.227.80.91,0,0,1,64,1,64,0.786210000,0.0000
144.75.218.233,<->,138.127.224.115,1,348,0,0,1,348,0.786111000,0.0000
197.58.137.254,<->,39.2.31.60,0,0,1,93,1,93,0.785853000,0.0000
215.158.239.58,<->,199.82.75.61,1,56,0,0,1,56,0.785641000,0.0000
207.92.21.145,<->,8.183.25.124,0,0,1,56,1,56,0.785622000,0.0000
109.222.253.182,<->,52.194.161.199,1,70,0,0,1,70,0.785564000,0.0000
144.75.218.241,<->,138.127.230.35,1,356,0,0,1,356,0.785486000,0.0000
192.64.234.225,<->,149.59.98.246,1,50,0,0,1,50,0.785465000,0.0000
53.213.148.81,<->,48.53.0.183,0,0,1,64,1,64,0.785361000,0.0000
230.62.102.89,<->,39.38.85.55,0,0,1,710,1,710,0.785185000,0.0000
207.236.115.122,<->,136.25.188.252,0,0,1,56,1,56,0.784106000,0.0000
198.157.156.166,<->,92.27.219.159,0,0,1,64,1,64,0.784094000,0.0000
146.196.145.46,<->,129.224.112.252,0,0,1,75,1,75,0.783494000,0.0000
93.146.42.91,<->,39.198.190.74,0,0,1,64,1,64,0.782928000,0.0000
53.240.6.143,<->,8.228.220.12,0,0,1,50,1,50,0.782827000,0.0000
204.1.185.180,<->,136.25.188.255,0,0,1,56,1,56,0.782750000,0.0000
246.108.250.201,<->,144.75.218.246,0,0,1,72,1,72,0.782649000,0.0000
207.60.123.205,<->,136.25.188.242,0,0,1,56,1,56,0.782475000,0.0000
119.90.251.239,<->,39.43.20.219,0,0,1,50,1,50,0.782218000,0.0000
140.147.61.91,<->,34.10.195.118,0,0,1,60,1,60,0.782194000,0.0000
207.62.88.179,<->,50.224.76.235,0,0,1,50,1,50,0.782072000,0.0000
114.187.169.221,<->,111.147.75.24,0,0,1,64,1,64,0.781981000,0.0000
195.124.223.45,<->,136.25.188.255,0,0,1,68,1,68,0.781842000,0.0000
204.136.215.19,<->,39.53.87.17,0,0,1,72,1,72,0.781553000,0.0000
144.122.240.210,<->,144.108.64.181,1,69,0,0,1,69,0.781523000,0.0000
76.2.0.240,<->,8.220.187.40,0,0,1,704,1,704,0.781441000,0.0000
144.75.218.241,<->,138.127.231.14,1,254,0,0,1,254,0.781229000,0.0000
101.70.127.229,<->,8.235.204.255,1,56,0,0,1,56,0.780843000,0.0000
104.237.170.147,<->,50.224.76.248,0,0,1,50,1,50,0.780481000,0.0000
215.158.239.78,<->,195.83.15.223,1,56,0,0,1,56,0.780152000,0.0000
106.29.77.23,<->,92.27.219.229,0,0,1,334,1,334,0.780151000,0.0000
215.158.140.207,<->,99.124.197.26,1,50,0,0,1,50,0.779871000,0.0000
112.210.150.36,<->,20.156.112.191,0,0,1,52,1,52,0.779651000,0.0000
127.101.245.243,<->,20.147.148.238,0,0,1,50,1,50,0.779339000,0.0000
144.75.218.233,<->,138.127.231.91,1,238,0,0,1,238,0.779168000,0.0000
92.27.219.171,<->,27.77.123.31,1,263,0,0,1,263,0.778993000,0.0000
213.186.52.81,<->,139.163.8.98,0,0,1,56,1,56,0.778932000,0.0000
244.50.133.60,<->,20.108.117.206,0,0,1,50,1,50,0.778810000,0.0000
215.158.140.120,<->,111.151.106.254,1,56,0,0,1,56,0.778713000,0.0000
205.63.215.229,<->,92.27.219.217,0,0,1,1398,1,1398,0.778574000,0.0000
109.127.101.16,<->,80.40.75.22,0,0,1,56,1,56,0.778073000,0.0000
75.62.16.8,<->,39.5.86.222,0,0,1,50,1,50,0.778073000,0.0000
218.31.254.210,<->,129.224.112.252,0,0,1,72,1,72,0.777945000,0.0000
119.49.204.222,<->,20.255.131.77,0,0,1,74,1,74,0.777830000,0.0000
198.182.188.35,<->,80.41.12.171,0,0,1,120,1,120,0.777827000,0.0000
144.75.218.242,<->,138.127.224.101,1,84,0,0,1,84,0.777296000,0.0000
159.36.245.188,<->,92.27.219.231,0,0,1,213,1,213,0.776920000,0.0000
105.140.23.31,<->,20.121.178.56,0,0,1,64,1,64,0.776184000,0.0000
208.238.47.197,<->,39.31.154.199,0,0,1,60,1,60,0.776149000,0.0000
93.146.42.91,<->,39.198.190.154,0,0,1,64,1,64,0.775644000,0.0000
247.136.236.74,<->,105.134.175.210,1,50,0,0,1,50,0.775642000,0.0000
159.69.187.12,<->,144.69.101.196,1,75,0,0,1,75,0.775436000,0.0000
127.186.128.183,<->,20.43.81.106,0,0,1,64,1,64,0.774978000,0.0000
241.193.172.231,<->,20.124.237.54,0,0,1,50,1,50,0.774926000,0.0000
141.183.33.233,<->,39.220.231.11,0,0,1,72,1,72,0.774852000,0.0000
143.87.158.84,<->,136.25.188.222,0,0,1,50,1,50,0.774838000,0.0000
132.211.85.163,<->,8.228.213.135,0,0,1,50,1,50,0.774754000,0.0000
249.101.114.4,<->,53.213.235.225,1,887,0,0,1,887,0.774705000,0.0000
207.239.48.12,<->,136.25.188.174,0,0,1,50,1,50,0.774365000,0.0000
218.138.240.252,<->,8.220.234.189,0,0,1,50,1,50,0.774279000,0.0000
246.254.97.149,<->,8.35.106.83,1,101,0,0,1,101,0.774046000,0.0000
103.178.26.56,<->,98.67.130.21,0,0,1,76,1,76,0.773807000,0.0000
215.158.140.118,<->,111.150.207.59,1,56,0,0,1,56,0.773805000,0.0000
53.232.165.97,<->,20.192.127.213,0,0,1,50,1,50,0.773800000,0.0000
143.88.89.23,<->,20.144.65.238,0,0,1,108,1,108,0.773693000,0.0000
198.212.18.67,<->,92.27.219.160,0,0,1,52,1,52,0.773649000,0.0000
97.11.170.243,<->,53.69.140.220,1,234,0,0,1,234,0.773608000,0.0000
136.25.188.105,<->,133.9.254.177,1,94,0,0,1,94,0.773566000,0.0000
192.229.216.117,<->,42.104.4.137,1,50,0,0,1,50,0.773336000,0.0000
204.186.27.148,<->,136.25.188.163,0,0,1,68,1,68,0.773161000,0.0000
129.160.244.26,<->,8.52.163.194,0,0,1,1002,1,1002,0.773129000,0.0000
92.27.219.19,<->,66.8.74.188,1,50,0,0,1,50,0.773119000,0.0000
132.18.67.29,<->,100.94.157.198,0,0,1,56,1,56,0.773066000,0.0000
120.116.159.59,<->,39.27.119.178,0,0,1,64,1,64,0.772932000,0.0000
159.137.248.15,<->,117.50.125.212,1,50,0,0,1,50,0.772724000,0.0000
145.42.14.168,<->,129.78.116.244,0,0,1,84,1,84,0.772432000,0.0000
139.106.97.80,<->,101.124.235.41,0,0,1,61,1,61,0.771981000,0.0000
241.193.172.231,<->,20.99.160.64,0,0,1,50,1,50,0.771729000,0.0000
215.158.239.51,<->,196.104.0.45,1,56,0,0,1,56,0.770795000,0.0000
111.147.125.110,<->,79.116.131.173,1,72,0,0,1,72,0.770772000,0.0000
247.136.236.74,<->,112.223.194.180,1,50,0,0,1,50,0.770754000,0.0000
215.158.239.4,<->,156.183.17.26,1,50,0,0,1,50,0.770727000,0.0000
33.233.141.33,<->,8.53.119.12,1,84,0,0,1,84,0.770675000,0.0000
215.158.239.57,<->,195.43.97.203,1,56,0,0,1,56,0.770562000,0.0000
136.181.47.228,<->,82.195.35.34,1,50,0,0,1,50,0.770242000,0.0000
195.39.175.170,<->,20.249.182.190,0,0,1,64,1,64,0.769750000,0.0000
121.94.99.179,<->,20.222.244.52,0,0,1,84,1,84,0.769563000,0.0000
202.33.254.229,<->,136.25.188.174,0,0,1,50,1,50,0.769137000,0.0000
138.68.167.2,<->,8.252.222.237,0,0,1,50,1,50,0.769107000,0.0000
118.35.233.94,<->,89.183.104.243,0,0,1,98,1,98,0.769009000,0.0000
89.183.104.149,<->,38.70.6.0,1,80,0,0,1,80,0.769003000,0.0000
241.75.192.120,<->,221.102.125.17,0,0,1,50,1,50,0.768993000,0.0000
247.118.144.42,<->,53.213.69.234,1,419,0,0,1,419,0.768807000,0.0000
111.147.120.64,<->,54.59.120.90,1,50,0,0,1,50,0.768098000,0.0000
137.148.176.213,<->,97.126.26.40,0,0,1,83,1,83,0.767910000,0.0000
144.75.218.246,<->,138.127.224.42,1,296,0,0,1,296,0.767701000,0.0000
89.153.121.33,<->,20.145.3.100,0,0,1,52,1,52,0.767631000,0.0000
69.128.141.135,<->,53.160.193.35,1,306,0,0,1,306,0.767477000,0.0000
93.146.42.245,<->,20.108.207.91,0,0,1,64,1,64,0.767415000,0.0000
80.40.21.203,<->,42.124.217.53,1,68,0,0,1,68,0.767305000,0.0000
133.54.43.29,<->,117.63.206.241,1,50,0,0,1,50,0.766988000,0.0000
113.106.21.134,<->,8.52.153.226,0,0,1,84,1,84,0.766556000,0.0000
92.27.219.207,<->,54.36.9.141,1,54,0,0,1,54,0.766399000,0.0000
215.158.61.195,<->,8.176.8.237,0,0,1,56,1,56,0.766169000,0.0000
210.220.219.153,<->,138.127.231.62,1,293,0,0,1,293,0.765985000,0.0000
197.81.80.32,<->,192.229.216.117,0,0,1,50,1,50,0.764962000,0.0000
215.158.239.92,<->,199.20.30.97,1,765,0,0,1,765,0.764926000,0.0000
109.222.216.239,<->,53.189.46.201,1,56,0,0,1,56,0.764777000,0.0000
92.27.219.253,<->,38.84.5.250,1,149,0,0,1,149,0.764622000,0.0000
136.25.188.45,<->,80.47.111.87,1,56,0,0,1,56,0.764547000,0.0000
54.58.199.145,<->,48.54.245.230,0,0,1,50,1,50,0.764072000,0.0000
142.166.62.108,<->,136.25.188.55,0,0,1,56,1,56,0.763665000,0.0000
204.89.145.215,<->,50.223.3.228,0,0,1,50,1,50,0.763086000,0.0000
119.70.236.72,<->,89.183.104.136,0,0,1,68,1,68,0.762930000,0.0000
246.253.253.213,<->,199.9.166.9,1,50,0,0,1,50,0.762878000,0.0000
215.158.239.95,<->,195.43.82.218,1,50,0,0,1,50,0.762667000,0.0000
142.241.44.215,<->,92.27.219.251,0,0,1,52,1,52,0.762607000,0.0000
144.75.218.233,<->,138.127.231.102,1,263,0,0,1,263,0.762321000,0.0000
144.75.218.242,<->,138.127.230.146,1,253,0,0,1,253,0.762247000,0.0000
207.172.153.47,<->,136.25.188.163,0,0,1,382,1,382,0.762184000,0.0000
136.25.189.214,<->,8.35.106.206,1,90,0,0,1,90,0.762035000,0.0000
198.157.156.210,<->,92.27.219.30,0,0,1,64,1,64,0.762027000,0.0000
215.158.239.217,<->,8.35.106.206,1,90,0,0,1,90,0.761691000,0.0000
110.194.75.220,<->,97.126.24.7,0,0,1,50,1,50,0.761659000,0.0000
113.27.9.42,<->,39.210.185.74,0,0,1,64,1,64,0.761608000,0.0000
231.138.6.93,<->,136.25.188.220,0,0,1,68,1,68,0.761599000,0.0000
144.75.218.242,<->,138.127.225.171,1,354,0,0,1,354,0.761377000,0.0000
215.158.140.105,<->,111.151.237.52,1,1064,0,0,1,1064,0.761264000,0.0000
144.75.218.246,<->,138.127.230.144,1,242,0,0,1,242,0.761212000,0.0000
193.21.29.240,<->,92.27.219.221,0,0,1,50,1,50,0.761195000,0.0000
100.208.15.63,<->,68.0.226.41,1,156,0,0,1,156,0.761017000,0.0000
97.126.7.170,<->,53.180.154.23,1,134,0,0,1,134,0.760527000,0.0000
111.151.142.231,<->,99.74.26.112,0,0,1,100,1,100,0.760503000,0.0000
116.146.226.124,<->,92.27.219.128,0,0,1,52,1,52,0.760146000,0.0000
200.175.252.134,<->,54.58.25.251,1,400,0,0,1,400,0.759986000,0.0000
121.87.244.23,<->,20.165.217.34,0,0,1,68,1,68,0.759913000,0.0000
101.122.132.105,<->,94.254.2.109,1,65,0,0,1,65,0.759911000,0.0000
111.146.145.46,<->,53.149.2.103,1,125,0,0,1,125,0.759556000,0.0000
80.38.3.11,<->,35.56.3.196,1,50,0,0,1,50,0.759507000,0.0000
111.150.207.235,<->,8.252.222.35,0,0,1,56,1,56,0.759431000,0.0000
247.136.205.152,<->,53.246.51.76,1,595,0,0,1,595,0.759244000,0.0000
130.19.95.191,<->,8.52.149.39,0,0,1,84,1,84,0.759217000,0.0000
109.1.21.151,<->,26.218.94.114,1,50,0,0,1,50,0.759072000,0.0000
98.236.95.13,<->,53.89.213.104,1,89,0,0,1,89,0.758257000,0.0000
144.75.218.242,<->,143.204.138.237,1,148,0,0,1,148,0.758118000,0.0000
158.95.3.28,<->,20.138.15.106,0,0,1,52,1,52,0.757855000,0.0000
129.92.114.30,<->,54.54.203.214,1,125,0,0,1,125,0.757784000,0.0000
215.158.239.70,<->,199.106.63.13,1,602,0,0,1,602,0.757708000,0.0000
33.155.155.153,<->,8.228.214.59,0,0,1,52,1,52,0.757327000,0.0000
21.15.226.126,<->,20.193.61.72,0,0,1,82,1,82,0.757270000,0.0000
192.67.167.86,<->,132.7.32.230,1,52,0,0,1,52,0.756826000,0.0000
139.163.5.140,<->,106.167.226.231,1,62,0,0,1,62,0.756634000,0.0000
215.158.239.97,<->,199.20.6.241,1,64,0,0,1,64,0.756341000,0.0000
95.245.52.194,<->,8.252.221.239,0,0,1,50,1,50,0.756191000,0.0000
198.158.197.83,<->,20.166.230.221,0,0,1,50,1,50,0.756066000,0.0000
143.132.143.58,<->,136.25.188.160,0,0,1,426,1,426,0.755945000,0.0000
199.15.232.42,<->,136.25.188.252,0,0,1,50,1,50,0.755939000,0.0000
198.158.197.83,<->,20.105.166.72,0,0,1,50,1,50,0.755894000,0.0000
143.135.224.130,<->,136.25.188.226,0,0,1,56,1,56,0.755602000,0.0000
144.75.218.233,<->,138.127.230.209,1,279,0,0,1,279,0.755140000,0.0000
105.197.17.184,<->,101.70.119.37,0,0,1,67,1,67,0.755029000,0.0000
221.102.56.51,<->,80.41.241.216,0,0,1,413,1,413,0.755018000,0.0000
144.75.218.242,<->,130.54.191.244,1,75,0,0,1,75,0.754823000,0.0000
192.229.216.117,<->,27.11.232.139,1,56,0,0,1,56,0.754562000,0.0000
207.53.220.222,<->,50.224.76.234,0,0,1,50,1,50,0.754497000,0.0000
152.16.212.51,<->,39.171.21.65,0,0,1,52,1,52,0.754389000,0.0000
144.76.44.59,<->,99.75.234.139,0,0,1,125,1,125,0.754386000,0.0000
215.158.239.5,<->,212.255.12.203,1,56,0,0,1,56,0.754269000,0.0000
92.27.219.29,<->,53.212.201.36,1,50,0,0,1,50,0.754155000,0.0000
113.179.22.128,<->,39.10.114.234,0,0,1,78,1,78,0.753918000,0.0000
127.255.84.41,<->,92.162.253.93,0,0,1,573,1,573,0.753618000,0.0000
144.75.218.237,<->,138.127.224.46,1,258,0,0,1,258,0.753571000,0.0000
215.158.239.99,<->,199.20.28.15,1,56,0,0,1,56,0.753530000,0.0000
198.157.156.226,<->,92.27.219.140,0,0,1,307,1,307,0.752733000,0.0000
144.75.218.237,<->,56.120.138.124,1,143,0,0,1,143,0.752303000,0.0000
195.124.199.6,<->,136.25.188.253,0,0,1,56,1,56,0.752125000,0.0000
144.71.44.95,<->,97.242.126.198,1,84,0,0,1,84,0.751284000,0.0000
119.45.233.37,<->,89.183.104.128,0,0,1,64,1,64,0.751216000,0.0000
118.194.174.35,<->,89.183.104.135,0,0,1,324,1,324,0.751033000,0.0000
92.27.219.153,<->,48.111.9.167,1,273,0,0,1,273,0.750659000,0.0000
229.42.148.9,<->,89.183.104.151,0,0,1,52,1,52,0.750456000,0.0000
112.98.195.229,<->,109.1.37.141,0,0,1,56,1,56,0.750366000,0.0000
102.15.71.55,<->,50.224.80.64,0,0,1,50,1,50,0.750334000,0.0000
144.75.218.246,<->,98.184.9.185,1,126,0,0,1,126,0.750182000,0.0000
233.145.251.212,<->,145.116.119.53,0,0,1,50,1,50,0.749717000,0.0000
136.129.69.77,<->,48.108.68.62,1,56,0,0,1,56,0.749703000,0.0000
215.158.140.205,<->,96.243.145.53,1,50,0,0,1,50,0.749537000,0.0000
144.75.218.242,<->,138.127.224.190,1,242,0,0,1,242,0.749364000,0.0000
213.38.249.208,<->,8.49.69.216,1,382,0,0,1,382,0.749358000,0.0000
215.158.239.104,<->,138.127.224.238,1,232,0,0,1,232,0.749239000,0.0000
210.209.251.214,<->,144.87.235.222,0,0,1,50,1,50,0.749132000,0.0000
246.253.130.234,<->,241.193.172.231,1,50,0,0,1,50,0.749061000,0.0000
204.61.108.183,<->,136.25.188.163,0,0,1,50,1,50,0.748622000,0.0000
92.27.219.201,<->,64.214.57.254,1,50,0,0,1,50,0.748534000,0.0000
221.150.250.237,<->,111.48.21.51,1,106,0,0,1,106,0.748495000,0.0000
145.236.95.142,<->,8.52.169.61,0,0,1,50,1,50,0.748118000,0.0000
93.146.42.91,<->,39.198.190.164,0,0,1,64,1,64,0.747969000,0.0000
159.23.130.160,<->,8.43.217.24,0,0,1,704,1,704,0.747769000,0.0000
210.209.251.214,<->,111.147.160.100,0,0,1,481,1,481,0.747555000,0.0000
159.37.13.102,<->,89.183.104.134,0,0,1,56,1,56,0.747158000,0.0000
109.222.251.171,<->,101.62.32.153,1,136,0,0,1,136,0.747001000,0.0000
112.70.87.240,<->,39.49.187.123,0,0,1,296,1,296,0.746748000,0.0000
244.50.133.60,<->,39.54.212.160,0,0,1,50,1,50,0.746662000,0.0000
133.178.227.73,<->,131.1.235.233,1,85,0,0,1,85,0.746482000,0.0000
197.113.99.23,<->,136.25.188.255,0,0,1,68,1,68,0.746062000,0.0000
93.146.42.91,<->,39.198.190.150,0,0,1,64,1,64,0.746018000,0.0000
109.222.217.93,<->,8.251.185.161,1,73,0,0,1,73,0.745635000,0.0000
78.151.182.244,<->,20.40.147.118,0,0,1,78,1,78,0.745524000,0.0000
144.75.218.233,<->,111.40.16.13,1,87,0,0,1,87,0.745520000,0.0000
148.165.13.37,<->,6.74.108.157,0,0,1,56,1,56,0.745511000,0.0000
139.163.26.146,<->,104.227.201.147,1,99,0,0,1,99,0.745422000,0.0000
215.158.23.63,<->,111.150.207.145,1,64,0,0,1,64,0.745273000,0.0000
109.222.217.93,<->,81.193.109.18,1,73,0,0,1,73,0.745214000,0.0000
137.148.176.213,<->,97.126.26.71,0,0,1,83,1,83,0.745214000,0.0000
97.243.206.148,<->,92.27.219.36,0,0,1,56,1,56,0.745022000,0.0000
194.201.244.171,<->,0.195.210.42,0,0,1,56,1,56,0.744901000,0.0000
111.146.225.100,<->,53.160.238.214,1,56,0,0,1,56,0.744569000,0.0000
192.67.179.218,<->,110.103.159.83,1,105,0,0,1,105,0.744470000,0.0000
159.112.9.198,<->,97.183.218.171,0,0,1,50,1,50,0.743933000,0.0000
21.137.241.193,<->,20.90.229.185,0,0,1,100,1,100,0.743912000,0.0000
144.93.22.146,<->,102.50.126.150,0,0,1,56,1,56,0.743895000,0.0000
132.216.20.184,<->,101.126.191.154,0,0,1,56,1,56,0.743703000,0.0000
201.217.193.35,<->,92.27.27.146,0,0,1,132,1,132,0.743662000,0.0000
112.29.250.153,<->,92.27.27.171,0,0,1,62,1,62,0.743574000,0.0000
98.200.186.13,<->,64.214.44.92,1,50,0,0,1,50,0.743533000,0.0000
106.181.79.175,<->,102.51.33.111,0,0,1,135,1,135,0.743217000,0.0000
109.222.243.128,<->,14.27.123.221,1,56,0,0,1,56,0.742915000,0.0000
215.158.238.85,<->,139.252.1.253,1,135,0,0,1,135,0.742519000,0.0000
100.94.127.242,<->,89.204.26.1,1,56,0,0,1,56,0.742459000,0.0000
221.102.113.102,<->,195.3.98.35,1,91,0,0,1,91,0.742022000,0.0000
42.208.129.136,<->,20.105.2.76,0,0,1,64,1,64,0.741971000,0.0000
247.136.216.62,<->,33.233.160.168,1,123,0,0,1,123,0.741387000,0.0000
144.75.218.242,<->,120.155.84.208,1,152,0,0,1,152,0.741386000,0.0000
143.135.224.71,<->,136.25.188.253,0,0,1,56,1,56,0.741049000,0.0000
207.162.177.13,<->,80.40.45.102,0,0,1,50,1,50,0.740762000,0.0000
193.94.11.240,<->,97.126.92.131,0,0,1,50,1,50,0.740719000,0.0000
125.207.203.96,<->,8.250.147.200,0,0,1,704,1,704,0.740445000,0.0000
207.64.64.73,<->,80.38.20.247,0,0,1,50,1,50,0.740316000,0.0000
246.45.253.17,<->,99.75.228.122,0,0,1,50,1,50,0.740204000,0.0000
239.66.184.247,<->,100.92.119.180,0,0,1,270,1,270,0.740140000,0.0000
50.136.101.138,<->,8.220.176.253,0,0,1,50,1,50,0.740029000,0.0000
220.80.188.18,<->,93.177.118.32,1,133,0,0,1,133,0.739614000,0.0000
247.136.235.140,<->,38.247.215.91,1,80,0,0,1,80,0.739445000,0.0000
101.71.60.7,<->,92.27.27.144,0,0,1,317,1,317,0.739394000,0.0000
100.255.17.187,<->,97.126.116.84,0,0,1,65,1,65,0.738563000,0.0000
192.64.217.166,<->,112.42.249.60,1,80,0,0,1,80,0.738416000,0.0000
220.84.205.112,<->,61.93.34.188,1,135,0,0,1,135,0.738290000,0.0000
136.25.189.5,<->,33.209.218.54,1,218,0,0,1,218,0.738149000,0.0000
133.178.227.172,<->,111.150.207.59,1,56,0,0,1,56,0.738028000,0.0000
231.141.58.240,<->,8.220.176.253,0,0,1,50,1,50,0.737724000,0.0000
104.147.228.66,<->,89.183.104.136,0,0,1,100,1,100,0.737339000,0.0000
133.178.227.29,<->,111.151.109.41,1,100,0,0,1,100,0.737048000,0.0000
252.98.249.11,<->,198.3.138.187,1,52,0,0,1,52,0.736435000,0.0000
126.1.16.173,<->,39.41.132.134,0,0,1,52,1,52,0.736252000,0.0000
215.158.238.70,<->,111.151.142.181,1,56,0,0,1,56,0.735307000,0.0000
144.75.218.233,<->,138.127.224.105,1,366,0,0,1,366,0.735222000,0.0000
54.37.224.121,<->,48.54.142.19,0,0,1,50,1,50,0.735105000,0.0000
215.158.239.57,<->,207.57.206.241,1,68,0,0,1,68,0.734670000,0.0000
111.151.142.211,<->,8.252.221.116,0,0,1,100,1,100,0.734639000,0.0000
158.184.99.167,<->,8.220.201.13,0,0,1,704,1,704,0.734632000,0.0000
215.158.239.84,<->,196.95.27.4,1,50,0,0,1,50,0.734184000,0.0000
221.102.143.189,<->,6.73.237.197,0,0,1,141,1,141,0.733811000,0.0000
215.158.239.194,<->,139.36.119.82,1,1069,0,0,1,1069,0.733796000,0.0000
39.224.192.81,<->,0.62.62.23,1,64,0,0,1,64,0.733498000,0.0000
239.71.80.85,<->,84.22.52.96,1,56,0,0,1,56,0.733091000,0.0000
144.89.244.175,<->,97.183.223.16,0,0,1,56,1,56,0.733071000,0.0000
122.238.92.211,<->,20.46.130.124,0,0,1,75,1,75,0.732906000,0.0000
193.21.29.252,<->,192.67.161.238,0,0,1,136,1,136,0.732765000,0.0000
145.252.127.155,<->,144.76.46.38,1,90,0,0,1,90,0.732618000,0.0000
210.158.44.137,<->,124.58.26.202,1,119,0,0,1,119,0.732448000,0.0000
117.5.204.163,<->,92.168.217.241,0,0,1,56,1,56,0.732125000,0.0000
159.137.210.33,<->,114.234.174.140,1,50,0,0,1,50,0.731766000,0.0000
132.49.236.207,<->,20.131.57.54,0,0,1,108,1,108,0.731723000,0.0000
132.168.196.9,<->,115.78.45.1,1,52,0,0,1,52,0.731615000,0.0000
144.75.218.246,<->,138.127.224.168,1,314,0,0,1,314,0.731308000,0.0000
129.1.96.39,<->,112.70.50.181,1,149,0,0,1,149,0.731146000,0.0000
246.253.253.84,<->,192.204.123.23,1,83,0,0,1,83,0.730861000,0.0000
144.75.218.233,<->,138.127.230.213,1,286,0,0,1,286,0.730766000,0.0000
132.216.20.150,<->,102.231.186.33,0,0,1,56,1,56,0.730359000,0.0000
136.129.94.107,<->,92.27.219.23,0,0,1,123,1,123,0.730147000,0.0000
220.20.200.14,<->,127.255.84.41,1,573,0,0,1,573,0.729983000,0.0000
195.39.172.27,<->,39.132.86.246,0,0,1,64,1,64,0.729890000,0.0000
38.21.156.204,<->,20.232.228.175,0,0,1,82,1,82,0.729754000,0.0000
147.47.189.152,<->,34.139.217.179,0,0,1,134,1,134,0.729521000,0.0000
97.173.75.108,<->,39.200.99.0,0,0,1,64,1,64,0.729419000,0.0000
159.137.203.107,<->,141.134.231.203,1,72,0,0,1,72,0.729128000,0.0000
109.222.222.94,<->,53.234.162.13,1,125,0,0,1,125,0.728802000,0.0000
215.158.239.103,<->,192.171.13.35,1,102,0,0,1,102,0.728280000,0.0000
124.159.72.74,<->,39.224.88.67,0,0,1,60,1,60,0.728273000,0.0000
199.50.93.112,<->,136.25.188.178,0,0,1,50,1,50,0.728102000,0.0000
156.182.98.147,<->,20.29.39.250,0,0,1,120,1,120,0.727881000,0.0000
134.50.189.160,<->,89.183.104.251,0,0,1,62,1,62,0.727800000,0.0000
192.64.236.57,<->,137.226.59.195,1,97,0,0,1,97,0.727777000,0.0000
207.192.30.76,<->,8.20.87.153,0,0,1,50,1,50,0.727143000,0.0000
111.150.207.167,<->,8.252.223.165,0,0,1,56,1,56,0.726993000,0.0000
127.179.157.223,<->,20.137.128.210,0,0,1,52,1,52,0.726983000,0.0000
65.67.142.90,<->,39.169.11.74,0,0,1,52,1,52,0.726966000,0.0000
102.83.157.248,<->,64.146.112.197,1,169,0,0,1,169,0.726894000,0.0000
99.74.27.88,<->,80.56.83.82,1,100,0,0,1,100,0.726651000,0.0000
157.208.128.9,<->,39.3.103.232,0,0,1,60,1,60,0.726506000,0.0000
105.201.221.207,<->,80.42.150.137,0,0,1,326,1,326,0.726413000,0.0000
192.229.216.117,<->,98.220.133.108,1,50,0,0,1,50,0.726338000,0.0000
205.121.167.47,<->,89.139.241.98,0,0,1,151,1,151,0.725994000,0.0000
136.181.42.176,<->,111.25.58.238,1,56,0,0,1,56,0.725780000,0.0000
215.158.239.84,<->,207.60.98.140,1,50,0,0,1,50,0.725456000,0.0000
144.76.46.38,<->,136.181.39.4,0,0,1,112,1,112,0.725376000,0.0000
76.72.228.64,<->,39.164.106.181,0,0,1,64,1,64,0.724925000,0.0000
50.145.209.112,<->,8.228.219.1,0,0,1,93,1,93,0.724779000,0.0000
92.27.219.159,<->,53.251.236.164,1,50,0,0,1,50,0.724759000,0.0000
125.193.251.207,<->,50.224.76.230,0,0,1,56,1,56,0.724693000,0.0000
144.75.218.241,<->,8.47.122.178,1,100,0,0,1,100,0.724632000,0.0000
196.1.35.51,<->,0.195.210.42,0,0,1,50,1,50,0.724320000,0.0000
143.215.4.188,<->,8.182.138.215,0,0,1,50,1,50,0.724286000,0.0000
215.158.239.79,<->,199.20.28.101,1,50,0,0,1,50,0.723883000,0.0000
111.150.207.168,<->,99.74.26.101,0,0,1,100,1,100,0.723852000,0.0000
127.73.18.187,<->,97.126.35.236,0,0,1,187,1,187,0.723367000,0.0000
143.117.247.30,<->,89.139.241.98,0,0,1,136,1,136,0.723298000,0.0000
139.193.141.139,<->,112.160.201.15,1,50,0,0,1,50,0.723266000,0.0000
199.53.97.236,<->,136.25.188.177,0,0,1,50,1,50,0.722823000,0.0000
109.222.255.151,<->,81.18.77.118,1,66,0,0,1,66,0.722650000,0.0000
104.158.163.210,<->,39.193.150.67,0,0,1,52,1,52,0.722541000,0.0000
215.158.239.58,<->,199.20.28.239,1,602,0,0,1,602,0.722017000,0.0000
199.15.77.28,<->,136.25.188.198,0,0,1,132,1,132,0.721986000,0.0000
122.253.118.127,<->,89.183.104.135,0,0,1,52,1,52,0.721887000,0.0000
221.102.56.51,<->,6.228.38.150,0,0,1,413,1,413,0.721720000,0.0000
119.90.250.200,<->,20.110.33.71,0,0,1,50,1,50,0.720978000,0.0000
192.67.167.86,<->,38.252.105.253,1,52,0,0,1,52,0.720788000,0.0000
144.75.218.241,<->,138.127.231.54,1,333,0,0,1,333,0.720550000,0.0000
54.37.31.141,<->,48.54.3.184,0,0,1,50,1,50,0.720427000,0.0000
200.175.44.222,<->,54.36.72.32,1,64,0,0,1,64,0.720285000,0.0000
144.85.170.246,<->,26.200.210.179,1,64,0,0,1,64,0.720147000,0.0000
131.141.160.17,<->,39.152.8.182,0,0,1,60,1,60,0.720053000,0.0000
102.47.130.213,<->,50.224.118.187,0,0,1,80,1,80,0.720044000,0.0000
215.158.239.51,<->,199.20.6.166,1,64,0,0,1,64,0.720021000,0.0000
144.122.240.222,<->,144.108.64.185,1,64,0,0,1,64,0.719940000,0.0000
109.222.228.12,<->,109.122.86.55,1,92,0,0,1,92,0.719908000,0.0000
195.55.67.217,<->,136.25.188.238,0,0,1,56,1,56,0.719718000,0.0000
241.193.172.231,<->,20.99.243.156,0,0,1,50,1,50,0.719667000,0.0000
196.30.163.164,<->,97.126.110.104,0,0,1,64,1,64,0.719414000,0.0000
159.69.187.28,<->,144.108.64.183,1,66,0,0,1,66,0.719330000,0.0000
106.226.78.72,<->,20.215.108.132,0,0,1,64,1,64,0.719124000,0.0000
199.69.87.94,<->,136.25.188.237,0,0,1,1053,1,1053,0.718914000,0.0000
215.158.239.76,<->,207.190.129.97,1,50,0,0,1,50,0.718310000,0.0000
195.71.128.176,<->,136.25.188.252,0,0,1,56,1,56,0.718006000,0.0000
215.158.61.255,<->,8.252.222.102,0,0,1,56,1,56,0.717973000,0.0000
144.75.221.204,<->,97.198.100.142,0,0,1,87,1,87,0.717849000,0.0000
138.74.30.197,<->,89.90.125.158,1,50,0,0,1,50,0.717375000,0.0000
246.253.253.79,<->,159.57.86.227,1,198,0,0,1,198,0.717168000,0.0000
122.212.149.92,<->,20.115.175.10,0,0,1,64,1,64,0.716850000,0.0000
125.221.158.28,<->,89.183.104.160,0,0,1,270,1,270,0.716839000,0.0000
141.105.189.30,<->,20.36.214.32,0,0,1,72,1,72,0.716795000,0.0000
149.50.187.76,<->,20.199.243.188,0,0,1,64,1,64,0.716770000,0.0000
149.66.144.205,<->,109.1.60.13,0,0,1,52,1,52,0.716766000,0.0000
194.237.18.156,<->,136.25.188.46,0,0,1,56,1,56,0.716214000,0.0000
114.255.206.17,<->,50.224.76.234,0,0,1,56,1,56,0.716184000,0.0000
80.41.44.203,<->,64.214.44.93,1,52,0,0,1,52,0.716165000,0.0000
98.101.66.179,<->,8.20.87.187,0,0,1,64,1,64,0.715990000,0.0000
215.158.239.103,<->,29.214.217.188,1,336,0,0,1,336,0.715913000,0.0000
133.178.226.28,<->,122.216.233.185,1,1325,0,0,1,1325,0.715890000,0.0000
142.255.62.243,<->,136.25.188.222,0,0,1,50,1,50,0.715504000,0.0000
149.50.187.76,<->,20.199.243.186,0,0,1,64,1,64,0.714769000,0.0000
119.122.228.54,<->,20.154.75.10,0,0,1,98,1,98,0.714709000,0.0000
121.15.252.56,<->,109.1.52.158,0,0,1,99,1,99,0.714263000,0.0000
98.232.172.60,<->,89.211.37.130,1,84,0,0,1,84,0.714089000,0.0000
139.254.213.98,<->,129.205.208.245,1,614,0,0,1,614,0.714015000,0.0000
144.93.22.181,<->,82.198.199.99,0,0,1,50,1,50,0.712598000,0.0000
158.99.169.247,<->,80.40.13.234,0,0,1,136,1,136,0.712177000,0.0000
226.162.38.40,<->,99.75.41.170,0,0,1,63,1,63,0.712104000,0.0000
142.222.204.12,<->,39.50.175.23,0,0,1,64,1,64,0.712051000,0.0000
8.220.200.124,<->,6.101.97.45,1,50,0,0,1,50,0.712029000,0.0000
113.14.32.243,<->,20.9.89.19,0,0,1,72,1,72,0.711842000,0.0000
220.80.18.212,<->,158.93.155.23,1,67,0,0,1,67,0.711719000,0.0000
210.235.163.211,<->,22.34.2.52,1,186,0,0,1,186,0.711587000,0.0000
117.40.189.122,<->,50.224.95.36,0,0,1,50,1,50,0.711260000,0.0000
210.221.111.74,<->,111.151.237.45,1,56,0,0,1,56,0.711217000,0.0000
145.128.7.86,<->,8.182.227.180,0,0,1,50,1,50,0.710885000,0.0000
141.108.105.215,<->,20.18.119.55,0,0,1,50,1,50,0.710709000,0.0000
200.175.204.226,<->,53.201.72.62,1,93,0,0,1,93,0.710553000,0.0000
220.14.185.120,<->,8.182.226.78,0,0,1,50,1,50,0.709898000,0.0000
206.195.90.218,<->,100.50.202.45,0,0,1,70,1,70,0.709787000,0.0000
159.134.47.10,<->,159.87.104.238,0,0,1,76,1,76,0.709635000,0.0000
237.56.30.41,<->,20.39.199.134,0,0,1,78,1,78,0.709430000,0.0000
117.195.102.219,<->,39.32.92.250,0,0,1,56,1,56,0.709368000,0.0000
215.158.239.79,<->,195.81.84.197,1,64,0,0,1,64,0.709339000,0.0000
198.158.197.83,<->,20.183.109.154,0,0,1,50,1,50,0.709093000,0.0000
231.143.173.93,<->,136.25.188.253,0,0,1,64,1,64,0.708991000,0.0000
215.158.239.34,<->,74.133.18.141,1,50,0,0,1,50,0.708510000,0.0000
111.150.207.137,<->,99.74.26.96,0,0,1,100,1,100,0.708327000,0.0000
215.158.140.170,<->,131.189.98.171,1,211,0,0,1,211,0.707882000,0.0000
206.72.179.52,<->,20.98.60.79,0,0,1,64,1,64,0.707855000,0.0000
127.125.166.217,<->,20.208.153.148,0,0,1,52,1,52,0.707794000,0.0000
133.32.1.105,<->,26.225.57.159,1,69,0,0,1,69,0.707794000,0.0000
148.151.124.212,<->,8.252.222.202,0,0,1,135,1,135,0.707683000,0.0000
195.120.220.245,<->,8.182.227.180,0,0,1,56,1,56,0.707310000,0.0000
134.186.25.29,<->,89.183.104.232,0,0,1,60,1,60,0.707232000,0.0000
145.128.7.86,<->,8.52.246.224,0,0,1,50,1,50,0.707149000,0.0000
204.21.72.196,<->,136.25.188.178,0,0,1,50,1,50,0.707124000,0.0000
215.158.239.99,<->,199.20.28.220,1,240,0,0,1,240,0.707013000,0.0000
135.233.98.57,<->,129.224.112.220,0,0,1,54,1,54,0.706964000,0.0000
140.145.221.58,<->,39.169.208.250,0,0,1,64,1,64,0.706884000,0.0000
143.220.58.215,<->,39.246.51.182,0,0,1,75,1,75,0.706657000,0.0000
144.75.218.233,<->,8.47.122.178,1,100,0,0,1,100,0.706520000,0.0000
143.23.92.141,<->,136.25.188.53,0,0,1,146,1,146,0.706013000,0.0000
195.88.173.36,<->,8.182.226.78,0,0,1,50,1,50,0.705924000,0.0000
220.81.184.104,<->,89.183.104.168,0,0,1,80,1,80,0.705754000,0.0000
112.130.42.21,<->,109.222.251.27,0,0,1,77,1,77,0.705530000,0.0000
96.232.37.25,<->,89.183.108.200,0,0,1,78,1,78,0.705321000,0.0000
131.144.248.45,<->,129.224.112.252,0,0,1,83,1,83,0.705160000,0.0000
196.204.142.121,<->,136.25.188.176,0,0,1,56,1,56,0.704601000,0.0000
149.119.124.101,<->,139.193.141.139,0,0,1,50,1,50,0.704521000,0.0000
89.183.104.150,<->,38.52.2.34,1,52,0,0,1,52,0.704399000,0.0000
241.193.172.231,<->,20.220.222.208,0,0,1,50,1,50,0.704081000,0.0000
21.15.226.126,<->,20.193.63.180,0,0,1,82,1,82,0.704066000,0.0000
101.224.174.108,<->,33.3.176.210,1,161,0,0,1,161,0.703991000,0.0000
215.158.239.87,<->,199.20.28.3,1,583,0,0,1,583,0.703910000,0.0000
231.137.181.32,<->,136.25.188.162,0,0,1,50,1,50,0.703652000,0.0000
66.57.136.199,<->,8.252.221.204,0,0,1,50,1,50,0.703481000,0.0000
38.21.156.204,<->,20.232.228.246,0,0,1,82,1,82,0.703421000,0.0000
205.224.29.67,<->,100.93.232.193,0,0,1,326,1,326,0.703369000,0.0000
80.40.42.207,<->,40.207.150.237,1,52,0,0,1,52,0.703220000,0.0000
125.216.6.208,<->,8.43.221.43,0,0,1,704,1,704,0.702955000,0.0000
145.3.142.7,<->,39.237.228.215,0,0,1,64,1,64,0.702592000,0.0000
215.158.238.205,<->,192.205.47.68,1,1002,0,0,1,1002,0.702410000,0.0000
192.64.248.243,<->,127.170.80.113,1,52,0,0,1,52,0.702291000,0.0000
93.141.116.172,<->,92.27.219.39,0,0,1,50,1,50,0.701737000,0.0000
210.220.219.153,<->,50.239.28.53,1,50,0,0,1,50,0.701493000,0.0000
38.21.156.204,<->,20.232.228.254,0,0,1,82,1,82,0.701049000,0.0000
196.204.142.121,<->,136.25.188.163,0,0,1,56,1,56,0.700939000,0.0000
192.67.152.0,<->,114.245.102.138,1,56,0,0,1,56,0.700756000,0.0000
246.253.222.199,<->,52.152.91.154,1,79,0,0,1,79,0.700618000,0.0000
159.140.232.210,<->,141.172.29.182,0,0,1,50,1,50,0.700615000,0.0000
97.126.119.99,<->,53.159.34.186,1,50,0,0,1,50,0.700361000,0.0000
198.185.158.73,<->,92.27.219.17,0,0,1,130,1,130,0.700345000,0.0000
59.35.252.53,<->,39.235.56.149,0,0,1,76,1,76,0.700046000,0.0000
199.20.21.232,<->,92.27.194.147,0,0,1,50,1,50,0.699857000,0.0000
215.158.2.127,<->,8.176.8.234,0,0,1,90,1,90,0.699773000,0.0000
201.219.35.9,<->,109.222.246.106,0,0,1,90,1,90,0.699436000,0.0000
215.158.239.79,<->,196.104.199.102,1,68,0,0,1,68,0.699425000,0.0000
147.61.214.19,<->,136.129.71.19,0,0,1,146,1,146,0.699123000,0.0000
108.134.119.186,<->,107.99.137.90,1,89,0,0,1,89,0.698878000,0.0000
109.222.217.93,<->,108.246.28.215,1,77,0,0,1,77,0.698861000,0.0000
192.229.216.117,<->,91.50.202.218,1,50,0,0,1,50,0.698298000,0.0000
100.92.96.108,<->,89.205.220.129,1,50,0,0,1,50,0.698289000,0.0000
100.92.51.73,<->,27.253.69.248,1,412,0,0,1,412,0.698194000,0.0000
192.67.167.86,<->,92.13.192.251,1,52,0,0,1,52,0.698099000,0.0000
196.89.221.5,<->,136.25.188.175,0,0,1,64,1,64,0.697858000,0.0000
192.67.169.201,<->,100.124.212.156,1,56,0,0,1,56,0.697701000,0.0000
75.62.16.8,<->,39.58.196.140,0,0,1,50,1,50,0.697700000,0.0000
197.113.65.0,<->,136.25.188.55,0,0,1,64,1,64,0.697643000,0.0000
76.101.120.55,<->,8.220.205.50,0,0,1,704,1,704,0.697243000,0.0000
215.158.103.219,<->,159.151.90.195,1,137,0,0,1,137,0.697202000,0.0000
204.186.95.64,<->,136.25.188.209,0,0,1,68,1,68,0.696985000,0.0000
241.193.172.231,<->,20.50.91.191,0,0,1,50,1,50,0.696889000,0.0000
207.66.33.41,<->,129.224.112.252,0,0,1,79,1,79,0.696823000,0.0000
139.248.201.139,<->,96.190.12.63,1,80,0,0,1,80,0.696729000,0.0000
143.20.121.215,<->,8.220.185.34,0,0,1,704,1,704,0.696591000,0.0000
122.228.238.242,<->,39.23.51.74,0,0,1,68,1,68,0.696538000,0.0000
208.197.102.102,<->,98.232.172.60,0,0,1,75,1,75,0.695580000,0.0000
39.189.129.43,<->,8.176.49.169,0,0,1,50,1,50,0.695412000,0.0000
147.54.67.205,<->,34.230.150.26,0,0,1,538,1,538,0.695340000,0.0000
111.237.175.187,<->,39.24.208.138,0,0,1,64,1,64,0.695319000,0.0000
200.174.218.232,<->,53.245.254.83,1,56,0,0,1,56,0.695205000,0.0000
112.6.232.7,<->,50.224.89.241,0,0,1,50,1,50,0.694997000,0.0000
215.158.103.206,<->,53.222.171.58,1,82,0,0,1,82,0.694978000,0.0000
206.144.195.198,<->,20.247.123.14,0,0,1,80,1,80,0.694927000,0.0000
234.17.243.111,<->,136.25.188.163,0,0,1,56,1,56,0.694128000,0.0000
114.128.248.198,<->,109.1.3.222,0,0,1,58,1,58,0.694017000,0.0000
146.196.107.134,<->,20.40.206.169,0,0,1,60,1,60,0.693893000,0.0000
144.75.218.235,<->,138.127.231.201,1,237,0,0,1,237,0.693723000,0.0000
100.182.99.11,<->,20.179.124.104,0,0,1,52,1,52,0.693507000,0.0000
244.50.129.64,<->,20.64.173.125,0,0,1,50,1,50,0.693392000,0.0000
196.13.0.1,<->,20.241.76.36,0,0,1,108,1,108,0.693281000,0.0000
152.37.100.190,<->,99.162.73.8,0,0,1,135,1,135,0.693229000,0.0000
89.183.104.160,<->,75.95.159.50,1,353,0,0,1,353,0.692852000,0.0000
192.105.127.33,<->,133.178.226.77,0,0,1,1064,1,1064,0.691881000,0.0000
200.175.239.147,<->,53.161.180.137,1,50,0,0,1,50,0.691679000,0.0000
120.248.109.0,<->,20.220.48.74,0,0,1,64,1,64,0.691497000,0.0000
144.75.218.246,<->,138.127.230.221,1,365,0,0,1,365,0.691157000,0.0000
199.72.20.51,<->,136.25.188.225,0,0,1,765,1,765,0.690849000,0.0000
215.158.239.96,<->,207.114.215.13,1,250,0,0,1,250,0.690514000,0.0000
221.102.123.23,<->,199.12.99.109,1,50,0,0,1,50,0.690507000,0.0000
199.70.203.153,<->,136.25.188.255,0,0,1,717,1,717,0.690424000,0.0000
192.67.161.171,<->,79.255.218.236,1,133,0,0,1,133,0.690352000,0.0000
149.228.97.44,<->,144.75.218.235,0,0,1,127,1,127,0.690117000,0.0000
101.224.204.141,<->,89.211.37.130,1,85,0,0,1,85,0.689931000,0.0000
247.136.251.138,<->,53.148.27.10,1,125,0,0,1,125,0.689856000,0.0000
42.129.115.3,<->,20.173.54.228,0,0,1,52,1,52,0.689596000,0.0000
92.27.219.32,<->,29.135.115.226,1,351,0,0,1,351,0.689357000,0.0000
207.60.89.223,<->,136.25.188.52,0,0,1,56,1,56,0.689292000,0.0000
204.63.113.237,<->,136.25.188.236,0,0,1,56,1,56,0.688972000,0.0000
247.136.146.192,<->,33.78.157.7,1,52,0,0,1,52,0.688887000,0.0000
247.136.139.153,<->,126.198.202.12,1,317,0,0,1,317,0.688883000,0.0000
109.222.214.26,<->,97.36.109.42,1,66,0,0,1,66,0.688847000,0.0000
144.75.218.237,<->,138.127.224.241,1,215,0,0,1,215,0.688790000,0.0000
60.103.87.91,<->,34.172.170.229,0,0,1,60,1,60,0.688681000,0.0000
89.183.104.191,<->,38.52.7.49,1,52,0,0,1,52,0.688396000,0.0000
98.217.9.93,<->,74.240.66.155,1,130,0,0,1,130,0.687962000,0.0000
210.213.172.204,<->,192.64.205.235,0,0,1,50,1,50,0.687958000,0.0000
203.76.53.47,<->,8.20.87.94,0,0,1,50,1,50,0.687762000,0.0000
119.50.12.116,<->,39.133.58.192,0,0,1,78,1,78,0.687530000,0.0000
221.102.103.73,<->,194.245.224.40,1,50,0,0,1,50,0.687400000,0.0000
127.77.246.94,<->,92.27.219.179,0,0,1,52,1,52,0.687308000,0.0000
144.123.49.227,<->,120.155.84.161,1,139,0,0,1,139,0.687017000,0.0000
206.72.179.52,<->,20.98.60.58,0,0,1,64,1,64,0.686970000,0.0000
249.101.202.25,<->,239.66.125.236,1,56,0,0,1,56,0.686219000,0.0000
126.219.56.231,<->,8.43.194.5,0,0,1,704,1,704,0.686130000,0.0000
39.169.146.185,<->,38.227.164.16,1,56,0,0,1,56,0.685676000,0.0000
196.246.128.82,<->,136.25.188.175,0,0,1,68,1,68,0.685672000,0.0000
112.87.29.241,<->,20.173.234.15,0,0,1,64,1,64,0.685624000,0.0000
136.25.188.162,<->,76.219.13.238,1,50,0,0,1,50,0.685581000,0.0000
249.101.193.220,<->,97.110.90.232,1,414,0,0,1,414,0.685527000,0.0000
99.167.136.236,<->,8.222.6.124,1,50,0,0,1,50,0.685170000,0.0000
215.158.61.242,<->,8.176.8.202,0,0,1,658,1,658,0.685164000,0.0000
215.158.239.38,<->,111.150.207.140,1,100,0,0,1,100,0.685123000,0.0000
133.178.227.23,<->,128.156.144.228,1,80,0,0,1,80,0.685017000,0.0000
80.42.134.4,<->,57.218.111.137,1,321,0,0,1,321,0.684875000,0.0000
205.165.37.182,<->,92.27.219.185,0,0,1,349,1,349,0.684837000,0.0000
215.158.239.93,<->,204.0.150.249,1,68,0,0,1,68,0.684709000,0.0000
21.15.226.126,<->,20.193.63.140,0,0,1,82,1,82,0.684550000,0.0000
144.75.218.235,<->,138.127.224.239,1,366,0,0,1,366,0.684474000,0.0000
142.235.87.114,<->,99.73.184.38,0,0,1,100,1,100,0.684224000,0.0000
136.25.189.94,<->,29.212.196.10,1,83,0,0,1,83,0.683815000,0.0000
215.158.239.86,<->,196.107.82.68,1,56,0,0,1,56,0.683569000,0.0000
215.158.239.117,<->,123.130.135.22,1,68,0,0,1,68,0.683377000,0.0000
111.147.213.111,<->,54.69.178.55,1,128,0,0,1,128,0.683372000,0.0000
159.112.9.198,<->,139.163.127.246,0,0,1,50,1,50,0.683317000,0.0000
246.253.253.213,<->,204.90.228.11,1,50,0,0,1,50,0.682944000,0.0000
124.38.144.229,<->,39.251.205.147,0,0,1,108,1,108,0.682799000,0.0000
216.144.223.26,<->,215.158.140.193,0,0,1,50,1,50,0.682027000,0.0000
200.174.213.73,<->,80.15.91.234,1,56,0,0,1,56,0.681792000,0.0000
194.233.93.15,<->,136.25.188.254,0,0,1,50,1,50,0.681639000,0.0000
215.158.238.180,<->,159.49.96.73,1,1064,0,0,1,1064,0.681303000,0.0000
215.158.61.243,<->,8.176.8.216,0,0,1,1395,1,1395,0.681190000,0.0000
247.136.131.3,<->,75.95.103.7,1,73,0,0,1,73,0.680932000,0.0000
247.136.208.42,<->,50.248.185.226,1,56,0,0,1,56,0.680701000,0.0000
137.21.23.51,<->,111.150.207.80,1,100,0,0,1,100,0.680687000,0.0000
144.54.14.68,<->,132.249.70.213,0,0,1,141,1,141,0.680599000,0.0000
215.158.239.48,<->,195.49.129.145,1,68,0,0,1,68,0.680584000,0.0000
142.248.97.163,<->,136.25.188.227,0,0,1,64,1,64,0.680407000,0.0000
224.213.229.84,<->,111.146.145.17,0,0,1,50,1,50,0.680382000,0.0000
220.20.200.114,<->,33.57.77.52,1,56,0,0,1,56,0.679889000,0.0000
144.75.218.241,<->,132.6.55.46,1,147,0,0,1,147,0.679887000,0.0000
92.27.131.66,<->,8.252.222.177,0,0,1,50,1,50,0.679850000,0.0000
126.25.17.12,<->,20.220.65.11,0,0,1,147,1,147,0.679786000,0.0000
224.129.227.70,<->,8.183.24.179,0,0,1,50,1,50,0.679368000,0.0000
17.27.56.184,<->,8.20.87.210,0,0,1,50,1,50,0.679279000,0.0000
137.21.3.121,<->,97.94.123.83,1,50,0,0,1,50,0.679195000,0.0000
134.195.15.243,<->,92.27.219.232,0,0,1,66,1,66,0.679170000,0.0000
149.200.220.216,<->,145.242.126.23,0,0,1,80,1,80,0.679157000,0.0000
101.224.183.152,<->,100.211.114.205,1,79,0,0,1,79,0.678995000,0.0000
199.52.30.196,<->,136.25.188.225,0,0,1,56,1,56,0.678737000,0.0000
196.92.46.65,<->,136.25.188.237,0,0,1,56,1,56,0.678482000,0.0000
104.96.114.255,<->,39.232.244.135,0,0,1,56,1,56,0.678034000,0.0000
215.158.239.96,<->,207.61.28.166,1,56,0,0,1,56,0.677890000,0.0000
89.216.125.215,<->,8.58.135.253,1,56,0,0,1,56,0.677675000,0.0000
92.27.27.143,<->,72.43.45.118,1,52,0,0,1,52,0.677132000,0.0000
194.196.213.236,<->,39.146.97.79,0,0,1,70,1,70,0.677009000,0.0000
149.201.60.62,<->,39.160.63.11,0,0,1,130,1,130,0.676870000,0.0000
144.75.218.246,<->,140.142.131.1,1,77,0,0,1,77,0.676241000,0.0000
204.25.101.14,<->,39.44.219.49,0,0,1,60,1,60,0.675736000,0.0000
192.67.167.86,<->,99.237.201.190,1,50,0,0,1,50,0.675470000,0.0000
244.50.136.175,<->,39.1.79.165,0,0,1,50,1,50,0.675332000,0.0000
144.79.8.89,<->,89.183.110.30,0,0,1,68,1,68,0.675309000,0.0000
144.86.148.228,<->,27.11.52.246,1,95,0,0,1,95,0.675197000,0.0000
215.158.239.103,<->,139.252.1.233,1,160,0,0,1,160,0.675133000,0.0000
50.224.76.248,<->,38.28.239.78,1,56,0,0,1,56,0.674930000,0.0000
118.4.162.8,<->,20.166.53.28,0,0,1,68,1,68,0.674857000,0.0000
102.50.47.32,<->,42.90.92.235,1,326,0,0,1,326,0.674808000,0.0000
17.128.214.140,<->,8.220.184.183,0,0,1,56,1,56,0.674787000,0.0000
207.204.91.186,<->,50.224.76.235,0,0,1,50,1,50,0.674765000,0.0000
143.134.78.9,<->,136.25.188.227,0,0,1,50,1,50,0.674741000,0.0000
215.158.140.187,<->,98.224.152.243,1,50,0,0,1,50,0.674520000,0.0000
48.53.240.104,<->,6.130.73.133,1,52,0,0,1,52,0.674405000,0.0000
244.50.242.201,<->,20.120.200.36,0,0,1,50,1,50,0.674353000,0.0000
21.15.226.126,<->,20.193.63.27,0,0,1,82,1,82,0.674161000,0.0000
215.158.103.219,<->,157.110.115.195,1,89,0,0,1,89,0.673997000,0.0000
158.13.237.24,<->,39.0.33.9,0,0,1,52,1,52,0.673529000,0.0000
195.68.208.36,<->,136.25.188.176,0,0,1,64,1,64,0.673075000,0.0000
107.10.174.193,<->,8.250.150.212,0,0,1,50,1,50,0.672889000,0.0000
199.21.105.3,<->,39.49.189.1,0,0,1,52,1,52,0.672810000,0.0000
210.229.230.18,<->,91.55.91.83,1,68,0,0,1,68,0.672621000,0.0000
121.252.25.54,<->,56.121.56.58,0,0,1,1245,1,1245,0.672445000,0.0000
98.67.140.202,<->,92.22.181.95,1,68,0,0,1,68,0.672178000,0.0000
230.58.201.38,<->,34.27.72.179,0,0,1,60,1,60,0.672153000,0.0000
127.29.150.181,<->,39.224.180.235,0,0,1,74,1,74,0.672128000,0.0000
159.140.232.210,<->,96.62.133.242,0,0,1,50,1,50,0.672006000,0.0000
204.181.177.50,<->,39.162.68.8,0,0,1,60,1,60,0.671999000,0.0000
199.29.88.191,<->,92.27.27.151,0,0,1,263,1,263,0.671847000,0.0000
229.59.1.44,<->,220.55.79.118,0,0,1,70,1,70,0.671723000,0.0000
247.136.204.55,<->,106.188.252.174,1,56,0,0,1,56,0.671678000,0.0000
120.206.187.17,<->,92.27.27.181,0,0,1,50,1,50,0.671499000,0.0000
192.64.248.200,<->,48.106.107.129,1,53,0,0,1,53,0.671022000,0.0000
126.103.58.218,<->,92.27.219.237,0,0,1,321,1,321,0.670894000,0.0000
129.245.206.220,<->,89.183.104.157,0,0,1,659,1,659,0.670866000,0.0000
80.5.27.123,<->,8.220.178.166,0,0,1,50,1,50,0.670727000,0.0000
204.1.151.201,<->,136.25.188.53,0,0,1,50,1,50,0.670700000,0.0000
136.25.189.47,<->,111.151.78.40,1,704,0,0,1,704,0.670248000,0.0000
215.158.239.84,<->,207.16.225.42,1,64,0,0,1,64,0.670197000,0.0000
207.87.179.41,<->,20.190.43.59,0,0,1,64,1,64,0.669905000,0.0000
206.103.215.240,<->,192.229.212.235,0,0,1,704,1,704,0.669870000,0.0000
100.182.99.11,<->,20.179.125.87,0,0,1,52,1,52,0.669812000,0.0000
215.158.1.207,<->,6.73.247.62,0,0,1,84,1,84,0.669756000,0.0000
140.174.85.71,<->,8.43.213.44,0,0,1,704,1,704,0.669698000,0.0000
134.254.243.178,<->,101.224.191.148,0,0,1,50,1,50,0.669580000,0.0000
215.158.239.66,<->,122.158.179.74,1,85,0,0,1,85,0.669564000,0.0000
210.220.219.153,<->,111.20.47.86,1,118,0,0,1,118,0.669563000,0.0000
215.158.239.92,<->,196.109.59.80,1,602,0,0,1,602,0.669500000,0.0000
129.229.242.60,<->,97.126.116.180,0,0,1,142,1,142,0.669358000,0.0000
112.136.164.234,<->,50.224.76.235,0,0,1,50,1,50,0.669100000,0.0000
35.32.203.123,<->,34.180.26.218,0,0,1,52,1,52,0.669095000,0.0000
127.250.7.59,<->,98.67.136.238,0,0,1,78,1,78,0.668923000,0.0000
69.221.65.158,<->,34.92.85.203,0,0,1,52,1,52,0.668501000,0.0000
207.117.105.242,<->,8.182.224.180,0,0,1,50,1,50,0.668258000,0.0000
120.154.172.95,<->,8.176.8.215,0,0,1,111,1,111,0.667983000,0.0000
221.102.143.189,<->,98.128.164.99,0,0,1,141,1,141,0.667851000,0.0000
246.254.97.149,<->,144.95.255.201,1,89,0,0,1,89,0.667745000,0.0000
111.20.172.119,<->,111.20.168.28,0,0,1,50,1,50,0.667160000,0.0000
199.63.179.13,<->,39.35.61.17,0,0,1,107,1,107,0.667074000,0.0000
118.103.74.218,<->,80.40.48.220,0,0,1,130,1,130,0.666981000,0.0000
205.209.170.212,<->,80.40.24.193,0,0,1,319,1,319,0.666842000,0.0000
247.136.165.38,<->,134.161.152.3,1,243,0,0,1,243,0.666831000,0.0000
145.19.6.54,<->,92.162.59.189,1,50,0,0,1,50,0.666667000,0.0000
149.50.187.76,<->,20.199.243.183,0,0,1,64,1,64,0.666337000,0.0000
241.193.172.231,<->,20.6.35.228,0,0,1,50,1,50,0.665844000,0.0000
215.158.140.27,<->,136.26.12.81,1,50,0,0,1,50,0.665721000,0.0000
111.151.109.39,<->,8.252.223.164,0,0,1,56,1,56,0.665537000,0.0000
210.209.251.214,<->,111.147.131.97,0,0,1,50,1,50,0.664069000,0.0000
111.151.239.7,<->,8.228.216.50,0,0,1,50,1,50,0.664057000,0.0000
144.75.218.246,<->,138.127.231.82,1,254,0,0,1,254,0.663885000,0.0000
149.246.94.20,<->,136.25.188.105,0,0,1,180,1,180,0.663701000,0.0000
101.70.119.29,<->,86.242.75.89,1,135,0,0,1,135,0.663585000,0.0000
116.236.186.198,<->,39.22.82.29,0,0,1,667,1,667,0.663545000,0.0000
199.20.5.54,<->,8.20.87.153,0,0,1,56,1,56,0.663344000,0.0000
126.253.26.254,<->,20.10.173.81,0,0,1,64,1,64,0.663178000,0.0000
144.69.82.139,<->,54.60.194.157,1,75,0,0,1,75,0.663035000,0.0000
121.35.112.201,<->,92.27.219.128,0,0,1,1446,1,1446,0.662720000,0.0000
247.136.254.97,<->,221.196.94.56,1,136,0,0,1,136,0.662714000,0.0000
195.77.22.79,<->,159.137.212.194,0,0,1,104,1,104,0.662542000,0.0000
29.211.214.80,<->,8.219.186.181,1,73,0,0,1,73,0.662307000,0.0000
138.127.224.103,<->,97.126.26.70,0,0,1,226,1,226,0.662143000,0.0000
215.158.61.242,<->,8.176.8.227,0,0,1,1420,1,1420,0.662072000,0.0000
199.14.159.160,<->,136.25.188.210,0,0,1,157,1,157,0.662052000,0.0000
210.209.251.214,<->,97.126.47.18,0,0,1,50,1,50,0.662044000,0.0000
249.101.103.55,<->,76.72.246.226,1,133,0,0,1,133,0.661758000,0.0000
195.39.175.170,<->,20.249.182.175,0,0,1,64,1,64,0.661428000,0.0000
197.154.195.217,<->,136.25.188.199,0,0,1,121,1,121,0.661081000,0.0000
109.222.195.53,<->,105.234.75.198,1,52,0,0,1,52,0.660944000,0.0000
144.75.218.242,<->,138.127.225.29,1,365,0,0,1,365,0.659445000,0.0000
215.158.103.219,<->,80.56.76.191,1,77,0,0,1,77,0.659433000,0.0000
133.178.227.138,<->,104.3.162.76,1,56,0,0,1,56,0.659407000,0.0000
193.21.28.204,<->,92.27.219.180,0,0,1,64,1,64,0.659401000,0.0000
207.190.36.143,<->,136.25.188.174,0,0,1,50,1,50,0.659316000,0.0000
247.157.159.32,<->,230.115.135.194,1,133,0,0,1,133,0.659299000,0.0000
220.85.250.190,<->,92.27.219.175,0,0,1,50,1,50,0.659137000,0.0000
120.181.9.116,<->,80.40.48.131,0,0,1,60,1,60,0.658797000,0.0000
215.158.140.10,<->,111.151.109.41,1,64,0,0,1,64,0.658678000,0.0000
138.127.224.238,<->,89.139.241.98,0,0,1,221,1,221,0.658566000,0.0000
156.30.10.180,<->,8.238.59.156,0,0,1,133,1,133,0.657790000,0.0000
42.249.74.120,<->,39.225.103.68,0,0,1,64,1,64,0.657517000,0.0000
221.102.143.189,<->,109.3.178.60,0,0,1,141,1,141,0.657481000,0.0000
192.65.80.104,<->,112.70.38.65,1,349,0,0,1,349,0.657324000,0.0000
121.13.86.14,<->,20.176.48.109,0,0,1,50,1,50,0.657234000,0.0000
144.75.218.233,<->,138.127.231.221,1,310,0,0,1,310,0.656593000,0.0000
207.92.23.36,<->,8.182.227.210,0,0,1,50,1,50,0.656128000,0.0000
120.190.31.249,<->,8.43.210.250,0,0,1,704,1,704,0.655959000,0.0000
241.193.172.231,<->,20.27.62.90,0,0,1,50,1,50,0.655853000,0.0000
248.225.27.2,<->,111.25.52.96,1,56,0,0,1,56,0.655017000,0.0000
207.62.9.159,<->,136.25.188.242,0,0,1,125,1,125,0.654692000,0.0000
215.158.103.206,<->,29.214.217.32,1,146,0,0,1,146,0.654443000,0.0000
144.75.218.246,<->,138.127.225.29,1,365,0,0,1,365,0.654428000,0.0000
215.158.199.136,<->,8.43.182.237,0,0,1,704,1,704,0.654416000,0.0000
116.110.29.86,<->,92.162.252.32,0,0,1,119,1,119,0.654175000,0.0000
215.158.103.219,<->,65.192.53.21,1,135,0,0,1,135,0.653801000,0.0000
144.75.218.242,<->,93.77.5.122,1,77,0,0,1,77,0.653223000,0.0000
54.37.5.99,<->,48.53.34.202,0,0,1,56,1,56,0.653012000,0.0000
220.55.91.56,<->,57.212.60.129,1,122,0,0,1,122,0.652885000,0.0000
234.156.65.142,<->,136.25.188.176,0,0,1,50,1,50,0.652787000,0.0000
80.40.25.242,<->,38.52.146.167,1,52,0,0,1,52,0.652575000,0.0000
94.192.198.174,<->,90.240.131.44,0,0,1,319,1,319,0.651890000,0.0000
144.75.218.237,<->,138.127.231.102,1,263,0,0,1,263,0.651799000,0.0000
133.178.227.44,<->,111.151.142.152,1,56,0,0,1,56,0.651712000,0.0000
215.158.239.120,<->,158.85.35.242,1,141,0,0,1,141,0.651680000,0.0000
215.158.239.68,<->,199.20.30.62,1,1022,0,0,1,1022,0.651645000,0.0000
246.253.248.211,<->,53.199.195.19,1,86,0,0,1,86,0.651620000,0.0000
215.201.235.99,<->,8.182.244.237,0,0,1,56,1,56,0.651432000,0.0000
119.90.250.200,<->,39.237.196.86,0,0,1,50,1,50,0.651334000,0.0000
204.50.252.177,<->,39.159.227.58,0,0,1,60,1,60,0.651001000,0.0000
215.158.239.92,<->,143.99.90.145,1,700,0,0,1,700,0.650902000,0.0000
230.9.8.84,<->,220.87.49.198,0,0,1,130,1,130,0.650783000,0.0000
145.3.142.7,<->,39.237.228.218,0,0,1,64,1,64,0.650611000,0.0000
193.77.246.1,<->,20.78.138.50,0,0,1,52,1,52,0.650192000,0.0000
215.158.140.11,<->,111.151.142.231,1,56,0,0,1,56,0.650086000,0.0000
247.136.231.91,<->,206.54.196.41,1,52,0,0,1,52,0.650079000,0.0000
159.23.225.99,<->,116.143.239.30,1,50,0,0,1,50,0.650058000,0.0000
152.46.83.147,<->,80.27.158.136,0,0,1,125,1,125,0.649914000,0.0000
116.0.231.14,<->,39.58.17.116,0,0,1,52,1,52,0.649724000,0.0000
99.157.235.29,<->,8.52.171.31,0,0,1,50,1,50,0.649596000,0.0000
20.13.109.47,<->,0.200.50.50,1,60,0,0,1,60,0.649360000,0.0000
144.71.44.80,<->,48.5.216.57,1,50,0,0,1,50,0.649043000,0.0000
133.0.57.72,<->,56.121.54.13,0,0,1,56,1,56,0.648965000,0.0000
246.253.79.141,<->,119.90.251.239,1,50,0,0,1,50,0.648442000,0.0000
129.92.118.168,<->,53.190.175.138,1,56,0,0,1,56,0.648177000,0.0000
92.27.27.169,<->,78.55.213.169,1,64,0,0,1,64,0.648072000,0.0000
149.102.122.164,<->,50.224.76.234,0,0,1,65,1,65,0.647937000,0.0000
92.27.219.178,<->,57.208.126.68,1,52,0,0,1,52,0.647936000,0.0000
68.79.184.163,<->,8.252.221.199,0,0,1,50,1,50,0.647882000,0.0000
144.75.218.241,<->,56.115.164.225,1,175,0,0,1,175,0.647860000,0.0000
220.60.50.113,<->,8.53.3.217,0,0,1,84,1,84,0.647587000,0.0000
194.106.142.25,<->,39.54.157.134,0,0,1,52,1,52,0.647407000,0.0000
89.216.124.92,<->,8.235.214.225,1,50,0,0,1,50,0.647275000,0.0000
195.41.69.181,<->,136.25.188.177,0,0,1,56,1,56,0.647186000,0.0000
75.62.16.8,<->,39.200.85.203,0,0,1,50,1,50,0.647123000,0.0000
89.183.104.145,<->,40.204.213.22,1,164,0,0,1,164,0.646509000,0.0000
17.12.130.178,<->,8.220.235.114,0,0,1,50,1,50,0.646099000,0.0000
111.150.207.137,<->,8.252.221.75,0,0,1,100,1,100,0.645979000,0.0000
124.158.81.239,<->,20.253.157.108,0,0,1,52,1,52,0.645973000,0.0000
192.67.143.178,<->,53.77.50.188,1,56,0,0,1,56,0.645854000,0.0000
207.7.180.232,<->,39.164.8.246,0,0,1,60,1,60,0.645746000,0.0000
195.36.141.86,<->,20.69.10.247,0,0,1,74,1,74,0.645733000,0.0000
247.136.227.198,<->,118.100.40.167,1,321,0,0,1,321,0.645689000,0.0000
241.193.172.231,<->,20.199.117.12,0,0,1,50,1,50,0.645622000,0.0000
239.170.100.210,<->,136.25.189.5,0,0,1,165,1,165,0.645215000,0.0000
205.224.29.85,<->,82.229.132.133,0,0,1,144,1,144,0.645078000,0.0000
221.102.143.189,<->,192.66.172.117,0,0,1,141,1,141,0.644878000,0.0000
119.127.194.253,<->,20.236.177.134,0,0,1,64,1,64,0.644768000,0.0000
215.158.210.97,<->,215.158.23.31,0,0,1,56,1,56,0.644601000,0.0000
80.42.173.148,<->,38.85.254.159,1,56,0,0,1,56,0.644507000,0.0000
221.102.110.4,<->,100.241.191.28,1,50,0,0,1,50,0.644336000,0.0000
204.1.235.25,<->,136.25.188.255,0,0,1,64,1,64,0.644285000,0.0000
145.252.126.61,<->,67.128.27.205,1,76,0,0,1,76,0.644271000,0.0000
93.73.95.165,<->,89.183.104.232,0,0,1,52,1,52,0.644242000,0.0000
231.143.97.197,<->,136.25.188.46,0,0,1,56,1,56,0.644052000,0.0000
33.246.152.154,<->,20.238.248.215,0,0,1,72,1,72,0.644047000,0.0000
230.116.229.58,<->,98.129.112.215,0,0,1,149,1,149,0.643770000,0.0000
238.118.126.42,<->,56.96.128.220,1,56,0,0,1,56,0.643747000,0.0000
148.146.75.16,<->,8.220.180.244,0,0,1,704,1,704,0.643606000,0.0000
220.50.242.197,<->,92.27.219.179,0,0,1,50,1,50,0.643428000,0.0000
199.13.105.183,<->,100.92.220.68,0,0,1,52,1,52,0.642851000,0.0000
139.193.141.139,<->,127.72.187.248,1,50,0,0,1,50,0.642454000,0.0000
241.193.172.231,<->,20.50.83.119,0,0,1,50,1,50,0.642442000,0.0000
113.128.39.3,<->,98.236.235.32,0,0,1,56,1,56,0.642125000,0.0000
153.138.23.31,<->,132.222.173.5,0,0,1,52,1,52,0.641797000,0.0000
118.120.58.175,<->,100.94.88.51,0,0,1,149,1,149,0.641277000,0.0000
215.158.239.48,<->,199.20.30.218,1,101,0,0,1,101,0.641247000,0.0000
193.46.99.150,<->,92.27.219.187,0,0,1,90,1,90,0.641167000,0.0000
145.226.75.120,<->,39.19.18.11,0,0,1,64,1,64,0.641084000,0.0000
92.27.219.139,<->,87.62.245.7,1,101,0,0,1,101,0.640804000,0.0000
204.89.88.29,<->,100.92.2.225,0,0,1,56,1,56,0.640752000,0.0000
144.87.235.187,<->,138.127.225.227,1,252,0,0,1,252,0.640603000,0.0000
147.176.48.103,<->,39.39.180.244,0,0,1,140,1,140,0.640584000,0.0000
21.15.226.126,<->,20.193.62.73,0,0,1,82,1,82,0.640090000,0.0000
206.63.227.193,<->,92.27.219.231,0,0,1,1377,1,1377,0.640057000,0.0000
159.112.9.198,<->,132.149.115.220,0,0,1,81,1,81,0.639759000,0.0000
109.2.69.22,<->,8.55.226.90,1,56,0,0,1,56,0.639540000,0.0000
215.158.239.218,<->,206.241.19.118,1,310,0,0,1,310,0.639106000,0.0000
131.233.74.166,<->,39.11.125.130,0,0,1,76,1,76,0.638947000,0.0000
197.113.98.49,<->,136.25.188.174,0,0,1,56,1,56,0.638808000,0.0000
100.93.185.72,<->,8.55.224.156,1,141,0,0,1,141,0.638740000,0.0000
247.136.240.175,<->,8.209.235.29,1,56,0,0,1,56,0.638681000,0.0000
210.236.205.21,<->,139.163.121.135,0,0,1,56,1,56,0.638505000,0.0000
139.163.45.228,<->,138.127.224.243,1,245,0,0,1,245,0.638227000,0.0000
241.193.172.231,<->,20.177.250.138,0,0,1,50,1,50,0.637965000,0.0000
144.75.218.237,<->,136.129.94.109,1,90,0,0,1,90,0.637710000,0.0000
197.197.68.90,<->,129.224.112.252,0,0,1,73,1,73,0.637664000,0.0000
215.158.238.101,<->,98.219.126.175,1,56,0,0,1,56,0.637225000,0.0000
140.158.247.164,<->,8.52.169.89,0,0,1,50,1,50,0.637091000,0.0000
210.209.251.211,<->,109.1.18.113,0,0,1,50,1,50,0.636863000,0.0000
205.152.222.67,<->,92.27.219.158,0,0,1,163,1,163,0.636706000,0.0000
192.171.13.80,<->,8.252.222.119,0,0,1,134,1,134,0.636062000,0.0000
215.158.239.76,<->,207.63.221.199,1,68,0,0,1,68,0.636010000,0.0000
98.67.130.23,<->,72.145.48.171,1,80,0,0,1,80,0.635642000,0.0000
196.113.186.195,<->,39.246.85.235,0,0,1,64,1,64,0.635613000,0.0000
192.64.217.166,<->,133.202.60.104,1,52,0,0,1,52,0.635575000,0.0000
53.149.175.135,<->,48.54.153.16,0,0,1,64,1,64,0.635280000,0.0000
247.136.186.159,<->,38.254.212.90,1,58,0,0,1,58,0.635119000,0.0000
80.41.55.98,<->,69.95.118.50,1,130,0,0,1,130,0.634948000,0.0000
68.154.104.122,<->,20.167.131.155,0,0,1,517,1,517,0.634333000,0.0000
195.126.191.229,<->,136.25.188.53,0,0,1,56,1,56,0.634285000,0.0000
54.37.202.190,<->,48.53.136.46,0,0,1,50,1,50,0.634193000,0.0000
241.193.172.231,<->,20.90.246.183,0,0,1,50,1,50,0.634189000,0.0000
199.33.84.183,<->,136.25.188.197,0,0,1,68,1,68,0.634167000,0.0000
142.209.130.161,<->,136.25.188.173,0,0,1,56,1,56,0.633703000,0.0000
210.158.44.208,<->,120.155.84.161,1,125,0,0,1,125,0.633640000,0.0000
241.193.172.231,<->,20.229.68.60,0,0,1,50,1,50,0.633455000,0.0000
198.158.197.83,<->,20.77.171.218,0,0,1,50,1,50,0.633391000,0.0000
38.91.97.206,<->,20.167.129.36,0,0,1,64,1,64,0.632790000,0.0000
93.237.78.161,<->,92.27.219.171,0,0,1,261,1,261,0.632481000,0.0000
215.158.239.69,<->,195.49.58.104,1,897,0,0,1,897,0.632391000,0.0000
205.77.98.134,<->,92.27.27.142,0,0,1,97,1,97,0.632389000,0.0000
121.25.88.239,<->,20.241.234.81,0,0,1,64,1,64,0.632002000,0.0000
215.158.239.97,<->,199.20.30.59,1,68,0,0,1,68,0.632001000,0.0000
215.158.239.78,<->,204.226.8.29,1,50,0,0,1,50,0.631906000,0.0000
204.200.49.187,<->,136.25.188.226,0,0,1,50,1,50,0.631735000,0.0000
108.39.179.21,<->,100.50.97.9,1,64,0,0,1,64,0.631259000,0.0000
105.69.65.62,<->,20.126.163.211,0,0,1,64,1,64,0.630957000,0.0000
118.98.251.158,<->,20.139.193.185,0,0,1,100,1,100,0.630728000,0.0000
192.67.159.62,<->,128.216.176.204,1,56,0,0,1,56,0.630084000,0.0000
144.64.139.146,<->,124.152.54.18,1,80,0,0,1,80,0.630083000,0.0000
127.178.109.106,<->,39.40.129.5,0,0,1,70,1,70,0.629752000,0.0000
194.105.236.216,<->,129.224.112.252,0,0,1,83,1,83,0.629622000,0.0000
232.31.64.94,<->,100.92.71.28,0,0,1,64,1,64,0.629466000,0.0000
159.13.218.93,<->,53.167.26.83,1,678,0,0,1,678,0.629400000,0.0000
215.158.238.187,<->,111.151.142.130,1,56,0,0,1,56,0.629332000,0.0000
129.224.112.253,<->,33.110.84.133,1,79,0,0,1,79,0.629282000,0.0000
129.175.139.97,<->,29.211.214.32,0,0,1,121,1,121,0.628768000,0.0000
133.178.226.246,<->,8.181.148.191,1,90,0,0,1,90,0.628531000,0.0000
111.4.160.48,<->,109.222.246.201,0,0,1,72,1,72,0.628036000,0.0000
215.158.239.56,<->,143.132.118.97,1,50,0,0,1,50,0.628032000,0.0000
220.81.10.32,<->,112.208.20.181,1,163,0,0,1,163,0.627368000,0.0000
124.158.135.8,<->,39.193.23.183,0,0,1,52,1,52,0.627344000,0.0000
96.48.137.8,<->,8.52.139.2,0,0,1,1004,1,1004,0.627145000,0.0000
142.241.150.26,<->,136.25.188.55,0,0,1,50,1,50,0.627101000,0.0000
215.158.239.56,<->,207.188.114.107,1,56,0,0,1,56,0.627056000,0.0000
120.62.177.108,<->,20.201.144.238,0,0,1,64,1,64,0.627049000,0.0000
244.50.242.201,<->,20.164.90.64,0,0,1,50,1,50,0.626848000,0.0000
144.75.218.246,<->,138.127.224.134,1,366,0,0,1,366,0.626837000,0.0000
129.224.112.252,<->,105.69.92.96,1,67,0,0,1,67,0.626372000,0.0000
227.29.174.46,<->,89.183.104.164,0,0,1,56,1,56,0.626055000,0.0000
21.15.226.126,<->,20.193.62.180,0,0,1,82,1,82,0.626027000,0.0000
139.163.1.182,<->,64.76.59.13,1,73,0,0,1,73,0.626023000,0.0000
129.224.112.252,<->,105.67.198.52,1,60,0,0,1,60,0.626020000,0.0000
199.12.125.72,<->,20.11.148.143,0,0,1,64,1,64,0.625984000,0.0000
123.112.8.250,<->,20.251.180.11,0,0,1,106,1,106,0.625576000,0.0000
193.47.198.199,<->,8.53.8.151,0,0,1,67,1,67,0.625149000,0.0000
196.30.163.164,<->,97.126.110.37,0,0,1,64,1,64,0.625141000,0.0000
92.27.219.219,<->,48.107.13.127,1,90,0,0,1,90,0.625084000,0.0000
196.31.80.207,<->,89.183.104.254,0,0,1,52,1,52,0.624656000,0.0000
215.158.239.226,<->,53.85.130.165,1,343,0,0,1,343,0.624425000,0.0000
194.210.21.66,<->,8.182.253.116,0,0,1,50,1,50,0.624380000,0.0000
252.98.135.226,<->,210.209.251.223,1,481,0,0,1,481,0.624173000,0.0000
144.85.74.147,<->,95.5.80.232,1,78,0,0,1,78,0.623823000,0.0000
42.48.61.109,<->,20.194.127.11,0,0,1,84,1,84,0.623462000,0.0000
17.33.239.67,<->,8.220.176.253,0,0,1,50,1,50,0.623227000,0.0000
231.138.19.104,<->,136.25.188.196,0,0,1,56,1,56,0.622833000,0.0000
143.155.109.61,<->,109.112.165.59,0,0,1,140,1,140,0.622718000,0.0000
215.158.239.92,<->,196.92.25.207,1,50,0,0,1,50,0.622670000,0.0000
95.77.182.153,<->,92.27.27.153,0,0,1,56,1,56,0.622548000,0.0000
204.129.248.132,<->,111.147.184.124,0,0,1,50,1,50,0.622465000,0.0000
21.15.226.126,<->,20.193.62.175,0,0,1,82,1,82,0.622258000,0.0000
199.33.84.183,<->,136.25.188.176,0,0,1,68,1,68,0.622213000,0.0000
80.40.56.250,<->,69.255.253.238,1,62,0,0,1,62,0.622129000,0.0000
92.27.27.186,<->,78.52.60.47,1,50,0,0,1,50,0.622026000,0.0000
116.246.222.47,<->,92.27.219.239,0,0,1,50,1,50,0.621815000,0.0000
202.198.184.100,<->,92.181.30.186,0,0,1,133,1,133,0.621141000,0.0000
133.32.39.30,<->,111.151.106.211,1,56,0,0,1,56,0.620899000,0.0000
105.162.44.87,<->,50.224.105.34,0,0,1,56,1,56,0.620877000,0.0000
144.75.218.235,<->,138.127.231.127,1,300,0,0,1,300,0.620637000,0.0000
100.188.18.234,<->,20.78.55.39,0,0,1,103,1,103,0.620539000,0.0000
126.242.231.201,<->,20.204.244.160,0,0,1,64,1,64,0.620086000,0.0000
132.234.106.64,<->,111.181.126.171,0,0,1,50,1,50,0.620080000,0.0000
215.158.238.162,<->,126.219.102.216,1,85,0,0,1,85,0.619886000,0.0000
210.150.233.86,<->,50.224.103.163,0,0,1,82,1,82,0.619626000,0.0000
136.25.189.245,<->,8.35.106.225,1,90,0,0,1,90,0.619623000,0.0000
205.186.197.249,<->,92.27.219.224,0,0,1,135,1,135,0.619153000,0.0000
244.50.135.57,<->,39.57.198.164,0,0,1,50,1,50,0.618965000,0.0000
131.5.161.231,<->,20.178.191.164,0,0,1,52,1,52,0.618934000,0.0000
115.146.247.141,<->,92.27.219.221,0,0,1,52,1,52,0.618701000,0.0000
143.76.145.82,<->,8.182.241.177,0,0,1,50,1,50,0.618691000,0.0000
133.178.226.233,<->,111.151.109.51,1,56,0,0,1,56,0.618028000,0.0000
58.11.224.8,<->,8.250.148.227,0,0,1,704,1,704,0.617773000,0.0000
198.158.197.83,<->,20.168.239.126,0,0,1,50,1,50,0.617658000,0.0000
241.193.172.231,<->,20.80.10.252,0,0,1,50,1,50,0.617602000,0.0000
218.4.168.149,<->,111.151.239.68,1,56,0,0,1,56,0.617530000,0.0000
215.158.239.48,<->,204.0.245.126,1,64,0,0,1,64,0.617225000,0.0000
197.119.129.249,<->,8.182.234.114,0,0,1,56,1,56,0.617065000,0.0000
144.75.218.242,<->,63.69.219.68,1,151,0,0,1,151,0.616692000,0.0000
92.27.219.145,<->,48.106.204.86,1,50,0,0,1,50,0.616661000,0.0000
139.252.1.230,<->,136.25.189.5,0,0,1,150,1,150,0.616481000,0.0000
159.255.21.75,<->,8.220.178.73,0,0,1,50,1,50,0.616456000,0.0000
143.43.193.150,<->,20.55.81.183,0,0,1,80,1,80,0.616242000,0.0000
215.158.239.95,<->,196.132.136.40,1,50,0,0,1,50,0.615943000,0.0000
149.115.136.246,<->,20.192.127.193,0,0,1,56,1,56,0.615740000,0.0000
204.0.239.137,<->,136.25.188.209,0,0,1,64,1,64,0.615366000,0.0000
221.102.143.189,<->,220.80.8.7,0,0,1,141,1,141,0.615337000,0.0000
120.62.177.108,<->,20.201.144.231,0,0,1,64,1,64,0.615048000,0.0000
38.110.248.147,<->,20.197.150.140,0,0,1,52,1,52,0.614898000,0.0000
80.40.47.46,<->,38.176.33.155,1,130,0,0,1,130,0.614898000,0.0000
144.75.218.246,<->,61.72.2.11,1,184,0,0,1,184,0.614861000,0.0000
100.234.24.233,<->,100.92.42.233,0,0,1,50,1,50,0.614831000,0.0000
75.189.136.225,<->,39.131.50.38,0,0,1,73,1,73,0.614510000,0.0000
124.82.215.221,<->,8.43.212.15,0,0,1,50,1,50,0.614073000,0.0000
89.183.104.137,<->,29.90.24.187,1,52,0,0,1,52,0.613996000,0.0000
118.154.53.19,<->,39.249.166.7,0,0,1,64,1,64,0.613341000,0.0000
143.79.16.140,<->,8.220.190.86,0,0,1,50,1,50,0.613274000,0.0000
192.67.149.36,<->,27.41.97.78,1,135,0,0,1,135,0.613037000,0.0000
102.44.113.82,<->,53.167.242.221,1,64,0,0,1,64,0.613029000,0.0000
206.16.142.172,<->,109.222.192.55,0,0,1,98,1,98,0.612728000,0.0000
204.184.229.228,<->,136.25.188.253,0,0,1,76,1,76,0.612271000,0.0000
210.209.251.211,<->,97.126.119.28,0,0,1,1404,1,1404,0.611879000,0.0000
92.27.27.175,<->,69.175.125.228,1,55,0,0,1,55,0.611814000,0.0000
193.88.67.36,<->,92.27.219.203,0,0,1,133,1,133,0.611762000,0.0000
243.123.125.57,<->,92.162.253.231,0,0,1,1039,1,1039,0.611052000,0.0000
130.39.210.240,<->,39.25.122.136,0,0,1,52,1,52,0.610642000,0.0000
106.226.1.149,<->,20.195.217.227,0,0,1,52,1,52,0.610406000,0.0000
104.232.115.160,<->,20.171.10.79,0,0,1,64,1,64,0.610267000,0.0000
115.157.62.146,<->,39.220.7.248,0,0,1,64,1,64,0.610149000,0.0000
196.234.222.249,<->,39.238.234.243,0,0,1,64,1,64,0.610017000,0.0000
101.122.133.46,<->,17.3.209.41,1,1101,0,0,1,1101,0.609912000,0.0000
129.211.8.217,<->,8.220.234.159,0,0,1,56,1,56,0.609624000,0.0000
109.222.215.151,<->,43.40.65.48,1,66,0,0,1,66,0.609418000,0.0000
136.47.51.6,<->,8.176.50.53,0,0,1,50,1,50,0.609418000,0.0000
139.163.7.121,<->,129.123.156.38,1,50,0,0,1,50,0.609341000,0.0000
215.158.103.206,<->,138.127.224.101,1,84,0,0,1,84,0.609213000,0.0000
77.42.253.1,<->,6.75.221.228,0,0,1,56,1,56,0.609203000,0.0000
127.50.84.214,<->,39.56.173.52,0,0,1,52,1,52,0.609018000,0.0000
145.116.223.24,<->,136.25.189.5,0,0,1,105,1,105,0.608965000,0.0000
159.69.187.23,<->,144.108.80.174,1,63,0,0,1,63,0.608917000,0.0000
247.136.199.176,<->,206.193.40.158,1,133,0,0,1,133,0.608412000,0.0000
247.136.231.91,<->,126.254.93.101,1,151,0,0,1,151,0.608399000,0.0000
142.240.213.181,<->,136.25.188.220,0,0,1,56,1,56,0.608284000,0.0000
215.158.239.68,<->,199.20.31.21,1,64,0,0,1,64,0.607826000,0.0000
141.57.70.80,<->,92.27.219.175,0,0,1,50,1,50,0.607677000,0.0000
221.102.143.189,<->,80.41.54.222,0,0,1,141,1,141,0.607111000,0.0000
33.223.177.186,<->,20.221.206.126,0,0,1,52,1,52,0.606325000,0.0000
215.158.239.56,<->,207.63.72.141,1,50,0,0,1,50,0.605935000,0.0000
241.193.172.231,<->,20.226.168.47,0,0,1,50,1,50,0.605918000,0.0000
241.193.172.231,<->,20.186.187.17,0,0,1,50,1,50,0.605759000,0.0000
97.151.151.182,<->,8.52.222.150,0,0,1,50,1,50,0.605745000,0.0000
139.163.26.146,<->,122.223.21.151,1,111,0,0,1,111,0.605134000,0.0000
136.129.66.2,<->,4.129.155.120,1,98,0,0,1,98,0.604921000,0.0000
215.158.239.84,<->,207.63.80.243,1,50,0,0,1,50,0.604747000,0.0000
215.158.239.182,<->,57.210.104.39,1,56,0,0,1,56,0.604707000,0.0000
206.141.76.213,<->,22.59.8.212,0,0,1,57,1,57,0.604539000,0.0000
115.119.48.250,<->,20.148.70.180,0,0,1,52,1,52,0.604532000,0.0000
148.129.33.51,<->,80.42.150.137,0,0,1,319,1,319,0.604525000,0.0000
192.67.160.166,<->,112.179.117.29,1,309,0,0,1,309,0.604461000,0.0000
105.234.171.79,<->,8.52.132.118,0,0,1,50,1,50,0.604048000,0.0000
192.64.217.166,<->,119.74.223.209,1,52,0,0,1,52,0.603793000,0.0000
241.193.172.231,<->,20.202.136.214,0,0,1,50,1,50,0.603494000,0.0000
109.1.17.59,<->,27.188.163.162,1,445,0,0,1,445,0.603255000,0.0000
121.167.63.19,<->,20.71.28.76,0,0,1,103,1,103,0.603137000,0.0000
136.25.188.220,<->,29.214.71.87,1,1005,0,0,1,1005,0.602986000,0.0000
215.158.239.120,<->,158.85.35.245,1,111,0,0,1,111,0.602742000,0.0000
136.25.188.74,<->,111.150.207.167,1,56,0,0,1,56,0.602443000,0.0000
127.154.219.203,<->,92.27.219.202,0,0,1,56,1,56,0.602086000,0.0000
149.40.27.174,<->,50.224.76.235,0,0,1,56,1,56,0.601799000,0.0000
192.66.130.20,<->,8.45.175.127,1,56,0,0,1,56,0.601794000,0.0000
129.224.112.252,<->,97.203.79.109,1,85,0,0,1,85,0.601739000,0.0000
207.191.58.217,<->,136.25.188.224,0,0,1,56,1,56,0.601239000,0.0000
100.26.93.178,<->,8.220.176.253,0,0,1,50,1,50,0.601186000,0.0000
215.158.238.161,<->,38.30.142.248,1,84,0,0,1,84,0.601153000,0.0000
215.158.239.95,<->,195.80.130.58,1,827,0,0,1,827,0.601010000,0.0000
17.28.87.58,<->,8.220.200.124,0,0,1,50,1,50,0.600897000,0.0000
111.71.7.41,<->,92.27.27.167,0,0,1,80,1,80,0.600881000,0.0000
207.79.213.186,<->,50.224.76.230,0,0,1,50,1,50,0.600759000,0.0000
246.253.253.171,<->,53.213.238.198,1,619,0,0,1,619,0.600707000,0.0000
35.55.193.238,<->,8.182.233.85,0,0,1,56,1,56,0.600356000,0.0000
120.224.252.5,<->,20.214.6.246,0,0,1,64,1,64,0.600329000,0.0000
146.200.130.17,<->,20.10.108.125,0,0,1,128,1,128,0.600272000,0.0000
78.129.196.251,<->,39.15.169.14,0,0,1,87,1,87,0.600239000,0.0000
220.77.8.58,<->,20.177.253.251,0,0,1,64,1,64,0.599895000,0.0000
197.19.51.22,<->,39.29.190.79,0,0,1,136,1,136,0.599836000,0.0000
104.133.149.237,<->,92.27.219.184,0,0,1,52,1,52,0.599831000,0.0000
102.224.161.182,<->,13.13.239.177,1,66,0,0,1,66,0.599660000,0.0000
8.176.8.215,<->,8.33.227.3,1,112,0,0,1,112,0.599028000,0.0000
193.24.112.103,<->,111.181.122.223,0,0,1,56,1,56,0.598937000,0.0000
249.101.85.6,<->,54.38.7.135,1,64,0,0,1,64,0.598583000,0.0000
96.228.67.219,<->,8.176.8.211,0,0,1,175,1,175,0.598349000,0.0000
102.224.161.182,<->,33.43.48.64,1,66,0,0,1,66,0.597942000,0.0000
129.225.200.194,<->,89.43.143.193,1,50,0,0,1,50,0.597940000,0.0000
97.126.4.233,<->,53.201.139.67,1,87,0,0,1,87,0.597854000,0.0000
100.95.37.92,<->,53.195.188.145,1,64,0,0,1,64,0.597526000,0.0000
142.223.110.181,<->,136.25.188.177,0,0,1,56,1,56,0.597348000,0.0000
144.75.218.242,<->,138.127.231.255,1,268,0,0,1,268,0.596870000,0.0000
89.155.62.95,<->,8.182.226.78,0,0,1,50,1,50,0.596665000,0.0000
130.101.149.241,<->,8.52.187.0,0,0,1,50,1,50,0.596486000,0.0000
208.238.232.243,<->,39.237.178.112,0,0,1,64,1,64,0.596423000,0.0000
159.57.86.226,<->,144.75.218.241,0,0,1,200,1,200,0.596291000,0.0000
145.172.91.126,<->,92.27.219.61,0,0,1,197,1,197,0.596181000,0.0000
89.220.115.77,<->,8.220.176.253,0,0,1,50,1,50,0.596134000,0.0000
144.85.170.254,<->,98.87.147.67,1,56,0,0,1,56,0.596087000,0.0000
126.234.198.25,<->,20.1.177.18,0,0,1,64,1,64,0.596036000,0.0000
109.113.92.170,<->,8.182.226.122,0,0,1,50,1,50,0.595981000,0.0000
29.90.217.22,<->,8.31.37.160,0,0,1,50,1,50,0.595719000,0.0000
204.95.210.109,<->,20.132.143.148,0,0,1,64,1,64,0.595712000,0.0000
129.224.112.252,<->,129.209.91.81,1,67,0,0,1,67,0.595654000,0.0000
195.55.225.175,<->,136.25.188.220,0,0,1,56,1,56,0.595540000,0.0000
54.39.227.121,<->,48.55.119.121,0,0,1,50,1,50,0.595184000,0.0000
144.122.240.242,<->,144.69.101.193,1,87,0,0,1,87,0.595096000,0.0000
215.158.140.10,<->,111.150.207.129,1,64,0,0,1,64,0.595032000,0.0000
158.163.154.138,<->,80.41.53.34,0,0,1,323,1,323,0.594950000,0.0000
196.25.219.50,<->,99.72.161.96,0,0,1,321,1,321,0.594881000,0.0000
198.126.17.101,<->,8.228.214.155,0,0,1,135,1,135,0.594515000,0.0000
21.15.226.126,<->,20.193.62.245,0,0,1,82,1,82,0.594490000,0.0000
241.193.172.231,<->,20.63.82.168,0,0,1,50,1,50,0.594415000,0.0000
250.50.70.45,<->,39.166.167.61,0,0,1,56,1,56,0.594395000,0.0000
204.184.91.6,<->,136.25.188.222,0,0,1,272,1,272,0.594236000,0.0000
80.40.37.166,<->,42.90.92.230,1,88,0,0,1,88,0.594189000,0.0000
205.91.134.38,<->,39.232.98.3,0,0,1,64,1,64,0.593704000,0.0000
139.205.45.247,<->,80.27.156.123,0,0,1,50,1,50,0.593209000,0.0000
119.94.79.144,<->,89.183.104.137,0,0,1,52,1,52,0.592848000,0.0000
159.112.9.198,<->,99.72.174.134,0,0,1,50,1,50,0.592510000,0.0000
127.67.30.87,<->,39.24.93.193,0,0,1,64,1,64,0.592492000,0.0000
132.60.192.138,<->,8.43.183.8,0,0,1,52,1,52,0.592279000,0.0000
21.15.226.126,<->,20.193.62.246,0,0,1,82,1,82,0.592215000,0.0000
97.53.94.59,<->,8.182.224.248,0,0,1,50,1,50,0.592022000,0.0000
92.27.219.38,<->,73.71.104.177,1,52,0,0,1,52,0.591707000,0.0000
247.136.240.215,<->,134.168.4.250,1,52,0,0,1,52,0.591679000,0.0000
136.25.188.105,<->,99.115.245.101,1,338,0,0,1,338,0.591379000,0.0000
111.150.207.201,<->,99.74.27.153,0,0,1,56,1,56,0.591272000,0.0000
195.5.27.37,<->,136.25.188.160,0,0,1,50,1,50,0.591255000,0.0000
98.190.121.53,<->,18.184.84.42,1,50,0,0,1,50,0.591040000,0.0000
255.133.229.164,<->,98.129.104.84,0,0,1,100,1,100,0.590730000,0.0000
215.158.239.96,<->,199.20.30.28,1,56,0,0,1,56,0.590698000,0.0000
215.158.239.92,<->,196.91.245.45,1,541,0,0,1,541,0.590220000,0.0000
121.204.192.178,<->,92.27.219.187,0,0,1,77,1,77,0.590165000,0.0000
159.137.210.232,<->,142.236.225.85,1,52,0,0,1,52,0.590162000,0.0000
55.53.96.252,<->,8.228.209.63,0,0,1,77,1,77,0.589657000,0.0000
252.98.141.99,<->,210.209.251.223,1,481,0,0,1,481,0.589625000,0.0000
137.68.217.95,<->,20.209.165.87,0,0,1,64,1,64,0.589306000,0.0000
220.20.200.10,<->,123.153.231.62,1,50,0,0,1,50,0.588985000,0.0000
111.147.148.245,<->,53.244.246.126,1,109,0,0,1,109,0.588698000,0.0000
248.239.143.11,<->,159.140.232.210,1,50,0,0,1,50,0.588562000,0.0000
113.149.207.43,<->,50.224.76.234,0,0,1,50,1,50,0.588558000,0.0000
148.249.205.202,<->,39.196.108.21,0,0,1,75,1,75,0.588521000,0.0000
210.157.133.68,<->,89.183.104.178,0,0,1,52,1,52,0.588500000,0.0000
136.18.230.137,<->,8.183.25.25,0,0,1,56,1,56,0.588377000,0.0000
109.222.250.168,<->,107.255.237.151,1,69,0,0,1,69,0.587519000,0.0000
246.254.97.229,<->,206.243.231.162,1,50,0,0,1,50,0.587493000,0.0000
92.27.219.150,<->,37.180.17.62,1,60,0,0,1,60,0.587283000,0.0000
215.158.238.126,<->,100.224.166.158,1,506,0,0,1,506,0.587271000,0.0000
149.76.140.130,<->,92.27.219.210,0,0,1,120,1,120,0.586843000,0.0000
127.255.93.100,<->,80.42.151.225,0,0,1,50,1,50,0.586648000,0.0000
142.227.31.224,<->,136.25.188.241,0,0,1,50,1,50,0.586452000,0.0000
207.63.13.146,<->,136.25.188.177,0,0,1,56,1,56,0.586392000,0.0000
254.75.90.114,<->,92.27.219.224,0,0,1,106,1,106,0.586381000,0.0000
137.68.217.95,<->,20.209.165.82,0,0,1,64,1,64,0.585829000,0.0000
42.61.190.235,<->,39.143.27.158,0,0,1,64,1,64,0.585737000,0.0000
200.174.207.109,<->,53.213.6.51,1,56,0,0,1,56,0.585354000,0.0000
21.15.226.126,<->,20.193.55.141,0,0,1,82,1,82,0.585226000,0.0000
240.208.191.109,<->,0.195.210.46,0,0,1,50,1,50,0.584941000,0.0000
122.216.135.178,<->,89.183.104.234,0,0,1,64,1,64,0.584936000,0.0000
117.228.237.160,<->,92.27.209.236,0,0,1,57,1,57,0.584698000,0.0000
119.48.29.96,<->,8.43.205.53,0,0,1,50,1,50,0.584516000,0.0000
137.186.16.216,<->,8.52.168.247,0,0,1,50,1,50,0.584514000,0.0000
144.75.218.235,<->,138.127.230.228,1,366,0,0,1,366,0.584238000,0.0000
221.102.143.189,<->,220.81.19.4,0,0,1,141,1,141,0.584223000,0.0000
197.145.200.52,<->,39.63.202.77,0,0,1,64,1,64,0.584146000,0.0000
98.129.68.142,<->,8.45.168.98,1,87,0,0,1,87,0.584046000,0.0000
247.136.133.19,<->,127.210.82.224,1,135,0,0,1,135,0.583859000,0.0000
117.38.153.125,<->,50.224.76.230,0,0,1,50,1,50,0.583483000,0.0000
215.158.140.74,<->,97.182.7.27,1,50,0,0,1,50,0.583349000,0.0000
133.178.226.28,<->,128.194.247.236,1,56,0,0,1,56,0.582868000,0.0000
127.112.186.151,<->,92.27.219.43,0,0,1,52,1,52,0.582717000,0.0000
220.83.18.46,<->,156.142.17.231,1,133,0,0,1,133,0.582700000,0.0000
142.209.157.97,<->,136.25.188.252,0,0,1,95,1,95,0.582403000,0.0000
144.75.218.246,<->,138.127.224.10,1,241,0,0,1,241,0.581486000,0.0000
142.175.13.70,<->,99.75.234.175,0,0,1,133,1,133,0.581051000,0.0000
246.253.134.201,<->,112.92.130.75,1,50,0,0,1,50,0.580971000,0.0000
244.50.135.57,<->,39.151.213.63,0,0,1,50,1,50,0.580922000,0.0000
221.102.143.189,<->,102.83.236.228,0,0,1,141,1,141,0.580885000,0.0000
241.193.172.231,<->,20.93.4.148,0,0,1,50,1,50,0.580848000,0.0000
92.27.219.158,<->,29.118.43.49,1,64,0,0,1,64,0.580634000,0.0000
199.21.3.31,<->,39.2.86.249,0,0,1,64,1,64,0.580458000,0.0000
241.193.172.231,<->,20.110.175.228,0,0,1,50,1,50,0.580086000,0.0000
105.75.78.27,<->,20.74.62.167,0,0,1,64,1,64,0.579684000,0.0000
207.173.36.174,<->,136.25.188.255,0,0,1,64,1,64,0.579336000,0.0000
112.6.187.180,<->,39.62.136.53,0,0,1,68,1,68,0.579279000,0.0000
145.118.217.235,<->,8.220.179.3,0,0,1,704,1,704,0.579211000,0.0000
6.145.150.192,<->,0.195.210.43,0,0,1,1244,1,1244,0.579030000,0.0000
223.141.199.22,<->,89.183.104.244,0,0,1,50,1,50,0.578970000,0.0000
207.173.72.238,<->,136.25.188.199,0,0,1,50,1,50,0.578337000,0.0000
196.213.224.133,<->,39.206.112.126,0,0,1,60,1,60,0.578305000,0.0000
246.253.252.62,<->,144.38.108.129,1,132,0,0,1,132,0.578251000,0.0000
92.27.219.191,<->,50.163.36.233,1,52,0,0,1,52,0.578191000,0.0000
80.41.40.188,<->,42.239.97.78,1,298,0,0,1,298,0.577804000,0.0000
244.50.136.175,<->,39.168.237.18,0,0,1,50,1,50,0.577749000,0.0000
207.122.191.170,<->,8.20.87.206,0,0,1,50,1,50,0.577594000,0.0000
120.83.21.29,<->,92.27.219.197,0,0,1,309,1,309,0.577324000,0.0000
197.68.57.83,<->,39.167.39.238,0,0,1,64,1,64,0.577180000,0.0000
199.122.245.72,<->,136.25.188.199,0,0,1,50,1,50,0.577159000,0.0000
144.75.218.235,<->,89.154.144.66,1,80,0,0,1,80,0.577014000,0.0000
57.100.247.124,<->,56.121.37.92,0,0,1,69,1,69,0.576255000,0.0000
235.254.160.52,<->,92.27.219.219,0,0,1,153,1,153,0.576194000,0.0000
215.158.239.78,<->,199.20.30.91,1,50,0,0,1,50,0.575657000,0.0000
204.185.167.224,<->,136.25.188.163,0,0,1,351,1,351,0.575593000,0.0000
215.158.140.13,<->,138.127.230.203,1,290,0,0,1,290,0.575571000,0.0000
21.15.226.126,<->,20.193.55.123,0,0,1,82,1,82,0.575498000,0.0000
102.45.225.190,<->,97.126.26.39,0,0,1,62,1,62,0.575271000,0.0000
139.112.136.254,<->,8.220.176.253,0,0,1,50,1,50,0.574662000,0.0000
215.158.239.237,<->,112.103.134.95,1,89,0,0,1,89,0.573774000,0.0000
89.183.104.246,<->,64.214.61.236,1,52,0,0,1,52,0.573635000,0.0000
246.253.198.139,<->,124.132.255.166,1,50,0,0,1,50,0.573625000,0.0000
139.47.239.142,<->,129.187.19.186,1,74,0,0,1,74,0.573550000,0.0000
192.67.184.7,<->,115.175.178.144,1,52,0,0,1,52,0.573284000,0.0000
215.158.239.76,<->,196.94.140.15,1,56,0,0,1,56,0.573169000,0.0000
192.242.189.168,<->,20.224.202.109,0,0,1,97,1,97,0.572915000,0.0000
249.115.172.218,<->,8.220.176.253,0,0,1,50,1,50,0.572748000,0.0000
99.73.150.125,<->,89.204.4.147,1,50,0,0,1,50,0.572746000,0.0000
207.22.228.196,<->,0.195.210.46,0,0,1,68,1,68,0.572683000,0.0000
192.64.204.246,<->,38.182.15.42,1,56,0,0,1,56,0.572585000,0.0000
215.158.239.96,<->,207.190.47.35,1,50,0,0,1,50,0.572541000,0.0000
135.81.125.246,<->,20.123.59.135,0,0,1,64,1,64,0.572472000,0.0000
215.158.239.49,<->,199.20.4.59,1,849,0,0,1,849,0.572294000,0.0000
118.141.40.138,<->,80.42.175.248,0,0,1,52,1,52,0.572103000,0.0000
110.155.32.46,<->,109.1.59.159,0,0,1,77,1,77,0.572062000,0.0000
195.68.97.165,<->,136.25.188.178,0,0,1,76,1,76,0.571489000,0.0000
199.20.74.163,<->,109.222.241.65,0,0,1,149,1,149,0.571283000,0.0000
144.75.218.246,<->,128.203.247.101,1,89,0,0,1,89,0.571116000,0.0000
195.55.67.217,<->,136.25.188.253,0,0,1,56,1,56,0.571079000,0.0000
142.227.174.189,<->,92.27.219.54,0,0,1,52,1,52,0.571041000,0.0000
101.126.189.91,<->,8.55.209.213,1,56,0,0,1,56,0.570910000,0.0000
140.17.122.242,<->,108.38.94.131,0,0,1,50,1,50,0.570586000,0.0000
42.61.190.235,<->,39.143.27.170,0,0,1,64,1,64,0.570474000,0.0000
127.126.250.100,<->,20.201.165.115,0,0,1,52,1,52,0.570360000,0.0000
215.158.23.53,<->,145.116.206.214,1,68,0,0,1,68,0.569920000,0.0000
149.147.3.128,<->,132.249.70.233,0,0,1,150,1,150,0.569840000,0.0000
145.221.103.17,<->,8.182.226.78,0,0,1,50,1,50,0.569773000,0.0000
237.56.14.109,<->,20.117.249.185,0,0,1,104,1,104,0.569632000,0.0000
246.253.253.215,<->,199.36.180.76,1,50,0,0,1,50,0.568981000,0.0000
221.102.143.189,<->,213.38.156.109,0,0,1,141,1,141,0.568469000,0.0000
56.121.39.173,<->,17.61.177.225,1,50,0,0,1,50,0.568142000,0.0000
69.196.64.236,<->,39.147.215.48,0,0,1,64,1,64,0.568095000,0.0000
126.215.125.89,<->,92.27.219.193,0,0,1,373,1,373,0.567677000,0.0000
42.61.190.235,<->,39.143.27.197,0,0,1,64,1,64,0.567662000,0.0000
199.39.15.249,<->,136.25.188.255,0,0,1,68,1,68,0.567358000,0.0000
17.245.146.125,<->,8.220.190.86,0,0,1,50,1,50,0.567137000,0.0000
53.221.209.144,<->,48.55.98.37,0,0,1,56,1,56,0.567052000,0.0000
247.136.217.186,<->,38.70.99.6,1,64,0,0,1,64,0.566993000,0.0000
152.130.101.225,<->,98.217.116.59,0,0,1,135,1,135,0.566819000,0.0000
138.127.225.205,<->,97.126.26.70,0,0,1,277,1,277,0.566599000,0.0000
195.68.142.187,<->,136.25.188.241,0,0,1,64,1,64,0.566328000,0.0000
107.68.172.182,<->,8.182.226.78,0,0,1,50,1,50,0.565450000,0.0000
199.50.85.252,<->,136.25.188.197,0,0,1,64,1,64,0.565294000,0.0000
207.239.202.90,<->,136.25.188.198,0,0,1,50,1,50,0.565012000,0.0000
193.28.156.197,<->,136.25.189.86,0,0,1,84,1,84,0.564669000,0.0000
118.149.114.113,<->,80.41.16.104,0,0,1,133,1,133,0.564292000,0.0000
93.88.139.46,<->,20.215.197.88,0,0,1,64,1,64,0.564288000,0.0000
119.124.169.175,<->,20.194.218.220,0,0,1,64,1,64,0.564223000,0.0000
215.158.103.219,<->,128.176.179.33,1,260,0,0,1,260,0.564167000,0.0000
210.221.107.50,<->,139.33.174.178,1,50,0,0,1,50,0.563986000,0.0000
111.151.106.232,<->,8.252.223.139,0,0,1,56,1,56,0.563817000,0.0000
241.193.172.231,<->,20.159.241.54,0,0,1,50,1,50,0.563786000,0.0000
218.4.187.87,<->,134.185.116.206,1,99,0,0,1,99,0.563663000,0.0000
199.120.91.244,<->,136.25.188.54,0,0,1,56,1,56,0.563651000,0.0000
8.222.48.144,<->,8.52.132.199,0,0,1,1002,1,1002,0.563327000,0.0000
194.207.113.238,<->,139.207.222.11,0,0,1,91,1,91,0.563313000,0.0000
144.122.240.234,<->,144.108.64.185,1,74,0,0,1,74,0.563259000,0.0000
244.50.242.201,<->,20.70.228.206,0,0,1,50,1,50,0.562945000,0.0000
193.21.29.246,<->,102.51.209.140,0,0,1,56,1,56,0.562357000,0.0000
105.120.253.39,<->,101.224.204.193,0,0,1,350,1,350,0.562187000,0.0000
215.158.239.56,<->,199.51.230.198,1,50,0,0,1,50,0.561804000,0.0000
158.85.50.75,<->,8.220.180.244,0,0,1,704,1,704,0.561660000,0.0000
204.60.6.129,<->,136.25.188.53,0,0,1,84,1,84,0.561643000,0.0000
195.45.113.57,<->,20.193.226.135,0,0,1,52,1,52,0.561549000,0.0000
132.168.198.94,<->,99.30.53.247,1,77,0,0,1,77,0.561452000,0.0000
196.233.158.73,<->,8.182.227.180,0,0,1,50,1,50,0.561297000,0.0000
196.18.201.9,<->,100.92.117.152,0,0,1,56,1,56,0.560992000,0.0000
215.158.239.76,<->,207.115.39.79,1,68,0,0,1,68,0.560969000,0.0000
199.15.114.33,<->,56.121.49.77,0,0,1,52,1,52,0.560719000,0.0000
66.90.102.244,<->,34.100.96.54,0,0,1,408,1,408,0.560695000,0.0000
126.224.22.23,<->,20.235.221.15,0,0,1,64,1,64,0.560577000,0.0000
144.75.218.242,<->,100.117.27.56,1,288,0,0,1,288,0.560328000,0.0000
241.193.172.231,<->,20.163.254.247,0,0,1,50,1,50,0.560153000,0.0000
220.55.113.56,<->,98.219.125.164,1,50,0,0,1,50,0.559972000,0.0000
141.92.219.216,<->,129.224.112.252,0,0,1,79,1,79,0.559918000,0.0000
239.66.108.231,<->,196.148.120.168,0,0,1,50,1,50,0.559253000,0.0000
89.183.104.191,<->,65.60.169.114,1,52,0,0,1,52,0.559022000,0.0000
132.107.75.195,<->,111.147.206.130,0,0,1,764,1,764,0.558798000,0.0000
200.174.213.196,<->,139.79.72.238,1,52,0,0,1,52,0.557875000,0.0000
195.12.2.213,<->,136.25.188.198,0,0,1,89,1,89,0.557598000,0.0000
215.158.239.58,<->,196.92.54.210,1,56,0,0,1,56,0.557499000,0.0000
42.61.190.235,<->,39.143.27.239,0,0,1,64,1,64,0.557373000,0.0000
77.23.78.17,<->,34.209.109.232,0,0,1,52,1,52,0.557367000,0.0000
159.23.227.147,<->,94.196.172.177,1,76,0,0,1,76,0.557363000,0.0000
97.94.1.70,<->,92.27.219.208,0,0,1,90,1,90,0.557071000,0.0000
138.98.246.1,<->,136.117.93.137,1,120,0,0,1,120,0.556715000,0.0000
205.236.10.86,<->,97.168.124.101,0,0,1,135,1,135,0.556625000,0.0000
91.250.143.162,<->,39.159.1.1,0,0,1,50,1,50,0.556516000,0.0000
111.151.107.247,<->,8.176.8.71,0,0,1,119,1,119,0.556393000,0.0000
198.254.35.214,<->,80.40.23.183,0,0,1,130,1,130,0.556389000,0.0000
133.45.77.233,<->,92.27.27.185,0,0,1,80,1,80,0.556265000,0.0000
143.76.151.4,<->,20.62.161.147,0,0,1,103,1,103,0.556033000,0.0000
136.25.188.75,<->,111.150.207.144,1,56,0,0,1,56,0.555975000,0.0000
204.0.251.51,<->,136.25.188.174,0,0,1,602,1,602,0.555807000,0.0000
246.253.248.210,<->,53.150.234.220,1,88,0,0,1,88,0.555461000,0.0000
53.161.254.252,<->,48.54.131.41,0,0,1,93,1,93,0.555424000,0.0000
60.102.23.64,<->,34.186.147.158,0,0,1,52,1,52,0.555391000,0.0000
158.206.162.249,<->,139.163.26.146,0,0,1,99,1,99,0.555194000,0.0000
144.76.46.38,<->,99.73.41.205,0,0,1,158,1,158,0.555165000,0.0000
57.195.38.86,<->,20.128.171.146,0,0,1,140,1,140,0.554719000,0.0000
94.24.2.177,<->,89.183.104.176,0,0,1,52,1,52,0.554639000,0.0000
207.61.250.182,<->,109.222.242.9,0,0,1,133,1,133,0.554549000,0.0000
42.61.190.235,<->,39.143.27.249,0,0,1,64,1,64,0.554536000,0.0000
42.61.190.235,<->,39.143.27.234,0,0,1,64,1,64,0.554185000,0.0000
215.158.239.93,<->,199.20.4.81,1,50,0,0,1,50,0.554129000,0.0000
142.241.9.166,<->,136.25.188.53,0,0,1,56,1,56,0.554008000,0.0000
215.158.49.32,<->,29.211.214.254,0,0,1,93,1,93,0.553171000,0.0000
208.250.159.17,<->,136.25.188.105,0,0,1,247,1,247,0.553152000,0.0000
192.64.225.224,<->,93.93.180.74,1,59,0,0,1,59,0.553034000,0.0000
241.193.172.231,<->,20.107.8.111,0,0,1,50,1,50,0.552854000,0.0000
99.227.122.48,<->,20.203.27.223,0,0,1,64,1,64,0.552652000,0.0000
215.158.239.30,<->,41.161.43.178,1,50,0,0,1,50,0.552518000,0.0000
205.81.94.28,<->,20.117.123.128,0,0,1,531,1,531,0.552449000,0.0000
210.60.115.65,<->,102.51.167.35,0,0,1,136,1,136,0.552149000,0.0000
220.50.242.218,<->,101.70.127.229,0,0,1,256,1,256,0.552116000,0.0000
132.180.214.237,<->,80.56.78.128,0,0,1,90,1,90,0.552007000,0.0000
92.27.219.46,<->,64.214.57.126,1,50,0,0,1,50,0.551989000,0.0000
199.52.95.217,<->,136.25.188.177,0,0,1,56,1,56,0.551828000,0.0000
93.146.42.245,<->,20.108.207.88,0,0,1,64,1,64,0.551686000,0.0000
53.221.209.144,<->,48.52.122.97,0,0,1,306,1,306,0.551684000,0.0000
247.136.145.168,<->,0.201.195.182,1,56,0,0,1,56,0.551595000,0.0000
192.67.161.91,<->,135.72.72.64,1,56,0,0,1,56,0.551516000,0.0000
137.137.103.117,<->,112.55.53.67,1,85,0,0,1,85,0.551112000,0.0000
109.222.21.194,<->,8.182.250.109,0,0,1,50,1,50,0.550977000,0.0000
139.163.161.57,<->,136.25.188.228,0,0,1,106,1,106,0.550880000,0.0000
255.133.229.164,<->,39.175.24.255,0,0,1,100,1,100,0.550337000,0.0000
202.38.137.164,<->,92.27.219.201,0,0,1,52,1,52,0.550172000,0.0000
135.77.53.12,<->,8.43.200.253,0,0,1,704,1,704,0.549873000,0.0000
208.238.232.243,<->,39.237.178.70,0,0,1,64,1,64,0.549855000,0.0000
215.158.239.79,<->,199.20.28.158,1,87,0,0,1,87,0.549624000,0.0000
89.183.104.248,<->,88.1.208.176,1,64,0,0,1,64,0.549579000,0.0000
192.67.136.193,<->,131.187.212.157,1,52,0,0,1,52,0.549552000,0.0000
142.190.148.47,<->,136.25.188.242,0,0,1,56,1,56,0.549459000,0.0000
42.61.190.235,<->,39.143.27.96,0,0,1,64,1,64,0.549448000,0.0000
136.25.188.228,<->,8.220.7.141,1,129,0,0,1,129,0.549312000,0.0000
109.1.51.242,<->,100.230.5.11,1,50,0,0,1,50,0.549166000,0.0000
100.182.99.11,<->,20.179.124.85,0,0,1,52,1,52,0.548867000,0.0000
109.1.18.233,<->,29.217.128.71,1,52,0,0,1,52,0.548408000,0.0000
215.158.239.120,<->,131.49.94.82,1,199,0,0,1,199,0.548264000,0.0000
204.60.124.241,<->,136.25.188.225,0,0,1,56,1,56,0.548038000,0.0000
144.83.60.153,<->,92.162.253.102,0,0,1,50,1,50,0.547139000,0.0000
199.122.60.237,<->,136.25.188.209,0,0,1,56,1,56,0.547093000,0.0000
249.129.136.216,<->,215.158.199.180,1,704,0,0,1,704,0.546740000,0.0000
112.208.20.177,<->,6.73.192.233,0,0,1,163,1,163,0.546579000,0.0000
198.158.197.83,<->,20.212.211.82,0,0,1,50,1,50,0.546552000,0.0000
246.253.252.63,<->,103.47.188.64,1,132,0,0,1,132,0.546415000,0.0000
193.0.126.28,<->,20.193.222.246,0,0,1,76,1,76,0.546339000,0.0000
144.122.240.237,<->,98.119.212.204,1,75,0,0,1,75,0.546291000,0.0000
42.61.190.235,<->,39.143.27.119,0,0,1,64,1,64,0.546250000,0.0000
145.154.11.50,<->,80.56.78.92,0,0,1,94,1,94,0.545970000,0.0000
215.158.239.253,<->,8.240.118.235,1,146,0,0,1,146,0.545730000,0.0000
105.201.221.207,<->,102.50.236.87,0,0,1,342,1,342,0.545683000,0.0000
215.158.239.87,<->,199.69.90.6,1,50,0,0,1,50,0.544831000,0.0000
74.240.111.222,<->,39.247.17.160,0,0,1,52,1,52,0.544404000,0.0000
20.249.126.1,<->,0.83.228.26,1,64,0,0,1,64,0.544179000,0.0000
193.51.144.62,<->,35.56.98.12,0,0,1,50,1,50,0.544128000,0.0000
57.145.62.65,<->,39.39.253.153,0,0,1,52,1,52,0.544084000,0.0000
108.35.33.43,<->,50.224.75.42,0,0,1,64,1,64,0.543847000,0.0000
56.121.60.51,<->,50.29.195.180,1,64,0,0,1,64,0.543652000,0.0000
215.158.239.68,<->,207.56.173.68,1,56,0,0,1,56,0.543281000,0.0000
17.70.190.211,<->,8.220.191.251,0,0,1,50,1,50,0.543243000,0.0000
109.1.17.28,<->,53.149.122.156,1,125,0,0,1,125,0.543102000,0.0000
97.126.113.142,<->,53.180.104.211,1,50,0,0,1,50,0.543017000,0.0000
39.16.162.253,<->,37.48.86.116,1,52,0,0,1,52,0.543001000,0.0000
152.132.171.243,<->,102.81.141.95,0,0,1,135,1,135,0.542558000,0.0000
21.15.226.126,<->,20.193.55.76,0,0,1,82,1,82,0.542463000,0.0000
42.61.190.235,<->,39.143.27.100,0,0,1,64,1,64,0.542374000,0.0000
223.141.220.222,<->,39.162.123.161,0,0,1,64,1,64,0.542269000,0.0000
152.11.32.140,<->,20.98.136.13,0,0,1,64,1,64,0.542257000,0.0000
144.75.218.246,<->,113.180.95.20,1,87,0,0,1,87,0.542024000,0.0000
244.50.129.64,<->,39.45.246.221,0,0,1,50,1,50,0.541985000,0.0000
123.61.21.253,<->,92.27.219.56,0,0,1,52,1,52,0.541852000,0.0000
109.28.15.133,<->,8.220.200.124,0,0,1,50,1,50,0.541656000,0.0000
114.180.190.148,<->,50.224.89.241,0,0,1,56,1,56,0.541504000,0.0000
113.149.166.94,<->,20.205.188.94,0,0,1,82,1,82,0.541100000,0.0000
215.158.239.182,<->,111.151.107.247,1,109,0,0,1,109,0.541086000,0.0000
192.229.216.117,<->,159.40.166.43,1,50,0,0,1,50,0.541056000,0.0000
145.89.194.40,<->,69.155.129.29,1,133,0,0,1,133,0.541006000,0.0000
215.158.238.233,<->,111.150.207.203,1,56,0,0,1,56,0.540887000,0.0000
199.51.190.165,<->,136.25.188.53,0,0,1,50,1,50,0.540429000,0.0000
215.158.103.219,<->,208.186.165.27,1,176,0,0,1,176,0.539689000,0.0000
215.158.239.50,<->,199.72.194.71,1,56,0,0,1,56,0.539668000,0.0000
245.36.48.253,<->,92.27.209.104,0,0,1,57,1,57,0.539400000,0.0000
92.27.219.37,<->,29.221.165.171,1,293,0,0,1,293,0.539312000,0.0000
193.24.150.240,<->,20.65.77.106,0,0,1,74,1,74,0.538980000,0.0000
215.158.239.50,<->,195.83.181.177,1,56,0,0,1,56,0.538823000,0.0000
215.158.103.219,<->,53.74.147.102,1,84,0,0,1,84,0.538682000,0.0000
100.182.99.11,<->,20.179.124.13,0,0,1,52,1,52,0.538344000,0.0000
138.74.30.197,<->,53.195.230.83,1,50,0,0,1,50,0.538087000,0.0000
142.194.232.159,<->,136.25.188.252,0,0,1,56,1,56,0.537679000,0.0000
21.15.226.126,<->,20.193.55.60,0,0,1,82,1,82,0.537666000,0.0000
120.190.159.223,<->,20.229.216.59,0,0,1,52,1,52,0.537599000,0.0000
80.30.28.112,<->,50.224.75.42,0,0,1,64,1,64,0.537564000,0.0000
192.67.154.172,<->,6.16.141.199,1,56,0,0,1,56,0.537388000,0.0000
244.50.249.107,<->,224.148.36.56,0,0,1,50,1,50,0.537385000,0.0000
104.67.149.22,<->,39.9.119.18,0,0,1,205,1,205,0.537330000,0.0000
121.43.237.135,<->,80.42.136.253,0,0,1,52,1,52,0.537267000,0.0000
220.20.200.52,<->,144.83.60.153,1,50,0,0,1,50,0.537122000,0.0000
230.76.194.65,<->,220.81.23.25,0,0,1,334,1,334,0.536942000,0.0000
215.158.239.92,<->,199.20.30.125,1,117,0,0,1,117,0.536709000,0.0000
158.236.199.232,<->,92.27.219.186,0,0,1,119,1,119,0.536641000,0.0000
42.128.41.242,<->,20.110.131.163,0,0,1,64,1,64,0.536170000,0.0000
92.27.219.50,<->,48.104.22.10,1,52,0,0,1,52,0.536030000,0.0000
80.28.127.235,<->,20.215.28.95,0,0,1,130,1,130,0.535957000,0.0000
199.6.230.219,<->,99.73.7.110,0,0,1,100,1,100,0.535825000,0.0000
77.57.4.146,<->,20.162.52.126,0,0,1,52,1,52,0.535605000,0.0000
125.0.210.158,<->,80.42.138.177,0,0,1,102,1,102,0.535392000,0.0000
215.158.239.120,<->,33.209.211.2,1,111,0,0,1,111,0.535353000,0.0000
124.50.117.158,<->,101.70.110.79,0,0,1,64,1,64,0.535172000,0.0000
142.236.213.253,<->,20.149.122.23,0,0,1,68,1,68,0.534815000,0.0000
159.13.155.136,<->,53.245.2.193,1,173,0,0,1,173,0.534752000,0.0000
206.69.124.84,<->,80.41.19.144,0,0,1,52,1,52,0.534604000,0.0000
198.187.30.136,<->,102.51.7.196,0,0,1,50,1,50,0.534279000,0.0000
215.158.239.96,<->,207.191.38.140,1,68,0,0,1,68,0.533612000,0.0000
92.27.219.229,<->,88.0.195.175,1,60,0,0,1,60,0.533206000,0.0000
192.67.160.161,<->,88.152.22.110,1,52,0,0,1,52,0.532815000,0.0000
144.75.218.241,<->,17.136.21.99,1,147,0,0,1,147,0.532613000,0.0000
121.252.146.7,<->,100.92.34.81,0,0,1,325,1,325,0.532469000,0.0000
200.175.45.62,<->,53.245.230.135,1,64,0,0,1,64,0.532213000,0.0000
143.76.158.252,<->,8.182.226.24,0,0,1,50,1,50,0.532178000,0.0000
193.51.220.212,<->,98.236.95.232,0,0,1,50,1,50,0.532011000,0.0000
118.131.209.62,<->,101.70.127.0,0,0,1,74,1,74,0.532008000,0.0000
205.36.103.208,<->,20.164.129.62,0,0,1,135,1,135,0.531956000,0.0000
158.51.95.95,<->,39.172.24.199,0,0,1,95,1,95,0.531843000,0.0000
195.105.83.164,<->,39.11.177.30,0,0,1,52,1,52,0.531602000,0.0000
206.21.254.238,<->,192.64.247.91,0,0,1,68,1,68,0.531507000,0.0000
144.75.218.246,<->,65.95.70.36,1,212,0,0,1,212,0.531350000,0.0000
137.68.217.95,<->,20.209.165.81,0,0,1,64,1,64,0.531191000,0.0000
215.158.239.56,<->,199.39.126.136,1,50,0,0,1,50,0.531152000,0.0000
137.68.217.95,<->,20.209.165.80,0,0,1,64,1,64,0.530921000,0.0000
111.150.207.51,<->,99.74.26.110,0,0,1,100,1,100,0.530757000,0.0000
199.12.125.72,<->,20.11.148.235,0,0,1,64,1,64,0.530165000,0.0000
159.112.9.198,<->,99.72.206.97,0,0,1,81,1,81,0.530103000,0.0000
200.174.194.106,<->,53.213.200.116,1,64,0,0,1,64,0.529726000,0.0000
223.115.155.15,<->,8.252.221.196,0,0,1,50,1,50,0.529419000,0.0000
139.163.26.146,<->,139.7.252.107,1,111,0,0,1,111,0.529240000,0.0000
93.104.212.227,<->,39.246.79.102,0,0,1,64,1,64,0.528761000,0.0000
100.182.99.11,<->,20.179.125.54,0,0,1,52,1,52,0.528101000,0.0000
192.64.198.168,<->,98.18.104.222,1,64,0,0,1,64,0.527673000,0.0000
221.101.9.15,<->,133.184.169.33,1,50,0,0,1,50,0.526904000,0.0000
139.252.0.243,<->,56.121.49.50,0,0,1,154,1,154,0.526674000,0.0000
245.227.5.165,<->,8.20.87.153,0,0,1,50,1,50,0.526649000,0.0000
195.51.192.253,<->,20.201.127.243,0,0,1,52,1,52,0.526223000,0.0000
215.158.239.95,<->,196.109.92.204,1,56,0,0,1,56,0.526127000,0.0000
21.15.226.126,<->,20.193.54.71,0,0,1,82,1,82,0.525810000,0.0000
201.7.56.152,<->,192.64.215.135,0,0,1,321,1,321,0.525556000,0.0000
132.230.26.160,<->,48.53.6.253,0,0,1,97,1,97,0.525445000,0.0000
159.255.250.12,<->,8.220.235.160,0,0,1,50,1,50,0.525269000,0.0000
210.226.164.31,<->,18.80.190.251,1,73,0,0,1,73,0.524867000,0.0000
144.75.218.241,<->,138.127.230.27,1,359,0,0,1,359,0.524845000,0.0000
210.226.164.31,<->,54.42.135.102,1,65,0,0,1,65,0.524678000,0.0000
66.82.254.66,<->,34.198.231.134,0,0,1,129,1,129,0.524382000,0.0000
92.169.146.2,<->,92.26.147.44,1,56,0,0,1,56,0.524352000,0.0000
210.229.230.21,<->,145.44.124.147,1,50,0,0,1,50,0.523922000,0.0000
146.188.233.245,<->,92.27.219.132,0,0,1,213,1,213,0.523799000,0.0000
207.239.155.145,<->,136.25.188.55,0,0,1,56,1,56,0.523773000,0.0000
192.242.185.97,<->,20.134.143.27,0,0,1,80,1,80,0.523576000,0.0000
56.121.60.210,<->,50.29.195.180,1,64,0,0,1,64,0.523564000,0.0000
113.127.211.18,<->,92.27.219.190,0,0,1,52,1,52,0.523155000,0.0000
194.247.68.124,<->,20.23.114.165,0,0,1,78,1,78,0.523003000,0.0000
133.171.115.67,<->,131.133.154.159,1,84,0,0,1,84,0.522687000,0.0000
100.92.54.183,<->,22.5.212.226,1,50,0,0,1,50,0.522622000,0.0000
207.87.124.164,<->,39.13.236.213,0,0,1,52,1,52,0.522395000,0.0000
132.5.71.202,<->,97.126.119.191,0,0,1,435,1,435,0.522118000,0.0000
204.62.113.222,<->,136.25.188.196,0,0,1,68,1,68,0.521815000,0.0000
251.60.180.100,<->,101.73.153.44,0,0,1,50,1,50,0.521743000,0.0000
119.47.178.15,<->,89.183.104.135,0,0,1,52,1,52,0.521198000,0.0000
140.60.185.188,<->,20.181.173.114,0,0,1,52,1,52,0.521127000,0.0000
143.76.150.69,<->,129.78.112.255,0,0,1,50,1,50,0.520632000,0.0000
100.182.99.11,<->,20.179.124.133,0,0,1,52,1,52,0.520185000,0.0000
207.116.181.94,<->,39.210.191.46,0,0,1,103,1,103,0.519868000,0.0000
217.48.90.141,<->,89.183.104.151,0,0,1,64,1,64,0.519587000,0.0000
132.118.97.71,<->,80.41.3.223,0,0,1,50,1,50,0.519461000,0.0000
194.193.103.88,<->,100.92.38.121,0,0,1,66,1,66,0.518863000,0.0000
120.83.11.135,<->,92.27.219.155,0,0,1,64,1,64,0.518661000,0.0000
144.57.226.233,<->,139.248.201.139,0,0,1,80,1,80,0.518311000,0.0000
215.158.239.240,<->,8.181.148.227,1,90,0,0,1,90,0.518158000,0.0000
100.182.99.11,<->,20.179.124.150,0,0,1,52,1,52,0.518139000,0.0000
215.158.140.168,<->,120.155.87.47,1,137,0,0,1,137,0.518062000,0.0000
241.193.172.231,<->,20.33.40.235,0,0,1,50,1,50,0.517838000,0.0000
206.17.164.193,<->,192.64.195.195,0,0,1,52,1,52,0.517763000,0.0000
114.39.133.245,<->,50.224.76.230,0,0,1,56,1,56,0.517669000,0.0000
92.27.219.159,<->,30.192.53.215,1,102,0,0,1,102,0.517649000,0.0000
195.26.48.140,<->,99.73.242.92,0,0,1,133,1,133,0.517573000,0.0000
159.64.148.13,<->,144.122.240.196,0,0,1,88,1,88,0.517567000,0.0000
114.225.110.244,<->,109.222.218.39,0,0,1,112,1,112,0.517059000,0.0000
244.50.129.64,<->,20.61.202.151,0,0,1,50,1,50,0.517047000,0.0000
120.100.37.17,<->,20.135.153.61,0,0,1,52,1,52,0.516690000,0.0000
98.67.158.136,<->,79.58.237.62,1,76,0,0,1,76,0.516615000,0.0000
219.228.243.244,<->,39.9.237.201,0,0,1,64,1,64,0.516398000,0.0000
247.136.223.75,<->,124.243.26.28,1,97,0,0,1,97,0.516391000,0.0000
215.158.140.193,<->,199.38.204.7,1,50,0,0,1,50,0.515916000,0.0000
139.193.141.200,<->,98.220.160.19,1,50,0,0,1,50,0.515906000,0.0000
144.92.163.176,<->,50.145.122.87,1,50,0,0,1,50,0.515850000,0.0000
255.133.223.252,<->,221.95.62.8,0,0,1,80,1,80,0.515072000,0.0000
196.250.234.88,<->,20.140.166.101,0,0,1,64,1,64,0.514991000,0.0000
201.67.129.213,<->,84.4.11.133,1,50,0,0,1,50,0.514809000,0.0000
199.38.74.255,<->,136.25.188.176,0,0,1,56,1,56,0.514395000,0.0000
92.27.27.185,<->,57.59.47.200,1,52,0,0,1,52,0.514377000,0.0000
136.246.92.113,<->,92.27.219.205,0,0,1,52,1,52,0.514283000,0.0000
127.18.252.200,<->,109.222.205.45,0,0,1,76,1,76,0.514283000,0.0000
198.158.197.83,<->,20.94.49.201,0,0,1,50,1,50,0.514281000,0.0000
100.182.99.11,<->,20.179.124.165,0,0,1,52,1,52,0.514208000,0.0000
159.112.24.53,<->,0.195.210.46,0,0,1,56,1,56,0.514031000,0.0000
56.121.60.48,<->,50.29.195.180,1,64,0,0,1,64,0.513826000,0.0000
143.34.37.188,<->,39.44.61.15,0,0,1,80,1,80,0.513561000,0.0000
246.253.148.235,<->,244.50.133.60,1,50,0,0,1,50,0.513469000,0.0000
75.81.51.112,<->,39.251.8.138,0,0,1,56,1,56,0.513430000,0.0000
134.98.5.37,<->,109.222.243.81,0,0,1,147,1,147,0.513412000,0.0000
80.41.25.41,<->,57.156.213.42,1,73,0,0,1,73,0.513351000,0.0000
108.35.43.81,<->,50.224.89.243,0,0,1,50,1,50,0.513069000,0.0000
210.158.44.220,<->,128.156.80.162,1,90,0,0,1,90,0.512850000,0.0000
137.173.24.253,<->,8.52.183.207,0,0,1,50,1,50,0.512751000,0.0000
215.158.239.97,<->,199.20.7.125,1,64,0,0,1,64,0.512648000,0.0000
98.23.96.94,<->,89.183.104.246,0,0,1,56,1,56,0.512126000,0.0000
145.247.113.60,<->,8.52.133.228,0,0,1,50,1,50,0.511971000,0.0000
143.42.218.2,<->,136.25.188.198,0,0,1,52,1,52,0.511907000,0.0000
109.222.231.242,<->,54.48.149.55,1,56,0,0,1,56,0.511751000,0.0000
215.158.239.92,<->,199.20.7.27,1,56,0,0,1,56,0.511379000,0.0000
125.197.11.161,<->,89.183.104.182,0,0,1,166,1,166,0.511335000,0.0000
201.214.103.81,<->,92.27.219.189,0,0,1,52,1,52,0.511049000,0.0000
121.19.179.105,<->,20.220.93.48,0,0,1,64,1,64,0.510988000,0.0000
132.168.197.106,<->,53.80.157.161,1,50,0,0,1,50,0.510422000,0.0000
192.64.213.119,<->,133.183.156.125,1,50,0,0,1,50,0.510098000,0.0000
199.83.47.13,<->,92.27.27.166,0,0,1,135,1,135,0.510013000,0.0000
195.41.228.211,<->,136.25.188.238,0,0,1,50,1,50,0.509828000,0.0000
159.137.138.173,<->,139.7.227.58,1,82,0,0,1,82,0.509736000,0.0000
109.93.202.217,<->,8.220.176.253,0,0,1,50,1,50,0.509588000,0.0000
204.188.254.233,<->,136.25.188.177,0,0,1,50,1,50,0.509578000,0.0000
197.235.145.178,<->,50.224.80.64,0,0,1,50,1,50,0.509301000,0.0000
199.105.28.169,<->,20.3.247.58,0,0,1,108,1,108,0.509274000,0.0000
195.124.217.206,<->,136.25.188.176,0,0,1,64,1,64,0.509233000,0.0000
91.250.143.162,<->,39.149.209.110,0,0,1,50,1,50,0.509080000,0.0000
201.211.227.212,<->,89.183.104.166,0,0,1,61,1,61,0.509071000,0.0000
217.11.189.9,<->,20.192.130.71,0,0,1,443,1,443,0.509004000,0.0000
192.229.212.192,<->,136.250.252.100,1,107,0,0,1,107,0.508727000,0.0000
215.158.239.87,<->,195.80.215.36,1,408,0,0,1,408,0.508716000,0.0000
92.27.219.208,<->,66.1.74.3,1,52,0,0,1,52,0.507808000,0.0000
138.98.214.132,<->,0.47.133.227,1,56,0,0,1,56,0.507731000,0.0000
241.193.172.231,<->,20.252.240.111,0,0,1,50,1,50,0.507684000,0.0000
215.158.239.57,<->,204.3.69.99,1,56,0,0,1,56,0.507634000,0.0000
109.49.93.23,<->,8.183.25.124,0,0,1,50,1,50,0.507482000,0.0000
99.92.252.77,<->,8.52.187.235,0,0,1,50,1,50,0.507391000,0.0000
204.184.227.223,<->,136.25.188.209,0,0,1,68,1,68,0.507215000,0.0000
215.158.239.57,<->,195.126.40.68,1,56,0,0,1,56,0.506991000,0.0000
116.145.98.56,<->,80.42.204.150,0,0,1,138,1,138,0.506939000,0.0000
139.1.128.199,<->,8.220.235.241,0,0,1,50,1,50,0.506595000,0.0000
93.101.192.84,<->,92.27.219.145,0,0,1,52,1,52,0.506533000,0.0000
42.61.190.235,<->,39.143.27.50,0,0,1,64,1,64,0.505741000,0.0000
252.98.138.147,<->,97.94.123.83,1,50,0,0,1,50,0.505683000,0.0000
227.29.170.188,<->,89.183.104.231,0,0,1,50,1,50,0.505666000,0.0000
109.222.221.234,<->,83.95.154.244,1,76,0,0,1,76,0.505442000,0.0000
215.158.239.69,<->,196.93.107.74,1,68,0,0,1,68,0.505428000,0.0000
220.80.133.58,<->,8.55.224.156,1,141,0,0,1,141,0.504952000,0.0000
194.232.176.181,<->,136.25.188.177,0,0,1,56,1,56,0.504917000,0.0000
42.61.190.235,<->,39.143.27.36,0,0,1,64,1,64,0.504402000,0.0000
213.38.238.227,<->,8.49.69.216,1,56,0,0,1,56,0.503932000,0.0000
120.119.180.74,<->,89.183.104.144,0,0,1,177,1,177,0.503896000,0.0000
145.252.116.252,<->,98.219.126.40,1,78,0,0,1,78,0.503876000,0.0000
38.91.97.206,<->,20.167.129.45,0,0,1,64,1,64,0.503564000,0.0000
98.23.96.82,<->,92.27.27.165,0,0,1,56,1,56,0.503523000,0.0000
103.237.231.47,<->,8.52.189.207,0,0,1,50,1,50,0.503314000,0.0000
121.209.3.168,<->,20.97.57.132,0,0,1,64,1,64,0.503027000,0.0000
201.211.202.7,<->,39.196.49.239,0,0,1,56,1,56,0.502964000,0.0000
129.224.112.252,<->,92.162.219.79,1,104,0,0,1,104,0.502902000,0.0000
192.171.13.189,<->,136.25.188.28,0,0,1,157,1,157,0.502639000,0.0000
39.189.158.204,<->,8.176.37.95,0,0,1,50,1,50,0.502321000,0.0000
149.99.39.90,<->,8.176.38.226,0,0,1,84,1,84,0.502297000,0.0000
195.6.111.192,<->,136.25.188.197,0,0,1,50,1,50,0.502210000,0.0000
220.20.200.155,<->,144.83.60.153,1,50,0,0,1,50,0.502153000,0.0000
140.17.122.242,<->,98.217.56.124,0,0,1,50,1,50,0.501916000,0.0000
255.133.229.164,<->,39.39.162.79,0,0,1,100,1,100,0.501554000,0.0000
38.21.156.204,<->,20.232.228.202,0,0,1,82,1,82,0.501551000,0.0000
118.134.127.116,<->,109.222.229.119,0,0,1,76,1,76,0.501466000,0.0000
50.224.76.235,<->,38.0.14.50,1,50,0,0,1,50,0.501376000,0.0000
109.222.255.55,<->,27.139.49.9,1,79,0,0,1,79,0.501281000,0.0000
192.67.175.129,<->,125.25.133.190,1,52,0,0,1,52,0.501244000,0.0000
215.158.239.113,<->,215.158.61.189,1,658,0,0,1,658,0.500899000,0.0000
123.162.85.98,<->,100.93.126.227,0,0,1,50,1,50,0.500749000,0.0000
126.224.70.25,<->,20.10.65.194,0,0,1,64,1,64,0.500734000,0.0000
197.107.46.147,<->,136.25.188.252,0,0,1,50,1,50,0.500705000,0.0000
204.147.48.36,<->,39.247.151.203,0,0,1,98,1,98,0.500476000,0.0000
241.193.172.231,<->,133.54.24.214,0,0,1,50,1,50,0.500408000,0.0000
133.178.227.97,<->,111.151.142.181,1,56,0,0,1,56,0.500343000,0.0000
129.16.253.244,<->,98.129.59.32,0,0,1,56,1,56,0.500176000,0.0000
111.147.119.137,<->,99.187.125.174,1,56,0,0,1,56,0.499989000,0.0000
199.111.93.250,<->,8.182.228.158,0,0,1,50,1,50,0.499867000,0.0000
122.173.165.4,<->,102.51.89.173,0,0,1,130,1,130,0.499634000,0.0000
159.69.187.2,<->,144.108.64.185,1,75,0,0,1,75,0.499466000,0.0000
207.206.173.251,<->,102.50.164.175,0,0,1,52,1,52,0.499259000,0.0000
66.82.117.130,<->,34.130.34.18,0,0,1,80,1,80,0.499135000,0.0000
218.4.180.210,<->,116.47.123.91,1,52,0,0,1,52,0.499088000,0.0000
69.128.118.18,<->,50.145.88.240,1,64,0,0,1,64,0.499068000,0.0000
215.158.61.191,<->,8.176.8.210,0,0,1,1229,1,1229,0.498947000,0.0000
98.232.172.60,<->,57.211.62.10,1,81,0,0,1,81,0.498777000,0.0000
199.89.59.174,<->,20.193.94.114,0,0,1,94,1,94,0.498562000,0.0000
120.4.216.186,<->,20.173.157.243,0,0,1,52,1,52,0.498561000,0.0000
195.6.123.30,<->,136.25.188.162,0,0,1,50,1,50,0.498453000,0.0000
21.15.226.126,<->,20.193.54.41,0,0,1,82,1,82,0.498400000,0.0000
97.126.31.90,<->,80.56.83.69,1,64,0,0,1,64,0.498277000,0.0000
100.182.99.11,<->,20.179.124.200,0,0,1,52,1,52,0.498234000,0.0000
192.67.161.91,<->,120.51.234.57,1,80,0,0,1,80,0.498232000,0.0000
100.182.99.11,<->,20.179.124.218,0,0,1,52,1,52,0.498211000,0.0000
241.193.172.231,<->,20.186.81.114,0,0,1,50,1,50,0.498118000,0.0000
199.121.174.186,<->,136.25.188.46,0,0,1,50,1,50,0.498008000,0.0000
215.158.239.36,<->,111.151.109.41,1,100,0,0,1,100,0.497197000,0.0000
89.183.104.166,<->,29.251.39.222,1,52,0,0,1,52,0.497053000,0.0000
144.75.218.235,<->,100.185.121.91,1,128,0,0,1,128,0.496829000,0.0000
215.158.239.79,<->,199.15.252.152,1,56,0,0,1,56,0.496253000,0.0000
142.236.8.239,<->,136.25.188.176,0,0,1,56,1,56,0.496252000,0.0000
139.163.26.146,<->,122.209.190.26,1,113,0,0,1,113,0.496132000,0.0000
109.1.51.11,<->,48.110.135.132,1,93,0,0,1,93,0.496095000,0.0000
138.98.155.28,<->,42.68.246.99,1,50,0,0,1,50,0.495811000,0.0000
199.71.158.41,<->,136.25.188.198,0,0,1,50,1,50,0.495791000,0.0000
136.25.189.92,<->,60.99.169.229,1,84,0,0,1,84,0.495762000,0.0000
220.20.200.118,<->,116.124.227.184,1,50,0,0,1,50,0.495595000,0.0000
109.222.201.157,<->,53.200.94.254,1,50,0,0,1,50,0.495077000,0.0000
124.232.32.37,<->,39.48.158.206,0,0,1,64,1,64,0.494804000,0.0000
208.238.232.243,<->,39.237.178.135,0,0,1,64,1,64,0.494771000,0.0000
159.23.224.110,<->,130.242.204.14,1,50,0,0,1,50,0.494715000,0.0000
143.44.155.136,<->,136.25.188.160,0,0,1,50,1,50,0.494637000,0.0000
21.15.226.126,<->,20.193.54.200,0,0,1,82,1,82,0.494163000,0.0000
194.209.186.154,<->,20.10.111.145,0,0,1,76,1,76,0.494031000,0.0000
192.67.149.88,<->,38.180.36.123,1,69,0,0,1,69,0.493900000,0.0000
215.158.239.96,<->,199.20.30.248,1,68,0,0,1,68,0.493665000,0.0000
97.126.114.69,<->,17.188.67.212,1,69,0,0,1,69,0.493592000,0.0000
192.64.248.243,<->,119.76.30.93,1,52,0,0,1,52,0.493338000,0.0000
142.164.244.12,<->,39.150.16.215,0,0,1,68,1,68,0.493031000,0.0000
204.124.37.148,<->,109.222.250.107,0,0,1,52,1,52,0.493007000,0.0000
199.80.150.135,<->,136.25.188.196,0,0,1,50,1,50,0.492611000,0.0000
215.158.239.76,<->,196.109.26.182,1,56,0,0,1,56,0.492511000,0.0000
215.158.239.84,<->,199.20.28.239,1,602,0,0,1,602,0.492281000,0.0000
197.107.46.147,<->,136.25.188.162,0,0,1,50,1,50,0.491953000,0.0000
127.179.27.118,<->,39.193.119.105,0,0,1,64,1,64,0.491271000,0.0000
195.39.113.211,<->,20.54.175.5,0,0,1,93,1,93,0.491189000,0.0000
130.226.129.60,<->,39.202.190.137,0,0,1,74,1,74,0.490801000,0.0000
121.209.70.144,<->,20.77.192.214,0,0,1,72,1,72,0.490629000,0.0000
215.158.239.43,<->,41.137.243.243,1,50,0,0,1,50,0.490532000,0.0000
156.136.120.152,<->,20.61.206.202,0,0,1,74,1,74,0.490466000,0.0000
192.170.241.194,<->,8.252.222.249,0,0,1,56,1,56,0.490231000,0.0000
89.183.104.154,<->,64.214.57.3,1,50,0,0,1,50,0.490022000,0.0000
122.129.100.246,<->,89.183.104.137,0,0,1,52,1,52,0.490001000,0.0000
159.13.225.44,<->,153.97.33.165,1,50,0,0,1,50,0.489937000,0.0000
221.102.143.189,<->,192.67.134.50,0,0,1,92,1,92,0.489796000,0.0000
6.145.172.2,<->,0.195.210.44,0,0,1,50,1,50,0.489742000,0.0000
114.31.119.171,<->,80.40.36.227,0,0,1,132,1,132,0.489555000,0.0000
215.158.2.61,<->,29.211.214.254,0,0,1,90,1,90,0.489522000,0.0000
194.245.40.17,<->,50.224.76.235,0,0,1,50,1,50,0.489477000,0.0000
121.20.156.83,<->,20.213.246.209,0,0,1,52,1,52,0.489425000,0.0000
198.65.255.220,<->,80.40.29.135,0,0,1,50,1,50,0.488809000,0.0000
139.163.5.144,<->,119.6.123.164,1,74,0,0,1,74,0.488393000,0.0000
144.75.218.235,<->,138.127.231.3,1,194,0,0,1,194,0.488301000,0.0000
121.19.179.105,<->,20.220.93.124,0,0,1,64,1,64,0.487890000,0.0000
133.178.227.63,<->,133.56.180.8,1,541,0,0,1,541,0.487499000,0.0000
144.122.240.224,<->,144.108.64.185,1,76,0,0,1,76,0.487378000,0.0000
144.75.218.235,<->,143.204.138.237,1,153,0,0,1,153,0.487286000,0.0000
92.27.27.177,<->,48.108.82.241,1,52,0,0,1,52,0.486838000,0.0000
223.140.130.253,<->,39.18.139.86,0,0,1,62,1,62,0.486836000,0.0000
215.158.140.148,<->,80.56.83.69,1,64,0,0,1,64,0.486640000,0.0000
126.224.150.56,<->,20.253.65.221,0,0,1,72,1,72,0.486619000,0.0000
215.158.239.56,<->,195.80.115.27,1,68,0,0,1,68,0.486393000,0.0000
144.71.44.39,<->,42.68.246.99,1,50,0,0,1,50,0.486244000,0.0000
82.237.232.145,<->,74.51.75.47,1,78,0,0,1,78,0.486206000,0.0000
116.126.69.169,<->,92.27.219.173,0,0,1,80,1,80,0.486120000,0.0000
97.199.185.128,<->,54.38.56.26,1,876,0,0,1,876,0.486055000,0.0000
80.15.251.30,<->,48.53.137.25,0,0,1,156,1,156,0.485947000,0.0000
107.10.175.116,<->,8.52.189.207,0,0,1,50,1,50,0.485727000,0.0000
204.45.238.246,<->,192.67.136.165,0,0,1,135,1,135,0.485557000,0.0000
199.21.226.193,<->,8.183.25.124,0,0,1,50,1,50,0.485508000,0.0000
158.164.134.203,<->,39.32.36.252,0,0,1,72,1,72,0.485504000,0.0000
113.115.31.85,<->,20.231.10.188,0,0,1,64,1,64,0.485464000,0.0000
204.184.19.178,<->,136.25.188.220,0,0,1,64,1,64,0.485418000,0.0000
100.122.42.37,<->,8.182.237.144,0,0,1,50,1,50,0.485013000,0.0000
111.151.107.247,<->,8.176.8.215,0,0,1,163,1,163,0.484810000,0.0000
194.233.47.63,<->,136.25.188.175,0,0,1,56,1,56,0.484724000,0.0000
112.87.29.241,<->,20.173.234.145,0,0,1,64,1,64,0.484612000,0.0000
215.158.239.78,<->,207.16.17.95,1,132,0,0,1,132,0.484509000,0.0000
136.99.57.75,<->,20.249.228.251,0,0,1,70,1,70,0.484119000,0.0000
38.21.156.204,<->,20.232.229.121,0,0,1,82,1,82,0.483333000,0.0000
132.51.6.188,<->,106.188.198.187,1,71,0,0,1,71,0.482731000,0.0000
92.27.219.23,<->,33.57.77.138,1,64,0,0,1,64,0.482407000,0.0000
204.131.118.196,<->,20.145.76.21,0,0,1,64,1,64,0.481299000,0.0000
116.106.38.41,<->,8.252.221.166,0,0,1,85,1,85,0.481076000,0.0000
121.19.179.105,<->,20.220.93.126,0,0,1,64,1,64,0.481058000,0.0000
100.52.156.101,<->,92.27.27.160,0,0,1,117,1,117,0.481054000,0.0000
119.126.189.126,<->,22.59.5.126,0,0,1,64,1,64,0.480580000,0.0000
204.184.90.9,<->,136.25.188.175,0,0,1,50,1,50,0.480363000,0.0000
204.250.58.20,<->,8.181.37.222,1,64,0,0,1,64,0.480276000,0.0000
159.23.226.247,<->,158.67.237.217,1,50,0,0,1,50,0.480242000,0.0000
79.52.255.177,<->,34.209.48.228,0,0,1,52,1,52,0.480060000,0.0000
251.24.252.115,<->,39.169.213.12,0,0,1,64,1,64,0.479722000,0.0000
241.193.172.231,<->,20.88.30.210,0,0,1,50,1,50,0.479383000,0.0000
239.227.103.52,<->,140.17.122.242,1,50,0,0,1,50,0.479271000,0.0000
215.158.2.47,<->,145.108.46.93,0,0,1,89,1,89,0.479206000,0.0000
192.229.208.216,<->,68.231.18.69,1,704,0,0,1,704,0.478876000,0.0000
247.157.36.145,<->,230.72.210.85,1,109,0,0,1,109,0.478532000,0.0000
138.39.159.34,<->,8.220.205.146,0,0,1,50,1,50,0.478520000,0.0000
207.92.55.92,<->,8.182.250.109,0,0,1,50,1,50,0.478402000,0.0000
194.237.93.152,<->,136.25.188.239,0,0,1,50,1,50,0.478285000,0.0000
120.190.159.223,<->,20.229.216.60,0,0,1,52,1,52,0.478230000,0.0000
100.83.51.52,<->,97.126.0.2,0,0,1,50,1,50,0.477529000,0.0000
109.1.17.114,<->,27.188.163.162,1,443,0,0,1,443,0.477424000,0.0000
108.46.86.66,<->,8.220.176.253,0,0,1,50,1,50,0.477413000,0.0000
142.222.33.198,<->,39.201.102.236,0,0,1,107,1,107,0.477027000,0.0000
122.117.43.241,<->,80.40.11.228,0,0,1,52,1,52,0.476942000,0.0000
120.20.125.189,<->,39.53.21.166,0,0,1,52,1,52,0.476486000,0.0000
89.183.104.141,<->,29.237.212.30,1,56,0,0,1,56,0.476466000,0.0000
215.158.239.97,<->,142.166.122.161,1,689,0,0,1,689,0.476025000,0.0000
148.242.193.1,<->,109.222.250.46,0,0,1,50,1,50,0.475939000,0.0000
129.92.114.124,<->,33.0.223.69,1,138,0,0,1,138,0.475816000,0.0000
145.116.223.66,<->,133.178.226.245,0,0,1,573,1,573,0.475520000,0.0000
207.77.30.118,<->,20.182.107.103,0,0,1,75,1,75,0.475266000,0.0000
215.158.239.79,<->,196.1.215.95,1,50,0,0,1,50,0.475197000,0.0000
123.48.57.181,<->,92.27.219.17,0,0,1,52,1,52,0.475087000,0.0000
111.151.109.33,<->,8.252.221.110,0,0,1,56,1,56,0.475048000,0.0000
149.163.240.29,<->,39.44.250.229,0,0,1,104,1,104,0.474854000,0.0000
21.15.226.126,<->,20.193.54.241,0,0,1,82,1,82,0.474849000,0.0000
109.0.253.66,<->,61.91.181.221,1,130,0,0,1,130,0.474450000,0.0000
159.112.9.198,<->,101.70.96.205,0,0,1,50,1,50,0.474090000,0.0000
196.113.186.195,<->,20.122.167.96,0,0,1,64,1,64,0.473763000,0.0000
112.107.203.81,<->,89.183.104.175,0,0,1,52,1,52,0.473542000,0.0000
111.151.107.210,<->,8.252.222.107,0,0,1,56,1,56,0.473487000,0.0000
247.136.143.107,<->,221.102.143.189,1,92,0,0,1,92,0.473481000,0.0000
231.143.44.103,<->,136.25.188.222,0,0,1,382,1,382,0.472608000,0.0000
215.158.238.244,<->,215.158.34.76,1,56,0,0,1,56,0.472582000,0.0000
196.113.186.195,<->,20.122.167.103,0,0,1,64,1,64,0.472533000,0.0000
111.151.239.94,<->,97.126.19.174,0,0,1,56,1,56,0.471720000,0.0000
194.204.184.221,<->,92.27.194.147,0,0,1,64,1,64,0.471669000,0.0000
102.179.210.213,<->,8.52.178.59,0,0,1,50,1,50,0.471559000,0.0000
197.155.50.86,<->,20.251.207.105,0,0,1,52,1,52,0.471465000,0.0000
114.232.65.138,<->,109.222.251.212,0,0,1,70,1,70,0.471433000,0.0000
122.196.70.119,<->,92.27.27.177,0,0,1,135,1,135,0.471401000,0.0000
111.151.109.20,<->,8.252.221.118,0,0,1,100,1,100,0.471309000,0.0000
197.113.99.74,<->,136.25.188.177,0,0,1,56,1,56,0.471291000,0.0000
215.158.239.77,<->,196.90.193.245,1,797,0,0,1,797,0.471119000,0.0000
241.193.172.231,<->,20.6.127.151,0,0,1,50,1,50,0.470638000,0.0000
159.133.57.200,<->,129.47.117.231,1,56,0,0,1,56,0.470582000,0.0000
132.222.168.185,<->,59.53.181.235,1,112,0,0,1,112,0.470523000,0.0000
8.182.224.87,<->,6.21.243.237,1,50,0,0,1,50,0.470141000,0.0000
194.233.249.250,<->,136.25.188.175,0,0,1,50,1,50,0.469981000,0.0000
103.237.45.95,<->,92.27.209.121,0,0,1,80,1,80,0.469961000,0.0000
192.64.246.137,<->,88.11.132.176,1,50,0,0,1,50,0.469763000,0.0000
142.239.121.248,<->,20.192.127.4,0,0,1,50,1,50,0.469609000,0.0000
92.180.4.195,<->,50.224.76.234,0,0,1,50,1,50,0.469536000,0.0000
111.151.109.27,<->,8.252.222.35,0,0,1,100,1,100,0.469504000,0.0000
132.249.137.140,<->,8.52.169.61,0,0,1,50,1,50,0.468914000,0.0000
117.4.114.166,<->,50.224.76.235,0,0,1,50,1,50,0.468797000,0.0000
119.127.4.87,<->,111.147.111.98,0,0,1,135,1,135,0.468756000,0.0000
199.7.53.154,<->,92.27.219.214,0,0,1,50,1,50,0.468614000,0.0000
199.82.144.104,<->,136.25.188.198,0,0,1,56,1,56,0.468481000,0.0000
241.193.172.231,<->,203.215.179.148,0,0,1,50,1,50,0.468193000,0.0000
125.22.35.22,<->,80.41.44.203,0,0,1,133,1,133,0.467508000,0.0000
22.34.207.34,<->,8.220.188.50,0,0,1,50,1,50,0.467355000,0.0000
111.25.52.96,<->,109.222.255.199,0,0,1,56,1,56,0.467270000,0.0000
134.36.81.173,<->,92.27.219.141,0,0,1,52,1,52,0.467239000,0.0000
194.107.4.209,<->,20.179.253.112,0,0,1,64,1,64,0.467096000,0.0000
111.147.253.179,<->,53.245.123.102,1,93,0,0,1,93,0.466522000,0.0000
139.163.13.6,<->,105.168.127.133,1,76,0,0,1,76,0.466305000,0.0000
247.136.157.67,<->,48.110.191.157,1,56,0,0,1,56,0.466011000,0.0000
215.158.239.120,<->,80.57.208.241,1,111,0,0,1,111,0.465903000,0.0000
196.87.94.176,<->,136.25.188.239,0,0,1,50,1,50,0.465724000,0.0000
199.71.219.169,<->,136.25.188.55,0,0,1,50,1,50,0.465331000,0.0000
159.176.32.29,<->,144.75.218.237,0,0,1,76,1,76,0.465053000,0.0000
215.158.239.120,<->,159.137.139.217,1,110,0,0,1,110,0.465004000,0.0000
195.87.206.134,<->,39.152.165.33,0,0,1,93,1,93,0.465004000,0.0000
159.140.232.210,<->,98.128.239.149,0,0,1,50,1,50,0.464736000,0.0000
102.50.242.234,<->,27.14.169.221,1,261,0,0,1,261,0.464563000,0.0000
142.227.168.94,<->,136.25.188.242,0,0,1,50,1,50,0.464394000,0.0000
79.253.14.215,<->,34.83.130.169,0,0,1,52,1,52,0.464206000,0.0000
117.192.134.132,<->,8.220.206.141,0,0,1,50,1,50,0.464193000,0.0000
207.162.155.76,<->,8.182.227.206,0,0,1,50,1,50,0.464125000,0.0000
159.147.28.223,<->,20.213.165.182,0,0,1,64,1,64,0.464114000,0.0000
120.155.84.163,<->,97.126.26.71,0,0,1,138,1,138,0.463952000,0.0000
106.224.70.18,<->,20.57.168.35,0,0,1,64,1,64,0.463936000,0.0000
80.41.255.115,<->,35.55.171.12,1,56,0,0,1,56,0.463662000,0.0000
89.183.111.197,<->,53.195.188.191,1,52,0,0,1,52,0.463535000,0.0000
20.13.112.44,<->,0.200.50.50,1,60,0,0,1,60,0.463475000,0.0000
215.158.140.115,<->,111.150.207.98,1,56,0,0,1,56,0.463249000,0.0000
21.15.226.126,<->,20.193.53.248,0,0,1,82,1,82,0.463194000,0.0000
215.158.239.99,<->,207.63.223.238,1,64,0,0,1,64,0.462907000,0.0000
198.151.28.229,<->,20.144.24.155,0,0,1,64,1,64,0.462753000,0.0000
116.107.67.119,<->,20.119.101.62,0,0,1,72,1,72,0.462745000,0.0000
144.75.221.206,<->,138.98.246.1,0,0,1,122,1,122,0.462673000,0.0000
84.198.246.225,<->,8.252.221.222,0,0,1,50,1,50,0.462130000,0.0000
136.25.189.47,<->,100.117.164.198,1,1002,0,0,1,1002,0.462075000,0.0000
200.174.222.245,<->,54.37.31.141,1,56,0,0,1,56,0.461831000,0.0000
104.131.160.56,<->,39.204.49.4,0,0,1,50,1,50,0.461768000,0.0000
212.241.174.245,<->,80.27.157.22,0,0,1,50,1,50,0.461488000,0.0000
144.76.46.36,<->,99.75.63.38,0,0,1,126,1,126,0.461134000,0.0000
142.255.39.190,<->,136.25.188.224,0,0,1,56,1,56,0.461067000,0.0000
134.3.122.239,<->,39.5.68.240,0,0,1,52,1,52,0.461030000,0.0000
121.19.179.105,<->,20.220.93.112,0,0,1,64,1,64,0.460967000,0.0000
220.81.47.225,<->,129.158.112.159,1,56,0,0,1,56,0.460862000,0.0000
98.246.18.142,<->,20.231.239.155,0,0,1,50,1,50,0.460779000,0.0000
75.62.16.8,<->,20.8.97.119,0,0,1,50,1,50,0.460565000,0.0000
100.182.99.11,<->,20.179.125.231,0,0,1,52,1,52,0.460088000,0.0000
195.7.213.170,<->,136.25.188.179,0,0,1,56,1,56,0.459735000,0.0000
144.75.218.235,<->,132.208.122.193,1,141,0,0,1,141,0.459453000,0.0000
222.65.22.201,<->,192.173.212.240,1,64,0,0,1,64,0.459004000,0.0000
215.158.239.49,<->,199.20.28.43,1,602,0,0,1,602,0.458596000,0.0000
126.9.199.3,<->,39.232.168.43,0,0,1,96,1,96,0.458348000,0.0000
97.168.80.204,<->,56.24.164.8,1,65,0,0,1,65,0.458204000,0.0000
215.158.239.84,<->,196.94.202.48,1,56,0,0,1,56,0.458129000,0.0000
218.233.211.196,<->,8.220.190.86,0,0,1,50,1,50,0.457932000,0.0000
218.4.190.253,<->,116.244.100.27,1,404,0,0,1,404,0.457870000,0.0000
221.102.56.69,<->,98.128.197.11,0,0,1,64,1,64,0.457819000,0.0000
129.224.112.252,<->,98.166.239.25,1,75,0,0,1,75,0.457579000,0.0000
89.183.104.189,<->,88.152.120.203,1,52,0,0,1,52,0.457247000,0.0000
133.178.226.247,<->,111.150.207.148,1,100,0,0,1,100,0.457246000,0.0000
88.2.122.252,<->,35.56.101.131,0,0,1,50,1,50,0.457031000,0.0000
92.27.247.197,<->,39.14.182.193,0,0,1,52,1,52,0.456899000,0.0000
247.136.223.219,<->,38.53.173.20,1,129,0,0,1,129,0.456428000,0.0000
205.121.93.107,<->,20.6.228.54,0,0,1,78,1,78,0.456062000,0.0000
113.163.15.15,<->,8.220.192.194,0,0,1,704,1,704,0.455990000,0.0000
142.43.184.230,<->,39.166.182.100,0,0,1,64,1,64,0.455898000,0.0000
196.114.224.239,<->,20.2.189.189,0,0,1,56,1,56,0.455764000,0.0000
245.244.32.96,<->,8.182.241.177,0,0,1,50,1,50,0.455542000,0.0000
215.158.239.50,<->,142.254.245.204,1,620,0,0,1,620,0.455323000,0.0000
139.163.26.146,<->,0.141.40.222,1,111,0,0,1,111,0.455064000,0.0000
246.254.182.132,<->,119.118.135.107,1,64,0,0,1,64,0.454999000,0.0000
159.57.90.68,<->,139.254.211.64,0,0,1,56,1,56,0.454792000,0.0000
114.208.34.76,<->,89.183.104.178,0,0,1,321,1,321,0.454527000,0.0000
120.62.177.108,<->,20.201.144.225,0,0,1,64,1,64,0.453975000,0.0000
210.209.251.211,<->,80.41.120.112,0,0,1,50,1,50,0.453717000,0.0000
204.190.7.75,<->,136.25.188.45,0,0,1,50,1,50,0.453060000,0.0000
249.62.21.108,<->,215.158.103.206,0,0,1,103,1,103,0.452935000,0.0000
196.148.130.233,<->,59.168.201.49,1,65,0,0,1,65,0.452879000,0.0000
207.172.227.16,<->,136.25.188.196,0,0,1,68,1,68,0.452878000,0.0000
152.133.60.221,<->,138.73.60.223,0,0,1,130,1,130,0.452876000,0.0000
194.245.242.177,<->,39.151.75.114,0,0,1,64,1,64,0.452779000,0.0000
29.211.214.32,<->,8.240.117.44,1,115,0,0,1,115,0.452728000,0.0000
116.153.202.111,<->,8.220.187.40,0,0,1,704,1,704,0.452693000,0.0000
112.12.164.127,<->,50.224.103.30,0,0,1,50,1,50,0.452411000,0.0000
215.158.239.76,<->,199.20.28.172,1,64,0,0,1,64,0.452359000,0.0000
97.126.19.126,<->,27.51.239.160,1,56,0,0,1,56,0.452213000,0.0000
218.38.100.178,<->,8.182.253.40,0,0,1,50,1,50,0.451520000,0.0000
195.4.148.171,<->,136.25.188.44,0,0,1,68,1,68,0.451510000,0.0000
50.224.89.239,<->,27.253.253.217,1,79,0,0,1,79,0.451238000,0.0000
196.236.94.136,<->,39.204.251.84,0,0,1,94,1,94,0.451151000,0.0000
199.44.120.51,<->,8.20.87.153,0,0,1,135,1,135,0.450764000,0.0000
100.182.99.11,<->,20.179.126.42,0,0,1,52,1,52,0.450454000,0.0000
133.178.227.204,<->,111.150.207.92,1,100,0,0,1,100,0.450428000,0.0000
100.182.99.11,<->,20.179.126.33,0,0,1,52,1,52,0.450324000,0.0000
215.158.239.56,<->,199.82.159.149,1,50,0,0,1,50,0.450011000,0.0000
215.158.239.105,<->,149.201.135.194,1,141,0,0,1,141,0.449947000,0.0000
92.27.131.123,<->,92.27.27.172,0,0,1,56,1,56,0.449916000,0.0000
109.222.251.106,<->,33.57.74.147,1,125,0,0,1,125,0.449893000,0.0000
215.158.239.105,<->,120.154.177.88,1,111,0,0,1,111,0.449751000,0.0000
215.158.239.49,<->,207.191.55.121,1,56,0,0,1,56,0.449278000,0.0000
39.36.96.222,<->,38.183.156.183,1,93,0,0,1,93,0.449140000,0.0000
119.131.98.208,<->,20.155.139.107,0,0,1,56,1,56,0.448566000,0.0000
252.98.139.157,<->,97.94.123.83,1,50,0,0,1,50,0.448480000,0.0000
199.21.52.17,<->,8.182.141.189,0,0,1,56,1,56,0.448346000,0.0000
114.188.244.66,<->,50.224.75.42,0,0,1,52,1,52,0.448134000,0.0000
115.62.40.21,<->,97.126.115.22,0,0,1,75,1,75,0.448098000,0.0000
103.127.138.3,<->,101.70.126.246,0,0,1,70,1,70,0.447885000,0.0000
247.136.138.125,<->,121.227.151.207,1,56,0,0,1,56,0.447387000,0.0000
224.240.218.11,<->,92.27.27.177,0,0,1,56,1,56,0.447378000,0.0000
204.184.227.223,<->,136.25.188.176,0,0,1,68,1,68,0.447337000,0.0000
235.225.213.208,<->,89.183.104.231,0,0,1,52,1,52,0.447184000,0.0000
204.250.33.215,<->,33.107.83.207,1,50,0,0,1,50,0.447060000,0.0000
132.66.49.212,<->,97.126.26.70,0,0,1,574,1,574,0.447056000,0.0000
78.129.196.247,<->,39.15.169.14,0,0,1,87,1,87,0.446978000,0.0000
21.15.226.126,<->,20.193.53.218,0,0,1,82,1,82,0.446907000,0.0000
109.222.227.131,<->,109.122.129.71,1,56,0,0,1,56,0.446802000,0.0000
109.222.244.46,<->,19.215.46.158,1,68,0,0,1,68,0.446799000,0.0000
137.21.23.50,<->,111.151.106.218,1,100,0,0,1,100,0.446621000,0.0000
120.158.207.179,<->,20.170.191.9,0,0,1,72,1,72,0.446372000,0.0000
101.224.186.192,<->,18.200.87.230,1,57,0,0,1,57,0.446237000,0.0000
136.25.189.5,<->,27.178.41.11,1,83,0,0,1,83,0.446213000,0.0000
231.142.181.214,<->,215.158.239.97,0,0,1,109,1,109,0.446064000,0.0000
119.131.98.208,<->,20.155.139.71,0,0,1,56,1,56,0.446012000,0.0000
144.75.218.233,<->,138.127.225.217,1,366,0,0,1,366,0.445011000,0.0000
137.68.217.95,<->,20.209.165.69,0,0,1,64,1,64,0.444795000,0.0000
98.86.101.56,<->,80.41.32.151,0,0,1,69,1,69,0.444607000,0.0000
199.115.143.194,<->,39.128.123.154,0,0,1,103,1,103,0.444361000,0.0000
196.63.216.97,<->,39.41.176.229,0,0,1,60,1,60,0.444359000,0.0000
143.95.254.8,<->,136.25.188.241,0,0,1,56,1,56,0.444287000,0.0000
193.41.49.218,<->,20.150.176.74,0,0,1,64,1,64,0.443994000,0.0000
109.1.9.205,<->,98.231.239.31,1,52,0,0,1,52,0.443784000,0.0000
142.240.142.165,<->,136.25.188.198,0,0,1,56,1,56,0.443410000,0.0000
142.220.26.221,<->,136.25.188.53,0,0,1,56,1,56,0.443388000,0.0000
215.158.239.97,<->,195.49.148.192,1,50,0,0,1,50,0.443199000,0.0000
215.158.239.49,<->,195.49.148.192,1,50,0,0,1,50,0.443198000,0.0000
247.136.184.192,<->,137.225.173.74,1,61,0,0,1,61,0.442896000,0.0000
194.254.157.54,<->,39.14.127.159,0,0,1,144,1,144,0.442893000,0.0000
247.136.181.26,<->,118.191.203.243,1,97,0,0,1,97,0.442744000,0.0000
92.27.117.27,<->,89.153.95.12,0,0,1,109,1,109,0.442716000,0.0000
146.249.227.164,<->,8.252.222.141,0,0,1,56,1,56,0.442626000,0.0000
197.113.84.184,<->,136.25.188.255,0,0,1,157,1,157,0.442334000,0.0000
118.102.82.70,<->,80.41.14.234,0,0,1,321,1,321,0.442180000,0.0000
220.209.92.96,<->,215.158.140.87,0,0,1,50,1,50,0.442164000,0.0000
210.220.219.153,<->,53.161.58.194,1,50,0,0,1,50,0.442077000,0.0000
110.86.133.46,<->,109.1.51.11,0,0,1,325,1,325,0.441993000,0.0000
130.207.46.10,<->,92.27.219.240,0,0,1,88,1,88,0.441785000,0.0000
123.125.227.160,<->,80.42.175.248,0,0,1,61,1,61,0.441580000,0.0000
215.158.239.69,<->,196.105.20.240,1,56,0,0,1,56,0.441423000,0.0000
109.222.205.186,<->,75.95.84.115,1,97,0,0,1,97,0.440973000,0.0000
200.174.126.191,<->,102.73.129.90,1,56,0,0,1,56,0.440949000,0.0000
138.98.246.1,<->,56.17.255.70,1,120,0,0,1,120,0.440544000,0.0000
215.158.239.51,<->,143.134.175.56,1,50,0,0,1,50,0.440077000,0.0000
193.41.49.218,<->,20.149.242.110,0,0,1,64,1,64,0.440017000,0.0000
215.158.239.50,<->,196.92.132.96,1,76,0,0,1,76,0.439919000,0.0000
215.158.239.95,<->,199.20.30.129,1,56,0,0,1,56,0.439656000,0.0000
144.98.6.41,<->,139.241.119.19,0,0,1,76,1,76,0.439573000,0.0000
255.133.229.164,<->,39.167.65.47,0,0,1,100,1,100,0.439417000,0.0000
117.5.66.97,<->,111.146.219.79,0,0,1,158,1,158,0.439278000,0.0000
133.32.1.105,<->,29.99.92.24,1,69,0,0,1,69,0.439069000,0.0000
105.200.28.92,<->,20.207.140.172,0,0,1,74,1,74,0.439059000,0.0000
139.254.213.35,<->,129.224.112.252,0,0,1,76,1,76,0.439024000,0.0000
133.178.226.162,<->,128.23.167.222,1,90,0,0,1,90,0.439010000,0.0000
126.242.231.201,<->,20.204.244.244,0,0,1,64,1,64,0.438870000,0.0000
145.213.37.26,<->,136.129.94.109,0,0,1,84,1,84,0.438824000,0.0000
215.158.239.72,<->,111.151.109.34,1,56,0,0,1,56,0.438514000,0.0000
204.185.235.144,<->,136.25.188.241,0,0,1,56,1,56,0.438207000,0.0000
144.75.218.241,<->,138.127.225.156,1,298,0,0,1,298,0.438082000,0.0000
92.27.219.38,<->,57.151.234.220,1,97,0,0,1,97,0.438067000,0.0000
111.147.204.204,<->,54.92.218.196,1,118,0,0,1,118,0.438051000,0.0000
144.85.170.246,<->,91.69.181.15,1,68,0,0,1,68,0.437834000,0.0000
144.75.218.237,<->,141.15.18.59,1,229,0,0,1,229,0.437534000,0.0000
145.252.119.79,<->,132.43.156.56,1,752,0,0,1,752,0.437312000,0.0000
249.101.201.37,<->,54.41.253.68,1,50,0,0,1,50,0.437304000,0.0000
120.119.65.203,<->,89.183.104.171,0,0,1,52,1,52,0.437207000,0.0000
144.122.240.199,<->,144.108.64.185,1,63,0,0,1,63,0.437198000,0.0000
197.196.96.98,<->,139.193.141.200,0,0,1,50,1,50,0.437097000,0.0000
116.141.230.22,<->,92.27.219.23,0,0,1,229,1,229,0.437027000,0.0000
80.40.108.201,<->,8.45.162.111,1,56,0,0,1,56,0.436912000,0.0000
144.85.170.208,<->,98.87.146.169,1,56,0,0,1,56,0.436687000,0.0000
21.15.226.126,<->,20.193.53.101,0,0,1,82,1,82,0.436253000,0.0000
53.69.143.15,<->,48.55.109.114,0,0,1,93,1,93,0.436042000,0.0000
202.178.8.205,<->,144.64.139.146,0,0,1,67,1,67,0.435748000,0.0000
247.136.143.247,<->,158.224.198.185,1,60,0,0,1,60,0.435715000,0.0000
246.44.99.250,<->,75.62.16.8,1,50,0,0,1,50,0.435343000,0.0000
144.87.238.91,<->,8.182.244.237,0,0,1,50,1,50,0.435241000,0.0000
215.158.238.137,<->,120.155.86.237,1,117,0,0,1,117,0.434936000,0.0000
111.151.106.211,<->,8.252.223.65,0,0,1,56,1,56,0.434555000,0.0000
215.158.239.99,<->,196.90.66.155,1,50,0,0,1,50,0.434261000,0.0000
144.83.60.153,<->,92.162.253.189,0,0,1,50,1,50,0.434131000,0.0000
117.66.147.65,<->,80.41.18.181,0,0,1,1470,1,1470,0.434056000,0.0000
196.14.198.174,<->,20.148.210.229,0,0,1,102,1,102,0.433773000,0.0000
123.89.2.13,<->,92.27.219.132,0,0,1,213,1,213,0.433684000,0.0000
241.193.172.231,<->,20.175.237.66,0,0,1,50,1,50,0.433678000,0.0000
195.5.55.183,<->,136.25.188.220,0,0,1,50,1,50,0.433546000,0.0000
120.155.84.97,<->,98.190.126.215,0,0,1,141,1,141,0.433311000,0.0000
129.201.176.4,<->,97.126.26.70,0,0,1,840,1,840,0.433156000,0.0000
97.126.119.99,<->,53.224.99.235,1,50,0,0,1,50,0.433111000,0.0000
103.162.170.64,<->,20.0.171.4,0,0,1,64,1,64,0.433055000,0.0000
231.138.228.181,<->,136.25.188.197,0,0,1,56,1,56,0.432817000,0.0000
216.73.179.43,<->,20.137.239.172,0,0,1,52,1,52,0.432701000,0.0000
241.193.172.231,<->,139.163.92.52,0,0,1,50,1,50,0.432056000,0.0000
133.54.43.16,<->,116.100.176.179,1,50,0,0,1,50,0.431978000,0.0000
8.166.167.253,<->,8.43.221.1,0,0,1,64,1,64,0.431872000,0.0000
123.58.41.255,<->,92.27.219.169,0,0,1,52,1,52,0.431789000,0.0000
219.228.243.244,<->,39.9.237.156,0,0,1,64,1,64,0.431673000,0.0000
133.135.213.14,<->,35.56.103.44,0,0,1,64,1,64,0.431632000,0.0000
247.136.213.175,<->,33.213.250.150,1,170,0,0,1,170,0.431433000,0.0000
197.113.99.62,<->,136.25.188.226,0,0,1,56,1,56,0.431075000,0.0000
126.242.231.201,<->,20.204.244.245,0,0,1,64,1,64,0.430882000,0.0000
221.102.56.51,<->,6.74.193.103,0,0,1,413,1,413,0.430182000,0.0000
193.41.49.218,<->,20.147.62.249,0,0,1,64,1,64,0.430032000,0.0000
254.199.70.131,<->,109.222.246.242,0,0,1,69,1,69,0.429348000,0.0000
139.163.26.146,<->,122.219.245.59,1,157,0,0,1,157,0.429335000,0.0000
241.193.172.231,<->,20.6.231.173,0,0,1,50,1,50,0.428857000,0.0000
207.92.62.85,<->,20.102.126.59,0,0,1,64,1,64,0.428329000,0.0000
213.38.136.197,<->,8.45.175.127,1,141,0,0,1,141,0.428056000,0.0000
193.41.49.218,<->,20.160.15.174,0,0,1,64,1,64,0.427971000,0.0000
215.158.239.253,<->,57.210.104.29,1,50,0,0,1,50,0.427816000,0.0000
200.174.199.248,<->,54.59.78.157,1,52,0,0,1,52,0.427673000,0.0000
109.122.222.217,<->,8.228.216.50,0,0,1,56,1,56,0.427507000,0.0000
131.144.248.44,<->,129.224.112.252,0,0,1,80,1,80,0.427499000,0.0000
193.41.49.218,<->,20.144.64.245,0,0,1,64,1,64,0.427300000,0.0000
198.158.197.83,<->,20.230.126.85,0,0,1,50,1,50,0.427032000,0.0000
221.196.95.250,<->,89.183.104.136,0,0,1,136,1,136,0.427027000,0.0000
193.41.49.218,<->,20.145.210.162,0,0,1,64,1,64,0.426925000,0.0000
109.222.246.242,<->,99.206.178.33,1,69,0,0,1,69,0.426272000,0.0000
111.150.207.179,<->,8.252.222.101,0,0,1,100,1,100,0.425754000,0.0000
215.158.239.95,<->,195.80.119.144,1,56,0,0,1,56,0.425734000,0.0000
92.27.219.168,<->,66.1.23.120,1,50,0,0,1,50,0.425688000,0.0000
123.129.238.171,<->,39.154.1.169,0,0,1,72,1,72,0.425408000,0.0000
207.87.179.41,<->,20.190.43.97,0,0,1,64,1,64,0.425374000,0.0000
120.155.84.161,<->,92.27.219.42,0,0,1,133,1,133,0.425184000,0.0000
193.41.49.218,<->,20.161.240.212,0,0,1,64,1,64,0.425064000,0.0000
215.158.239.96,<->,199.20.29.120,1,50,0,0,1,50,0.424922000,0.0000
207.212.154.51,<->,92.27.194.147,0,0,1,56,1,56,0.424812000,0.0000
231.141.60.32,<->,50.224.76.234,0,0,1,56,1,56,0.424788000,0.0000
198.158.197.83,<->,20.52.247.107,0,0,1,50,1,50,0.424780000,0.0000
215.158.239.96,<->,199.20.4.242,1,56,0,0,1,56,0.424611000,0.0000
139.5.114.201,<->,136.25.189.7,0,0,1,432,1,432,0.424591000,0.0000
122.212.149.92,<->,20.115.175.26,0,0,1,64,1,64,0.424576000,0.0000
106.22.183.117,<->,20.64.170.2,0,0,1,60,1,60,0.424452000,0.0000
144.75.218.233,<->,138.127.225.213,1,227,0,0,1,227,0.423984000,0.0000
119.74.160.119,<->,92.27.219.36,0,0,1,50,1,50,0.423730000,0.0000
198.158.197.83,<->,20.18.82.96,0,0,1,50,1,50,0.423313000,0.0000
215.158.239.56,<->,196.93.209.245,1,68,0,0,1,68,0.423279000,0.0000
144.71.41.191,<->,76.186.121.75,1,50,0,0,1,50,0.422585000,0.0000
215.158.140.163,<->,130.61.219.1,1,671,0,0,1,671,0.422033000,0.0000
192.67.167.86,<->,108.180.89.175,1,66,0,0,1,66,0.421469000,0.0000
92.27.27.166,<->,27.64.145.201,1,326,0,0,1,326,0.421368000,0.0000
136.25.188.220,<->,33.209.217.213,1,56,0,0,1,56,0.421217000,0.0000
100.182.99.11,<->,20.179.126.164,0,0,1,52,1,52,0.421167000,0.0000
215.158.239.96,<->,199.20.7.81,1,64,0,0,1,64,0.420978000,0.0000
215.158.239.33,<->,207.63.172.102,1,50,0,0,1,50,0.420965000,0.0000
91.231.194.109,<->,42.194.20.138,1,64,0,0,1,64,0.420962000,0.0000
201.212.14.151,<->,39.207.143.241,0,0,1,64,1,64,0.420948000,0.0000
241.193.172.231,<->,20.3.15.225,0,0,1,50,1,50,0.420453000,0.0000
156.190.55.10,<->,50.145.216.49,1,146,0,0,1,146,0.420386000,0.0000
193.41.49.218,<->,20.163.66.20,0,0,1,64,1,64,0.420036000,0.0000
109.1.17.98,<->,27.188.163.162,1,445,0,0,1,445,0.419674000,0.0000
92.27.190.249,<->,20.143.114.14,0,0,1,52,1,52,0.419652000,0.0000
204.20.133.205,<->,136.25.188.55,0,0,1,56,1,56,0.419606000,0.0000
20.13.112.138,<->,0.200.50.50,1,60,0,0,1,60,0.419459000,0.0000
113.127.207.90,<->,97.126.113.73,0,0,1,64,1,64,0.419439000,0.0000
244.50.135.57,<->,20.166.123.215,0,0,1,50,1,50,0.419382000,0.0000
89.153.92.190,<->,34.173.54.227,0,0,1,52,1,52,0.419082000,0.0000
92.27.219.220,<->,35.61.221.74,1,56,0,0,1,56,0.418635000,0.0000
207.191.233.199,<->,136.25.188.177,0,0,1,68,1,68,0.418505000,0.0000
224.240.250.38,<->,92.27.219.228,0,0,1,52,1,52,0.418459000,0.0000
215.158.239.92,<->,204.2.77.95,1,68,0,0,1,68,0.418453000,0.0000
98.67.133.113,<->,40.240.144.244,1,74,0,0,1,74,0.418183000,0.0000
210.209.251.214,<->,98.128.0.227,0,0,1,50,1,50,0.417724000,0.0000
103.5.97.227,<->,8.220.176.253,0,0,1,50,1,50,0.417409000,0.0000
133.178.227.8,<->,89.70.190.180,1,85,0,0,1,85,0.417397000,0.0000
193.41.49.218,<->,20.165.224.237,0,0,1,64,1,64,0.417324000,0.0000
221.102.143.189,<->,192.67.146.253,0,0,1,92,1,92,0.417123000,0.0000
215.158.43.153,<->,8.252.223.201,0,0,1,97,1,97,0.417108000,0.0000
193.41.49.218,<->,20.166.66.231,0,0,1,64,1,64,0.417078000,0.0000
109.222.238.4,<->,108.132.148.8,1,50,0,0,1,50,0.416947000,0.0000
119.165.69.159,<->,39.37.132.244,0,0,1,56,1,56,0.416910000,0.0000
241.193.172.231,<->,20.26.106.185,0,0,1,50,1,50,0.416112000,0.0000
252.64.177.47,<->,247.136.245.208,0,0,1,321,1,321,0.415999000,0.0000
215.158.140.9,<->,56.23.171.110,1,1064,0,0,1,1064,0.415853000,0.0000
144.75.218.233,<->,143.230.117.93,1,248,0,0,1,248,0.415567000,0.0000
215.158.238.246,<->,111.151.142.216,1,100,0,0,1,100,0.415221000,0.0000
136.25.188.105,<->,131.16.151.86,1,135,0,0,1,135,0.415158000,0.0000
120.190.159.223,<->,20.229.216.63,0,0,1,52,1,52,0.415148000,0.0000
139.163.26.146,<->,120.45.127.197,1,99,0,0,1,99,0.415146000,0.0000
116.142.209.67,<->,50.224.76.234,0,0,1,50,1,50,0.414973000,0.0000
230.14.252.62,<->,39.6.171.212,0,0,1,52,1,52,0.414947000,0.0000
92.27.219.231,<->,40.208.16.117,1,56,0,0,1,56,0.414840000,0.0000
145.19.6.243,<->,97.68.20.226,1,50,0,0,1,50,0.414487000,0.0000
204.11.248.222,<->,39.193.8.8,0,0,1,94,1,94,0.414404000,0.0000
215.158.239.17,<->,198.233.198.222,1,50,0,0,1,50,0.414225000,0.0000
80.56.78.128,<->,80.47.34.171,1,101,0,0,1,101,0.414166000,0.0000
215.158.239.81,<->,111.151.142.232,1,56,0,0,1,56,0.413545000,0.0000
198.158.197.83,<->,20.80.217.113,0,0,1,50,1,50,0.413380000,0.0000
119.127.194.253,<->,20.236.177.136,0,0,1,64,1,64,0.413306000,0.0000
244.50.252.80,<->,20.11.199.147,0,0,1,50,1,50,0.413197000,0.0000
192.67.129.253,<->,107.21.28.148,1,76,0,0,1,76,0.413158000,0.0000
246.253.253.107,<->,111.151.239.135,1,56,0,0,1,56,0.413145000,0.0000
215.158.140.170,<->,130.61.230.62,1,678,0,0,1,678,0.412924000,0.0000
144.75.218.242,<->,139.114.208.35,1,131,0,0,1,131,0.412841000,0.0000
241.242.244.237,<->,138.127.227.251,1,233,0,0,1,233,0.412432000,0.0000
198.103.239.241,<->,92.27.219.19,0,0,1,52,1,52,0.412216000,0.0000
120.82.229.76,<->,80.41.16.79,0,0,1,97,1,97,0.412186000,0.0000
97.126.114.234,<->,53.230.101.77,1,50,0,0,1,50,0.412145000,0.0000
8.252.222.39,<->,4.122.182.163,1,50,0,0,1,50,0.411827000,0.0000
99.236.27.146,<->,92.27.219.159,0,0,1,62,1,62,0.411824000,0.0000
144.75.218.237,<->,138.127.230.130,1,253,0,0,1,253,0.411749000,0.0000
196.84.101.90,<->,136.25.188.226,0,0,1,64,1,64,0.411320000,0.0000
224.250.64.91,<->,102.50.157.50,0,0,1,68,1,68,0.411018000,0.0000
229.107.126.52,<->,139.163.26.146,0,0,1,99,1,99,0.410995000,0.0000
215.158.239.38,<->,215.158.58.237,1,1450,0,0,1,1450,0.410736000,0.0000
97.127.101.156,<->,54.58.255.143,1,125,0,0,1,125,0.410462000,0.0000
192.64.250.221,<->,8.45.168.98,1,56,0,0,1,56,0.410170000,0.0000
204.200.52.99,<->,136.25.188.178,0,0,1,132,1,132,0.410155000,0.0000
136.26.10.226,<->,8.228.217.101,0,0,1,120,1,120,0.410022000,0.0000
193.41.49.218,<->,20.168.130.171,0,0,1,64,1,64,0.410001000,0.0000
218.4.187.87,<->,140.91.191.15,1,99,0,0,1,99,0.409966000,0.0000
193.41.49.218,<->,20.166.3.16,0,0,1,64,1,64,0.409932000,0.0000
127.66.17.50,<->,39.141.80.43,0,0,1,64,1,64,0.409846000,0.0000
134.9.11.151,<->,39.24.108.121,0,0,1,64,1,64,0.409610000,0.0000
80.38.26.162,<->,42.94.141.71,1,56,0,0,1,56,0.409442000,0.0000
210.220.219.153,<->,54.42.226.46,1,50,0,0,1,50,0.408691000,0.0000
111.147.223.238,<->,100.234.24.233,1,50,0,0,1,50,0.408642000,0.0000
210.220.219.153,<->,50.238.182.2,1,50,0,0,1,50,0.408303000,0.0000
93.77.26.44,<->,92.27.219.192,0,0,1,64,1,64,0.408301000,0.0000
203.88.22.86,<->,20.90.75.3,0,0,1,56,1,56,0.408176000,0.0000
210.220.219.153,<->,8.232.202.181,1,50,0,0,1,50,0.408168000,0.0000
215.158.239.56,<->,196.7.80.159,1,157,0,0,1,157,0.408016000,0.0000
193.47.198.119,<->,8.52.161.253,0,0,1,67,1,67,0.407902000,0.0000
210.220.219.153,<->,54.55.151.118,1,50,0,0,1,50,0.407837000,0.0000
215.158.103.219,<->,159.176.32.28,1,76,0,0,1,76,0.407517000,0.0000
215.158.239.87,<->,196.90.211.33,1,68,0,0,1,68,0.407042000,0.0000
144.75.218.235,<->,136.99.66.244,1,174,0,0,1,174,0.406974000,0.0000
97.126.114.234,<->,53.230.103.170,1,50,0,0,1,50,0.406735000,0.0000
112.7.33.113,<->,39.8.201.124,0,0,1,66,1,66,0.405969000,0.0000
158.164.217.111,<->,39.242.94.199,0,0,1,78,1,78,0.405944000,0.0000
92.27.219.244,<->,59.146.81.189,1,52,0,0,1,52,0.405911000,0.0000
157.142.59.66,<->,20.139.218.107,0,0,1,52,1,52,0.405743000,0.0000
57.126.221.209,<->,39.43.98.237,0,0,1,88,1,88,0.405724000,0.0000
207.191.174.199,<->,136.25.188.178,0,0,1,56,1,56,0.404923000,0.0000
138.42.27.182,<->,56.121.33.48,0,0,1,50,1,50,0.404583000,0.0000
100.182.99.11,<->,20.179.125.202,0,0,1,52,1,52,0.404161000,0.0000
120.115.228.105,<->,20.133.119.44,0,0,1,52,1,52,0.404017000,0.0000
231.140.150.135,<->,136.25.188.253,0,0,1,50,1,50,0.403957000,0.0000
92.27.219.207,<->,64.214.63.86,1,62,0,0,1,62,0.403772000,0.0000
199.123.15.78,<->,136.25.188.196,0,0,1,68,1,68,0.403750000,0.0000
8.252.223.230,<->,8.176.12.107,1,56,0,0,1,56,0.403608000,0.0000
241.193.172.231,<->,20.73.205.42,0,0,1,50,1,50,0.403606000,0.0000
247.136.211.163,<->,92.19.40.242,1,52,0,0,1,52,0.403532000,0.0000
193.41.49.218,<->,20.173.124.63,0,0,1,64,1,64,0.403279000,0.0000
142.241.62.105,<->,136.25.188.199,0,0,1,630,1,630,0.403163000,0.0000
75.62.16.8,<->,39.14.148.7,0,0,1,50,1,50,0.403108000,0.0000
122.159.69.87,<->,50.224.110.122,0,0,1,86,1,86,0.402666000,0.0000
192.64.195.164,<->,104.251.192.216,1,50,0,0,1,50,0.402568000,0.0000
215.158.239.93,<->,199.20.28.47,1,56,0,0,1,56,0.402393000,0.0000
136.25.188.243,<->,17.61.4.176,1,50,0,0,1,50,0.402320000,0.0000
145.252.123.206,<->,35.62.71.37,1,68,0,0,1,68,0.402239000,0.0000
210.229.230.22,<->,102.179.166.70,1,56,0,0,1,56,0.402155000,0.0000
97.126.115.199,<->,49.89.97.93,1,78,0,0,1,78,0.402060000,0.0000
221.98.99.233,<->,148.57.134.57,1,84,0,0,1,84,0.401998000,0.0000
193.41.49.218,<->,20.173.237.246,0,0,1,64,1,64,0.401957000,0.0000
200.174.10.198,<->,54.36.230.207,1,56,0,0,1,56,0.401949000,0.0000
133.178.226.162,<->,126.219.197.206,1,90,0,0,1,90,0.401318000,0.0000
105.201.211.173,<->,102.51.227.2,0,0,1,330,1,330,0.401300000,0.0000
195.4.96.58,<->,136.25.188.252,0,0,1,50,1,50,0.400518000,0.0000
192.64.230.47,<->,122.112.203.205,1,52,0,0,1,52,0.400381000,0.0000
147.180.61.51,<->,89.216.126.106,0,0,1,97,1,97,0.400319000,0.0000
139.163.87.88,<->,130.61.227.228,1,52,0,0,1,52,0.400273000,0.0000
114.233.87.165,<->,92.27.219.193,0,0,1,56,1,56,0.400125000,0.0000
143.148.50.173,<->,39.160.238.214,0,0,1,75,1,75,0.399892000,0.0000
141.191.13.155,<->,39.0.95.117,0,0,1,104,1,104,0.399520000,0.0000
132.249.70.233,<->,124.51.228.76,1,159,0,0,1,159,0.399336000,0.0000
142.198.112.88,<->,20.240.134.8,0,0,1,52,1,52,0.399289000,0.0000
249.101.127.5,<->,54.38.108.23,1,125,0,0,1,125,0.399115000,0.0000
142.238.207.205,<->,8.20.87.187,0,0,1,56,1,56,0.399040000,0.0000
241.193.172.231,<->,20.97.162.219,0,0,1,50,1,50,0.398926000,0.0000
142.208.111.233,<->,136.25.188.174,0,0,1,56,1,56,0.398925000,0.0000
221.102.56.69,<->,220.81.49.114,0,0,1,64,1,64,0.398324000,0.0000
196.74.186.233,<->,39.20.46.0,0,0,1,104,1,104,0.397997000,0.0000
193.41.49.218,<->,20.172.240.126,0,0,1,64,1,64,0.397957000,0.0000
80.41.3.230,<->,38.18.60.250,1,135,0,0,1,135,0.397775000,0.0000
222.65.26.198,<->,132.18.67.28,1,50,0,0,1,50,0.397705000,0.0000
247.136.139.247,<->,132.18.67.28,1,50,0,0,1,50,0.397682000,0.0000
241.193.172.231,<->,20.152.229.255,0,0,1,50,1,50,0.397528000,0.0000
192.67.181.145,<->,50.248.185.173,1,50,0,0,1,50,0.396990000,0.0000
97.27.254.35,<->,8.52.186.156,0,0,1,50,1,50,0.396718000,0.0000
145.3.142.7,<->,39.237.228.239,0,0,1,64,1,64,0.396589000,0.0000
127.242.248.118,<->,50.224.76.230,0,0,1,50,1,50,0.396561000,0.0000
196.233.216.109,<->,50.224.76.234,0,0,1,50,1,50,0.396363000,0.0000
215.158.43.154,<->,8.252.223.202,0,0,1,97,1,97,0.396122000,0.0000
104.152.220.2,<->,89.183.104.227,0,0,1,52,1,52,0.396075000,0.0000
207.51.198.46,<->,109.1.60.170,0,0,1,52,1,52,0.395998000,0.0000
124.178.214.131,<->,92.27.219.23,0,0,1,149,1,149,0.395884000,0.0000
159.112.9.198,<->,137.137.116.236,0,0,1,50,1,50,0.395879000,0.0000
215.158.140.87,<->,83.227.21.185,1,50,0,0,1,50,0.395558000,0.0000
215.126.160.83,<->,39.164.84.252,0,0,1,64,1,64,0.395478000,0.0000
215.158.103.219,<->,129.220.171.193,1,782,0,0,1,782,0.395285000,0.0000
241.193.172.231,<->,20.113.199.172,0,0,1,50,1,50,0.395207000,0.0000
197.113.175.58,<->,129.224.112.252,0,0,1,93,1,93,0.395118000,0.0000
129.250.50.22,<->,8.220.190.86,0,0,1,56,1,56,0.394841000,0.0000
144.75.218.235,<->,138.127.225.253,1,291,0,0,1,291,0.394841000,0.0000
109.14.167.30,<->,79.255.66.183,1,130,0,0,1,130,0.394658000,0.0000
99.215.38.13,<->,8.182.251.151,0,0,1,50,1,50,0.394655000,0.0000
215.158.103.219,<->,126.84.20.136,1,166,0,0,1,166,0.394233000,0.0000
215.158.239.105,<->,215.158.214.222,1,141,0,0,1,141,0.394013000,0.0000
193.41.49.218,<->,20.181.114.37,0,0,1,64,1,64,0.393952000,0.0000
99.75.54.228,<->,33.107.91.35,1,50,0,0,1,50,0.393612000,0.0000
247.136.180.69,<->,57.85.32.67,1,149,0,0,1,149,0.393362000,0.0000
122.222.66.154,<->,39.174.200.118,0,0,1,60,1,60,0.393240000,0.0000
200.175.152.251,<->,54.37.202.190,1,50,0,0,1,50,0.393201000,0.0000
215.158.239.210,<->,111.151.71.75,1,84,0,0,1,84,0.393114000,0.0000
111.146.237.145,<->,33.49.23.119,1,135,0,0,1,135,0.393110000,0.0000
92.27.219.33,<->,38.94.255.65,1,58,0,0,1,58,0.393034000,0.0000
248.232.154.130,<->,215.158.140.74,0,0,1,50,1,50,0.392843000,0.0000
145.186.93.66,<->,53.167.130.141,1,50,0,0,1,50,0.392802000,0.0000
207.78.70.240,<->,92.27.219.242,0,0,1,52,1,52,0.392499000,0.0000
215.158.239.76,<->,199.68.224.66,1,50,0,0,1,50,0.392360000,0.0000
220.55.168.247,<->,53.157.11.198,1,209,0,0,1,209,0.392314000,0.0000
195.55.20.38,<->,136.25.188.53,0,0,1,68,1,68,0.392101000,0.0000
76.82.63.165,<->,34.142.191.107,0,0,1,52,1,52,0.391483000,0.0000
215.158.239.112,<->,109.126.137.237,1,94,0,0,1,94,0.391371000,0.0000
199.70.186.96,<->,136.25.188.160,0,0,1,272,1,272,0.391339000,0.0000
197.44.22.113,<->,89.183.104.138,0,0,1,52,1,52,0.391338000,0.0000
17.46.87.216,<->,8.220.238.126,0,0,1,50,1,50,0.391155000,0.0000
144.75.218.235,<->,129.35.251.34,1,136,0,0,1,136,0.390564000,0.0000
145.3.142.7,<->,39.237.228.244,0,0,1,64,1,64,0.390471000,0.0000
130.13.151.57,<->,92.27.219.63,0,0,1,52,1,52,0.390256000,0.0000
121.71.65.35,<->,92.27.219.182,0,0,1,102,1,102,0.390152000,0.0000
92.27.27.164,<->,18.200.206.47,1,315,0,0,1,315,0.390072000,0.0000
76.96.28.29,<->,20.226.92.160,0,0,1,60,1,60,0.390046000,0.0000
117.154.63.56,<->,100.94.16.235,0,0,1,105,1,105,0.389715000,0.0000
126.82.210.35,<->,92.27.219.19,0,0,1,52,1,52,0.389601000,0.0000
210.158.44.231,<->,8.220.7.206,1,149,0,0,1,149,0.389422000,0.0000
220.55.97.182,<->,27.11.68.126,1,148,0,0,1,148,0.389339000,0.0000
215.158.239.79,<->,204.3.235.45,1,56,0,0,1,56,0.388930000,0.0000
231.143.13.188,<->,136.25.188.53,0,0,1,93,1,93,0.388819000,0.0000
215.158.238.132,<->,57.225.219.36,1,1117,0,0,1,1117,0.388811000,0.0000
118.125.182.41,<->,39.140.92.107,0,0,1,140,1,140,0.388618000,0.0000
127.87.219.139,<->,80.42.165.24,0,0,1,135,1,135,0.388597000,0.0000
129.92.112.227,<->,53.84.229.56,1,56,0,0,1,56,0.388177000,0.0000
215.158.239.79,<->,199.20.31.80,1,56,0,0,1,56,0.388170000,0.0000
146.1.155.25,<->,144.75.218.246,0,0,1,171,1,171,0.388051000,0.0000
210.209.251.214,<->,132.51.5.140,0,0,1,481,1,481,0.388046000,0.0000
91.250.143.162,<->,39.207.133.19,0,0,1,50,1,50,0.387932000,0.0000
215.158.239.93,<->,204.226.53.153,1,50,0,0,1,50,0.387926000,0.0000
89.183.104.234,<->,33.95.62.155,1,321,0,0,1,321,0.387842000,0.0000
144.0.26.215,<->,137.21.23.63,0,0,1,50,1,50,0.387599000,0.0000
241.193.172.231,<->,20.129.104.118,0,0,1,50,1,50,0.387440000,0.0000
141.21.245.250,<->,129.224.112.252,0,0,1,59,1,59,0.387039000,0.0000
215.158.239.95,<->,204.226.53.153,1,50,0,0,1,50,0.387023000,0.0000
215.158.239.85,<->,195.6.197.173,1,101,0,0,1,101,0.386987000,0.0000
192.67.143.37,<->,97.91.14.64,1,56,0,0,1,56,0.386904000,0.0000
215.158.199.180,<->,101.65.255.233,0,0,1,704,1,704,0.386678000,0.0000
215.158.238.126,<->,100.224.166.120,1,364,0,0,1,364,0.386652000,0.0000
144.75.218.246,<->,138.127.230.151,1,68,0,0,1,68,0.386380000,0.0000
195.71.146.117,<->,136.25.188.52,0,0,1,56,1,56,0.386286000,0.0000
77.19.64.23,<->,34.248.11.46,0,0,1,132,1,132,0.385715000,0.0000
117.38.167.80,<->,89.183.104.177,0,0,1,263,1,263,0.385433000,0.0000
132.24.95.70,<->,39.150.226.202,0,0,1,64,1,64,0.385157000,0.0000
204.186.150.53,<->,136.25.188.176,0,0,1,68,1,68,0.384948000,0.0000
207.60.149.206,<->,136.25.188.209,0,0,1,56,1,56,0.384733000,0.0000
195.0.79.151,<->,139.163.95.75,0,0,1,50,1,50,0.384405000,0.0000
247.136.162.79,<->,129.222.39.105,1,50,0,0,1,50,0.384224000,0.0000
141.245.151.215,<->,136.47.66.197,1,85,0,0,1,85,0.384108000,0.0000
89.183.104.174,<->,14.70.166.219,1,109,0,0,1,109,0.383854000,0.0000
90.240.3.93,<->,53.148.184.48,1,56,0,0,1,56,0.383470000,0.0000
108.134.112.54,<->,100.230.2.53,1,56,0,0,1,56,0.383283000,0.0000
143.135.59.118,<->,136.25.188.255,0,0,1,50,1,50,0.382990000,0.0000
215.158.239.85,<->,199.68.224.66,1,50,0,0,1,50,0.382963000,0.0000
92.27.219.41,<->,40.199.74.69,1,56,0,0,1,56,0.382731000,0.0000
199.89.56.124,<->,50.224.76.235,0,0,1,50,1,50,0.382254000,0.0000
244.50.136.175,<->,20.110.154.2,0,0,1,50,1,50,0.382231000,0.0000
21.15.226.126,<->,20.193.52.72,0,0,1,82,1,82,0.382120000,0.0000
218.5.92.23,<->,159.133.63.103,0,0,1,76,1,76,0.382028000,0.0000
123.251.189.247,<->,109.222.250.174,0,0,1,78,1,78,0.381655000,0.0000
215.158.239.92,<->,199.82.206.177,1,56,0,0,1,56,0.381629000,0.0000
139.163.8.52,<->,105.201.221.207,1,88,0,0,1,88,0.381557000,0.0000
231.255.132.167,<->,145.19.8.119,0,0,1,50,1,50,0.381105000,0.0000
215.158.239.87,<->,196.90.171.92,1,56,0,0,1,56,0.380533000,0.0000
129.224.112.252,<->,33.78.13.33,1,79,0,0,1,79,0.380333000,0.0000
194.201.14.91,<->,20.23.44.25,0,0,1,103,1,103,0.380170000,0.0000
220.20.200.44,<->,144.83.60.153,1,50,0,0,1,50,0.380144000,0.0000
197.197.246.234,<->,39.243.58.114,0,0,1,108,1,108,0.380001000,0.0000
129.224.112.252,<->,114.187.168.248,1,70,0,0,1,70,0.379901000,0.0000
156.132.134.164,<->,34.16.125.126,0,0,1,72,1,72,0.379630000,0.0000
144.50.154.211,<->,136.25.188.55,0,0,1,50,1,50,0.379471000,0.0000
33.157.131.51,<->,20.168.212.185,0,0,1,52,1,52,0.379408000,0.0000
102.50.117.189,<->,92.27.27.181,0,0,1,397,1,397,0.379094000,0.0000
53.161.2.103,<->,6.95.3.106,0,0,1,605,1,605,0.378793000,0.0000
192.171.13.189,<->,8.252.222.10,0,0,1,157,1,157,0.378159000,0.0000
103.162.170.64,<->,20.0.171.0,0,0,1,64,1,64,0.378053000,0.0000
215.158.239.77,<->,195.49.173.230,1,172,0,0,1,172,0.377940000,0.0000
192.205.38.247,<->,29.211.214.254,0,0,1,92,1,92,0.377648000,0.0000
215.158.239.196,<->,112.235.16.174,1,56,0,0,1,56,0.377232000,0.0000
215.158.239.50,<->,194.237.55.75,1,50,0,0,1,50,0.377219000,0.0000
136.25.188.209,<->,67.0.40.34,1,50,0,0,1,50,0.376967000,0.0000
204.51.118.227,<->,39.6.23.0,0,0,1,60,1,60,0.376857000,0.0000
203.215.167.132,<->,142.172.153.106,1,64,0,0,1,64,0.376788000,0.0000
198.59.252.179,<->,89.183.104.231,0,0,1,52,1,52,0.376404000,0.0000
215.158.239.56,<->,199.68.61.40,1,50,0,0,1,50,0.376367000,0.0000
196.24.224.171,<->,100.94.72.189,0,0,1,130,1,130,0.376271000,0.0000
8.252.221.221,<->,4.122.142.62,1,50,0,0,1,50,0.376193000,0.0000
215.158.239.105,<->,159.147.253.1,1,220,0,0,1,220,0.376036000,0.0000
220.31.22.169,<->,144.75.218.237,0,0,1,248,1,248,0.375800000,0.0000
127.180.125.49,<->,97.168.91.134,0,0,1,72,1,72,0.375667000,0.0000
42.228.80.221,<->,39.24.230.209,0,0,1,60,1,60,0.375594000,0.0000
102.232.177.73,<->,52.220.244.34,1,71,0,0,1,71,0.375463000,0.0000
215.158.239.76,<->,196.1.76.198,1,56,0,0,1,56,0.375434000,0.0000
216.37.68.179,<->,215.158.140.182,0,0,1,57,1,57,0.375406000,0.0000
54.36.246.164,<->,48.55.145.196,0,0,1,125,1,125,0.375322000,0.0000
222.3.112.217,<->,139.163.26.146,0,0,1,99,1,99,0.375178000,0.0000
144.76.46.38,<->,100.93.238.68,0,0,1,158,1,158,0.374887000,0.0000
38.21.156.204,<->,20.232.229.96,0,0,1,82,1,82,0.374621000,0.0000
53.195.186.155,<->,35.56.101.196,0,0,1,512,1,512,0.374267000,0.0000
204.118.226.107,<->,92.27.194.147,0,0,1,56,1,56,0.374073000,0.0000
92.27.219.188,<->,92.27.131.123,1,56,0,0,1,56,0.374048000,0.0000
192.171.13.189,<->,8.176.8.71,0,0,1,138,1,138,0.373573000,0.0000
111.199.229.199,<->,0.195.210.44,0,0,1,56,1,56,0.373447000,0.0000
244.50.249.107,<->,20.22.62.214,0,0,1,50,1,50,0.373095000,0.0000
159.57.90.83,<->,89.183.104.137,0,0,1,50,1,50,0.372362000,0.0000
148.162.217.87,<->,39.249.24.116,0,0,1,78,1,78,0.372338000,0.0000
210.221.111.210,<->,155.17.159.75,1,109,0,0,1,109,0.372263000,0.0000
116.111.127.70,<->,39.141.135.129,0,0,1,60,1,60,0.371906000,0.0000
113.63.153.121,<->,89.183.104.243,0,0,1,98,1,98,0.371618000,0.0000
118.209.6.97,<->,89.183.104.179,0,0,1,64,1,64,0.371257000,0.0000
149.96.85.100,<->,139.163.26.146,0,0,1,99,1,99,0.371255000,0.0000
147.54.117.181,<->,39.43.170.225,0,0,1,134,1,134,0.370986000,0.0000
146.198.38.34,<->,99.160.105.66,0,0,1,67,1,67,0.370985000,0.0000
194.233.112.233,<->,136.25.188.255,0,0,1,56,1,56,0.370949000,0.0000
241.193.172.231,<->,20.153.50.191,0,0,1,50,1,50,0.370937000,0.0000
143.91.217.78,<->,136.25.188.45,0,0,1,282,1,282,0.370786000,0.0000
215.158.140.172,<->,100.52.120.242,1,50,0,0,1,50,0.370580000,0.0000
148.157.159.25,<->,8.43.220.234,0,0,1,84,1,84,0.370294000,0.0000
109.222.253.48,<->,26.81.16.237,1,75,0,0,1,75,0.369966000,0.0000
192.64.228.244,<->,120.150.227.165,1,56,0,0,1,56,0.369727000,0.0000
255.133.229.164,<->,39.48.242.143,0,0,1,100,1,100,0.369599000,0.0000
121.188.115.120,<->,92.27.219.40,0,0,1,50,1,50,0.369512000,0.0000
215.158.239.99,<->,142.240.138.160,1,95,0,0,1,95,0.369488000,0.0000
97.21.115.188,<->,0.195.210.46,0,0,1,50,1,50,0.369253000,0.0000
195.7.97.13,<->,20.192.127.190,0,0,1,50,1,50,0.369227000,0.0000
120.102.6.202,<->,39.24.125.142,0,0,1,52,1,52,0.369025000,0.0000
215.158.239.105,<->,210.104.195.8,1,256,0,0,1,256,0.368905000,0.0000
215.158.140.193,<->,41.60.3.115,1,50,0,0,1,50,0.368712000,0.0000
125.10.150.102,<->,80.42.160.210,0,0,1,99,1,99,0.368372000,0.0000
216.132.55.74,<->,80.41.16.226,0,0,1,52,1,52,0.368137000,0.0000
215.158.239.68,<->,195.6.3.97,1,50,0,0,1,50,0.367968000,0.0000
133.178.226.213,<->,69.31.238.192,1,56,0,0,1,56,0.367854000,0.0000
105.140.227.39,<->,20.220.226.179,0,0,1,52,1,52,0.367847000,0.0000
130.35.155.10,<->,39.27.99.49,0,0,1,52,1,52,0.367716000,0.0000
144.75.218.237,<->,50.149.206.150,1,205,0,0,1,205,0.367131000,0.0000
144.122.240.194,<->,144.108.80.170,1,61,0,0,1,61,0.366859000,0.0000
204.21.170.140,<->,136.25.188.177,0,0,1,50,1,50,0.366774000,0.0000
192.67.167.86,<->,103.147.216.59,1,83,0,0,1,83,0.366237000,0.0000
246.253.252.62,<->,136.21.70.219,1,132,0,0,1,132,0.366106000,0.0000
192.67.174.62,<->,50.62.255.14,1,97,0,0,1,97,0.365972000,0.0000
232.31.28.211,<->,99.72.224.17,0,0,1,50,1,50,0.365906000,0.0000
95.169.150.140,<->,92.27.219.34,0,0,1,52,1,52,0.365856000,0.0000
109.1.47.253,<->,93.170.103.133,1,50,0,0,1,50,0.365375000,0.0000
127.186.128.183,<->,20.43.81.148,0,0,1,64,1,64,0.365369000,0.0000
91.250.143.162,<->,39.47.219.33,0,0,1,50,1,50,0.365118000,0.0000
108.134.117.140,<->,97.242.126.187,1,75,0,0,1,75,0.364754000,0.0000
21.15.226.126,<->,20.193.52.152,0,0,1,82,1,82,0.364549000,0.0000
207.59.185.115,<->,136.25.188.53,0,0,1,50,1,50,0.364462000,0.0000
146.199.195.194,<->,39.58.191.75,0,0,1,134,1,134,0.364142000,0.0000
241.193.172.231,<->,20.139.179.147,0,0,1,50,1,50,0.364020000,0.0000
215.158.103.206,<->,120.155.87.47,1,102,0,0,1,102,0.363568000,0.0000
142.229.219.153,<->,136.25.188.52,0,0,1,56,1,56,0.363472000,0.0000
92.27.219.235,<->,60.149.94.152,1,132,0,0,1,132,0.363464000,0.0000
156.148.151.114,<->,39.53.120.116,0,0,1,531,1,531,0.363452000,0.0000
199.32.237.234,<->,20.202.198.27,0,0,1,52,1,52,0.363265000,0.0000
125.223.91.142,<->,20.33.115.109,0,0,1,64,1,64,0.363078000,0.0000
144.75.218.242,<->,138.127.224.235,1,306,0,0,1,306,0.362951000,0.0000
215.158.61.189,<->,8.176.8.180,0,0,1,1149,1,1149,0.362814000,0.0000
244.50.136.175,<->,20.171.165.85,0,0,1,50,1,50,0.362758000,0.0000
21.15.226.126,<->,20.193.52.158,0,0,1,82,1,82,0.362462000,0.0000
133.178.226.161,<->,111.150.207.83,1,163,0,0,1,163,0.362350000,0.0000
215.158.239.105,<->,192.226.44.43,1,111,0,0,1,111,0.362152000,0.0000
119.118.207.166,<->,20.187.4.80,0,0,1,52,1,52,0.361999000,0.0000
144.76.43.234,<->,138.98.141.131,0,0,1,83,1,83,0.361924000,0.0000
69.196.64.236,<->,39.147.215.38,0,0,1,64,1,64,0.361580000,0.0000
195.39.172.27,<->,39.132.86.228,0,0,1,64,1,64,0.361432000,0.0000
127.255.81.26,<->,109.222.205.84,0,0,1,50,1,50,0.361284000,0.0000
192.64.196.5,<->,125.29.8.109,1,64,0,0,1,64,0.361140000,0.0000
221.101.9.15,<->,199.55.11.97,1,50,0,0,1,50,0.361007000,0.0000
144.75.218.242,<->,138.127.225.21,1,254,0,0,1,254,0.360981000,0.0000
144.75.218.237,<->,132.208.122.193,1,133,0,0,1,133,0.360917000,0.0000
145.128.96.18,<->,8.52.171.120,0,0,1,50,1,50,0.360350000,0.0000
215.158.239.79,<->,207.236.72.252,1,170,0,0,1,170,0.360144000,0.0000
53.201.48.249,<->,48.53.115.143,0,0,1,56,1,56,0.359937000,0.0000
244.50.129.64,<->,39.248.27.244,0,0,1,50,1,50,0.359811000,0.0000
33.144.130.144,<->,20.198.127.119,0,0,1,64,1,64,0.359792000,0.0000
111.69.70.13,<->,8.220.202.59,0,0,1,50,1,50,0.359775000,0.0000
144.95.254.55,<->,137.19.245.24,0,0,1,56,1,56,0.359710000,0.0000
196.247.184.25,<->,136.25.188.174,0,0,1,56,1,56,0.359657000,0.0000
247.136.216.15,<->,127.162.227.139,1,50,0,0,1,50,0.359592000,0.0000
215.158.239.84,<->,199.20.31.244,1,68,0,0,1,68,0.359549000,0.0000
139.254.209.152,<->,8.182.123.88,1,68,0,0,1,68,0.359003000,0.0000
111.146.169.221,<->,53.231.93.123,1,81,0,0,1,81,0.358703000,0.0000
193.46.99.114,<->,80.42.150.137,0,0,1,300,1,300,0.358518000,0.0000
111.147.246.5,<->,105.122.151.39,1,301,0,0,1,301,0.357693000,0.0000
215.158.140.230,<->,17.12.130.178,1,50,0,0,1,50,0.357504000,0.0000
206.115.123.105,<->,192.64.224.151,0,0,1,135,1,135,0.357273000,0.0000
8.183.25.124,<->,6.167.235.77,1,50,0,0,1,50,0.357155000,0.0000
192.64.217.166,<->,112.238.34.98,1,52,0,0,1,52,0.356696000,0.0000
192.65.168.51,<->,8.55.211.213,1,294,0,0,1,294,0.356531000,0.0000
73.118.101.73,<->,8.252.222.160,0,0,1,50,1,50,0.356529000,0.0000
106.23.130.20,<->,8.220.176.253,0,0,1,50,1,50,0.356357000,0.0000
250.50.34.183,<->,20.115.54.218,0,0,1,50,1,50,0.356272000,0.0000
145.16.26.17,<->,113.188.193.169,1,68,0,0,1,68,0.356239000,0.0000
142.43.184.230,<->,39.166.182.65,0,0,1,64,1,64,0.356100000,0.0000
127.66.17.50,<->,39.141.80.41,0,0,1,64,1,64,0.356013000,0.0000
215.158.2.59,<->,133.81.199.205,0,0,1,88,1,88,0.355910000,0.0000
76.72.228.64,<->,39.164.106.188,0,0,1,64,1,64,0.355620000,0.0000
21.15.226.126,<->,20.193.52.171,0,0,1,82,1,82,0.355423000,0.0000
116.97.206.237,<->,92.27.219.204,0,0,1,52,1,52,0.355387000,0.0000
204.200.44.174,<->,136.25.188.255,0,0,1,172,1,172,0.355321000,0.0000
38.188.34.199,<->,20.195.144.177,0,0,1,52,1,52,0.354991000,0.0000
204.143.14.177,<->,8.182.226.78,0,0,1,50,1,50,0.354989000,0.0000
111.149.184.72,<->,92.26.129.210,1,108,0,0,1,108,0.354971000,0.0000
200.174.223.64,<->,53.161.35.31,1,93,0,0,1,93,0.354791000,0.0000
137.81.65.54,<->,107.99.228.94,1,77,0,0,1,77,0.354507000,0.0000
21.15.226.126,<->,20.193.52.175,0,0,1,82,1,82,0.354450000,0.0000
130.200.217.118,<->,20.8.122.17,0,0,1,64,1,64,0.354359000,0.0000
89.153.91.164,<->,82.130.83.146,1,56,0,0,1,56,0.354092000,0.0000
142.249.254.162,<->,136.25.188.198,0,0,1,56,1,56,0.354067000,0.0000
215.158.239.99,<->,196.91.14.84,1,64,0,0,1,64,0.353947000,0.0000
76.187.234.228,<->,39.211.201.158,0,0,1,103,1,103,0.353932000,0.0000
128.156.80.162,<->,92.162.252.175,0,0,1,142,1,142,0.353842000,0.0000
215.158.239.95,<->,199.20.31.35,1,101,0,0,1,101,0.353836000,0.0000
247.136.162.79,<->,220.20.253.61,1,50,0,0,1,50,0.353391000,0.0000
231.141.56.107,<->,136.25.188.178,0,0,1,56,1,56,0.353276000,0.0000
50.136.22.165,<->,8.20.87.200,0,0,1,56,1,56,0.353071000,0.0000
207.173.5.199,<->,136.25.188.52,0,0,1,602,1,602,0.352965000,0.0000
197.113.99.250,<->,136.25.188.199,0,0,1,64,1,64,0.352940000,0.0000
131.144.248.40,<->,129.224.112.252,0,0,1,77,1,77,0.352585000,0.0000
132.149.113.27,<->,68.206.114.172,1,130,0,0,1,130,0.352408000,0.0000
105.170.125.212,<->,98.128.84.189,0,0,1,906,1,906,0.352339000,0.0000
213.186.52.89,<->,98.236.235.234,0,0,1,56,1,56,0.352149000,0.0000
235.228.110.72,<->,139.163.26.146,0,0,1,99,1,99,0.352106000,0.0000
215.158.239.51,<->,196.0.95.122,1,50,0,0,1,50,0.351984000,0.0000
123.189.238.244,<->,80.42.146.105,0,0,1,56,1,56,0.351926000,0.0000
144.75.218.233,<->,129.165.131.13,1,189,0,0,1,189,0.351783000,0.0000
144.75.218.237,<->,137.23.166.213,1,279,0,0,1,279,0.351745000,0.0000
247.136.200.213,<->,120.146.111.188,1,319,0,0,1,319,0.351721000,0.0000
210.208.231.236,<->,102.51.41.219,0,0,1,108,1,108,0.351716000,0.0000
199.108.208.102,<->,92.27.219.182,0,0,1,1455,1,1455,0.351591000,0.0000
144.75.218.246,<->,129.127.53.251,1,141,0,0,1,141,0.351468000,0.0000
247.136.161.17,<->,82.106.63.160,1,52,0,0,1,52,0.351404000,0.0000
98.8.84.242,<->,34.93.69.102,0,0,1,134,1,134,0.351028000,0.0000
197.145.200.52,<->,39.63.202.173,0,0,1,64,1,64,0.350928000,0.0000
112.12.176.125,<->,50.224.76.234,0,0,1,50,1,50,0.350854000,0.0000
130.1.23.14,<->,80.38.16.211,0,0,1,50,1,50,0.350533000,0.0000
198.14.7.174,<->,39.140.36.23,0,0,1,104,1,104,0.350172000,0.0000
114.206.151.246,<->,89.183.104.245,0,0,1,52,1,52,0.350037000,0.0000
231.255.191.45,<->,80.40.46.139,0,0,1,376,1,376,0.350011000,0.0000
215.158.2.46,<->,159.123.32.28,0,0,1,88,1,88,0.349590000,0.0000
195.5.113.108,<->,136.25.188.252,0,0,1,50,1,50,0.349454000,0.0000
198.70.237.101,<->,92.27.219.46,0,0,1,52,1,52,0.349445000,0.0000
17.140.208.104,<->,8.220.190.86,0,0,1,50,1,50,0.349177000,0.0000
192.171.13.189,<->,8.252.222.11,0,0,1,143,1,143,0.349068000,0.0000
29.95.158.240,<->,20.199.198.213,0,0,1,64,1,64,0.348721000,0.0000
215.158.239.84,<->,199.20.29.148,1,76,0,0,1,76,0.348668000,0.0000
215.158.140.163,<->,126.219.102.124,1,106,0,0,1,106,0.348171000,0.0000
142.249.254.162,<->,136.25.188.241,0,0,1,56,1,56,0.348124000,0.0000
202.218.167.205,<->,34.121.158.24,0,0,1,106,1,106,0.347687000,0.0000
136.25.188.74,<->,111.151.142.169,1,56,0,0,1,56,0.347673000,0.0000
58.202.16.67,<->,34.9.89.117,0,0,1,52,1,52,0.347519000,0.0000
58.132.245.34,<->,20.182.55.13,0,0,1,52,1,52,0.347222000,0.0000
108.39.242.156,<->,65.26.119.133,1,60,0,0,1,60,0.347176000,0.0000
244.50.249.107,<->,20.86.106.227,0,0,1,50,1,50,0.347121000,0.0000
132.159.118.94,<->,100.230.144.109,1,79,0,0,1,79,0.347022000,0.0000
207.167.195.47,<->,39.149.0.141,0,0,1,102,1,102,0.346588000,0.0000
159.154.230.134,<->,67.103.130.54,1,130,0,0,1,130,0.346265000,0.0000
241.231.183.50,<->,141.92.221.24,1,87,0,0,1,87,0.346219000,0.0000
207.36.127.222,<->,39.154.44.30,0,0,1,60,1,60,0.346175000,0.0000
114.253.132.49,<->,80.40.25.242,0,0,1,61,1,61,0.346037000,0.0000
198.158.197.83,<->,20.200.148.149,0,0,1,50,1,50,0.345821000,0.0000
201.216.164.96,<->,39.2.106.226,0,0,1,64,1,64,0.345706000,0.0000
199.33.16.185,<->,136.25.188.236,0,0,1,68,1,68,0.345547000,0.0000
133.178.227.229,<->,100.224.243.90,1,289,0,0,1,289,0.345546000,0.0000
246.253.248.211,<->,216.184.0.236,1,79,0,0,1,79,0.345421000,0.0000
215.158.140.79,<->,80.56.91.248,1,56,0,0,1,56,0.345371000,0.0000
247.136.222.27,<->,8.150.21.141,1,56,0,0,1,56,0.345100000,0.0000
215.158.140.162,<->,139.69.162.109,1,1004,0,0,1,1004,0.344908000,0.0000
195.215.196.158,<->,92.27.194.147,0,0,1,56,1,56,0.344704000,0.0000
21.15.226.126,<->,20.193.51.231,0,0,1,82,1,82,0.344345000,0.0000
207.239.218.24,<->,136.25.188.220,0,0,1,56,1,56,0.344114000,0.0000
144.75.218.233,<->,138.127.230.49,1,263,0,0,1,263,0.344100000,0.0000
227.229.200.72,<->,39.141.146.133,0,0,1,100,1,100,0.344037000,0.0000
155.179.221.28,<->,8.220.189.249,0,0,1,50,1,50,0.343565000,0.0000
158.14.116.39,<->,50.224.89.237,0,0,1,79,1,79,0.343383000,0.0000
215.158.239.56,<->,199.20.31.9,1,781,0,0,1,781,0.343357000,0.0000
159.209.217.88,<->,145.19.9.13,0,0,1,88,1,88,0.343062000,0.0000
203.215.167.135,<->,142.172.153.106,1,64,0,0,1,64,0.342577000,0.0000
117.233.77.145,<->,92.27.219.239,0,0,1,52,1,52,0.342135000,0.0000
244.50.129.64,<->,39.26.182.30,0,0,1,50,1,50,0.342055000,0.0000
149.50.109.18,<->,20.138.181.255,0,0,1,75,1,75,0.342018000,0.0000
103.18.240.78,<->,80.40.50.197,0,0,1,52,1,52,0.341754000,0.0000
246.253.157.15,<->,32.216.133.32,1,50,0,0,1,50,0.341388000,0.0000
104.34.67.250,<->,92.27.219.194,0,0,1,135,1,135,0.340789000,0.0000
231.143.96.2,<->,136.25.188.177,0,0,1,68,1,68,0.340594000,0.0000
139.193.141.139,<->,33.240.118.27,1,50,0,0,1,50,0.340500000,0.0000
230.95.236.34,<->,89.181.189.56,0,0,1,130,1,130,0.340420000,0.0000
194.237.35.120,<->,136.25.188.252,0,0,1,50,1,50,0.340256000,0.0000
231.140.157.228,<->,136.25.188.226,0,0,1,56,1,56,0.339904000,0.0000
158.3.202.66,<->,39.8.88.74,0,0,1,78,1,78,0.339838000,0.0000
215.158.239.102,<->,215.158.61.203,1,1392,0,0,1,1392,0.339826000,0.0000
158.189.117.8,<->,39.147.186.199,0,0,1,64,1,64,0.339700000,0.0000
158.226.109.18,<->,20.20.200.106,0,0,1,80,1,80,0.339634000,0.0000
244.50.136.175,<->,20.145.229.139,0,0,1,50,1,50,0.339622000,0.0000
144.75.218.241,<->,137.132.222.177,1,110,0,0,1,110,0.339607000,0.0000
123.125.71.216,<->,100.94.190.20,0,0,1,52,1,52,0.339283000,0.0000
121.19.179.105,<->,20.220.93.92,0,0,1,64,1,64,0.339017000,0.0000
118.234.22.105,<->,89.183.104.141,0,0,1,52,1,52,0.338882000,0.0000
74.142.196.45,<->,8.252.221.236,0,0,1,56,1,56,0.338827000,0.0000
121.60.236.104,<->,92.27.27.164,0,0,1,349,1,349,0.338704000,0.0000
124.29.255.45,<->,20.253.243.222,0,0,1,64,1,64,0.338492000,0.0000
145.229.2.58,<->,138.68.168.244,0,0,1,347,1,347,0.338305000,0.0000
192.171.13.189,<->,136.25.188.217,0,0,1,138,1,138,0.338282000,0.0000
221.102.143.189,<->,220.81.54.34,0,0,1,141,1,141,0.338082000,0.0000
142.221.194.104,<->,92.27.27.156,0,0,1,351,1,351,0.338056000,0.0000
125.161.104.51,<->,92.27.219.242,0,0,1,52,1,52,0.337962000,0.0000
207.173.34.35,<->,136.25.188.55,0,0,1,901,1,901,0.337866000,0.0000
136.25.189.47,<->,124.172.20.249,1,1002,0,0,1,1002,0.337861000,0.0000
199.123.97.74,<->,136.25.188.198,0,0,1,56,1,56,0.337311000,0.0000
204.58.235.199,<->,136.25.188.163,0,0,1,56,1,56,0.336987000,0.0000
220.28.109.52,<->,136.25.188.213,0,0,1,56,1,56,0.336956000,0.0000
215.158.30.54,<->,29.211.214.254,0,0,1,87,1,87,0.336792000,0.0000
141.57.72.223,<->,111.147.221.24,0,0,1,60,1,60,0.336687000,0.0000
129.209.198.76,<->,8.182.226.78,0,0,1,56,1,56,0.336613000,0.0000
113.115.31.85,<->,20.231.10.197,0,0,1,64,1,64,0.336473000,0.0000
215.158.239.17,<->,92.5.174.3,1,50,0,0,1,50,0.336317000,0.0000
98.67.139.204,<->,8.198.182.253,1,84,0,0,1,84,0.336232000,0.0000
93.104.212.227,<->,39.246.79.106,0,0,1,64,1,64,0.336055000,0.0000
53.245.95.83,<->,48.54.247.249,0,0,1,64,1,64,0.335452000,0.0000
243.123.125.57,<->,92.162.253.11,0,0,1,1039,1,1039,0.335448000,0.0000
215.158.239.51,<->,199.20.5.43,1,765,0,0,1,765,0.335316000,0.0000
204.185.209.80,<->,136.25.188.176,0,0,1,50,1,50,0.335112000,0.0000
144.93.20.76,<->,98.67.154.32,0,0,1,56,1,56,0.335096000,0.0000
137.83.251.44,<->,112.17.31.45,1,50,0,0,1,50,0.335045000,0.0000
127.250.253.245,<->,97.126.26.71,0,0,1,82,1,82,0.334733000,0.0000
106.188.184.144,<->,8.220.203.35,0,0,1,704,1,704,0.334519000,0.0000
139.193.141.139,<->,38.0.18.12,1,50,0,0,1,50,0.334471000,0.0000
215.158.239.58,<->,195.55.135.23,1,56,0,0,1,56,0.334365000,0.0000
138.127.205.200,<->,109.222.240.214,0,0,1,50,1,50,0.333760000,0.0000
102.50.53.121,<->,33.250.186.2,1,107,0,0,1,107,0.333428000,0.0000
99.74.27.16,<->,8.251.27.197,1,704,0,0,1,704,0.333422000,0.0000
92.27.219.41,<->,92.27.131.123,1,56,0,0,1,56,0.333118000,0.0000
145.3.142.7,<->,39.237.228.248,0,0,1,64,1,64,0.332516000,0.0000
133.178.226.28,<->,111.151.73.197,1,56,0,0,1,56,0.332165000,0.0000
204.63.156.7,<->,136.25.188.177,0,0,1,50,1,50,0.331746000,0.0000
149.172.111.213,<->,109.222.192.25,0,0,1,166,1,166,0.331562000,0.0000
136.18.122.236,<->,8.182.136.221,0,0,1,50,1,50,0.331524000,0.0000
122.0.180.69,<->,80.41.41.240,0,0,1,135,1,135,0.331422000,0.0000
199.111.179.209,<->,8.182.250.65,0,0,1,50,1,50,0.331195000,0.0000
142.249.62.59,<->,136.25.188.242,0,0,1,50,1,50,0.330875000,0.0000
159.37.0.148,<->,145.116.119.173,0,0,1,56,1,56,0.330555000,0.0000
244.50.249.107,<->,20.158.127.21,0,0,1,50,1,50,0.330501000,0.0000
109.127.156.13,<->,8.220.178.166,0,0,1,50,1,50,0.330354000,0.0000
197.113.99.73,<->,136.25.188.54,0,0,1,68,1,68,0.330172000,0.0000
230.95.83.187,<->,192.64.91.148,0,0,1,133,1,133,0.329939000,0.0000
142.175.74.37,<->,100.95.46.59,0,0,1,56,1,56,0.329924000,0.0000
215.158.238.209,<->,146.171.130.231,1,56,0,0,1,56,0.329634000,0.0000
159.69.187.28,<->,144.108.80.174,1,63,0,0,1,63,0.329405000,0.0000
202.33.6.88,<->,136.25.188.220,0,0,1,50,1,50,0.329364000,0.0000
144.71.43.106,<->,4.154.120.226,1,50,0,0,1,50,0.329342000,0.0000
95.99.231.204,<->,0.195.210.44,0,0,1,56,1,56,0.328902000,0.0000
21.15.226.126,<->,20.193.51.183,0,0,1,82,1,82,0.328871000,0.0000
144.75.218.246,<->,102.45.225.190,1,74,0,0,1,74,0.328537000,0.0000
98.101.92.196,<->,8.182.253.233,0,0,1,50,1,50,0.328526000,0.0000
215.158.239.58,<->,196.74.44.173,1,68,0,0,1,68,0.328432000,0.0000
126.242.231.201,<->,20.204.244.231,0,0,1,64,1,64,0.328357000,0.0000
109.222.242.9,<->,76.75.85.195,1,133,0,0,1,133,0.328056000,0.0000
118.125.238.242,<->,99.75.217.171,0,0,1,76,1,76,0.327906000,0.0000
158.186.230.206,<->,136.181.50.197,0,0,1,169,1,169,0.327896000,0.0000
35.37.172.67,<->,8.220.205.146,0,0,1,50,1,50,0.327704000,0.0000
207.61.161.66,<->,136.25.188.241,0,0,1,50,1,50,0.327701000,0.0000
120.117.98.110,<->,39.171.195.90,0,0,1,60,1,60,0.327369000,0.0000
200.175.139.33,<->,53.201.234.140,1,56,0,0,1,56,0.327144000,0.0000
148.228.29.190,<->,50.224.76.248,0,0,1,56,1,56,0.327119000,0.0000
133.178.226.161,<->,113.92.168.222,1,90,0,0,1,90,0.326954000,0.0000
247.136.209.19,<->,135.254.181.19,1,56,0,0,1,56,0.326919000,0.0000
98.150.107.161,<->,97.126.24.188,0,0,1,50,1,50,0.326855000,0.0000
246.253.253.169,<->,139.33.174.13,1,50,0,0,1,50,0.326788000,0.0000
192.64.211.1,<->,119.226.132.122,1,56,0,0,1,56,0.326779000,0.0000
144.69.82.139,<->,129.19.247.27,1,65,0,0,1,65,0.326498000,0.0000
133.178.227.11,<->,111.151.109.27,1,56,0,0,1,56,0.326181000,0.0000
139.81.1.42,<->,8.220.179.238,0,0,1,50,1,50,0.325925000,0.0000
192.67.152.0,<->,125.5.241.52,1,52,0,0,1,52,0.325874000,0.0000
109.222.253.150,<->,39.247.154.221,1,74,0,0,1,74,0.325799000,0.0000
216.184.2.174,<->,6.73.247.20,0,0,1,381,1,381,0.325557000,0.0000
204.185.19.166,<->,136.25.188.174,0,0,1,68,1,68,0.325208000,0.0000
210.220.219.151,<->,91.41.67.73,1,56,0,0,1,56,0.325041000,0.0000
197.113.99.120,<->,136.25.188.177,0,0,1,632,1,632,0.324966000,0.0000
54.59.75.111,<->,48.55.128.174,0,0,1,1068,1,1068,0.324807000,0.0000
116.94.248.161,<->,109.222.246.241,0,0,1,76,1,76,0.324744000,0.0000
113.176.55.114,<->,80.41.27.166,0,0,1,56,1,56,0.324517000,0.0000
192.67.159.167,<->,118.51.58.214,1,138,0,0,1,138,0.324384000,0.0000
192.67.133.6,<->,134.103.233.204,1,135,0,0,1,135,0.323937000,0.0000
204.187.173.185,<->,136.25.188.198,0,0,1,56,1,56,0.323851000,0.0000
207.190.208.207,<->,136.25.188.225,0,0,1,56,1,56,0.323659000,0.0000
144.83.60.153,<->,92.162.253.111,0,0,1,50,1,50,0.323541000,0.0000
204.124.112.85,<->,92.27.194.147,0,0,1,56,1,56,0.323435000,0.0000
89.183.104.175,<->,27.41.82.122,1,1431,0,0,1,1431,0.322820000,0.0000
122.147.77.52,<->,20.134.242.55,0,0,1,64,1,64,0.322802000,0.0000
113.115.31.85,<->,20.231.10.202,0,0,1,64,1,64,0.322547000,0.0000
215.201.146.84,<->,8.182.136.57,0,0,1,50,1,50,0.322532000,0.0000
204.186.234.226,<->,136.25.188.222,0,0,1,56,1,56,0.322426000,0.0000
212.118.51.50,<->,8.52.132.185,0,0,1,50,1,50,0.322302000,0.0000
53.161.180.137,<->,48.53.29.239,0,0,1,50,1,50,0.322201000,0.0000
92.27.219.216,<->,42.204.6.217,1,309,0,0,1,309,0.321920000,0.0000
93.181.154.75,<->,92.27.219.16,0,0,1,51,1,51,0.321673000,0.0000
215.158.103.219,<->,138.127.224.207,1,299,0,0,1,299,0.321315000,0.0000
241.193.172.231,<->,20.222.127.217,0,0,1,50,1,50,0.321125000,0.0000
8.182.245.10,<->,6.20.17.204,1,50,0,0,1,50,0.320954000,0.0000
111.151.107.194,<->,8.176.8.218,0,0,1,56,1,56,0.320626000,0.0000
121.210.44.10,<->,92.27.219.38,0,0,1,52,1,52,0.320621000,0.0000
105.78.55.110,<->,20.83.50.158,0,0,1,64,1,64,0.320554000,0.0000
194.105.236.217,<->,129.224.112.252,0,0,1,82,1,82,0.320210000,0.0000
75.62.16.8,<->,20.63.119.248,0,0,1,50,1,50,0.318596000,0.0000
148.127.114.12,<->,92.27.219.50,0,0,1,52,1,52,0.318546000,0.0000
247.136.138.97,<->,104.230.130.153,1,97,0,0,1,97,0.318279000,0.0000
207.74.66.179,<->,20.130.242.39,0,0,1,66,1,66,0.318268000,0.0000
215.158.239.78,<->,204.1.141.231,1,84,0,0,1,84,0.318165000,0.0000
74.235.239.33,<->,39.252.18.244,0,0,1,72,1,72,0.318046000,0.0000
122.222.66.154,<->,39.174.200.95,0,0,1,60,1,60,0.318025000,0.0000
124.29.255.45,<->,20.253.243.237,0,0,1,64,1,64,0.317630000,0.0000
144.75.218.242,<->,138.127.230.139,1,366,0,0,1,366,0.317596000,0.0000
192.64.217.166,<->,127.15.227.181,1,135,0,0,1,135,0.317561000,0.0000
215.158.140.170,<->,97.4.116.236,1,103,0,0,1,103,0.317296000,0.0000
159.140.232.210,<->,102.83.34.23,0,0,1,50,1,50,0.317202000,0.0000
89.155.31.88,<->,8.182.226.78,0,0,1,50,1,50,0.317128000,0.0000
215.158.140.173,<->,41.158.30.215,1,50,0,0,1,50,0.316990000,0.0000
54.37.1.37,<->,48.53.6.121,0,0,1,56,1,56,0.316542000,0.0000
196.253.174.217,<->,8.52.225.26,0,0,1,50,1,50,0.316461000,0.0000
17.201.221.178,<->,8.220.200.124,0,0,1,50,1,50,0.316432000,0.0000
195.68.97.235,<->,136.25.188.252,0,0,1,781,1,781,0.315670000,0.0000
104.9.192.113,<->,92.27.219.148,0,0,1,130,1,130,0.315434000,0.0000
204.139.150.193,<->,20.16.101.141,0,0,1,64,1,64,0.315350000,0.0000
139.163.92.210,<->,65.212.33.33,1,78,0,0,1,78,0.315181000,0.0000
120.20.32.118,<->,39.46.76.159,0,0,1,52,1,52,0.314970000,0.0000
215.158.209.184,<->,215.158.140.170,0,0,1,106,1,106,0.314461000,0.0000
111.151.142.130,<->,8.252.221.181,0,0,1,56,1,56,0.314166000,0.0000
204.200.53.246,<->,136.25.188.220,0,0,1,132,1,132,0.313861000,0.0000
98.246.18.142,<->,20.189.246.56,0,0,1,50,1,50,0.313846000,0.0000
196.27.47.139,<->,102.51.189.104,0,0,1,262,1,262,0.313774000,0.0000
197.147.176.170,<->,8.20.87.153,0,0,1,50,1,50,0.313523000,0.0000
199.103.106.195,<->,20.159.38.152,0,0,1,52,1,52,0.313510000,0.0000
97.40.49.218,<->,8.250.150.39,0,0,1,50,1,50,0.313447000,0.0000
104.67.149.22,<->,39.9.119.23,0,0,1,205,1,205,0.313365000,0.0000
98.129.80.71,<->,59.33.166.136,1,138,0,0,1,138,0.313273000,0.0000
112.79.207.61,<->,89.183.104.138,0,0,1,149,1,149,0.313230000,0.0000
204.187.163.107,<->,136.25.188.243,0,0,1,282,1,282,0.312955000,0.0000
21.15.226.126,<->,20.193.51.161,0,0,1,82,1,82,0.312944000,0.0000
215.158.140.19,<->,111.150.207.173,1,100,0,0,1,100,0.312860000,0.0000
196.30.163.164,<->,97.126.110.99,0,0,1,64,1,64,0.312157000,0.0000
198.158.197.83,<->,20.92.41.241,0,0,1,50,1,50,0.311871000,0.0000
239.227.105.202,<->,8.49.69.216,1,382,0,0,1,382,0.311379000,0.0000
80.42.146.108,<->,33.58.164.61,1,174,0,0,1,174,0.311216000,0.0000
246.253.217.193,<->,194.220.184.3,1,50,0,0,1,50,0.311017000,0.0000
249.101.118.54,<->,100.206.91.27,1,197,0,0,1,197,0.310811000,0.0000
204.185.131.178,<->,136.25.188.209,0,0,1,56,1,56,0.310600000,0.0000
111.181.120.47,<->,8.20.81.121,1,56,0,0,1,56,0.310452000,0.0000
17.140.127.119,<->,8.220.190.86,0,0,1,50,1,50,0.310206000,0.0000
244.50.133.60,<->,39.23.21.209,0,0,1,50,1,50,0.310171000,0.0000
109.222.244.209,<->,75.92.184.28,1,105,0,0,1,105,0.310060000,0.0000
137.47.213.144,<->,8.220.178.166,0,0,1,50,1,50,0.310028000,0.0000
207.173.221.153,<->,136.25.188.52,0,0,1,93,1,93,0.309941000,0.0000
197.156.165.4,<->,39.213.127.191,0,0,1,68,1,68,0.309910000,0.0000
117.2.252.55,<->,92.27.219.250,0,0,1,321,1,321,0.309649000,0.0000
227.20.73.190,<->,119.33.40.184,1,50,0,0,1,50,0.309289000,0.0000
159.87.104.238,<->,129.121.121.12,1,72,0,0,1,72,0.309097000,0.0000
92.27.27.99,<->,29.219.16.87,1,293,0,0,1,293,0.308870000,0.0000
143.76.142.29,<->,8.182.226.78,0,0,1,50,1,50,0.308846000,0.0000
119.90.250.200,<->,20.243.83.2,0,0,1,50,1,50,0.308693000,0.0000
215.158.239.99,<->,196.92.105.96,1,56,0,0,1,56,0.308620000,0.0000
111.151.221.231,<->,97.126.31.65,0,0,1,1004,1,1004,0.308213000,0.0000
215.158.140.163,<->,29.211.93.14,1,105,0,0,1,105,0.308159000,0.0000
215.158.238.133,<->,56.23.171.247,1,1064,0,0,1,1064,0.308081000,0.0000
120.246.78.113,<->,20.248.109.40,0,0,1,64,1,64,0.307902000,0.0000
220.83.116.142,<->,97.4.116.46,1,50,0,0,1,50,0.307810000,0.0000
109.222.250.107,<->,95.221.85.194,1,877,0,0,1,877,0.307789000,0.0000
220.77.8.58,<->,20.177.253.150,0,0,1,64,1,64,0.307777000,0.0000
50.224.76.234,<->,30.179.236.114,1,56,0,0,1,56,0.307743000,0.0000
82.150.74.65,<->,20.194.30.147,0,0,1,52,1,52,0.307553000,0.0000
205.81.190.171,<->,111.146.169.0,0,0,1,138,1,138,0.307518000,0.0000
215.158.239.95,<->,199.20.31.102,1,101,0,0,1,101,0.307462000,0.0000
195.117.147.52,<->,39.60.111.77,0,0,1,104,1,104,0.307450000,0.0000
124.29.255.45,<->,20.253.243.226,0,0,1,64,1,64,0.307385000,0.0000
116.244.1.168,<->,20.82.95.229,0,0,1,65,1,65,0.307270000,0.0000
133.178.227.69,<->,6.73.247.37,1,72,0,0,1,72,0.307032000,0.0000
102.53.204.206,<->,92.27.219.190,0,0,1,52,1,52,0.306928000,0.0000
128.158.125.168,<->,8.43.214.50,0,0,1,84,1,84,0.306853000,0.0000
100.115.92.194,<->,41.143.115.31,1,56,0,0,1,56,0.306845000,0.0000
238.118.126.97,<->,91.51.57.236,1,50,0,0,1,50,0.306690000,0.0000
144.75.218.233,<->,136.99.66.245,1,174,0,0,1,174,0.306671000,0.0000
101.70.107.137,<->,6.44.81.76,1,66,0,0,1,66,0.306402000,0.0000
192.170.241.192,<->,99.74.27.4,0,0,1,56,1,56,0.306277000,0.0000
140.168.161.68,<->,92.27.27.182,0,0,1,99,1,99,0.306073000,0.0000
100.182.175.240,<->,91.231.209.86,1,64,0,0,1,64,0.305536000,0.0000
199.80.96.193,<->,50.224.76.235,0,0,1,50,1,50,0.305517000,0.0000
195.89.9.41,<->,8.182.241.177,0,0,1,50,1,50,0.305418000,0.0000
204.186.41.48,<->,136.25.188.52,0,0,1,56,1,56,0.305356000,0.0000
215.158.140.163,<->,113.24.0.152,1,134,0,0,1,134,0.305351000,0.0000
48.53.141.71,<->,6.170.6.133,1,56,0,0,1,56,0.305192000,0.0000
122.146.46.6,<->,20.184.105.90,0,0,1,52,1,52,0.305053000,0.0000
121.226.83.43,<->,39.2.99.62,0,0,1,64,1,64,0.304894000,0.0000
100.230.7.112,<->,92.162.252.191,0,0,1,50,1,50,0.304878000,0.0000
140.161.45.6,<->,133.178.227.2,0,0,1,56,1,56,0.304624000,0.0000
105.192.129.57,<->,98.67.140.11,0,0,1,97,1,97,0.304457000,0.0000
69.246.57.11,<->,34.216.36.20,0,0,1,60,1,60,0.304389000,0.0000
246.253.248.210,<->,131.230.134.171,1,86,0,0,1,86,0.304348000,0.0000
215.158.239.95,<->,199.33.27.32,1,56,0,0,1,56,0.304331000,0.0000
98.1.35.157,<->,8.220.186.82,0,0,1,50,1,50,0.304230000,0.0000
221.102.143.189,<->,98.128.110.36,0,0,1,141,1,141,0.304166000,0.0000
102.50.114.228,<->,33.78.90.64,1,50,0,0,1,50,0.304159000,0.0000
123.81.4.55,<->,20.152.1.45,0,0,1,52,1,52,0.304030000,0.0000
200.175.242.140,<->,53.244.236.0,1,56,0,0,1,56,0.304002000,0.0000
89.183.104.252,<->,48.107.168.216,1,52,0,0,1,52,0.303701000,0.0000
196.114.35.219,<->,20.56.131.162,0,0,1,72,1,72,0.303552000,0.0000
144.75.218.237,<->,138.127.225.249,1,265,0,0,1,265,0.303387000,0.0000
215.158.239.92,<->,199.20.31.115,1,68,0,0,1,68,0.303354000,0.0000
149.15.111.138,<->,20.28.157.87,0,0,1,76,1,76,0.303202000,0.0000
244.50.129.64,<->,20.152.165.110,0,0,1,50,1,50,0.303083000,0.0000
215.158.238.154,<->,111.151.142.246,1,100,0,0,1,100,0.303032000,0.0000
132.18.67.31,<->,100.94.126.177,0,0,1,56,1,56,0.302702000,0.0000
106.168.190.66,<->,99.75.96.88,0,0,1,137,1,137,0.302594000,0.0000
213.38.198.143,<->,77.18.248.187,1,53,0,0,1,53,0.302486000,0.0000
136.99.182.241,<->,97.94.123.72,1,50,0,0,1,50,0.302439000,0.0000
196.148.133.194,<->,122.217.80.94,1,56,0,0,1,56,0.302312000,0.0000
121.213.147.139,<->,8.228.215.123,0,0,1,64,1,64,0.302195000,0.0000
142.253.160.117,<->,136.25.188.226,0,0,1,56,1,56,0.302158000,0.0000
144.75.218.241,<->,111.20.61.182,1,86,0,0,1,86,0.302051000,0.0000
193.46.99.193,<->,92.27.218.64,0,0,1,129,1,129,0.301821000,0.0000
194.106.193.254,<->,0.195.210.46,0,0,1,50,1,50,0.301641000,0.0000
215.158.239.92,<->,199.20.29.42,1,50,0,0,1,50,0.301592000,0.0000
215.158.239.97,<->,199.20.7.28,1,68,0,0,1,68,0.301216000,0.0000
202.33.106.20,<->,136.25.188.240,0,0,1,56,1,56,0.301207000,0.0000
115.249.71.20,<->,8.43.212.233,0,0,1,84,1,84,0.301173000,0.0000
237.56.23.121,<->,20.112.155.153,0,0,1,60,1,60,0.300773000,0.0000
113.141.30.72,<->,89.183.104.173,0,0,1,357,1,357,0.300656000,0.0000
159.87.104.238,<->,106.5.213.19,1,83,0,0,1,83,0.300631000,0.0000
215.158.239.95,<->,196.91.10.176,1,781,0,0,1,781,0.300510000,0.0000
140.91.112.221,<->,50.224.76.235,0,0,1,56,1,56,0.300416000,0.0000
199.69.225.36,<->,136.25.188.238,0,0,1,50,1,50,0.300182000,0.0000
136.181.53.193,<->,0.195.216.207,1,56,0,0,1,56,0.300154000,0.0000
197.2.207.32,<->,109.1.61.240,0,0,1,61,1,61,0.299777000,0.0000
203.116.242.247,<->,136.25.188.227,0,0,1,68,1,68,0.299531000,0.0000
246.253.34.209,<->,78.200.213.11,1,52,0,0,1,52,0.299425000,0.0000
192.64.217.166,<->,112.236.179.11,1,52,0,0,1,52,0.299345000,0.0000
111.237.175.187,<->,39.24.208.155,0,0,1,64,1,64,0.299333000,0.0000
192.229.219.28,<->,93.188.226.109,1,84,0,0,1,84,0.299090000,0.0000
195.5.55.82,<->,136.25.188.242,0,0,1,64,1,64,0.298492000,0.0000
197.113.99.46,<->,136.25.188.255,0,0,1,56,1,56,0.298313000,0.0000
215.158.239.50,<->,207.228.47.79,1,56,0,0,1,56,0.298143000,0.0000
92.27.219.48,<->,68.227.114.115,1,52,0,0,1,52,0.297930000,0.0000
200.174.197.247,<->,53.160.87.174,1,93,0,0,1,93,0.297924000,0.0000
109.1.4.138,<->,0.238.104.199,1,64,0,0,1,64,0.297577000,0.0000
60.93.108.205,<->,39.200.254.5,0,0,1,50,1,50,0.297539000,0.0000
194.253.238.252,<->,20.237.231.240,0,0,1,99,1,99,0.297515000,0.0000
200.174.208.0,<->,53.160.87.174,1,93,0,0,1,93,0.297331000,0.0000
129.224.112.252,<->,114.187.50.12,1,79,0,0,1,79,0.297256000,0.0000
199.51.153.252,<->,136.25.188.241,0,0,1,56,1,56,0.297168000,0.0000
144.75.218.235,<->,138.127.224.103,1,365,0,0,1,365,0.297148000,0.0000
195.13.140.158,<->,136.25.188.209,0,0,1,132,1,132,0.297082000,0.0000
122.245.179.149,<->,89.183.104.238,0,0,1,52,1,52,0.296929000,0.0000
193.89.192.220,<->,92.27.219.58,0,0,1,50,1,50,0.296564000,0.0000
21.15.226.126,<->,20.193.48.7,0,0,1,82,1,82,0.296265000,0.0000
192.242.182.171,<->,20.79.117.226,0,0,1,103,1,103,0.296142000,0.0000
221.102.143.189,<->,109.3.153.204,0,0,1,141,1,141,0.296001000,0.0000
207.190.55.12,<->,136.25.188.209,0,0,1,64,1,64,0.295976000,0.0000
159.228.165.136,<->,89.139.244.160,0,0,1,50,1,50,0.295872000,0.0000
220.82.24.255,<->,159.140.232.210,1,50,0,0,1,50,0.295840000,0.0000
192.64.193.89,<->,27.50.54.159,1,135,0,0,1,135,0.295686000,0.0000
117.156.100.40,<->,99.73.202.52,0,0,1,138,1,138,0.295681000,0.0000
246.253.253.5,<->,132.234.106.64,1,50,0,0,1,50,0.295663000,0.0000
215.158.238.205,<->,29.212.198.219,1,1002,0,0,1,1002,0.295276000,0.0000
202.236.234.97,<->,109.3.149.0,0,0,1,319,1,319,0.295269000,0.0000
39.5.166.84,<->,33.96.234.215,1,52,0,0,1,52,0.295151000,0.0000
109.1.17.76,<->,27.188.163.162,1,447,0,0,1,447,0.295121000,0.0000
249.101.117.55,<->,127.230.111.246,1,904,0,0,1,904,0.294683000,0.0000
246.253.248.210,<->,143.127.56.179,1,87,0,0,1,87,0.294641000,0.0000
235.237.188.148,<->,20.163.77.9,0,0,1,107,1,107,0.294075000,0.0000
118.116.183.59,<->,92.27.219.38,0,0,1,52,1,52,0.293081000,0.0000
206.228.176.15,<->,92.27.219.18,0,0,1,133,1,133,0.293021000,0.0000
138.48.80.166,<->,132.249.70.213,0,0,1,116,1,116,0.293013000,0.0000
53.68.218.171,<->,48.52.116.205,0,0,1,56,1,56,0.292903000,0.0000
159.23.226.94,<->,79.29.239.45,1,76,0,0,1,76,0.292517000,0.0000
197.107.246.174,<->,136.25.188.255,0,0,1,56,1,56,0.292497000,0.0000
124.29.255.45,<->,20.253.243.119,0,0,1,64,1,64,0.292484000,0.0000
215.158.140.163,<->,130.61.208.238,1,671,0,0,1,671,0.292411000,0.0000
8.45.168.98,<->,6.73.239.110,0,0,1,50,1,50,0.292354000,0.0000
92.27.219.49,<->,48.105.23.184,1,52,0,0,1,52,0.292061000,0.0000
136.25.188.163,<->,32.238.15.31,1,50,0,0,1,50,0.292039000,0.0000
133.178.226.87,<->,111.151.142.208,1,56,0,0,1,56,0.291885000,0.0000
121.66.179.101,<->,89.183.104.181,0,0,1,52,1,52,0.291736000,0.0000
207.64.72.141,<->,8.182.241.177,0,0,1,50,1,50,0.291620000,0.0000
21.15.226.126,<->,20.193.48.10,0,0,1,82,1,82,0.291503000,0.0000
193.46.99.163,<->,192.67.152.196,0,0,1,129,1,129,0.291475000,0.0000
200.174.207.72,<->,53.167.40.217,1,592,0,0,1,592,0.291364000,0.0000
144.87.235.187,<->,138.127.224.156,1,292,0,0,1,292,0.291103000,0.0000
220.20.253.61,<->,145.16.33.197,0,0,1,50,1,50,0.290978000,0.0000
53.148.168.215,<->,48.54.34.192,0,0,1,56,1,56,0.290719000,0.0000
253.107.165.0,<->,139.163.1.154,0,0,1,50,1,50,0.290702000,0.0000
215.158.239.49,<->,196.90.252.135,1,50,0,0,1,50,0.290648000,0.0000
126.198.149.124,<->,99.72.69.129,0,0,1,50,1,50,0.290409000,0.0000
138.31.199.102,<->,53.212.157.83,1,74,0,0,1,74,0.290337000,0.0000
127.255.88.114,<->,109.222.195.135,0,0,1,82,1,82,0.290331000,0.0000
54.37.31.141,<->,48.54.90.198,0,0,1,50,1,50,0.290010000,0.0000
122.215.15.158,<->,92.27.209.222,0,0,1,64,1,64,0.289766000,0.0000
204.63.228.133,<->,136.25.188.163,0,0,1,64,1,64,0.289091000,0.0000
215.158.239.0,<->,215.158.127.152,1,56,0,0,1,56,0.289043000,0.0000
134.18.234.58,<->,92.27.27.185,0,0,1,52,1,52,0.288407000,0.0000
136.25.188.105,<->,73.45.221.12,1,203,0,0,1,203,0.288284000,0.0000
111.147.102.130,<->,92.27.195.51,1,152,0,0,1,152,0.287932000,0.0000
246.253.253.12,<->,106.187.78.231,1,116,0,0,1,116,0.287867000,0.0000
215.158.103.219,<->,159.151.89.197,1,137,0,0,1,137,0.287851000,0.0000
120.174.149.7,<->,89.183.104.175,0,0,1,50,1,50,0.287786000,0.0000
215.158.102.78,<->,29.211.214.82,0,0,1,89,1,89,0.287784000,0.0000
21.15.226.126,<->,20.193.48.72,0,0,1,82,1,82,0.287704000,0.0000
215.158.239.85,<->,199.20.4.24,1,50,0,0,1,50,0.287362000,0.0000
207.20.199.56,<->,0.195.210.44,0,0,1,56,1,56,0.287321000,0.0000
152.111.180.244,<->,34.255.14.181,0,0,1,52,1,52,0.287079000,0.0000
241.193.172.231,<->,20.9.235.82,0,0,1,50,1,50,0.286950000,0.0000
218.4.163.23,<->,122.128.183.218,1,52,0,0,1,52,0.286739000,0.0000
198.158.197.83,<->,20.204.205.247,0,0,1,50,1,50,0.286351000,0.0000
120.111.59.192,<->,39.61.150.226,0,0,1,52,1,52,0.285439000,0.0000
143.129.218.243,<->,136.25.188.225,0,0,1,50,1,50,0.285417000,0.0000
145.128.111.98,<->,8.52.137.40,0,0,1,50,1,50,0.285336000,0.0000
127.107.198.222,<->,92.168.217.252,0,0,1,56,1,56,0.285150000,0.0000
241.193.172.231,<->,20.69.94.119,0,0,1,50,1,50,0.285102000,0.0000
197.145.200.52,<->,39.63.202.181,0,0,1,64,1,64,0.284920000,0.0000
215.158.239.56,<->,196.95.113.156,1,84,0,0,1,84,0.284768000,0.0000
210.220.219.150,<->,50.239.32.214,1,56,0,0,1,56,0.284708000,0.0000
195.120.218.250,<->,39.157.97.41,0,0,1,66,1,66,0.284638000,0.0000
147.132.245.136,<->,97.199.155.37,0,0,1,125,1,125,0.284625000,0.0000
143.104.30.210,<->,92.27.219.229,0,0,1,52,1,52,0.284603000,0.0000
203.142.62.61,<->,109.222.220.52,0,0,1,135,1,135,0.284461000,0.0000
215.158.140.167,<->,83.236.199.200,1,50,0,0,1,50,0.284456000,0.0000
129.78.112.176,<->,106.5.213.20,1,70,0,0,1,70,0.284435000,0.0000
20.249.126.47,<->,0.83.228.26,1,64,0,0,1,64,0.284379000,0.0000
204.2.16.105,<->,136.25.188.174,0,0,1,56,1,56,0.284106000,0.0000
215.158.239.48,<->,196.93.209.245,1,84,0,0,1,84,0.283835000,0.0000
195.7.102.197,<->,136.25.188.198,0,0,1,56,1,56,0.283709000,0.0000
111.147.172.190,<->,33.62.52.114,1,307,0,0,1,307,0.283585000,0.0000
98.246.18.142,<->,20.117.160.118,0,0,1,50,1,50,0.282987000,0.0000
122.239.148.163,<->,80.40.51.140,0,0,1,50,1,50,0.282641000,0.0000
199.82.173.18,<->,92.27.219.36,0,0,1,52,1,52,0.282628000,0.0000
142.236.13.135,<->,136.25.188.177,0,0,1,50,1,50,0.282360000,0.0000
113.127.207.90,<->,97.126.113.94,0,0,1,64,1,64,0.282307000,0.0000
21.15.226.126,<->,20.193.48.86,0,0,1,82,1,82,0.282121000,0.0000
79.52.255.177,<->,34.231.97.89,0,0,1,52,1,52,0.281983000,0.0000
119.90.250.200,<->,39.47.110.247,0,0,1,50,1,50,0.281636000,0.0000
207.160.220.252,<->,0.195.210.44,0,0,1,56,1,56,0.281432000,0.0000
142.228.133.133,<->,136.25.188.178,0,0,1,50,1,50,0.280977000,0.0000
136.25.188.105,<->,127.174.45.1,1,117,0,0,1,117,0.280970000,0.0000
143.53.34.2,<->,136.25.188.44,0,0,1,56,1,56,0.280677000,0.0000
121.242.143.12,<->,80.41.18.181,0,0,1,369,1,369,0.280596000,0.0000
80.42.159.249,<->,38.49.54.206,1,105,0,0,1,105,0.280577000,0.0000
215.158.239.223,<->,80.47.154.203,1,90,0,0,1,90,0.280557000,0.0000
143.72.44.200,<->,136.25.188.224,0,0,1,50,1,50,0.280490000,0.0000
129.92.117.123,<->,91.42.212.126,1,50,0,0,1,50,0.280458000,0.0000
144.75.218.241,<->,138.127.230.49,1,324,0,0,1,324,0.280455000,0.0000
143.76.152.237,<->,8.182.227.180,0,0,1,50,1,50,0.280259000,0.0000
97.85.151.132,<->,8.52.186.156,0,0,1,50,1,50,0.280074000,0.0000
92.27.219.163,<->,78.52.41.185,1,50,0,0,1,50,0.280031000,0.0000
100.182.99.11,<->,20.179.125.193,0,0,1,52,1,52,0.279964000,0.0000
197.68.57.83,<->,39.167.39.222,0,0,1,64,1,64,0.279681000,0.0000
134.9.11.151,<->,39.24.108.115,0,0,1,64,1,64,0.279376000,0.0000
20.249.126.46,<->,0.83.228.26,1,64,0,0,1,64,0.279328000,0.0000
111.151.239.56,<->,97.168.127.123,0,0,1,56,1,56,0.279266000,0.0000
212.247.11.10,<->,97.198.98.50,0,0,1,50,1,50,0.279094000,0.0000
192.64.196.68,<->,134.150.128.85,1,52,0,0,1,52,0.279018000,0.0000
144.75.218.235,<->,56.112.1.18,1,297,0,0,1,297,0.278981000,0.0000
196.88.35.234,<->,136.25.188.253,0,0,1,129,1,129,0.278771000,0.0000
247.136.216.15,<->,112.236.62.41,1,52,0,0,1,52,0.278695000,0.0000
89.183.104.150,<->,64.214.44.94,1,50,0,0,1,50,0.278671000,0.0000
252.189.162.82,<->,8.182.243.69,0,0,1,95,1,95,0.278642000,0.0000
101.70.107.210,<->,53.214.239.188,1,113,0,0,1,113,0.278536000,0.0000
128.156.85.188,<->,8.176.8.194,0,0,1,100,1,100,0.278394000,0.0000
92.27.219.253,<->,60.81.96.138,1,135,0,0,1,135,0.277827000,0.0000
132.18.67.31,<->,102.81.191.98,0,0,1,64,1,64,0.277798000,0.0000
119.90.251.239,<->,39.217.114.0,0,0,1,50,1,50,0.277439000,0.0000
93.221.9.89,<->,92.27.219.244,0,0,1,50,1,50,0.276840000,0.0000
247.136.199.176,<->,38.182.1.6,1,52,0,0,1,52,0.276811000,0.0000
54.59.177.47,<->,48.53.248.72,0,0,1,50,1,50,0.276720000,0.0000
144.75.218.237,<->,138.127.231.211,1,242,0,0,1,242,0.276389000,0.0000
92.27.219.250,<->,51.249.248.5,1,52,0,0,1,52,0.276360000,0.0000
141.179.51.33,<->,33.233.141.29,0,0,1,177,1,177,0.276313000,0.0000
141.232.245.107,<->,91.251.76.107,0,0,1,50,1,50,0.276278000,0.0000
133.178.226.163,<->,8.191.10.185,1,1064,0,0,1,1064,0.276109000,0.0000
196.206.252.226,<->,136.25.188.227,0,0,1,56,1,56,0.275957000,0.0000
113.200.181.126,<->,80.42.185.67,0,0,1,50,1,50,0.275928000,0.0000
144.75.218.235,<->,139.252.1.252,1,139,0,0,1,139,0.275806000,0.0000
111.151.106.219,<->,99.74.27.56,0,0,1,100,1,100,0.275731000,0.0000
195.89.103.138,<->,92.27.219.41,0,0,1,50,1,50,0.275661000,0.0000
215.158.238.162,<->,8.50.118.32,1,84,0,0,1,84,0.275571000,0.0000
17.58.250.175,<->,8.220.191.251,0,0,1,56,1,56,0.275480000,0.0000
241.193.172.231,<->,20.73.245.92,0,0,1,50,1,50,0.275423000,0.0000
207.201.108.10,<->,20.196.180.246,0,0,1,52,1,52,0.275308000,0.0000
120.179.18.5,<->,92.27.219.205,0,0,1,52,1,52,0.275240000,0.0000
215.158.103.219,<->,139.252.1.248,1,220,0,0,1,220,0.274970000,0.0000
92.27.27.148,<->,88.1.14.140,1,52,0,0,1,52,0.274815000,0.0000
199.5.96.222,<->,102.51.42.193,0,0,1,56,1,56,0.274566000,0.0000
144.75.218.233,<->,138.127.230.221,1,84,0,0,1,84,0.274533000,0.0000
131.144.248.59,<->,129.224.112.252,0,0,1,78,1,78,0.274415000,0.0000
113.127.207.90,<->,97.126.113.92,0,0,1,64,1,64,0.274315000,0.0000
109.222.220.112,<->,91.41.12.43,1,56,0,0,1,56,0.274313000,0.0000
210.221.110.77,<->,122.3.36.157,1,135,0,0,1,135,0.274164000,0.0000
50.137.5.129,<->,8.20.87.204,0,0,1,50,1,50,0.274131000,0.0000
204.159.249.166,<->,20.112.194.213,0,0,1,104,1,104,0.273912000,0.0000
215.158.239.68,<->,195.81.58.17,1,50,0,0,1,50,0.273775000,0.0000
198.157.56.197,<->,39.33.163.180,0,0,1,64,1,64,0.273637000,0.0000
215.158.140.187,<->,83.236.199.200,1,50,0,0,1,50,0.273570000,0.0000
215.158.238.16,<->,111.151.139.217,1,56,0,0,1,56,0.273229000,0.0000
247.136.220.238,<->,100.124.212.248,1,56,0,0,1,56,0.272959000,0.0000
29.154.35.223,<->,20.198.120.124,0,0,1,50,1,50,0.272895000,0.0000
8.252.221.204,<->,4.180.166.114,1,50,0,0,1,50,0.272878000,0.0000
206.226.123.198,<->,56.121.35.12,0,0,1,111,1,111,0.272728000,0.0000
215.158.239.58,<->,199.20.30.158,1,64,0,0,1,64,0.272398000,0.0000
220.20.253.61,<->,56.121.42.72,0,0,1,50,1,50,0.272369000,0.0000
90.240.135.74,<->,53.200.51.184,1,285,0,0,1,285,0.272350000,0.0000
198.157.56.197,<->,39.33.163.153,0,0,1,64,1,64,0.271783000,0.0000
207.14.190.163,<->,109.222.241.65,0,0,1,138,1,138,0.271219000,0.0000
142.252.71.0,<->,136.25.188.236,0,0,1,50,1,50,0.271042000,0.0000
144.29.3.6,<->,20.192.98.24,0,0,1,52,1,52,0.270848000,0.0000
119.33.88.137,<->,98.128.208.173,0,0,1,64,1,64,0.270814000,0.0000
124.152.145.65,<->,80.42.182.80,0,0,1,737,1,737,0.270651000,0.0000
111.146.160.51,<->,53.214.239.188,1,50,0,0,1,50,0.270437000,0.0000
39.203.251.62,<->,30.191.108.39,1,88,0,0,1,88,0.270279000,0.0000
204.183.168.70,<->,20.187.113.160,0,0,1,104,1,104,0.270218000,0.0000
136.25.188.29,<->,8.220.7.141,1,110,0,0,1,110,0.270171000,0.0000
133.178.226.234,<->,91.57.170.66,1,56,0,0,1,56,0.269920000,0.0000
142.228.86.78,<->,136.25.188.243,0,0,1,50,1,50,0.269833000,0.0000
247.136.162.66,<->,8.20.92.17,1,56,0,0,1,56,0.269604000,0.0000
215.158.239.84,<->,199.20.31.183,1,68,0,0,1,68,0.269214000,0.0000
192.64.225.129,<->,53.193.181.215,1,50,0,0,1,50,0.269186000,0.0000
220.55.64.223,<->,132.43.156.54,1,391,0,0,1,391,0.269060000,0.0000
144.75.218.233,<->,138.127.224.167,1,268,0,0,1,268,0.268830000,0.0000
247.136.136.4,<->,0.250.140.55,1,56,0,0,1,56,0.268819000,0.0000
104.233.32.3,<->,89.183.104.227,0,0,1,52,1,52,0.268562000,0.0000
196.89.53.235,<->,136.25.188.163,0,0,1,56,1,56,0.268368000,0.0000
109.146.97.102,<->,20.138.255.55,0,0,1,64,1,64,0.268226000,0.0000
76.184.54.224,<->,39.237.134.65,0,0,1,70,1,70,0.268217000,0.0000
100.182.99.11,<->,20.179.126.228,0,0,1,52,1,52,0.268070000,0.0000
109.222.241.33,<->,76.228.54.2,1,76,0,0,1,76,0.268059000,0.0000
144.148.84.204,<->,80.42.188.249,0,0,1,83,1,83,0.267998000,0.0000
204.189.138.123,<->,136.25.188.243,0,0,1,64,1,64,0.267619000,0.0000
156.164.9.225,<->,39.208.64.39,0,0,1,94,1,94,0.267609000,0.0000
92.27.159.67,<->,8.252.222.210,0,0,1,50,1,50,0.267345000,0.0000
215.158.239.84,<->,199.33.180.81,1,50,0,0,1,50,0.267293000,0.0000
132.18.67.28,<->,80.40.253.132,0,0,1,50,1,50,0.267270000,0.0000
137.137.75.72,<->,119.214.7.55,1,69,0,0,1,69,0.267242000,0.0000
211.11.4.252,<->,92.27.27.143,0,0,1,80,1,80,0.267170000,0.0000
207.198.136.208,<->,109.222.242.9,0,0,1,135,1,135,0.267106000,0.0000
199.100.254.150,<->,100.92.138.30,0,0,1,56,1,56,0.267096000,0.0000
149.50.187.76,<->,20.199.243.114,0,0,1,64,1,64,0.266869000,0.0000
199.53.132.195,<->,136.25.188.160,0,0,1,50,1,50,0.266797000,0.0000
207.162.175.160,<->,8.182.230.157,0,0,1,56,1,56,0.266750000,0.0000
43.55.206.244,<->,8.252.222.45,0,0,1,50,1,50,0.266702000,0.0000
50.224.76.235,<->,17.25.64.204,1,56,0,0,1,56,0.266671000,0.0000
144.95.111.109,<->,111.147.112.131,0,0,1,50,1,50,0.266637000,0.0000
199.53.250.79,<->,136.25.188.177,0,0,1,50,1,50,0.266360000,0.0000
92.27.219.208,<->,35.33.19.191,1,78,0,0,1,78,0.266231000,0.0000
220.20.200.123,<->,111.1.250.57,1,50,0,0,1,50,0.266204000,0.0000
198.158.197.83,<->,20.173.150.188,0,0,1,50,1,50,0.266178000,0.0000
144.70.164.222,<->,89.183.104.185,0,0,1,164,1,164,0.265969000,0.0000
17.140.223.133,<->,8.53.7.199,0,0,1,50,1,50,0.265904000,0.0000
204.139.150.193,<->,20.16.101.243,0,0,1,64,1,64,0.265844000,0.0000
136.250.74.155,<->,8.182.226.78,0,0,1,50,1,50,0.265710000,0.0000
215.158.66.194,<->,29.211.214.254,0,0,1,114,1,114,0.265537000,0.0000
54.59.43.180,<->,48.53.158.62,0,0,1,52,1,52,0.265521000,0.0000
112.44.56.227,<->,20.165.246.40,0,0,1,68,1,68,0.265479000,0.0000
132.249.71.227,<->,132.249.70.154,0,0,1,283,1,283,0.265427000,0.0000
144.76.44.59,<->,100.93.133.50,0,0,1,85,1,85,0.265372000,0.0000
159.69.187.13,<->,144.108.80.170,1,69,0,0,1,69,0.265322000,0.0000
215.158.239.97,<->,199.20.30.247,1,56,0,0,1,56,0.265198000,0.0000
215.158.239.51,<->,199.20.31.107,1,68,0,0,1,68,0.265123000,0.0000
241.193.172.231,<->,20.205.224.18,0,0,1,50,1,50,0.265011000,0.0000
109.1.16.46,<->,53.69.90.226,1,125,0,0,1,125,0.264730000,0.0000
221.102.143.189,<->,100.94.107.238,0,0,1,92,1,92,0.264063000,0.0000
204.139.150.193,<->,20.16.101.241,0,0,1,64,1,64,0.263900000,0.0000
61.87.95.241,<->,39.254.135.162,0,0,1,52,1,52,0.263594000,0.0000
215.158.239.48,<->,196.93.253.247,1,50,0,0,1,50,0.263284000,0.0000
8.49.69.216,<->,6.75.206.27,0,0,1,56,1,56,0.263262000,0.0000
220.20.200.178,<->,144.83.60.153,1,1102,0,0,1,1102,0.262885000,0.0000
120.167.217.164,<->,92.27.219.214,0,0,1,52,1,52,0.262750000,0.0000
215.158.239.57,<->,204.0.204.92,1,50,0,0,1,50,0.262568000,0.0000
123.97.133.82,<->,20.227.243.121,0,0,1,68,1,68,0.262453000,0.0000
98.246.18.142,<->,20.44.42.152,0,0,1,50,1,50,0.262207000,0.0000
204.139.150.193,<->,20.16.101.232,0,0,1,64,1,64,0.262095000,0.0000
192.64.210.19,<->,121.131.79.75,1,56,0,0,1,56,0.262066000,0.0000
233.97.214.62,<->,89.183.110.153,0,0,1,64,1,64,0.261578000,0.0000
199.81.171.183,<->,136.25.188.53,0,0,1,68,1,68,0.261272000,0.0000
122.158.179.118,<->,8.252.221.175,0,0,1,83,1,83,0.260607000,0.0000
215.158.238.205,<->,8.61.250.216,1,704,0,0,1,704,0.260401000,0.0000
144.232.222.1,<->,89.183.107.46,0,0,1,88,1,88,0.260119000,0.0000
104.226.195.200,<->,39.9.33.214,0,0,1,52,1,52,0.259681000,0.0000
215.158.239.195,<->,8.220.7.141,1,184,0,0,1,184,0.259493000,0.0000
99.72.141.223,<->,33.250.15.79,1,561,0,0,1,561,0.259460000,0.0000
144.70.196.25,<->,72.204.156.37,1,78,0,0,1,78,0.259399000,0.0000
215.158.239.50,<->,196.91.187.31,1,797,0,0,1,797,0.259309000,0.0000
193.51.220.212,<->,98.236.95.97,0,0,1,50,1,50,0.259214000,0.0000
249.95.65.178,<->,246.253.248.210,0,0,1,82,1,82,0.259137000,0.0000
196.90.190.173,<->,136.25.188.242,0,0,1,68,1,68,0.259018000,0.0000
75.62.16.8,<->,20.32.144.98,0,0,1,50,1,50,0.258970000,0.0000
247.136.199.131,<->,121.245.128.167,1,130,0,0,1,130,0.258647000,0.0000
127.223.55.31,<->,89.183.104.233,0,0,1,52,1,52,0.258646000,0.0000
145.242.126.150,<->,57.1.228.46,1,89,0,0,1,89,0.258350000,0.0000
200.175.80.143,<->,53.243.9.83,1,50,0,0,1,50,0.258245000,0.0000
97.200.239.122,<->,8.52.189.207,0,0,1,50,1,50,0.257954000,0.0000
196.115.29.51,<->,39.15.169.14,0,0,1,86,1,86,0.257831000,0.0000
139.193.141.143,<->,117.19.132.26,1,56,0,0,1,56,0.257707000,0.0000
215.158.239.79,<->,199.20.31.210,1,50,0,0,1,50,0.257466000,0.0000
92.27.219.57,<->,30.58.89.244,1,56,0,0,1,56,0.257207000,0.0000
139.193.141.139,<->,33.134.143.145,1,50,0,0,1,50,0.256693000,0.0000
69.246.49.151,<->,20.19.230.173,0,0,1,60,1,60,0.256574000,0.0000
215.158.239.48,<->,196.92.115.10,1,68,0,0,1,68,0.256406000,0.0000
92.27.219.247,<->,92.27.5.165,1,52,0,0,1,52,0.256330000,0.0000
127.200.190.122,<->,80.40.25.242,0,0,1,61,1,61,0.256257000,0.0000
199.28.91.46,<->,102.51.182.178,0,0,1,138,1,138,0.256253000,0.0000
221.102.143.189,<->,220.80.132.255,0,0,1,141,1,141,0.256227000,0.0000
215.158.238.238,<->,197.125.118.233,1,56,0,0,1,56,0.256189000,0.0000
255.133.229.164,<->,102.50.107.213,0,0,1,100,1,100,0.256054000,0.0000
145.16.119.27,<->,4.206.35.220,1,52,0,0,1,52,0.256025000,0.0000
111.20.171.168,<->,33.233.141.40,0,0,1,1203,1,1203,0.255809000,0.0000
192.67.167.86,<->,50.109.250.60,1,52,0,0,1,52,0.255583000,0.0000
132.200.51.119,<->,129.224.112.221,0,0,1,68,1,68,0.255422000,0.0000
77.16.86.124,<->,34.146.103.93,0,0,1,52,1,52,0.255265000,0.0000
246.44.63.17,<->,98.231.199.23,1,84,0,0,1,84,0.254859000,0.0000
122.106.32.33,<->,92.27.27.178,0,0,1,102,1,102,0.254786000,0.0000
213.155.76.174,<->,136.25.188.196,0,0,1,56,1,56,0.254709000,0.0000
80.41.19.144,<->,27.186.225.200,1,149,0,0,1,149,0.254396000,0.0000
21.15.226.126,<->,20.193.48.155,0,0,1,82,1,82,0.254287000,0.0000
104.70.4.13,<->,39.58.215.22,0,0,1,52,1,52,0.254267000,0.0000
129.224.112.252,<->,92.162.219.197,1,86,0,0,1,86,0.254041000,0.0000
243.117.125.58,<->,129.224.112.252,0,0,1,78,1,78,0.253974000,0.0000
207.191.159.27,<->,136.25.188.198,0,0,1,50,1,50,0.253785000,0.0000
57.145.136.234,<->,20.191.133.55,0,0,1,52,1,52,0.253717000,0.0000
144.76.43.238,<->,80.56.78.31,0,0,1,88,1,88,0.253596000,0.0000
205.167.137.144,<->,92.27.219.170,0,0,1,100,1,100,0.253562000,0.0000
207.190.129.97,<->,136.25.188.255,0,0,1,68,1,68,0.253473000,0.0000
144.50.95.66,<->,8.53.15.98,0,0,1,50,1,50,0.253154000,0.0000
193.79.76.252,<->,20.105.2.76,0,0,1,64,1,64,0.253149000,0.0000
107.3.232.230,<->,20.163.148.110,0,0,1,74,1,74,0.253057000,0.0000
215.158.238.105,<->,29.212.193.25,1,1357,0,0,1,1357,0.252971000,0.0000
156.165.37.109,<->,136.25.189.18,0,0,1,56,1,56,0.252883000,0.0000
143.23.168.28,<->,136.25.188.241,0,0,1,694,1,694,0.252867000,0.0000
116.228.36.60,<->,39.48.99.38,0,0,1,90,1,90,0.252839000,0.0000
144.69.82.139,<->,53.163.249.141,1,76,0,0,1,76,0.252831000,0.0000
121.167.230.8,<->,92.27.219.158,0,0,1,52,1,52,0.252734000,0.0000
249.162.92.179,<->,109.1.0.172,0,0,1,50,1,50,0.252728000,0.0000
57.148.17.77,<->,8.52.222.23,0,0,1,50,1,50,0.252713000,0.0000
92.27.219.164,<->,64.214.57.225,1,50,0,0,1,50,0.251874000,0.0000
121.194.65.68,<->,50.224.76.230,0,0,1,50,1,50,0.251822000,0.0000
199.38.167.77,<->,136.25.188.174,0,0,1,146,1,146,0.251762000,0.0000
142.43.184.230,<->,39.166.182.186,0,0,1,64,1,64,0.251352000,0.0000
198.157.56.197,<->,39.33.163.197,0,0,1,64,1,64,0.251244000,0.0000
192.67.149.88,<->,134.97.174.253,1,80,0,0,1,80,0.250921000,0.0000
129.229.242.60,<->,97.126.26.70,0,0,1,637,1,637,0.250590000,0.0000
156.164.246.134,<->,39.144.16.99,0,0,1,102,1,102,0.250588000,0.0000
128.156.85.146,<->,8.176.8.93,0,0,1,56,1,56,0.250558000,0.0000
204.185.62.11,<->,136.25.188.174,0,0,1,68,1,68,0.249875000,0.0000
230.16.29.181,<->,136.25.188.174,0,0,1,50,1,50,0.249581000,0.0000
113.184.255.140,<->,8.228.209.32,0,0,1,76,1,76,0.249462000,0.0000
241.193.172.231,<->,20.91.3.52,0,0,1,50,1,50,0.249242000,0.0000
247.136.152.186,<->,57.46.23.242,1,52,0,0,1,52,0.249199000,0.0000
131.229.28.177,<->,39.155.51.81,0,0,1,76,1,76,0.249177000,0.0000
244.50.249.107,<->,20.78.165.233,0,0,1,50,1,50,0.249122000,0.0000
247.136.216.228,<->,243.49.81.32,1,50,0,0,1,50,0.248809000,0.0000
111.151.106.235,<->,8.252.221.195,0,0,1,100,1,100,0.248532000,0.0000
207.7.109.45,<->,8.182.250.65,0,0,1,50,1,50,0.248254000,0.0000
241.193.172.231,<->,20.72.52.196,0,0,1,50,1,50,0.248242000,0.0000
227.56.190.69,<->,144.75.218.237,0,0,1,128,1,128,0.248117000,0.0000
89.183.104.139,<->,33.57.77.183,1,50,0,0,1,50,0.248085000,0.0000
141.54.113.244,<->,92.27.27.143,0,0,1,135,1,135,0.248029000,0.0000
29.91.33.217,<->,8.228.215.123,0,0,1,64,1,64,0.247507000,0.0000
204.125.111.48,<->,89.183.104.142,0,0,1,52,1,52,0.247502000,0.0000
133.178.226.43,<->,109.126.137.220,1,240,0,0,1,240,0.247463000,0.0000
159.162.16.96,<->,8.176.34.109,0,0,1,50,1,50,0.247196000,0.0000
215.158.239.49,<->,196.94.123.208,1,50,0,0,1,50,0.247189000,0.0000
145.110.55.59,<->,100.185.124.124,1,67,0,0,1,67,0.246910000,0.0000
215.158.140.205,<->,80.92.193.65,1,50,0,0,1,50,0.246761000,0.0000
247.136.240.215,<->,0.47.150.192,1,52,0,0,1,52,0.246309000,0.0000
205.37.92.12,<->,100.93.234.54,0,0,1,80,1,80,0.246218000,0.0000
215.158.239.50,<->,199.20.31.70,1,68,0,0,1,68,0.246097000,0.0000
206.232.36.243,<->,20.228.39.155,0,0,1,64,1,64,0.246005000,0.0000
126.95.96.109,<->,92.27.219.17,0,0,1,52,1,52,0.245941000,0.0000
215.158.103.219,<->,158.235.98.75,1,129,0,0,1,129,0.244999000,0.0000
195.15.42.227,<->,136.25.188.52,0,0,1,50,1,50,0.244922000,0.0000
144.85.170.254,<->,98.87.146.236,1,68,0,0,1,68,0.244616000,0.0000
142.191.80.57,<->,136.25.188.226,0,0,1,56,1,56,0.244590000,0.0000
76.72.228.64,<->,39.164.106.199,0,0,1,64,1,64,0.244511000,0.0000
144.75.218.235,<->,124.57.86.149,1,133,0,0,1,133,0.244495000,0.0000
124.159.72.74,<->,39.224.88.117,0,0,1,60,1,60,0.244411000,0.0000
92.27.27.167,<->,27.64.155.243,1,64,0,0,1,64,0.243863000,0.0000
156.159.3.122,<->,39.241.209.211,0,0,1,76,1,76,0.243741000,0.0000
246.254.97.229,<->,54.58.153.140,1,87,0,0,1,87,0.243659000,0.0000
21.15.226.126,<->,20.193.49.243,0,0,1,82,1,82,0.243638000,0.0000
144.75.218.233,<->,102.45.225.190,1,79,0,0,1,79,0.243311000,0.0000
215.158.239.76,<->,207.115.180.161,1,64,0,0,1,64,0.243176000,0.0000
245.244.33.12,<->,92.27.194.117,0,0,1,50,1,50,0.242731000,0.0000
144.227.67.90,<->,128.156.85.198,1,1004,0,0,1,1004,0.242603000,0.0000
215.158.239.205,<->,53.213.51.229,1,285,0,0,1,285,0.242563000,0.0000
111.151.142.200,<->,99.74.27.138,0,0,1,56,1,56,0.242535000,0.0000
215.158.239.58,<->,204.2.94.36,1,76,0,0,1,76,0.242328000,0.0000
241.193.172.231,<->,20.225.21.206,0,0,1,50,1,50,0.242254000,0.0000
241.193.172.231,<->,20.24.8.85,0,0,1,50,1,50,0.242176000,0.0000
106.213.68.182,<->,20.225.145.108,0,0,1,91,1,91,0.242156000,0.0000
17.140.208.104,<->,8.220.235.114,0,0,1,50,1,50,0.242090000,0.0000
249.101.200.44,<->,27.187.152.161,1,593,0,0,1,593,0.241726000,0.0000
142.43.184.230,<->,39.166.182.76,0,0,1,64,1,64,0.241619000,0.0000
198.157.56.197,<->,39.33.163.220,0,0,1,64,1,64,0.241512000,0.0000
145.10.90.235,<->,20.15.48.254,0,0,1,79,1,79,0.241397000,0.0000
113.127.207.90,<->,97.126.113.91,0,0,1,64,1,64,0.241393000,0.0000
215.158.238.244,<->,80.56.91.248,1,100,0,0,1,100,0.241338000,0.0000
132.18.67.26,<->,99.75.49.65,0,0,1,56,1,56,0.241114000,0.0000
215.158.239.58,<->,204.0.204.92,1,50,0,0,1,50,0.241104000,0.0000
97.126.117.77,<->,74.11.146.36,1,75,0,0,1,75,0.240998000,0.0000
254.242.186.223,<->,193.58.6.142,1,544,0,0,1,544,0.240907000,0.0000
57.176.114.210,<->,33.233.141.43,0,0,1,181,1,181,0.240460000,0.0000
215.158.239.87,<->,199.20.31.87,1,68,0,0,1,68,0.240225000,0.0000
207.78.145.120,<->,102.50.89.64,0,0,1,52,1,52,0.240215000,0.0000
133.244.30.133,<->,127.103.229.214,1,98,0,0,1,98,0.240110000,0.0000
132.43.156.54,<->,80.38.62.78,0,0,1,271,1,271,0.240032000,0.0000
133.178.227.70,<->,8.57.163.136,1,56,0,0,1,56,0.239828000,0.0000
192.67.158.69,<->,125.178.10.70,1,321,0,0,1,321,0.239765000,0.0000
230.114.137.29,<->,34.56.142.22,0,0,1,52,1,52,0.239657000,0.0000
221.102.121.97,<->,159.190.91.140,1,50,0,0,1,50,0.239565000,0.0000
198.157.56.197,<->,39.33.163.223,0,0,1,64,1,64,0.239544000,0.0000
198.157.56.197,<->,39.33.163.212,0,0,1,64,1,64,0.239461000,0.0000
92.27.219.159,<->,42.210.179.82,1,52,0,0,1,52,0.239430000,0.0000
241.193.172.231,<->,20.101.60.186,0,0,1,50,1,50,0.239292000,0.0000
114.233.163.117,<->,92.27.219.203,0,0,1,52,1,52,0.238871000,0.0000
134.186.43.5,<->,92.27.27.165,0,0,1,60,1,60,0.238825000,0.0000
215.158.239.56,<->,199.20.28.16,1,56,0,0,1,56,0.238825000,0.0000
138.127.230.2,<->,97.126.26.71,0,0,1,227,1,227,0.238725000,0.0000
124.29.255.45,<->,20.253.243.81,0,0,1,64,1,64,0.238519000,0.0000
215.158.140.240,<->,8.213.202.204,1,704,0,0,1,704,0.238334000,0.0000
98.209.164.107,<->,8.220.190.86,0,0,1,50,1,50,0.238233000,0.0000
98.67.136.52,<->,53.64.4.18,1,75,0,0,1,75,0.238067000,0.0000
158.94.211.91,<->,8.52.132.199,0,0,1,84,1,84,0.237680000,0.0000
200.174.28.57,<->,54.36.91.17,1,50,0,0,1,50,0.237488000,0.0000
148.122.200.44,<->,80.40.14.171,0,0,1,68,1,68,0.237108000,0.0000
17.96.223.98,<->,8.220.188.50,0,0,1,56,1,56,0.236609000,0.0000
111.151.142.208,<->,8.252.221.117,0,0,1,100,1,100,0.236587000,0.0000
98.209.164.107,<->,8.220.189.81,0,0,1,50,1,50,0.236171000,0.0000
59.43.254.143,<->,34.236.217.103,0,0,1,132,1,132,0.235917000,0.0000
215.158.239.35,<->,57.227.82.249,1,56,0,0,1,56,0.235820000,0.0000
93.104.212.227,<->,39.246.79.134,0,0,1,64,1,64,0.235565000,0.0000
195.14.141.149,<->,136.25.188.53,0,0,1,56,1,56,0.235467000,0.0000
197.156.2.4,<->,92.27.219.249,0,0,1,52,1,52,0.235401000,0.0000
21.15.226.126,<->,20.193.49.230,0,0,1,82,1,82,0.234819000,0.0000
144.75.218.246,<->,138.127.230.33,1,366,0,0,1,366,0.234797000,0.0000
109.222.214.24,<->,98.150.107.182,1,50,0,0,1,50,0.234741000,0.0000
198.157.56.197,<->,39.33.163.249,0,0,1,64,1,64,0.234676000,0.0000
204.60.37.181,<->,136.25.188.198,0,0,1,68,1,68,0.234674000,0.0000
203.39.11.231,<->,80.42.171.60,0,0,1,56,1,56,0.234416000,0.0000
210.229.230.21,<->,6.141.155.95,1,50,0,0,1,50,0.234170000,0.0000
192.67.167.86,<->,110.55.21.179,1,52,0,0,1,52,0.233806000,0.0000
251.24.86.229,<->,221.102.113.220,0,0,1,50,1,50,0.233587000,0.0000
215.158.239.69,<->,207.115.229.207,1,165,0,0,1,165,0.233345000,0.0000
132.249.70.213,<->,98.60.126.27,1,126,0,0,1,126,0.233165000,0.0000
215.158.140.172,<->,199.15.40.240,1,50,0,0,1,50,0.232653000,0.0000
105.83.153.163,<->,20.206.222.178,0,0,1,64,1,64,0.232441000,0.0000
144.75.218.237,<->,138.127.225.27,1,366,0,0,1,366,0.232183000,0.0000
248.225.29.34,<->,141.20.135.250,1,50,0,0,1,50,0.232174000,0.0000
143.76.13.151,<->,136.25.188.173,0,0,1,50,1,50,0.232153000,0.0000
119.214.81.185,<->,39.63.255.88,0,0,1,66,1,66,0.231836000,0.0000
215.158.239.78,<->,199.20.29.243,1,56,0,0,1,56,0.231684000,0.0000
80.40.48.126,<->,58.164.1.58,1,133,0,0,1,133,0.231672000,0.0000
123.86.101.51,<->,39.159.36.2,0,0,1,64,1,64,0.231399000,0.0000
205.185.251.148,<->,159.137.255.155,0,0,1,50,1,50,0.231087000,0.0000
109.222.252.84,<->,53.231.94.178,1,50,0,0,1,50,0.230614000,0.0000
241.193.172.231,<->,20.49.65.48,0,0,1,50,1,50,0.230517000,0.0000
204.200.58.55,<->,136.25.188.243,0,0,1,56,1,56,0.230472000,0.0000
137.109.175.154,<->,109.1.27.116,0,0,1,50,1,50,0.230442000,0.0000
133.208.38.103,<->,111.146.217.37,0,0,1,50,1,50,0.230429000,0.0000
192.64.223.86,<->,88.158.96.85,1,52,0,0,1,52,0.230403000,0.0000
144.75.218.246,<->,143.89.38.224,1,174,0,0,1,174,0.230353000,0.0000
120.20.16.198,<->,39.60.50.191,0,0,1,52,1,52,0.229930000,0.0000
120.241.123.129,<->,92.27.219.163,0,0,1,52,1,52,0.229909000,0.0000
112.40.30.109,<->,92.27.219.165,0,0,1,52,1,52,0.229809000,0.0000
192.229.213.201,<->,115.236.122.18,1,84,0,0,1,84,0.229740000,0.0000
207.162.143.3,<->,8.182.241.177,0,0,1,50,1,50,0.229710000,0.0000
207.172.238.145,<->,136.25.188.225,0,0,1,68,1,68,0.229541000,0.0000
215.158.239.58,<->,196.240.181.47,1,56,0,0,1,56,0.228959000,0.0000
244.50.133.60,<->,39.138.229.118,0,0,1,50,1,50,0.228934000,0.0000
65.67.142.90,<->,20.188.210.191,0,0,1,52,1,52,0.228801000,0.0000
139.163.26.146,<->,117.59.189.183,1,145,0,0,1,145,0.228796000,0.0000
21.15.226.126,<->,20.193.49.216,0,0,1,82,1,82,0.228489000,0.0000
107.97.115.181,<->,92.27.219.38,0,0,1,80,1,80,0.228386000,0.0000
195.61.230.12,<->,39.132.89.30,0,0,1,68,1,68,0.228254000,0.0000
144.85.169.211,<->,136.181.49.208,0,0,1,50,1,50,0.228254000,0.0000
252.138.239.5,<->,0.195.210.46,0,0,1,56,1,56,0.228112000,0.0000
253.107.167.228,<->,139.163.1.154,0,0,1,50,1,50,0.227930000,0.0000
215.158.239.84,<->,199.106.49.18,1,56,0,0,1,56,0.227665000,0.0000
215.158.239.239,<->,111.151.109.27,1,56,0,0,1,56,0.227569000,0.0000
112.204.192.86,<->,8.250.148.227,0,0,1,84,1,84,0.227093000,0.0000
215.158.140.111,<->,141.204.127.17,1,711,0,0,1,711,0.226989000,0.0000
91.234.186.164,<->,8.252.221.171,0,0,1,50,1,50,0.226858000,0.0000
215.158.239.198,<->,145.234.121.95,1,646,0,0,1,646,0.226840000,0.0000
195.42.107.156,<->,136.25.188.199,0,0,1,92,1,92,0.226761000,0.0000
42.204.17.198,<->,20.151.146.24,0,0,1,50,1,50,0.226660000,0.0000
159.123.17.187,<->,144.81.143.55,1,244,0,0,1,244,0.226190000,0.0000
132.249.70.233,<->,132.43.156.54,1,366,0,0,1,366,0.226137000,0.0000
109.222.204.142,<->,53.190.154.67,1,91,0,0,1,91,0.225967000,0.0000
194.227.216.124,<->,8.182.241.177,0,0,1,50,1,50,0.224764000,0.0000
203.215.167.143,<->,142.172.153.106,1,64,0,0,1,64,0.224646000,0.0000
215.158.238.69,<->,29.214.109.116,1,85,0,0,1,85,0.224611000,0.0000
116.180.1.221,<->,92.27.219.22,0,0,1,329,1,329,0.224552000,0.0000
248.225.26.140,<->,53.239.130.226,1,56,0,0,1,56,0.224488000,0.0000
221.102.114.234,<->,207.193.113.191,1,95,0,0,1,95,0.224343000,0.0000
54.38.83.190,<->,48.52.228.108,0,0,1,56,1,56,0.224268000,0.0000
132.10.25.52,<->,56.118.223.83,1,50,0,0,1,50,0.224251000,0.0000
92.27.219.218,<->,33.75.241.254,1,52,0,0,1,52,0.224168000,0.0000
141.204.127.17,<->,80.27.155.177,0,0,1,770,1,770,0.223590000,0.0000
215.158.239.56,<->,204.0.239.137,1,64,0,0,1,64,0.223300000,0.0000
113.127.207.90,<->,97.126.113.86,0,0,1,64,1,64,0.223236000,0.0000
136.25.189.7,<->,120.155.84.162,1,145,0,0,1,145,0.223191000,0.0000
247.136.192.215,<->,158.184.75.213,1,56,0,0,1,56,0.223178000,0.0000
92.27.219.29,<->,50.106.153.97,1,213,0,0,1,213,0.223164000,0.0000
158.225.226.228,<->,8.220.234.210,0,0,1,84,1,84,0.223149000,0.0000
75.139.109.73,<->,20.134.46.171,0,0,1,64,1,64,0.223133000,0.0000
128.32.74.204,<->,92.27.219.38,0,0,1,171,1,171,0.223096000,0.0000
144.122.240.209,<->,144.108.80.170,1,72,0,0,1,72,0.222928000,0.0000
215.158.239.56,<->,199.51.194.190,1,56,0,0,1,56,0.222692000,0.0000
215.158.238.163,<->,139.106.73.252,1,85,0,0,1,85,0.222626000,0.0000
109.222.253.179,<->,94.254.151.249,1,68,0,0,1,68,0.222560000,0.0000
139.241.116.90,<->,129.224.112.252,0,0,1,81,1,81,0.222491000,0.0000
224.250.64.84,<->,100.95.182.74,0,0,1,68,1,68,0.221969000,0.0000
111.147.114.15,<->,98.150.171.73,1,120,0,0,1,120,0.221689000,0.0000
40.196.135.202,<->,39.203.135.53,0,0,1,52,1,52,0.221663000,0.0000
104.42.81.60,<->,8.52.162.153,0,0,1,64,1,64,0.221662000,0.0000
135.76.10.106,<->,20.159.151.24,0,0,1,70,1,70,0.221536000,0.0000
207.60.149.29,<->,136.25.188.53,0,0,1,56,1,56,0.221419000,0.0000
230.74.143.176,<->,89.181.159.131,0,0,1,138,1,138,0.221354000,0.0000
241.193.166.2,<->,145.252.113.224,0,0,1,50,1,50,0.220930000,0.0000
121.202.110.68,<->,80.42.146.105,0,0,1,56,1,56,0.220831000,0.0000
142.236.13.135,<->,136.25.188.52,0,0,1,50,1,50,0.220639000,0.0000
97.126.113.186,<->,89.59.163.56,1,65,0,0,1,65,0.220605000,0.0000
204.62.188.213,<->,136.25.188.241,0,0,1,68,1,68,0.220524000,0.0000
98.236.87.190,<->,8.222.6.181,1,56,0,0,1,56,0.220446000,0.0000
216.248.130.197,<->,192.64.201.230,0,0,1,317,1,317,0.220165000,0.0000
109.222.242.9,<->,57.25.19.14,1,135,0,0,1,135,0.220139000,0.0000
131.46.106.108,<->,129.224.112.253,0,0,1,79,1,79,0.219990000,0.0000
133.8.10.152,<->,111.20.168.141,0,0,1,1130,1,1130,0.219712000,0.0000
247.136.226.75,<->,100.28.81.81,1,56,0,0,1,56,0.219551000,0.0000
120.155.87.66,<->,8.176.8.94,0,0,1,142,1,142,0.219534000,0.0000
109.49.93.23,<->,8.182.239.140,0,0,1,50,1,50,0.219418000,0.0000
145.16.88.13,<->,120.60.249.108,1,64,0,0,1,64,0.219355000,0.0000
215.158.239.68,<->,195.55.52.123,1,89,0,0,1,89,0.219096000,0.0000
143.76.185.21,<->,99.73.255.150,0,0,1,64,1,64,0.218942000,0.0000
215.158.239.49,<->,199.20.29.72,1,64,0,0,1,64,0.218837000,0.0000
144.75.218.242,<->,61.72.0.237,1,182,0,0,1,182,0.218309000,0.0000
144.76.46.38,<->,99.73.216.23,0,0,1,130,1,130,0.218086000,0.0000
111.2.156.133,<->,8.182.230.205,0,0,1,50,1,50,0.217938000,0.0000
215.158.103.206,<->,149.169.27.6,1,113,0,0,1,113,0.217717000,0.0000
138.127.227.231,<->,136.99.189.93,0,0,1,231,1,231,0.217218000,0.0000
145.242.126.212,<->,22.50.111.16,1,84,0,0,1,84,0.216935000,0.0000
197.126.179.66,<->,39.173.118.217,0,0,1,103,1,103,0.216607000,0.0000
112.122.80.33,<->,109.1.25.177,0,0,1,135,1,135,0.216385000,0.0000
142.190.177.119,<->,136.25.188.46,0,0,1,50,1,50,0.216128000,0.0000
194.233.63.160,<->,136.25.188.53,0,0,1,657,1,657,0.215728000,0.0000
142.229.27.148,<->,136.25.188.163,0,0,1,50,1,50,0.215417000,0.0000
57.189.25.121,<->,39.40.0.45,0,0,1,103,1,103,0.215188000,0.0000
205.225.112.16,<->,39.248.99.227,0,0,1,50,1,50,0.215173000,0.0000
89.183.104.151,<->,38.94.249.76,1,52,0,0,1,52,0.214780000,0.0000
198.158.197.83,<->,8.176.40.40,0,0,1,50,1,50,0.214372000,0.0000
247.136.199.131,<->,0.235.53.64,1,135,0,0,1,135,0.214295000,0.0000
199.72.31.82,<->,136.25.188.239,0,0,1,101,1,101,0.213766000,0.0000
118.122.93.165,<->,97.126.45.209,0,0,1,62,1,62,0.213752000,0.0000
97.126.116.12,<->,76.243.226.34,1,70,0,0,1,70,0.213643000,0.0000
149.99.43.199,<->,8.182.227.5,0,0,1,50,1,50,0.213639000,0.0000
117.228.237.160,<->,92.27.26.161,0,0,1,57,1,57,0.213576000,0.0000
198.252.57.150,<->,89.183.104.146,0,0,1,102,1,102,0.213563000,0.0000
144.75.218.235,<->,120.155.84.160,1,160,0,0,1,160,0.213522000,0.0000
215.158.238.223,<->,156.165.37.86,1,56,0,0,1,56,0.213472000,0.0000
233.97.214.110,<->,129.6.83.11,0,0,1,1165,1,1165,0.213285000,0.0000
204.153.249.251,<->,92.27.194.147,0,0,1,56,1,56,0.213142000,0.0000
68.65.48.62,<->,34.6.83.121,0,0,1,60,1,60,0.212681000,0.0000
220.20.200.6,<->,144.83.60.153,1,50,0,0,1,50,0.212582000,0.0000
142.248.31.11,<->,136.25.188.241,0,0,1,50,1,50,0.212568000,0.0000
123.108.229.120,<->,39.48.46.249,0,0,1,52,1,52,0.212421000,0.0000
194.237.119.120,<->,136.25.188.222,0,0,1,50,1,50,0.212387000,0.0000
17.41.129.194,<->,8.53.2.255,0,0,1,50,1,50,0.212089000,0.0000
204.154.205.160,<->,39.27.22.121,0,0,1,52,1,52,0.212087000,0.0000
79.126.130.209,<->,8.228.216.133,0,0,1,65,1,65,0.211964000,0.0000
200.174.195.110,<->,53.149.94.186,1,50,0,0,1,50,0.211532000,0.0000
99.162.77.146,<->,53.69.165.159,1,56,0,0,1,56,0.211503000,0.0000
244.50.249.107,<->,20.144.181.157,0,0,1,50,1,50,0.211320000,0.0000
126.23.139.115,<->,50.224.76.234,0,0,1,56,1,56,0.211251000,0.0000
159.69.187.44,<->,145.213.37.25,1,81,0,0,1,81,0.211130000,0.0000
129.208.50.133,<->,97.126.24.146,0,0,1,50,1,50,0.211112000,0.0000
196.112.116.141,<->,20.255.89.5,0,0,1,64,1,64,0.210908000,0.0000
124.119.25.10,<->,39.171.187.88,0,0,1,56,1,56,0.210717000,0.0000
142.115.117.86,<->,39.53.4.98,0,0,1,70,1,70,0.210590000,0.0000
144.69.82.139,<->,106.183.227.126,1,70,0,0,1,70,0.210359000,0.0000
104.242.12.102,<->,50.224.76.230,0,0,1,50,1,50,0.210109000,0.0000
199.73.176.126,<->,136.25.188.46,0,0,1,50,1,50,0.209993000,0.0000
42.128.41.242,<->,20.110.131.140,0,0,1,64,1,64,0.209692000,0.0000
247.136.139.26,<->,235.229.248.237,1,321,0,0,1,321,0.209634000,0.0000
125.155.198.194,<->,8.52.171.120,0,0,1,50,1,50,0.209552000,0.0000
204.95.210.109,<->,20.132.143.153,0,0,1,64,1,64,0.209337000,0.0000
207.61.159.147,<->,136.25.188.174,0,0,1,50,1,50,0.209234000,0.0000
21.15.226.126,<->,20.193.49.126,0,0,1,82,1,82,0.209226000,0.0000
159.69.187.81,<->,144.108.80.170,1,73,0,0,1,73,0.208875000,0.0000
207.76.252.185,<->,100.93.226.244,0,0,1,78,1,78,0.208817000,0.0000
196.247.197.35,<->,136.25.188.243,0,0,1,56,1,56,0.208591000,0.0000
193.29.109.175,<->,20.251.205.87,0,0,1,92,1,92,0.208552000,0.0000
142.223.114.231,<->,136.25.188.253,0,0,1,95,1,95,0.208322000,0.0000
209.91.231.36,<->,8.53.4.76,0,0,1,50,1,50,0.207872000,0.0000
142.43.184.230,<->,39.166.182.78,0,0,1,64,1,64,0.207721000,0.0000
144.232.206.81,<->,6.74.105.34,0,0,1,52,1,52,0.207431000,0.0000
144.95.111.109,<->,109.222.214.254,0,0,1,50,1,50,0.207412000,0.0000
202.33.250.128,<->,136.25.188.253,0,0,1,56,1,56,0.207089000,0.0000
101.70.119.178,<->,42.54.4.230,1,73,0,0,1,73,0.207016000,0.0000
104.232.96.226,<->,39.218.181.127,0,0,1,92,1,92,0.207004000,0.0000
104.143.24.112,<->,20.255.123.105,0,0,1,64,1,64,0.206995000,0.0000
18.129.95.200,<->,8.52.181.95,0,0,1,56,1,56,0.206629000,0.0000
53.244.237.146,<->,48.53.33.94,0,0,1,286,1,286,0.206612000,0.0000
130.101.149.241,<->,8.52.245.44,0,0,1,50,1,50,0.206585000,0.0000
218.4.183.100,<->,8.202.89.92,1,50,0,0,1,50,0.206213000,0.0000
215.158.239.176,<->,111.150.207.80,1,56,0,0,1,56,0.205995000,0.0000
92.27.27.186,<->,33.245.20.60,1,1396,0,0,1,1396,0.205931000,0.0000
53.148.133.218,<->,48.54.82.11,0,0,1,50,1,50,0.205910000,0.0000
121.189.158.110,<->,20.6.36.107,0,0,1,80,1,80,0.205704000,0.0000
199.51.131.171,<->,136.25.188.176,0,0,1,56,1,56,0.205492000,0.0000
215.158.239.56,<->,199.106.115.19,1,56,0,0,1,56,0.205377000,0.0000
203.114.119.98,<->,136.25.188.220,0,0,1,56,1,56,0.205006000,0.0000
202.33.254.225,<->,136.25.188.240,0,0,1,56,1,56,0.204741000,0.0000
195.42.222.251,<->,136.25.188.253,0,0,1,50,1,50,0.204659000,0.0000
192.67.174.38,<->,104.48.135.250,1,52,0,0,1,52,0.204570000,0.0000
139.163.26.146,<->,93.216.208.210,1,99,0,0,1,99,0.204155000,0.0000
101.70.119.178,<->,61.52.123.61,1,73,0,0,1,73,0.204058000,0.0000
246.253.248.211,<->,53.162.7.29,1,88,0,0,1,88,0.203862000,0.0000
99.175.215.250,<->,92.27.27.157,0,0,1,85,1,85,0.203306000,0.0000
195.6.143.23,<->,136.25.188.177,0,0,1,95,1,95,0.203289000,0.0000
133.178.227.69,<->,29.211.238.48,1,72,0,0,1,72,0.203239000,0.0000
143.53.64.213,<->,136.25.188.163,0,0,1,50,1,50,0.203216000,0.0000
98.217.78.34,<->,74.240.206.47,1,138,0,0,1,138,0.202958000,0.0000
210.229.230.22,<->,110.247.159.16,1,50,0,0,1,50,0.202675000,0.0000
8.182.245.110,<->,6.20.52.136,1,50,0,0,1,50,0.202447000,0.0000
136.181.43.0,<->,8.235.240.21,1,50,0,0,1,50,0.202421000,0.0000
130.196.241.40,<->,99.75.250.157,0,0,1,52,1,52,0.202301000,0.0000
20.13.113.158,<->,0.200.50.50,1,60,0,0,1,60,0.201700000,0.0000
131.45.239.182,<->,92.162.253.133,0,0,1,439,1,439,0.201489000,0.0000
129.221.194.218,<->,97.126.26.70,0,0,1,764,1,764,0.201359000,0.0000
158.91.200.210,<->,8.43.197.220,0,0,1,84,1,84,0.200989000,0.0000
254.120.20.98,<->,92.27.219.244,0,0,1,50,1,50,0.200905000,0.0000
248.239.173.39,<->,221.102.143.189,1,141,0,0,1,141,0.200839000,0.0000
142.182.55.51,<->,136.25.188.239,0,0,1,50,1,50,0.200374000,0.0000
8.222.7.155,<->,8.176.8.60,0,0,1,1064,1,1064,0.200346000,0.0000
21.15.226.126,<->,20.193.49.108,0,0,1,82,1,82,0.200333000,0.0000
158.157.46.189,<->,92.27.235.58,0,0,1,138,1,138,0.200309000,0.0000
213.186.59.207,<->,144.85.170.246,0,0,1,56,1,56,0.200258000,0.0000
144.75.218.235,<->,138.127.224.160,1,233,0,0,1,233,0.200115000,0.0000
159.69.187.47,<->,144.108.64.183,1,65,0,0,1,65,0.200071000,0.0000
38.99.196.125,<->,8.52.241.19,0,0,1,50,1,50,0.199945000,0.0000
101.169.164.225,<->,92.26.129.210,1,140,0,0,1,140,0.199852000,0.0000
139.7.138.92,<->,133.178.227.69,0,0,1,72,1,72,0.199811000,0.0000
229.45.205.2,<->,33.107.81.163,1,50,0,0,1,50,0.199781000,0.0000
247.136.188.124,<->,121.195.8.117,1,343,0,0,1,343,0.199667000,0.0000
199.82.200.8,<->,136.25.188.55,0,0,1,50,1,50,0.199554000,0.0000
136.25.189.16,<->,126.219.194.135,1,56,0,0,1,56,0.199266000,0.0000
139.163.26.146,<->,118.116.102.66,1,111,0,0,1,111,0.199038000,0.0000
204.182.162.77,<->,20.14.198.141,0,0,1,103,1,103,0.198867000,0.0000
21.15.226.126,<->,20.193.49.110,0,0,1,82,1,82,0.198817000,0.0000
118.207.145.100,<->,92.27.219.20,0,0,1,50,1,50,0.198665000,0.0000
50.224.76.248,<->,48.129.95.161,1,50,0,0,1,50,0.198616000,0.0000
95.77.81.114,<->,34.182.191.36,0,0,1,52,1,52,0.198569000,0.0000
100.95.176.77,<->,42.68.246.99,1,50,0,0,1,50,0.198491000,0.0000
215.158.239.92,<->,199.20.30.19,1,56,0,0,1,56,0.198409000,0.0000
98.101.71.51,<->,8.182.224.87,0,0,1,56,1,56,0.198396000,0.0000
156.148.228.171,<->,34.69.154.140,0,0,1,135,1,135,0.198211000,0.0000
215.158.239.68,<->,196.106.80.177,1,56,0,0,1,56,0.198210000,0.0000
80.27.96.139,<->,8.182.226.78,0,0,1,56,1,56,0.198120000,0.0000
119.131.30.232,<->,100.92.32.36,0,0,1,105,1,105,0.197951000,0.0000
110.252.124.98,<->,8.220.176.253,0,0,1,50,1,50,0.197932000,0.0000
199.38.63.196,<->,136.25.188.52,0,0,1,50,1,50,0.197466000,0.0000
89.85.232.190,<->,20.221.188.229,0,0,1,56,1,56,0.197461000,0.0000
207.60.9.84,<->,136.25.188.44,0,0,1,50,1,50,0.197228000,0.0000
97.94.229.155,<->,56.121.54.98,0,0,1,687,1,687,0.197194000,0.0000
196.112.116.141,<->,20.255.89.21,0,0,1,64,1,64,0.196613000,0.0000
203.215.144.37,<->,118.241.252.70,1,64,0,0,1,64,0.196469000,0.0000
192.64.225.61,<->,122.239.148.149,1,68,0,0,1,68,0.196463000,0.0000
144.75.218.241,<->,53.162.176.63,1,83,0,0,1,83,0.196033000,0.0000
119.204.151.2,<->,39.19.104.203,0,0,1,52,1,52,0.195775000,0.0000
159.69.187.23,<->,144.108.64.184,1,65,0,0,1,65,0.195385000,0.0000
133.135.214.174,<->,92.27.235.86,0,0,1,64,1,64,0.195259000,0.0000
144.83.60.153,<->,92.162.253.127,0,0,1,627,1,627,0.195254000,0.0000
215.158.239.84,<->,142.236.89.108,1,50,0,0,1,50,0.195166000,0.0000
215.158.239.245,<->,122.158.176.232,1,1112,0,0,1,1112,0.195089000,0.0000
215.158.239.96,<->,199.68.37.176,1,56,0,0,1,56,0.194547000,0.0000
109.1.39.166,<->,29.238.48.130,1,64,0,0,1,64,0.194463000,0.0000
159.81.1.22,<->,132.249.70.233,0,0,1,355,1,355,0.194290000,0.0000
199.72.194.71,<->,136.25.188.177,0,0,1,56,1,56,0.194285000,0.0000
142.255.230.39,<->,136.25.188.177,0,0,1,50,1,50,0.194162000,0.0000
139.163.0.106,<->,91.69.181.225,1,56,0,0,1,56,0.194105000,0.0000
192.64.196.68,<->,29.198.187.160,1,135,0,0,1,135,0.194076000,0.0000
204.136.193.126,<->,39.26.17.188,0,0,1,80,1,80,0.194019000,0.0000
204.158.156.69,<->,20.177.115.146,0,0,1,106,1,106,0.193943000,0.0000
142.248.204.144,<->,136.25.188.55,0,0,1,50,1,50,0.193908000,0.0000
133.178.226.255,<->,56.97.187.145,1,89,0,0,1,89,0.193677000,0.0000
124.86.160.236,<->,39.61.169.227,0,0,1,80,1,80,0.193560000,0.0000
229.45.57.4,<->,33.107.91.35,1,50,0,0,1,50,0.193556000,0.0000
105.67.67.40,<->,20.77.145.11,0,0,1,64,1,64,0.193315000,0.0000
134.169.126.159,<->,89.183.104.249,0,0,1,193,1,193,0.193193000,0.0000
121.165.130.185,<->,39.61.215.21,0,0,1,52,1,52,0.192993000,0.0000
192.227.191.242,<->,133.178.227.138,0,0,1,1059,1,1059,0.192936000,0.0000
136.172.238.246,<->,92.27.219.47,0,0,1,331,1,331,0.192867000,0.0000
80.27.155.100,<->,66.247.93.228,1,50,0,0,1,50,0.192690000,0.0000
215.158.239.92,<->,207.59.4.239,1,56,0,0,1,56,0.192386000,0.0000
76.5.32.59,<->,56.121.37.61,0,0,1,50,1,50,0.192214000,0.0000
143.134.250.32,<->,136.25.188.176,0,0,1,50,1,50,0.192209000,0.0000
104.143.24.112,<->,20.255.123.93,0,0,1,64,1,64,0.192168000,0.0000
221.102.56.69,<->,98.128.56.204,0,0,1,50,1,50,0.192159000,0.0000
196.134.137.67,<->,92.27.194.147,0,0,1,50,1,50,0.192028000,0.0000
215.158.238.133,<->,149.250.115.26,1,56,0,0,1,56,0.191739000,0.0000
206.72.179.52,<->,20.98.60.240,0,0,1,64,1,64,0.191713000,0.0000
144.108.64.184,<->,97.199.169.50,0,0,1,70,1,70,0.191622000,0.0000
64.105.12.84,<->,53.244.229.106,1,417,0,0,1,417,0.191450000,0.0000
145.166.4.99,<->,8.182.251.218,0,0,1,50,1,50,0.191382000,0.0000
92.27.27.165,<->,8.47.122.177,1,126,0,0,1,126,0.191237000,0.0000
109.222.231.67,<->,106.18.141.73,1,69,0,0,1,69,0.191178000,0.0000
203.48.1.38,<->,39.216.85.179,0,0,1,70,1,70,0.191025000,0.0000
246.253.253.169,<->,56.114.235.120,1,50,0,0,1,50,0.190828000,0.0000
199.70.25.58,<->,136.25.188.209,0,0,1,50,1,50,0.190605000,0.0000
145.229.246.201,<->,8.52.243.47,0,0,1,50,1,50,0.190575000,0.0000
139.163.84.114,<->,109.48.94.18,1,73,0,0,1,73,0.190390000,0.0000
111.150.207.144,<->,8.252.223.137,0,0,1,100,1,100,0.190113000,0.0000
89.183.104.248,<->,50.149.205.38,1,78,0,0,1,78,0.189811000,0.0000
123.156.103.111,<->,20.238.136.88,0,0,1,64,1,64,0.189762000,0.0000
112.204.236.103,<->,8.52.171.31,0,0,1,50,1,50,0.189528000,0.0000
127.110.72.35,<->,20.154.1.186,0,0,1,64,1,64,0.189494000,0.0000
197.153.85.104,<->,20.252.68.89,0,0,1,64,1,64,0.189420000,0.0000
89.183.106.118,<->,18.129.154.14,1,64,0,0,1,64,0.189217000,0.0000
196.18.142.60,<->,8.20.87.179,0,0,1,50,1,50,0.188939000,0.0000
216.144.221.21,<->,215.158.140.204,0,0,1,50,1,50,0.188824000,0.0000
144.75.218.237,<->,130.61.250.228,1,140,0,0,1,140,0.188773000,0.0000
255.133.229.164,<->,39.7.107.249,0,0,1,100,1,100,0.188677000,0.0000
8.182.238.33,<->,6.20.52.215,1,50,0,0,1,50,0.188515000,0.0000
133.135.218.222,<->,89.183.109.69,0,0,1,64,1,64,0.188271000,0.0000
21.15.226.126,<->,20.193.49.95,0,0,1,82,1,82,0.188226000,0.0000
241.193.172.231,<->,20.124.152.221,0,0,1,50,1,50,0.188104000,0.0000
39.175.234.21,<->,33.211.62.36,1,52,0,0,1,52,0.188010000,0.0000
139.193.141.139,<->,123.167.41.242,1,50,0,0,1,50,0.187840000,0.0000
195.42.93.222,<->,136.25.188.220,0,0,1,56,1,56,0.187624000,0.0000
146.12.146.21,<->,139.193.141.139,0,0,1,50,1,50,0.187519000,0.0000
204.1.231.207,<->,136.25.188.199,0,0,1,56,1,56,0.187402000,0.0000
197.145.200.52,<->,39.63.202.83,0,0,1,64,1,64,0.187078000,0.0000
206.222.44.212,<->,92.27.219.134,0,0,1,147,1,147,0.186841000,0.0000
223.139.104.157,<->,39.154.108.254,0,0,1,64,1,64,0.186762000,0.0000
200.174.195.241,<->,53.160.23.38,1,57,0,0,1,57,0.186710000,0.0000
205.107.152.23,<->,109.1.7.226,0,0,1,50,1,50,0.186661000,0.0000
137.137.75.72,<->,0.247.67.42,1,62,0,0,1,62,0.186584000,0.0000
116.242.46.12,<->,89.183.104.191,0,0,1,63,1,63,0.186578000,0.0000
198.157.56.197,<->,39.33.163.105,0,0,1,64,1,64,0.186530000,0.0000
199.82.242.253,<->,136.25.188.241,0,0,1,50,1,50,0.186290000,0.0000
122.201.39.217,<->,89.183.104.231,0,0,1,62,1,62,0.186138000,0.0000
206.243.235.195,<->,109.1.7.226,0,0,1,50,1,50,0.185595000,0.0000
142.206.47.161,<->,92.27.194.147,0,0,1,68,1,68,0.185479000,0.0000
199.111.23.145,<->,39.34.6.147,0,0,1,96,1,96,0.185202000,0.0000
210.221.107.50,<->,8.222.6.81,1,1424,0,0,1,1424,0.185120000,0.0000
196.113.186.195,<->,20.122.167.69,0,0,1,64,1,64,0.184970000,0.0000
192.67.143.198,<->,115.185.23.246,1,319,0,0,1,319,0.184960000,0.0000
144.75.218.237,<->,139.254.118.32,1,163,0,0,1,163,0.184951000,0.0000
133.8.0.39,<->,50.224.76.131,0,0,1,79,1,79,0.184893000,0.0000
101.70.127.164,<->,53.210.61.139,1,56,0,0,1,56,0.184422000,0.0000
215.158.61.242,<->,8.176.8.97,0,0,1,1117,1,1117,0.184354000,0.0000
215.158.238.70,<->,111.151.107.210,1,56,0,0,1,56,0.184135000,0.0000
193.22.183.181,<->,92.27.219.193,0,0,1,50,1,50,0.184021000,0.0000
215.158.238.92,<->,143.155.233.210,1,56,0,0,1,56,0.183800000,0.0000
210.113.152.194,<->,144.81.142.226,1,102,0,0,1,102,0.183726000,0.0000
194.159.61.237,<->,129.224.112.252,0,0,1,76,1,76,0.183512000,0.0000
142.246.107.19,<->,138.98.237.231,0,0,1,50,1,50,0.183416000,0.0000
215.158.239.220,<->,53.231.141.46,1,50,0,0,1,50,0.183414000,0.0000
229.59.197.90,<->,97.198.98.88,0,0,1,50,1,50,0.183326000,0.0000
196.112.116.141,<->,20.255.89.52,0,0,1,64,1,64,0.183324000,0.0000
126.87.3.138,<->,99.73.153.222,0,0,1,62,1,62,0.183295000,0.0000
112.86.0.93,<->,20.44.104.190,0,0,1,64,1,64,0.183237000,0.0000
215.158.140.75,<->,122.216.233.115,1,56,0,0,1,56,0.183052000,0.0000
80.42.163.111,<->,0.195.46.144,1,135,0,0,1,135,0.182994000,0.0000
134.47.233.28,<->,92.27.219.19,0,0,1,103,1,103,0.182489000,0.0000
139.163.26.146,<->,103.191.109.156,1,157,0,0,1,157,0.182379000,0.0000
204.187.70.2,<->,136.25.188.226,0,0,1,68,1,68,0.182196000,0.0000
105.116.242.83,<->,92.27.219.225,0,0,1,288,1,288,0.182078000,0.0000
198.158.197.83,<->,20.31.247.120,0,0,1,50,1,50,0.181921000,0.0000
74.133.208.61,<->,39.225.125.120,0,0,1,52,1,52,0.181764000,0.0000
192.67.152.128,<->,68.81.15.237,1,50,0,0,1,50,0.181747000,0.0000
108.134.119.37,<->,48.53.172.232,1,52,0,0,1,52,0.181740000,0.0000
198.157.56.197,<->,39.33.163.67,0,0,1,64,1,64,0.181453000,0.0000
207.22.2.241,<->,92.27.194.147,0,0,1,56,1,56,0.181258000,0.0000
121.213.128.52,<->,92.27.27.143,0,0,1,52,1,52,0.181213000,0.0000
198.157.56.197,<->,39.33.163.96,0,0,1,64,1,64,0.181065000,0.0000
159.36.244.22,<->,8.52.222.23,0,0,1,50,1,50,0.180935000,0.0000
118.219.171.125,<->,89.183.104.246,0,0,1,62,1,62,0.180444000,0.0000
230.116.239.209,<->,98.217.47.85,0,0,1,56,1,56,0.180068000,0.0000
152.134.175.21,<->,34.136.235.105,0,0,1,126,1,126,0.179827000,0.0000
207.57.59.139,<->,136.25.188.175,0,0,1,56,1,56,0.179711000,0.0000
142.221.231.93,<->,136.25.188.237,0,0,1,50,1,50,0.179620000,0.0000
142.254.67.106,<->,136.25.188.198,0,0,1,56,1,56,0.179280000,0.0000
109.222.239.143,<->,86.113.249.211,1,69,0,0,1,69,0.179243000,0.0000
80.27.159.59,<->,72.151.67.10,1,56,0,0,1,56,0.179124000,0.0000
202.218.28.35,<->,100.182.162.67,0,0,1,583,1,583,0.179085000,0.0000
198.157.56.197,<->,39.33.163.99,0,0,1,64,1,64,0.178845000,0.0000
124.22.63.79,<->,39.236.54.14,0,0,1,74,1,74,0.178821000,0.0000
235.254.4.212,<->,159.137.255.95,0,0,1,50,1,50,0.178771000,0.0000
133.135.214.174,<->,89.183.109.69,0,0,1,64,1,64,0.178612000,0.0000
109.1.17.129,<->,27.188.163.162,1,444,0,0,1,444,0.178552000,0.0000
140.21.2.175,<->,39.160.87.110,0,0,1,70,1,70,0.178478000,0.0000
105.69.82.59,<->,20.35.165.243,0,0,1,56,1,56,0.178351000,0.0000
196.1.91.184,<->,39.145.4.201,0,0,1,100,1,100,0.178109000,0.0000
205.107.152.205,<->,109.1.7.226,0,0,1,50,1,50,0.178055000,0.0000
194.210.151.159,<->,8.182.227.180,0,0,1,50,1,50,0.177874000,0.0000
215.158.140.173,<->,98.34.228.101,1,50,0,0,1,50,0.177766000,0.0000
207.194.158.174,<->,8.182.138.83,0,0,1,50,1,50,0.177401000,0.0000
192.229.218.249,<->,143.137.125.28,1,50,0,0,1,50,0.177339000,0.0000
192.67.186.56,<->,29.197.46.156,1,56,0,0,1,56,0.177319000,0.0000
215.158.42.138,<->,136.25.188.26,0,0,1,1064,1,1064,0.177312000,0.0000
113.171.75.11,<->,101.70.98.5,0,0,1,135,1,135,0.177164000,0.0000
198.157.56.197,<->,39.33.163.72,0,0,1,64,1,64,0.176476000,0.0000
215.158.239.48,<->,207.61.69.132,1,93,0,0,1,93,0.176452000,0.0000
199.38.121.175,<->,136.25.188.226,0,0,1,50,1,50,0.176331000,0.0000
244.50.249.107,<->,20.166.26.108,0,0,1,50,1,50,0.176233000,0.0000
121.229.119.219,<->,35.32.8.23,0,0,1,64,1,64,0.175930000,0.0000
241.193.172.231,<->,20.228.56.11,0,0,1,50,1,50,0.175879000,0.0000
111.20.172.70,<->,101.224.89.174,0,0,1,78,1,78,0.175857000,0.0000
155.135.152.83,<->,20.60.178.123,0,0,1,56,1,56,0.175742000,0.0000
247.136.145.168,<->,127.161.24.212,1,52,0,0,1,52,0.175631000,0.0000
207.191.116.173,<->,136.25.188.239,0,0,1,64,1,64,0.175556000,0.0000
215.158.140.11,<->,128.157.72.138,1,117,0,0,1,117,0.175445000,0.0000
106.201.56.143,<->,20.178.90.62,0,0,1,64,1,64,0.175368000,0.0000
142.236.143.102,<->,136.25.188.252,0,0,1,50,1,50,0.175278000,0.0000
113.211.218.73,<->,20.234.67.118,0,0,1,52,1,52,0.175260000,0.0000
115.121.102.239,<->,35.56.101.201,0,0,1,50,1,50,0.175230000,0.0000
229.96.182.194,<->,8.181.37.222,1,64,0,0,1,64,0.174977000,0.0000
144.82.14.49,<->,129.224.112.252,0,0,1,84,1,84,0.174891000,0.0000
196.30.163.164,<->,97.126.110.97,0,0,1,64,1,64,0.174877000,0.0000
215.158.239.93,<->,199.20.28.225,1,68,0,0,1,68,0.174578000,0.0000
159.112.9.198,<->,99.74.131.242,0,0,1,81,1,81,0.174036000,0.0000
136.128.19.81,<->,102.50.37.223,0,0,1,50,1,50,0.173551000,0.0000
129.211.8.218,<->,8.220.234.159,0,0,1,56,1,56,0.173439000,0.0000
126.225.224.82,<->,20.147.130.35,0,0,1,64,1,64,0.173217000,0.0000
198.157.56.197,<->,39.33.163.74,0,0,1,64,1,64,0.173128000,0.0000
215.158.238.99,<->,100.233.69.54,1,56,0,0,1,56,0.172662000,0.0000
195.70.196.11,<->,136.25.188.236,0,0,1,50,1,50,0.172333000,0.0000
111.151.107.247,<->,8.176.8.97,0,0,1,166,1,166,0.172175000,0.0000
111.150.187.57,<->,6.73.247.150,0,0,1,106,1,106,0.172119000,0.0000
144.95.255.201,<->,109.222.246.240,0,0,1,468,1,468,0.171993000,0.0000
215.158.239.93,<->,195.13.168.27,1,50,0,0,1,50,0.171934000,0.0000
210.229.230.21,<->,110.20.255.46,1,50,0,0,1,50,0.171729000,0.0000
109.222.200.34,<->,54.42.32.66,1,56,0,0,1,56,0.171612000,0.0000
144.87.235.187,<->,138.127.225.69,1,229,0,0,1,229,0.170490000,0.0000
215.158.3.104,<->,6.73.247.2,0,0,1,72,1,72,0.170484000,0.0000
241.193.172.231,<->,20.227.217.128,0,0,1,50,1,50,0.170367000,0.0000
218.4.176.27,<->,159.42.43.76,1,406,0,0,1,406,0.170257000,0.0000
97.126.118.91,<->,33.223.137.131,1,52,0,0,1,52,0.170019000,0.0000
215.158.239.57,<->,199.20.31.208,1,64,0,0,1,64,0.169823000,0.0000
247.136.192.123,<->,0.41.29.5,1,50,0,0,1,50,0.169736000,0.0000
66.90.124.145,<->,34.176.134.118,0,0,1,102,1,102,0.169661000,0.0000
101.70.123.35,<->,100.83.51.93,1,120,0,0,1,120,0.169582000,0.0000
213.108.31.243,<->,111.147.243.157,0,0,1,64,1,64,0.169504000,0.0000
114.156.85.117,<->,20.157.128.174,0,0,1,56,1,56,0.169415000,0.0000
207.61.108.128,<->,136.25.188.225,0,0,1,50,1,50,0.169307000,0.0000
17.117.220.29,<->,8.220.190.86,0,0,1,50,1,50,0.169250000,0.0000
248.225.27.2,<->,95.221.82.237,1,52,0,0,1,52,0.169057000,0.0000
207.49.136.151,<->,8.52.228.245,0,0,1,84,1,84,0.168770000,0.0000
111.151.109.20,<->,8.252.222.106,0,0,1,56,1,56,0.168750000,0.0000
106.23.73.139,<->,92.27.219.232,0,0,1,56,1,56,0.168337000,0.0000
92.27.219.179,<->,42.27.201.253,1,64,0,0,1,64,0.168250000,0.0000
112.12.147.43,<->,50.224.76.230,0,0,1,50,1,50,0.168202000,0.0000
195.122.123.26,<->,139.193.141.200,0,0,1,56,1,56,0.167997000,0.0000
210.209.251.211,<->,100.182.157.219,0,0,1,1484,1,1484,0.167732000,0.0000
133.178.226.212,<->,8.190.216.202,1,56,0,0,1,56,0.167662000,0.0000
109.1.57.247,<->,97.4.116.46,1,50,0,0,1,50,0.167451000,0.0000
132.168.197.16,<->,52.102.236.155,1,65,0,0,1,65,0.167276000,0.0000
98.23.96.85,<->,92.27.27.175,0,0,1,56,1,56,0.167212000,0.0000
207.60.183.138,<->,136.25.188.198,0,0,1,50,1,50,0.167052000,0.0000
249.101.118.96,<->,27.11.6.104,1,50,0,0,1,50,0.167044000,0.0000
92.27.131.123,<->,89.183.104.238,0,0,1,56,1,56,0.166755000,0.0000
207.92.37.12,<->,8.182.224.248,0,0,1,50,1,50,0.166620000,0.0000
97.243.206.148,<->,89.183.104.238,0,0,1,56,1,56,0.166615000,0.0000
195.5.52.254,<->,136.25.188.199,0,0,1,50,1,50,0.166556000,0.0000
215.158.30.56,<->,29.211.214.254,0,0,1,94,1,94,0.166421000,0.0000
133.242.244.247,<->,133.54.17.114,0,0,1,50,1,50,0.166347000,0.0000
116.128.34.231,<->,56.121.41.67,0,0,1,56,1,56,0.166288000,0.0000
215.158.238.180,<->,132.58.23.96,1,155,0,0,1,155,0.166238000,0.0000
159.137.138.173,<->,133.8.0.39,1,79,0,0,1,79,0.165978000,0.0000
142.229.179.19,<->,136.25.188.222,0,0,1,50,1,50,0.165894000,0.0000
215.158.238.233,<->,111.151.142.231,1,100,0,0,1,100,0.165840000,0.0000
126.234.223.254,<->,20.224.242.127,0,0,1,64,1,64,0.165585000,0.0000
104.131.160.56,<->,39.51.193.196,0,0,1,50,1,50,0.165273000,0.0000
136.25.188.72,<->,111.150.207.179,1,56,0,0,1,56,0.165145000,0.0000
113.127.129.244,<->,20.191.243.136,0,0,1,64,1,64,0.165081000,0.0000
131.145.83.75,<->,92.27.219.244,0,0,1,52,1,52,0.164799000,0.0000
120.126.180.136,<->,92.27.219.224,0,0,1,52,1,52,0.164664000,0.0000
199.68.161.101,<->,136.25.188.209,0,0,1,50,1,50,0.164622000,0.0000
101.235.75.179,<->,8.55.194.110,1,56,0,0,1,56,0.164349000,0.0000
215.158.239.50,<->,199.38.27.81,1,50,0,0,1,50,0.164349000,0.0000
192.171.32.184,<->,136.25.189.77,0,0,1,56,1,56,0.164158000,0.0000
215.158.239.87,<->,196.95.113.145,1,68,0,0,1,68,0.163912000,0.0000
215.158.239.51,<->,199.71.247.119,1,56,0,0,1,56,0.163736000,0.0000
134.21.38.250,<->,92.27.219.43,0,0,1,52,1,52,0.163627000,0.0000
53.213.148.81,<->,48.53.6.148,0,0,1,56,1,56,0.163552000,0.0000
8.220.191.244,<->,6.89.119.99,1,50,0,0,1,50,0.163474000,0.0000
202.33.251.78,<->,136.25.188.240,0,0,1,56,1,56,0.163433000,0.0000
92.27.219.244,<->,30.58.184.144,1,50,0,0,1,50,0.163334000,0.0000
245.227.15.156,<->,8.182.241.177,0,0,1,50,1,50,0.162925000,0.0000
149.240.146.211,<->,0.195.210.42,0,0,1,56,1,56,0.162846000,0.0000
148.3.52.53,<->,144.85.74.113,0,0,1,187,1,187,0.162778000,0.0000
109.1.17.133,<->,27.188.163.162,1,446,0,0,1,446,0.162412000,0.0000
215.158.239.70,<->,199.20.30.30,1,64,0,0,1,64,0.162177000,0.0000
193.64.253.32,<->,109.222.212.103,0,0,1,50,1,50,0.162054000,0.0000
76.72.228.64,<->,39.164.106.193,0,0,1,64,1,64,0.162015000,0.0000
241.193.172.231,<->,20.132.82.197,0,0,1,50,1,50,0.161986000,0.0000
142.183.80.32,<->,92.27.219.149,0,0,1,1457,1,1457,0.161741000,0.0000
133.0.67.60,<->,108.11.71.121,1,395,0,0,1,395,0.161695000,0.0000
109.1.41.161,<->,38.191.160.210,1,64,0,0,1,64,0.161606000,0.0000
113.127.207.90,<->,97.126.113.83,0,0,1,64,1,64,0.161347000,0.0000
215.158.239.56,<->,143.91.250.185,1,64,0,0,1,64,0.160352000,0.0000
204.184.134.174,<->,136.25.188.242,0,0,1,101,1,101,0.160255000,0.0000
94.194.17.154,<->,8.252.221.207,0,0,1,56,1,56,0.160044000,0.0000
223.115.225.253,<->,8.252.222.158,0,0,1,50,1,50,0.159995000,0.0000
94.192.24.73,<->,8.252.221.197,0,0,1,50,1,50,0.159614000,0.0000
143.194.53.201,<->,80.38.33.214,0,0,1,519,1,519,0.159580000,0.0000
196.206.234.103,<->,136.25.188.46,0,0,1,56,1,56,0.159368000,0.0000
222.16.241.187,<->,192.67.157.171,0,0,1,50,1,50,0.159327000,0.0000
89.183.104.164,<->,50.163.69.12,1,52,0,0,1,52,0.159324000,0.0000
97.168.64.242,<->,42.90.92.188,1,88,0,0,1,88,0.159306000,0.0000
193.46.99.139,<->,8.228.219.176,0,0,1,129,1,129,0.159241000,0.0000
39.33.219.107,<->,4.206.34.232,1,52,0,0,1,52,0.158761000,0.0000
100.182.99.11,<->,20.179.125.134,0,0,1,52,1,52,0.158588000,0.0000
207.79.69.173,<->,100.95.244.53,0,0,1,62,1,62,0.158451000,0.0000
241.193.172.231,<->,20.34.64.179,0,0,1,50,1,50,0.158374000,0.0000
148.52.139.15,<->,80.42.140.207,0,0,1,50,1,50,0.158360000,0.0000
21.15.226.126,<->,20.193.40.119,0,0,1,82,1,82,0.157704000,0.0000
215.158.61.145,<->,8.176.8.251,0,0,1,1405,1,1405,0.157365000,0.0000
145.252.122.164,<->,132.43.156.54,1,260,0,0,1,260,0.157196000,0.0000
197.7.105.10,<->,8.183.25.25,0,0,1,64,1,64,0.157059000,0.0000
215.158.239.93,<->,199.20.28.131,1,56,0,0,1,56,0.156889000,0.0000
144.75.218.233,<->,138.127.225.221,1,365,0,0,1,365,0.156633000,0.0000
220.20.200.105,<->,144.83.60.153,1,559,0,0,1,559,0.156531000,0.0000
144.35.135.7,<->,8.52.163.19,0,0,1,56,1,56,0.156227000,0.0000
107.68.172.8,<->,8.182.224.248,0,0,1,50,1,50,0.155785000,0.0000
129.224.112.252,<->,41.137.22.107,1,85,0,0,1,85,0.155672000,0.0000
141.11.249.114,<->,20.159.134.46,0,0,1,96,1,96,0.155663000,0.0000
136.25.189.93,<->,8.219.184.149,1,83,0,0,1,83,0.155627000,0.0000
148.145.80.227,<->,145.252.123.97,0,0,1,84,1,84,0.155593000,0.0000
92.27.219.202,<->,92.27.131.122,1,56,0,0,1,56,0.155390000,0.0000
97.183.195.190,<->,56.120.131.76,1,687,0,0,1,687,0.155198000,0.0000
215.158.239.57,<->,196.1.176.223,1,602,0,0,1,602,0.154842000,0.0000
146.226.226.225,<->,144.75.218.246,0,0,1,82,1,82,0.154780000,0.0000
207.117.75.91,<->,8.182.241.177,0,0,1,50,1,50,0.154776000,0.0000
204.62.7.45,<->,136.25.188.211,0,0,1,68,1,68,0.154666000,0.0000
109.222.239.143,<->,102.103.77.216,1,71,0,0,1,71,0.154611000,0.0000
142.228.213.164,<->,136.25.188.175,0,0,1,50,1,50,0.154609000,0.0000
215.158.239.79,<->,199.20.5.126,1,101,0,0,1,101,0.154571000,0.0000
218.4.180.233,<->,137.64.13.252,1,85,0,0,1,85,0.154407000,0.0000
136.25.188.222,<->,84.204.17.52,1,56,0,0,1,56,0.154397000,0.0000
215.158.239.76,<->,199.20.29.81,1,56,0,0,1,56,0.154276000,0.0000
215.158.239.96,<->,195.40.191.17,1,50,0,0,1,50,0.154154000,0.0000
129.254.99.2,<->,129.224.112.252,0,0,1,67,1,67,0.153953000,0.0000
215.158.140.13,<->,145.234.87.73,1,1064,0,0,1,1064,0.153923000,0.0000
215.158.238.148,<->,126.219.194.106,1,56,0,0,1,56,0.153691000,0.0000
205.22.252.132,<->,39.17.204.156,0,0,1,64,1,64,0.153386000,0.0000
215.158.239.78,<->,199.106.115.19,1,56,0,0,1,56,0.153341000,0.0000
158.194.192.241,<->,20.200.51.121,0,0,1,52,1,52,0.153268000,0.0000
137.46.169.48,<->,8.53.7.199,0,0,1,50,1,50,0.153172000,0.0000
104.143.24.112,<->,20.255.123.201,0,0,1,64,1,64,0.153142000,0.0000
241.193.172.231,<->,20.172.238.76,0,0,1,50,1,50,0.152994000,0.0000
143.187.221.221,<->,80.42.130.245,0,0,1,50,1,50,0.152852000,0.0000
204.186.131.68,<->,136.25.188.252,0,0,1,1438,1,1438,0.152778000,0.0000
210.209.251.214,<->,56.121.51.247,0,0,1,50,1,50,0.152702000,0.0000
143.76.138.242,<->,8.182.227.180,0,0,1,50,1,50,0.152512000,0.0000
132.249.70.213,<->,56.115.253.42,1,117,0,0,1,117,0.152375000,0.0000
118.221.39.205,<->,92.27.219.226,0,0,1,149,1,149,0.152113000,0.0000
125.20.145.172,<->,80.40.8.11,0,0,1,56,1,56,0.152064000,0.0000
241.193.172.231,<->,20.235.208.148,0,0,1,50,1,50,0.152033000,0.0000
142.206.34.130,<->,136.25.188.55,0,0,1,50,1,50,0.151961000,0.0000
207.92.20.62,<->,8.182.139.197,0,0,1,50,1,50,0.151719000,0.0000
198.158.197.83,<->,20.30.218.104,0,0,1,50,1,50,0.151696000,0.0000
113.115.31.85,<->,20.231.10.220,0,0,1,64,1,64,0.151661000,0.0000
215.158.239.87,<->,207.59.192.204,1,50,0,0,1,50,0.151519000,0.0000
159.69.187.21,<->,144.108.64.183,1,64,0,0,1,64,0.151514000,0.0000
136.25.188.105,<->,93.12.2.192,1,115,0,0,1,115,0.151339000,0.0000
111.146.162.6,<->,54.53.106.181,1,64,0,0,1,64,0.151196000,0.0000
241.193.172.231,<->,20.17.223.252,0,0,1,50,1,50,0.151098000,0.0000
60.93.108.205,<->,39.243.135.27,0,0,1,50,1,50,0.150794000,0.0000
104.143.24.112,<->,20.255.123.205,0,0,1,64,1,64,0.150711000,0.0000
102.83.205.217,<->,8.55.209.213,1,56,0,0,1,56,0.150685000,0.0000
204.200.49.159,<->,136.25.188.53,0,0,1,50,1,50,0.150677000,0.0000
53.161.104.250,<->,48.54.25.110,0,0,1,50,1,50,0.150638000,0.0000
139.163.122.73,<->,53.250.249.111,1,56,0,0,1,56,0.150633000,0.0000
144.75.218.235,<->,138.127.231.117,1,254,0,0,1,254,0.150425000,0.0000
198.176.250.54,<->,50.224.75.42,0,0,1,52,1,52,0.150382000,0.0000
195.5.81.85,<->,136.25.188.53,0,0,1,56,1,56,0.150315000,0.0000
241.193.172.231,<->,20.92.17.210,0,0,1,50,1,50,0.150290000,0.0000
200.164.4.84,<->,8.252.221.220,0,0,1,50,1,50,0.150260000,0.0000
104.143.24.112,<->,20.255.123.14,0,0,1,64,1,64,0.150160000,0.0000
42.199.222.241,<->,20.10.250.172,0,0,1,64,1,64,0.150031000,0.0000
215.158.140.19,<->,139.252.1.230,1,150,0,0,1,150,0.149575000,0.0000
207.236.50.115,<->,136.25.188.252,0,0,1,50,1,50,0.149406000,0.0000
145.252.126.29,<->,119.231.171.14,1,50,0,0,1,50,0.149392000,0.0000
109.1.23.143,<->,93.174.65.127,1,50,0,0,1,50,0.149228000,0.0000
109.222.244.209,<->,93.167.142.44,1,213,0,0,1,213,0.149225000,0.0000
215.158.238.177,<->,131.144.116.30,1,56,0,0,1,56,0.149141000,0.0000
143.129.218.243,<->,136.25.188.255,0,0,1,50,1,50,0.148997000,0.0000
111.151.107.247,<->,8.252.223.245,0,0,1,112,1,112,0.148938000,0.0000
132.249.70.233,<->,109.203.229.64,1,148,0,0,1,148,0.148732000,0.0000
241.193.172.231,<->,20.120.117.26,0,0,1,50,1,50,0.148570000,0.0000
229.59.1.46,<->,144.86.151.120,0,0,1,75,1,75,0.148492000,0.0000
195.42.93.222,<->,136.25.188.162,0,0,1,56,1,56,0.148357000,0.0000
114.64.216.52,<->,92.27.219.145,0,0,1,135,1,135,0.148315000,0.0000
100.95.89.103,<->,89.86.110.6,1,453,0,0,1,453,0.148182000,0.0000
215.158.140.111,<->,139.252.33.121,1,106,0,0,1,106,0.148013000,0.0000
127.124.174.97,<->,89.183.104.191,0,0,1,56,1,56,0.147937000,0.0000
93.181.153.134,<->,92.27.219.187,0,0,1,52,1,52,0.147762000,0.0000
142.240.197.152,<->,136.25.188.177,0,0,1,50,1,50,0.147523000,0.0000
21.15.226.126,<->,20.193.40.97,0,0,1,82,1,82,0.147471000,0.0000
124.57.226.241,<->,20.196.179.188,0,0,1,96,1,96,0.147145000,0.0000
50.30.86.14,<->,8.220.191.251,0,0,1,50,1,50,0.147024000,0.0000
144.75.218.233,<->,138.127.231.98,1,355,0,0,1,355,0.146732000,0.0000
246.253.252.54,<->,137.254.128.4,1,116,0,0,1,116,0.146727000,0.0000
145.16.29.114,<->,120.60.249.108,1,50,0,0,1,50,0.146678000,0.0000
207.173.191.151,<->,136.25.188.225,0,0,1,101,1,101,0.146637000,0.0000
105.135.77.221,<->,20.97.187.132,0,0,1,60,1,60,0.146470000,0.0000
143.129.218.243,<->,136.25.188.163,0,0,1,50,1,50,0.146423000,0.0000
123.58.158.133,<->,92.27.219.159,0,0,1,52,1,52,0.146418000,0.0000
116.129.34.166,<->,80.41.32.232,0,0,1,130,1,130,0.146166000,0.0000
89.183.104.151,<->,8.47.122.95,1,368,0,0,1,368,0.146034000,0.0000
68.76.35.119,<->,8.252.221.223,0,0,1,56,1,56,0.145940000,0.0000
202.33.21.183,<->,136.25.188.240,0,0,1,50,1,50,0.145634000,0.0000
210.156.204.25,<->,77.21.127.1,1,99,0,0,1,99,0.145313000,0.0000
199.32.170.22,<->,20.32.183.40,0,0,1,64,1,64,0.145293000,0.0000
113.127.129.244,<->,20.191.243.140,0,0,1,64,1,64,0.144784000,0.0000
127.186.128.183,<->,20.43.81.163,0,0,1,64,1,64,0.144447000,0.0000
100.115.92.195,<->,41.143.115.31,1,56,0,0,1,56,0.144409000,0.0000
142.190.183.140,<->,136.25.188.196,0,0,1,95,1,95,0.144354000,0.0000
215.158.239.50,<->,196.1.104.155,1,56,0,0,1,56,0.144317000,0.0000
215.158.239.92,<->,195.13.168.27,1,50,0,0,1,50,0.144201000,0.0000
92.27.219.250,<->,92.27.131.127,1,56,0,0,1,56,0.144192000,0.0000
207.59.44.200,<->,136.25.188.227,0,0,1,50,1,50,0.144170000,0.0000
194.107.4.209,<->,20.179.253.109,0,0,1,64,1,64,0.144094000,0.0000
244.50.136.175,<->,39.168.82.19,0,0,1,50,1,50,0.144087000,0.0000
215.158.140.19,<->,215.158.58.243,1,317,0,0,1,317,0.144044000,0.0000
136.25.189.33,<->,114.25.48.23,1,56,0,0,1,56,0.144005000,0.0000
152.100.31.168,<->,8.252.222.223,0,0,1,50,1,50,0.143968000,0.0000
194.50.141.12,<->,129.224.112.252,0,0,1,84,1,84,0.143934000,0.0000
247.136.240.215,<->,106.115.168.17,1,68,0,0,1,68,0.143850000,0.0000
21.15.226.126,<->,20.193.40.72,0,0,1,82,1,82,0.143837000,0.0000
59.43.228.12,<->,50.162.22.58,0,0,1,130,1,130,0.143701000,0.0000
215.158.238.218,<->,215.158.34.98,1,568,0,0,1,568,0.143379000,0.0000
98.238.34.5,<->,8.183.25.124,0,0,1,50,1,50,0.143361000,0.0000
98.101.171.19,<->,53.231.85.232,1,50,0,0,1,50,0.143280000,0.0000
119.19.115.29,<->,92.27.219.212,0,0,1,52,1,52,0.143247000,0.0000
215.158.238.132,<->,57.210.107.1,1,56,0,0,1,56,0.143240000,0.0000
159.64.219.139,<->,8.31.37.173,0,0,1,56,1,56,0.143226000,0.0000
93.181.154.83,<->,92.27.27.163,0,0,1,50,1,50,0.143223000,0.0000
199.15.252.123,<->,136.25.188.177,0,0,1,56,1,56,0.142952000,0.0000
215.158.239.79,<->,199.20.31.159,1,56,0,0,1,56,0.142802000,0.0000
196.90.28.195,<->,136.25.188.239,0,0,1,68,1,68,0.142610000,0.0000
195.70.196.11,<->,136.25.188.222,0,0,1,50,1,50,0.142543000,0.0000
92.27.219.223,<->,38.64.55.57,1,90,0,0,1,90,0.142420000,0.0000
142.167.214.90,<->,136.25.188.163,0,0,1,50,1,50,0.142339000,0.0000
159.69.187.20,<->,144.108.80.170,1,70,0,0,1,70,0.142232000,0.0000
104.37.201.253,<->,39.54.201.166,0,0,1,52,1,52,0.141853000,0.0000
157.211.181.91,<->,20.0.53.106,0,0,1,64,1,64,0.141667000,0.0000
97.126.106.44,<->,54.37.197.187,1,535,0,0,1,535,0.141281000,0.0000
195.126.34.88,<->,136.25.188.227,0,0,1,50,1,50,0.141034000,0.0000
196.119.218.22,<->,92.27.194.147,0,0,1,64,1,64,0.140919000,0.0000
100.182.99.11,<->,20.179.126.227,0,0,1,52,1,52,0.140918000,0.0000
248.225.25.172,<->,138.127.204.229,1,50,0,0,1,50,0.140844000,0.0000
252.253.21.235,<->,139.207.222.11,0,0,1,91,1,91,0.140683000,0.0000
210.156.155.20,<->,66.222.188.102,1,130,0,0,1,130,0.140653000,0.0000
132.168.197.132,<->,129.225.3.90,1,56,0,0,1,56,0.140461000,0.0000
192.64.221.115,<->,124.42.191.143,1,50,0,0,1,50,0.140180000,0.0000
138.127.225.201,<->,89.216.125.35,0,0,1,233,1,233,0.140153000,0.0000
199.33.30.108,<->,136.25.188.227,0,0,1,50,1,50,0.140121000,0.0000
215.158.140.112,<->,111.151.106.203,1,56,0,0,1,56,0.140121000,0.0000
195.54.161.96,<->,136.25.188.163,0,0,1,50,1,50,0.139491000,0.0000
126.13.105.76,<->,39.9.45.196,0,0,1,52,1,52,0.139112000,0.0000
198.66.182.2,<->,20.238.44.246,0,0,1,64,1,64,0.138889000,0.0000
207.162.185.61,<->,8.182.136.216,0,0,1,50,1,50,0.138742000,0.0000
130.7.224.243,<->,39.192.133.218,0,0,1,246,1,246,0.138726000,0.0000
200.175.35.79,<->,54.36.159.13,1,79,0,0,1,79,0.138705000,0.0000
64.151.7.177,<->,39.37.194.165,0,0,1,74,1,74,0.138436000,0.0000
80.40.51.106,<->,33.70.117.88,1,193,0,0,1,193,0.138399000,0.0000
94.39.161.169,<->,39.129.254.142,0,0,1,52,1,52,0.138157000,0.0000
192.67.152.0,<->,127.85.120.31,1,135,0,0,1,135,0.138027000,0.0000
195.69.119.68,<->,20.106.150.158,0,0,1,66,1,66,0.137901000,0.0000
243.56.223.216,<->,89.183.110.72,0,0,1,56,1,56,0.137550000,0.0000
198.157.156.148,<->,89.183.104.242,0,0,1,64,1,64,0.137529000,0.0000
204.108.90.50,<->,39.138.25.78,0,0,1,100,1,100,0.137448000,0.0000
145.158.81.92,<->,50.145.65.134,1,1424,0,0,1,1424,0.137293000,0.0000
220.20.200.160,<->,149.92.32.188,1,50,0,0,1,50,0.136985000,0.0000
202.178.8.66,<->,144.69.82.139,0,0,1,66,1,66,0.136854000,0.0000
159.31.207.156,<->,77.38.63.32,1,213,0,0,1,213,0.136806000,0.0000
144.75.218.242,<->,138.127.230.15,1,366,0,0,1,366,0.136693000,0.0000
131.45.239.182,<->,92.162.253.83,0,0,1,439,1,439,0.136269000,0.0000
215.158.239.78,<->,199.33.232.185,1,50,0,0,1,50,0.136156000,0.0000
123.158.42.91,<->,89.183.104.246,0,0,1,135,1,135,0.136021000,0.0000
144.75.218.242,<->,130.61.211.1,1,91,0,0,1,91,0.136008000,0.0000
195.105.95.197,<->,39.52.48.251,0,0,1,56,1,56,0.136007000,0.0000
114.80.83.75,<->,8.43.213.44,0,0,1,84,1,84,0.135743000,0.0000
120.20.16.51,<->,20.223.56.139,0,0,1,52,1,52,0.135617000,0.0000
215.158.103.206,<->,144.72.25.35,1,208,0,0,1,208,0.135608000,0.0000
158.189.37.55,<->,144.75.218.246,0,0,1,88,1,88,0.135602000,0.0000
144.75.218.237,<->,138.127.230.79,1,262,0,0,1,262,0.135517000,0.0000
57.176.114.210,<->,33.233.141.72,0,0,1,181,1,181,0.134888000,0.0000
199.85.73.162,<->,20.143.234.145,0,0,1,52,1,52,0.134738000,0.0000
80.41.57.193,<->,64.214.27.68,1,62,0,0,1,62,0.134508000,0.0000
136.181.51.108,<->,131.92.219.170,1,50,0,0,1,50,0.134224000,0.0000
244.50.129.64,<->,98.129.9.38,0,0,1,50,1,50,0.134009000,0.0000
142.190.140.132,<->,136.25.188.253,0,0,1,50,1,50,0.133769000,0.0000
215.158.239.84,<->,199.79.55.96,1,56,0,0,1,56,0.133753000,0.0000
199.25.143.93,<->,0.195.210.46,0,0,1,50,1,50,0.133683000,0.0000
142.249.201.199,<->,136.25.188.220,0,0,1,50,1,50,0.133229000,0.0000
123.86.222.193,<->,109.222.213.94,0,0,1,321,1,321,0.133169000,0.0000
204.153.11.196,<->,50.224.76.230,0,0,1,50,1,50,0.133164000,0.0000
139.36.120.222,<->,6.73.247.72,0,0,1,1064,1,1064,0.133088000,0.0000
94.194.167.11,<->,8.252.221.205,0,0,1,50,1,50,0.132549000,0.0000
101.224.89.134,<->,53.231.93.146,1,50,0,0,1,50,0.132483000,0.0000
247.136.179.199,<->,109.119.182.171,1,50,0,0,1,50,0.132441000,0.0000
210.220.219.152,<->,138.127.224.90,1,250,0,0,1,250,0.132157000,0.0000
158.235.101.245,<->,109.222.213.126,0,0,1,56,1,56,0.131871000,0.0000
59.49.73.35,<->,56.121.55.121,0,0,1,64,1,64,0.131862000,0.0000
215.158.238.132,<->,89.80.251.217,1,56,0,0,1,56,0.131836000,0.0000
203.215.118.5,<->,118.241.252.70,1,64,0,0,1,64,0.131805000,0.0000
92.27.219.181,<->,29.170.244.6,1,351,0,0,1,351,0.131551000,0.0000
101.224.89.248,<->,53.149.149.124,1,56,0,0,1,56,0.131497000,0.0000
143.10.183.99,<->,136.25.188.239,0,0,1,50,1,50,0.130965000,0.0000
104.143.24.112,<->,20.255.123.29,0,0,1,64,1,64,0.130965000,0.0000
215.158.239.95,<->,196.93.68.3,1,50,0,0,1,50,0.130922000,0.0000
149.113.167.89,<->,80.42.189.6,0,0,1,373,1,373,0.130911000,0.0000
21.15.226.126,<->,20.193.40.232,0,0,1,82,1,82,0.130762000,0.0000
136.25.188.253,<->,38.177.25.120,1,50,0,0,1,50,0.130630000,0.0000
42.47.226.251,<->,20.241.93.28,0,0,1,64,1,64,0.130074000,0.0000
198.158.197.83,<->,20.241.162.57,0,0,1,50,1,50,0.129847000,0.0000
132.216.20.191,<->,109.1.56.68,0,0,1,56,1,56,0.129756000,0.0000
109.1.17.136,<->,27.188.163.162,1,447,0,0,1,447,0.129726000,0.0000
247.136.161.187,<->,74.253.156.4,1,130,0,0,1,130,0.129680000,0.0000
65.57.89.237,<->,39.135.171.205,0,0,1,80,1,80,0.129663000,0.0000
200.174.7.87,<->,54.37.130.82,1,50,0,0,1,50,0.129635000,0.0000
91.250.143.162,<->,39.52.160.7,0,0,1,50,1,50,0.129516000,0.0000
58.46.144.129,<->,34.169.2.245,0,0,1,64,1,64,0.129411000,0.0000
249.101.235.54,<->,109.119.182.166,1,50,0,0,1,50,0.129331000,0.0000
195.71.152.119,<->,136.25.188.46,0,0,1,797,1,797,0.129214000,0.0000
144.75.218.233,<->,138.127.230.98,1,366,0,0,1,366,0.129171000,0.0000
144.76.44.59,<->,100.95.30.204,0,0,1,104,1,104,0.129157000,0.0000
196.0.216.90,<->,39.131.52.108,0,0,1,96,1,96,0.128298000,0.0000
215.158.3.42,<->,29.211.214.32,0,0,1,95,1,95,0.128118000,0.0000
115.159.174.25,<->,89.183.104.179,0,0,1,102,1,102,0.127979000,0.0000
124.29.255.45,<->,20.253.243.15,0,0,1,64,1,64,0.127855000,0.0000
124.19.215.36,<->,20.221.163.49,0,0,1,50,1,50,0.127584000,0.0000
132.7.177.108,<->,111.146.159.190,0,0,1,717,1,717,0.127541000,0.0000
199.52.239.188,<->,20.131.71.1,0,0,1,52,1,52,0.127432000,0.0000
53.239.87.170,<->,8.228.220.236,0,0,1,56,1,56,0.127341000,0.0000
241.193.172.231,<->,20.235.130.110,0,0,1,50,1,50,0.127119000,0.0000
195.56.196.75,<->,92.27.219.175,0,0,1,132,1,132,0.126828000,0.0000
247.136.143.180,<->,103.102.107.103,1,138,0,0,1,138,0.126581000,0.0000
244.50.236.30,<->,20.243.204.133,0,0,1,50,1,50,0.126535000,0.0000
99.151.86.158,<->,8.182.227.35,0,0,1,50,1,50,0.126352000,0.0000
92.27.219.135,<->,84.198.245.154,1,50,0,0,1,50,0.126290000,0.0000
142.235.190.75,<->,99.75.250.109,0,0,1,56,1,56,0.126197000,0.0000
142.228.133.133,<->,136.25.188.255,0,0,1,50,1,50,0.126092000,0.0000
202.33.230.162,<->,136.25.188.236,0,0,1,50,1,50,0.126047000,0.0000
158.159.95.185,<->,50.224.76.234,0,0,1,50,1,50,0.126044000,0.0000
101.106.122.69,<->,92.27.219.157,0,0,1,135,1,135,0.125920000,0.0000
195.69.164.67,<->,136.25.188.220,0,0,1,50,1,50,0.125482000,0.0000
215.158.239.92,<->,195.4.116.163,1,50,0,0,1,50,0.125467000,0.0000
196.247.165.197,<->,136.25.188.243,0,0,1,68,1,68,0.125459000,0.0000
156.142.13.207,<->,8.252.222.158,0,0,1,56,1,56,0.125424000,0.0000
109.222.253.134,<->,80.157.173.15,1,80,0,0,1,80,0.125352000,0.0000
92.27.219.228,<->,33.156.47.131,1,135,0,0,1,135,0.125340000,0.0000
215.158.140.27,<->,112.70.164.219,1,56,0,0,1,56,0.125215000,0.0000
250.50.34.183,<->,243.230.241.5,0,0,1,50,1,50,0.124939000,0.0000
104.143.24.112,<->,20.255.123.61,0,0,1,64,1,64,0.124819000,0.0000
215.158.238.143,<->,122.158.51.86,1,56,0,0,1,56,0.124797000,0.0000
197.68.217.227,<->,39.35.72.49,0,0,1,78,1,78,0.124752000,0.0000
215.158.239.87,<->,196.94.154.56,1,56,0,0,1,56,0.124397000,0.0000
215.158.140.240,<->,192.170.210.149,1,1002,0,0,1,1002,0.124302000,0.0000
202.33.17.92,<->,136.25.188.179,0,0,1,50,1,50,0.124092000,0.0000
255.133.229.164,<->,39.50.242.7,0,0,1,100,1,100,0.123976000,0.0000
124.29.255.45,<->,20.253.243.20,0,0,1,64,1,64,0.123770000,0.0000
215.158.239.95,<->,142.166.44.108,1,56,0,0,1,56,0.123721000,0.0000
120.20.16.198,<->,20.144.231.110,0,0,1,52,1,52,0.123696000,0.0000
197.7.116.50,<->,8.182.235.164,0,0,1,50,1,50,0.123624000,0.0000
73.46.158.199,<->,20.245.203.255,0,0,1,52,1,52,0.123493000,0.0000
129.1.109.243,<->,105.170.21.183,1,258,0,0,1,258,0.123315000,0.0000
144.105.43.185,<->,64.214.44.93,1,50,0,0,1,50,0.123216000,0.0000
111.147.189.183,<->,53.149.218.13,1,56,0,0,1,56,0.123034000,0.0000
215.158.239.58,<->,196.93.62.113,1,56,0,0,1,56,0.123000000,0.0000
140.90.106.189,<->,20.190.69.165,0,0,1,52,1,52,0.122887000,0.0000
89.25.123.110,<->,8.52.181.95,0,0,1,56,1,56,0.122846000,0.0000
109.222.199.19,<->,95.221.82.196,1,50,0,0,1,50,0.122397000,0.0000
221.102.56.69,<->,102.81.210.45,0,0,1,68,1,68,0.122113000,0.0000
119.203.29.53,<->,109.1.25.177,0,0,1,97,1,97,0.122017000,0.0000
215.158.239.48,<->,199.20.29.205,1,68,0,0,1,68,0.121998000,0.0000
207.57.39.178,<->,136.25.188.175,0,0,1,56,1,56,0.121796000,0.0000
91.250.143.162,<->,39.19.32.217,0,0,1,50,1,50,0.121420000,0.0000
158.150.10.58,<->,139.163.68.55,0,0,1,51,1,51,0.121292000,0.0000
215.158.239.92,<->,196.94.220.87,1,64,0,0,1,64,0.121175000,0.0000
109.1.59.56,<->,80.235.12.235,1,176,0,0,1,176,0.121040000,0.0000
199.71.19.20,<->,136.25.188.176,0,0,1,50,1,50,0.120933000,0.0000
197.161.78.251,<->,50.224.80.64,0,0,1,56,1,56,0.120561000,0.0000
192.67.179.181,<->,27.198.249.65,1,50,0,0,1,50,0.120469000,0.0000
132.208.68.222,<->,92.27.219.62,0,0,1,612,1,612,0.120415000,0.0000
215.158.239.123,<->,128.156.85.235,1,56,0,0,1,56,0.120264000,0.0000
104.143.24.112,<->,20.255.123.230,0,0,1,64,1,64,0.120189000,0.0000
142.167.105.185,<->,136.25.188.55,0,0,1,56,1,56,0.120008000,0.0000
215.158.239.70,<->,199.20.30.18,1,101,0,0,1,101,0.119999000,0.0000
127.66.17.50,<->,39.141.80.103,0,0,1,64,1,64,0.119981000,0.0000
195.4.184.157,<->,136.25.188.255,0,0,1,50,1,50,0.119962000,0.0000
196.30.93.119,<->,99.75.116.169,0,0,1,133,1,133,0.119884000,0.0000
89.183.104.166,<->,67.0.122.210,1,90,0,0,1,90,0.119755000,0.0000
159.69.187.29,<->,144.108.80.170,1,74,0,0,1,74,0.119667000,0.0000
136.181.39.100,<->,53.189.56.13,1,50,0,0,1,50,0.119591000,0.0000
98.248.200.18,<->,8.183.25.124,0,0,1,95,1,95,0.119563000,0.0000
121.77.89.131,<->,20.193.13.103,0,0,1,66,1,66,0.119535000,0.0000
231.142.199.97,<->,215.158.239.84,0,0,1,50,1,50,0.119514000,0.0000
133.178.226.28,<->,122.158.179.70,1,56,0,0,1,56,0.119368000,0.0000
6.145.169.217,<->,0.195.210.46,0,0,1,56,1,56,0.119319000,0.0000
198.242.216.33,<->,50.224.80.64,0,0,1,56,1,56,0.118978000,0.0000
93.104.212.227,<->,39.246.79.129,0,0,1,64,1,64,0.118975000,0.0000
246.253.253.79,<->,138.127.231.3,1,274,0,0,1,274,0.118943000,0.0000
129.224.112.252,<->,42.119.57.109,1,81,0,0,1,81,0.118874000,0.0000
215.158.103.206,<->,138.127.230.247,1,332,0,0,1,332,0.118666000,0.0000
109.1.61.240,<->,104.52.173.105,1,52,0,0,1,52,0.118652000,0.0000
136.25.188.30,<->,54.52.91.50,1,573,0,0,1,573,0.118482000,0.0000
92.27.27.148,<->,78.48.155.49,1,136,0,0,1,136,0.118124000,0.0000
206.195.154.29,<->,99.75.116.59,0,0,1,324,1,324,0.117793000,0.0000
215.158.140.240,<->,122.158.70.36,1,1002,0,0,1,1002,0.117696000,0.0000
133.178.227.73,<->,133.56.180.2,1,541,0,0,1,541,0.117563000,0.0000
194.238.215.148,<->,136.25.188.253,0,0,1,50,1,50,0.117202000,0.0000
139.59.41.197,<->,8.252.221.249,0,0,1,50,1,50,0.117076000,0.0000
92.27.219.195,<->,78.47.24.89,1,52,0,0,1,52,0.116985000,0.0000
98.246.18.142,<->,20.31.207.79,0,0,1,50,1,50,0.116931000,0.0000
159.115.105.190,<->,64.214.44.95,1,77,0,0,1,77,0.116432000,0.0000
75.214.216.243,<->,8.252.221.197,0,0,1,56,1,56,0.116375000,0.0000
196.13.204.65,<->,39.63.226.253,0,0,1,60,1,60,0.116314000,0.0000
204.187.177.6,<->,136.25.188.227,0,0,1,64,1,64,0.116217000,0.0000
86.198.151.118,<->,0.195.210.24,0,0,1,50,1,50,0.116066000,0.0000
27.65.39.249,<->,20.128.175.62,0,0,1,60,1,60,0.116034000,0.0000
144.75.218.235,<->,139.254.119.192,1,163,0,0,1,163,0.116014000,0.0000
197.32.240.149,<->,50.224.80.64,0,0,1,50,1,50,0.115978000,0.0000
136.25.188.198,<->,30.73.155.46,1,50,0,0,1,50,0.115786000,0.0000
215.158.238.12,<->,145.213.46.36,1,1064,0,0,1,1064,0.115764000,0.0000
194.254.217.76,<->,8.182.136.217,0,0,1,50,1,50,0.115664000,0.0000
109.1.9.216,<->,100.176.233.172,1,94,0,0,1,94,0.115501000,0.0000
140.68.10.122,<->,8.252.222.63,0,0,1,56,1,56,0.115500000,0.0000
109.222.203.124,<->,106.255.129.196,1,70,0,0,1,70,0.115385000,0.0000
220.55.75.13,<->,93.77.63.40,1,50,0,0,1,50,0.115373000,0.0000
230.126.45.98,<->,34.146.122.74,0,0,1,52,1,52,0.115355000,0.0000
53.231.92.109,<->,33.233.141.19,0,0,1,50,1,50,0.115184000,0.0000
137.74.4.104,<->,105.133.200.122,1,50,0,0,1,50,0.115110000,0.0000
75.62.16.8,<->,39.217.170.131,0,0,1,50,1,50,0.115074000,0.0000
215.158.239.48,<->,199.20.7.133,1,56,0,0,1,56,0.114982000,0.0000
149.164.189.49,<->,144.75.218.246,0,0,1,87,1,87,0.114832000,0.0000
93.64.108.3,<->,8.228.208.18,0,0,1,94,1,94,0.114259000,0.0000
111.20.172.70,<->,101.224.89.153,0,0,1,283,1,283,0.113867000,0.0000
93.94.133.139,<->,35.56.96.84,0,0,1,50,1,50,0.113690000,0.0000
195.69.208.189,<->,136.25.188.177,0,0,1,68,1,68,0.113676000,0.0000
210.221.107.50,<->,8.220.7.141,1,114,0,0,1,114,0.113346000,0.0000
133.20.250.202,<->,8.52.166.232,0,0,1,50,1,50,0.113307000,0.0000
215.158.140.64,<->,58.49.163.215,1,85,0,0,1,85,0.113287000,0.0000
144.75.218.237,<->,138.127.231.221,1,246,0,0,1,246,0.113243000,0.0000
157.210.206.227,<->,34.223.219.192,0,0,1,80,1,80,0.113236000,0.0000
199.120.125.141,<->,20.164.98.235,0,0,1,64,1,64,0.113004000,0.0000
99.162.77.146,<->,54.38.254.96,1,876,0,0,1,876,0.112921000,0.0000
207.193.80.243,<->,102.51.125.92,0,0,1,56,1,56,0.112796000,0.0000
111.20.172.70,<->,33.233.141.10,0,0,1,284,1,284,0.112736000,0.0000
111.20.172.70,<->,111.20.168.9,0,0,1,153,1,153,0.112699000,0.0000
99.75.57.252,<->,0.33.116.215,1,289,0,0,1,289,0.112661000,0.0000
224.148.99.69,<->,53.244.238.82,1,286,0,0,1,286,0.112552000,0.0000
246.253.253.96,<->,111.151.239.145,1,634,0,0,1,634,0.112309000,0.0000
215.158.239.95,<->,207.236.97.248,1,50,0,0,1,50,0.112307000,0.0000
144.75.218.237,<->,138.127.230.75,1,259,0,0,1,259,0.112293000,0.0000
53.199.195.19,<->,39.15.169.14,0,0,1,87,1,87,0.111882000,0.0000
109.1.51.39,<->,29.219.94.61,1,321,0,0,1,321,0.111686000,0.0000
207.38.173.138,<->,20.183.65.116,0,0,1,96,1,96,0.111622000,0.0000
196.245.88.32,<->,136.25.188.252,0,0,1,56,1,56,0.111513000,0.0000
43.52.23.227,<->,8.252.221.207,0,0,1,56,1,56,0.111484000,0.0000
111.20.172.70,<->,101.224.89.178,0,0,1,289,1,289,0.111379000,0.0000
21.15.226.126,<->,20.193.41.142,0,0,1,82,1,82,0.111067000,0.0000
145.242.126.41,<->,53.177.245.183,1,80,0,0,1,80,0.111054000,0.0000
142.253.237.85,<->,136.25.188.177,0,0,1,50,1,50,0.111036000,0.0000
215.158.238.135,<->,42.226.3.106,1,56,0,0,1,56,0.110948000,0.0000
101.224.89.225,<->,89.155.8.207,1,165,0,0,1,165,0.110895000,0.0000
192.64.211.17,<->,125.202.240.38,1,331,0,0,1,331,0.110862000,0.0000
215.158.238.33,<->,139.36.120.222,1,1064,0,0,1,1064,0.110339000,0.0000
224.148.203.58,<->,89.204.254.169,1,238,0,0,1,238,0.110312000,0.0000
203.215.151.167,<->,118.241.252.70,1,56,0,0,1,56,0.109332000,0.0000
119.225.116.131,<->,92.27.27.172,0,0,1,52,1,52,0.109302000,0.0000
143.94.116.115,<->,20.64.245.223,0,0,1,56,1,56,0.108956000,0.0000
115.172.202.133,<->,20.15.122.79,0,0,1,80,1,80,0.108866000,0.0000
144.75.218.246,<->,138.127.224.171,1,254,0,0,1,254,0.108739000,0.0000
143.42.124.50,<->,136.25.188.177,0,0,1,50,1,50,0.108565000,0.0000
143.22.76.211,<->,8.182.239.190,0,0,1,50,1,50,0.108509000,0.0000
97.20.3.29,<->,8.52.147.123,0,0,1,50,1,50,0.108375000,0.0000
138.127.224.104,<->,97.126.31.65,0,0,1,273,1,273,0.108198000,0.0000
207.201.28.147,<->,20.207.104.118,0,0,1,78,1,78,0.108006000,0.0000
215.158.23.28,<->,145.116.206.237,1,56,0,0,1,56,0.107884000,0.0000
99.124.192.211,<->,8.52.181.95,0,0,1,50,1,50,0.107609000,0.0000
129.224.112.252,<->,92.160.15.151,1,74,0,0,1,74,0.107598000,0.0000
215.158.239.97,<->,204.21.59.9,1,95,0,0,1,95,0.107582000,0.0000
200.174.210.184,<->,6.147.99.23,1,135,0,0,1,135,0.107567000,0.0000
106.177.44.73,<->,20.21.245.186,0,0,1,80,1,80,0.107172000,0.0000
193.10.105.251,<->,92.27.27.150,0,0,1,52,1,52,0.106981000,0.0000
136.62.161.28,<->,56.114.235.120,1,56,0,0,1,56,0.106979000,0.0000
199.72.46.179,<->,136.25.188.253,0,0,1,50,1,50,0.106648000,0.0000
215.158.140.189,<->,128.156.85.235,1,64,0,0,1,64,0.106600000,0.0000
158.200.224.120,<->,50.224.76.234,0,0,1,56,1,56,0.106584000,0.0000
109.222.212.108,<->,8.234.89.60,1,257,0,0,1,257,0.106452000,0.0000
91.43.31.208,<->,89.216.126.0,0,0,1,50,1,50,0.106241000,0.0000
111.20.172.70,<->,33.233.141.116,0,0,1,284,1,284,0.106082000,0.0000
148.27.67.32,<->,109.222.214.116,0,0,1,334,1,334,0.106022000,0.0000
100.123.122.203,<->,56.121.58.28,0,0,1,50,1,50,0.105978000,0.0000
109.1.17.143,<->,27.188.163.162,1,446,0,0,1,446,0.105919000,0.0000
97.68.226.205,<->,96.114.3.72,1,84,0,0,1,84,0.105816000,0.0000
215.158.238.234,<->,215.158.33.114,1,611,0,0,1,611,0.105620000,0.0000
196.242.88.60,<->,136.25.188.238,0,0,1,50,1,50,0.105463000,0.0000
124.58.142.197,<->,8.52.241.18,0,0,1,84,1,84,0.105371000,0.0000
195.55.51.194,<->,136.25.188.238,0,0,1,50,1,50,0.105225000,0.0000
204.63.134.215,<->,136.25.188.252,0,0,1,68,1,68,0.104894000,0.0000
121.242.114.74,<->,80.40.38.153,0,0,1,317,1,317,0.104867000,0.0000
109.51.23.164,<->,8.183.25.124,0,0,1,50,1,50,0.104855000,0.0000
241.193.172.231,<->,20.219.108.42,0,0,1,50,1,50,0.104746000,0.0000
204.140.169.90,<->,0.195.210.44,0,0,1,56,1,56,0.104735000,0.0000
104.209.8.29,<->,20.248.239.41,0,0,1,90,1,90,0.104182000,0.0000
148.145.2.123,<->,101.224.204.141,0,0,1,80,1,80,0.103589000,0.0000
38.21.156.204,<->,20.232.229.47,0,0,1,82,1,82,0.103529000,0.0000
129.31.196.8,<->,95.221.124.146,1,134,0,0,1,134,0.103347000,0.0000
111.20.172.70,<->,33.233.141.35,0,0,1,296,1,296,0.103111000,0.0000
205.127.108.113,<->,33.233.141.32,0,0,1,56,1,56,0.103062000,0.0000
105.201.211.173,<->,100.95.179.115,0,0,1,330,1,330,0.102071000,0.0000
133.20.250.202,<->,8.220.176.253,0,0,1,50,1,50,0.102041000,0.0000
202.33.212.224,<->,136.25.188.238,0,0,1,50,1,50,0.101991000,0.0000
93.104.212.227,<->,39.246.79.110,0,0,1,64,1,64,0.101914000,0.0000
144.86.148.0,<->,97.4.79.164,1,328,0,0,1,328,0.101873000,0.0000
126.155.202.132,<->,20.214.92.24,0,0,1,50,1,50,0.101751000,0.0000
136.25.188.75,<->,111.150.207.148,1,56,0,0,1,56,0.101679000,0.0000
215.158.239.48,<->,195.97.65.194,1,56,0,0,1,56,0.101629000,0.0000
235.231.70.149,<->,89.183.104.182,0,0,1,52,1,52,0.101389000,0.0000
215.158.140.27,<->,118.20.110.35,1,56,0,0,1,56,0.101326000,0.0000
145.16.41.83,<->,120.60.251.7,1,56,0,0,1,56,0.101288000,0.0000
92.27.27.154,<->,66.244.13.112,1,102,0,0,1,102,0.101054000,0.0000
159.69.187.5,<->,144.76.43.238,1,75,0,0,1,75,0.100994000,0.0000
97.168.65.251,<->,54.52.236.37,1,129,0,0,1,129,0.100967000,0.0000
244.50.133.60,<->,39.45.216.66,0,0,1,50,1,50,0.100787000,0.0000
97.125.2.62,<->,20.240.46.64,0,0,1,66,1,66,0.100596000,0.0000
215.158.238.243,<->,143.227.65.227,1,56,0,0,1,56,0.100467000,0.0000
142.252.225.112,<->,136.25.188.222,0,0,1,50,1,50,0.100219000,0.0000
215.158.238.105,<->,61.35.70.251,1,56,0,0,1,56,0.100154000,0.0000
215.158.239.97,<->,196.91.157.53,1,50,0,0,1,50,0.099693000,0.0000
86.194.117.24,<->,0.195.210.24,0,0,1,717,1,717,0.098983000,0.0000
124.42.155.139,<->,8.252.221.171,0,0,1,50,1,50,0.098436000,0.0000
132.249.70.213,<->,101.229.93.37,1,106,0,0,1,106,0.098190000,0.0000
111.20.172.70,<->,33.233.141.41,0,0,1,284,1,284,0.098084000,0.0000
8.188.179.3,<->,8.176.8.68,0,0,1,68,1,68,0.097972000,0.0000
109.222.251.106,<->,93.226.210.241,1,84,0,0,1,84,0.097956000,0.0000
92.27.5.225,<->,6.74.81.60,0,0,1,237,1,237,0.097447000,0.0000
194.234.232.96,<->,136.25.188.198,0,0,1,95,1,95,0.097404000,0.0000
199.72.166.32,<->,136.25.188.239,0,0,1,50,1,50,0.097396000,0.0000
199.5.150.123,<->,50.224.76.235,0,0,1,50,1,50,0.097366000,0.0000
80.41.35.44,<->,54.36.159.13,1,79,0,0,1,79,0.097333000,0.0000
129.236.64.228,<->,129.224.112.252,0,0,1,84,1,84,0.097131000,0.0000
93.181.154.95,<->,92.27.219.189,0,0,1,50,1,50,0.097090000,0.0000
92.27.199.112,<->,34.245.99.16,0,0,1,52,1,52,0.097006000,0.0000
159.69.187.28,<->,144.108.80.170,1,78,0,0,1,78,0.096971000,0.0000
89.183.104.236,<->,57.98.252.180,1,147,0,0,1,147,0.096930000,0.0000
101.81.167.0,<->,89.183.104.186,0,0,1,52,1,52,0.096930000,0.0000
54.37.130.82,<->,48.53.35.207,0,0,1,56,1,56,0.096859000,0.0000
97.126.115.69,<->,46.223.205.111,1,71,0,0,1,71,0.096596000,0.0000
118.213.163.32,<->,92.27.27.177,0,0,1,309,1,309,0.096585000,0.0000
206.195.23.101,<->,192.229.216.117,0,0,1,56,1,56,0.096472000,0.0000
101.67.172.12,<->,8.52.181.95,0,0,1,56,1,56,0.096436000,0.0000
144.75.218.241,<->,132.200.124.228,1,189,0,0,1,189,0.096325000,0.0000
126.198.147.25,<->,111.147.69.132,0,0,1,50,1,50,0.096296000,0.0000
108.134.118.200,<->,106.213.123.64,1,64,0,0,1,64,0.096256000,0.0000
114.94.186.99,<->,20.201.155.120,0,0,1,52,1,52,0.096158000,0.0000
241.193.172.231,<->,20.233.61.248,0,0,1,50,1,50,0.096100000,0.0000
215.158.61.183,<->,8.176.8.186,0,0,1,1098,1,1098,0.095961000,0.0000
210.229.230.18,<->,108.41.145.17,1,50,0,0,1,50,0.095880000,0.0000
124.29.255.45,<->,20.253.243.24,0,0,1,64,1,64,0.095352000,0.0000
199.53.195.53,<->,8.220.176.253,0,0,1,50,1,50,0.095233000,0.0000
109.222.203.196,<->,77.68.220.47,1,74,0,0,1,74,0.095012000,0.0000
210.220.219.151,<->,54.55.66.60,1,56,0,0,1,56,0.095002000,0.0000
109.222.244.223,<->,84.218.178.97,1,66,0,0,1,66,0.094983000,0.0000
133.178.226.200,<->,8.220.7.141,1,163,0,0,1,163,0.094526000,0.0000
111.88.67.250,<->,109.222.230.66,0,0,1,157,1,157,0.094384000,0.0000
193.26.139.230,<->,39.164.72.145,0,0,1,70,1,70,0.094277000,0.0000
80.41.32.57,<->,38.169.20.202,1,80,0,0,1,80,0.094256000,0.0000
247.136.220.38,<->,114.132.145.18,1,52,0,0,1,52,0.094073000,0.0000
215.158.239.182,<->,111.150.82.231,1,56,0,0,1,56,0.093955000,0.0000
132.234.110.226,<->,20.206.36.216,0,0,1,70,1,70,0.093891000,0.0000
199.110.162.183,<->,39.165.126.12,0,0,1,102,1,102,0.093846000,0.0000
132.168.199.107,<->,75.144.222.194,1,75,0,0,1,75,0.093717000,0.0000
215.158.239.92,<->,199.20.29.65,1,172,0,0,1,172,0.093710000,0.0000
215.158.61.242,<->,8.176.8.240,0,0,1,1437,1,1437,0.093618000,0.0000
92.27.219.244,<->,67.240.107.172,1,52,0,0,1,52,0.093319000,0.0000
199.121.82.214,<->,136.25.188.237,0,0,1,50,1,50,0.093181000,0.0000
101.70.105.2,<->,38.70.90.237,1,96,0,0,1,96,0.093023000,0.0000
66.11.237.29,<->,50.149.34.234,1,50,0,0,1,50,0.092891000,0.0000
89.183.104.229,<->,38.64.182.46,1,52,0,0,1,52,0.092500000,0.0000
111.147.177.252,<->,54.69.66.184,1,64,0,0,1,64,0.092382000,0.0000
120.246.27.56,<->,8.252.222.62,0,0,1,50,1,50,0.092309000,0.0000
121.2.160.45,<->,80.42.134.4,0,0,1,130,1,130,0.092237000,0.0000
136.129.54.117,<->,77.11.199.239,1,133,0,0,1,133,0.092190000,0.0000
139.69.162.91,<->,80.56.78.208,0,0,1,82,1,82,0.092168000,0.0000
109.121.30.241,<->,20.218.116.168,0,0,1,89,1,89,0.092151000,0.0000
143.20.74.1,<->,136.25.188.163,0,0,1,56,1,56,0.092148000,0.0000
204.120.45.212,<->,80.38.50.48,0,0,1,50,1,50,0.092146000,0.0000
244.50.229.157,<->,20.84.144.212,0,0,1,50,1,50,0.091750000,0.0000
215.158.238.173,<->,143.155.231.52,1,1135,0,0,1,1135,0.091709000,0.0000
126.146.206.213,<->,20.68.193.137,0,0,1,64,1,64,0.091478000,0.0000
213.186.61.59,<->,144.85.170.246,0,0,1,56,1,56,0.091080000,0.0000
138.127.230.65,<->,97.126.26.70,0,0,1,261,1,261,0.091055000,0.0000
215.158.238.95,<->,128.123.91.58,1,1197,0,0,1,1197,0.090900000,0.0000
123.156.103.111,<->,20.238.136.93,0,0,1,64,1,64,0.090860000,0.0000
210.209.251.214,<->,98.129.107.34,0,0,1,50,1,50,0.090851000,0.0000
145.236.84.182,<->,8.52.180.214,0,0,1,56,1,56,0.090647000,0.0000
112.86.106.238,<->,20.79.120.224,0,0,1,64,1,64,0.090413000,0.0000
253.180.78.131,<->,80.40.3.132,0,0,1,321,1,321,0.090376000,0.0000
207.172.9.243,<->,136.25.188.54,0,0,1,56,1,56,0.090366000,0.0000
198.11.20.6,<->,92.27.219.40,0,0,1,52,1,52,0.090145000,0.0000
197.172.92.167,<->,101.70.105.2,0,0,1,96,1,96,0.090118000,0.0000
204.31.30.117,<->,39.1.151.145,0,0,1,102,1,102,0.090046000,0.0000
215.158.140.13,<->,8.218.118.27,1,1064,0,0,1,1064,0.089981000,0.0000
92.27.219.49,<->,27.233.134.120,1,52,0,0,1,52,0.089979000,0.0000
198.158.197.83,<->,20.203.12.165,0,0,1,50,1,50,0.089959000,0.0000
99.74.26.206,<->,27.2.250.192,1,50,0,0,1,50,0.089935000,0.0000
101.106.122.69,<->,92.27.27.156,0,0,1,138,1,138,0.089807000,0.0000
80.27.158.226,<->,61.51.82.50,1,50,0,0,1,50,0.089759000,0.0000
136.25.188.242,<->,8.220.51.166,1,56,0,0,1,56,0.089551000,0.0000
112.219.43.107,<->,92.162.253.21,0,0,1,50,1,50,0.089454000,0.0000
124.126.187.13,<->,111.20.168.22,0,0,1,50,1,50,0.089093000,0.0000
207.193.105.114,<->,8.182.239.190,0,0,1,50,1,50,0.089031000,0.0000
97.19.21.153,<->,8.182.239.190,0,0,1,56,1,56,0.088936000,0.0000
215.158.238.221,<->,130.13.228.199,1,56,0,0,1,56,0.088886000,0.0000
144.70.164.217,<->,109.222.253.89,0,0,1,68,1,68,0.088434000,0.0000
111.147.135.8,<->,42.68.246.99,1,50,0,0,1,50,0.088362000,0.0000
99.74.26.219,<->,8.191.135.35,1,215,0,0,1,215,0.088328000,0.0000
207.56.177.222,<->,136.25.188.197,0,0,1,56,1,56,0.088322000,0.0000
195.5.127.70,<->,136.25.188.162,0,0,1,50,1,50,0.087982000,0.0000
115.170.188.97,<->,92.27.219.151,0,0,1,64,1,64,0.087975000,0.0000
215.158.3.213,<->,80.56.78.94,0,0,1,87,1,87,0.087726000,0.0000
92.27.219.17,<->,27.187.59.205,1,138,0,0,1,138,0.087665000,0.0000
129.224.112.252,<->,92.162.219.32,1,73,0,0,1,73,0.087646000,0.0000
111.20.172.70,<->,33.233.141.76,0,0,1,307,1,307,0.087567000,0.0000
120.95.205.61,<->,89.183.104.146,0,0,1,102,1,102,0.087524000,0.0000
238.118.126.64,<->,17.197.194.55,1,50,0,0,1,50,0.087503000,0.0000
148.155.131.220,<->,101.224.89.159,0,0,1,161,1,161,0.086594000,0.0000
129.224.112.252,<->,113.24.138.85,1,83,0,0,1,83,0.086548000,0.0000
215.158.140.177,<->,87.63.10.98,1,50,0,0,1,50,0.086484000,0.0000
246.253.168.231,<->,42.32.4.143,1,50,0,0,1,50,0.086455000,0.0000
159.139.136.83,<->,159.109.243.43,0,0,1,52,1,52,0.086364000,0.0000
215.158.238.75,<->,65.27.220.197,1,56,0,0,1,56,0.086028000,0.0000
132.58.234.78,<->,39.255.143.133,0,0,1,66,1,66,0.085964000,0.0000
204.184.230.16,<->,136.25.188.225,0,0,1,50,1,50,0.085595000,0.0000
105.83.153.163,<->,20.206.222.207,0,0,1,64,1,64,0.085586000,0.0000
133.107.19.189,<->,6.74.97.64,0,0,1,56,1,56,0.085473000,0.0000
215.158.239.102,<->,128.156.85.146,1,100,0,0,1,100,0.085469000,0.0000
207.59.241.51,<->,136.25.188.220,0,0,1,68,1,68,0.085249000,0.0000
195.159.251.156,<->,50.224.76.234,0,0,1,50,1,50,0.085202000,0.0000
246.253.252.62,<->,241.19.79.118,1,132,0,0,1,132,0.084945000,0.0000
195.55.42.78,<->,136.25.188.252,0,0,1,50,1,50,0.084861000,0.0000
215.158.239.97,<->,199.20.7.168,1,781,0,0,1,781,0.084814000,0.0000
215.158.239.48,<->,199.20.31.208,1,50,0,0,1,50,0.084804000,0.0000
131.99.146.125,<->,50.224.76.234,0,0,1,50,1,50,0.084767000,0.0000
125.155.221.2,<->,109.1.15.101,0,0,1,56,1,56,0.084759000,0.0000
215.158.239.58,<->,195.41.216.49,1,84,0,0,1,84,0.084565000,0.0000
195.1.224.116,<->,102.51.8.102,0,0,1,138,1,138,0.084481000,0.0000
143.135.156.251,<->,136.25.188.176,0,0,1,50,1,50,0.084453000,0.0000
215.158.239.231,<->,192.171.13.190,1,120,0,0,1,120,0.084395000,0.0000
117.35.54.124,<->,8.182.136.93,0,0,1,50,1,50,0.084386000,0.0000
210.209.251.223,<->,111.147.202.234,0,0,1,481,1,481,0.084307000,0.0000
200.174.220.128,<->,54.58.199.145,1,50,0,0,1,50,0.084201000,0.0000
92.27.219.160,<->,29.27.248.15,1,52,0,0,1,52,0.083898000,0.0000
136.25.189.80,<->,119.196.23.43,1,56,0,0,1,56,0.083801000,0.0000
111.199.226.46,<->,0.195.210.44,0,0,1,109,1,109,0.083711000,0.0000
136.25.189.80,<->,126.219.191.38,1,56,0,0,1,56,0.083700000,0.0000
215.201.235.99,<->,8.182.226.78,0,0,1,50,1,50,0.083664000,0.0000
215.158.239.92,<->,199.20.30.138,1,56,0,0,1,56,0.083354000,0.0000
105.83.153.163,<->,20.206.222.1,0,0,1,64,1,64,0.083270000,0.0000
198.74.128.204,<->,20.243.162.197,0,0,1,52,1,52,0.083220000,0.0000
215.158.239.32,<->,131.95.192.199,1,56,0,0,1,56,0.083195000,0.0000
136.25.189.14,<->,120.154.221.252,1,56,0,0,1,56,0.083171000,0.0000
145.5.113.114,<->,8.182.253.100,0,0,1,50,1,50,0.083106000,0.0000
215.158.239.48,<->,196.90.26.87,1,717,0,0,1,717,0.082790000,0.0000
246.253.253.230,<->,100.225.82.253,1,91,0,0,1,91,0.082691000,0.0000
96.38.142.249,<->,8.52.255.8,0,0,1,84,1,84,0.082673000,0.0000
109.222.255.7,<->,41.241.188.79,1,78,0,0,1,78,0.082529000,0.0000
192.227.191.239,<->,133.178.227.242,0,0,1,56,1,56,0.082502000,0.0000
230.126.147.103,<->,192.67.182.164,0,0,1,133,1,133,0.082362000,0.0000
142.229.118.185,<->,136.25.188.239,0,0,1,50,1,50,0.082003000,0.0000
140.55.246.203,<->,16.139.9.35,0,0,1,52,1,52,0.081789000,0.0000
89.183.104.181,<->,42.204.53.59,1,326,0,0,1,326,0.081645000,0.0000
111.20.172.70,<->,33.233.141.119,0,0,1,293,1,293,0.081371000,0.0000
195.5.127.29,<->,136.25.188.163,0,0,1,50,1,50,0.081234000,0.0000
199.73.151.138,<->,136.25.188.238,0,0,1,56,1,56,0.081103000,0.0000
131.99.146.125,<->,50.224.76.230,0,0,1,50,1,50,0.080939000,0.0000
221.102.122.48,<->,199.12.96.54,1,50,0,0,1,50,0.080931000,0.0000
99.247.176.88,<->,8.228.219.4,0,0,1,147,1,147,0.080876000,0.0000
246.254.97.229,<->,143.31.209.136,1,50,0,0,1,50,0.080771000,0.0000
146.154.165.212,<->,39.144.112.17,0,0,1,60,1,60,0.080492000,0.0000
198.213.121.62,<->,50.224.76.230,0,0,1,50,1,50,0.080476000,0.0000
240.140.135.61,<->,145.252.115.55,0,0,1,50,1,50,0.080189000,0.0000
207.58.174.160,<->,136.25.188.242,0,0,1,50,1,50,0.080036000,0.0000
159.23.227.132,<->,117.16.217.37,1,76,0,0,1,76,0.080021000,0.0000
229.42.57.91,<->,89.183.104.182,0,0,1,52,1,52,0.079936000,0.0000
238.168.14.0,<->,50.224.75.42,0,0,1,52,1,52,0.079539000,0.0000
199.39.106.105,<->,136.25.188.253,0,0,1,56,1,56,0.079444000,0.0000
144.71.45.37,<->,42.68.246.99,1,50,0,0,1,50,0.079384000,0.0000
53.167.183.229,<->,48.52.71.6,0,0,1,56,1,56,0.079321000,0.0000
204.180.152.126,<->,20.174.114.169,0,0,1,103,1,103,0.079174000,0.0000
139.193.141.139,<->,117.1.190.190,1,50,0,0,1,50,0.078903000,0.0000
192.229.40.101,<->,133.178.226.95,0,0,1,84,1,84,0.078651000,0.0000
254.48.52.89,<->,89.183.104.189,0,0,1,52,1,52,0.078630000,0.0000
207.60.52.5,<->,136.25.188.255,0,0,1,50,1,50,0.078436000,0.0000
140.91.153.138,<->,100.224.209.64,0,0,1,50,1,50,0.078157000,0.0000
92.168.217.241,<->,50.136.145.104,1,56,0,0,1,56,0.077988000,0.0000
131.224.216.95,<->,89.183.104.135,0,0,1,52,1,52,0.077883000,0.0000
195.43.40.193,<->,136.25.188.225,0,0,1,56,1,56,0.077728000,0.0000
220.20.200.182,<->,193.19.70.184,1,50,0,0,1,50,0.077595000,0.0000
92.27.219.233,<->,38.87.96.19,1,50,0,0,1,50,0.077301000,0.0000
53.231.85.150,<->,33.233.141.20,0,0,1,50,1,50,0.077290000,0.0000
197.109.193.7,<->,136.25.188.177,0,0,1,56,1,56,0.077186000,0.0000
235.37.190.233,<->,136.25.189.15,0,0,1,56,1,56,0.077097000,0.0000
136.25.188.198,<->,111.78.214.43,1,157,0,0,1,157,0.077006000,0.0000
131.22.101.89,<->,92.162.253.4,0,0,1,50,1,50,0.076967000,0.0000
88.122.137.238,<->,0.195.210.46,0,0,1,1373,1,1373,0.076615000,0.0000
131.226.206.47,<->,39.32.114.93,0,0,1,70,1,70,0.076548000,0.0000
144.75.218.237,<->,138.127.224.171,1,254,0,0,1,254,0.076493000,0.0000
138.127.224.104,<->,101.224.89.252,0,0,1,293,1,293,0.076285000,0.0000
111.150.207.239,<->,8.252.221.195,0,0,1,100,1,100,0.076167000,0.0000
98.230.204.162,<->,8.252.223.192,0,0,1,50,1,50,0.076113000,0.0000
124.29.255.45,<->,20.253.243.48,0,0,1,64,1,64,0.075982000,0.0000
220.20.200.134,<->,131.45.239.182,1,327,0,0,1,327,0.075960000,0.0000
194.210.233.110,<->,8.252.222.151,0,0,1,56,1,56,0.075884000,0.0000
137.137.103.117,<->,123.212.48.165,1,85,0,0,1,85,0.075537000,0.0000
192.67.149.158,<->,105.185.224.18,1,130,0,0,1,130,0.075250000,0.0000
254.242.184.11,<->,57.50.25.229,1,50,0,0,1,50,0.075221000,0.0000
144.75.218.242,<->,138.127.231.72,1,168,0,0,1,168,0.075128000,0.0000
215.158.239.86,<->,143.79.181.170,1,50,0,0,1,50,0.074858000,0.0000
205.42.126.9,<->,39.206.191.193,0,0,1,60,1,60,0.074633000,0.0000
106.224.70.18,<->,20.57.168.150,0,0,1,64,1,64,0.074617000,0.0000
201.223.146.32,<->,92.27.27.153,0,0,1,52,1,52,0.074335000,0.0000
201.8.175.76,<->,8.228.214.59,0,0,1,120,1,120,0.074160000,0.0000
215.158.239.56,<->,207.61.18.136,1,50,0,0,1,50,0.074053000,0.0000
201.216.164.96,<->,39.2.106.224,0,0,1,64,1,64,0.073986000,0.0000
138.127.225.208,<->,111.20.168.13,0,0,1,232,1,232,0.073824000,0.0000
215.158.238.177,<->,149.254.114.43,1,56,0,0,1,56,0.073774000,0.0000
204.90.255.169,<->,8.52.135.156,0,0,1,95,1,95,0.073487000,0.0000
124.29.255.45,<->,20.253.243.32,0,0,1,64,1,64,0.073329000,0.0000
199.120.234.16,<->,136.25.188.243,0,0,1,56,1,56,0.073271000,0.0000
54.37.127.247,<->,8.30.100.213,0,0,1,604,1,604,0.073093000,0.0000
210.229.230.18,<->,50.183.243.254,1,50,0,0,1,50,0.072998000,0.0000
97.126.26.70,<->,80.56.76.30,1,114,0,0,1,114,0.072685000,0.0000
111.199.231.97,<->,0.195.210.44,0,0,1,56,1,56,0.072626000,0.0000
80.41.53.160,<->,57.123.246.235,1,135,0,0,1,135,0.072383000,0.0000
196.88.204.180,<->,136.25.188.208,0,0,1,56,1,56,0.072310000,0.0000
101.73.153.37,<->,4.9.45.56,1,68,0,0,1,68,0.072196000,0.0000
199.81.87.108,<->,136.25.188.225,0,0,1,89,1,89,0.071978000,0.0000
220.20.200.119,<->,144.83.60.153,1,50,0,0,1,50,0.071943000,0.0000
215.201.233.114,<->,8.182.226.78,0,0,1,50,1,50,0.071906000,0.0000
105.67.124.147,<->,8.52.165.247,0,0,1,75,1,75,0.071906000,0.0000
21.15.226.126,<->,20.193.41.106,0,0,1,82,1,82,0.071531000,0.0000
246.108.203.212,<->,100.95.63.33,0,0,1,56,1,56,0.071516000,0.0000
144.89.109.66,<->,101.224.89.159,0,0,1,50,1,50,0.071475000,0.0000
144.75.218.246,<->,138.127.224.113,1,365,0,0,1,365,0.071463000,0.0000
129.236.100.150,<->,129.224.112.252,0,0,1,77,1,77,0.071433000,0.0000
109.1.100.42,<->,8.45.162.111,1,286,0,0,1,286,0.071350000,0.0000
136.25.189.86,<->,29.214.109.249,1,84,0,0,1,84,0.071007000,0.0000
215.158.239.84,<->,199.20.30.67,1,56,0,0,1,56,0.070911000,0.0000
132.18.67.31,<->,102.50.89.121,0,0,1,50,1,50,0.070729000,0.0000
136.18.96.147,<->,8.182.250.109,0,0,1,50,1,50,0.070667000,0.0000
210.220.219.152,<->,53.231.146.1,1,50,0,0,1,50,0.070654000,0.0000
17.41.77.129,<->,8.220.200.124,0,0,1,56,1,56,0.070564000,0.0000
144.122.240.221,<->,144.108.80.170,1,69,0,0,1,69,0.070315000,0.0000
93.90.120.100,<->,20.43.161.228,0,0,1,64,1,64,0.070153000,0.0000
94.192.177.152,<->,8.252.221.231,0,0,1,56,1,56,0.070118000,0.0000
216.39.137.168,<->,137.137.71.215,0,0,1,56,1,56,0.070078000,0.0000
135.251.133.132,<->,92.27.219.148,0,0,1,80,1,80,0.069918000,0.0000
215.158.239.48,<->,195.54.43.34,1,50,0,0,1,50,0.069639000,0.0000
193.89.192.220,<->,92.27.27.178,0,0,1,50,1,50,0.069275000,0.0000
139.193.141.139,<->,125.193.130.129,1,50,0,0,1,50,0.069262000,0.0000
144.75.218.233,<->,99.187.128.217,1,203,0,0,1,203,0.069175000,0.0000
117.83.36.110,<->,80.42.160.210,0,0,1,52,1,52,0.069048000,0.0000
232.31.69.92,<->,102.50.26.134,0,0,1,56,1,56,0.068572000,0.0000
195.40.118.199,<->,136.25.188.225,0,0,1,56,1,56,0.068426000,0.0000
145.252.120.50,<->,117.37.105.131,1,56,0,0,1,56,0.068399000,0.0000
54.49.150.11,<->,8.228.218.170,0,0,1,64,1,64,0.068371000,0.0000
76.170.179.103,<->,20.199.76.165,0,0,1,52,1,52,0.068280000,0.0000
202.33.250.150,<->,136.25.188.220,0,0,1,50,1,50,0.068234000,0.0000
109.1.34.223,<->,27.150.244.150,1,334,0,0,1,334,0.068127000,0.0000
138.127.225.202,<->,101.224.89.180,0,0,1,282,1,282,0.068027000,0.0000
204.186.80.166,<->,136.25.188.174,0,0,1,101,1,101,0.067841000,0.0000
196.28.164.84,<->,99.72.132.173,0,0,1,62,1,62,0.067486000,0.0000
109.222.251.123,<->,108.242.8.175,1,73,0,0,1,73,0.067410000,0.0000
197.57.227.125,<->,20.121.29.24,0,0,1,74,1,74,0.067369000,0.0000
133.178.227.79,<->,119.168.0.155,1,56,0,0,1,56,0.067240000,0.0000
126.198.147.25,<->,100.92.87.243,0,0,1,50,1,50,0.067039000,0.0000
204.3.67.2,<->,136.25.188.176,0,0,1,378,1,378,0.066977000,0.0000
138.127.224.104,<->,111.20.168.154,0,0,1,276,1,276,0.066946000,0.0000
80.42.160.104,<->,40.221.184.1,1,50,0,0,1,50,0.066645000,0.0000
86.194.115.29,<->,0.195.210.24,0,0,1,56,1,56,0.066584000,0.0000
136.25.188.106,<->,26.180.89.62,1,60,0,0,1,60,0.066477000,0.0000
142.255.47.112,<->,136.25.188.198,0,0,1,50,1,50,0.066377000,0.0000
148.88.242.247,<->,97.126.119.99,0,0,1,50,1,50,0.066273000,0.0000
97.173.75.108,<->,39.200.99.27,0,0,1,64,1,64,0.066113000,0.0000
144.76.46.38,<->,99.75.159.71,0,0,1,129,1,129,0.066082000,0.0000
224.33.81.238,<->,80.41.32.204,0,0,1,89,1,89,0.066077000,0.0000
215.158.103.206,<->,158.225.58.19,1,126,0,0,1,126,0.066011000,0.0000
220.55.88.235,<->,0.34.90.181,1,50,0,0,1,50,0.065947000,0.0000
75.62.16.8,<->,39.29.12.30,0,0,1,50,1,50,0.065836000,0.0000
109.222.213.122,<->,90.150.165.141,1,65,0,0,1,65,0.065666000,0.0000
133.178.226.168,<->,8.58.230.11,1,84,0,0,1,84,0.065563000,0.0000
215.158.239.79,<->,199.39.169.154,1,50,0,0,1,50,0.065523000,0.0000
109.222.251.123,<->,79.202.246.0,1,73,0,0,1,73,0.065467000,0.0000
138.127.224.225,<->,33.233.141.39,0,0,1,234,1,234,0.065286000,0.0000
135.243.190.253,<->,8.52.136.12,0,0,1,50,1,50,0.065274000,0.0000
219.228.243.244,<->,39.9.237.181,0,0,1,64,1,64,0.065249000,0.0000
215.158.140.201,<->,113.23.45.203,1,56,0,0,1,56,0.065132000,0.0000
192.67.186.29,<->,38.172.241.11,1,50,0,0,1,50,0.065048000,0.0000
195.43.201.16,<->,136.25.188.243,0,0,1,107,1,107,0.064787000,0.0000
145.242.126.223,<->,6.94.58.6,1,80,0,0,1,80,0.064703000,0.0000
207.172.99.178,<->,136.25.188.236,0,0,1,56,1,56,0.064619000,0.0000
143.135.56.17,<->,136.25.188.177,0,0,1,50,1,50,0.064500000,0.0000
89.183.104.178,<->,27.122.135.142,1,52,0,0,1,52,0.064436000,0.0000
129.236.100.68,<->,129.224.112.252,0,0,1,70,1,70,0.064417000,0.0000
144.75.218.242,<->,138.127.230.104,1,257,0,0,1,257,0.064398000,0.0000
215.158.140.75,<->,8.241.233.108,1,56,0,0,1,56,0.064349000,0.0000
111.20.172.70,<->,33.233.141.75,0,0,1,292,1,292,0.064163000,0.0000
50.159.31.45,<->,8.250.152.227,0,0,1,84,1,84,0.064139000,0.0000
197.161.214.193,<->,136.25.188.225,0,0,1,87,1,87,0.064125000,0.0000
138.127.225.117,<->,101.224.89.159,0,0,1,167,1,167,0.064071000,0.0000
159.137.162.213,<->,29.93.19.133,1,50,0,0,1,50,0.063935000,0.0000
202.33.57.137,<->,136.25.188.227,0,0,1,56,1,56,0.063917000,0.0000
199.71.17.91,<->,136.25.188.253,0,0,1,56,1,56,0.063799000,0.0000
140.151.234.76,<->,8.220.176.253,0,0,1,50,1,50,0.063782000,0.0000
210.229.230.20,<->,101.195.19.4,1,50,0,0,1,50,0.063732000,0.0000
133.178.226.28,<->,69.150.169.227,1,56,0,0,1,56,0.063630000,0.0000
198.180.230.241,<->,92.27.219.193,0,0,1,106,1,106,0.063408000,0.0000
215.158.239.7,<->,158.166.175.233,1,68,0,0,1,68,0.063398000,0.0000
194.238.204.43,<->,136.25.188.197,0,0,1,50,1,50,0.063188000,0.0000
89.183.104.153,<->,30.58.151.59,1,100,0,0,1,100,0.063128000,0.0000
215.158.239.69,<->,199.20.31.156,1,56,0,0,1,56,0.063033000,0.0000
204.200.61.167,<->,136.25.188.177,0,0,1,132,1,132,0.062846000,0.0000
129.236.64.99,<->,129.224.112.221,0,0,1,76,1,76,0.062762000,0.0000
139.114.178.207,<->,102.50.202.136,0,0,1,116,1,116,0.062739000,0.0000
206.96.224.104,<->,89.183.104.151,0,0,1,135,1,135,0.062672000,0.0000
17.97.9.35,<->,8.52.173.56,0,0,1,84,1,84,0.062421000,0.0000
101.87.46.107,<->,8.220.201.13,0,0,1,84,1,84,0.062160000,0.0000
144.122.240.202,<->,144.108.64.183,1,64,0,0,1,64,0.061969000,0.0000
247.136.226.75,<->,198.251.121.255,1,135,0,0,1,135,0.061834000,0.0000
224.250.64.86,<->,100.95.6.174,0,0,1,50,1,50,0.061783000,0.0000
133.178.227.208,<->,131.36.201.103,1,894,0,0,1,894,0.061692000,0.0000
104.146.72.62,<->,92.27.219.226,0,0,1,56,1,56,0.061679000,0.0000
215.158.238.163,<->,111.151.106.211,1,100,0,0,1,100,0.061553000,0.0000
66.222.225.226,<->,6.74.208.29,0,0,1,130,1,130,0.061459000,0.0000
207.57.143.124,<->,136.25.188.255,0,0,1,95,1,95,0.061170000,0.0000
204.184.245.201,<->,136.25.188.220,0,0,1,56,1,56,0.060908000,0.0000
129.31.169.101,<->,8.182.226.78,0,0,1,50,1,50,0.060867000,0.0000
215.158.239.49,<->,196.104.19.240,1,64,0,0,1,64,0.060795000,0.0000
215.158.239.86,<->,199.69.105.180,1,50,0,0,1,50,0.060590000,0.0000
194.233.238.26,<->,136.25.188.175,0,0,1,56,1,56,0.060332000,0.0000
241.193.172.231,<->,20.131.200.206,0,0,1,50,1,50,0.060077000,0.0000
195.13.165.40,<->,136.25.188.198,0,0,1,68,1,68,0.060036000,0.0000
132.136.198.112,<->,0.220.33.65,1,50,0,0,1,50,0.059725000,0.0000
97.126.18.231,<->,68.208.243.152,1,50,0,0,1,50,0.059693000,0.0000
207.190.81.59,<->,50.224.76.235,0,0,1,50,1,50,0.059667000,0.0000
111.199.228.85,<->,0.195.210.44,0,0,1,56,1,56,0.059659000,0.0000
111.150.207.194,<->,8.252.221.118,0,0,1,100,1,100,0.059591000,0.0000
215.158.239.76,<->,202.33.2.145,1,56,0,0,1,56,0.059534000,0.0000
149.96.34.220,<->,20.105.217.52,0,0,1,118,1,118,0.059156000,0.0000
143.87.163.0,<->,136.25.188.53,0,0,1,68,1,68,0.058843000,0.0000
129.236.64.112,<->,129.224.112.252,0,0,1,76,1,76,0.058789000,0.0000
207.59.140.137,<->,136.25.188.177,0,0,1,95,1,95,0.058777000,0.0000
127.126.131.122,<->,20.148.248.209,0,0,1,52,1,52,0.058584000,0.0000
221.102.122.48,<->,199.12.98.116,1,50,0,0,1,50,0.058150000,0.0000
207.86.52.114,<->,91.231.193.200,0,0,1,50,1,50,0.058085000,0.0000
82.89.66.196,<->,50.224.76.234,0,0,1,50,1,50,0.058033000,0.0000
136.25.189.46,<->,113.23.100.180,1,56,0,0,1,56,0.057956000,0.0000
246.254.97.112,<->,53.69.153.116,1,56,0,0,1,56,0.057868000,0.0000
149.13.40.114,<->,50.224.76.235,0,0,1,56,1,56,0.057847000,0.0000
148.249.196.8,<->,137.109.229.242,0,0,1,52,1,52,0.057700000,0.0000
215.158.239.99,<->,204.0.175.239,1,1098,0,0,1,1098,0.057612000,0.0000
203.215.167.155,<->,142.172.153.106,1,64,0,0,1,64,0.057444000,0.0000
6.20.51.6,<->,0.195.210.44,0,0,1,56,1,56,0.057354000,0.0000
142.190.104.227,<->,136.25.188.226,0,0,1,84,1,84,0.057182000,0.0000
215.158.239.68,<->,199.20.29.127,1,50,0,0,1,50,0.056598000,0.0000
141.108.233.205,<->,8.176.8.219,0,0,1,1082,1,1082,0.056517000,0.0000
144.75.218.235,<->,99.197.78.193,1,76,0,0,1,76,0.056451000,0.0000
210.220.219.152,<->,8.35.106.57,1,83,0,0,1,83,0.056139000,0.0000
144.75.218.235,<->,132.234.109.230,1,150,0,0,1,150,0.056129000,0.0000
215.158.239.56,<->,199.80.82.109,1,56,0,0,1,56,0.056113000,0.0000
96.34.114.194,<->,8.220.180.184,0,0,1,50,1,50,0.056030000,0.0000
53.213.200.116,<->,48.53.34.86,0,0,1,285,1,285,0.055989000,0.0000
215.158.239.95,<->,57.226.224.43,1,56,0,0,1,56,0.055841000,0.0000
159.69.187.47,<->,144.108.64.184,1,62,0,0,1,62,0.055763000,0.0000
247.136.188.124,<->,33.250.131.215,1,373,0,0,1,373,0.055752000,0.0000
247.136.178.211,<->,61.58.39.197,1,317,0,0,1,317,0.055699000,0.0000
111.20.172.70,<->,33.233.141.40,0,0,1,146,1,146,0.055538000,0.0000
110.55.186.175,<->,92.27.219.129,0,0,1,79,1,79,0.055352000,0.0000
215.158.239.79,<->,199.20.30.140,1,56,0,0,1,56,0.054962000,0.0000
75.62.16.8,<->,39.39.110.175,0,0,1,50,1,50,0.054875000,0.0000
215.158.140.173,<->,98.249.65.8,1,50,0,0,1,50,0.054703000,0.0000
148.155.131.234,<->,101.224.89.208,0,0,1,166,1,166,0.054612000,0.0000
92.162.218.84,<->,50.224.121.36,0,0,1,50,1,50,0.054507000,0.0000
50.224.105.33,<->,6.145.169.226,1,56,0,0,1,56,0.053880000,0.0000
137.33.165.19,<->,39.14.27.228,0,0,1,238,1,238,0.053543000,0.0000
215.158.239.56,<->,199.20.101.65,1,50,0,0,1,50,0.053317000,0.0000
224.93.235.34,<->,80.27.157.15,0,0,1,50,1,50,0.053049000,0.0000
92.27.219.246,<->,27.67.139.81,1,110,0,0,1,110,0.052915000,0.0000
152.11.32.140,<->,20.98.136.44,0,0,1,64,1,64,0.052910000,0.0000
192.67.190.59,<->,97.94.179.54,1,50,0,0,1,50,0.052844000,0.0000
241.193.172.231,<->,20.98.73.65,0,0,1,50,1,50,0.052799000,0.0000
215.158.239.223,<->,33.209.217.191,1,78,0,0,1,78,0.052775000,0.0000
106.217.197.232,<->,92.168.217.209,0,0,1,56,1,56,0.052683000,0.0000
192.67.190.240,<->,8.45.168.98,1,56,0,0,1,56,0.052566000,0.0000
144.86.148.17,<->,84.214.213.193,1,50,0,0,1,50,0.052469000,0.0000
74.143.26.226,<->,8.252.221.197,0,0,1,56,1,56,0.052425000,0.0000
239.190.195.116,<->,101.70.99.237,0,0,1,50,1,50,0.052321000,0.0000
117.37.43.86,<->,8.31.37.169,0,0,1,56,1,56,0.052246000,0.0000
221.102.102.139,<->,98.230.209.119,1,50,0,0,1,50,0.052044000,0.0000
27.230.11.180,<->,20.5.47.3,0,0,1,50,1,50,0.051887000,0.0000
138.98.183.177,<->,98.219.124.106,1,50,0,0,1,50,0.051802000,0.0000
136.25.188.255,<->,102.125.119.60,1,50,0,0,1,50,0.051526000,0.0000
203.94.130.122,<->,0.195.210.46,0,0,1,50,1,50,0.051515000,0.0000
88.122.47.230,<->,39.30.11.251,0,0,1,64,1,64,0.051472000,0.0000
192.67.146.217,<->,115.222.251.133,1,97,0,0,1,97,0.051329000,0.0000
111.150.206.32,<->,80.56.78.92,0,0,1,86,1,86,0.051131000,0.0000
114.75.170.84,<->,8.52.223.67,0,0,1,56,1,56,0.051093000,0.0000
215.158.140.27,<->,133.147.123.25,1,56,0,0,1,56,0.051074000,0.0000
39.34.74.140,<->,33.223.161.138,1,52,0,0,1,52,0.051002000,0.0000
241.193.172.231,<->,20.200.185.178,0,0,1,50,1,50,0.050777000,0.0000
215.158.238.132,<->,122.158.49.151,1,56,0,0,1,56,0.050677000,0.0000
159.140.232.210,<->,48.53.178.47,0,0,1,50,1,50,0.050334000,0.0000
197.120.231.194,<->,129.224.112.252,0,0,1,83,1,83,0.050202000,0.0000
215.207.149.203,<->,33.233.141.24,0,0,1,66,1,66,0.050180000,0.0000
144.75.218.242,<->,138.127.225.48,1,168,0,0,1,168,0.050091000,0.0000
111.20.172.70,<->,33.233.141.12,0,0,1,286,1,286,0.049993000,0.0000
57.94.149.86,<->,20.20.217.100,0,0,1,78,1,78,0.049851000,0.0000
129.236.111.95,<->,129.224.112.252,0,0,1,88,1,88,0.049469000,0.0000
138.127.225.156,<->,101.224.89.208,0,0,1,341,1,341,0.049428000,0.0000
204.200.57.107,<->,136.25.188.162,0,0,1,56,1,56,0.049296000,0.0000
126.213.42.171,<->,8.228.218.69,0,0,1,133,1,133,0.049063000,0.0000
92.27.194.117,<->,88.156.237.207,1,50,0,0,1,50,0.048948000,0.0000
139.163.26.146,<->,117.25.85.194,1,111,0,0,1,111,0.048888000,0.0000
246.253.198.51,<->,117.152.68.95,1,50,0,0,1,50,0.048862000,0.0000
39.197.184.38,<->,38.188.127.90,1,64,0,0,1,64,0.048799000,0.0000
139.241.56.147,<->,136.25.189.52,0,0,1,509,1,509,0.048695000,0.0000
215.158.239.110,<->,109.126.137.238,1,50,0,0,1,50,0.048562000,0.0000
93.224.24.248,<->,89.183.104.189,0,0,1,52,1,52,0.048469000,0.0000
38.188.127.67,<->,20.26.255.98,0,0,1,64,1,64,0.048457000,0.0000
215.158.239.50,<->,207.228.196.160,1,378,0,0,1,378,0.048365000,0.0000
207.191.135.197,<->,136.25.188.242,0,0,1,50,1,50,0.048241000,0.0000
199.33.127.244,<->,136.25.188.241,0,0,1,68,1,68,0.048143000,0.0000
6.145.169.65,<->,0.195.210.44,0,0,1,56,1,56,0.048076000,0.0000
38.21.156.204,<->,20.232.229.18,0,0,1,82,1,82,0.048049000,0.0000
53.148.184.48,<->,48.54.187.73,0,0,1,56,1,56,0.047900000,0.0000
21.15.226.126,<->,20.193.41.28,0,0,1,82,1,82,0.047804000,0.0000
129.236.64.50,<->,129.224.112.252,0,0,1,75,1,75,0.047789000,0.0000
92.27.219.229,<->,78.44.86.74,1,56,0,0,1,56,0.047433000,0.0000
119.219.97.10,<->,101.224.204.141,0,0,1,80,1,80,0.047395000,0.0000
230.57.2.170,<->,39.3.0.248,0,0,1,68,1,68,0.047334000,0.0000
105.251.93.143,<->,50.224.111.129,0,0,1,66,1,66,0.047332000,0.0000
126.198.149.124,<->,111.146.198.228,0,0,1,50,1,50,0.047208000,0.0000
120.23.198.205,<->,39.54.209.228,0,0,1,52,1,52,0.046932000,0.0000
195.15.2.61,<->,136.25.188.242,0,0,1,56,1,56,0.046889000,0.0000
98.32.6.84,<->,8.220.176.253,0,0,1,50,1,50,0.046798000,0.0000
215.158.239.50,<->,195.40.235.29,1,68,0,0,1,68,0.046577000,0.0000
215.158.239.48,<->,196.109.95.126,1,50,0,0,1,50,0.046274000,0.0000
215.158.239.56,<->,207.236.219.181,1,50,0,0,1,50,0.046242000,0.0000
244.50.133.60,<->,39.247.199.161,0,0,1,50,1,50,0.046202000,0.0000
138.121.99.24,<->,8.220.191.251,0,0,1,50,1,50,0.045941000,0.0000
159.69.187.19,<->,144.108.64.184,1,66,0,0,1,66,0.045900000,0.0000
127.52.61.99,<->,89.183.111.52,0,0,1,56,1,56,0.045882000,0.0000
91.250.143.162,<->,39.222.80.63,0,0,1,50,1,50,0.045771000,0.0000
194.244.97.62,<->,20.98.98.52,0,0,1,80,1,80,0.045710000,0.0000
136.129.112.99,<->,8.52.185.88,0,0,1,50,1,50,0.045660000,0.0000
221.102.104.221,<->,158.236.141.190,1,84,0,0,1,84,0.045528000,0.0000
50.224.80.229,<->,50.224.13.98,1,100,0,0,1,100,0.045479000,0.0000
203.118.37.242,<->,92.27.219.243,0,0,1,52,1,52,0.045414000,0.0000
89.183.111.52,<->,33.150.36.202,1,56,0,0,1,56,0.045336000,0.0000
199.82.200.8,<->,136.25.188.252,0,0,1,50,1,50,0.045278000,0.0000
195.50.57.207,<->,39.13.86.159,0,0,1,52,1,52,0.045195000,0.0000
115.81.129.57,<->,89.183.104.252,0,0,1,62,1,62,0.044953000,0.0000
207.172.118.35,<->,136.25.188.222,0,0,1,56,1,56,0.044931000,0.0000
129.236.111.81,<->,129.224.112.252,0,0,1,75,1,75,0.044884000,0.0000
206.243.231.162,<->,97.168.64.127,0,0,1,113,1,113,0.044393000,0.0000
148.155.130.96,<->,101.224.89.251,0,0,1,174,1,174,0.044262000,0.0000
204.98.37.240,<->,39.41.183.33,0,0,1,100,1,100,0.044170000,0.0000
39.56.199.171,<->,33.98.176.141,1,52,0,0,1,52,0.043680000,0.0000
195.4.81.167,<->,20.108.206.120,0,0,1,98,1,98,0.043472000,0.0000
138.127.225.152,<->,33.233.141.97,0,0,1,246,1,246,0.043202000,0.0000
158.55.120.187,<->,144.75.218.235,0,0,1,150,1,150,0.043020000,0.0000
144.75.218.246,<->,100.185.121.91,1,85,0,0,1,85,0.042710000,0.0000
205.225.112.16,<->,129.187.6.142,0,0,1,50,1,50,0.042693000,0.0000
33.74.131.244,<->,20.89.152.184,0,0,1,64,1,64,0.042574000,0.0000
93.104.212.227,<->,39.246.79.128,0,0,1,64,1,64,0.042566000,0.0000
122.212.65.37,<->,89.183.104.252,0,0,1,52,1,52,0.042442000,0.0000
215.158.239.92,<->,204.0.204.92,1,50,0,0,1,50,0.042087000,0.0000
230.91.134.56,<->,109.3.162.222,0,0,1,133,1,133,0.042042000,0.0000
192.64.199.47,<->,105.227.214.36,1,52,0,0,1,52,0.042021000,0.0000
231.140.124.238,<->,136.25.188.242,0,0,1,50,1,50,0.041912000,0.0000
199.111.80.248,<->,8.182.241.177,0,0,1,50,1,50,0.041856000,0.0000
142.191.72.236,<->,136.25.188.177,0,0,1,50,1,50,0.041793000,0.0000
143.204.138.236,<->,136.25.188.105,0,0,1,125,1,125,0.041687000,0.0000
138.127.224.59,<->,33.233.141.88,0,0,1,249,1,249,0.041619000,0.0000
80.27.154.173,<->,79.56.125.14,1,56,0,0,1,56,0.041489000,0.0000
98.67.154.211,<->,54.55.213.137,1,76,0,0,1,76,0.041439000,0.0000
207.56.239.88,<->,136.25.188.236,0,0,1,50,1,50,0.041270000,0.0000
247.136.151.26,<->,64.214.35.158,1,135,0,0,1,135,0.041176000,0.0000
66.193.249.94,<->,34.154.0.26,0,0,1,66,1,66,0.041145000,0.0000
204.251.31.203,<->,137.21.18.224,0,0,1,1424,1,1424,0.041118000,0.0000
218.81.246.221,<->,8.220.178.216,0,0,1,56,1,56,0.040871000,0.0000
92.27.219.236,<->,33.57.77.185,1,50,0,0,1,50,0.040657000,0.0000
39.161.26.72,<->,27.223.232.148,1,64,0,0,1,64,0.040347000,0.0000
199.12.125.72,<->,20.11.148.194,0,0,1,64,1,64,0.040318000,0.0000
148.157.229.161,<->,144.75.218.241,0,0,1,60,1,60,0.040010000,0.0000
246.253.253.209,<->,142.232.107.172,1,221,0,0,1,221,0.039768000,0.0000
144.83.60.153,<->,92.162.253.125,0,0,1,626,1,626,0.039238000,0.0000
139.148.100.213,<->,8.182.239.241,0,0,1,56,1,56,0.039070000,0.0000
136.25.188.199,<->,30.73.130.54,1,50,0,0,1,50,0.039037000,0.0000
210.229.230.21,<->,133.255.149.89,1,50,0,0,1,50,0.038961000,0.0000
144.75.218.241,<->,138.127.225.194,1,238,0,0,1,238,0.038823000,0.0000
120.224.238.228,<->,20.142.137.62,0,0,1,126,1,126,0.038808000,0.0000
50.48.167.226,<->,8.52.178.229,0,0,1,50,1,50,0.038779000,0.0000
197.107.8.192,<->,159.137.255.155,0,0,1,50,1,50,0.038779000,0.0000
138.127.224.104,<->,101.224.89.130,0,0,1,289,1,289,0.038714000,0.0000
192.65.25.39,<->,112.208.20.230,1,163,0,0,1,163,0.038591000,0.0000
220.55.113.199,<->,122.238.96.221,1,50,0,0,1,50,0.038271000,0.0000
112.84.33.83,<->,20.138.190.57,0,0,1,64,1,64,0.038172000,0.0000
207.72.122.121,<->,8.252.222.157,0,0,1,50,1,50,0.038157000,0.0000
95.245.91.32,<->,8.238.222.86,0,0,1,135,1,135,0.038078000,0.0000
138.127.224.44,<->,101.224.89.251,0,0,1,234,1,234,0.037988000,0.0000
255.133.229.164,<->,39.252.118.186,0,0,1,100,1,100,0.037922000,0.0000
53.148.20.156,<->,48.54.132.240,0,0,1,64,1,64,0.037885000,0.0000
104.1.27.29,<->,20.109.71.240,0,0,1,64,1,64,0.037873000,0.0000
246.253.166.43,<->,244.50.129.64,1,50,0,0,1,50,0.037826000,0.0000
146.172.11.46,<->,39.14.208.141,0,0,1,52,1,52,0.037595000,0.0000
197.113.99.181,<->,136.25.188.177,0,0,1,50,1,50,0.037455000,0.0000
92.27.219.132,<->,64.214.44.95,1,105,0,0,1,105,0.037266000,0.0000
100.92.86.131,<->,27.14.150.165,1,169,0,0,1,169,0.037240000,0.0000
109.0.245.91,<->,8.49.69.216,1,394,0,0,1,394,0.037234000,0.0000
242.180.253.31,<->,8.220.199.37,0,0,1,84,1,84,0.037069000,0.0000
138.127.224.44,<->,101.224.89.244,0,0,1,234,1,234,0.036997000,0.0000
241.193.172.231,<->,20.67.52.133,0,0,1,50,1,50,0.036935000,0.0000
94.39.154.13,<->,92.27.27.144,0,0,1,52,1,52,0.036842000,0.0000
53.149.99.50,<->,48.54.53.142,0,0,1,328,1,328,0.036815000,0.0000
206.103.215.34,<->,136.25.189.59,0,0,1,56,1,56,0.036761000,0.0000
215.158.239.93,<->,195.49.36.237,1,56,0,0,1,56,0.036653000,0.0000
114.28.246.175,<->,92.27.219.221,0,0,1,52,1,52,0.036618000,0.0000
195.55.134.63,<->,136.25.188.174,0,0,1,50,1,50,0.036411000,0.0000
215.158.140.228,<->,98.226.240.147,1,50,0,0,1,50,0.036275000,0.0000
207.190.211.25,<->,136.25.188.209,0,0,1,56,1,56,0.036191000,0.0000
133.178.226.30,<->,29.211.186.41,1,56,0,0,1,56,0.036176000,0.0000
222.65.28.126,<->,215.158.33.168,1,56,0,0,1,56,0.036081000,0.0000
137.137.109.30,<->,54.69.178.55,1,125,0,0,1,125,0.035997000,0.0000
144.122.240.238,<->,144.108.64.183,1,64,0,0,1,64,0.035851000,0.0000
142.208.51.209,<->,136.25.188.52,0,0,1,56,1,56,0.035436000,0.0000
136.25.189.2,<->,67.174.33.134,1,56,0,0,1,56,0.035286000,0.0000
215.158.239.95,<->,196.91.24.37,1,190,0,0,1,190,0.035196000,0.0000
38.21.156.204,<->,20.232.229.4,0,0,1,82,1,82,0.035012000,0.0000
215.158.239.221,<->,215.158.61.191,1,1410,0,0,1,1410,0.035011000,0.0000
194.154.60.221,<->,129.224.112.252,0,0,1,63,1,63,0.034979000,0.0000
149.50.187.76,<->,20.199.243.54,0,0,1,64,1,64,0.034861000,0.0000
98.130.107.211,<->,8.52.222.23,0,0,1,50,1,50,0.034307000,0.0000
194.237.46.16,<->,136.25.188.175,0,0,1,50,1,50,0.033695000,0.0000
92.27.27.173,<->,33.57.74.185,1,56,0,0,1,56,0.033502000,0.0000
159.69.187.46,<->,144.108.64.184,1,73,0,0,1,73,0.033322000,0.0000
138.127.225.73,<->,33.233.141.34,0,0,1,86,1,86,0.033089000,0.0000
142.240.159.133,<->,136.25.188.52,0,0,1,50,1,50,0.033048000,0.0000
215.201.195.147,<->,8.182.224.248,0,0,1,50,1,50,0.032989000,0.0000
140.24.164.199,<->,8.252.222.38,0,0,1,50,1,50,0.032957000,0.0000
133.178.226.28,<->,96.155.60.213,1,56,0,0,1,56,0.032835000,0.0000
222.38.5.245,<->,50.224.80.64,0,0,1,50,1,50,0.032829000,0.0000
148.155.131.220,<->,101.224.89.175,0,0,1,172,1,172,0.032803000,0.0000
21.15.226.126,<->,20.193.43.244,0,0,1,82,1,82,0.032762000,0.0000
201.70.13.141,<->,92.27.219.218,0,0,1,52,1,52,0.032760000,0.0000
146.15.20.243,<->,80.27.157.212,0,0,1,50,1,50,0.032724000,0.0000
136.25.188.82,<->,111.150.207.179,1,56,0,0,1,56,0.032520000,0.0000
53.148.238.77,<->,48.53.165.70,0,0,1,50,1,50,0.032370000,0.0000
111.48.223.192,<->,8.182.244.237,0,0,1,56,1,56,0.032269000,0.0000
200.174.217.174,<->,54.37.202.190,1,50,0,0,1,50,0.032249000,0.0000
108.47.159.174,<->,8.52.183.207,0,0,1,50,1,50,0.032123000,0.0000
60.170.105.150,<->,20.66.59.200,0,0,1,52,1,52,0.031930000,0.0000
124.159.23.236,<->,39.209.159.106,0,0,1,60,1,60,0.031844000,0.0000
111.146.194.62,<->,53.149.30.218,1,125,0,0,1,125,0.031779000,0.0000
100.215.74.116,<->,33.233.141.107,0,0,1,50,1,50,0.031767000,0.0000
139.163.26.146,<->,131.33.20.26,1,99,0,0,1,99,0.031752000,0.0000
111.150.207.80,<->,8.252.223.136,0,0,1,56,1,56,0.031612000,0.0000
116.166.197.8,<->,89.183.104.143,0,0,1,50,1,50,0.031318000,0.0000
215.158.61.254,<->,8.252.221.233,0,0,1,396,1,396,0.031301000,0.0000
133.178.226.11,<->,111.151.106.218,1,56,0,0,1,56,0.031005000,0.0000
215.158.239.68,<->,199.20.28.4,1,50,0,0,1,50,0.030875000,0.0000
144.122.240.240,<->,144.108.64.184,1,93,0,0,1,93,0.030800000,0.0000
193.30.240.160,<->,89.139.241.98,0,0,1,152,1,152,0.030736000,0.0000
136.25.188.47,<->,122.158.51.60,1,68,0,0,1,68,0.030417000,0.0000
102.50.23.191,<->,89.183.104.177,0,0,1,393,1,393,0.030412000,0.0000
119.45.87.57,<->,92.162.253.173,0,0,1,50,1,50,0.030392000,0.0000
145.116.118.68,<->,113.225.174.168,1,50,0,0,1,50,0.030308000,0.0000
111.199.236.91,<->,0.195.210.44,0,0,1,68,1,68,0.029789000,0.0000
140.20.42.168,<->,111.146.188.194,0,0,1,50,1,50,0.029527000,0.0000
216.144.219.121,<->,215.158.140.177,0,0,1,50,1,50,0.029418000,0.0000
123.87.27.159,<->,20.128.169.18,0,0,1,184,1,184,0.029377000,0.0000
127.107.211.40,<->,50.224.76.234,0,0,1,56,1,56,0.029271000,0.0000
215.158.239.95,<->,195.43.141.71,1,172,0,0,1,172,0.029021000,0.0000
35.33.29.101,<->,33.233.141.114,0,0,1,56,1,56,0.028927000,0.0000
106.224.70.18,<->,20.57.168.169,0,0,1,64,1,64,0.028843000,0.0000
138.127.224.158,<->,33.233.141.74,0,0,1,290,1,290,0.028808000,0.0000
133.178.226.202,<->,113.86.183.243,1,56,0,0,1,56,0.028725000,0.0000
207.188.86.228,<->,136.25.188.177,0,0,1,50,1,50,0.028707000,0.0000
136.18.96.147,<->,8.182.227.71,0,0,1,50,1,50,0.028445000,0.0000
246.254.97.229,<->,54.55.44.79,1,362,0,0,1,362,0.028389000,0.0000
204.186.114.86,<->,136.25.188.237,0,0,1,765,1,765,0.028363000,0.0000
144.75.218.233,<->,8.47.123.77,1,111,0,0,1,111,0.028253000,0.0000
111.48.54.205,<->,8.52.222.23,0,0,1,50,1,50,0.028150000,0.0000
215.158.239.56,<->,195.70.102.202,1,56,0,0,1,56,0.027341000,0.0000
138.127.225.156,<->,101.224.89.222,0,0,1,284,1,284,0.027261000,0.0000
246.254.97.107,<->,210.209.251.211,1,50,0,0,1,50,0.027249000,0.0000
129.92.117.26,<->,111.20.62.72,1,204,0,0,1,204,0.027179000,0.0000
215.158.239.78,<->,196.92.139.128,1,602,0,0,1,602,0.027097000,0.0000
203.215.176.33,<->,118.241.252.70,1,56,0,0,1,56,0.026839000,0.0000
199.82.19.237,<->,50.224.76.230,0,0,1,56,1,56,0.026797000,0.0000
138.127.224.104,<->,33.233.141.114,0,0,1,276,1,276,0.026754000,0.0000
247.157.92.140,<->,154.149.9.215,1,130,0,0,1,130,0.026713000,0.0000
128.152.250.4,<->,20.212.200.7,0,0,1,72,1,72,0.026703000,0.0000
206.232.36.243,<->,20.228.39.148,0,0,1,64,1,64,0.026688000,0.0000
111.20.171.168,<->,33.233.141.25,0,0,1,50,1,50,0.026665000,0.0000
53.249.253.120,<->,39.15.169.14,0,0,1,88,1,88,0.026654000,0.0000
215.158.140.205,<->,41.136.238.227,1,50,0,0,1,50,0.026639000,0.0000
196.148.133.194,<->,105.102.187.17,1,103,0,0,1,103,0.026621000,0.0000
21.15.226.126,<->,20.193.43.228,0,0,1,82,1,82,0.026550000,0.0000
109.222.238.4,<->,109.208.27.214,1,50,0,0,1,50,0.026332000,0.0000
215.158.239.50,<->,195.83.167.74,1,602,0,0,1,602,0.026113000,0.0000
38.50.224.17,<->,20.202.58.224,0,0,1,104,1,104,0.025855000,0.0000
144.122.240.202,<->,144.108.80.163,1,65,0,0,1,65,0.025693000,0.0000
98.3.2.87,<->,8.182.138.11,0,0,1,50,1,50,0.025669000,0.0000
144.122.240.235,<->,144.108.64.184,1,67,0,0,1,67,0.025453000,0.0000
120.246.11.222,<->,89.183.104.236,0,0,1,52,1,52,0.025405000,0.0000
236.160.232.38,<->,92.27.27.189,0,0,1,260,1,260,0.025388000,0.0000
133.178.227.16,<->,8.53.217.69,1,56,0,0,1,56,0.025315000,0.0000
215.158.239.56,<->,196.90.104.65,1,68,0,0,1,68,0.025165000,0.0000
100.216.218.81,<->,8.52.222.23,0,0,1,56,1,56,0.025136000,0.0000
112.153.46.24,<->,92.27.219.252,0,0,1,80,1,80,0.025133000,0.0000
138.127.224.187,<->,33.233.141.73,0,0,1,235,1,235,0.024610000,0.0000
215.158.61.193,<->,8.176.8.193,0,0,1,658,1,658,0.024539000,0.0000
247.136.211.104,<->,229.5.203.221,1,50,0,0,1,50,0.024440000,0.0000
118.90.196.79,<->,20.192.100.231,0,0,1,56,1,56,0.024406000,0.0000
192.64.196.45,<->,8.209.235.29,1,50,0,0,1,50,0.024294000,0.0000
53.149.56.125,<->,48.54.89.201,0,0,1,50,1,50,0.023912000,0.0000
215.158.239.56,<->,199.20.28.159,1,50,0,0,1,50,0.023898000,0.0000
215.158.103.206,<->,159.118.210.230,1,84,0,0,1,84,0.023869000,0.0000
215.158.239.85,<->,207.62.15.212,1,64,0,0,1,64,0.023843000,0.0000
53.148.184.48,<->,48.52.81.232,0,0,1,50,1,50,0.023769000,0.0000
69.246.57.135,<->,20.29.17.125,0,0,1,60,1,60,0.023762000,0.0000
215.158.238.32,<->,133.186.94.165,1,56,0,0,1,56,0.023664000,0.0000
26.253.21.82,<->,8.220.181.167,0,0,1,50,1,50,0.023628000,0.0000
195.14.138.144,<->,136.25.188.53,0,0,1,50,1,50,0.023573000,0.0000
21.15.226.126,<->,20.193.43.239,0,0,1,82,1,82,0.023517000,0.0000
239.227.94.216,<->,132.18.67.31,1,56,0,0,1,56,0.023517000,0.0000
215.158.239.76,<->,196.93.232.134,1,68,0,0,1,68,0.023453000,0.0000
92.162.253.167,<->,36.125.24.43,1,50,0,0,1,50,0.023363000,0.0000
195.41.101.81,<->,136.25.188.253,0,0,1,50,1,50,0.023284000,0.0000
122.201.252.141,<->,20.207.104.197,0,0,1,64,1,64,0.022787000,0.0000
145.252.126.188,<->,0.247.66.228,1,71,0,0,1,71,0.022629000,0.0000
215.158.239.92,<->,199.20.30.16,1,56,0,0,1,56,0.022419000,0.0000
92.27.219.231,<->,6.94.151.80,1,56,0,0,1,56,0.022216000,0.0000
136.25.188.196,<->,50.155.118.89,1,50,0,0,1,50,0.022022000,0.0000
141.105.247.20,<->,136.129.94.107,0,0,1,84,1,84,0.021625000,0.0000
203.117.35.248,<->,0.195.210.42,0,0,1,56,1,56,0.021465000,0.0000
218.38.100.178,<->,8.182.233.43,0,0,1,50,1,50,0.021390000,0.0000
215.158.239.86,<->,128.23.84.26,1,56,0,0,1,56,0.021378000,0.0000
197.7.112.39,<->,8.182.224.87,0,0,1,56,1,56,0.021286000,0.0000
246.254.58.60,<->,244.50.236.30,1,50,0,0,1,50,0.021224000,0.0000
143.68.60.226,<->,136.25.188.255,0,0,1,50,1,50,0.021189000,0.0000
133.178.227.20,<->,98.219.126.140,1,56,0,0,1,56,0.021172000,0.0000
215.158.239.6,<->,127.171.80.214,1,56,0,0,1,56,0.021110000,0.0000
215.158.238.134,<->,61.34.184.228,1,56,0,0,1,56,0.020908000,0.0000
129.92.117.130,<->,53.200.150.117,1,56,0,0,1,56,0.020904000,0.0000
111.20.168.143,<->,81.96.106.185,1,175,0,0,1,175,0.020771000,0.0000
215.158.238.220,<->,6.29.97.138,1,56,0,0,1,56,0.020770000,0.0000
143.10.202.207,<->,136.25.188.163,0,0,1,56,1,56,0.020757000,0.0000
97.126.21.248,<->,54.50.59.134,1,50,0,0,1,50,0.020515000,0.0000
123.97.227.2,<->,20.114.7.137,0,0,1,50,1,50,0.020474000,0.0000
17.98.79.183,<->,8.52.239.51,0,0,1,84,1,84,0.020214000,0.0000
132.44.248.117,<->,50.224.76.234,0,0,1,50,1,50,0.020176000,0.0000
215.158.239.48,<->,195.14.207.146,1,56,0,0,1,56,0.020173000,0.0000
197.107.28.84,<->,136.25.188.174,0,0,1,50,1,50,0.020147000,0.0000
158.193.236.29,<->,20.192.127.153,0,0,1,64,1,64,0.020120000,0.0000
33.233.141.67,<->,17.62.194.122,1,559,0,0,1,559,0.020100000,0.0000
215.158.239.8,<->,144.90.109.23,1,122,0,0,1,122,0.020087000,0.0000
255.133.229.164,<->,39.225.232.32,0,0,1,100,1,100,0.020067000,0.0000
96.143.113.148,<->,8.52.222.220,0,0,1,56,1,56,0.020041000,0.0000
142.236.68.196,<->,136.25.188.252,0,0,1,68,1,68,0.020006000,0.0000
215.158.239.94,<->,196.92.69.113,1,64,0,0,1,64,0.019987000,0.0000
92.180.248.62,<->,92.27.219.50,0,0,1,52,1,52,0.019966000,0.0000
129.254.101.3,<->,129.224.112.252,0,0,1,63,1,63,0.019899000,0.0000
252.132.201.22,<->,8.182.136.217,0,0,1,50,1,50,0.019888000,0.0000
207.87.179.41,<->,20.190.43.128,0,0,1,64,1,64,0.019789000,0.0000
68.77.99.68,<->,8.252.221.236,0,0,1,50,1,50,0.019778000,0.0000
241.193.172.231,<->,20.57.125.172,0,0,1,50,1,50,0.019722000,0.0000
215.158.239.95,<->,196.88.210.86,1,56,0,0,1,56,0.019688000,0.0000
210.209.251.223,<->,145.16.88.242,0,0,1,50,1,50,0.019659000,0.0000
199.68.172.237,<->,136.25.188.163,0,0,1,56,1,56,0.019543000,0.0000
97.126.31.80,<->,89.124.155.59,1,1002,0,0,1,1002,0.019270000,0.0000
124.125.130.197,<->,80.38.49.144,0,0,1,82,1,82,0.019218000,0.0000
100.182.151.25,<->,8.37.245.94,1,141,0,0,1,141,0.019132000,0.0000
207.42.247.171,<->,39.0.118.174,0,0,1,68,1,68,0.018886000,0.0000
20.134.42.159,<->,18.203.4.73,1,64,0,0,1,64,0.018867000,0.0000
91.50.34.140,<->,8.220.176.253,0,0,1,50,1,50,0.018618000,0.0000
132.10.25.131,<->,132.3.191.238,1,638,0,0,1,638,0.018480000,0.0000
144.122.240.220,<->,144.84.228.247,1,79,0,0,1,79,0.018442000,0.0000
210.220.219.182,<->,53.200.217.70,1,56,0,0,1,56,0.018440000,0.0000
196.233.235.10,<->,8.182.241.177,0,0,1,50,1,50,0.018440000,0.0000
113.127.244.3,<->,92.27.27.143,0,0,1,50,1,50,0.018393000,0.0000
122.142.196.174,<->,92.27.219.148,0,0,1,105,1,105,0.018272000,0.0000
204.186.218.123,<->,136.25.188.225,0,0,1,182,1,182,0.018245000,0.0000
194.232.157.59,<->,136.25.188.176,0,0,1,50,1,50,0.018231000,0.0000
192.64.196.68,<->,119.74.161.14,1,56,0,0,1,56,0.018149000,0.0000
220.20.206.207,<->,129.224.112.252,0,0,1,81,1,81,0.017983000,0.0000
215.158.239.49,<->,195.14.207.146,1,56,0,0,1,56,0.017941000,0.0000
8.222.48.251,<->,6.73.247.6,0,0,1,537,1,537,0.017917000,0.0000
138.127.224.148,<->,33.233.141.32,0,0,1,289,1,289,0.017735000,0.0000
242.21.6.159,<->,8.182.224.248,0,0,1,50,1,50,0.017628000,0.0000
207.61.76.146,<->,136.25.188.252,0,0,1,50,1,50,0.017349000,0.0000
144.122.240.239,<->,144.108.64.184,1,63,0,0,1,63,0.017274000,0.0000
215.158.239.49,<->,196.93.175.123,1,50,0,0,1,50,0.017267000,0.0000
22.236.20.227,<->,8.182.233.43,0,0,1,50,1,50,0.017219000,0.0000
215.158.238.246,<->,215.158.33.123,1,1504,0,0,1,1504,0.017211000,0.0000
120.107.79.5,<->,39.52.158.152,0,0,1,52,1,52,0.017040000,0.0000
195.42.104.214,<->,136.25.188.199,0,0,1,68,1,68,0.017039000,0.0000
101.70.112.9,<->,54.58.80.225,1,50,0,0,1,50,0.016499000,0.0000
138.127.224.225,<->,101.224.89.168,0,0,1,243,1,243,0.016439000,0.0000
199.53.47.86,<->,136.25.188.236,0,0,1,56,1,56,0.016434000,0.0000
215.158.140.74,<->,83.244.198.136,1,50,0,0,1,50,0.016378000,0.0000
204.60.65.128,<->,136.25.188.178,0,0,1,56,1,56,0.016322000,0.0000
138.127.224.44,<->,33.233.141.68,0,0,1,234,1,234,0.016285000,0.0000
117.141.92.31,<->,20.106.14.76,0,0,1,64,1,64,0.016276000,0.0000
138.127.224.138,<->,33.233.141.113,0,0,1,264,1,264,0.016273000,0.0000
195.42.52.44,<->,136.25.188.242,0,0,1,56,1,56,0.016068000,0.0000
215.158.239.58,<->,207.58.161.119,1,50,0,0,1,50,0.016045000,0.0000
50.54.40.210,<->,8.52.171.120,0,0,1,50,1,50,0.016027000,0.0000
199.51.129.216,<->,136.25.188.197,0,0,1,259,1,259,0.015941000,0.0000
207.63.14.214,<->,20.119.116.167,0,0,1,70,1,70,0.015686000,0.0000
192.229.216.117,<->,91.51.31.120,1,95,0,0,1,95,0.015297000,0.0000
215.158.239.6,<->,8.255.92.107,1,56,0,0,1,56,0.015196000,0.0000
136.25.188.255,<->,6.73.106.221,1,50,0,0,1,50,0.015171000,0.0000
215.158.239.50,<->,199.20.30.157,1,132,0,0,1,132,0.014891000,0.0000
210.158.44.63,<->,33.229.58.179,1,638,0,0,1,638,0.014887000,0.0000
102.224.165.225,<->,8.55.194.110,1,56,0,0,1,56,0.014837000,0.0000
143.94.41.24,<->,136.25.188.255,0,0,1,68,1,68,0.014771000,0.0000
92.27.27.169,<->,27.11.106.159,1,52,0,0,1,52,0.014659000,0.0000
221.196.122.5,<->,136.25.188.163,0,0,1,56,1,56,0.014594000,0.0000
8.252.223.130,<->,8.222.7.154,1,56,0,0,1,56,0.014489000,0.0000
215.158.239.49,<->,196.91.91.51,1,56,0,0,1,56,0.014386000,0.0000
215.158.239.95,<->,195.7.21.76,1,95,0,0,1,95,0.014299000,0.0000
97.110.148.13,<->,33.233.141.30,0,0,1,98,1,98,0.014202000,0.0000
193.21.28.204,<->,92.27.27.174,0,0,1,64,1,64,0.013950000,0.0000
204.186.82.209,<->,136.25.188.222,0,0,1,56,1,56,0.013887000,0.0000
136.25.189.1,<->,38.104.11.42,1,56,0,0,1,56,0.013684000,0.0000
199.123.124.210,<->,136.25.188.243,0,0,1,56,1,56,0.013616000,0.0000
109.1.62.236,<->,38.239.76.149,1,72,0,0,1,72,0.013555000,0.0000
56.8.252.1,<->,8.182.251.151,0,0,1,50,1,50,0.013549000,0.0000
143.44.43.57,<->,136.25.188.239,0,0,1,56,1,56,0.013496000,0.0000
144.122.240.196,<->,144.108.64.184,1,70,0,0,1,70,0.013494000,0.0000
97.126.118.161,<->,95.221.85.194,1,50,0,0,1,50,0.013268000,0.0000
109.0.246.3,<->,8.55.226.90,1,56,0,0,1,56,0.013190000,0.0000
238.118.126.22,<->,224.213.241.40,1,56,0,0,1,56,0.013019000,0.0000
114.211.225.166,<->,92.27.27.144,0,0,1,52,1,52,0.012952000,0.0000
159.69.187.8,<->,144.108.64.183,1,72,0,0,1,72,0.012936000,0.0000
144.75.218.246,<->,139.252.1.244,1,244,0,0,1,244,0.012595000,0.0000
145.252.113.224,<->,120.240.154.112,1,50,0,0,1,50,0.012483000,0.0000
133.32.39.0,<->,14.71.95.237,1,56,0,0,1,56,0.012413000,0.0000
215.158.239.58,<->,199.20.31.40,1,56,0,0,1,56,0.012329000,0.0000
127.236.62.242,<->,109.222.217.93,0,0,1,69,1,69,0.012328000,0.0000
215.158.239.57,<->,207.61.233.26,1,50,0,0,1,50,0.011684000,0.0000
215.158.238.78,<->,139.163.161.34,1,56,0,0,1,56,0.011683000,0.0000
123.97.227.2,<->,20.23.171.96,0,0,1,50,1,50,0.011672000,0.0000
89.183.108.71,<->,69.151.151.102,1,50,0,0,1,50,0.011657000,0.0000
143.114.105.100,<->,20.211.50.182,0,0,1,52,1,52,0.011655000,0.0000
136.181.33.181,<->,0.195.216.195,1,141,0,0,1,141,0.011642000,0.0000
198.158.197.83,<->,20.171.157.32,0,0,1,50,1,50,0.011535000,0.0000
215.158.239.99,<->,199.20.31.107,1,68,0,0,1,68,0.011479000,0.0000
123.97.227.2,<->,20.116.149.38,0,0,1,50,1,50,0.011311000,0.0000
142.249.80.182,<->,136.25.188.160,0,0,1,56,1,56,0.010902000,0.0000
231.140.115.25,<->,136.25.188.255,0,0,1,50,1,50,0.010735000,0.0000
222.62.100.148,<->,48.52.243.81,0,0,1,50,1,50,0.010658000,0.0000
197.109.192.8,<->,136.25.188.53,0,0,1,56,1,56,0.010507000,0.0000
241.193.172.231,<->,20.244.183.81,0,0,1,50,1,50,0.010474000,0.0000
145.23.22.147,<->,136.25.188.175,0,0,1,50,1,50,0.010403000,0.0000
220.20.200.143,<->,131.45.239.182,1,526,0,0,1,526,0.010346000,0.0000
111.147.92.14,<->,53.232.137.66,1,52,0,0,1,52,0.010310000,0.0000
198.182.215.243,<->,109.1.34.223,0,0,1,325,1,325,0.010231000,0.0000
145.48.251.217,<->,8.52.164.239,0,0,1,56,1,56,0.010220000,0.0000
246.254.97.80,<->,50.145.195.49,1,92,0,0,1,92,0.009974000,0.0000
215.158.239.56,<->,199.20.28.237,1,68,0,0,1,68,0.009490000,0.0000
231.142.173.115,<->,215.158.239.92,0,0,1,56,1,56,0.009479000,0.0000
124.53.158.31,<->,20.12.117.106,0,0,1,108,1,108,0.009427000,0.0000
98.23.96.86,<->,92.27.219.150,0,0,1,56,1,56,0.009379000,0.0000
50.224.76.235,<->,38.105.255.16,1,50,0,0,1,50,0.009292000,0.0000
159.237.225.1,<->,57.199.73.37,1,52,0,0,1,52,0.009248000,0.0000
195.115.161.3,<->,92.27.194.147,0,0,1,56,1,56,0.009246000,0.0000
133.178.227.16,<->,113.20.94.68,1,56,0,0,1,56,0.008605000,0.0000
133.178.226.202,<->,57.227.82.214,1,56,0,0,1,56,0.008598000,0.0000
247.136.176.220,<->,100.124.212.156,1,50,0,0,1,50,0.008556000,0.0000
143.135.199.85,<->,136.25.188.255,0,0,1,68,1,68,0.008495000,0.0000
215.158.23.23,<->,144.29.28.236,1,68,0,0,1,68,0.008468000,0.0000
136.18.227.12,<->,8.182.226.78,0,0,1,50,1,50,0.008457000,0.0000
39.5.229.139,<->,29.151.117.152,1,52,0,0,1,52,0.008299000,0.0000
209.91.214.58,<->,8.220.186.30,0,0,1,50,1,50,0.008299000,0.0000
207.74.108.169,<->,20.67.179.246,0,0,1,72,1,72,0.008220000,0.0000
111.151.107.247,<->,99.74.26.144,0,0,1,217,1,217,0.008219000,0.0000
215.158.239.87,<->,199.20.30.136,1,56,0,0,1,56,0.008164000,0.0000
97.126.27.248,<->,53.191.207.209,1,50,0,0,1,50,0.008143000,0.0000
192.64.245.111,<->,33.200.176.52,1,135,0,0,1,135,0.008107000,0.0000
101.70.126.35,<->,35.122.9.250,1,80,0,0,1,80,0.008012000,0.0000
215.158.239.192,<->,138.127.225.15,1,191,0,0,1,191,0.007670000,0.0000
158.200.200.182,<->,20.207.97.201,0,0,1,110,1,110,0.007662000,0.0000
143.104.159.198,<->,8.182.227.180,0,0,1,561,1,561,0.007633000,0.0000
220.20.200.13,<->,144.83.60.137,1,50,0,0,1,50,0.007600000,0.0000
204.3.35.202,<->,136.25.188.236,0,0,1,50,1,50,0.007518000,0.0000
98.23.96.87,<->,92.27.27.178,0,0,1,56,1,56,0.007392000,0.0000
215.158.239.93,<->,199.20.28.118,1,68,0,0,1,68,0.007194000,0.0000
142.247.206.108,<->,136.25.188.252,0,0,1,56,1,56,0.006837000,0.0000
197.133.247.181,<->,133.178.227.24,0,0,1,56,1,56,0.006745000,0.0000
89.183.104.157,<->,18.201.152.85,1,325,0,0,1,325,0.006474000,0.0000
50.224.76.235,<->,29.217.228.88,1,56,0,0,1,56,0.006276000,0.0000
215.158.239.95,<->,199.20.5.168,1,50,0,0,1,50,0.006205000,0.0000
215.158.103.206,<->,138.127.231.160,1,153,0,0,1,153,0.005819000,0.0000
50.140.171.97,<->,8.20.87.254,0,0,1,50,1,50,0.005671000,0.0000
29.95.158.240,<->,20.199.198.222,0,0,1,64,1,64,0.005670000,0.0000
120.48.82.204,<->,80.38.25.142,0,0,1,78,1,78,0.005616000,0.0000
148.110.20.29,<->,89.183.104.189,0,0,1,135,1,135,0.005609000,0.0000
194.234.234.158,<->,136.25.188.198,0,0,1,50,1,50,0.005507000,0.0000
124.159.72.74,<->,39.224.88.186,0,0,1,60,1,60,0.005446000,0.0000
97.126.113.29,<->,97.19.107.13,1,152,0,0,1,152,0.005375000,0.0000
17.213.162.200,<->,8.220.188.220,0,0,1,56,1,56,0.005361000,0.0000
53.161.58.87,<->,48.53.19.205,0,0,1,56,1,56,0.005125000,0.0000
143.29.129.15,<->,136.25.188.105,0,0,1,159,1,159,0.004890000,0.0000
244.50.136.175,<->,39.150.215.250,0,0,1,50,1,50,0.004842000,0.0000
50.224.75.42,<->,42.71.226.159,1,52,0,0,1,52,0.004833000,0.0000
17.249.7.18,<->,8.220.181.15,0,0,1,56,1,56,0.004828000,0.0000
210.220.219.151,<->,53.196.19.232,1,56,0,0,1,56,0.004602000,0.0000
123.97.227.2,<->,20.200.129.243,0,0,1,50,1,50,0.004475000,0.0000
207.188.96.34,<->,136.25.188.209,0,0,1,56,1,56,0.004332000,0.0000
207.59.241.123,<->,136.25.188.163,0,0,1,50,1,50,0.004013000,0.0000
118.159.227.185,<->,89.183.104.143,0,0,1,50,1,50,0.003941000,0.0000
104.245.139.155,<->,89.183.104.145,0,0,1,164,1,164,0.003884000,0.0000
215.158.238.82,<->,97.243.113.43,1,56,0,0,1,56,0.003802000,0.0000
139.163.5.140,<->,120.231.123.174,1,62,0,0,1,62,0.003773000,0.0000
144.72.193.17,<->,100.93.185.216,0,0,1,50,1,50,0.003702000,0.0000
215.158.239.56,<->,196.90.192.245,1,56,0,0,1,56,0.003664000,0.0000
215.158.239.70,<->,6.15.207.64,1,56,0,0,1,56,0.003520000,0.0000
231.136.11.222,<->,136.25.188.253,0,0,1,56,1,56,0.003410000,0.0000
97.126.24.188,<->,54.53.31.135,1,50,0,0,1,50,0.003368000,0.0000
53.231.73.166,<->,48.53.16.89,0,0,1,97,1,97,0.003303000,0.0000
215.158.239.57,<->,196.90.225.114,1,56,0,0,1,56,0.003264000,0.0000
195.54.150.206,<->,136.25.188.242,0,0,1,56,1,56,0.003008000,0.0000
215.158.30.187,<->,8.252.222.32,0,0,1,93,1,93,0.002936000,0.0000
106.168.191.162,<->,99.75.24.112,0,0,1,50,1,50,0.002768000,0.0000
199.103.173.55,<->,8.20.87.153,0,0,1,56,1,56,0.002518000,0.0000
122.184.13.50,<->,8.52.223.102,0,0,1,56,1,56,0.002385000,0.0000
215.158.239.85,<->,136.139.59.87,1,56,0,0,1,56,0.002273000,0.0000
195.70.195.79,<->,136.25.188.55,0,0,1,50,1,50,0.002240000,0.0000
136.99.207.59,<->,78.49.234.86,1,56,0,0,1,56,0.002230000,0.0000
144.75.218.241,<->,138.127.224.135,1,238,0,0,1,238,0.002178000,0.0000
137.21.23.55,<->,8.218.124.70,1,1002,0,0,1,1002,0.002172000,0.0000
99.167.5.31,<->,8.182.226.78,0,0,1,50,1,50,0.002011000,0.0000
144.70.196.18,<->,59.130.179.247,1,65,0,0,1,65,0.001983000,0.0000
252.98.138.179,<->,100.230.5.11,1,50,0,0,1,50,0.001746000,0.0000
133.165.252.43,<->,109.127.101.16,1,509,0,0,1,509,0.001689000,0.0000
195.6.201.7,<->,136.25.188.174,0,0,1,50,1,50,0.001639000,0.0000
21.15.226.126,<->,20.193.43.25,0,0,1,82,1,82,0.001582000,0.0000
192.67.172.77,<->,75.148.75.193,1,133,0,0,1,133,0.001538000,0.0000
247.136.244.156,<->,53.229.7.78,1,56,0,0,1,56,0.001386000,0.0000
222.65.25.155,<->,132.18.67.27,1,105,0,0,1,105,0.001118000,0.0000
215.158.239.87,<->,199.20.31.173,1,56,0,0,1,56,0.001018000,0.0000
197.113.99.23,<->,136.25.188.197,0,0,1,56,1,56,0.000753000,0.0000
138.127.224.104,<->,111.20.168.22,0,0,1,197,1,197,0.000749000,0.0000
215.158.239.97,<->,199.15.41.28,1,50,0,0,1,50,0.000503000,0.0000
192.67.147.89,<->,122.4.58.170,1,60,0,0,1,60,0.000430000,0.0000
204.200.35.226,<->,136.25.188.173,0,0,1,50,1,50,0.000374000,0.0000
239.227.117.41,<->,230.94.217.98,1,61,0,0,1,61,0.000329000,0.0000
109.1.17.167,<->,27.188.163.162,1,445,0,0,1,445,0.000116000,0.0000
241.193.172.231,<->,20.171.169.70,0,0,1,50,1,50,0.000055000,0.0000
