src,sep,dst,inframes,inbytes,outframes,outbytes,totalframes,totalbytes,relstart,duration
247.136.153.249,<->,126.198.78.25,16,800,0,0,16,800,0.335691000,0.4033
249.101.209.167,<->,246.108.107.164,13,650,0,0,13,650,0.624597000,1.0948
144.87.238.89,<->,8.182.253.100,0,0,11,550,11,550,0.223755000,1.6970
17.18.69.246,<->,8.220.176.253,0,0,10,500,10,500,0.666097000,1.1945
220.28.64.202,<->,50.224.80.75,0,0,9,504,9,504,0.623018000,1.2837
221.102.56.69,<->,6.74.201.88,0,0,8,448,8,448,1.675715000,0.2326
246.108.107.211,<->,100.95.73.41,0,0,8,400,8,400,0.007394000,1.8857
220.55.69.95,<->,35.56.3.196,7,350,0,0,7,350,0.175186000,1.5941
221.102.56.69,<->,109.1.60.236,0,0,7,392,7,392,0.050029000,0.6884
215.158.239.95,<->,204.2.144.255,6,336,0,0,6,336,0.644938000,0.2045
138.74.30.197,<->,89.90.107.236,6,300,0,0,6,300,0.275091000,1.6427
194.124.22.48,<->,145.252.126.80,0,0,6,300,6,300,0.055211000,0.8234
221.102.56.69,<->,213.38.233.112,0,0,5,280,5,280,0.944910000,0.6200
159.223.99.61,<->,8.52.185.129,0,0,5,250,5,250,0.616358000,1.0006
147.58.211.37,<->,8.252.221.200,0,0,5,280,5,280,0.440459000,1.2722
222.244.167.142,<->,8.52.188.77,0,0,5,280,5,280,0.300636000,1.2520
221.102.143.189,<->,100.94.173.92,0,0,5,535,5,535,0.228867000,1.7446
80.38.62.154,<->,35.56.3.196,5,250,0,0,5,250,0.173597000,1.3329
98.129.94.194,<->,8.49.114.128,5,535,0,0,5,535,0.166654000,1.7076
243.185.81.59,<->,8.52.179.237,0,0,5,280,5,280,0.042408000,1.8683
101.224.178.156,<->,8.182.253.231,0,0,4,224,4,224,1.654576000,0.0135
144.70.14.36,<->,111.160.232.222,4,224,0,0,4,224,1.495854000,0.3239
8.20.81.32,<->,6.122.148.3,0,0,4,224,4,224,1.022509000,0.9583
56.8.55.61,<->,8.182.224.87,0,0,4,224,4,224,1.008687000,0.0292
221.102.143.189,<->,218.4.169.120,0,0,4,224,4,224,0.962874000,0.5376
111.147.219.221,<->,54.59.84.229,4,224,0,0,4,224,0.950712000,0.9981
218.4.164.231,<->,97.110.90.219,4,200,0,0,4,200,0.938270000,0.5174
220.55.79.216,<->,35.56.3.196,4,200,0,0,4,200,0.874429000,0.6159
139.144.241.233,<->,98.67.154.32,0,0,4,200,4,200,0.763992000,0.9995
146.249.227.135,<->,8.252.221.199,0,0,4,971,4,971,0.671049000,0.3420
192.65.97.145,<->,8.45.175.31,4,286,0,0,4,286,0.593578000,0.7760
221.102.143.189,<->,192.67.184.152,0,0,4,394,4,394,0.582088000,0.7708
139.114.131.88,<->,8.182.239.159,0,0,4,224,4,224,0.555073000,1.2363
210.221.107.50,<->,8.37.222.100,4,309,0,0,4,309,0.534985000,1.3012
213.38.201.158,<->,113.178.172.170,4,200,0,0,4,200,0.400557000,1.1015
92.181.172.215,<->,8.204.53.229,4,224,0,0,4,224,0.360685000,0.3770
215.158.239.232,<->,100.244.13.12,4,224,0,0,4,224,0.336609000,1.6578
111.151.239.114,<->,8.30.103.118,0,0,4,224,4,224,0.302983000,0.9521
139.241.73.46,<->,129.224.112.221,0,0,4,224,4,224,0.177681000,1.5439
17.143.241.23,<->,8.220.188.138,0,0,4,224,4,224,0.170249000,1.1530
221.102.56.69,<->,80.40.10.250,0,0,4,224,4,224,0.100994000,1.0163
132.20.222.234,<->,129.224.112.221,0,0,4,224,4,224,0.060824000,1.8561
221.102.56.69,<->,192.67.172.205,0,0,4,224,4,224,0.033830000,0.5603
99.162.77.146,<->,53.243.12.169,4,200,0,0,4,200,0.024072000,1.8583
239.66.110.113,<->,203.215.177.29,0,0,3,168,3,168,1.895940000,0.0383
92.181.45.37,<->,8.204.53.229,3,168,0,0,3,168,1.895921000,0.0208
129.224.112.252,<->,97.242.126.186,3,168,0,0,3,168,1.662790000,0.2966
221.102.56.46,<->,98.128.228.57,0,0,3,168,3,168,1.603005000,0.2603
221.102.56.69,<->,98.128.231.37,0,0,3,168,3,168,1.551387000,0.2540
252.135.0.205,<->,139.193.141.132,0,0,3,168,3,168,1.487116000,0.0971
144.94.162.244,<->,144.85.170.254,0,0,3,168,3,168,1.262891000,0.4387
221.102.56.69,<->,102.83.11.76,0,0,3,168,3,168,1.221390000,0.4656
251.20.81.56,<->,108.134.108.240,0,0,3,168,3,168,1.124113000,0.7031
144.86.149.46,<->,35.56.3.196,3,150,0,0,3,150,1.121360000,0.8093
246.108.107.182,<->,80.40.4.150,0,0,3,150,3,150,1.108556000,0.4128
144.87.238.89,<->,8.182.226.78,0,0,3,150,3,150,1.107967000,0.7027
221.102.56.69,<->,98.128.75.116,0,0,3,168,3,168,1.098891000,0.5657
220.50.215.89,<->,50.224.80.75,0,0,3,205,3,205,1.088341000,0.8008
197.112.27.111,<->,8.52.222.23,0,0,3,150,3,150,1.080141000,0.7193
239.66.218.250,<->,139.163.41.64,0,0,3,168,3,168,1.072044000,0.7054
17.113.90.104,<->,8.220.200.124,0,0,3,150,3,150,0.950832000,0.0024
215.158.239.49,<->,199.20.31.212,3,168,0,0,3,168,0.926595000,0.0803
210.220.219.151,<->,50.239.31.210,3,168,0,0,3,168,0.892167000,0.4667
210.221.107.50,<->,8.37.249.53,3,168,0,0,3,168,0.875600000,0.0642
195.68.143.220,<->,136.25.188.44,0,0,3,168,3,168,0.838914000,0.2004
195.68.143.220,<->,136.25.188.177,0,0,3,168,3,168,0.834826000,0.1941
221.102.56.69,<->,192.65.35.88,0,0,3,168,3,168,0.747865000,0.4165
232.31.155.18,<->,97.198.118.56,0,0,3,168,3,168,0.741450000,0.2876
99.187.125.121,<->,8.20.87.34,0,0,3,168,3,168,0.741417000,1.1354
50.224.110.86,<->,39.188.171.31,3,150,0,0,3,150,0.738242000,1.1209
232.31.155.17,<->,97.198.118.56,0,0,3,168,3,168,0.721462000,0.3136
109.222.217.220,<->,53.231.222.144,3,150,0,0,3,150,0.691924000,0.0097
216.184.1.112,<->,8.252.222.169,0,0,3,168,3,168,0.667423000,1.1271
215.158.239.87,<->,199.33.220.112,3,230,0,0,3,230,0.622334000,1.3405
97.126.24.188,<->,54.36.93.106,3,327,0,0,3,327,0.601424000,0.5771
220.50.215.68,<->,50.224.80.75,0,0,3,168,3,168,0.585645000,0.6914
132.18.67.31,<->,102.83.62.125,0,0,3,168,3,168,0.544774000,0.8452
144.64.138.63,<->,107.250.233.36,3,150,0,0,3,150,0.453507000,0.5458
68.72.133.189,<->,8.252.221.223,0,0,3,168,3,168,0.432151000,0.0686
213.38.133.55,<->,8.55.230.253,3,291,0,0,3,291,0.399412000,1.3994
56.8.135.115,<->,8.182.227.14,0,0,3,168,3,168,0.382149000,0.0091
133.178.227.255,<->,126.219.54.44,3,168,0,0,3,168,0.365245000,0.9648
144.87.238.91,<->,8.182.226.78,0,0,3,150,3,150,0.357811000,1.3114
247.136.222.54,<->,221.102.143.189,3,423,0,0,3,423,0.331920000,1.0780
199.82.159.149,<->,136.25.188.163,0,0,3,244,3,244,0.325916000,1.2942
129.224.112.252,<->,97.242.126.203,3,168,0,0,3,168,0.264784000,0.9375
221.102.56.69,<->,192.65.85.199,0,0,3,168,3,168,0.236520000,1.6178
221.102.143.189,<->,80.41.2.180,0,0,3,423,3,423,0.232893000,1.4380
95.247.103.183,<->,8.252.221.238,0,0,3,168,3,168,0.222323000,0.0187
221.102.143.189,<->,192.65.236.21,0,0,3,423,3,423,0.211912000,1.4660
239.227.73.148,<->,221.102.56.69,3,168,0,0,3,168,0.196220000,0.5336
144.87.238.20,<->,144.87.235.144,0,0,3,150,3,150,0.195059000,0.2382
221.102.56.69,<->,80.41.225.188,0,0,3,168,3,168,0.188656000,0.1143
195.7.51.31,<->,136.25.188.226,0,0,3,150,3,150,0.186486000,1.0206
221.102.143.189,<->,109.3.189.142,0,0,3,423,3,423,0.173105000,1.4060
221.102.143.189,<->,220.80.132.211,0,0,3,168,3,168,0.137505000,0.7150
68.75.18.110,<->,8.252.221.238,0,0,3,168,3,168,0.132636000,0.0201
221.102.56.69,<->,109.1.51.9,0,0,3,168,3,168,0.118412000,0.5093
17.193.242.92,<->,8.220.188.138,0,0,3,168,3,168,0.094789000,1.8129
221.102.143.189,<->,192.64.78.135,0,0,3,338,3,338,0.081807000,1.8000
192.64.101.33,<->,8.55.224.156,3,261,0,0,3,261,0.069083000,1.4380
221.102.143.189,<->,102.83.9.113,0,0,3,168,3,168,0.068796000,1.3950
221.102.143.189,<->,98.129.57.240,0,0,3,4374,3,4374,0.061486000,1.4380
129.78.112.201,<->,102.45.210.141,3,150,0,0,3,150,0.058669000,0.8393
196.148.133.194,<->,58.131.3.21,3,150,0,0,3,150,0.038887000,1.5848
129.225.135.32,<->,129.225.132.95,0,0,2,100,2,100,1.960542000,0.0030
144.71.44.80,<->,134.65.80.3,2,100,0,0,2,100,1.937303000,0.0073
231.140.235.239,<->,215.158.239.79,0,0,2,112,2,112,1.914115000,0.0106
98.129.116.148,<->,8.45.252.128,2,100,0,0,2,100,1.890776000,0.1055
237.162.205.18,<->,133.54.43.17,0,0,2,100,2,100,1.887232000,0.0033
86.135.211.208,<->,8.252.222.38,0,0,2,100,2,100,1.881956000,0.0043
239.227.119.111,<->,221.102.143.189,2,112,0,0,2,112,1.851051000,0.0791
210.209.251.214,<->,80.41.78.81,0,0,2,100,2,100,1.845869000,0.0000
221.102.143.189,<->,80.40.42.241,0,0,2,112,2,112,1.842810000,0.0717
152.139.166.235,<->,80.27.157.236,0,0,2,112,2,112,1.841993000,0.0048
221.102.56.69,<->,129.1.92.242,0,0,2,112,2,112,1.841481000,0.0035
197.156.143.3,<->,0.195.210.46,0,0,2,100,2,100,1.830559000,0.0092
221.102.126.240,<->,139.254.211.64,2,112,0,0,2,112,1.827267000,0.0320
111.147.236.79,<->,50.145.81.54,2,100,0,0,2,100,1.823044000,0.0182
129.224.112.252,<->,97.242.126.196,2,112,0,0,2,112,1.815676000,0.0098
8.55.211.213,<->,6.72.19.178,0,0,2,112,2,112,1.812839000,0.0198
97.168.79.200,<->,0.195.216.193,2,100,0,0,2,100,1.811876000,0.1494
215.158.239.31,<->,6.230.146.142,2,100,0,0,2,100,1.808080000,0.0059
246.254.97.109,<->,54.59.253.241,2,112,0,0,2,112,1.805316000,0.0014
199.54.0.36,<->,50.223.3.228,0,0,2,112,2,112,1.801579000,0.0001
99.187.125.122,<->,8.20.87.2,0,0,2,112,2,112,1.789167000,0.1861
192.172.29.39,<->,8.52.131.188,0,0,2,100,2,100,1.787649000,0.0008
145.242.124.39,<->,99.72.60.194,0,0,2,100,2,100,1.779677000,0.0967
99.124.166.199,<->,8.52.183.96,0,0,2,112,2,112,1.751577000,0.1855
239.66.110.113,<->,203.215.177.37,0,0,2,112,2,112,1.742141000,0.1602
215.201.227.68,<->,8.182.229.180,0,0,2,112,2,112,1.720733000,0.0049
146.235.129.205,<->,0.195.210.42,0,0,2,112,2,112,1.711762000,0.0242
146.249.220.207,<->,8.252.221.197,0,0,2,112,2,112,1.701398000,0.0120
213.38.197.82,<->,8.55.224.156,2,112,0,0,2,112,1.690810000,0.0832
221.102.56.46,<->,80.40.10.88,0,0,2,112,2,112,1.683537000,0.2903
139.192.40.145,<->,8.52.222.23,0,0,2,112,2,112,1.673183000,0.2032
139.163.26.146,<->,101.85.186.19,2,212,0,0,2,212,1.634887000,0.3042
210.209.251.211,<->,111.146.143.217,0,0,2,168,2,168,1.606787000,0.0000
38.2.189.242,<->,8.220.176.253,0,0,2,100,2,100,1.599286000,0.0003
132.49.148.122,<->,56.120.95.192,2,100,0,0,2,100,1.584505000,0.0002
199.51.21.63,<->,136.25.188.46,0,0,2,100,2,100,1.562743000,0.4238
122.193.57.250,<->,8.52.183.96,0,0,2,112,2,112,1.549580000,0.0822
98.67.140.104,<->,53.83.63.193,2,112,0,0,2,112,1.547127000,0.1400
221.102.56.69,<->,80.41.82.212,0,0,2,112,2,112,1.546891000,0.0139
220.55.70.117,<->,117.62.170.239,2,100,0,0,2,100,1.531387000,0.0025
221.102.56.69,<->,109.1.61.117,0,0,2,112,2,112,1.524627000,0.0471
153.111.172.30,<->,8.252.222.223,0,0,2,100,2,100,1.504063000,0.0017
129.31.169.113,<->,8.183.25.124,0,0,2,112,2,112,1.501826000,0.0419
195.71.67.80,<->,136.25.188.209,0,0,2,188,2,188,1.493197000,0.4042
221.102.56.69,<->,102.83.27.68,0,0,2,112,2,112,1.489220000,0.3818
192.65.64.48,<->,8.55.211.213,2,112,0,0,2,112,1.482932000,0.0041
221.102.56.69,<->,6.74.243.3,0,0,2,112,2,112,1.470623000,0.3884
215.158.239.59,<->,195.49.13.174,2,112,0,0,2,112,1.470030000,0.0196
8.52.179.237,<->,6.231.239.220,2,112,0,0,2,112,1.464465000,0.1010
239.66.46.155,<->,159.137.235.224,0,0,2,100,2,100,1.464276000,0.0107
197.113.99.244,<->,136.25.188.227,0,0,2,112,2,112,1.444393000,0.0389
22.62.92.244,<->,8.183.24.109,0,0,2,100,2,100,1.437761000,0.3614
215.158.239.76,<->,207.191.73.225,2,112,0,0,2,112,1.435855000,0.2602
204.60.124.72,<->,136.25.188.243,0,0,2,149,2,149,1.435663000,0.1200
143.128.24.209,<->,136.25.188.255,0,0,2,100,2,100,1.429532000,0.0406
221.102.56.46,<->,192.64.248.163,0,0,2,112,2,112,1.394374000,0.1430
92.181.155.55,<->,8.204.53.229,2,112,0,0,2,112,1.381878000,0.3737
158.221.127.30,<->,50.224.76.234,0,0,2,100,2,100,1.361093000,0.0020
128.1.13.147,<->,89.183.110.72,0,0,2,112,2,112,1.351556000,0.4928
215.158.239.79,<->,199.20.29.72,2,112,0,0,2,112,1.345703000,0.0000
133.54.26.241,<->,27.117.140.41,2,100,0,0,2,100,1.335908000,0.1951
243.134.122.0,<->,8.183.25.124,0,0,2,100,2,100,1.330232000,0.0000
215.158.239.69,<->,199.20.31.208,2,149,0,0,2,149,1.327915000,0.0021
252.171.236.72,<->,50.224.76.248,0,0,2,112,2,112,1.327683000,0.1825
109.222.219.163,<->,53.214.88.10,2,112,0,0,2,112,1.324242000,0.2529
17.0.7.92,<->,8.220.190.86,0,0,2,112,2,112,1.311966000,0.3515
215.158.239.96,<->,195.81.3.160,2,197,0,0,2,197,1.299476000,0.2204
252.132.51.222,<->,92.27.194.147,0,0,2,112,2,112,1.283747000,0.0024
143.132.175.227,<->,136.25.188.255,0,0,2,100,2,100,1.280771000,0.0022
102.44.70.160,<->,92.162.253.45,0,0,2,414,2,414,1.280686000,0.0000
91.51.152.82,<->,8.53.2.189,0,0,2,112,2,112,1.275420000,0.0043
204.200.60.4,<->,136.25.188.174,0,0,2,149,2,149,1.272030000,0.6720
69.128.138.24,<->,53.213.63.93,2,112,0,0,2,112,1.261982000,0.7346
246.253.157.15,<->,112.5.73.193,2,100,0,0,2,100,1.253239000,0.2388
143.76.175.211,<->,8.182.227.180,0,0,2,100,2,100,1.250696000,0.0022
221.102.56.69,<->,220.81.26.217,0,0,2,112,2,112,1.236531000,0.1745
199.73.130.216,<->,136.25.188.241,0,0,2,163,2,163,1.230140000,0.5815
221.102.98.9,<->,100.239.17.130,2,112,0,0,2,112,1.227449000,0.0079
225.120.209.61,<->,50.224.76.235,0,0,2,112,2,112,1.223747000,0.0211
112.118.148.133,<->,109.1.58.226,0,0,2,100,2,100,1.207890000,0.3250
215.158.239.56,<->,195.83.227.71,2,112,0,0,2,112,1.170379000,0.2601
134.0.214.2,<->,89.183.104.136,0,0,2,100,2,100,1.168848000,0.2924
207.193.113.191,<->,8.252.222.141,0,0,2,112,2,112,1.166946000,0.7651
129.138.248.137,<->,8.252.222.157,0,0,2,112,2,112,1.164187000,0.0023
136.181.42.3,<->,82.193.206.111,2,112,0,0,2,112,1.145088000,0.0021
215.158.239.87,<->,199.68.207.61,2,149,0,0,2,149,1.134127000,0.7151
195.13.251.5,<->,136.25.188.220,0,0,2,188,2,188,1.130445000,0.4962
215.158.239.56,<->,195.54.55.145,2,100,0,0,2,100,1.129008000,0.5920
76.179.26.127,<->,8.252.221.221,0,0,2,112,2,112,1.128742000,0.1207
144.93.201.3,<->,8.220.186.82,0,0,2,112,2,112,1.113598000,0.0753
194.194.188.83,<->,50.224.76.235,0,0,2,100,2,100,1.107680000,0.4399
111.88.201.74,<->,8.220.176.253,0,0,2,112,2,112,1.106772000,0.0012
215.158.239.93,<->,196.105.53.59,2,112,0,0,2,112,1.104322000,0.2592
207.193.32.90,<->,8.182.227.180,0,0,2,100,2,100,1.079117000,0.0010
100.192.167.54,<->,8.52.222.23,0,0,2,100,2,100,1.072443000,0.0010
247.118.158.36,<->,8.182.253.52,0,0,2,112,2,112,1.061068000,0.4161
89.204.65.12,<->,8.182.251.47,0,0,2,112,2,112,1.042896000,0.1860
111.146.225.58,<->,8.222.6.62,2,100,0,0,2,100,1.033672000,0.0018
215.158.238.186,<->,215.158.43.40,2,112,0,0,2,112,1.026913000,0.9039
232.31.110.202,<->,97.198.118.56,0,0,2,112,2,112,1.009670000,0.1538
216.184.1.115,<->,136.25.188.164,0,0,2,112,2,112,1.008626000,0.9110
129.224.112.252,<->,97.242.126.179,2,112,0,0,2,112,1.001128000,0.9585
192.65.42.219,<->,8.55.195.24,2,112,0,0,2,112,0.993472000,0.0715
48.19.185.80,<->,8.252.221.198,0,0,2,100,2,100,0.992674000,0.0007
239.66.104.49,<->,97.198.118.56,0,0,2,112,2,112,0.985418000,0.0190
215.158.239.101,<->,129.222.39.139,2,112,0,0,2,112,0.972076000,0.1188
246.253.253.106,<->,210.231.140.55,2,100,0,0,2,100,0.963345000,0.0738
136.25.188.34,<->,127.168.165.134,2,112,0,0,2,112,0.960486000,0.0050
232.31.43.150,<->,97.198.118.56,0,0,2,112,2,112,0.957413000,0.0662
215.158.239.211,<->,210.231.140.46,2,120,0,0,2,120,0.956339000,0.0000
215.158.239.56,<->,143.91.212.113,2,112,0,0,2,112,0.948375000,0.8300
215.158.239.239,<->,210.231.140.46,2,114,0,0,2,114,0.936429000,0.0000
139.193.141.200,<->,27.74.241.183,2,100,0,0,2,100,0.931850000,0.0001
231.140.71.101,<->,136.25.188.45,0,0,2,112,2,112,0.930563000,0.0136
99.181.53.171,<->,8.52.240.121,0,0,2,112,2,112,0.928472000,0.2661
129.92.115.88,<->,33.239.63.145,2,112,0,0,2,112,0.926536000,0.2089
199.80.24.87,<->,136.25.188.253,0,0,2,100,2,100,0.925946000,0.0175
109.222.222.94,<->,53.239.138.128,2,181,0,0,2,181,0.918516000,0.3850
94.194.201.39,<->,8.252.221.204,0,0,2,100,2,100,0.912820000,0.4314
215.158.238.106,<->,113.23.104.220,2,112,0,0,2,112,0.908747000,0.0076
246.253.198.51,<->,119.119.129.12,2,100,0,0,2,100,0.900689000,0.2852
42.230.95.115,<->,39.248.89.73,0,0,2,112,2,112,0.896946000,0.0000
99.215.109.108,<->,8.182.244.237,0,0,2,112,2,112,0.889957000,0.0003
200.174.210.241,<->,53.213.148.81,2,181,0,0,2,181,0.888999000,1.0560
94.185.224.29,<->,8.252.222.174,0,0,2,197,2,197,0.883342000,0.5214
229.96.181.7,<->,8.181.151.154,2,112,0,0,2,112,0.881764000,0.0161
218.154.30.233,<->,8.52.222.23,0,0,2,100,2,100,0.871712000,0.0029
199.122.246.125,<->,136.25.188.220,0,0,2,100,2,100,0.871193000,0.2597
99.187.125.121,<->,8.20.87.32,0,0,2,112,2,112,0.863268000,0.8568
213.38.254.205,<->,8.55.211.213,2,112,0,0,2,112,0.862914000,0.0161
215.158.238.186,<->,215.158.43.14,2,112,0,0,2,112,0.858277000,0.2393
133.56.201.50,<->,8.52.189.207,0,0,2,112,2,112,0.855819000,0.1153
94.192.201.131,<->,8.252.221.236,0,0,2,100,2,100,0.803708000,0.4791
218.4.171.168,<->,8.192.173.161,2,112,0,0,2,112,0.793189000,0.7421
145.16.59.85,<->,144.85.169.209,2,417,0,0,2,417,0.779494000,0.1248
196.148.175.168,<->,8.181.37.222,2,112,0,0,2,112,0.774377000,0.6436
200.174.215.121,<->,53.203.244.195,2,325,0,0,2,325,0.772578000,1.1648
215.158.140.217,<->,112.235.95.54,2,384,0,0,2,384,0.772193000,0.1243
17.5.13.62,<->,8.52.179.237,0,0,2,112,2,112,0.772187000,0.4139
243.117.36.147,<->,89.183.110.72,0,0,2,112,2,112,0.771150000,0.4108
111.147.195.158,<->,97.110.90.234,2,100,0,0,2,100,0.769539000,1.1799
95.245.113.50,<->,8.252.221.204,0,0,2,112,2,112,0.761656000,0.4867
133.178.227.108,<->,41.161.45.58,2,112,0,0,2,112,0.754832000,0.1655
109.1.21.151,<->,8.45.175.31,2,100,0,0,2,100,0.741438000,0.0607
239.66.164.120,<->,97.198.118.56,0,0,2,112,2,112,0.741276000,0.0477
210.209.251.211,<->,192.64.215.193,0,0,2,100,2,100,0.741258000,0.0001
232.31.192.220,<->,97.198.118.56,0,0,2,112,2,112,0.740965000,0.6143
97.198.118.56,<->,27.11.142.84,2,112,0,0,2,112,0.740316000,0.2286
53.149.38.189,<->,8.228.215.41,0,0,2,163,2,163,0.740019000,0.9591
232.31.196.176,<->,97.198.118.56,0,0,2,112,2,112,0.738257000,0.0220
144.64.136.129,<->,136.116.9.75,2,100,0,0,2,100,0.735753000,1.0594
221.102.56.69,<->,102.81.131.138,0,0,2,112,2,112,0.733955000,0.0811
239.66.21.86,<->,97.198.118.56,0,0,2,112,2,112,0.729678000,0.2251
232.31.148.10,<->,97.198.118.56,0,0,2,112,2,112,0.729407000,0.0189
195.41.211.140,<->,136.25.188.225,0,0,2,100,2,100,0.722980000,0.8561
98.128.107.99,<->,8.55.211.213,2,112,0,0,2,112,0.721901000,0.1147
199.52.68.236,<->,136.25.188.198,0,0,2,100,2,100,0.718658000,0.0019
149.224.19.220,<->,97.198.118.56,0,0,2,112,2,112,0.710495000,0.0659
100.230.43.160,<->,50.224.72.12,0,0,2,100,2,100,0.709344000,0.6863
194.234.241.111,<->,136.25.188.199,0,0,2,149,2,149,0.709265000,0.3753
111.146.224.2,<->,53.149.237.205,2,112,0,0,2,112,0.700999000,0.0048
142.248.23.11,<->,136.25.188.46,0,0,2,149,2,149,0.700829000,1.1642
221.102.56.69,<->,6.75.204.162,0,0,2,112,2,112,0.694396000,0.0039
92.27.219.188,<->,27.11.166.221,2,162,0,0,2,162,0.694271000,0.0533
232.31.192.216,<->,97.198.118.56,0,0,2,112,2,112,0.694189000,0.0110
215.158.239.58,<->,199.20.28.114,2,149,0,0,2,149,0.690545000,0.0004
207.62.181.205,<->,136.25.188.174,0,0,2,100,2,100,0.687680000,0.4787
195.71.50.46,<->,136.25.188.177,0,0,2,100,2,100,0.686848000,0.3928
215.158.239.86,<->,199.20.29.193,2,100,0,0,2,100,0.672084000,0.0007
215.158.239.50,<->,199.20.30.27,2,112,0,0,2,112,0.662456000,0.0000
207.66.72.41,<->,8.182.229.19,0,0,2,125,2,125,0.660601000,0.0012
192.65.40.174,<->,8.55.211.213,2,112,0,0,2,112,0.659968000,0.2417
89.155.251.27,<->,8.182.227.14,0,0,2,112,2,112,0.653831000,0.2034
143.129.169.210,<->,136.25.188.162,0,0,2,112,2,112,0.643512000,0.3030
136.25.188.243,<->,8.227.55.87,2,112,0,0,2,112,0.642124000,0.0349
144.86.147.98,<->,35.56.3.196,2,100,0,0,2,100,0.638318000,0.9993
75.31.146.51,<->,8.252.221.221,0,0,2,112,2,112,0.636051000,0.0084
252.98.139.93,<->,210.209.251.211,2,100,0,0,2,100,0.630571000,0.0454
215.158.239.86,<->,199.33.220.112,2,143,0,0,2,143,0.601048000,0.4694
215.158.239.86,<->,143.128.151.156,2,112,0,0,2,112,0.597218000,0.9414
243.117.82.36,<->,129.78.117.164,0,0,2,100,2,100,0.570491000,0.5240
17.90.64.205,<->,8.220.200.124,0,0,2,112,2,112,0.567522000,0.0022
202.33.5.182,<->,136.25.188.226,0,0,2,112,2,112,0.562514000,0.0044
159.23.227.241,<->,141.21.241.15,2,112,0,0,2,112,0.561287000,1.1874
202.33.5.182,<->,136.25.188.209,0,0,2,112,2,112,0.560106000,0.0848
98.67.155.83,<->,82.193.202.117,2,112,0,0,2,112,0.551357000,0.1446
144.71.43.239,<->,38.229.228.56,2,100,0,0,2,100,0.549445000,0.0090
146.149.81.142,<->,8.252.221.231,0,0,2,100,2,100,0.546957000,0.4138
243.117.93.2,<->,35.56.96.75,0,0,2,100,2,100,0.545767000,0.1148
204.2.222.151,<->,136.25.188.209,0,0,2,188,2,188,0.533878000,0.9332
192.64.228.240,<->,8.49.69.216,2,112,0,0,2,112,0.530377000,0.0002
246.253.253.113,<->,210.209.251.211,2,373,0,0,2,373,0.521353000,0.0000
130.2.77.218,<->,80.38.45.116,0,0,2,100,2,100,0.518696000,1.3504
239.66.110.113,<->,203.215.177.34,0,0,2,112,2,112,0.518660000,1.3704
215.158.239.78,<->,207.57.215.230,2,100,0,0,2,100,0.517832000,1.4517
221.102.56.69,<->,192.67.115.110,0,0,2,112,2,112,0.516756000,0.0229
101.129.32.178,<->,98.67.158.12,0,0,2,100,2,100,0.515133000,0.1782
221.102.56.69,<->,218.4.179.115,0,0,2,112,2,112,0.502481000,0.7393
17.68.77.212,<->,8.220.198.10,0,0,2,100,2,100,0.502356000,0.3950
250.5.201.28,<->,0.195.210.42,0,0,2,100,2,100,0.499510000,0.1013
109.1.5.52,<->,92.160.68.135,2,100,0,0,2,100,0.496111000,0.0029
221.102.56.69,<->,192.64.225.2,0,0,2,112,2,112,0.492182000,0.0676
53.160.44.69,<->,48.53.36.9,0,0,2,119,2,119,0.489673000,1.0581
207.36.42.96,<->,92.27.194.147,0,0,2,112,2,112,0.486408000,0.7594
215.158.239.211,<->,145.82.220.164,2,112,0,0,2,112,0.480880000,0.3892
220.28.114.25,<->,111.147.106.141,0,0,2,324,2,324,0.452875000,1.2461
136.18.96.147,<->,8.182.253.209,0,0,2,100,2,100,0.450166000,0.0033
80.41.28.151,<->,50.145.65.73,2,112,0,0,2,112,0.442333000,0.6420
142.252.167.45,<->,136.25.188.226,0,0,2,100,2,100,0.427814000,0.6221
144.86.151.96,<->,8.16.244.137,2,112,0,0,2,112,0.422366000,0.0384
220.50.215.94,<->,50.224.80.75,0,0,2,112,2,112,0.421485000,1.3432
80.27.157.123,<->,69.175.101.3,2,100,0,0,2,100,0.419575000,0.0105
249.101.100.85,<->,210.209.251.211,2,574,0,0,2,574,0.419281000,0.0000
53.161.180.137,<->,48.55.35.116,0,0,2,112,2,112,0.416456000,0.9996
136.25.188.227,<->,30.73.132.24,2,149,0,0,2,149,0.415523000,1.2997
221.102.56.46,<->,80.41.223.64,0,0,2,359,2,359,0.375462000,0.5398
17.23.198.220,<->,8.220.191.154,0,0,2,100,2,100,0.373654000,0.0021
215.158.239.68,<->,143.128.227.162,2,100,0,0,2,100,0.369177000,0.7292
204.41.29.229,<->,8.52.227.111,0,0,2,100,2,100,0.348277000,0.0100
80.42.184.215,<->,8.55.237.110,2,112,0,0,2,112,0.345176000,1.2096
215.158.238.212,<->,215.158.43.1,2,112,0,0,2,112,0.341241000,0.9548
246.254.97.104,<->,210.231.140.38,2,114,0,0,2,114,0.340335000,0.0000
136.25.189.37,<->,98.219.126.175,2,112,0,0,2,112,0.336929000,1.2349
138.121.99.24,<->,8.220.190.86,0,0,2,100,2,100,0.327778000,0.3168
223.120.19.40,<->,8.252.221.221,0,0,2,112,2,112,0.321575000,0.7474
8.220.176.253,<->,6.74.212.63,2,112,0,0,2,112,0.319977000,0.0272
199.122.48.39,<->,136.25.188.163,0,0,2,112,2,112,0.314290000,1.0043
215.158.239.48,<->,199.20.7.72,2,100,0,0,2,100,0.308833000,0.2415
144.85.170.254,<->,91.69.185.180,2,112,0,0,2,112,0.303694000,1.0161
221.102.56.69,<->,220.80.167.246,0,0,2,112,2,112,0.296880000,0.0344
246.253.168.253,<->,222.245.128.141,2,100,0,0,2,100,0.288032000,0.3119
17.166.0.253,<->,8.220.200.124,0,0,2,100,2,100,0.288032000,0.3000
80.38.16.211,<->,54.68.57.160,2,100,0,0,2,100,0.278233000,1.4508
215.158.239.49,<->,199.20.29.153,2,112,0,0,2,112,0.270264000,0.0897
90.240.140.125,<->,84.4.11.134,2,150,0,0,2,150,0.269572000,1.5480
215.158.239.77,<->,207.228.66.131,2,100,0,0,2,100,0.268636000,1.2799
133.178.226.30,<->,96.155.60.216,2,112,0,0,2,112,0.263475000,0.9308
215.158.30.238,<->,8.252.222.57,0,0,2,112,2,112,0.244086000,0.0281
210.209.251.211,<->,111.147.248.65,0,0,2,1365,2,1365,0.241602000,0.0000
159.137.189.229,<->,19.195.138.181,2,112,0,0,2,112,0.235203000,1.2967
144.87.238.89,<->,8.182.230.205,0,0,2,100,2,100,0.230333000,0.8119
215.158.239.68,<->,196.91.81.242,2,149,0,0,2,149,0.211878000,0.0001
215.158.238.247,<->,215.158.43.33,2,112,0,0,2,112,0.210523000,1.5080
215.158.239.84,<->,194.199.218.18,2,188,0,0,2,188,0.208540000,0.3898
108.39.84.149,<->,50.224.89.241,0,0,2,112,2,112,0.202854000,0.0687
221.102.56.46,<->,220.83.32.78,0,0,2,650,2,650,0.193922000,0.5196
94.192.15.227,<->,8.252.222.44,0,0,2,188,2,188,0.190680000,0.7442
215.158.238.212,<->,215.158.43.0,2,112,0,0,2,112,0.189652000,1.4684
197.113.88.116,<->,144.86.150.79,0,0,2,100,2,100,0.189541000,1.5129
194.233.73.10,<->,136.25.188.53,0,0,2,112,2,112,0.185625000,0.0092
215.158.239.93,<->,199.20.4.135,2,100,0,0,2,100,0.185034000,0.0504
144.70.14.36,<->,116.100.98.32,2,112,0,0,2,112,0.183068000,1.2341
109.3.128.230,<->,8.45.175.127,2,112,0,0,2,112,0.177504000,0.0754
144.87.238.91,<->,8.182.224.87,0,0,2,100,2,100,0.176754000,0.7430
109.222.199.118,<->,91.40.184.34,2,112,0,0,2,112,0.176366000,0.1533
207.63.113.124,<->,136.25.188.46,0,0,2,264,2,264,0.169290000,1.0146
194.233.103.247,<->,136.25.188.255,0,0,2,112,2,112,0.158822000,0.2404
132.168.199.82,<->,53.84.228.210,2,112,0,0,2,112,0.158063000,1.4940
199.120.132.194,<->,136.25.188.209,0,0,2,188,2,188,0.135665000,0.8444
210.209.251.211,<->,111.147.160.100,0,0,2,1388,2,1388,0.131841000,0.0000
204.58.178.191,<->,136.25.188.253,0,0,2,100,2,100,0.129149000,0.9493
50.224.76.248,<->,48.129.94.134,2,112,0,0,2,112,0.122284000,0.0108
99.187.125.121,<->,8.20.87.5,0,0,2,112,2,112,0.116040000,0.3575
98.128.214.64,<->,8.45.175.127,2,282,0,0,2,282,0.110012000,0.4689
242.6.19.104,<->,50.224.76.235,0,0,2,112,2,112,0.105464000,0.2222
220.50.242.203,<->,215.158.239.104,0,0,2,112,2,112,0.095036000,0.0035
221.102.56.69,<->,80.42.206.154,0,0,2,112,2,112,0.088767000,0.0756
216.184.1.103,<->,8.252.222.128,0,0,2,112,2,112,0.080749000,1.2432
132.168.196.110,<->,54.43.249.8,2,100,0,0,2,100,0.059661000,1.6451
215.158.239.96,<->,196.91.240.5,2,112,0,0,2,112,0.059067000,1.1600
195.5.52.146,<->,136.25.188.176,0,0,2,100,2,100,0.054444000,0.0032
80.38.8.26,<->,46.44.235.228,2,100,0,0,2,100,0.042223000,1.7394
92.27.219.191,<->,33.57.78.105,2,100,0,0,2,100,0.042112000,0.0261
133.54.22.69,<->,35.55.8.92,2,112,0,0,2,112,0.029919000,0.0939
102.88.200.8,<->,50.224.76.235,0,0,2,112,2,112,0.017341000,0.0146
197.161.241.95,<->,136.25.188.225,0,0,2,264,2,264,0.012595000,0.7296
100.94.152.199,<->,89.155.61.122,2,112,0,0,2,112,0.012015000,0.0012
74.133.18.141,<->,8.52.134.84,0,0,2,100,2,100,0.009052000,0.0065
239.66.110.113,<->,203.215.177.36,0,0,2,112,2,112,0.006158000,1.9016
111.14.251.182,<->,8.182.244.237,0,0,2,100,2,100,0.000643000,0.0000
207.62.129.228,<->,136.25.188.163,0,0,1,50,1,50,1.999915000,0.0000
143.132.133.221,<->,136.25.188.45,0,0,1,56,1,56,1.999649000,0.0000
159.137.162.213,<->,29.134.123.217,1,50,0,0,1,50,1.999600000,0.0000
203.116.195.130,<->,136.25.188.239,0,0,1,56,1,56,1.999518000,0.0000
204.200.61.119,<->,136.25.188.163,0,0,1,56,1,56,1.999497000,0.0000
144.108.94.67,<->,99.162.77.146,0,0,1,50,1,50,1.999340000,0.0000
114.246.59.79,<->,97.198.118.110,0,0,1,56,1,56,1.999283000,0.0000
101.224.182.5,<->,92.162.253.20,0,0,1,50,1,50,1.998261000,0.0000
199.14.210.238,<->,136.25.188.198,0,0,1,50,1,50,1.998035000,0.0000
204.3.169.225,<->,136.25.188.163,0,0,1,50,1,50,1.997947000,0.0000
221.102.143.189,<->,220.83.114.215,0,0,1,75,1,75,1.997807000,0.0000
53.149.17.194,<->,48.53.234.112,0,0,1,56,1,56,1.997641000,0.0000
132.211.85.158,<->,98.236.90.61,0,0,1,50,1,50,1.997449000,0.0000
228.75.38.43,<->,92.162.252.233,0,0,1,50,1,50,1.997079000,0.0000
192.64.250.252,<->,109.219.207.11,1,50,0,0,1,50,1.996890000,0.0000
194.237.125.198,<->,136.25.188.238,0,0,1,50,1,50,1.996568000,0.0000
8.45.168.98,<->,6.72.10.208,0,0,1,50,1,50,1.995458000,0.0000
242.21.50.110,<->,8.182.239.144,0,0,1,50,1,50,1.995305000,0.0000
120.47.187.252,<->,80.38.40.56,0,0,1,56,1,56,1.994920000,0.0000
129.95.133.231,<->,8.201.224.59,0,0,1,56,1,56,1.993052000,0.0000
99.162.70.146,<->,54.37.162.116,1,50,0,0,1,50,1.992968000,0.0000
195.109.35.75,<->,99.73.186.154,0,0,1,56,1,56,1.992917000,0.0000
101.70.121.211,<->,53.197.213.66,1,1029,0,0,1,1029,1.992916000,0.0000
214.85.253.103,<->,50.224.76.235,0,0,1,56,1,56,1.992098000,0.0000
215.158.140.181,<->,53.231.93.171,1,50,0,0,1,50,1.991868000,0.0000
133.54.43.35,<->,88.2.255.142,1,56,0,0,1,56,1.991636000,0.0000
93.181.154.111,<->,92.27.219.197,0,0,1,50,1,50,1.990451000,0.0000
54.37.9.160,<->,48.53.95.39,0,0,1,56,1,56,1.990147000,0.0000
220.82.37.72,<->,132.18.67.28,1,50,0,0,1,50,1.990067000,0.0000
139.193.141.207,<->,110.68.182.105,1,56,0,0,1,56,1.989868000,0.0000
215.158.239.77,<->,199.20.7.209,1,56,0,0,1,56,1.989796000,0.0000
215.158.239.50,<->,194.251.95.32,1,56,0,0,1,56,1.988834000,0.0000
251.98.38.228,<->,50.224.76.234,0,0,1,56,1,56,1.988615000,0.0000
231.140.68.187,<->,136.25.188.209,0,0,1,50,1,50,1.988269000,0.0000
144.85.170.208,<->,98.87.145.175,1,56,0,0,1,56,1.987552000,0.0000
215.158.239.68,<->,199.20.5.132,1,56,0,0,1,56,1.987290000,0.0000
132.118.97.71,<->,109.1.49.70,0,0,1,50,1,50,1.986985000,0.0000
129.19.150.122,<->,50.224.108.164,0,0,1,50,1,50,1.986973000,0.0000
133.178.226.255,<->,17.128.69.208,1,56,0,0,1,56,1.986635000,0.0000
207.22.224.140,<->,0.195.210.46,0,0,1,56,1,56,1.986193000,0.0000
215.158.239.48,<->,196.90.192.14,1,56,0,0,1,56,1.986106000,0.0000
225.41.137.39,<->,50.224.76.235,0,0,1,56,1,56,1.985994000,0.0000
144.71.44.80,<->,120.241.62.116,1,50,0,0,1,50,1.985580000,0.0000
246.254.97.109,<->,56.114.235.120,1,309,0,0,1,309,1.985526000,0.0000
111.147.134.68,<->,97.46.125.149,1,56,0,0,1,56,1.984663000,0.0000
111.146.222.49,<->,53.245.224.206,1,50,0,0,1,50,1.984207000,0.0000
199.39.41.121,<->,136.25.188.209,0,0,1,56,1,56,1.983998000,0.0000
64.210.146.9,<->,8.252.221.223,0,0,1,50,1,50,1.982092000,0.0000
204.63.45.166,<->,136.25.188.237,0,0,1,56,1,56,1.981870000,0.0000
207.163.164.201,<->,50.224.76.234,0,0,1,56,1,56,1.980259000,0.0000
195.14.37.76,<->,136.25.188.238,0,0,1,50,1,50,1.979868000,0.0000
68.74.242.126,<->,8.252.221.236,0,0,1,50,1,50,1.979252000,0.0000
199.15.53.151,<->,136.25.188.255,0,0,1,56,1,56,1.978240000,0.0000
246.45.209.210,<->,202.178.8.198,1,50,0,0,1,50,1.976459000,0.0000
50.224.76.235,<->,8.142.42.110,1,56,0,0,1,56,1.976357000,0.0000
132.216.159.29,<->,92.162.253.28,0,0,1,50,1,50,1.976028000,0.0000
221.102.56.69,<->,80.40.58.69,0,0,1,56,1,56,1.975330000,0.0000
204.187.124.135,<->,136.25.188.199,0,0,1,56,1,56,1.975288000,0.0000
98.23.123.117,<->,8.182.250.109,0,0,1,56,1,56,1.974627000,0.0000
215.158.239.113,<->,129.222.36.45,1,56,0,0,1,56,1.973790000,0.0000
129.225.134.164,<->,129.225.132.97,0,0,1,50,1,50,1.973489000,0.0000
143.134.235.114,<->,136.25.188.163,0,0,1,50,1,50,1.973328000,0.0000
112.24.68.114,<->,80.38.35.91,0,0,1,50,1,50,1.973302000,0.0000
220.20.200.184,<->,113.173.254.227,1,50,0,0,1,50,1.973045000,0.0000
121.189.46.48,<->,92.27.194.147,0,0,1,56,1,56,1.972032000,0.0000
215.158.239.56,<->,196.0.229.34,1,56,0,0,1,56,1.971948000,0.0000
220.28.108.254,<->,133.178.227.21,0,0,1,56,1,56,1.971171000,0.0000
143.20.129.111,<->,136.25.188.253,0,0,1,56,1,56,1.971062000,0.0000
215.158.140.230,<->,99.75.20.97,1,50,0,0,1,50,1.970726000,0.0000
207.60.85.200,<->,136.25.188.209,0,0,1,56,1,56,1.970372000,0.0000
129.80.83.17,<->,35.56.100.21,0,0,1,118,1,118,1.970232000,0.0000
207.236.72.39,<->,136.25.188.46,0,0,1,50,1,50,1.970006000,0.0000
195.71.147.207,<->,136.25.188.236,0,0,1,56,1,56,1.969421000,0.0000
195.0.198.20,<->,50.224.76.235,0,0,1,56,1,56,1.969387000,0.0000
215.158.239.9,<->,57.185.183.147,1,56,0,0,1,56,1.969227000,0.0000
204.21.191.88,<->,136.25.188.52,0,0,1,50,1,50,1.969223000,0.0000
129.224.112.221,<->,97.242.126.176,1,56,0,0,1,56,1.969176000,0.0000
215.158.239.99,<->,196.89.246.79,1,56,0,0,1,56,1.968590000,0.0000
246.253.253.99,<->,8.20.81.65,1,56,0,0,1,56,1.968309000,0.0000
215.158.239.69,<->,199.20.31.190,1,56,0,0,1,56,1.968306000,0.0000
210.220.219.150,<->,53.180.28.29,1,56,0,0,1,56,1.967715000,0.0000
192.67.150.17,<->,126.198.147.25,1,50,0,0,1,50,1.967659000,0.0000
133.178.226.214,<->,129.175.139.144,1,56,0,0,1,56,1.967380000,0.0000
143.128.10.11,<->,136.25.188.225,0,0,1,56,1,56,1.967209000,0.0000
204.200.40.210,<->,136.25.188.241,0,0,1,50,1,50,1.966561000,0.0000
133.178.226.227,<->,113.23.103.185,1,56,0,0,1,56,1.966255000,0.0000
195.55.131.131,<->,136.25.188.238,0,0,1,56,1,56,1.965358000,0.0000
109.222.219.165,<->,8.232.96.250,1,50,0,0,1,50,1.965338000,0.0000
92.27.219.241,<->,54.39.184.254,1,50,0,0,1,50,1.965331000,0.0000
207.172.164.74,<->,136.25.188.175,0,0,1,56,1,56,1.965266000,0.0000
199.72.101.125,<->,136.25.188.174,0,0,1,56,1,56,1.964090000,0.0000
131.195.9.102,<->,50.224.76.234,0,0,1,56,1,56,1.963934000,0.0000
194.252.68.61,<->,0.195.210.33,0,0,1,56,1,56,1.962530000,0.0000
220.28.110.130,<->,144.86.150.89,0,0,1,50,1,50,1.961346000,0.0000
136.25.188.209,<->,17.140.118.35,1,56,0,0,1,56,1.961328000,0.0000
148.35.65.45,<->,50.224.76.234,0,0,1,56,1,56,1.960369000,0.0000
159.137.162.213,<->,105.81.55.121,1,50,0,0,1,50,1.960050000,0.0000
133.178.226.198,<->,56.97.187.106,1,56,0,0,1,56,1.959571000,0.0000
192.67.130.85,<->,139.241.58.89,1,50,0,0,1,50,1.959072000,0.0000
215.158.238.104,<->,145.14.166.92,1,56,0,0,1,56,1.959003000,0.0000
204.61.21.163,<->,136.25.188.198,0,0,1,56,1,56,1.958270000,0.0000
215.158.209.250,<->,80.27.152.239,0,0,1,56,1,56,1.958127000,0.0000
136.25.188.174,<->,8.255.92.246,1,56,0,0,1,56,1.958020000,0.0000
215.158.239.76,<->,199.80.23.222,1,50,0,0,1,50,1.957785000,0.0000
199.14.5.85,<->,136.25.188.178,0,0,1,56,1,56,1.957462000,0.0000
195.70.148.185,<->,136.25.188.220,0,0,1,50,1,50,1.957334000,0.0000
142.190.83.146,<->,136.25.188.226,0,0,1,50,1,50,1.956982000,0.0000
136.25.189.202,<->,129.222.39.156,1,56,0,0,1,56,1.956883000,0.0000
142.229.138.205,<->,136.25.188.177,0,0,1,50,1,50,1.956599000,0.0000
194.237.136.186,<->,136.25.188.44,0,0,1,50,1,50,1.956479000,0.0000
192.67.173.89,<->,54.35.100.140,1,50,0,0,1,50,1.954777000,0.0000
92.27.219.231,<->,67.240.21.67,1,50,0,0,1,50,1.954620000,0.0000
100.94.43.120,<->,89.205.197.79,1,50,0,0,1,50,1.954496000,0.0000
136.25.188.16,<->,92.58.185.135,1,50,0,0,1,50,1.954435000,0.0000
145.252.122.253,<->,100.120.38.6,1,56,0,0,1,56,1.954304000,0.0000
196.148.133.194,<->,27.64.152.81,1,50,0,0,1,50,1.953908000,0.0000
133.178.226.227,<->,8.191.135.35,1,56,0,0,1,56,1.953796000,0.0000
207.56.170.67,<->,136.25.188.253,0,0,1,50,1,50,1.953614000,0.0000
136.128.59.59,<->,92.162.253.27,0,0,1,50,1,50,1.953371000,0.0000
132.187.73.3,<->,8.182.139.197,0,0,1,56,1,56,1.953325000,0.0000
204.200.63.83,<->,136.25.188.46,0,0,1,56,1,56,1.953286000,0.0000
144.85.170.248,<->,91.69.185.190,1,56,0,0,1,56,1.953137000,0.0000
139.33.174.15,<->,101.70.121.141,0,0,1,50,1,50,1.953020000,0.0000
216.184.1.115,<->,136.25.188.165,0,0,1,56,1,56,1.952613000,0.0000
95.246.72.11,<->,8.252.222.149,0,0,1,50,1,50,1.952473000,0.0000
246.253.168.231,<->,119.118.171.99,1,50,0,0,1,50,1.951940000,0.0000
215.158.238.133,<->,112.220.206.24,1,56,0,0,1,56,1.951592000,0.0000
215.158.239.69,<->,199.20.4.195,1,56,0,0,1,56,1.951328000,0.0000
215.158.140.27,<->,68.124.221.207,1,56,0,0,1,56,1.951106000,0.0000
8.55.211.213,<->,6.74.94.24,0,0,1,56,1,56,1.950860000,0.0000
39.189.129.88,<->,8.20.87.204,0,0,1,50,1,50,1.949985000,0.0000
215.158.239.79,<->,196.88.180.76,1,56,0,0,1,56,1.949699000,0.0000
142.236.24.52,<->,136.25.188.177,0,0,1,56,1,56,1.948945000,0.0000
156.135.202.220,<->,50.223.3.230,0,0,1,56,1,56,1.948542000,0.0000
121.77.99.114,<->,80.42.131.27,0,0,1,50,1,50,1.947316000,0.0000
92.162.253.89,<->,35.62.67.92,1,50,0,0,1,50,1.946986000,0.0000
138.37.95.126,<->,92.162.253.61,0,0,1,50,1,50,1.946632000,0.0000
138.37.95.126,<->,92.162.253.51,0,0,1,50,1,50,1.945761000,0.0000
235.227.104.112,<->,50.224.76.235,0,0,1,56,1,56,1.945732000,0.0000
231.136.241.241,<->,136.25.188.241,0,0,1,56,1,56,1.945045000,0.0000
221.98.66.193,<->,98.249.162.2,1,50,0,0,1,50,1.944651000,0.0000
207.162.182.125,<->,8.182.230.134,0,0,1,56,1,56,1.944419000,0.0000
145.252.124.87,<->,89.155.136.36,1,50,0,0,1,50,1.943982000,0.0000
138.37.95.126,<->,92.162.253.59,0,0,1,50,1,50,1.943083000,0.0000
202.33.86.90,<->,136.25.188.209,0,0,1,56,1,56,1.942495000,0.0000
215.158.239.99,<->,199.106.249.160,1,56,0,0,1,56,1.942451000,0.0000
138.98.204.211,<->,119.45.190.118,1,230,0,0,1,230,1.942443000,0.0000
95.246.72.11,<->,8.252.222.44,0,0,1,50,1,50,1.941374000,0.0000
143.13.208.92,<->,136.25.188.222,0,0,1,50,1,50,1.941346000,0.0000
159.224.178.58,<->,8.53.3.36,0,0,1,50,1,50,1.940990000,0.0000
200.174.218.150,<->,54.59.63.210,1,50,0,0,1,50,1.940848000,0.0000
247.136.248.229,<->,14.30.152.10,1,56,0,0,1,56,1.939511000,0.0000
204.186.124.153,<->,136.25.188.225,0,0,1,56,1,56,1.939191000,0.0000
221.102.123.31,<->,207.86.240.212,1,50,0,0,1,50,1.939113000,0.0000
220.7.136.210,<->,136.25.188.52,0,0,1,50,1,50,1.939112000,0.0000
231.139.2.69,<->,136.25.188.162,0,0,1,56,1,56,1.938911000,0.0000
199.122.101.120,<->,136.25.188.197,0,0,1,50,1,50,1.937849000,0.0000
215.158.239.93,<->,207.59.68.196,1,50,0,0,1,50,1.937089000,0.0000
142.236.207.107,<->,136.25.188.225,0,0,1,50,1,50,1.936641000,0.0000
215.158.239.68,<->,196.91.35.67,1,56,0,0,1,56,1.935838000,0.0000
192.74.126.53,<->,89.183.104.143,0,0,1,50,1,50,1.935516000,0.0000
144.86.144.224,<->,92.162.218.148,1,50,0,0,1,50,1.934841000,0.0000
132.18.67.28,<->,6.228.9.91,0,0,1,50,1,50,1.934684000,0.0000
143.14.0.13,<->,50.224.76.230,0,0,1,56,1,56,1.934509000,0.0000
136.25.188.220,<->,30.73.138.137,1,56,0,0,1,56,1.934478000,0.0000
144.85.169.211,<->,97.126.83.79,0,0,1,56,1,56,1.934459000,0.0000
142.167.122.186,<->,136.25.188.174,0,0,1,56,1,56,1.934195000,0.0000
142.182.203.88,<->,50.224.76.234,0,0,1,50,1,50,1.934168000,0.0000
220.20.200.62,<->,127.255.90.88,1,50,0,0,1,50,1.934154000,0.0000
132.216.159.4,<->,92.162.253.85,0,0,1,1182,1,1182,1.934148000,0.0000
215.158.239.92,<->,207.59.68.196,1,50,0,0,1,50,1.933947000,0.0000
136.25.188.241,<->,99.93.189.162,1,56,0,0,1,56,1.933672000,0.0000
86.194.118.34,<->,0.195.210.24,0,0,1,56,1,56,1.933457000,0.0000
142.253.92.128,<->,136.25.188.253,0,0,1,50,1,50,1.932936000,0.0000
194.254.226.57,<->,8.252.222.156,0,0,1,56,1,56,1.931798000,0.0000
92.27.27.165,<->,74.133.57.237,1,56,0,0,1,56,1.930340000,0.0000
207.56.170.67,<->,136.25.188.225,0,0,1,50,1,50,1.930052000,0.0000
204.45.227.97,<->,8.52.179.217,0,0,1,50,1,50,1.929075000,0.0000
199.8.51.240,<->,50.224.96.57,0,0,1,50,1,50,1.928104000,0.0000
144.85.170.254,<->,136.18.96.216,1,56,0,0,1,56,1.927936000,0.0000
142.240.226.24,<->,136.25.188.241,0,0,1,50,1,50,1.927476000,0.0000
199.70.71.24,<->,136.25.188.177,0,0,1,56,1,56,1.927476000,0.0000
210.60.25.92,<->,92.162.253.102,0,0,1,50,1,50,1.927472000,0.0000
195.71.80.95,<->,136.25.188.253,0,0,1,56,1,56,1.927188000,0.0000
91.57.171.43,<->,8.220.200.21,0,0,1,56,1,56,1.926885000,0.0000
246.254.97.105,<->,139.33.174.16,1,50,0,0,1,50,1.926825000,0.0000
207.59.238.132,<->,136.25.188.52,0,0,1,56,1,56,1.926679000,0.0000
130.2.106.238,<->,50.224.76.234,0,0,1,56,1,56,1.925931000,0.0000
129.254.96.7,<->,80.38.33.214,0,0,1,50,1,50,1.925087000,0.0000
215.158.239.113,<->,129.222.36.103,1,56,0,0,1,56,1.924708000,0.0000
218.154.250.6,<->,8.52.163.19,0,0,1,50,1,50,1.924683000,0.0000
230.206.224.242,<->,145.19.5.99,0,0,1,50,1,50,1.924674000,0.0000
195.5.64.63,<->,136.25.188.226,0,0,1,50,1,50,1.924642000,0.0000
103.237.224.235,<->,8.52.186.161,0,0,1,50,1,50,1.923881000,0.0000
220.80.242.167,<->,8.55.211.213,1,56,0,0,1,56,1.923172000,0.0000
97.43.55.64,<->,50.223.3.230,0,0,1,56,1,56,1.922657000,0.0000
192.64.93.227,<->,8.55.211.213,1,56,0,0,1,56,1.921919000,0.0000
132.18.67.31,<->,97.190.216.19,0,0,1,56,1,56,1.921708000,0.0000
196.88.84.24,<->,136.25.188.253,0,0,1,50,1,50,1.921661000,0.0000
195.54.108.162,<->,136.25.188.162,0,0,1,56,1,56,1.920927000,0.0000
215.158.239.93,<->,207.166.162.210,1,56,0,0,1,56,1.920632000,0.0000
136.214.10.22,<->,92.27.194.112,0,0,1,50,1,50,1.920414000,0.0000
215.158.239.58,<->,199.20.28.161,1,56,0,0,1,56,1.919357000,0.0000
109.222.220.98,<->,54.52.243.230,1,50,0,0,1,50,1.919249000,0.0000
112.7.169.106,<->,8.31.37.173,0,0,1,56,1,56,1.918322000,0.0000
97.209.105.200,<->,80.40.36.227,0,0,1,822,1,822,1.918313000,0.0000
199.122.101.120,<->,136.25.188.241,0,0,1,50,1,50,1.917783000,0.0000
136.25.189.196,<->,129.222.39.209,1,56,0,0,1,56,1.917264000,0.0000
196.88.7.49,<->,136.25.188.237,0,0,1,56,1,56,1.916625000,0.0000
89.204.65.12,<->,8.182.252.86,0,0,1,56,1,56,1.915072000,0.0000
215.158.239.95,<->,199.106.66.60,1,56,0,0,1,56,1.915049000,0.0000
194.233.3.53,<->,136.25.188.174,0,0,1,56,1,56,1.914699000,0.0000
195.71.146.117,<->,136.25.188.176,0,0,1,93,1,93,1.914513000,0.0000
142.190.49.174,<->,136.25.188.196,0,0,1,56,1,56,1.914050000,0.0000
231.138.254.49,<->,136.25.188.178,0,0,1,56,1,56,1.914027000,0.0000
220.20.200.13,<->,144.83.60.136,1,50,0,0,1,50,1.914001000,0.0000
142.227.65.64,<->,50.224.76.234,0,0,1,50,1,50,1.913850000,0.0000
194.244.174.224,<->,8.182.227.180,0,0,1,50,1,50,1.912324000,0.0000
143.12.234.77,<->,136.25.188.174,0,0,1,56,1,56,1.911739000,0.0000
215.158.239.92,<->,196.93.185.246,1,93,0,0,1,93,1.911294000,0.0000
97.53.102.255,<->,8.182.224.248,0,0,1,50,1,50,1.911127000,0.0000
194.234.203.239,<->,136.25.188.236,0,0,1,56,1,56,1.910844000,0.0000
231.142.5.238,<->,136.25.188.175,0,0,1,50,1,50,1.910603000,0.0000
220.20.200.91,<->,132.216.159.4,1,979,0,0,1,979,1.910453000,0.0000
199.80.3.58,<->,136.25.188.253,0,0,1,56,1,56,1.910396000,0.0000
17.255.107.2,<->,8.220.235.203,0,0,1,56,1,56,1.910057000,0.0000
98.219.117.2,<->,80.38.56.244,0,0,1,50,1,50,1.910006000,0.0000
207.188.202.30,<->,136.25.188.220,0,0,1,50,1,50,1.909812000,0.0000
204.61.83.193,<->,136.25.188.44,0,0,1,56,1,56,1.909512000,0.0000
39.189.129.88,<->,8.43.215.120,0,0,1,50,1,50,1.908855000,0.0000
215.158.239.182,<->,149.254.204.166,1,56,0,0,1,56,1.907825000,0.0000
159.223.99.45,<->,8.220.180.84,0,0,1,50,1,50,1.907604000,0.0000
159.223.99.45,<->,8.52.185.129,0,0,1,50,1,50,1.907409000,0.0000
215.158.238.189,<->,122.158.245.7,1,56,0,0,1,56,1.907387000,0.0000
207.61.253.167,<->,136.25.188.46,0,0,1,50,1,50,1.907249000,0.0000
234.182.161.111,<->,97.126.31.66,0,0,1,50,1,50,1.907231000,0.0000
195.13.153.197,<->,136.25.188.242,0,0,1,56,1,56,1.907194000,0.0000
215.158.239.51,<->,195.7.254.154,1,56,0,0,1,56,1.907083000,0.0000
143.53.255.61,<->,136.25.188.225,0,0,1,56,1,56,1.906164000,0.0000
195.15.170.142,<->,136.25.188.241,0,0,1,56,1,56,1.906060000,0.0000
39.189.129.88,<->,8.250.157.155,0,0,1,50,1,50,1.905338000,0.0000
195.124.253.80,<->,136.25.188.209,0,0,1,56,1,56,1.905206000,0.0000
144.85.170.208,<->,98.87.147.158,1,56,0,0,1,56,1.904853000,0.0000
213.221.90.234,<->,144.85.170.248,0,0,1,56,1,56,1.904523000,0.0000
204.184.217.171,<->,136.25.188.198,0,0,1,56,1,56,1.904375000,0.0000
215.158.239.58,<->,199.20.20.169,1,56,0,0,1,56,1.904362000,0.0000
207.58.213.126,<->,136.25.188.53,0,0,1,50,1,50,1.904330000,0.0000
199.83.55.4,<->,136.25.188.209,0,0,1,56,1,56,1.903994000,0.0000
29.214.108.124,<->,8.252.222.18,0,0,1,56,1,56,1.903625000,0.0000
215.158.140.144,<->,135.243.190.253,1,56,0,0,1,56,1.903166000,0.0000
215.158.239.93,<->,196.1.204.70,1,56,0,0,1,56,1.903117000,0.0000
53.160.164.131,<->,48.53.114.198,0,0,1,56,1,56,1.903019000,0.0000
159.137.160.61,<->,120.101.94.28,1,56,0,0,1,56,1.902596000,0.0000
215.158.239.96,<->,204.1.178.17,1,56,0,0,1,56,1.901938000,0.0000
239.66.110.113,<->,203.215.177.31,0,0,1,56,1,56,1.901713000,0.0000
231.138.254.49,<->,136.25.188.241,0,0,1,56,1,56,1.901307000,0.0000
144.108.64.184,<->,136.129.100.124,0,0,1,56,1,56,1.900491000,0.0000
220.28.85.14,<->,215.158.239.90,0,0,1,56,1,56,1.900213000,0.0000
221.102.56.69,<->,220.80.167.49,0,0,1,56,1,56,1.900127000,0.0000
207.58.161.119,<->,136.25.188.209,0,0,1,50,1,50,1.900072000,0.0000
195.12.249.171,<->,136.25.188.224,0,0,1,132,1,132,1.899797000,0.0000
202.178.8.84,<->,108.134.108.232,0,0,1,50,1,50,1.899554000,0.0000
215.158.239.113,<->,129.222.39.134,1,56,0,0,1,56,1.899517000,0.0000
133.178.226.37,<->,8.255.92.246,1,56,0,0,1,56,1.899461000,0.0000
89.152.249.182,<->,8.182.239.159,0,0,1,56,1,56,1.898483000,0.0000
89.216.124.13,<->,54.54.1.89,1,56,0,0,1,56,1.898349000,0.0000
114.251.240.197,<->,50.224.76.248,0,0,1,56,1,56,1.897727000,0.0000
210.209.251.211,<->,144.87.235.222,0,0,1,50,1,50,1.897601000,0.0000
215.158.239.79,<->,196.92.46.128,1,56,0,0,1,56,1.897559000,0.0000
207.20.191.116,<->,8.252.222.208,0,0,1,56,1,56,1.897406000,0.0000
220.20.200.30,<->,144.83.60.153,1,50,0,0,1,50,1.897345000,0.0000
239.66.110.113,<->,203.215.177.30,0,0,1,56,1,56,1.895479000,0.0000
92.27.122.179,<->,35.56.100.21,0,0,1,50,1,50,1.895375000,0.0000
142.190.179.239,<->,136.25.188.252,0,0,1,50,1,50,1.895059000,0.0000
207.64.65.44,<->,50.223.3.230,0,0,1,50,1,50,1.894992000,0.0000
144.85.170.254,<->,91.69.181.215,1,56,0,0,1,56,1.894182000,0.0000
108.131.143.163,<->,8.220.235.178,0,0,1,50,1,50,1.893593000,0.0000
200.174.198.214,<->,53.160.87.174,1,56,0,0,1,56,1.892802000,0.0000
215.158.238.49,<->,129.222.36.70,1,56,0,0,1,56,1.892756000,0.0000
8.55.211.213,<->,6.75.211.43,0,0,1,56,1,56,1.892592000,0.0000
213.186.52.88,<->,144.85.170.254,0,0,1,56,1,56,1.892419000,0.0000
199.68.120.238,<->,136.25.188.160,0,0,1,56,1,56,1.892417000,0.0000
138.80.112.237,<->,8.220.186.61,0,0,1,56,1,56,1.892061000,0.0000
215.158.239.86,<->,196.94.180.143,1,56,0,0,1,56,1.892035000,0.0000
207.58.213.126,<->,136.25.188.209,0,0,1,50,1,50,1.891183000,0.0000
194.220.115.30,<->,50.223.3.228,0,0,1,50,1,50,1.890549000,0.0000
195.68.236.31,<->,136.25.188.238,0,0,1,56,1,56,1.890455000,0.0000
251.24.86.2,<->,8.252.222.132,0,0,1,56,1,56,1.890101000,0.0000
195.41.195.238,<->,136.25.188.238,0,0,1,56,1,56,1.889780000,0.0000
215.158.103.203,<->,33.3.89.166,1,50,0,0,1,50,1.889679000,0.0000
204.3.170.31,<->,136.25.188.252,0,0,1,56,1,56,1.889421000,0.0000
117.111.232.65,<->,109.1.47.253,0,0,1,50,1,50,1.889351000,0.0000
142.207.236.233,<->,136.25.188.253,0,0,1,50,1,50,1.888772000,0.0000
199.70.62.22,<->,136.25.188.225,0,0,1,50,1,50,1.888428000,0.0000
207.239.44.76,<->,136.25.188.252,0,0,1,50,1,50,1.888324000,0.0000
220.38.162.62,<->,215.158.140.181,0,0,1,56,1,56,1.887469000,0.0000
133.59.237.236,<->,8.52.163.19,0,0,1,56,1,56,1.887453000,0.0000
215.158.140.27,<->,98.228.168.159,1,56,0,0,1,56,1.887418000,0.0000
207.239.44.76,<->,136.25.188.222,0,0,1,50,1,50,1.887272000,0.0000
215.158.239.93,<->,196.108.62.238,1,56,0,0,1,56,1.885889000,0.0000
215.158.140.27,<->,80.127.206.96,1,56,0,0,1,56,1.885532000,0.0000
108.39.30.89,<->,50.224.76.235,0,0,1,50,1,50,1.885269000,0.0000
143.114.150.67,<->,50.224.76.234,0,0,1,56,1,56,1.885230000,0.0000
195.5.131.126,<->,136.25.188.160,0,0,1,56,1,56,1.884871000,0.0000
124.47.116.59,<->,50.224.76.235,0,0,1,56,1,56,1.884416000,0.0000
204.56.122.78,<->,136.25.188.255,0,0,1,50,1,50,1.884135000,0.0000
142.229.81.148,<->,136.25.188.163,0,0,1,56,1,56,1.883911000,0.0000
237.162.205.18,<->,133.54.43.12,0,0,1,50,1,50,1.883699000,0.0000
199.120.12.168,<->,136.25.188.236,0,0,1,50,1,50,1.883359000,0.0000
247.136.211.6,<->,232.31.64.94,1,56,0,0,1,56,1.883309000,0.0000
202.33.44.121,<->,136.25.188.178,0,0,1,56,1,56,1.882478000,0.0000
215.158.140.27,<->,141.185.47.151,1,56,0,0,1,56,1.881616000,0.0000
137.45.38.219,<->,8.220.190.86,0,0,1,50,1,50,1.880962000,0.0000
207.61.72.59,<->,136.25.188.242,0,0,1,56,1,56,1.880309000,0.0000
80.41.252.160,<->,8.45.168.98,1,141,0,0,1,141,1.879617000,0.0000
207.61.141.2,<->,136.25.188.252,0,0,1,56,1,56,1.877731000,0.0000
89.183.104.251,<->,53.68.95.1,1,50,0,0,1,50,1.877688000,0.0000
145.232.120.123,<->,58.43.188.36,1,50,0,0,1,50,1.877643000,0.0000
192.65.127.160,<->,8.55.211.213,1,56,0,0,1,56,1.877559000,0.0000
215.158.239.86,<->,143.132.101.154,1,56,0,0,1,56,1.876966000,0.0000
215.158.239.87,<->,142.240.103.195,1,50,0,0,1,50,1.876678000,0.0000
140.147.42.1,<->,8.252.222.28,0,0,1,56,1,56,1.876490000,0.0000
196.17.190.33,<->,50.224.76.234,0,0,1,56,1,56,1.876420000,0.0000
200.174.211.120,<->,54.37.1.37,1,56,0,0,1,56,1.875779000,0.0000
133.178.226.14,<->,99.192.168.186,1,56,0,0,1,56,1.875391000,0.0000
215.158.239.84,<->,195.49.251.245,1,56,0,0,1,56,1.875289000,0.0000
144.85.170.208,<->,56.189.215.197,1,56,0,0,1,56,1.875282000,0.0000
144.72.193.17,<->,80.40.53.29,0,0,1,50,1,50,1.875038000,0.0000
144.85.170.208,<->,98.87.147.161,1,56,0,0,1,56,1.875019000,0.0000
204.200.39.243,<->,136.25.188.255,0,0,1,56,1,56,1.874882000,0.0000
136.25.188.212,<->,80.57.141.209,1,56,0,0,1,56,1.874780000,0.0000
246.253.253.107,<->,56.114.235.120,1,966,0,0,1,966,1.874576000,0.0000
215.158.239.50,<->,199.106.106.24,1,56,0,0,1,56,1.874018000,0.0000
215.158.239.76,<->,143.13.234.114,1,50,0,0,1,50,1.873444000,0.0000
143.20.104.241,<->,136.25.188.225,0,0,1,50,1,50,1.872955000,0.0000
207.57.179.153,<->,136.25.188.46,0,0,1,50,1,50,1.872906000,0.0000
195.54.85.50,<->,136.25.188.209,0,0,1,50,1,50,1.871251000,0.0000
246.254.97.228,<->,139.33.174.68,1,50,0,0,1,50,1.870413000,0.0000
139.33.174.178,<->,97.168.65.251,0,0,1,50,1,50,1.870388000,0.0000
204.1.228.207,<->,136.25.188.209,0,0,1,56,1,56,1.870220000,0.0000
199.71.10.244,<->,136.25.188.238,0,0,1,56,1,56,1.869768000,0.0000
98.236.238.137,<->,27.11.22.41,1,56,0,0,1,56,1.868611000,0.0000
215.158.239.95,<->,199.20.6.26,1,56,0,0,1,56,1.868540000,0.0000
129.224.112.252,<->,97.242.126.184,1,56,0,0,1,56,1.868089000,0.0000
57.154.233.234,<->,50.224.76.230,0,0,1,56,1,56,1.867350000,0.0000
136.25.188.209,<->,50.150.173.171,1,56,0,0,1,56,1.866912000,0.0000
194.237.44.11,<->,136.25.188.222,0,0,1,50,1,50,1.866369000,0.0000
252.152.59.8,<->,215.158.239.17,0,0,1,50,1,50,1.866077000,0.0000
248.225.27.2,<->,82.193.207.46,1,50,0,0,1,50,1.865436000,0.0000
195.70.96.22,<->,136.25.188.252,0,0,1,50,1,50,1.865310000,0.0000
199.82.190.79,<->,136.25.188.178,0,0,1,50,1,50,1.864708000,0.0000
199.39.76.4,<->,136.25.188.196,0,0,1,56,1,56,1.864183000,0.0000
249.101.89.113,<->,50.145.227.155,1,93,0,0,1,93,1.864008000,0.0000
223.176.113.234,<->,8.252.222.36,0,0,1,56,1,56,1.863703000,0.0000
195.14.209.131,<->,136.25.188.239,0,0,1,56,1,56,1.863302000,0.0000
39.189.184.42,<->,8.20.87.86,0,0,1,56,1,56,1.862863000,0.0000
80.38.61.113,<->,38.177.158.149,1,50,0,0,1,50,1.862551000,0.0000
221.102.56.69,<->,6.74.104.58,0,0,1,294,1,294,1.862365000,0.0000
133.135.214.225,<->,129.6.83.5,0,0,1,56,1,56,1.861854000,0.0000
195.7.214.220,<->,136.25.188.52,0,0,1,56,1,56,1.861815000,0.0000
215.158.238.134,<->,33.220.0.39,1,56,0,0,1,56,1.861715000,0.0000
215.158.140.27,<->,98.228.163.96,1,56,0,0,1,56,1.860550000,0.0000
74.142.203.248,<->,8.252.221.204,0,0,1,50,1,50,1.858633000,0.0000
92.180.152.146,<->,92.27.219.231,0,0,1,50,1,50,1.858405000,0.0000
213.221.90.175,<->,144.85.170.208,0,0,1,56,1,56,1.858361000,0.0000
142.195.143.226,<->,136.25.188.225,0,0,1,56,1,56,1.858279000,0.0000
159.137.162.213,<->,92.180.14.181,1,50,0,0,1,50,1.858212000,0.0000
132.213.199.17,<->,8.53.3.201,0,0,1,56,1,56,1.858049000,0.0000
142.253.84.18,<->,136.25.188.252,0,0,1,50,1,50,1.856595000,0.0000
133.178.226.227,<->,29.214.216.96,1,56,0,0,1,56,1.855931000,0.0000
192.74.94.29,<->,8.182.251.218,0,0,1,56,1,56,1.855112000,0.0000
199.80.179.98,<->,136.25.188.46,0,0,1,50,1,50,1.854955000,0.0000
215.158.239.57,<->,195.81.52.214,1,56,0,0,1,56,1.854775000,0.0000
192.170.241.167,<->,8.252.221.164,0,0,1,56,1,56,1.854528000,0.0000
204.56.249.12,<->,136.25.188.241,0,0,1,56,1,56,1.854524000,0.0000
84.14.137.3,<->,8.43.215.120,0,0,1,56,1,56,1.854248000,0.0000
98.159.98.236,<->,8.182.226.194,0,0,1,50,1,50,1.852662000,0.0000
223.176.113.234,<->,8.252.222.141,0,0,1,56,1,56,1.851854000,0.0000
142.221.99.102,<->,136.25.188.227,0,0,1,56,1,56,1.851741000,0.0000
29.214.108.201,<->,8.252.223.130,0,0,1,56,1,56,1.851544000,0.0000
109.222.230.140,<->,109.57.161.32,1,56,0,0,1,56,1.851441000,0.0000
246.253.253.99,<->,139.33.175.151,1,50,0,0,1,50,1.851353000,0.0000
215.158.239.51,<->,196.104.134.164,1,56,0,0,1,56,1.851074000,0.0000
195.127.150.57,<->,136.25.188.53,0,0,1,56,1,56,1.850943000,0.0000
246.44.58.251,<->,111.150.186.0,1,56,0,0,1,56,1.850359000,0.0000
143.43.117.203,<->,136.25.188.46,0,0,1,50,1,50,1.850319000,0.0000
17.136.179.122,<->,8.220.176.253,0,0,1,50,1,50,1.850247000,0.0000
195.127.150.57,<->,136.25.188.176,0,0,1,56,1,56,1.850245000,0.0000
195.14.69.238,<->,136.25.188.226,0,0,1,56,1,56,1.849956000,0.0000
98.67.155.83,<->,53.224.64.121,1,50,0,0,1,50,1.849787000,0.0000
239.227.117.98,<->,112.208.20.192,1,50,0,0,1,50,1.849542000,0.0000
199.72.117.29,<->,136.25.188.178,0,0,1,56,1,56,1.849388000,0.0000
143.132.139.161,<->,136.25.188.252,0,0,1,56,1,56,1.848594000,0.0000
221.102.56.69,<->,192.66.191.203,0,0,1,56,1,56,1.847895000,0.0000
142.247.192.89,<->,136.25.188.174,0,0,1,50,1,50,1.847509000,0.0000
98.248.253.162,<->,50.224.76.234,0,0,1,50,1,50,1.847084000,0.0000
129.92.118.200,<->,91.250.55.98,1,56,0,0,1,56,1.847063000,0.0000
195.54.57.102,<->,136.25.188.236,0,0,1,50,1,50,1.846906000,0.0000
215.158.239.86,<->,196.1.105.243,1,56,0,0,1,56,1.846683000,0.0000
100.224.138.151,<->,97.126.31.80,0,0,1,56,1,56,1.845785000,0.0000
144.85.170.254,<->,91.69.181.222,1,56,0,0,1,56,1.845589000,0.0000
215.158.239.82,<->,80.57.141.131,1,56,0,0,1,56,1.845301000,0.0000
145.252.114.15,<->,109.31.72.114,1,50,0,0,1,50,1.844606000,0.0000
142.227.97.23,<->,50.224.76.234,0,0,1,50,1,50,1.844040000,0.0000
205.72.167.142,<->,50.224.76.248,0,0,1,50,1,50,1.843739000,0.0000
143.76.168.51,<->,8.182.139.40,0,0,1,50,1,50,1.843568000,0.0000
247.136.154.185,<->,27.178.95.28,1,50,0,0,1,50,1.843528000,0.0000
143.148.100.254,<->,0.195.210.46,0,0,1,56,1,56,1.843254000,0.0000
221.102.56.69,<->,109.2.24.130,0,0,1,56,1,56,1.843138000,0.0000
99.187.125.121,<->,8.20.87.33,0,0,1,56,1,56,1.843004000,0.0000
215.158.239.77,<->,207.228.117.16,1,56,0,0,1,56,1.842868000,0.0000
221.196.122.150,<->,136.25.188.173,0,0,1,56,1,56,1.842279000,0.0000
213.186.59.172,<->,144.85.170.208,0,0,1,56,1,56,1.841820000,0.0000
220.20.200.155,<->,198.205.121.180,1,50,0,0,1,50,1.840430000,0.0000
144.85.170.246,<->,144.54.7.171,1,56,0,0,1,56,1.839400000,0.0000
246.253.157.15,<->,119.226.13.55,1,50,0,0,1,50,1.839340000,0.0000
134.98.189.43,<->,80.38.54.178,0,0,1,50,1,50,1.838060000,0.0000
215.158.140.27,<->,95.74.72.71,1,56,0,0,1,56,1.837965000,0.0000
220.20.200.157,<->,132.216.159.4,1,50,0,0,1,50,1.837349000,0.0000
204.200.45.245,<->,136.25.188.196,0,0,1,56,1,56,1.836251000,0.0000
204.200.35.204,<->,136.25.188.225,0,0,1,56,1,56,1.835730000,0.0000
139.33.175.144,<->,8.228.215.157,0,0,1,50,1,50,1.834686000,0.0000
194.253.83.145,<->,50.224.76.235,0,0,1,56,1,56,1.834594000,0.0000
204.21.153.161,<->,136.25.188.179,0,0,1,50,1,50,1.834444000,0.0000
221.102.56.69,<->,192.65.205.59,0,0,1,56,1,56,1.834165000,0.0000
143.44.28.196,<->,136.25.188.199,0,0,1,56,1,56,1.834118000,0.0000
159.137.162.213,<->,6.210.129.148,1,50,0,0,1,50,1.833157000,0.0000
142.191.149.111,<->,136.25.188.252,0,0,1,56,1,56,1.832914000,0.0000
50.224.80.67,<->,29.233.87.16,1,56,0,0,1,56,1.832343000,0.0000
202.33.233.53,<->,136.25.188.225,0,0,1,50,1,50,1.832273000,0.0000
202.33.26.110,<->,136.25.188.179,0,0,1,56,1,56,1.831854000,0.0000
231.143.89.81,<->,136.25.188.54,0,0,1,56,1,56,1.831480000,0.0000
153.245.144.109,<->,80.27.154.138,0,0,1,50,1,50,1.830763000,0.0000
8.181.147.63,<->,8.52.242.106,0,0,1,56,1,56,1.830677000,0.0000
114.205.133.225,<->,50.224.76.234,0,0,1,50,1,50,1.830670000,0.0000
201.41.156.131,<->,159.115.113.93,0,0,1,56,1,56,1.830115000,0.0000
199.82.242.44,<->,136.25.188.242,0,0,1,56,1,56,1.829315000,0.0000
217.244.108.162,<->,50.223.3.230,0,0,1,56,1,56,1.828609000,0.0000
142.255.40.85,<->,136.25.188.52,0,0,1,50,1,50,1.828232000,0.0000
8.182.253.40,<->,6.133.212.101,1,56,0,0,1,56,1.827588000,0.0000
111.20.44.252,<->,97.126.4.233,0,0,1,50,1,50,1.827164000,0.0000
108.134.109.74,<->,8.37.200.100,1,56,0,0,1,56,1.826524000,0.0000
143.132.153.33,<->,136.25.188.174,0,0,1,56,1,56,1.826106000,0.0000
212.249.34.46,<->,109.222.233.44,0,0,1,387,1,387,1.824948000,0.0000
133.178.227.251,<->,29.212.207.49,1,56,0,0,1,56,1.824859000,0.0000
208.122.230.62,<->,89.64.133.48,1,56,0,0,1,56,1.823434000,0.0000
200.174.193.202,<->,54.37.65.21,1,50,0,0,1,50,1.823159000,0.0000
215.158.140.228,<->,41.161.80.229,1,50,0,0,1,50,1.823157000,0.0000
136.25.188.179,<->,41.148.41.133,1,50,0,0,1,50,1.823032000,0.0000
136.25.188.199,<->,61.34.33.254,1,56,0,0,1,56,1.822783000,0.0000
109.222.245.154,<->,50.238.210.101,1,50,0,0,1,50,1.822275000,0.0000
8.222.7.155,<->,8.182.233.87,0,0,1,56,1,56,1.821753000,0.0000
215.158.239.57,<->,196.1.222.190,1,56,0,0,1,56,1.821466000,0.0000
215.158.209.250,<->,97.126.31.80,0,0,1,56,1,56,1.821304000,0.0000
197.113.64.255,<->,136.25.188.163,0,0,1,56,1,56,1.821060000,0.0000
142.179.176.110,<->,139.163.26.238,0,0,1,50,1,50,1.820946000,0.0000
132.18.67.30,<->,80.40.53.29,0,0,1,50,1,50,1.820907000,0.0000
100.81.104.145,<->,50.224.76.235,0,0,1,56,1,56,1.820654000,0.0000
144.93.201.3,<->,8.220.178.166,0,0,1,50,1,50,1.818338000,0.0000
133.178.226.235,<->,113.23.114.102,1,56,0,0,1,56,1.818294000,0.0000
112.30.234.122,<->,92.168.217.228,0,0,1,56,1,56,1.817648000,0.0000
145.29.244.88,<->,8.52.187.43,0,0,1,50,1,50,1.816737000,0.0000
144.72.195.98,<->,100.94.118.188,0,0,1,50,1,50,1.816311000,0.0000
210.60.187.68,<->,111.147.92.14,0,0,1,50,1,50,1.816123000,0.0000
215.158.239.59,<->,196.108.254.251,1,56,0,0,1,56,1.815778000,0.0000
96.47.148.163,<->,8.52.187.74,0,0,1,50,1,50,1.815276000,0.0000
215.158.239.92,<->,207.16.14.38,1,56,0,0,1,56,1.815235000,0.0000
215.158.239.49,<->,142.190.246.182,1,50,0,0,1,50,1.815231000,0.0000
159.137.162.213,<->,110.66.204.9,1,50,0,0,1,50,1.814343000,0.0000
220.55.126.63,<->,137.44.153.224,1,50,0,0,1,50,1.814203000,0.0000
243.117.92.202,<->,80.38.46.20,0,0,1,50,1,50,1.813942000,0.0000
92.27.219.23,<->,88.122.3.5,1,56,0,0,1,56,1.813498000,0.0000
204.62.152.26,<->,136.25.188.253,0,0,1,56,1,56,1.813329000,0.0000
213.38.171.239,<->,50.224.76.248,0,0,1,50,1,50,1.812962000,0.0000
204.200.157.129,<->,136.25.188.176,0,0,1,50,1,50,1.812601000,0.0000
215.158.140.11,<->,53.231.141.31,1,50,0,0,1,50,1.811686000,0.0000
139.33.175.144,<->,111.147.236.79,0,0,1,50,1,50,1.811591000,0.0000
89.155.40.74,<->,8.182.251.218,0,0,1,56,1,56,1.811304000,0.0000
132.149.114.12,<->,53.214.238.49,1,50,0,0,1,50,1.811164000,0.0000
159.137.162.213,<->,126.100.242.174,1,50,0,0,1,50,1.810981000,0.0000
17.213.58.90,<->,8.220.181.167,0,0,1,56,1,56,1.810284000,0.0000
254.242.180.52,<->,124.228.209.84,1,50,0,0,1,50,1.810223000,0.0000
53.148.184.48,<->,48.54.20.117,0,0,1,56,1,56,1.809930000,0.0000
144.85.170.208,<->,98.87.147.120,1,56,0,0,1,56,1.809813000,0.0000
221.102.56.69,<->,218.4.184.243,0,0,1,56,1,56,1.809716000,0.0000
222.4.209.41,<->,159.137.162.213,0,0,1,50,1,50,1.809493000,0.0000
215.158.239.113,<->,129.222.39.190,1,56,0,0,1,56,1.809064000,0.0000
199.121.54.19,<->,136.25.188.45,0,0,1,50,1,50,1.808938000,0.0000
80.40.49.169,<->,38.65.219.171,1,50,0,0,1,50,1.808330000,0.0000
80.42.166.61,<->,8.179.135.180,1,50,0,0,1,50,1.808030000,0.0000
91.69.181.247,<->,50.224.105.45,0,0,1,56,1,56,1.807953000,0.0000
159.240.2.16,<->,8.52.222.23,0,0,1,50,1,50,1.807486000,0.0000
133.178.226.14,<->,8.222.212.40,1,56,0,0,1,56,1.807433000,0.0000
197.113.99.143,<->,136.25.188.227,0,0,1,56,1,56,1.807188000,0.0000
231.136.241.241,<->,136.25.188.236,0,0,1,56,1,56,1.806346000,0.0000
50.224.76.248,<->,8.35.106.90,1,56,0,0,1,56,1.806276000,0.0000
192.64.230.162,<->,125.223.21.203,1,56,0,0,1,56,1.806236000,0.0000
221.102.56.46,<->,192.67.115.24,0,0,1,56,1,56,1.806057000,0.0000
215.158.239.85,<->,199.20.30.24,1,56,0,0,1,56,1.805929000,0.0000
139.33.174.87,<->,111.147.236.79,0,0,1,50,1,50,1.805637000,0.0000
199.121.54.19,<->,136.25.188.227,0,0,1,50,1,50,1.805568000,0.0000
119.159.22.233,<->,92.162.253.39,0,0,1,50,1,50,1.805353000,0.0000
246.108.106.235,<->,111.147.92.14,0,0,1,50,1,50,1.805325000,0.0000
210.158.59.62,<->,92.27.8.159,0,0,1,50,1,50,1.804050000,0.0000
248.225.29.61,<->,53.180.201.219,1,50,0,0,1,50,1.803987000,0.0000
196.119.218.141,<->,50.224.76.230,0,0,1,56,1,56,1.803487000,0.0000
144.71.40.148,<->,139.155.32.124,1,50,0,0,1,50,1.802754000,0.0000
204.152.117.163,<->,50.224.76.234,0,0,1,56,1,56,1.802283000,0.0000
139.163.5.140,<->,130.137.174.13,1,50,0,0,1,50,1.801926000,0.0000
143.95.22.76,<->,136.25.188.222,0,0,1,56,1,56,1.801618000,0.0000
145.189.24.252,<->,8.52.185.143,0,0,1,56,1,56,1.801362000,0.0000
215.158.239.92,<->,199.20.30.64,1,56,0,0,1,56,1.801213000,0.0000
124.46.191.127,<->,92.162.253.144,0,0,1,50,1,50,1.800965000,0.0000
195.41.38.35,<->,8.52.228.29,0,0,1,50,1,50,1.800794000,0.0000
215.158.239.84,<->,196.108.117.163,1,50,0,0,1,50,1.800087000,0.0000
221.102.56.69,<->,80.40.30.130,0,0,1,56,1,56,1.799570000,0.0000
195.88.178.47,<->,8.182.226.78,0,0,1,56,1,56,1.798454000,0.0000
142.167.98.245,<->,136.25.188.209,0,0,1,50,1,50,1.798406000,0.0000
195.41.194.143,<->,136.25.188.225,0,0,1,50,1,50,1.798379000,0.0000
199.71.72.160,<->,136.25.188.198,0,0,1,50,1,50,1.798055000,0.0000
126.109.2.56,<->,50.224.76.248,0,0,1,50,1,50,1.796894000,0.0000
143.132.153.33,<->,136.25.188.46,0,0,1,56,1,56,1.796375000,0.0000
102.44.100.188,<->,53.214.237.111,1,50,0,0,1,50,1.795913000,0.0000
195.54.90.228,<->,136.25.188.252,0,0,1,50,1,50,1.795706000,0.0000
98.23.105.53,<->,8.252.221.249,0,0,1,56,1,56,1.795558000,0.0000
197.113.99.126,<->,136.25.188.222,0,0,1,56,1,56,1.795496000,0.0000
53.68.255.122,<->,48.53.53.225,0,0,1,56,1,56,1.794762000,0.0000
199.52.87.66,<->,136.25.188.198,0,0,1,56,1,56,1.793986000,0.0000
215.158.239.48,<->,142.241.156.45,1,50,0,0,1,50,1.793118000,0.0000
240.117.25.98,<->,50.224.76.235,0,0,1,50,1,50,1.792803000,0.0000
252.132.5.13,<->,92.27.194.117,0,0,1,50,1,50,1.792560000,0.0000
207.62.87.241,<->,136.25.188.222,0,0,1,50,1,50,1.792540000,0.0000
97.19.5.28,<->,8.182.226.78,0,0,1,56,1,56,1.792152000,0.0000
146.248.115.199,<->,141.252.251.223,0,0,1,56,1,56,1.791815000,0.0000
192.67.163.217,<->,146.234.133.196,1,56,0,0,1,56,1.791691000,0.0000
246.253.198.51,<->,126.110.94.90,1,50,0,0,1,50,1.790925000,0.0000
203.212.35.24,<->,50.224.76.230,0,0,1,50,1,50,1.789756000,0.0000
195.55.112.191,<->,136.25.188.241,0,0,1,56,1,56,1.789706000,0.0000
215.158.238.246,<->,215.158.43.0,1,56,0,0,1,56,1.789327000,0.0000
204.3.142.141,<->,136.25.188.241,0,0,1,56,1,56,1.789105000,0.0000
192.67.163.192,<->,145.95.195.20,1,50,0,0,1,50,1.788806000,0.0000
129.148.0.173,<->,50.224.76.234,0,0,1,50,1,50,1.788663000,0.0000
195.124.102.68,<->,136.25.188.252,0,0,1,56,1,56,1.787530000,0.0000
210.220.219.178,<->,53.239.143.73,1,56,0,0,1,56,1.786469000,0.0000
221.102.56.69,<->,192.67.97.23,0,0,1,56,1,56,1.786132000,0.0000
97.243.195.155,<->,8.182.228.20,0,0,1,56,1,56,1.785981000,0.0000
194.237.32.46,<->,136.25.188.242,0,0,1,56,1,56,1.784346000,0.0000
195.61.150.70,<->,50.223.3.228,0,0,1,56,1,56,1.784146000,0.0000
136.116.9.155,<->,50.224.76.234,0,0,1,56,1,56,1.784078000,0.0000
143.42.198.52,<->,136.25.188.177,0,0,1,56,1,56,1.784040000,0.0000
146.240.17.87,<->,50.224.76.229,0,0,1,56,1,56,1.782976000,0.0000
111.146.238.44,<->,54.58.99.60,1,50,0,0,1,50,1.782726000,0.0000
203.119.35.163,<->,80.38.24.63,0,0,1,50,1,50,1.782701000,0.0000
195.4.31.177,<->,136.25.188.178,0,0,1,50,1,50,1.782462000,0.0000
207.40.11.106,<->,50.224.76.234,0,0,1,50,1,50,1.782351000,0.0000
159.248.57.173,<->,136.25.188.209,0,0,1,56,1,56,1.782000000,0.0000
59.142.198.227,<->,8.252.221.238,0,0,1,56,1,56,1.780722000,0.0000
197.107.99.127,<->,136.25.188.176,0,0,1,56,1,56,1.779273000,0.0000
143.135.35.209,<->,136.25.188.53,0,0,1,56,1,56,1.779037000,0.0000
142.249.228.40,<->,136.25.188.198,0,0,1,50,1,50,1.778245000,0.0000
149.97.34.22,<->,50.224.76.234,0,0,1,50,1,50,1.778221000,0.0000
215.158.140.240,<->,29.212.182.13,1,56,0,0,1,56,1.777976000,0.0000
246.254.97.109,<->,210.209.251.214,1,50,0,0,1,50,1.777815000,0.0000
129.225.141.239,<->,129.225.132.80,0,0,1,50,1,50,1.777528000,0.0000
192.67.129.19,<->,136.177.116.176,1,50,0,0,1,50,1.776444000,0.0000
215.158.239.84,<->,196.92.181.47,1,56,0,0,1,56,1.776341000,0.0000
132.44.248.125,<->,50.224.76.230,0,0,1,50,1,50,1.775980000,0.0000
229.45.205.24,<->,222.20.211.148,1,56,0,0,1,56,1.775950000,0.0000
198.230.46.183,<->,159.137.162.213,0,0,1,50,1,50,1.775358000,0.0000
202.33.49.188,<->,136.25.188.225,0,0,1,56,1,56,1.774403000,0.0000
215.158.238.216,<->,215.158.43.17,1,56,0,0,1,56,1.774094000,0.0000
215.158.239.50,<->,199.39.188.6,1,56,0,0,1,56,1.774042000,0.0000
199.38.199.15,<->,136.25.188.175,0,0,1,50,1,50,1.773372000,0.0000
204.186.197.47,<->,136.25.188.177,0,0,1,56,1,56,1.773196000,0.0000
221.102.143.189,<->,80.41.100.42,0,0,1,141,1,141,1.773139000,0.0000
136.25.188.220,<->,99.170.109.13,1,50,0,0,1,50,1.772720000,0.0000
195.14.247.117,<->,136.25.188.242,0,0,1,56,1,56,1.772535000,0.0000
132.18.67.27,<->,111.181.101.116,0,0,1,50,1,50,1.771608000,0.0000
215.158.238.141,<->,112.220.206.24,1,56,0,0,1,56,1.768851000,0.0000
97.193.216.222,<->,8.252.222.46,0,0,1,50,1,50,1.768218000,0.0000
195.15.210.139,<->,136.25.188.46,0,0,1,50,1,50,1.768196000,0.0000
199.55.201.201,<->,8.182.250.65,0,0,1,50,1,50,1.767374000,0.0000
221.102.143.189,<->,80.41.94.184,0,0,1,141,1,141,1.767327000,0.0000
199.39.134.36,<->,136.25.188.53,0,0,1,56,1,56,1.767122000,0.0000
8.252.222.197,<->,4.123.173.51,1,56,0,0,1,56,1.766862000,0.0000
247.136.144.152,<->,158.19.152.110,1,56,0,0,1,56,1.766234000,0.0000
56.114.235.120,<->,35.56.101.154,0,0,1,609,1,609,1.765857000,0.0000
133.178.226.227,<->,122.158.206.246,1,56,0,0,1,56,1.765736000,0.0000
220.55.111.131,<->,8.222.6.110,1,1249,0,0,1,1249,1.765712000,0.0000
89.216.124.92,<->,53.201.161.188,1,50,0,0,1,50,1.765501000,0.0000
159.248.57.96,<->,136.25.188.227,0,0,1,56,1,56,1.765190000,0.0000
144.232.206.52,<->,8.252.222.237,0,0,1,56,1,56,1.765136000,0.0000
204.58.51.204,<->,136.25.188.253,0,0,1,50,1,50,1.765000000,0.0000
53.201.200.21,<->,48.54.157.178,0,0,1,56,1,56,1.764654000,0.0000
146.193.46.105,<->,8.252.222.158,0,0,1,56,1,56,1.764470000,0.0000
157.127.144.140,<->,8.252.221.223,0,0,1,56,1,56,1.763990000,0.0000
195.127.213.157,<->,136.25.188.239,0,0,1,56,1,56,1.763420000,0.0000
207.63.173.220,<->,136.25.188.243,0,0,1,50,1,50,1.763071000,0.0000
142.207.234.1,<->,136.25.188.54,0,0,1,50,1,50,1.762859000,0.0000
215.158.140.27,<->,38.31.196.176,1,56,0,0,1,56,1.762375000,0.0000
215.158.239.85,<->,199.69.65.114,1,56,0,0,1,56,1.762143000,0.0000
194.233.2.158,<->,136.25.188.163,0,0,1,56,1,56,1.761751000,0.0000
91.248.127.117,<->,8.52.186.156,0,0,1,56,1,56,1.761498000,0.0000
139.163.161.164,<->,8.53.1.5,0,0,1,56,1,56,1.761013000,0.0000
195.71.83.109,<->,136.25.188.198,0,0,1,56,1,56,1.760981000,0.0000
215.158.61.183,<->,8.176.8.93,0,0,1,56,1,56,1.760805000,0.0000
199.121.229.160,<->,136.25.188.209,0,0,1,50,1,50,1.759128000,0.0000
144.87.235.222,<->,139.241.58.74,1,339,0,0,1,339,1.758821000,0.0000
91.231.192.88,<->,89.219.78.245,1,56,0,0,1,56,1.758169000,0.0000
50.224.76.235,<->,50.163.8.133,1,56,0,0,1,56,1.757677000,0.0000
112.208.20.199,<->,6.72.11.112,0,0,1,50,1,50,1.757482000,0.0000
215.158.239.48,<->,142.244.61.220,1,56,0,0,1,56,1.757115000,0.0000
215.158.239.182,<->,100.224.243.67,1,56,0,0,1,56,1.756162000,0.0000
95.246.110.181,<->,8.252.221.223,0,0,1,56,1,56,1.756118000,0.0000
229.45.57.252,<->,97.243.220.36,1,56,0,0,1,56,1.755989000,0.0000
99.73.144.173,<->,98.57.212.245,1,56,0,0,1,56,1.755938000,0.0000
218.147.52.203,<->,8.176.58.168,0,0,1,56,1,56,1.755815000,0.0000
199.53.207.183,<->,136.25.188.225,0,0,1,50,1,50,1.755788000,0.0000
8.220.185.20,<->,6.101.43.182,1,50,0,0,1,50,1.755687000,0.0000
204.58.90.138,<->,136.25.188.46,0,0,1,50,1,50,1.755608000,0.0000
136.25.188.254,<->,8.227.55.97,1,56,0,0,1,56,1.755313000,0.0000
142.253.91.82,<->,136.25.188.254,0,0,1,56,1,56,1.755202000,0.0000
145.252.126.139,<->,98.219.126.40,1,56,0,0,1,56,1.754421000,0.0000
195.14.209.131,<->,136.25.188.209,0,0,1,56,1,56,1.754366000,0.0000
58.131.194.115,<->,8.252.221.205,0,0,1,50,1,50,1.754003000,0.0000
8.220.189.81,<->,6.101.43.182,1,50,0,0,1,50,1.753674000,0.0000
233.30.195.29,<->,8.20.87.187,0,0,1,56,1,56,1.753437000,0.0000
199.55.20.193,<->,8.252.222.62,0,0,1,56,1,56,1.752859000,0.0000
196.148.167.157,<->,120.154.64.187,1,56,0,0,1,56,1.752732000,0.0000
107.96.190.175,<->,50.224.76.248,0,0,1,56,1,56,1.751984000,0.0000
142.253.227.167,<->,136.25.188.225,0,0,1,56,1,56,1.751978000,0.0000
103.144.40.219,<->,92.27.27.185,0,0,1,56,1,56,1.751854000,0.0000
215.158.239.78,<->,195.49.87.166,1,56,0,0,1,56,1.751735000,0.0000
215.158.239.48,<->,199.20.28.12,1,56,0,0,1,56,1.751253000,0.0000
220.243.198.21,<->,8.252.222.107,0,0,1,56,1,56,1.751071000,0.0000
213.186.52.58,<->,144.85.170.208,0,0,1,56,1,56,1.750921000,0.0000
139.193.141.139,<->,105.201.186.230,1,56,0,0,1,56,1.750739000,0.0000
143.94.165.210,<->,136.25.188.252,0,0,1,56,1,56,1.750571000,0.0000
221.102.56.69,<->,220.83.80.104,0,0,1,56,1,56,1.750275000,0.0000
221.163.98.137,<->,92.162.252.133,0,0,1,50,1,50,1.750201000,0.0000
220.28.73.211,<->,136.25.189.53,0,0,1,56,1,56,1.749758000,0.0000
215.158.238.199,<->,29.214.73.193,1,56,0,0,1,56,1.748673000,0.0000
200.174.205.125,<->,54.58.60.144,1,56,0,0,1,56,1.748397000,0.0000
129.225.135.32,<->,129.225.132.72,0,0,1,50,1,50,1.747660000,0.0000
17.225.173.92,<->,8.220.189.63,0,0,1,50,1,50,1.746984000,0.0000
215.158.239.48,<->,199.20.29.23,1,56,0,0,1,56,1.746298000,0.0000
159.137.162.213,<->,112.30.205.142,1,50,0,0,1,50,1.745632000,0.0000
157.127.139.203,<->,8.252.221.223,0,0,1,56,1,56,1.744990000,0.0000
142.240.211.219,<->,136.25.188.176,0,0,1,56,1,56,1.744937000,0.0000
215.158.239.92,<->,195.49.37.133,1,56,0,0,1,56,1.744808000,0.0000
215.158.34.7,<->,8.252.222.42,0,0,1,56,1,56,1.744760000,0.0000
213.186.59.246,<->,144.85.170.208,0,0,1,56,1,56,1.744249000,0.0000
17.116.40.224,<->,8.220.189.234,0,0,1,50,1,50,1.744180000,0.0000
250.109.247.154,<->,80.27.158.247,0,0,1,674,1,674,1.743890000,0.0000
100.224.243.190,<->,8.53.3.84,0,0,1,56,1,56,1.743858000,0.0000
199.36.28.158,<->,99.75.109.64,0,0,1,50,1,50,1.743781000,0.0000
117.29.74.77,<->,50.224.89.243,0,0,1,56,1,56,1.743746000,0.0000
215.158.239.76,<->,195.5.170.96,1,56,0,0,1,56,1.743201000,0.0000
112.220.206.122,<->,100.182.132.40,0,0,1,56,1,56,1.741925000,0.0000
104.154.114.232,<->,89.183.106.29,0,0,1,50,1,50,1.741915000,0.0000
207.61.146.120,<->,136.25.188.46,0,0,1,50,1,50,1.741689000,0.0000
246.253.145.104,<->,117.44.174.254,1,50,0,0,1,50,1.741209000,0.0000
246.253.198.51,<->,93.188.223.232,1,50,0,0,1,50,1.740690000,0.0000
204.184.234.221,<->,136.25.188.177,0,0,1,56,1,56,1.738503000,0.0000
136.25.188.255,<->,41.133.132.80,1,50,0,0,1,50,1.738322000,0.0000
215.158.140.172,<->,135.243.190.253,1,50,0,0,1,50,1.736720000,0.0000
50.224.76.234,<->,18.201.121.175,1,50,0,0,1,50,1.736687000,0.0000
114.76.97.87,<->,92.162.252.174,0,0,1,50,1,50,1.735803000,0.0000
102.83.246.39,<->,8.240.117.69,1,56,0,0,1,56,1.735162000,0.0000
112.208.20.199,<->,99.72.22.255,0,0,1,50,1,50,1.733682000,0.0000
197.113.99.224,<->,136.25.188.239,0,0,1,56,1,56,1.733343000,0.0000
93.191.36.129,<->,50.224.106.182,0,0,1,56,1,56,1.732568000,0.0000
97.240.249.56,<->,97.126.28.102,0,0,1,50,1,50,1.732533000,0.0000
194.232.134.122,<->,136.25.188.177,0,0,1,56,1,56,1.732521000,0.0000
215.158.238.162,<->,136.158.73.48,1,56,0,0,1,56,1.731941000,0.0000
215.158.239.48,<->,196.89.228.182,1,56,0,0,1,56,1.731872000,0.0000
215.158.239.101,<->,129.222.36.87,1,56,0,0,1,56,1.731337000,0.0000
17.27.56.184,<->,8.220.234.159,0,0,1,50,1,50,1.731232000,0.0000
111.147.250.231,<->,50.145.194.89,1,56,0,0,1,56,1.731102000,0.0000
133.54.30.222,<->,38.91.28.96,1,56,0,0,1,56,1.730838000,0.0000
139.44.226.212,<->,100.230.5.11,1,50,0,0,1,50,1.730661000,0.0000
195.89.50.183,<->,8.252.222.62,0,0,1,50,1,50,1.730525000,0.0000
215.158.239.76,<->,194.199.210.94,1,56,0,0,1,56,1.730230000,0.0000
143.42.51.210,<->,136.25.188.44,0,0,1,50,1,50,1.730197000,0.0000
119.86.172.235,<->,50.224.76.234,0,0,1,56,1,56,1.728959000,0.0000
136.18.96.45,<->,8.182.244.177,0,0,1,56,1,56,1.728933000,0.0000
142.248.57.243,<->,136.25.188.196,0,0,1,56,1,56,1.728860000,0.0000
215.158.140.184,<->,6.72.10.83,1,50,0,0,1,50,1.728522000,0.0000
215.158.239.77,<->,199.70.171.119,1,50,0,0,1,50,1.728173000,0.0000
136.25.188.166,<->,100.224.202.178,1,56,0,0,1,56,1.727390000,0.0000
243.117.82.3,<->,220.55.124.65,0,0,1,50,1,50,1.727173000,0.0000
132.249.71.176,<->,100.94.46.112,0,0,1,56,1,56,1.726132000,0.0000
50.224.76.235,<->,6.74.204.201,1,56,0,0,1,56,1.726077000,0.0000
207.61.146.120,<->,136.25.188.176,0,0,1,50,1,50,1.725955000,0.0000
207.236.183.94,<->,136.25.188.177,0,0,1,93,1,93,1.725826000,0.0000
99.74.26.235,<->,8.58.132.243,1,56,0,0,1,56,1.725746000,0.0000
114.183.125.131,<->,50.224.76.235,0,0,1,50,1,50,1.725734000,0.0000
215.158.239.77,<->,207.63.63.196,1,56,0,0,1,56,1.725687000,0.0000
213.186.52.91,<->,144.86.144.95,0,0,1,56,1,56,1.725411000,0.0000
93.181.154.60,<->,92.27.219.143,0,0,1,50,1,50,1.725040000,0.0000
215.158.239.95,<->,196.92.93.79,1,56,0,0,1,56,1.724504000,0.0000
133.178.226.196,<->,8.47.121.21,1,56,0,0,1,56,1.724332000,0.0000
104.203.8.6,<->,50.224.76.248,0,0,1,56,1,56,1.723862000,0.0000
136.25.189.11,<->,98.219.126.175,1,56,0,0,1,56,1.723761000,0.0000
136.25.188.41,<->,53.159.128.145,1,56,0,0,1,56,1.723686000,0.0000
215.158.239.48,<->,196.92.220.44,1,56,0,0,1,56,1.723680000,0.0000
197.113.89.43,<->,136.25.188.222,0,0,1,56,1,56,1.723418000,0.0000
95.246.190.87,<->,8.252.221.223,0,0,1,56,1,56,1.723093000,0.0000
207.50.113.136,<->,8.182.136.221,0,0,1,50,1,50,1.721799000,0.0000
143.89.225.230,<->,136.25.188.238,0,0,1,56,1,56,1.721785000,0.0000
207.57.241.1,<->,136.25.188.54,0,0,1,56,1,56,1.720304000,0.0000
215.158.239.79,<->,207.62.94.212,1,56,0,0,1,56,1.719080000,0.0000
249.101.99.176,<->,111.20.62.72,1,50,0,0,1,50,1.718821000,0.0000
215.158.239.78,<->,196.90.53.82,1,50,0,0,1,50,1.718762000,0.0000
215.158.239.96,<->,143.44.228.56,1,56,0,0,1,56,1.718427000,0.0000
199.82.220.118,<->,136.25.188.252,0,0,1,56,1,56,1.718150000,0.0000
199.33.66.187,<->,136.25.188.176,0,0,1,50,1,50,1.717633000,0.0000
68.72.108.92,<->,8.252.221.239,0,0,1,56,1,56,1.716845000,0.0000
136.106.165.124,<->,0.195.210.42,0,0,1,50,1,50,1.716689000,0.0000
202.33.230.104,<->,136.25.188.252,0,0,1,56,1,56,1.716617000,0.0000
220.50.242.215,<->,133.32.39.1,0,0,1,56,1,56,1.716024000,0.0000
215.158.28.174,<->,98.173.205.232,1,50,0,0,1,50,1.715695000,0.0000
215.158.239.113,<->,129.222.39.230,1,56,0,0,1,56,1.715633000,0.0000
53.213.63.210,<->,48.53.159.235,0,0,1,93,1,93,1.715177000,0.0000
133.73.198.233,<->,8.52.250.99,0,0,1,56,1,56,1.715015000,0.0000
139.254.215.30,<->,129.243.217.199,1,56,0,0,1,56,1.714980000,0.0000
197.113.99.126,<->,136.25.188.177,0,0,1,56,1,56,1.714962000,0.0000
133.54.43.82,<->,112.30.36.128,1,206,0,0,1,206,1.713896000,0.0000
221.102.56.69,<->,98.129.28.237,0,0,1,56,1,56,1.713683000,0.0000
207.236.119.240,<->,136.25.188.227,0,0,1,50,1,50,1.712943000,0.0000
246.253.157.15,<->,120.246.77.210,1,50,0,0,1,50,1.712275000,0.0000
89.204.33.10,<->,8.182.244.19,0,0,1,56,1,56,1.712183000,0.0000
215.158.239.97,<->,199.39.181.253,1,50,0,0,1,50,1.711732000,0.0000
139.194.75.189,<->,8.220.178.203,0,0,1,50,1,50,1.711632000,0.0000
133.178.226.227,<->,111.52.90.194,1,56,0,0,1,56,1.711152000,0.0000
192.64.223.86,<->,38.28.38.35,1,50,0,0,1,50,1.710802000,0.0000
215.158.140.27,<->,140.145.218.248,1,56,0,0,1,56,1.710702000,0.0000
215.158.103.203,<->,89.193.125.208,1,75,0,0,1,75,1.710259000,0.0000
215.158.103.203,<->,41.137.75.125,1,844,0,0,1,844,1.710004000,0.0000
8.181.147.63,<->,8.52.242.107,0,0,1,56,1,56,1.708978000,0.0000
221.196.122.159,<->,136.25.188.226,0,0,1,56,1,56,1.708785000,0.0000
96.190.6.207,<->,92.27.219.190,0,0,1,50,1,50,1.708175000,0.0000
159.137.162.213,<->,125.220.197.150,1,50,0,0,1,50,1.707906000,0.0000
195.77.33.211,<->,50.224.76.230,0,0,1,56,1,56,1.707650000,0.0000
231.140.159.96,<->,136.25.188.252,0,0,1,56,1,56,1.707366000,0.0000
221.196.122.159,<->,136.25.188.209,0,0,1,56,1,56,1.706781000,0.0000
213.186.61.127,<->,144.85.170.208,0,0,1,56,1,56,1.706393000,0.0000
215.158.239.82,<->,80.57.141.226,1,56,0,0,1,56,1.705038000,0.0000
213.21.35.44,<->,8.220.176.253,0,0,1,56,1,56,1.704555000,0.0000
215.158.239.58,<->,196.1.49.84,1,50,0,0,1,50,1.704360000,0.0000
196.246.164.42,<->,136.25.188.241,0,0,1,56,1,56,1.704069000,0.0000
220.59.108.41,<->,220.20.200.33,0,0,1,50,1,50,1.703476000,0.0000
199.122.54.211,<->,136.25.188.55,0,0,1,50,1,50,1.703354000,0.0000
133.73.194.38,<->,80.40.58.90,0,0,1,56,1,56,1.703189000,0.0000
143.76.130.51,<->,8.182.229.19,0,0,1,50,1,50,1.703108000,0.0000
215.158.239.76,<->,196.1.49.84,1,50,0,0,1,50,1.702865000,0.0000
213.186.59.241,<->,144.85.170.254,0,0,1,56,1,56,1.702201000,0.0000
144.54.85.141,<->,136.25.188.173,0,0,1,56,1,56,1.701895000,0.0000
133.231.56.221,<->,50.224.76.234,0,0,1,50,1,50,1.701833000,0.0000
8.55.211.213,<->,6.74.66.227,0,0,1,56,1,56,1.701340000,0.0000
139.163.16.203,<->,50.56.118.190,1,50,0,0,1,50,1.701008000,0.0000
17.192.237.19,<->,8.220.234.159,0,0,1,50,1,50,1.700990000,0.0000
129.225.134.164,<->,129.225.132.80,0,0,1,50,1,50,1.700119000,0.0000
142.252.210.96,<->,136.25.188.208,0,0,1,56,1,56,1.699314000,0.0000
240.171.101.60,<->,8.220.186.114,0,0,1,56,1,56,1.698486000,0.0000
215.158.239.69,<->,199.106.62.174,1,56,0,0,1,56,1.698358000,0.0000
159.137.152.34,<->,133.178.226.227,0,0,1,56,1,56,1.697396000,0.0000
220.39.53.23,<->,133.178.226.202,0,0,1,56,1,56,1.697130000,0.0000
56.112.166.221,<->,8.182.141.189,0,0,1,50,1,50,1.696311000,0.0000
215.158.239.97,<->,194.251.115.79,1,56,0,0,1,56,1.696007000,0.0000
133.178.226.213,<->,115.162.222.216,1,56,0,0,1,56,1.695970000,0.0000
114.76.122.237,<->,101.123.192.247,0,0,1,50,1,50,1.695610000,0.0000
215.158.239.66,<->,145.116.209.92,1,56,0,0,1,56,1.695467000,0.0000
195.55.221.107,<->,136.25.188.222,0,0,1,50,1,50,1.694914000,0.0000
122.223.218.50,<->,50.224.76.235,0,0,1,50,1,50,1.694826000,0.0000
195.55.148.74,<->,136.25.188.45,0,0,1,50,1,50,1.694546000,0.0000
215.158.239.57,<->,194.202.182.67,1,56,0,0,1,56,1.694360000,0.0000
143.10.40.48,<->,136.25.188.241,0,0,1,56,1,56,1.694284000,0.0000
54.38.126.203,<->,48.54.111.255,0,0,1,56,1,56,1.694264000,0.0000
109.2.108.59,<->,8.45.168.98,1,97,0,0,1,97,1.693622000,0.0000
221.102.143.189,<->,98.128.214.64,0,0,1,87,1,87,1.693133000,0.0000
215.158.239.50,<->,196.92.173.187,1,56,0,0,1,56,1.692906000,0.0000
159.137.252.189,<->,38.253.84.123,1,50,0,0,1,50,1.692895000,0.0000
205.107.153.253,<->,80.42.171.176,0,0,1,50,1,50,1.691996000,0.0000
142.241.15.104,<->,136.25.188.226,0,0,1,56,1,56,1.691425000,0.0000
243.49.82.173,<->,192.64.249.52,0,0,1,256,1,256,1.690426000,0.0000
142.179.40.120,<->,50.224.76.234,0,0,1,50,1,50,1.690309000,0.0000
215.158.239.180,<->,8.191.15.132,1,56,0,0,1,56,1.690105000,0.0000
252.2.178.146,<->,92.27.219.178,0,0,1,593,1,593,1.689932000,0.0000
215.158.239.84,<->,199.20.31.77,1,56,0,0,1,56,1.689738000,0.0000
143.72.206.141,<->,136.25.188.160,0,0,1,50,1,50,1.689578000,0.0000
146.148.96.104,<->,8.252.221.223,0,0,1,56,1,56,1.688438000,0.0000
197.113.99.238,<->,136.25.188.176,0,0,1,56,1,56,1.688380000,0.0000
144.85.170.249,<->,98.87.145.159,1,56,0,0,1,56,1.687789000,0.0000
138.98.178.182,<->,116.108.172.2,1,50,0,0,1,50,1.687668000,0.0000
213.221.90.185,<->,144.85.170.208,0,0,1,56,1,56,1.687414000,0.0000
109.222.211.206,<->,53.148.173.60,1,56,0,0,1,56,1.686386000,0.0000
215.158.239.61,<->,98.219.126.175,1,56,0,0,1,56,1.686070000,0.0000
98.156.168.196,<->,8.20.87.94,0,0,1,50,1,50,1.685570000,0.0000
80.42.174.132,<->,38.71.242.128,1,50,0,0,1,50,1.685201000,0.0000
199.83.48.197,<->,136.25.188.45,0,0,1,56,1,56,1.684855000,0.0000
215.158.238.86,<->,145.116.209.93,1,56,0,0,1,56,1.684181000,0.0000
215.158.140.27,<->,215.158.43.248,1,56,0,0,1,56,1.683930000,0.0000
192.226.44.83,<->,136.25.189.196,0,0,1,56,1,56,1.683729000,0.0000
215.158.239.69,<->,199.20.31.73,1,56,0,0,1,56,1.683633000,0.0000
93.95.33.184,<->,50.224.76.235,0,0,1,50,1,50,1.683412000,0.0000
248.239.155.247,<->,221.102.56.69,1,56,0,0,1,56,1.682548000,0.0000
207.92.23.99,<->,8.182.229.19,0,0,1,50,1,50,1.682312000,0.0000
229.73.239.30,<->,133.54.31.182,0,0,1,50,1,50,1.680718000,0.0000
215.158.239.48,<->,199.20.30.169,1,56,0,0,1,56,1.680502000,0.0000
215.158.239.68,<->,204.227.216.39,1,56,0,0,1,56,1.680295000,0.0000
50.224.76.235,<->,33.245.207.237,1,50,0,0,1,50,1.680080000,0.0000
231.140.234.12,<->,136.25.188.220,0,0,1,50,1,50,1.680034000,0.0000
215.158.239.96,<->,199.69.209.83,1,50,0,0,1,50,1.679789000,0.0000
215.158.239.51,<->,142.241.15.155,1,56,0,0,1,56,1.679215000,0.0000
215.158.239.92,<->,195.49.213.146,1,56,0,0,1,56,1.679015000,0.0000
222.62.112.179,<->,48.53.187.107,0,0,1,50,1,50,1.678111000,0.0000
221.102.143.189,<->,6.228.23.67,0,0,1,141,1,141,1.677886000,0.0000
215.158.239.76,<->,204.1.227.143,1,75,0,0,1,75,1.677681000,0.0000
111.147.130.105,<->,53.245.116.237,1,56,0,0,1,56,1.677554000,0.0000
136.25.188.104,<->,8.182.121.167,1,56,0,0,1,56,1.677011000,0.0000
215.158.239.57,<->,199.20.30.124,1,56,0,0,1,56,1.676836000,0.0000
192.64.217.166,<->,142.174.218.147,1,50,0,0,1,50,1.676440000,0.0000
17.166.0.253,<->,8.220.190.86,0,0,1,50,1,50,1.676440000,0.0000
202.33.25.164,<->,136.25.188.178,0,0,1,56,1,56,1.676145000,0.0000
210.209.251.211,<->,192.66.156.29,0,0,1,50,1,50,1.675598000,0.0000
215.158.239.51,<->,195.5.170.96,1,56,0,0,1,56,1.675202000,0.0000
92.27.219.37,<->,29.143.214.182,1,50,0,0,1,50,1.675165000,0.0000
215.158.238.109,<->,145.116.209.82,1,56,0,0,1,56,1.674656000,0.0000
97.28.20.70,<->,8.176.42.231,0,0,1,50,1,50,1.674172000,0.0000
92.27.219.218,<->,33.57.74.132,1,50,0,0,1,50,1.673469000,0.0000
54.37.202.190,<->,48.54.43.172,0,0,1,50,1,50,1.673425000,0.0000
122.208.197.9,<->,50.224.76.234,0,0,1,50,1,50,1.672803000,0.0000
136.25.188.218,<->,100.224.202.157,1,56,0,0,1,56,1.672213000,0.0000
199.82.247.64,<->,136.25.188.209,0,0,1,50,1,50,1.671885000,0.0000
241.75.192.120,<->,221.102.116.168,0,0,1,50,1,50,1.671794000,0.0000
215.158.239.59,<->,199.106.50.216,1,56,0,0,1,56,1.671555000,0.0000
246.254.97.107,<->,132.128.61.22,1,56,0,0,1,56,1.671144000,0.0000
144.85.170.208,<->,98.87.144.89,1,56,0,0,1,56,1.670977000,0.0000
144.86.150.8,<->,112.3.174.85,1,50,0,0,1,50,1.670834000,0.0000
17.199.106.163,<->,8.220.179.94,0,0,1,50,1,50,1.670655000,0.0000
213.186.61.2,<->,144.85.170.246,0,0,1,56,1,56,1.669691000,0.0000
122.221.169.96,<->,50.224.76.230,0,0,1,50,1,50,1.669482000,0.0000
136.25.189.47,<->,8.53.216.111,1,56,0,0,1,56,1.669173000,0.0000
233.97.213.17,<->,129.6.83.11,0,0,1,56,1,56,1.667795000,0.0000
143.95.23.194,<->,136.25.188.198,0,0,1,50,1,50,1.667452000,0.0000
207.86.242.130,<->,8.182.139.161,0,0,1,50,1,50,1.667250000,0.0000
215.158.140.27,<->,100.224.132.171,1,56,0,0,1,56,1.666979000,0.0000
221.102.143.189,<->,220.80.24.204,0,0,1,141,1,141,1.666900000,0.0000
159.137.162.213,<->,29.157.49.25,1,50,0,0,1,50,1.666405000,0.0000
193.7.254.171,<->,92.162.252.195,0,0,1,50,1,50,1.666330000,0.0000
118.114.190.83,<->,50.224.76.248,0,0,1,50,1,50,1.666116000,0.0000
139.192.40.145,<->,8.52.181.50,0,0,1,56,1,56,1.665259000,0.0000
79.20.57.135,<->,8.252.222.31,0,0,1,56,1,56,1.665176000,0.0000
203.54.84.122,<->,136.25.188.236,0,0,1,50,1,50,1.664426000,0.0000
8.252.221.221,<->,4.123.161.8,1,56,0,0,1,56,1.664093000,0.0000
204.138.41.198,<->,8.182.241.177,0,0,1,56,1,56,1.663100000,0.0000
100.80.61.12,<->,50.224.76.234,0,0,1,56,1,56,1.662305000,0.0000
99.74.26.235,<->,8.58.132.242,1,56,0,0,1,56,1.662165000,0.0000
122.214.20.70,<->,89.183.104.189,0,0,1,50,1,50,1.661999000,0.0000
215.158.239.68,<->,143.128.41.197,1,56,0,0,1,56,1.661919000,0.0000
221.102.56.69,<->,80.41.212.50,0,0,1,56,1,56,1.660855000,0.0000
149.210.211.99,<->,50.224.76.248,0,0,1,56,1,56,1.660013000,0.0000
221.102.143.189,<->,102.81.148.183,0,0,1,141,1,141,1.658177000,0.0000
221.102.123.190,<->,133.40.208.180,1,56,0,0,1,56,1.656436000,0.0000
142.220.162.20,<->,136.25.188.241,0,0,1,56,1,56,1.656200000,0.0000
136.25.188.213,<->,80.57.141.187,1,56,0,0,1,56,1.655671000,0.0000
132.200.108.136,<->,129.224.112.221,0,0,1,56,1,56,1.654656000,0.0000
213.186.52.118,<->,144.85.170.208,0,0,1,56,1,56,1.654606000,0.0000
215.158.239.48,<->,143.13.168.8,1,50,0,0,1,50,1.654379000,0.0000
195.126.22.217,<->,136.25.188.220,0,0,1,50,1,50,1.654142000,0.0000
215.158.238.133,<->,113.23.104.221,1,56,0,0,1,56,1.653646000,0.0000
142.166.245.108,<->,136.25.188.222,0,0,1,56,1,56,1.653328000,0.0000
221.102.143.189,<->,109.1.84.71,0,0,1,87,1,87,1.651931000,0.0000
129.26.255.153,<->,53.201.48.187,1,56,0,0,1,56,1.651510000,0.0000
142.249.41.62,<->,136.25.188.55,0,0,1,50,1,50,1.650568000,0.0000
144.86.235.98,<->,17.61.199.251,1,50,0,0,1,50,1.650424000,0.0000
195.127.208.96,<->,136.25.188.220,0,0,1,56,1,56,1.650355000,0.0000
94.25.236.249,<->,50.224.76.235,0,0,1,50,1,50,1.650175000,0.0000
195.126.207.196,<->,136.25.188.174,0,0,1,50,1,50,1.649838000,0.0000
99.75.7.32,<->,8.240.117.23,1,56,0,0,1,56,1.649838000,0.0000
192.229.214.69,<->,192.170.179.2,1,56,0,0,1,56,1.649058000,0.0000
143.53.79.89,<->,136.25.188.242,0,0,1,56,1,56,1.648888000,0.0000
215.158.239.233,<->,100.244.13.26,1,56,0,0,1,56,1.648836000,0.0000
205.70.194.140,<->,92.27.219.214,0,0,1,56,1,56,1.648146000,0.0000
202.162.40.142,<->,8.252.222.49,0,0,1,56,1,56,1.648049000,0.0000
222.65.18.127,<->,89.90.107.0,1,50,0,0,1,50,1.647741000,0.0000
142.190.251.186,<->,136.25.188.55,0,0,1,50,1,50,1.647617000,0.0000
148.99.76.44,<->,0.195.210.8,0,0,1,56,1,56,1.647577000,0.0000
123.108.215.253,<->,92.162.252.1,0,0,1,50,1,50,1.647490000,0.0000
48.131.159.6,<->,8.252.223.106,0,0,1,56,1,56,1.647227000,0.0000
144.85.170.208,<->,91.69.185.225,1,56,0,0,1,56,1.647005000,0.0000
215.158.239.92,<->,207.58.10.161,1,50,0,0,1,50,1.646498000,0.0000
215.158.239.99,<->,196.109.174.101,1,56,0,0,1,56,1.646145000,0.0000
132.250.195.43,<->,80.41.223.29,0,0,1,50,1,50,1.645720000,0.0000
142.255.42.89,<->,136.25.188.196,0,0,1,56,1,56,1.645599000,0.0000
215.158.140.230,<->,83.245.80.251,1,50,0,0,1,50,1.645519000,0.0000
195.15.152.123,<->,136.25.188.222,0,0,1,50,1,50,1.645437000,0.0000
220.20.202.153,<->,129.78.117.164,0,0,1,50,1,50,1.644276000,0.0000
100.174.6.88,<->,8.182.248.147,0,0,1,50,1,50,1.643966000,0.0000
215.158.239.56,<->,196.95.87.139,1,56,0,0,1,56,1.643372000,0.0000
206.243.235.195,<->,92.27.8.96,0,0,1,50,1,50,1.642859000,0.0000
220.38.162.21,<->,215.158.238.109,0,0,1,56,1,56,1.642560000,0.0000
221.102.143.189,<->,102.81.178.78,0,0,1,141,1,141,1.642501000,0.0000
222.42.150.75,<->,50.224.76.235,0,0,1,56,1,56,1.642359000,0.0000
195.15.152.123,<->,136.25.188.220,0,0,1,50,1,50,1.642273000,0.0000
195.5.131.126,<->,136.25.188.53,0,0,1,56,1,56,1.642243000,0.0000
92.162.219.33,<->,80.38.36.175,0,0,1,50,1,50,1.642069000,0.0000
100.206.88.223,<->,92.162.253.223,0,0,1,50,1,50,1.641307000,0.0000
142.206.66.136,<->,136.25.188.177,0,0,1,50,1,50,1.640541000,0.0000
159.219.44.30,<->,50.224.102.157,0,0,1,56,1,56,1.639946000,0.0000
207.57.222.125,<->,136.25.188.253,0,0,1,56,1,56,1.639931000,0.0000
195.5.100.193,<->,8.52.187.14,0,0,1,50,1,50,1.639685000,0.0000
133.54.17.198,<->,89.183.98.97,1,56,0,0,1,56,1.638818000,0.0000
221.102.143.189,<->,220.80.156.5,0,0,1,56,1,56,1.638790000,0.0000
194.232.172.16,<->,136.25.188.199,0,0,1,50,1,50,1.638583000,0.0000
145.176.8.232,<->,80.41.248.200,0,0,1,56,1,56,1.638423000,0.0000
136.18.16.150,<->,8.182.224.248,0,0,1,50,1,50,1.638320000,0.0000
112.2.10.68,<->,8.176.37.25,0,0,1,56,1,56,1.638110000,0.0000
204.1.145.195,<->,136.25.188.225,0,0,1,56,1,56,1.636754000,0.0000
145.89.42.24,<->,8.204.66.217,1,56,0,0,1,56,1.636454000,0.0000
53.149.127.239,<->,48.53.178.63,0,0,1,56,1,56,1.636110000,0.0000
101.70.109.51,<->,82.195.71.7,1,50,0,0,1,50,1.636098000,0.0000
133.178.226.227,<->,29.212.206.231,1,56,0,0,1,56,1.635157000,0.0000
194.209.165.92,<->,8.52.168.63,0,0,1,50,1,50,1.634810000,0.0000
221.163.98.137,<->,220.20.200.169,0,0,1,50,1,50,1.634291000,0.0000
197.107.73.204,<->,136.25.188.220,0,0,1,56,1,56,1.634101000,0.0000
142.252.170.0,<->,136.25.188.241,0,0,1,50,1,50,1.633113000,0.0000
220.20.200.29,<->,144.83.60.153,1,50,0,0,1,50,1.632563000,0.0000
220.28.73.211,<->,136.25.189.93,0,0,1,56,1,56,1.632219000,0.0000
125.197.1.201,<->,50.224.76.234,0,0,1,50,1,50,1.631418000,0.0000
159.178.117.109,<->,8.52.222.23,0,0,1,50,1,50,1.631085000,0.0000
89.216.125.35,<->,53.231.156.17,1,50,0,0,1,50,1.629996000,0.0000
197.107.254.192,<->,8.252.222.30,0,0,1,50,1,50,1.629947000,0.0000
148.139.52.246,<->,92.162.253.252,0,0,1,50,1,50,1.629940000,0.0000
221.101.9.11,<->,204.130.124.252,1,56,0,0,1,56,1.629619000,0.0000
89.183.110.72,<->,0.70.165.139,1,50,0,0,1,50,1.628391000,0.0000
195.6.100.153,<->,136.25.188.236,0,0,1,50,1,50,1.627373000,0.0000
133.178.226.28,<->,96.155.60.195,1,56,0,0,1,56,1.627100000,0.0000
101.70.120.239,<->,89.207.30.140,1,56,0,0,1,56,1.626596000,0.0000
99.175.105.137,<->,53.149.98.170,1,50,0,0,1,50,1.626395000,0.0000
204.21.73.238,<->,136.25.188.163,0,0,1,56,1,56,1.626018000,0.0000
209.91.240.74,<->,8.220.188.183,0,0,1,50,1,50,1.625933000,0.0000
159.48.29.115,<->,8.220.186.144,0,0,1,50,1,50,1.625912000,0.0000
195.42.123.57,<->,136.25.188.45,0,0,1,50,1,50,1.625743000,0.0000
158.198.102.239,<->,50.224.76.235,0,0,1,50,1,50,1.625521000,0.0000
219.249.163.103,<->,80.38.16.211,0,0,1,50,1,50,1.625467000,0.0000
142.249.47.13,<->,136.25.188.226,0,0,1,50,1,50,1.625149000,0.0000
133.32.39.1,<->,80.47.188.76,1,56,0,0,1,56,1.624835000,0.0000
91.43.41.108,<->,89.216.124.92,0,0,1,50,1,50,1.624400000,0.0000
132.208.234.82,<->,8.204.66.217,1,56,0,0,1,56,1.624321000,0.0000
153.100.221.208,<->,92.27.219.236,0,0,1,50,1,50,1.624236000,0.0000
207.56.170.177,<->,136.25.188.255,0,0,1,56,1,56,1.623700000,0.0000
143.134.250.27,<->,136.25.188.53,0,0,1,50,1,50,1.623044000,0.0000
215.158.238.153,<->,98.219.126.175,1,56,0,0,1,56,1.622651000,0.0000
68.73.117.169,<->,8.252.221.236,0,0,1,56,1,56,1.622554000,0.0000
246.254.97.228,<->,210.231.140.48,1,50,0,0,1,50,1.622337000,0.0000
142.209.155.50,<->,136.25.188.198,0,0,1,56,1,56,1.622154000,0.0000
143.129.206.106,<->,136.25.188.239,0,0,1,56,1,56,1.621642000,0.0000
215.158.239.181,<->,131.36.66.137,1,56,0,0,1,56,1.620853000,0.0000
50.224.76.230,<->,0.246.227.151,1,50,0,0,1,50,1.620664000,0.0000
204.58.165.79,<->,136.25.188.196,0,0,1,56,1,56,1.620152000,0.0000
144.85.170.254,<->,98.87.146.71,1,56,0,0,1,56,1.620047000,0.0000
210.220.218.67,<->,17.43.172.58,1,50,0,0,1,50,1.619790000,0.0000
50.224.76.235,<->,33.251.204.238,1,50,0,0,1,50,1.619689000,0.0000
210.226.167.67,<->,53.191.133.250,1,50,0,0,1,50,1.619461000,0.0000
132.18.67.31,<->,102.50.169.135,0,0,1,50,1,50,1.619328000,0.0000
215.158.199.180,<->,8.182.168.84,0,0,1,56,1,56,1.619266000,0.0000
192.64.239.241,<->,149.71.254.200,1,56,0,0,1,56,1.619086000,0.0000
246.253.253.107,<->,89.152.226.82,1,56,0,0,1,56,1.618841000,0.0000
144.87.238.89,<->,8.182.224.87,0,0,1,50,1,50,1.618447000,0.0000
225.226.156.241,<->,8.20.87.89,0,0,1,56,1,56,1.618405000,0.0000
199.32.113.255,<->,136.25.188.198,0,0,1,56,1,56,1.618292000,0.0000
142.195.143.226,<->,136.25.188.255,0,0,1,56,1,56,1.617743000,0.0000
199.81.215.251,<->,50.224.76.235,0,0,1,50,1,50,1.616499000,0.0000
204.200.35.204,<->,136.25.188.46,0,0,1,56,1,56,1.616483000,0.0000
56.8.135.115,<->,8.182.139.168,0,0,1,56,1,56,1.615579000,0.0000
195.71.94.186,<->,136.25.188.253,0,0,1,56,1,56,1.614472000,0.0000
99.252.190.185,<->,92.27.27.174,0,0,1,56,1,56,1.614271000,0.0000
231.142.103.128,<->,136.25.188.44,0,0,1,56,1,56,1.613373000,0.0000
215.158.239.58,<->,196.0.149.119,1,56,0,0,1,56,1.613005000,0.0000
215.158.239.76,<->,207.60.89.242,1,50,0,0,1,50,1.612382000,0.0000
215.158.239.113,<->,129.222.39.153,1,56,0,0,1,56,1.611926000,0.0000
134.34.66.140,<->,92.27.194.147,0,0,1,56,1,56,1.611390000,0.0000
132.216.20.202,<->,109.1.8.45,0,0,1,50,1,50,1.611308000,0.0000
144.85.170.246,<->,91.69.185.136,1,56,0,0,1,56,1.610719000,0.0000
136.25.189.47,<->,100.224.139.148,1,56,0,0,1,56,1.610635000,0.0000
142.240.36.44,<->,136.25.188.176,0,0,1,56,1,56,1.610330000,0.0000
215.158.239.58,<->,142.191.216.49,1,50,0,0,1,50,1.610100000,0.0000
50.224.76.235,<->,50.105.237.70,1,50,0,0,1,50,1.609708000,0.0000
115.139.125.51,<->,50.224.76.230,0,0,1,50,1,50,1.609090000,0.0000
65.26.119.20,<->,50.224.76.248,0,0,1,56,1,56,1.608765000,0.0000
133.54.17.207,<->,57.4.50.131,1,56,0,0,1,56,1.608077000,0.0000
97.203.37.94,<->,8.182.226.78,0,0,1,50,1,50,1.607282000,0.0000
132.18.67.31,<->,99.73.141.255,0,0,1,56,1,56,1.606406000,0.0000
142.182.50.173,<->,136.25.188.199,0,0,1,50,1,50,1.606338000,0.0000
142.220.26.164,<->,136.25.188.225,0,0,1,56,1,56,1.606264000,0.0000
117.46.137.244,<->,50.224.76.234,0,0,1,50,1,50,1.606071000,0.0000
215.158.239.244,<->,215.158.129.100,1,56,0,0,1,56,1.604541000,0.0000
139.148.27.43,<->,8.182.239.241,0,0,1,56,1,56,1.603623000,0.0000
29.201.70.132,<->,8.52.186.161,0,0,1,50,1,50,1.603400000,0.0000
200.175.87.179,<->,54.37.9.160,1,56,0,0,1,56,1.603308000,0.0000
215.158.239.58,<->,142.247.210.117,1,50,0,0,1,50,1.603301000,0.0000
146.234.124.46,<->,0.195.210.8,0,0,1,56,1,56,1.603128000,0.0000
197.106.105.34,<->,133.32.39.45,0,0,1,56,1,56,1.602466000,0.0000
232.31.124.106,<->,220.55.66.44,0,0,1,154,1,154,1.602300000,0.0000
146.217.33.226,<->,8.43.155.247,0,0,1,50,1,50,1.602283000,0.0000
159.37.0.186,<->,145.116.119.49,0,0,1,50,1,50,1.601677000,0.0000
196.89.197.70,<->,136.25.188.222,0,0,1,50,1,50,1.601384000,0.0000
215.158.140.161,<->,29.211.199.33,1,316,0,0,1,316,1.600208000,0.0000
133.135.217.174,<->,129.6.83.11,0,0,1,56,1,56,1.600185000,0.0000
215.158.239.99,<->,196.0.232.99,1,87,0,0,1,87,1.600117000,0.0000
195.14.102.254,<->,136.25.188.163,0,0,1,50,1,50,1.600067000,0.0000
159.137.162.213,<->,117.56.163.126,1,50,0,0,1,50,1.599594000,0.0000
215.158.239.96,<->,196.108.60.23,1,56,0,0,1,56,1.597497000,0.0000
247.136.212.254,<->,122.105.68.11,1,50,0,0,1,50,1.597308000,0.0000
215.158.239.79,<->,199.20.30.208,1,56,0,0,1,56,1.596703000,0.0000
215.158.239.96,<->,194.199.197.57,1,56,0,0,1,56,1.596399000,0.0000
158.1.102.101,<->,89.183.104.143,0,0,1,56,1,56,1.595760000,0.0000
144.85.170.254,<->,91.69.185.245,1,56,0,0,1,56,1.595612000,0.0000
221.98.66.220,<->,215.158.6.192,1,56,0,0,1,56,1.595098000,0.0000
195.41.211.140,<->,136.25.188.241,0,0,1,50,1,50,1.595051000,0.0000
136.209.178.171,<->,8.182.226.78,0,0,1,50,1,50,1.594401000,0.0000
108.38.16.192,<->,50.224.80.64,0,0,1,56,1,56,1.593105000,0.0000
207.88.204.64,<->,50.224.76.234,0,0,1,56,1,56,1.592672000,0.0000
215.158.239.68,<->,199.20.31.231,1,56,0,0,1,56,1.592605000,0.0000
215.158.239.94,<->,204.226.11.55,1,56,0,0,1,56,1.592545000,0.0000
215.158.239.57,<->,199.20.28.118,1,56,0,0,1,56,1.592343000,0.0000
215.158.239.56,<->,196.93.253.43,1,68,0,0,1,68,1.591578000,0.0000
80.42.162.247,<->,8.20.81.3,1,56,0,0,1,56,1.591211000,0.0000
194.232.107.196,<->,136.25.188.198,0,0,1,56,1,56,1.590451000,0.0000
222.254.205.206,<->,97.126.21.248,0,0,1,470,1,470,1.590168000,0.0000
136.25.188.236,<->,92.175.125.206,1,50,0,0,1,50,1.590044000,0.0000
204.62.134.29,<->,136.25.188.178,0,0,1,56,1,56,1.589996000,0.0000
199.33.117.166,<->,136.25.188.241,0,0,1,50,1,50,1.588064000,0.0000
17.3.51.127,<->,8.220.176.253,0,0,1,56,1,56,1.587845000,0.0000
221.102.143.189,<->,192.64.92.213,0,0,1,141,1,141,1.587533000,0.0000
207.56.158.107,<->,136.25.188.252,0,0,1,50,1,50,1.587309000,0.0000
109.51.233.76,<->,8.183.25.124,0,0,1,50,1,50,1.586954000,0.0000
220.55.97.164,<->,111.151.237.44,1,723,0,0,1,723,1.586907000,0.0000
215.158.239.58,<->,142.166.245.240,1,56,0,0,1,56,1.586611000,0.0000
196.251.66.231,<->,0.195.210.42,0,0,1,56,1,56,1.585987000,0.0000
133.178.226.61,<->,96.155.60.202,1,56,0,0,1,56,1.585873000,0.0000
221.102.56.69,<->,213.38.198.219,0,0,1,56,1,56,1.585845000,0.0000
215.158.239.93,<->,195.81.19.82,1,56,0,0,1,56,1.584534000,0.0000
131.82.121.131,<->,50.224.76.235,0,0,1,56,1,56,1.584053000,0.0000
197.107.44.87,<->,136.25.188.174,0,0,1,56,1,56,1.582488000,0.0000
199.52.226.234,<->,136.25.188.163,0,0,1,50,1,50,1.582049000,0.0000
195.69.198.18,<->,136.25.188.253,0,0,1,50,1,50,1.581946000,0.0000
136.25.188.253,<->,8.227.55.54,1,56,0,0,1,56,1.581591000,0.0000
144.72.194.209,<->,137.137.124.27,0,0,1,50,1,50,1.581519000,0.0000
53.86.58.175,<->,8.228.213.135,0,0,1,56,1,56,1.581127000,0.0000
142.191.141.85,<->,136.25.188.198,0,0,1,50,1,50,1.580974000,0.0000
109.222.195.35,<->,54.41.177.117,1,50,0,0,1,50,1.580512000,0.0000
197.107.44.87,<->,136.25.188.209,0,0,1,56,1,56,1.580490000,0.0000
248.239.184.227,<->,221.102.56.46,1,56,0,0,1,56,1.579904000,0.0000
215.158.239.17,<->,199.82.11.179,1,50,0,0,1,50,1.579715000,0.0000
215.158.239.49,<->,207.115.125.111,1,56,0,0,1,56,1.579635000,0.0000
197.113.99.128,<->,136.25.188.198,0,0,1,56,1,56,1.577985000,0.0000
129.26.254.60,<->,53.189.209.21,1,56,0,0,1,56,1.576934000,0.0000
72.156.38.45,<->,50.224.76.235,0,0,1,50,1,50,1.576616000,0.0000
215.158.239.95,<->,195.97.145.102,1,56,0,0,1,56,1.576335000,0.0000
143.135.255.175,<->,136.25.188.254,0,0,1,50,1,50,1.575717000,0.0000
135.255.67.82,<->,8.252.222.45,0,0,1,56,1,56,1.575630000,0.0000
204.200.50.113,<->,136.25.188.46,0,0,1,132,1,132,1.574848000,0.0000
159.137.162.213,<->,117.11.138.106,1,50,0,0,1,50,1.574632000,0.0000
196.148.99.61,<->,53.243.94.134,1,56,0,0,1,56,1.574322000,0.0000
215.158.239.76,<->,207.188.123.170,1,50,0,0,1,50,1.574071000,0.0000
220.28.114.28,<->,136.25.189.23,0,0,1,56,1,56,1.573656000,0.0000
215.158.140.27,<->,140.163.167.87,1,56,0,0,1,56,1.573124000,0.0000
111.66.29.160,<->,92.27.219.151,0,0,1,50,1,50,1.572855000,0.0000
215.158.239.68,<->,199.20.29.82,1,56,0,0,1,56,1.572035000,0.0000
229.45.205.24,<->,124.148.1.107,1,56,0,0,1,56,1.571901000,0.0000
215.158.103.203,<->,54.35.184.63,1,50,0,0,1,50,1.571299000,0.0000
192.64.217.166,<->,33.123.162.14,1,50,0,0,1,50,1.570523000,0.0000
99.187.125.121,<->,8.20.87.8,0,0,1,56,1,56,1.570514000,0.0000
142.227.35.32,<->,136.25.188.222,0,0,1,50,1,50,1.570275000,0.0000
143.10.103.63,<->,136.25.188.241,0,0,1,56,1,56,1.569939000,0.0000
194.237.59.217,<->,136.25.188.54,0,0,1,50,1,50,1.569594000,0.0000
142.166.51.110,<->,136.25.188.242,0,0,1,50,1,50,1.569162000,0.0000
231.142.111.219,<->,136.25.188.196,0,0,1,56,1,56,1.568555000,0.0000
136.25.188.226,<->,41.161.48.147,1,56,0,0,1,56,1.567884000,0.0000
129.78.115.95,<->,116.96.63.23,1,50,0,0,1,50,1.567651000,0.0000
231.142.68.126,<->,136.25.188.253,0,0,1,56,1,56,1.567325000,0.0000
129.31.61.223,<->,8.182.244.19,0,0,1,56,1,56,1.567295000,0.0000
111.147.245.82,<->,53.244.236.61,1,56,0,0,1,56,1.567249000,0.0000
136.25.188.178,<->,98.32.65.40,1,56,0,0,1,56,1.567048000,0.0000
207.172.10.45,<->,136.25.188.174,0,0,1,56,1,56,1.566423000,0.0000
144.87.238.89,<->,80.38.19.223,0,0,1,50,1,50,1.566276000,0.0000
239.66.76.150,<->,100.94.91.165,0,0,1,56,1,56,1.566155000,0.0000
249.101.211.202,<->,53.214.126.11,1,93,0,0,1,93,1.565289000,0.0000
215.158.239.113,<->,129.222.36.154,1,56,0,0,1,56,1.565066000,0.0000
195.7.222.38,<->,136.25.188.160,0,0,1,50,1,50,1.564761000,0.0000
143.10.103.63,<->,136.25.188.52,0,0,1,56,1,56,1.564514000,0.0000
105.163.53.213,<->,80.41.26.51,0,0,1,50,1,50,1.563529000,0.0000
215.158.239.79,<->,196.93.106.189,1,50,0,0,1,50,1.563432000,0.0000
204.185.111.190,<->,136.25.188.178,0,0,1,56,1,56,1.562955000,0.0000
143.129.94.140,<->,136.25.188.238,0,0,1,50,1,50,1.562209000,0.0000
215.158.239.85,<->,199.69.64.14,1,56,0,0,1,56,1.561735000,0.0000
139.163.71.197,<->,119.223.130.3,1,56,0,0,1,56,1.561276000,0.0000
218.4.180.66,<->,8.20.81.32,1,56,0,0,1,56,1.560660000,0.0000
207.59.81.196,<->,136.25.188.52,0,0,1,56,1,56,1.560260000,0.0000
215.158.239.78,<->,199.20.6.69,1,56,0,0,1,56,1.560242000,0.0000
199.38.230.175,<->,136.25.188.220,0,0,1,56,1,56,1.559716000,0.0000
204.2.251.130,<->,136.25.188.163,0,0,1,56,1,56,1.559164000,0.0000
247.136.132.111,<->,103.166.36.62,1,50,0,0,1,50,1.558953000,0.0000
111.147.221.66,<->,53.69.106.30,1,56,0,0,1,56,1.558324000,0.0000
231.140.2.184,<->,136.25.188.253,0,0,1,56,1,56,1.557471000,0.0000
143.132.68.11,<->,136.25.188.53,0,0,1,50,1,50,1.557423000,0.0000
145.105.170.35,<->,8.20.87.94,0,0,1,68,1,68,1.556842000,0.0000
143.43.102.227,<->,136.25.188.53,0,0,1,56,1,56,1.556535000,0.0000
139.193.141.139,<->,50.149.195.148,1,56,0,0,1,56,1.556497000,0.0000
199.32.226.84,<->,136.25.188.252,0,0,1,56,1,56,1.556248000,0.0000
128.150.111.92,<->,50.224.76.230,0,0,1,50,1,50,1.555094000,0.0000
215.158.239.76,<->,194.203.253.208,1,56,0,0,1,56,1.554937000,0.0000
139.78.230.224,<->,8.20.87.7,0,0,1,56,1,56,1.554789000,0.0000
99.162.77.146,<->,54.37.113.65,1,56,0,0,1,56,1.554655000,0.0000
109.127.101.16,<->,102.50.165.139,0,0,1,511,1,511,1.554354000,0.0000
50.48.121.204,<->,8.220.176.253,0,0,1,56,1,56,1.554001000,0.0000
142.249.111.35,<->,136.25.188.198,0,0,1,50,1,50,1.553894000,0.0000
215.158.239.86,<->,199.20.6.122,1,56,0,0,1,56,1.552507000,0.0000
159.137.162.213,<->,122.202.251.213,1,50,0,0,1,50,1.552449000,0.0000
215.158.239.48,<->,204.226.127.49,1,56,0,0,1,56,1.551951000,0.0000
144.81.101.239,<->,144.71.42.15,0,0,1,50,1,50,1.551790000,0.0000
210.209.251.211,<->,137.137.105.214,0,0,1,50,1,50,1.551785000,0.0000
218.85.24.6,<->,50.224.76.234,0,0,1,56,1,56,1.551740000,0.0000
144.87.235.222,<->,112.208.20.140,1,50,0,0,1,50,1.551500000,0.0000
132.249.70.157,<->,111.151.237.22,1,56,0,0,1,56,1.550653000,0.0000
101.195.32.10,<->,8.220.190.86,0,0,1,50,1,50,1.550462000,0.0000
92.27.219.244,<->,27.77.34.89,1,50,0,0,1,50,1.550404000,0.0000
215.158.140.27,<->,38.71.71.55,1,56,0,0,1,56,1.550172000,0.0000
194.232.165.130,<->,136.25.188.177,0,0,1,56,1,56,1.549961000,0.0000
207.59.160.249,<->,136.25.188.237,0,0,1,50,1,50,1.549685000,0.0000
215.158.239.50,<->,204.226.96.57,1,56,0,0,1,56,1.549055000,0.0000
199.52.44.60,<->,136.25.188.179,0,0,1,50,1,50,1.548883000,0.0000
199.52.44.60,<->,136.25.188.52,0,0,1,50,1,50,1.548881000,0.0000
215.158.239.113,<->,129.222.36.182,1,56,0,0,1,56,1.548804000,0.0000
98.217.53.146,<->,50.224.76.234,0,0,1,50,1,50,1.548790000,0.0000
215.158.140.27,<->,105.193.33.88,1,56,0,0,1,56,1.548740000,0.0000
215.158.239.95,<->,194.202.160.71,1,56,0,0,1,56,1.548500000,0.0000
215.158.239.51,<->,196.90.101.128,1,56,0,0,1,56,1.547413000,0.0000
139.253.153.32,<->,92.162.253.43,0,0,1,332,1,332,1.547020000,0.0000
137.47.232.19,<->,8.220.176.253,0,0,1,56,1,56,1.546544000,0.0000
113.127.245.199,<->,92.27.219.39,0,0,1,50,1,50,1.546053000,0.0000
195.14.125.36,<->,136.25.188.54,0,0,1,56,1,56,1.545982000,0.0000
199.123.43.28,<->,136.25.188.198,0,0,1,56,1,56,1.545930000,0.0000
199.33.203.41,<->,136.25.188.52,0,0,1,50,1,50,1.545498000,0.0000
213.21.35.45,<->,8.220.190.86,0,0,1,56,1,56,1.545330000,0.0000
215.158.238.223,<->,143.155.227.40,1,56,0,0,1,56,1.544678000,0.0000
215.158.239.77,<->,207.239.101.124,1,50,0,0,1,50,1.544627000,0.0000
200.174.157.158,<->,54.59.92.175,1,50,0,0,1,50,1.544621000,0.0000
207.63.121.119,<->,136.25.188.174,0,0,1,50,1,50,1.543829000,0.0000
50.224.76.235,<->,48.129.113.186,1,50,0,0,1,50,1.543771000,0.0000
142.236.92.247,<->,136.25.188.209,0,0,1,56,1,56,1.542585000,0.0000
199.82.215.142,<->,136.25.188.44,0,0,1,89,1,89,1.542433000,0.0000
247.136.226.88,<->,112.33.109.68,1,50,0,0,1,50,1.542031000,0.0000
136.128.35.206,<->,8.176.8.87,0,0,1,56,1,56,1.542030000,0.0000
89.155.2.203,<->,8.183.25.124,0,0,1,56,1,56,1.541496000,0.0000
215.158.140.27,<->,143.14.191.88,1,56,0,0,1,56,1.540972000,0.0000
215.158.239.58,<->,199.106.118.136,1,56,0,0,1,56,1.540884000,0.0000
100.124.212.156,<->,80.41.56.143,0,0,1,50,1,50,1.540673000,0.0000
142.207.65.145,<->,136.25.188.46,0,0,1,50,1,50,1.540643000,0.0000
196.21.87.7,<->,50.224.76.234,0,0,1,50,1,50,1.540232000,0.0000
215.158.239.50,<->,199.20.30.209,1,56,0,0,1,56,1.539982000,0.0000
136.50.56.221,<->,6.122.155.162,0,0,1,50,1,50,1.539875000,0.0000
215.158.239.57,<->,199.20.30.126,1,56,0,0,1,56,1.539827000,0.0000
215.158.238.86,<->,145.116.209.82,1,56,0,0,1,56,1.539363000,0.0000
215.158.239.96,<->,143.94.246.7,1,56,0,0,1,56,1.539184000,0.0000
207.59.207.147,<->,136.25.188.196,0,0,1,50,1,50,1.539074000,0.0000
199.39.82.92,<->,136.25.188.242,0,0,1,50,1,50,1.538802000,0.0000
243.117.93.53,<->,129.78.116.160,0,0,1,50,1,50,1.538616000,0.0000
200.174.199.250,<->,53.161.180.137,1,50,0,0,1,50,1.537997000,0.0000
143.68.11.75,<->,136.25.188.222,0,0,1,50,1,50,1.537374000,0.0000
99.207.140.179,<->,8.220.185.254,0,0,1,50,1,50,1.537283000,0.0000
226.73.2.55,<->,8.220.187.2,0,0,1,56,1,56,1.537037000,0.0000
196.200.78.52,<->,8.252.222.178,0,0,1,56,1,56,1.535895000,0.0000
195.14.139.42,<->,136.25.188.55,0,0,1,50,1,50,1.535842000,0.0000
94.194.38.158,<->,8.252.221.238,0,0,1,56,1,56,1.535802000,0.0000
109.1.58.226,<->,103.115.97.227,1,122,0,0,1,122,1.535630000,0.0000
199.15.241.133,<->,136.25.188.253,0,0,1,56,1,56,1.534204000,0.0000
207.59.232.88,<->,136.25.188.239,0,0,1,56,1,56,1.534174000,0.0000
143.20.71.191,<->,136.25.188.253,0,0,1,50,1,50,1.534137000,0.0000
195.6.143.23,<->,136.25.188.242,0,0,1,50,1,50,1.533031000,0.0000
143.134.51.28,<->,136.25.188.163,0,0,1,56,1,56,1.532936000,0.0000
109.127.101.16,<->,99.73.161.56,0,0,1,499,1,499,1.532870000,0.0000
133.32.1.140,<->,115.121.228.207,1,50,0,0,1,50,1.532806000,0.0000
195.71.95.254,<->,136.25.188.53,0,0,1,56,1,56,1.532514000,0.0000
215.158.239.84,<->,199.70.185.46,1,56,0,0,1,56,1.530947000,0.0000
123.162.64.53,<->,50.224.76.234,0,0,1,50,1,50,1.530913000,0.0000
215.158.239.93,<->,196.1.217.234,1,56,0,0,1,56,1.530528000,0.0000
215.158.239.253,<->,144.253.73.231,1,56,0,0,1,56,1.530390000,0.0000
221.102.56.46,<->,109.0.228.33,0,0,1,56,1,56,1.530033000,0.0000
143.53.234.215,<->,136.25.188.177,0,0,1,56,1,56,1.528914000,0.0000
142.249.41.101,<->,136.25.188.163,0,0,1,50,1,50,1.528873000,0.0000
193.41.169.240,<->,8.52.225.237,0,0,1,56,1,56,1.527525000,0.0000
142.208.234.171,<->,136.25.188.160,0,0,1,56,1,56,1.527214000,0.0000
215.158.239.86,<->,199.20.31.29,1,56,0,0,1,56,1.526954000,0.0000
215.158.239.67,<->,80.57.141.205,1,56,0,0,1,56,1.525826000,0.0000
248.225.25.242,<->,56.9.27.51,1,435,0,0,1,435,1.525805000,0.0000
199.14.252.25,<->,136.25.188.174,0,0,1,56,1,56,1.525568000,0.0000
142.248.58.249,<->,136.25.188.46,0,0,1,50,1,50,1.525464000,0.0000
99.175.115.103,<->,50.145.0.192,1,56,0,0,1,56,1.524725000,0.0000
221.102.56.1,<->,129.1.81.150,0,0,1,56,1,56,1.524441000,0.0000
109.222.220.98,<->,54.43.249.8,1,50,0,0,1,50,1.524314000,0.0000
144.71.44.209,<->,143.252.79.101,1,50,0,0,1,50,1.524314000,0.0000
216.144.221.249,<->,215.158.140.221,0,0,1,50,1,50,1.524239000,0.0000
152.40.191.96,<->,8.252.222.174,0,0,1,56,1,56,1.524037000,0.0000
111.2.157.67,<->,8.182.228.163,0,0,1,50,1,50,1.523954000,0.0000
8.52.133.228,<->,4.7.144.163,1,50,0,0,1,50,1.523873000,0.0000
215.158.239.76,<->,196.108.169.133,1,56,0,0,1,56,1.523488000,0.0000
194.234.181.28,<->,136.25.188.226,0,0,1,56,1,56,1.523055000,0.0000
143.94.23.34,<->,50.224.76.234,0,0,1,50,1,50,1.522074000,0.0000
207.190.91.156,<->,136.25.188.255,0,0,1,56,1,56,1.520772000,0.0000
204.58.18.123,<->,136.25.188.220,0,0,1,56,1,56,1.520500000,0.0000
215.158.239.59,<->,204.227.217.14,1,50,0,0,1,50,1.520446000,0.0000
143.43.193.213,<->,50.224.76.235,0,0,1,50,1,50,1.520398000,0.0000
215.158.140.27,<->,98.89.150.79,1,56,0,0,1,56,1.520393000,0.0000
50.224.76.230,<->,8.238.181.176,1,50,0,0,1,50,1.520053000,0.0000
216.184.1.112,<->,8.252.222.170,0,0,1,56,1,56,1.519797000,0.0000
204.200.57.164,<->,136.25.188.177,0,0,1,56,1,56,1.519623000,0.0000
195.4.8.199,<->,136.25.188.240,0,0,1,56,1,56,1.518525000,0.0000
159.137.162.213,<->,110.240.17.32,1,50,0,0,1,50,1.518455000,0.0000
192.170.179.5,<->,133.32.39.0,0,0,1,56,1,56,1.517225000,0.0000
213.186.61.57,<->,144.85.170.208,0,0,1,56,1,56,1.516914000,0.0000
199.32.127.142,<->,136.25.188.237,0,0,1,50,1,50,1.515917000,0.0000
8.55.195.24,<->,6.138.239.59,0,0,1,50,1,50,1.515910000,0.0000
197.113.99.168,<->,136.25.188.255,0,0,1,56,1,56,1.515255000,0.0000
239.66.241.243,<->,97.126.113.29,0,0,1,50,1,50,1.513756000,0.0000
142.236.68.142,<->,136.25.188.241,0,0,1,56,1,56,1.513186000,0.0000
202.33.255.198,<->,136.25.188.240,0,0,1,56,1,56,1.512222000,0.0000
204.3.28.135,<->,136.25.188.178,0,0,1,56,1,56,1.512209000,0.0000
142.227.251.30,<->,136.25.188.176,0,0,1,56,1,56,1.511857000,0.0000
204.226.49.238,<->,8.20.87.206,0,0,1,56,1,56,1.511403000,0.0000
105.111.25.197,<->,50.224.76.230,0,0,1,50,1,50,1.511360000,0.0000
215.158.30.229,<->,8.252.222.32,0,0,1,56,1,56,1.511286000,0.0000
221.102.56.69,<->,99.75.22.179,0,0,1,56,1,56,1.510972000,0.0000
220.20.200.127,<->,144.83.60.139,1,50,0,0,1,50,1.510531000,0.0000
192.67.139.230,<->,22.63.36.222,1,50,0,0,1,50,1.510412000,0.0000
199.69.174.156,<->,136.25.188.225,0,0,1,56,1,56,1.509930000,0.0000
109.112.164.45,<->,100.230.5.7,1,50,0,0,1,50,1.509336000,0.0000
248.80.123.25,<->,133.32.39.0,0,0,1,56,1,56,1.509251000,0.0000
56.121.53.122,<->,53.249.54.105,1,267,0,0,1,267,1.508904000,0.0000
92.27.219.43,<->,48.108.118.139,1,56,0,0,1,56,1.508732000,0.0000
213.221.90.178,<->,144.85.170.254,0,0,1,56,1,56,1.507602000,0.0000
69.240.78.251,<->,8.252.222.30,0,0,1,56,1,56,1.506889000,0.0000
252.98.135.143,<->,116.123.165.184,1,50,0,0,1,50,1.506738000,0.0000
207.56.46.216,<->,136.25.188.254,0,0,1,50,1,50,1.506698000,0.0000
132.18.67.31,<->,101.70.127.229,0,0,1,50,1,50,1.506502000,0.0000
215.158.239.92,<->,199.20.31.6,1,56,0,0,1,56,1.504061000,0.0000
215.158.239.84,<->,199.32.172.120,1,56,0,0,1,56,1.503508000,0.0000
111.147.192.122,<->,54.41.253.68,1,50,0,0,1,50,1.502565000,0.0000
159.37.0.178,<->,145.116.119.49,0,0,1,50,1,50,1.501969000,0.0000
246.253.253.169,<->,139.33.174.178,1,50,0,0,1,50,1.501380000,0.0000
132.44.144.167,<->,50.224.76.248,0,0,1,56,1,56,1.500088000,0.0000
97.4.40.55,<->,80.38.37.64,0,0,1,56,1,56,1.499143000,0.0000
132.249.70.127,<->,27.155.137.55,1,56,0,0,1,56,1.499066000,0.0000
143.135.128.30,<->,136.25.188.238,0,0,1,56,1,56,1.498973000,0.0000
199.32.150.99,<->,136.25.188.54,0,0,1,50,1,50,1.498658000,0.0000
133.244.28.233,<->,127.255.180.249,1,56,0,0,1,56,1.498455000,0.0000
207.232.222.142,<->,133.54.28.143,0,0,1,50,1,50,1.498300000,0.0000
195.12.108.157,<->,136.25.188.176,0,0,1,50,1,50,1.497737000,0.0000
117.41.238.88,<->,50.224.76.230,0,0,1,50,1,50,1.497550000,0.0000
143.10.47.43,<->,136.25.188.178,0,0,1,56,1,56,1.497502000,0.0000
239.66.119.155,<->,159.137.235.224,0,0,1,50,1,50,1.496864000,0.0000
204.2.102.51,<->,136.25.188.208,0,0,1,50,1,50,1.495602000,0.0000
194.233.169.234,<->,136.25.188.176,0,0,1,56,1,56,1.494657000,0.0000
215.158.239.182,<->,29.214.216.64,1,56,0,0,1,56,1.494178000,0.0000
139.163.26.146,<->,137.167.73.77,1,56,0,0,1,56,1.494167000,0.0000
215.158.239.50,<->,199.106.91.244,1,56,0,0,1,56,1.494156000,0.0000
210.209.251.214,<->,192.64.210.129,0,0,1,50,1,50,1.493711000,0.0000
215.158.140.27,<->,140.174.84.7,1,56,0,0,1,56,1.493593000,0.0000
195.41.238.250,<->,136.25.188.177,0,0,1,50,1,50,1.493553000,0.0000
195.13.253.215,<->,136.25.188.239,0,0,1,56,1,56,1.493126000,0.0000
92.27.219.173,<->,82.178.158.143,1,56,0,0,1,56,1.492769000,0.0000
130.146.158.154,<->,89.216.124.92,0,0,1,50,1,50,1.492695000,0.0000
199.82.249.196,<->,136.25.188.222,0,0,1,56,1,56,1.492228000,0.0000
215.158.239.94,<->,195.81.19.82,1,56,0,0,1,56,1.491470000,0.0000
142.249.72.88,<->,136.25.188.226,0,0,1,50,1,50,1.491402000,0.0000
136.25.188.220,<->,30.73.92.33,1,56,0,0,1,56,1.491249000,0.0000
133.32.39.45,<->,83.225.157.222,1,50,0,0,1,50,1.489718000,0.0000
109.119.182.228,<->,8.182.235.52,0,0,1,50,1,50,1.489121000,0.0000
136.25.189.213,<->,98.192.115.72,1,50,0,0,1,50,1.488877000,0.0000
231.142.111.219,<->,136.25.188.197,0,0,1,56,1,56,1.488768000,0.0000
8.252.222.51,<->,4.122.15.27,1,56,0,0,1,56,1.488574000,0.0000
195.65.192.81,<->,50.224.76.234,0,0,1,50,1,50,1.488503000,0.0000
8.220.207.68,<->,8.35.106.200,1,56,0,0,1,56,1.488113000,0.0000
98.236.90.77,<->,8.37.124.174,1,97,0,0,1,97,1.488022000,0.0000
215.158.140.140,<->,8.252.213.117,1,56,0,0,1,56,1.488015000,0.0000
231.141.215.30,<->,136.25.188.174,0,0,1,50,1,50,1.486874000,0.0000
194.237.218.116,<->,136.25.188.253,0,0,1,50,1,50,1.486411000,0.0000
97.248.246.50,<->,89.183.104.172,0,0,1,50,1,50,1.486099000,0.0000
195.212.97.109,<->,50.224.76.230,0,0,1,50,1,50,1.486064000,0.0000
136.25.188.171,<->,100.224.202.157,1,56,0,0,1,56,1.485873000,0.0000
199.80.181.36,<->,136.25.188.172,0,0,1,50,1,50,1.484821000,0.0000
132.168.197.211,<->,109.108.154.250,1,50,0,0,1,50,1.484553000,0.0000
92.27.27.173,<->,48.109.17.12,1,50,0,0,1,50,1.484468000,0.0000
99.187.125.121,<->,8.20.87.10,0,0,1,56,1,56,1.484380000,0.0000
197.107.107.247,<->,8.182.138.11,0,0,1,50,1,50,1.483975000,0.0000
100.124.212.246,<->,80.41.38.205,0,0,1,255,1,255,1.483744000,0.0000
204.185.255.78,<->,136.25.188.238,0,0,1,56,1,56,1.483645000,0.0000
54.39.184.254,<->,48.55.119.121,0,0,1,50,1,50,1.483383000,0.0000
199.70.236.208,<->,136.25.188.236,0,0,1,50,1,50,1.483261000,0.0000
145.203.236.158,<->,136.25.188.163,0,0,1,56,1,56,1.483078000,0.0000
220.20.200.116,<->,102.45.208.135,1,50,0,0,1,50,1.482800000,0.0000
215.158.239.58,<->,195.5.208.21,1,50,0,0,1,50,1.482766000,0.0000
82.248.207.148,<->,8.220.239.48,0,0,1,50,1,50,1.482650000,0.0000
215.158.239.113,<->,129.222.39.54,1,56,0,0,1,56,1.482521000,0.0000
207.190.210.84,<->,136.25.188.177,0,0,1,50,1,50,1.481810000,0.0000
215.158.239.49,<->,196.107.168.131,1,56,0,0,1,56,1.481707000,0.0000
215.158.239.57,<->,199.20.29.252,1,56,0,0,1,56,1.481515000,0.0000
56.112.226.51,<->,8.176.34.109,0,0,1,50,1,50,1.481356000,0.0000
246.253.253.107,<->,56.148.119.56,1,50,0,0,1,50,1.481166000,0.0000
196.88.23.127,<->,136.25.188.226,0,0,1,56,1,56,1.481032000,0.0000
136.25.188.52,<->,56.12.213.238,1,56,0,0,1,56,1.480526000,0.0000
142.255.136.94,<->,136.25.188.178,0,0,1,56,1,56,1.480210000,0.0000
136.18.96.147,<->,8.183.25.124,0,0,1,50,1,50,1.480151000,0.0000
143.129.169.210,<->,136.25.188.163,0,0,1,141,1,141,1.480020000,0.0000
246.253.253.170,<->,8.35.106.56,1,56,0,0,1,56,1.479514000,0.0000
98.230.195.67,<->,8.182.227.210,0,0,1,50,1,50,1.479263000,0.0000
215.158.239.25,<->,96.135.154.115,1,56,0,0,1,56,1.479014000,0.0000
199.52.224.192,<->,136.25.188.241,0,0,1,56,1,56,1.478728000,0.0000
142.236.127.231,<->,136.25.188.176,0,0,1,50,1,50,1.478314000,0.0000
215.158.239.50,<->,199.38.118.52,1,56,0,0,1,56,1.478204000,0.0000
220.20.200.193,<->,159.70.46.125,1,50,0,0,1,50,1.477071000,0.0000
215.158.239.96,<->,199.20.30.238,1,56,0,0,1,56,1.477010000,0.0000
203.89.231.103,<->,50.224.80.64,0,0,1,50,1,50,1.476934000,0.0000
139.163.13.98,<->,122.209.227.154,1,50,0,0,1,50,1.476789000,0.0000
142.167.60.22,<->,136.25.188.209,0,0,1,50,1,50,1.475900000,0.0000
207.60.253.155,<->,136.25.188.254,0,0,1,56,1,56,1.475801000,0.0000
195.5.226.40,<->,136.25.188.177,0,0,1,50,1,50,1.475303000,0.0000
249.101.84.219,<->,54.61.53.169,1,50,0,0,1,50,1.474862000,0.0000
159.23.227.171,<->,93.135.236.168,1,50,0,0,1,50,1.474768000,0.0000
246.254.97.113,<->,210.231.140.55,1,50,0,0,1,50,1.473652000,0.0000
142.191.216.119,<->,136.25.188.225,0,0,1,50,1,50,1.473407000,0.0000
215.158.239.56,<->,199.20.30.110,1,56,0,0,1,56,1.473385000,0.0000
215.158.239.95,<->,199.20.31.143,1,56,0,0,1,56,1.473133000,0.0000
195.55.157.61,<->,136.25.188.176,0,0,1,56,1,56,1.473125000,0.0000
215.158.239.57,<->,199.20.30.110,1,56,0,0,1,56,1.472746000,0.0000
143.251.58.238,<->,129.78.115.208,0,0,1,56,1,56,1.472064000,0.0000
218.147.52.203,<->,8.176.48.218,0,0,1,56,1,56,1.471363000,0.0000
215.158.239.79,<->,199.20.30.110,1,56,0,0,1,56,1.470713000,0.0000
139.185.223.103,<->,97.168.93.121,0,0,1,983,1,983,1.469891000,0.0000
142.167.1.136,<->,136.25.188.53,0,0,1,68,1,68,1.468718000,0.0000
218.4.182.90,<->,159.42.43.112,1,56,0,0,1,56,1.467791000,0.0000
204.61.36.1,<->,136.25.188.226,0,0,1,56,1,56,1.467416000,0.0000
195.126.187.28,<->,136.25.188.46,0,0,1,56,1,56,1.466647000,0.0000
91.57.171.43,<->,8.220.200.17,0,0,1,56,1,56,1.466574000,0.0000
144.64.136.137,<->,27.15.11.177,1,56,0,0,1,56,1.466127000,0.0000
215.158.30.187,<->,8.252.222.57,0,0,1,56,1,56,1.465248000,0.0000
192.64.204.68,<->,122.120.221.47,1,50,0,0,1,50,1.464851000,0.0000
199.50.155.121,<->,136.25.188.253,0,0,1,56,1,56,1.464170000,0.0000
210.158.44.130,<->,145.200.61.224,1,50,0,0,1,50,1.462198000,0.0000
220.20.200.165,<->,149.92.32.244,1,50,0,0,1,50,1.462048000,0.0000
200.175.217.203,<->,53.213.103.24,1,50,0,0,1,50,1.461575000,0.0000
215.158.239.68,<->,202.33.255.198,1,56,0,0,1,56,1.461388000,0.0000
140.68.10.122,<->,8.252.222.158,0,0,1,132,1,132,1.460941000,0.0000
111.146.175.27,<->,27.158.211.45,1,50,0,0,1,50,1.460814000,0.0000
231.142.160.21,<->,136.25.188.225,0,0,1,50,1,50,1.460257000,0.0000
97.203.33.81,<->,8.182.226.78,0,0,1,56,1,56,1.460223000,0.0000
215.158.239.49,<->,195.83.184.144,1,56,0,0,1,56,1.460040000,0.0000
221.102.103.73,<->,207.23.68.228,1,50,0,0,1,50,1.459352000,0.0000
138.98.210.200,<->,99.170.109.141,1,56,0,0,1,56,1.458489000,0.0000
213.221.90.240,<->,144.85.170.208,0,0,1,56,1,56,1.458147000,0.0000
101.224.182.5,<->,92.162.253.239,0,0,1,585,1,585,1.457782000,0.0000
215.158.239.96,<->,143.42.43.107,1,50,0,0,1,50,1.457630000,0.0000
220.20.200.33,<->,98.23.99.94,1,50,0,0,1,50,1.457123000,0.0000
199.33.203.41,<->,136.25.188.209,0,0,1,50,1,50,1.456752000,0.0000
205.224.85.74,<->,99.73.59.147,0,0,1,50,1,50,1.456512000,0.0000
142.241.137.131,<->,136.25.188.174,0,0,1,56,1,56,1.455853000,0.0000
100.110.29.161,<->,92.27.219.36,0,0,1,50,1,50,1.455307000,0.0000
101.224.206.44,<->,57.211.62.2,1,56,0,0,1,56,1.455073000,0.0000
215.158.239.50,<->,142.252.177.167,1,56,0,0,1,56,1.454976000,0.0000
247.136.242.239,<->,132.216.20.254,1,56,0,0,1,56,1.454320000,0.0000
215.158.60.32,<->,133.178.226.213,0,0,1,56,1,56,1.453872000,0.0000
195.124.40.68,<->,136.25.188.198,0,0,1,56,1,56,1.453436000,0.0000
105.204.179.226,<->,50.224.76.234,0,0,1,50,1,50,1.453400000,0.0000
215.158.239.49,<->,194.251.113.103,1,56,0,0,1,56,1.453348000,0.0000
206.195.129.169,<->,144.86.146.31,0,0,1,50,1,50,1.452803000,0.0000
215.158.239.95,<->,196.0.149.119,1,56,0,0,1,56,1.452502000,0.0000
194.237.34.9,<->,136.25.188.55,0,0,1,56,1,56,1.452379000,0.0000
144.71.40.160,<->,64.163.196.59,1,50,0,0,1,50,1.452208000,0.0000
215.158.239.182,<->,144.253.73.244,1,56,0,0,1,56,1.452200000,0.0000
58.143.242.65,<->,8.252.221.204,0,0,1,50,1,50,1.452194000,0.0000
195.42.232.64,<->,136.25.188.255,0,0,1,50,1,50,1.452111000,0.0000
136.25.189.209,<->,96.234.109.145,1,285,0,0,1,285,1.451904000,0.0000
97.168.119.55,<->,91.231.223.53,1,50,0,0,1,50,1.451455000,0.0000
231.178.9.244,<->,39.248.89.72,0,0,1,56,1,56,1.450557000,0.0000
142.241.148.10,<->,136.25.188.236,0,0,1,50,1,50,1.450497000,0.0000
144.85.170.246,<->,98.87.146.190,1,56,0,0,1,56,1.450405000,0.0000
207.236.0.219,<->,136.25.188.177,0,0,1,50,1,50,1.450113000,0.0000
215.158.239.85,<->,207.63.54.13,1,56,0,0,1,56,1.449669000,0.0000
204.61.47.132,<->,136.25.188.220,0,0,1,50,1,50,1.449062000,0.0000
215.158.239.56,<->,194.251.73.223,1,56,0,0,1,56,1.448891000,0.0000
66.47.107.243,<->,8.252.222.63,0,0,1,50,1,50,1.447297000,0.0000
210.236.203.57,<->,91.231.193.139,0,0,1,56,1,56,1.446437000,0.0000
215.158.239.48,<->,142.248.197.100,1,50,0,0,1,50,1.445838000,0.0000
104.193.36.174,<->,50.224.76.234,0,0,1,50,1,50,1.445751000,0.0000
199.38.214.113,<->,136.25.188.199,0,0,1,56,1,56,1.445196000,0.0000
50.224.76.248,<->,17.139.200.50,1,56,0,0,1,56,1.444976000,0.0000
196.89.255.151,<->,136.25.188.225,0,0,1,56,1,56,1.444071000,0.0000
143.13.239.77,<->,136.25.188.241,0,0,1,50,1,50,1.443857000,0.0000
125.9.59.246,<->,109.1.25.177,0,0,1,56,1,56,1.443768000,0.0000
143.42.216.79,<->,136.25.188.176,0,0,1,50,1,50,1.443263000,0.0000
196.245.45.193,<->,136.25.188.198,0,0,1,56,1,56,1.443227000,0.0000
215.158.239.84,<->,207.188.142.23,1,50,0,0,1,50,1.441108000,0.0000
142.190.238.181,<->,136.25.188.241,0,0,1,56,1,56,1.440331000,0.0000
203.215.188.177,<->,111.151.237.20,1,56,0,0,1,56,1.439164000,0.0000
215.158.30.240,<->,8.252.222.32,0,0,1,56,1,56,1.438754000,0.0000
8.55.212.136,<->,6.74.242.83,0,0,1,56,1,56,1.438639000,0.0000
97.183.201.92,<->,8.222.7.179,1,56,0,0,1,56,1.438457000,0.0000
53.245.65.149,<->,48.54.250.126,0,0,1,50,1,50,1.438377000,0.0000
204.187.158.135,<->,136.25.188.222,0,0,1,56,1,56,1.438109000,0.0000
215.158.238.92,<->,113.23.104.247,1,56,0,0,1,56,1.437439000,0.0000
213.186.61.53,<->,144.85.170.208,0,0,1,56,1,56,1.436782000,0.0000
215.158.239.95,<->,195.41.138.4,1,50,0,0,1,50,1.436552000,0.0000
246.45.208.172,<->,132.119.137.223,1,56,0,0,1,56,1.436442000,0.0000
215.158.140.27,<->,38.27.126.240,1,56,0,0,1,56,1.436234000,0.0000
103.156.177.241,<->,89.183.104.165,0,0,1,50,1,50,1.435880000,0.0000
142.190.113.150,<->,136.25.188.163,0,0,1,56,1,56,1.435777000,0.0000
159.248.57.134,<->,136.25.188.209,0,0,1,56,1,56,1.435354000,0.0000
194.233.219.172,<->,136.25.188.177,0,0,1,56,1,56,1.435052000,0.0000
136.25.188.176,<->,8.227.55.27,1,56,0,0,1,56,1.435028000,0.0000
215.158.239.99,<->,142.166.122.161,1,50,0,0,1,50,1.434642000,0.0000
95.246.166.29,<->,8.252.221.239,0,0,1,56,1,56,1.434257000,0.0000
204.200.46.119,<->,136.25.188.226,0,0,1,50,1,50,1.433169000,0.0000
231.140.199.133,<->,136.25.188.226,0,0,1,56,1,56,1.432651000,0.0000
203.37.18.144,<->,8.220.238.62,0,0,1,50,1,50,1.432552000,0.0000
195.55.181.10,<->,136.25.188.209,0,0,1,50,1,50,1.432322000,0.0000
195.43.244.17,<->,136.25.188.253,0,0,1,50,1,50,1.432178000,0.0000
221.102.143.189,<->,98.128.162.225,0,0,1,56,1,56,1.432073000,0.0000
194.205.168.97,<->,8.182.226.167,0,0,1,50,1,50,1.431918000,0.0000
132.249.70.93,<->,8.37.218.73,1,56,0,0,1,56,1.431850000,0.0000
220.39.21.52,<->,133.32.39.1,0,0,1,56,1,56,1.431767000,0.0000
215.158.239.58,<->,199.39.65.23,1,50,0,0,1,50,1.431744000,0.0000
98.3.15.248,<->,8.182.226.78,0,0,1,50,1,50,1.430950000,0.0000
215.158.239.95,<->,199.20.29.254,1,56,0,0,1,56,1.430597000,0.0000
199.32.127.142,<->,136.25.188.220,0,0,1,50,1,50,1.430551000,0.0000
139.207.175.72,<->,50.224.76.235,0,0,1,56,1,56,1.430470000,0.0000
143.13.239.77,<->,136.25.188.175,0,0,1,50,1,50,1.430235000,0.0000
203.215.2.153,<->,8.181.37.222,1,56,0,0,1,56,1.430100000,0.0000
215.158.238.83,<->,80.47.111.11,1,56,0,0,1,56,1.429563000,0.0000
159.137.189.208,<->,121.21.77.8,1,50,0,0,1,50,1.428465000,0.0000
144.83.60.153,<->,92.162.253.94,0,0,1,50,1,50,1.428141000,0.0000
133.40.211.1,<->,8.252.222.160,0,0,1,56,1,56,1.427759000,0.0000
143.44.75.225,<->,136.25.188.225,0,0,1,56,1,56,1.427183000,0.0000
56.8.151.146,<->,8.182.226.78,0,0,1,50,1,50,1.426605000,0.0000
246.253.253.99,<->,205.209.150.135,1,50,0,0,1,50,1.426514000,0.0000
215.158.239.84,<->,204.227.240.179,1,56,0,0,1,56,1.426362000,0.0000
114.76.96.142,<->,92.162.253.161,0,0,1,789,1,789,1.426266000,0.0000
195.107.225.155,<->,50.224.76.234,0,0,1,50,1,50,1.426072000,0.0000
133.73.194.44,<->,98.128.213.98,0,0,1,50,1,50,1.425948000,0.0000
215.158.239.99,<->,199.20.30.57,1,56,0,0,1,56,1.425814000,0.0000
104.148.85.199,<->,92.27.219.192,0,0,1,50,1,50,1.425503000,0.0000
132.200.62.217,<->,132.20.222.234,1,56,0,0,1,56,1.425317000,0.0000
215.158.239.51,<->,195.54.50.33,1,50,0,0,1,50,1.424899000,0.0000
215.158.239.232,<->,100.244.13.26,1,56,0,0,1,56,1.424377000,0.0000
97.126.0.114,<->,56.121.22.229,1,50,0,0,1,50,1.423705000,0.0000
196.206.210.12,<->,136.25.188.178,0,0,1,56,1,56,1.423697000,0.0000
136.139.59.124,<->,136.25.188.172,0,0,1,56,1,56,1.422947000,0.0000
142.240.68.183,<->,136.25.188.243,0,0,1,50,1,50,1.422410000,0.0000
50.224.76.230,<->,18.201.229.119,1,50,0,0,1,50,1.421856000,0.0000
207.61.112.76,<->,136.25.188.255,0,0,1,56,1,56,1.421794000,0.0000
199.38.103.232,<->,136.25.188.177,0,0,1,50,1,50,1.421138000,0.0000
139.163.7.204,<->,130.79.84.77,1,56,0,0,1,56,1.420791000,0.0000
215.158.239.78,<->,196.93.146.104,1,56,0,0,1,56,1.420602000,0.0000
136.11.64.218,<->,8.53.2.189,0,0,1,56,1,56,1.420053000,0.0000
133.178.226.72,<->,98.219.126.140,1,56,0,0,1,56,1.419595000,0.0000
136.25.188.247,<->,100.224.202.178,1,56,0,0,1,56,1.418992000,0.0000
144.85.170.254,<->,91.69.185.154,1,56,0,0,1,56,1.418753000,0.0000
142.229.12.251,<->,136.25.188.236,0,0,1,50,1,50,1.418466000,0.0000
215.158.238.247,<->,215.158.43.49,1,56,0,0,1,56,1.417930000,0.0000
89.183.104.188,<->,78.45.228.179,1,56,0,0,1,56,1.417747000,0.0000
207.172.128.52,<->,136.25.188.162,0,0,1,56,1,56,1.417261000,0.0000
138.121.99.24,<->,8.220.202.59,0,0,1,50,1,50,1.416677000,0.0000
205.224.35.9,<->,139.193.141.207,0,0,1,56,1,56,1.416252000,0.0000
215.158.140.27,<->,38.88.250.159,1,56,0,0,1,56,1.416230000,0.0000
144.85.170.254,<->,91.69.185.193,1,56,0,0,1,56,1.415626000,0.0000
204.184.43.115,<->,136.25.188.222,0,0,1,56,1,56,1.414814000,0.0000
232.117.172.125,<->,220.55.99.127,0,0,1,50,1,50,1.413970000,0.0000
195.42.29.225,<->,136.25.188.253,0,0,1,56,1,56,1.413864000,0.0000
215.158.140.27,<->,141.185.8.239,1,56,0,0,1,56,1.413691000,0.0000
233.51.75.15,<->,215.158.140.27,0,0,1,56,1,56,1.412848000,0.0000
215.158.239.97,<->,207.57.17.96,1,93,0,0,1,93,1.412610000,0.0000
215.158.140.87,<->,83.242.143.211,1,50,0,0,1,50,1.412411000,0.0000
246.254.97.109,<->,139.33.175.144,1,216,0,0,1,216,1.411330000,0.0000
143.108.28.2,<->,8.220.195.51,0,0,1,56,1,56,1.410964000,0.0000
213.186.52.58,<->,144.85.170.246,0,0,1,56,1,56,1.410814000,0.0000
204.58.93.172,<->,50.224.76.234,0,0,1,50,1,50,1.410716000,0.0000
207.58.51.236,<->,136.25.188.44,0,0,1,50,1,50,1.410608000,0.0000
246.253.253.96,<->,210.209.251.214,1,50,0,0,1,50,1.410380000,0.0000
139.163.1.75,<->,38.49.236.26,1,50,0,0,1,50,1.410282000,0.0000
143.132.200.174,<->,136.25.188.253,0,0,1,50,1,50,1.410154000,0.0000
144.87.238.91,<->,8.182.224.248,0,0,1,50,1,50,1.410022000,0.0000
207.117.212.70,<->,8.182.239.140,0,0,1,50,1,50,1.409278000,0.0000
142.207.18.52,<->,136.25.188.254,0,0,1,56,1,56,1.408870000,0.0000
221.102.123.31,<->,194.245.232.253,1,50,0,0,1,50,1.408797000,0.0000
249.101.93.221,<->,109.127.101.16,1,499,0,0,1,499,1.408620000,0.0000
140.24.189.196,<->,8.252.222.156,0,0,1,50,1,50,1.408256000,0.0000
207.58.51.236,<->,136.25.188.197,0,0,1,50,1,50,1.408039000,0.0000
109.1.40.189,<->,53.68.234.251,1,50,0,0,1,50,1.406943000,0.0000
114.75.170.84,<->,8.52.169.61,0,0,1,56,1,56,1.406462000,0.0000
195.5.76.1,<->,136.25.188.241,0,0,1,50,1,50,1.406437000,0.0000
111.146.249.8,<->,53.149.173.81,1,56,0,0,1,56,1.405850000,0.0000
90.240.3.29,<->,53.244.102.135,1,56,0,0,1,56,1.405733000,0.0000
143.132.200.174,<->,136.25.188.222,0,0,1,50,1,50,1.405724000,0.0000
17.34.58.13,<->,8.220.235.114,0,0,1,50,1,50,1.405671000,0.0000
139.163.20.196,<->,97.53.8.224,1,50,0,0,1,50,1.405210000,0.0000
197.105.53.72,<->,8.252.222.159,0,0,1,50,1,50,1.404547000,0.0000
145.229.244.20,<->,8.52.182.119,0,0,1,50,1,50,1.404249000,0.0000
99.75.85.95,<->,8.55.194.232,1,56,0,0,1,56,1.403976000,0.0000
220.28.65.9,<->,136.25.189.62,0,0,1,56,1,56,1.403963000,0.0000
195.14.149.126,<->,136.25.188.227,0,0,1,56,1,56,1.403564000,0.0000
58.51.34.135,<->,8.252.222.46,0,0,1,56,1,56,1.403176000,0.0000
144.83.60.153,<->,92.162.253.6,0,0,1,50,1,50,1.403094000,0.0000
136.139.59.124,<->,136.25.189.89,0,0,1,56,1,56,1.402018000,0.0000
193.31.225.146,<->,92.162.252.222,0,0,1,50,1,50,1.401089000,0.0000
210.209.251.211,<->,98.129.77.37,0,0,1,50,1,50,1.400624000,0.0000
215.158.140.27,<->,126.221.81.103,1,56,0,0,1,56,1.400594000,0.0000
224.223.25.232,<->,8.220.202.59,0,0,1,50,1,50,1.400378000,0.0000
215.158.239.58,<->,196.93.154.19,1,56,0,0,1,56,1.399796000,0.0000
142.209.105.143,<->,136.25.188.220,0,0,1,56,1,56,1.398964000,0.0000
215.158.239.76,<->,199.70.23.5,1,56,0,0,1,56,1.398642000,0.0000
8.20.87.210,<->,6.145.149.214,1,56,0,0,1,56,1.397946000,0.0000
120.83.30.208,<->,101.70.116.99,0,0,1,50,1,50,1.396865000,0.0000
50.224.76.235,<->,18.51.233.128,1,50,0,0,1,50,1.396569000,0.0000
221.102.143.189,<->,80.40.17.42,0,0,1,87,1,87,1.395794000,0.0000
215.158.140.27,<->,159.154.253.88,1,56,0,0,1,56,1.394420000,0.0000
215.158.239.78,<->,199.106.152.222,1,56,0,0,1,56,1.393646000,0.0000
199.82.56.235,<->,136.25.188.225,0,0,1,56,1,56,1.393440000,0.0000
143.128.216.164,<->,136.25.188.220,0,0,1,56,1,56,1.393347000,0.0000
143.132.54.239,<->,136.25.188.226,0,0,1,56,1,56,1.392753000,0.0000
215.158.239.87,<->,199.20.31.208,1,56,0,0,1,56,1.392637000,0.0000
8.235.54.44,<->,8.228.219.242,0,0,1,50,1,50,1.392532000,0.0000
215.158.239.58,<->,196.106.117.138,1,56,0,0,1,56,1.391985000,0.0000
215.158.238.103,<->,145.116.209.82,1,56,0,0,1,56,1.391280000,0.0000
195.126.30.131,<->,136.25.188.242,0,0,1,50,1,50,1.390656000,0.0000
195.14.3.167,<->,136.25.188.176,0,0,1,50,1,50,1.390201000,0.0000
215.158.42.84,<->,133.178.226.246,0,0,1,56,1,56,1.390191000,0.0000
207.236.179.85,<->,136.25.188.253,0,0,1,56,1,56,1.389512000,0.0000
204.61.63.39,<->,136.25.188.46,0,0,1,56,1,56,1.389467000,0.0000
195.4.206.169,<->,136.25.188.225,0,0,1,50,1,50,1.388222000,0.0000
215.158.239.68,<->,207.63.240.255,1,56,0,0,1,56,1.388165000,0.0000
136.25.188.48,<->,80.57.141.130,1,56,0,0,1,56,1.387864000,0.0000
144.85.170.208,<->,91.69.181.137,1,56,0,0,1,56,1.387222000,0.0000
232.31.155.12,<->,97.198.118.56,0,0,1,56,1,56,1.386803000,0.0000
222.68.68.146,<->,144.95.111.109,1,71,0,0,1,71,1.386610000,0.0000
143.13.235.83,<->,136.25.188.209,0,0,1,56,1,56,1.384542000,0.0000
247.136.144.152,<->,92.160.68.225,1,50,0,0,1,50,1.384510000,0.0000
255.133.39.74,<->,220.49.48.127,1,50,0,0,1,50,1.384419000,0.0000
207.190.210.84,<->,136.25.188.53,0,0,1,50,1,50,1.384300000,0.0000
215.158.239.101,<->,129.222.39.189,1,56,0,0,1,56,1.384080000,0.0000
99.187.125.121,<->,8.20.87.2,0,0,1,56,1,56,1.383708000,0.0000
207.58.70.243,<->,136.25.188.54,0,0,1,56,1,56,1.383495000,0.0000
117.46.38.40,<->,92.27.219.21,0,0,1,50,1,50,1.382432000,0.0000
199.80.30.244,<->,136.25.188.178,0,0,1,50,1,50,1.381912000,0.0000
215.158.239.122,<->,53.246.131.101,1,56,0,0,1,56,1.380878000,0.0000
104.230.210.45,<->,50.224.76.234,0,0,1,50,1,50,1.380838000,0.0000
231.140.2.184,<->,136.25.188.45,0,0,1,56,1,56,1.380616000,0.0000
223.115.15.226,<->,8.252.221.239,0,0,1,56,1,56,1.380509000,0.0000
204.187.20.114,<->,136.25.188.174,0,0,1,56,1,56,1.380220000,0.0000
215.158.239.99,<->,199.20.30.36,1,56,0,0,1,56,1.379998000,0.0000
136.139.59.124,<->,136.25.188.222,0,0,1,56,1,56,1.379204000,0.0000
215.158.239.56,<->,199.122.128.167,1,50,0,0,1,50,1.379194000,0.0000
91.231.220.149,<->,6.228.14.212,0,0,1,50,1,50,1.378061000,0.0000
111.147.180.135,<->,54.37.105.75,1,50,0,0,1,50,1.377954000,0.0000
220.55.106.26,<->,120.247.80.243,1,50,0,0,1,50,1.377705000,0.0000
192.227.191.250,<->,133.178.227.208,0,0,1,56,1,56,1.377499000,0.0000
108.47.155.125,<->,8.52.222.23,0,0,1,50,1,50,1.377360000,0.0000
204.200.166.81,<->,136.25.188.242,0,0,1,50,1,50,1.376754000,0.0000
145.31.7.133,<->,92.27.219.135,0,0,1,50,1,50,1.376455000,0.0000
136.25.189.86,<->,98.219.126.175,1,56,0,0,1,56,1.376210000,0.0000
100.115.92.207,<->,97.110.90.36,1,56,0,0,1,56,1.376157000,0.0000
215.158.239.93,<->,196.104.91.110,1,56,0,0,1,56,1.375633000,0.0000
215.158.239.97,<->,207.236.245.176,1,50,0,0,1,50,1.375366000,0.0000
159.137.162.213,<->,125.194.251.186,1,50,0,0,1,50,1.375151000,0.0000
204.35.186.89,<->,50.223.3.228,0,0,1,56,1,56,1.374917000,0.0000
145.116.209.93,<->,136.25.188.231,0,0,1,56,1,56,1.374253000,0.0000
205.224.38.167,<->,102.51.12.80,0,0,1,50,1,50,1.373803000,0.0000
50.224.76.235,<->,48.129.148.191,1,56,0,0,1,56,1.373080000,0.0000
96.232.43.155,<->,92.27.219.55,0,0,1,50,1,50,1.372900000,0.0000
199.52.222.222,<->,136.25.188.226,0,0,1,50,1,50,1.372734000,0.0000
252.98.135.226,<->,106.5.211.8,1,56,0,0,1,56,1.372017000,0.0000
89.178.121.124,<->,50.224.76.230,0,0,1,50,1,50,1.371480000,0.0000
139.163.5.140,<->,105.131.197.161,1,269,0,0,1,269,1.371221000,0.0000
215.158.239.69,<->,199.20.31.18,1,56,0,0,1,56,1.371206000,0.0000
210.158.44.137,<->,124.58.27.63,1,50,0,0,1,50,1.371123000,0.0000
112.208.20.199,<->,102.50.212.36,0,0,1,50,1,50,1.371096000,0.0000
199.53.47.86,<->,136.25.188.255,0,0,1,56,1,56,1.371067000,0.0000
221.102.56.69,<->,109.2.82.112,0,0,1,56,1,56,1.370874000,0.0000
195.4.255.137,<->,136.25.188.225,0,0,1,50,1,50,1.370850000,0.0000
243.117.83.168,<->,133.54.28.241,0,0,1,50,1,50,1.370697000,0.0000
50.224.76.235,<->,48.130.162.38,1,56,0,0,1,56,1.370643000,0.0000
17.143.241.23,<->,8.220.176.253,0,0,1,56,1,56,1.370118000,0.0000
231.138.130.211,<->,136.25.188.227,0,0,1,56,1,56,1.369161000,0.0000
215.158.239.56,<->,195.42.86.194,1,50,0,0,1,50,1.368942000,0.0000
213.221.90.140,<->,144.85.170.208,0,0,1,56,1,56,1.368802000,0.0000
246.253.253.171,<->,56.114.235.120,1,486,0,0,1,486,1.367786000,0.0000
92.162.253.100,<->,35.107.150.45,1,50,0,0,1,50,1.367702000,0.0000
142.209.105.143,<->,136.25.188.175,0,0,1,56,1,56,1.367493000,0.0000
207.172.203.14,<->,136.25.188.196,0,0,1,56,1,56,1.367420000,0.0000
247.127.114.238,<->,221.102.113.231,0,0,1,50,1,50,1.367291000,0.0000
198.206.21.236,<->,100.93.217.200,0,0,1,50,1,50,1.366960000,0.0000
145.5.191.142,<->,50.224.111.73,0,0,1,56,1,56,1.366918000,0.0000
215.158.239.96,<->,199.70.111.166,1,50,0,0,1,50,1.366671000,0.0000
199.15.219.0,<->,136.25.188.45,0,0,1,56,1,56,1.366345000,0.0000
144.85.170.208,<->,98.87.145.170,1,56,0,0,1,56,1.365163000,0.0000
26.223.52.82,<->,8.220.179.94,0,0,1,50,1,50,1.365038000,0.0000
132.49.144.232,<->,54.36.194.252,1,56,0,0,1,56,1.364973000,0.0000
119.45.113.35,<->,92.162.252.142,0,0,1,50,1,50,1.364422000,0.0000
138.0.9.133,<->,109.1.60.149,0,0,1,56,1,56,1.363718000,0.0000
195.5.137.158,<->,136.25.188.252,0,0,1,50,1,50,1.363405000,0.0000
192.65.82.37,<->,8.45.168.98,1,50,0,0,1,50,1.363308000,0.0000
195.55.159.186,<->,136.25.188.175,0,0,1,50,1,50,1.362608000,0.0000
133.90.61.177,<->,8.220.186.82,0,0,1,56,1,56,1.361760000,0.0000
75.137.50.255,<->,8.252.221.221,0,0,1,56,1,56,1.361515000,0.0000
204.58.165.79,<->,136.25.188.174,0,0,1,56,1,56,1.361197000,0.0000
206.195.248.172,<->,108.134.118.112,0,0,1,56,1,56,1.361077000,0.0000
113.188.193.197,<->,8.252.222.58,0,0,1,56,1,56,1.361072000,0.0000
203.215.176.177,<->,124.42.185.84,1,56,0,0,1,56,1.360955000,0.0000
139.244.182.238,<->,8.220.239.132,0,0,1,50,1,50,1.360955000,0.0000
229.45.207.12,<->,53.230.44.150,1,56,0,0,1,56,1.360786000,0.0000
141.252.217.88,<->,58.43.188.34,1,50,0,0,1,50,1.360536000,0.0000
133.32.39.45,<->,100.190.199.37,1,50,0,0,1,50,1.359908000,0.0000
194.237.47.251,<->,136.25.188.220,0,0,1,56,1,56,1.359405000,0.0000
144.72.193.201,<->,99.74.36.20,0,0,1,50,1,50,1.359334000,0.0000
145.236.79.181,<->,8.52.188.25,0,0,1,56,1,56,1.359130000,0.0000
144.85.170.254,<->,91.69.181.227,1,56,0,0,1,56,1.359117000,0.0000
132.200.62.137,<->,132.200.51.75,1,56,0,0,1,56,1.358572000,0.0000
80.32.33.204,<->,8.52.181.8,0,0,1,50,1,50,1.358436000,0.0000
138.90.73.184,<->,133.32.39.1,0,0,1,50,1,50,1.357930000,0.0000
159.137.162.213,<->,113.225.205.88,1,50,0,0,1,50,1.357689000,0.0000
119.163.235.139,<->,50.224.76.235,0,0,1,56,1,56,1.357358000,0.0000
243.117.82.214,<->,203.214.79.56,0,0,1,50,1,50,1.357049000,0.0000
221.102.56.69,<->,192.64.102.83,0,0,1,56,1,56,1.356444000,0.0000
159.137.162.213,<->,122.211.242.222,1,50,0,0,1,50,1.355526000,0.0000
255.133.39.74,<->,53.231.144.222,1,50,0,0,1,50,1.355138000,0.0000
145.89.249.42,<->,50.224.76.230,0,0,1,50,1,50,1.355110000,0.0000
215.158.238.236,<->,33.209.210.244,1,56,0,0,1,56,1.354403000,0.0000
215.158.239.85,<->,207.228.145.49,1,56,0,0,1,56,1.354118000,0.0000
133.178.226.227,<->,8.53.216.3,1,56,0,0,1,56,1.354095000,0.0000
144.87.238.91,<->,8.182.227.18,0,0,1,50,1,50,1.354056000,0.0000
142.222.45.79,<->,92.27.194.147,0,0,1,56,1,56,1.353865000,0.0000
192.65.25.7,<->,8.55.211.213,1,56,0,0,1,56,1.353461000,0.0000
138.98.231.23,<->,100.120.38.110,1,56,0,0,1,56,1.353191000,0.0000
193.51.144.28,<->,109.1.35.91,0,0,1,56,1,56,1.352071000,0.0000
144.86.148.17,<->,84.214.213.100,1,50,0,0,1,50,1.352069000,0.0000
207.236.236.149,<->,136.25.188.238,0,0,1,56,1,56,1.350577000,0.0000
199.53.47.86,<->,136.25.188.242,0,0,1,56,1,56,1.350345000,0.0000
220.55.96.42,<->,8.222.6.181,1,1251,0,0,1,1251,1.350261000,0.0000
195.41.59.163,<->,136.25.188.179,0,0,1,50,1,50,1.350113000,0.0000
136.25.188.202,<->,80.57.141.161,1,56,0,0,1,56,1.349819000,0.0000
195.14.91.226,<->,136.25.188.252,0,0,1,56,1,56,1.349678000,0.0000
196.240.212.210,<->,136.25.188.176,0,0,1,50,1,50,1.349552000,0.0000
138.98.147.25,<->,42.68.240.157,1,50,0,0,1,50,1.349287000,0.0000
142.218.198.234,<->,8.52.182.30,0,0,1,50,1,50,1.349143000,0.0000
239.66.110.113,<->,203.215.177.38,0,0,1,56,1,56,1.349050000,0.0000
133.178.226.225,<->,113.24.30.219,1,56,0,0,1,56,1.348951000,0.0000
215.158.239.56,<->,194.251.126.128,1,56,0,0,1,56,1.348412000,0.0000
215.158.239.95,<->,199.20.28.85,1,56,0,0,1,56,1.348331000,0.0000
199.69.210.44,<->,136.25.188.220,0,0,1,50,1,50,1.348134000,0.0000
249.101.118.139,<->,144.72.193.17,1,50,0,0,1,50,1.347851000,0.0000
97.198.121.8,<->,80.27.154.150,1,56,0,0,1,56,1.347155000,0.0000
199.122.164.167,<->,136.25.188.44,0,0,1,56,1,56,1.346818000,0.0000
143.132.20.174,<->,136.25.188.225,0,0,1,56,1,56,1.346813000,0.0000
215.158.239.79,<->,199.20.30.180,1,56,0,0,1,56,1.346567000,0.0000
204.200.34.97,<->,136.25.188.162,0,0,1,132,1,132,1.346225000,0.0000
142.207.203.238,<->,136.25.188.54,0,0,1,50,1,50,1.345604000,0.0000
199.50.26.180,<->,136.25.188.46,0,0,1,50,1,50,1.345505000,0.0000
207.63.170.142,<->,136.25.188.209,0,0,1,50,1,50,1.345122000,0.0000
215.158.140.27,<->,149.254.205.176,1,56,0,0,1,56,1.345116000,0.0000
213.186.52.112,<->,144.85.170.254,0,0,1,56,1,56,1.344692000,0.0000
215.158.239.252,<->,8.47.189.76,1,56,0,0,1,56,1.344648000,0.0000
192.67.160.161,<->,117.196.96.71,1,56,0,0,1,56,1.344193000,0.0000
251.122.143.50,<->,50.224.76.234,0,0,1,56,1,56,1.343768000,0.0000
80.41.32.57,<->,38.86.74.97,1,50,0,0,1,50,1.342656000,0.0000
142.166.5.17,<->,136.25.188.175,0,0,1,56,1,56,1.342459000,0.0000
158.55.218.34,<->,50.224.76.235,0,0,1,56,1,56,1.341944000,0.0000
144.85.170.244,<->,91.69.185.135,1,56,0,0,1,56,1.341942000,0.0000
54.59.120.90,<->,6.95.133.147,0,0,1,50,1,50,1.341849000,0.0000
144.72.193.17,<->,99.75.53.165,0,0,1,50,1,50,1.341248000,0.0000
132.249.70.195,<->,92.26.137.227,1,56,0,0,1,56,1.341197000,0.0000
109.1.8.94,<->,53.213.1.69,1,56,0,0,1,56,1.340529000,0.0000
199.14.239.58,<->,136.25.188.239,0,0,1,56,1,56,1.339619000,0.0000
193.53.171.164,<->,144.64.139.133,0,0,1,50,1,50,1.338933000,0.0000
145.242.126.139,<->,53.94.218.235,1,56,0,0,1,56,1.338311000,0.0000
215.158.239.50,<->,204.61.83.25,1,56,0,0,1,56,1.335915000,0.0000
17.201.151.140,<->,8.220.204.234,0,0,1,56,1,56,1.335726000,0.0000
215.158.239.113,<->,129.222.39.145,1,56,0,0,1,56,1.335626000,0.0000
144.85.170.208,<->,103.40.248.158,1,56,0,0,1,56,1.335494000,0.0000
220.28.115.46,<->,215.158.238.103,0,0,1,56,1,56,1.335491000,0.0000
129.224.112.252,<->,97.242.126.187,1,56,0,0,1,56,1.334568000,0.0000
221.163.98.137,<->,220.20.200.19,0,0,1,50,1,50,1.334560000,0.0000
199.38.234.35,<->,136.25.188.177,0,0,1,56,1,56,1.334291000,0.0000
100.122.38.84,<->,8.182.229.19,0,0,1,50,1,50,1.334178000,0.0000
195.70.145.112,<->,136.25.188.46,0,0,1,56,1,56,1.334096000,0.0000
199.32.178.45,<->,136.25.188.175,0,0,1,50,1,50,1.333294000,0.0000
139.163.120.40,<->,118.113.168.54,1,56,0,0,1,56,1.333258000,0.0000
118.66.41.107,<->,50.224.76.235,0,0,1,50,1,50,1.332802000,0.0000
215.158.239.244,<->,112.235.86.193,1,56,0,0,1,56,1.332484000,0.0000
199.50.123.48,<->,136.25.188.252,0,0,1,56,1,56,1.332224000,0.0000
136.25.188.253,<->,8.227.55.116,1,56,0,0,1,56,1.331090000,0.0000
141.30.139.33,<->,50.224.76.235,0,0,1,56,1,56,1.330817000,0.0000
243.134.122.0,<->,8.182.226.78,0,0,1,50,1,50,1.329586000,0.0000
199.73.34.24,<->,136.25.188.176,0,0,1,50,1,50,1.329146000,0.0000
199.32.178.45,<->,136.25.188.222,0,0,1,50,1,50,1.329097000,0.0000
243.117.93.192,<->,159.137.243.250,0,0,1,50,1,50,1.329049000,0.0000
197.113.99.161,<->,136.25.188.225,0,0,1,56,1,56,1.328077000,0.0000
249.101.227.124,<->,98.57.212.245,1,56,0,0,1,56,1.326899000,0.0000
220.20.200.140,<->,67.2.14.156,1,50,0,0,1,50,1.326757000,0.0000
207.72.121.71,<->,8.176.49.189,0,0,1,50,1,50,1.326736000,0.0000
111.146.236.167,<->,53.243.10.49,1,50,0,0,1,50,1.326683000,0.0000
199.73.184.144,<->,136.25.188.225,0,0,1,50,1,50,1.326342000,0.0000
214.245.143.148,<->,210.158.44.41,0,0,1,50,1,50,1.324342000,0.0000
114.76.119.97,<->,92.162.253.80,0,0,1,50,1,50,1.323967000,0.0000
92.27.59.96,<->,8.182.136.181,0,0,1,56,1,56,1.323527000,0.0000
231.142.55.106,<->,215.158.239.56,0,0,1,50,1,50,1.322897000,0.0000
143.134.97.211,<->,136.25.188.197,0,0,1,56,1,56,1.322888000,0.0000
8.52.178.229,<->,6.37.218.160,1,50,0,0,1,50,1.322882000,0.0000
159.137.162.213,<->,112.70.222.21,1,50,0,0,1,50,1.322577000,0.0000
144.87.238.91,<->,8.182.253.40,0,0,1,50,1,50,1.322080000,0.0000
69.243.32.83,<->,8.252.221.197,0,0,1,56,1,56,1.321976000,0.0000
210.209.251.223,<->,144.87.235.222,0,0,1,50,1,50,1.321729000,0.0000
207.60.249.92,<->,136.25.188.220,0,0,1,56,1,56,1.321685000,0.0000
144.75.218.95,<->,17.61.6.229,1,56,0,0,1,56,1.321230000,0.0000
248.225.31.13,<->,50.233.39.151,1,50,0,0,1,50,1.321217000,0.0000
215.158.239.80,<->,98.219.126.140,1,56,0,0,1,56,1.319658000,0.0000
247.136.147.108,<->,38.28.33.62,1,50,0,0,1,50,1.319291000,0.0000
220.59.108.41,<->,92.162.253.25,0,0,1,50,1,50,1.319188000,0.0000
139.249.90.204,<->,100.120.38.6,1,56,0,0,1,56,1.317275000,0.0000
215.158.239.94,<->,196.107.189.140,1,56,0,0,1,56,1.316647000,0.0000
215.158.146.244,<->,8.252.223.120,0,0,1,50,1,50,1.315949000,0.0000
99.187.125.122,<->,8.20.87.33,0,0,1,56,1,56,1.315777000,0.0000
144.88.76.220,<->,54.69.75.250,1,56,0,0,1,56,1.315690000,0.0000
199.50.55.20,<->,136.25.188.177,0,0,1,56,1,56,1.315566000,0.0000
215.158.239.93,<->,199.20.7.50,1,56,0,0,1,56,1.314992000,0.0000
199.81.193.82,<->,136.25.188.243,0,0,1,56,1,56,1.314640000,0.0000
159.109.227.110,<->,54.59.129.47,1,56,0,0,1,56,1.314483000,0.0000
136.25.189.11,<->,98.219.126.140,1,56,0,0,1,56,1.313667000,0.0000
207.175.236.1,<->,136.25.188.220,0,0,1,50,1,50,1.313621000,0.0000
206.51.47.69,<->,192.64.217.166,0,0,1,50,1,50,1.313595000,0.0000
215.158.239.252,<->,8.255.95.184,1,56,0,0,1,56,1.313576000,0.0000
204.63.98.222,<->,136.25.188.175,0,0,1,56,1,56,1.313048000,0.0000
126.159.11.10,<->,50.224.76.230,0,0,1,56,1,56,1.311677000,0.0000
159.137.162.213,<->,38.126.10.50,1,50,0,0,1,50,1.311472000,0.0000
200.174.207.15,<->,53.160.87.174,1,56,0,0,1,56,1.310879000,0.0000
136.25.188.252,<->,84.210.156.185,1,50,0,0,1,50,1.310804000,0.0000
192.224.21.47,<->,133.178.226.66,0,0,1,56,1,56,1.310351000,0.0000
231.142.16.195,<->,136.25.188.196,0,0,1,56,1,56,1.310049000,0.0000
215.158.239.99,<->,199.20.30.171,1,56,0,0,1,56,1.309581000,0.0000
141.182.238.203,<->,8.252.221.223,0,0,1,56,1,56,1.308927000,0.0000
215.158.140.27,<->,121.130.202.224,1,56,0,0,1,56,1.308537000,0.0000
103.239.109.158,<->,92.27.219.173,0,0,1,50,1,50,1.308046000,0.0000
200.174.210.169,<->,53.200.100.60,1,56,0,0,1,56,1.307463000,0.0000
246.253.157.15,<->,149.100.161.82,1,50,0,0,1,50,1.306899000,0.0000
215.158.239.84,<->,204.226.125.255,1,56,0,0,1,56,1.306789000,0.0000
199.82.100.160,<->,136.25.188.225,0,0,1,50,1,50,1.306630000,0.0000
207.159.193.224,<->,50.224.76.235,0,0,1,50,1,50,1.305875000,0.0000
142.229.81.148,<->,136.25.188.255,0,0,1,56,1,56,1.305653000,0.0000
132.18.67.27,<->,100.95.39.8,0,0,1,50,1,50,1.305231000,0.0000
215.158.238.82,<->,113.23.104.221,1,56,0,0,1,56,1.304748000,0.0000
215.158.239.200,<->,145.82.220.164,1,56,0,0,1,56,1.303470000,0.0000
246.253.253.171,<->,145.166.26.99,1,56,0,0,1,56,1.303122000,0.0000
215.158.239.92,<->,196.88.76.140,1,50,0,0,1,50,1.302489000,0.0000
196.246.129.115,<->,136.25.188.52,0,0,1,56,1,56,1.301791000,0.0000
202.33.52.234,<->,136.25.188.174,0,0,1,56,1,56,1.301244000,0.0000
99.162.77.146,<->,53.167.130.195,1,56,0,0,1,56,1.299607000,0.0000
105.201.254.176,<->,80.42.128.224,0,0,1,50,1,50,1.299057000,0.0000
215.158.239.96,<->,199.71.81.103,1,50,0,0,1,50,1.298480000,0.0000
204.200.42.4,<->,136.25.188.177,0,0,1,56,1,56,1.297611000,0.0000
215.158.239.57,<->,195.7.4.235,1,50,0,0,1,50,1.295662000,0.0000
195.215.92.47,<->,50.223.3.228,0,0,1,50,1,50,1.295632000,0.0000
223.143.26.18,<->,92.27.27.148,0,0,1,50,1,50,1.295397000,0.0000
204.3.154.3,<->,136.25.188.52,0,0,1,50,1,50,1.294724000,0.0000
215.158.239.55,<->,80.57.141.179,1,56,0,0,1,56,1.294099000,0.0000
199.68.247.252,<->,136.25.188.252,0,0,1,56,1,56,1.293951000,0.0000
204.187.74.11,<->,136.25.188.160,0,0,1,56,1,56,1.293723000,0.0000
193.25.56.161,<->,50.224.76.230,0,0,1,56,1,56,1.293539000,0.0000
195.41.80.183,<->,136.25.188.45,0,0,1,56,1,56,1.293516000,0.0000
215.158.238.89,<->,145.116.209.82,1,56,0,0,1,56,1.292960000,0.0000
159.137.162.213,<->,82.150.50.215,1,50,0,0,1,50,1.292347000,0.0000
133.178.226.213,<->,112.235.95.84,1,56,0,0,1,56,1.292293000,0.0000
50.224.76.235,<->,4.129.153.247,1,50,0,0,1,50,1.292111000,0.0000
215.158.239.113,<->,129.222.39.232,1,56,0,0,1,56,1.291114000,0.0000
246.254.97.113,<->,139.33.174.19,1,50,0,0,1,50,1.290434000,0.0000
149.29.174.76,<->,50.224.76.234,0,0,1,56,1,56,1.290425000,0.0000
202.33.125.147,<->,136.25.188.174,0,0,1,56,1,56,1.290044000,0.0000
142.253.110.56,<->,136.25.188.196,0,0,1,56,1,56,1.289401000,0.0000
136.51.124.227,<->,8.53.4.76,0,0,1,56,1,56,1.289341000,0.0000
92.175.125.194,<->,8.220.178.166,0,0,1,50,1,50,1.288631000,0.0000
193.51.144.28,<->,80.40.11.116,0,0,1,56,1,56,1.287548000,0.0000
215.158.239.48,<->,199.20.6.6,1,56,0,0,1,56,1.286534000,0.0000
195.41.45.182,<->,136.25.188.253,0,0,1,50,1,50,1.286273000,0.0000
129.224.112.252,<->,97.242.126.176,1,56,0,0,1,56,1.285823000,0.0000
197.160.85.21,<->,8.182.138.83,0,0,1,50,1,50,1.284205000,0.0000
197.160.85.21,<->,8.182.234.114,0,0,1,50,1,50,1.283678000,0.0000
98.98.23.141,<->,8.52.182.119,0,0,1,50,1,50,1.282817000,0.0000
133.178.226.80,<->,96.155.60.212,1,56,0,0,1,56,1.281090000,0.0000
231.143.91.67,<->,136.25.188.225,0,0,1,56,1,56,1.280862000,0.0000
246.45.209.122,<->,59.150.215.46,1,56,0,0,1,56,1.280840000,0.0000
98.101.7.51,<->,8.176.63.62,0,0,1,56,1,56,1.280484000,0.0000
199.33.95.97,<->,136.25.188.252,0,0,1,56,1,56,1.278684000,0.0000
220.20.200.172,<->,53.173.23.121,1,50,0,0,1,50,1.278543000,0.0000
204.62.175.71,<->,136.25.188.225,0,0,1,56,1,56,1.278193000,0.0000
213.186.52.66,<->,144.85.170.208,0,0,1,56,1,56,1.277632000,0.0000
104.246.207.98,<->,50.224.76.234,0,0,1,56,1,56,1.277317000,0.0000
94.192.158.3,<->,8.252.222.143,0,0,1,56,1,56,1.277312000,0.0000
145.242.126.139,<->,99.167.188.131,1,56,0,0,1,56,1.276273000,0.0000
113.5.147.22,<->,111.147.92.14,0,0,1,445,1,445,1.275711000,0.0000
218.233.211.196,<->,8.220.188.183,0,0,1,50,1,50,1.275448000,0.0000
57.17.145.133,<->,50.224.76.234,0,0,1,56,1,56,1.274975000,0.0000
194.238.211.78,<->,136.25.188.237,0,0,1,56,1,56,1.274968000,0.0000
109.222.238.4,<->,54.43.164.11,1,50,0,0,1,50,1.274739000,0.0000
80.42.155.74,<->,8.55.152.101,1,50,0,0,1,50,1.274427000,0.0000
195.4.94.194,<->,136.25.188.226,0,0,1,50,1,50,1.274279000,0.0000
86.76.233.159,<->,80.27.159.117,0,0,1,50,1,50,1.274248000,0.0000
65.26.112.57,<->,8.252.222.62,0,0,1,56,1,56,1.272773000,0.0000
220.28.108.254,<->,136.25.189.8,0,0,1,56,1,56,1.272462000,0.0000
231.140.125.106,<->,136.25.188.225,0,0,1,56,1,56,1.271202000,0.0000
195.14.249.169,<->,136.25.188.238,0,0,1,56,1,56,1.271108000,0.0000
142.223.153.139,<->,136.25.188.160,0,0,1,56,1,56,1.270601000,0.0000
215.158.239.57,<->,195.41.171.110,1,50,0,0,1,50,1.270101000,0.0000
144.83.60.139,<->,92.162.253.97,0,0,1,50,1,50,1.269869000,0.0000
215.158.239.57,<->,207.239.53.40,1,50,0,0,1,50,1.269203000,0.0000
142.220.241.46,<->,136.25.188.196,0,0,1,50,1,50,1.268964000,0.0000
199.70.23.31,<->,136.25.188.237,0,0,1,56,1,56,1.268833000,0.0000
213.186.61.123,<->,144.85.170.208,0,0,1,56,1,56,1.268776000,0.0000
204.2.225.153,<->,136.25.188.178,0,0,1,56,1,56,1.267934000,0.0000
113.2.177.77,<->,50.224.76.235,0,0,1,56,1,56,1.267477000,0.0000
204.200.160.221,<->,136.25.188.236,0,0,1,50,1,50,1.267354000,0.0000
244.149.8.95,<->,215.158.140.27,0,0,1,56,1,56,1.266857000,0.0000
50.224.76.235,<->,29.211.4.107,1,56,0,0,1,56,1.266586000,0.0000
215.158.239.97,<->,196.104.65.18,1,56,0,0,1,56,1.266016000,0.0000
197.113.65.29,<->,136.25.188.253,0,0,1,50,1,50,1.265916000,0.0000
215.158.239.56,<->,143.132.31.242,1,50,0,0,1,50,1.265101000,0.0000
199.73.204.98,<->,136.25.188.211,0,0,1,50,1,50,1.264357000,0.0000
97.168.79.89,<->,93.68.182.75,1,50,0,0,1,50,1.263484000,0.0000
136.129.30.3,<->,50.224.76.248,0,0,1,50,1,50,1.263270000,0.0000
215.158.238.129,<->,139.163.161.50,1,56,0,0,1,56,1.263244000,0.0000
215.158.238.106,<->,143.155.227.59,1,56,0,0,1,56,1.263081000,0.0000
215.158.239.86,<->,199.20.30.158,1,56,0,0,1,56,1.262752000,0.0000
136.181.50.70,<->,0.195.216.195,1,56,0,0,1,56,1.261615000,0.0000
53.240.56.15,<->,8.228.209.115,0,0,1,56,1,56,1.261579000,0.0000
80.42.168.235,<->,14.30.152.112,1,56,0,0,1,56,1.261513000,0.0000
198.154.155.94,<->,50.224.76.230,0,0,1,50,1,50,1.261149000,0.0000
220.55.119.126,<->,198.146.28.33,1,50,0,0,1,50,1.260717000,0.0000
195.12.120.42,<->,136.25.188.178,0,0,1,56,1,56,1.260555000,0.0000
199.39.251.109,<->,136.25.188.253,0,0,1,56,1,56,1.260466000,0.0000
137.137.115.85,<->,132.18.67.27,1,50,0,0,1,50,1.259492000,0.0000
144.72.193.17,<->,132.163.8.243,0,0,1,50,1,50,1.259322000,0.0000
215.158.239.69,<->,194.251.91.218,1,50,0,0,1,50,1.258218000,0.0000
111.25.52.96,<->,98.67.141.138,0,0,1,50,1,50,1.258132000,0.0000
204.21.96.158,<->,136.25.188.253,0,0,1,50,1,50,1.257770000,0.0000
215.158.239.50,<->,194.232.252.138,1,56,0,0,1,56,1.257198000,0.0000
36.123.54.248,<->,8.20.87.10,0,0,1,56,1,56,1.257128000,0.0000
215.158.239.87,<->,199.20.28.159,1,56,0,0,1,56,1.257084000,0.0000
159.137.162.213,<->,122.212.51.57,1,50,0,0,1,50,1.256945000,0.0000
195.50.75.207,<->,50.224.76.230,0,0,1,56,1,56,1.256888000,0.0000
255.17.29.128,<->,8.220.176.253,0,0,1,50,1,50,1.255391000,0.0000
220.28.114.28,<->,215.158.238.234,0,0,1,56,1,56,1.255300000,0.0000
158.195.24.146,<->,139.193.141.139,0,0,1,56,1,56,1.254925000,0.0000
200.73.217.247,<->,8.220.176.253,0,0,1,50,1,50,1.254663000,0.0000
121.31.106.144,<->,109.1.56.197,0,0,1,50,1,50,1.254607000,0.0000
112.172.123.2,<->,8.52.187.224,0,0,1,50,1,50,1.254290000,0.0000
195.13.14.209,<->,136.25.188.252,0,0,1,56,1,56,1.254130000,0.0000
245.61.110.58,<->,8.20.87.153,0,0,1,56,1,56,1.253996000,0.0000
144.86.144.224,<->,92.162.221.88,1,50,0,0,1,50,1.253363000,0.0000
207.58.173.209,<->,136.25.188.52,0,0,1,50,1,50,1.252699000,0.0000
207.58.197.224,<->,136.25.188.163,0,0,1,50,1,50,1.252652000,0.0000
215.158.238.120,<->,42.195.144.225,1,56,0,0,1,56,1.252226000,0.0000
215.158.239.95,<->,204.2.151.175,1,56,0,0,1,56,1.252097000,0.0000
201.192.55.103,<->,80.38.21.161,0,0,1,50,1,50,1.251052000,0.0000
143.94.97.133,<->,50.224.76.230,0,0,1,56,1,56,1.250075000,0.0000
204.200.51.94,<->,136.25.188.243,0,0,1,132,1,132,1.249932000,0.0000
143.135.8.163,<->,136.25.188.163,0,0,1,56,1,56,1.248668000,0.0000
111.146.212.59,<->,53.245.93.66,1,50,0,0,1,50,1.247864000,0.0000
221.95.117.170,<->,50.224.76.230,0,0,1,50,1,50,1.247822000,0.0000
207.62.182.244,<->,136.25.188.252,0,0,1,56,1,56,1.247137000,0.0000
195.55.49.14,<->,136.25.188.252,0,0,1,56,1,56,1.246357000,0.0000
139.163.26.238,<->,0.164.109.191,1,56,0,0,1,56,1.245847000,0.0000
133.178.226.197,<->,56.97.187.17,1,56,0,0,1,56,1.245815000,0.0000
215.158.239.58,<->,142.191.235.114,1,56,0,0,1,56,1.245742000,0.0000
119.45.80.60,<->,92.162.253.188,0,0,1,50,1,50,1.245700000,0.0000
243.117.83.161,<->,220.55.72.171,0,0,1,50,1,50,1.245180000,0.0000
207.61.214.110,<->,136.25.188.242,0,0,1,50,1,50,1.244846000,0.0000
144.85.170.254,<->,91.69.181.209,1,56,0,0,1,56,1.244363000,0.0000
216.144.222.186,<->,215.158.140.165,0,0,1,50,1,50,1.244181000,0.0000
204.200.162.182,<->,136.25.188.240,0,0,1,56,1,56,1.244016000,0.0000
143.42.232.82,<->,136.25.188.252,0,0,1,50,1,50,1.243808000,0.0000
144.83.60.137,<->,92.162.253.96,0,0,1,50,1,50,1.243433000,0.0000
193.35.127.52,<->,50.224.108.164,0,0,1,50,1,50,1.243350000,0.0000
220.28.73.211,<->,136.25.189.7,0,0,1,56,1,56,1.242736000,0.0000
148.46.100.128,<->,50.224.76.234,0,0,1,50,1,50,1.242388000,0.0000
75.214.44.151,<->,8.252.221.236,0,0,1,56,1,56,1.242208000,0.0000
144.85.170.244,<->,139.148.114.204,1,56,0,0,1,56,1.241705000,0.0000
159.137.162.213,<->,50.72.52.215,1,50,0,0,1,50,1.241357000,0.0000
145.19.169.181,<->,92.162.253.239,0,0,1,50,1,50,1.240962000,0.0000
199.70.160.51,<->,136.25.188.174,0,0,1,50,1,50,1.240267000,0.0000
144.85.170.208,<->,91.69.185.132,1,56,0,0,1,56,1.240024000,0.0000
215.158.239.58,<->,199.20.7.206,1,56,0,0,1,56,1.239995000,0.0000
200.175.248.186,<->,53.200.28.121,1,56,0,0,1,56,1.239976000,0.0000
97.233.39.9,<->,8.220.190.86,0,0,1,50,1,50,1.239724000,0.0000
48.43.216.192,<->,0.195.210.46,0,0,1,56,1,56,1.239627000,0.0000
75.214.44.151,<->,8.252.221.198,0,0,1,56,1,56,1.239514000,0.0000
17.248.138.62,<->,8.220.200.124,0,0,1,50,1,50,1.239309000,0.0000
132.180.15.160,<->,8.220.200.124,0,0,1,50,1,50,1.238633000,0.0000
215.158.239.99,<->,207.60.60.95,1,50,0,0,1,50,1.237471000,0.0000
17.248.138.62,<->,8.220.188.50,0,0,1,50,1,50,1.237438000,0.0000
225.170.68.28,<->,97.198.118.57,0,0,1,56,1,56,1.236982000,0.0000
143.76.164.44,<->,8.182.226.42,0,0,1,50,1,50,1.236812000,0.0000
215.158.239.90,<->,145.116.209.92,1,56,0,0,1,56,1.236353000,0.0000
231.142.229.46,<->,136.25.188.222,0,0,1,56,1,56,1.236015000,0.0000
99.187.125.122,<->,8.20.87.34,0,0,1,56,1,56,1.235135000,0.0000
195.126.152.22,<->,136.25.188.178,0,0,1,56,1,56,1.234906000,0.0000
220.20.200.172,<->,119.159.22.233,1,50,0,0,1,50,1.234777000,0.0000
248.239.92.239,<->,132.18.67.26,1,56,0,0,1,56,1.234666000,0.0000
29.157.140.52,<->,8.182.136.236,0,0,1,50,1,50,1.234477000,0.0000
159.23.224.190,<->,73.80.222.209,1,50,0,0,1,50,1.233741000,0.0000
197.225.152.32,<->,92.27.219.155,0,0,1,50,1,50,1.232459000,0.0000
207.60.55.165,<->,136.25.188.163,0,0,1,56,1,56,1.231156000,0.0000
54.59.75.111,<->,48.54.97.29,0,0,1,56,1,56,1.230615000,0.0000
220.84.197.99,<->,66.216.210.188,1,50,0,0,1,50,1.230280000,0.0000
195.41.208.229,<->,136.25.188.255,0,0,1,56,1,56,1.229856000,0.0000
207.57.148.180,<->,136.25.188.238,0,0,1,56,1,56,1.229810000,0.0000
215.158.239.56,<->,196.0.105.26,1,56,0,0,1,56,1.229085000,0.0000
35.55.6.217,<->,8.183.25.224,0,0,1,56,1,56,1.228173000,0.0000
192.170.255.220,<->,133.32.39.0,0,0,1,56,1,56,1.227940000,0.0000
215.158.239.48,<->,196.93.47.221,1,56,0,0,1,56,1.227798000,0.0000
194.237.73.14,<->,136.25.188.44,0,0,1,56,1,56,1.227651000,0.0000
143.79.216.168,<->,136.25.188.225,0,0,1,50,1,50,1.227582000,0.0000
143.79.199.56,<->,136.25.188.163,0,0,1,50,1,50,1.227337000,0.0000
215.158.239.93,<->,196.95.135.73,1,56,0,0,1,56,1.227106000,0.0000
215.158.239.93,<->,199.76.70.154,1,132,0,0,1,132,1.227004000,0.0000
82.121.224.75,<->,8.52.180.14,0,0,1,50,1,50,1.226817000,0.0000
112.109.130.103,<->,8.228.218.37,0,0,1,50,1,50,1.226771000,0.0000
100.93.182.97,<->,35.55.218.106,1,56,0,0,1,56,1.226452000,0.0000
215.158.140.27,<->,116.125.105.207,1,56,0,0,1,56,1.225769000,0.0000
143.132.103.11,<->,136.25.188.226,0,0,1,50,1,50,1.225647000,0.0000
215.158.239.48,<->,142.167.211.243,1,56,0,0,1,56,1.224875000,0.0000
207.61.214.110,<->,136.25.188.236,0,0,1,50,1,50,1.224334000,0.0000
216.144.222.136,<->,215.158.140.144,0,0,1,56,1,56,1.222934000,0.0000
215.158.238.117,<->,145.116.209.82,1,56,0,0,1,56,1.222524000,0.0000
99.215.120.166,<->,8.183.25.124,0,0,1,50,1,50,1.221336000,0.0000
215.158.30.229,<->,136.25.188.244,0,0,1,56,1,56,1.221158000,0.0000
215.158.239.48,<->,196.91.218.75,1,56,0,0,1,56,1.220708000,0.0000
136.25.188.178,<->,8.227.55.4,1,56,0,0,1,56,1.220610000,0.0000
132.118.97.71,<->,80.42.154.222,0,0,1,56,1,56,1.219479000,0.0000
207.172.10.180,<->,136.25.188.225,0,0,1,105,1,105,1.218733000,0.0000
111.147.202.234,<->,54.58.210.172,1,50,0,0,1,50,1.217714000,0.0000
220.20.200.61,<->,84.211.26.201,1,50,0,0,1,50,1.217612000,0.0000
203.94.155.241,<->,136.25.188.46,0,0,1,56,1,56,1.216267000,0.0000
199.38.237.160,<->,136.25.188.52,0,0,1,50,1,50,1.216265000,0.0000
207.162.174.184,<->,8.182.235.164,0,0,1,50,1,50,1.215376000,0.0000
133.178.227.27,<->,133.56.180.33,1,56,0,0,1,56,1.215275000,0.0000
192.64.254.164,<->,8.45.162.111,1,50,0,0,1,50,1.214927000,0.0000
207.77.155.149,<->,8.182.227.180,0,0,1,50,1,50,1.214886000,0.0000
54.55.139.166,<->,8.228.210.186,0,0,1,56,1,56,1.213936000,0.0000
213.221.90.230,<->,144.85.170.208,0,0,1,56,1,56,1.213768000,0.0000
215.158.239.78,<->,199.20.31.243,1,56,0,0,1,56,1.213603000,0.0000
50.224.76.235,<->,29.154.146.144,1,50,0,0,1,50,1.212850000,0.0000
215.158.239.80,<->,145.116.209.76,1,56,0,0,1,56,1.212452000,0.0000
80.27.155.117,<->,56.7.53.161,1,50,0,0,1,50,1.212350000,0.0000
207.206.9.47,<->,50.224.76.235,0,0,1,50,1,50,1.212341000,0.0000
199.70.149.192,<->,136.25.188.177,0,0,1,50,1,50,1.211636000,0.0000
195.41.237.25,<->,136.25.188.53,0,0,1,56,1,56,1.210593000,0.0000
234.182.161.104,<->,215.158.140.188,0,0,1,50,1,50,1.210555000,0.0000
133.178.226.214,<->,29.211.199.33,1,56,0,0,1,56,1.210518000,0.0000
210.209.251.211,<->,109.2.43.79,0,0,1,50,1,50,1.209957000,0.0000
215.158.239.79,<->,195.43.148.38,1,56,0,0,1,56,1.209543000,0.0000
215.158.239.69,<->,199.20.5.131,1,56,0,0,1,56,1.209077000,0.0000
243.117.125.26,<->,203.214.79.56,0,0,1,50,1,50,1.208271000,0.0000
207.236.187.217,<->,136.25.188.252,0,0,1,50,1,50,1.208203000,0.0000
127.182.106.91,<->,109.1.16.242,0,0,1,50,1,50,1.207999000,0.0000
192.76.122.50,<->,89.183.104.179,0,0,1,50,1,50,1.207928000,0.0000
243.49.82.173,<->,97.190.208.100,0,0,1,1041,1,1041,1.207775000,0.0000
92.162.253.70,<->,8.4.143.176,1,50,0,0,1,50,1.207750000,0.0000
203.94.155.241,<->,136.25.188.162,0,0,1,56,1,56,1.206974000,0.0000
119.159.22.233,<->,92.162.253.252,0,0,1,50,1,50,1.206800000,0.0000
247.152.220.29,<->,50.224.76.235,0,0,1,50,1,50,1.206126000,0.0000
143.42.24.199,<->,136.25.188.174,0,0,1,56,1,56,1.204922000,0.0000
100.93.188.233,<->,89.205.210.165,1,50,0,0,1,50,1.204807000,0.0000
218.4.165.167,<->,132.216.20.76,1,50,0,0,1,50,1.204476000,0.0000
215.158.239.101,<->,129.222.39.218,1,56,0,0,1,56,1.203696000,0.0000
142.207.240.33,<->,136.25.188.176,0,0,1,50,1,50,1.203073000,0.0000
215.158.239.57,<->,196.104.174.247,1,56,0,0,1,56,1.202851000,0.0000
95.247.43.157,<->,8.252.221.221,0,0,1,56,1,56,1.202696000,0.0000
109.1.118.120,<->,80.46.139.86,1,50,0,0,1,50,1.202369000,0.0000
142.220.62.244,<->,136.25.188.162,0,0,1,50,1,50,1.202195000,0.0000
139.163.166.118,<->,136.25.188.176,0,0,1,56,1,56,1.202174000,0.0000
131.78.5.109,<->,89.183.104.143,0,0,1,50,1,50,1.201986000,0.0000
145.16.34.73,<->,137.39.55.47,1,56,0,0,1,56,1.201580000,0.0000
159.137.189.229,<->,27.150.102.249,1,56,0,0,1,56,1.201251000,0.0000
104.92.51.130,<->,89.183.109.134,0,0,1,56,1,56,1.201053000,0.0000
249.176.116.24,<->,224.148.203.58,0,0,1,56,1,56,1.201017000,0.0000
194.245.232.156,<->,8.252.222.177,0,0,1,56,1,56,1.200242000,0.0000
215.158.238.252,<->,215.158.43.40,1,56,0,0,1,56,1.199714000,0.0000
53.161.180.137,<->,48.55.59.102,0,0,1,50,1,50,1.199479000,0.0000
132.128.49.138,<->,35.56.97.244,0,0,1,50,1,50,1.198953000,0.0000
215.158.239.56,<->,196.93.232.240,1,56,0,0,1,56,1.198104000,0.0000
202.33.252.100,<->,136.25.188.179,0,0,1,56,1,56,1.197759000,0.0000
142.252.121.142,<->,136.25.188.176,0,0,1,56,1,56,1.196527000,0.0000
207.191.168.51,<->,136.25.188.222,0,0,1,132,1,132,1.196435000,0.0000
111.147.193.127,<->,53.201.91.18,1,56,0,0,1,56,1.195839000,0.0000
204.58.167.215,<->,136.25.188.175,0,0,1,56,1,56,1.195505000,0.0000
133.178.227.253,<->,126.219.54.44,1,56,0,0,1,56,1.195370000,0.0000
118.228.219.119,<->,50.224.76.235,0,0,1,56,1,56,1.195097000,0.0000
207.59.194.140,<->,136.25.188.177,0,0,1,50,1,50,1.194350000,0.0000
243.117.93.112,<->,80.38.36.175,0,0,1,50,1,50,1.193917000,0.0000
94.192.158.3,<->,8.252.222.60,0,0,1,56,1,56,1.193672000,0.0000
133.178.226.215,<->,131.251.111.52,1,56,0,0,1,56,1.192931000,0.0000
195.124.172.110,<->,136.25.188.209,0,0,1,50,1,50,1.192751000,0.0000
144.85.170.208,<->,91.69.181.159,1,56,0,0,1,56,1.192647000,0.0000
54.37.171.141,<->,48.55.138.147,0,0,1,50,1,50,1.192110000,0.0000
195.42.146.59,<->,136.25.188.163,0,0,1,50,1,50,1.191970000,0.0000
207.236.196.98,<->,136.25.188.225,0,0,1,56,1,56,1.191939000,0.0000
111.147.66.19,<->,54.37.127.247,1,56,0,0,1,56,1.191258000,0.0000
221.102.143.189,<->,192.64.244.13,0,0,1,141,1,141,1.190163000,0.0000
196.94.112.182,<->,50.224.76.248,0,0,1,56,1,56,1.189596000,0.0000
215.158.239.94,<->,196.1.17.216,1,56,0,0,1,56,1.189438000,0.0000
215.158.239.85,<->,195.42.22.18,1,50,0,0,1,50,1.188184000,0.0000
215.158.239.70,<->,142.191.179.38,1,50,0,0,1,50,1.188056000,0.0000
215.158.239.86,<->,204.226.36.140,1,56,0,0,1,56,1.188047000,0.0000
247.136.132.244,<->,109.219.207.11,1,369,0,0,1,369,1.186228000,0.0000
207.63.65.6,<->,136.25.188.176,0,0,1,56,1,56,1.186209000,0.0000
207.64.129.119,<->,92.27.194.147,0,0,1,56,1,56,1.185851000,0.0000
139.47.249.71,<->,109.192.136.250,0,0,1,50,1,50,1.185612000,0.0000
8.222.212.2,<->,8.43.183.186,0,0,1,56,1,56,1.185178000,0.0000
199.32.197.239,<->,136.25.188.220,0,0,1,50,1,50,1.184875000,0.0000
204.61.128.174,<->,136.25.188.239,0,0,1,50,1,50,1.184853000,0.0000
207.236.118.137,<->,136.25.188.252,0,0,1,56,1,56,1.184578000,0.0000
207.239.101.2,<->,136.25.188.239,0,0,1,56,1,56,1.183585000,0.0000
246.253.217.173,<->,143.76.143.45,1,50,0,0,1,50,1.182218000,0.0000
102.45.241.111,<->,92.162.253.16,0,0,1,50,1,50,1.182069000,0.0000
229.45.200.94,<->,27.158.122.184,1,56,0,0,1,56,1.182053000,0.0000
133.178.226.225,<->,106.188.226.66,1,56,0,0,1,56,1.181296000,0.0000
136.25.188.52,<->,64.108.32.174,1,50,0,0,1,50,1.181031000,0.0000
233.145.101.62,<->,109.222.236.213,0,0,1,50,1,50,1.180876000,0.0000
249.101.102.77,<->,233.116.130.93,1,50,0,0,1,50,1.180551000,0.0000
144.87.238.89,<->,8.182.136.93,0,0,1,50,1,50,1.180497000,0.0000
142.234.32.238,<->,8.52.175.115,0,0,1,56,1,56,1.180488000,0.0000
215.158.239.59,<->,199.20.30.218,1,56,0,0,1,56,1.180316000,0.0000
129.78.116.160,<->,92.162.219.10,1,50,0,0,1,50,1.180256000,0.0000
215.158.3.13,<->,99.73.241.125,0,0,1,50,1,50,1.179956000,0.0000
195.70.4.190,<->,136.25.188.241,0,0,1,50,1,50,1.179815000,0.0000
142.190.131.48,<->,136.25.188.176,0,0,1,50,1,50,1.179022000,0.0000
93.181.154.110,<->,92.27.27.148,0,0,1,56,1,56,1.178643000,0.0000
204.3.28.135,<->,136.25.188.176,0,0,1,56,1,56,1.177348000,0.0000
142.248.47.73,<->,136.25.188.242,0,0,1,50,1,50,1.176802000,0.0000
143.79.22.132,<->,136.25.188.241,0,0,1,56,1,56,1.176780000,0.0000
133.178.226.233,<->,115.162.222.164,1,56,0,0,1,56,1.176688000,0.0000
141.252.251.223,<->,100.50.96.207,1,56,0,0,1,56,1.176479000,0.0000
199.15.18.41,<->,136.25.188.238,0,0,1,56,1,56,1.176081000,0.0000
199.121.78.32,<->,136.25.188.52,0,0,1,50,1,50,1.175042000,0.0000
197.113.99.169,<->,136.25.188.226,0,0,1,56,1,56,1.174956000,0.0000
199.69.28.179,<->,136.25.188.220,0,0,1,50,1,50,1.173681000,0.0000
252.98.135.226,<->,106.5.211.7,1,56,0,0,1,56,1.173367000,0.0000
215.158.140.27,<->,29.211.238.15,1,56,0,0,1,56,1.173332000,0.0000
215.158.239.86,<->,195.83.248.246,1,56,0,0,1,56,1.172535000,0.0000
221.102.143.189,<->,98.129.25.93,0,0,1,87,1,87,1.172456000,0.0000
231.142.35.175,<->,136.25.188.53,0,0,1,50,1,50,1.171999000,0.0000
204.34.141.202,<->,50.224.76.234,0,0,1,50,1,50,1.171690000,0.0000
143.129.220.197,<->,136.25.188.198,0,0,1,56,1,56,1.171470000,0.0000
215.158.140.27,<->,57.61.162.208,1,56,0,0,1,56,1.171321000,0.0000
221.196.122.67,<->,136.25.188.173,0,0,1,56,1,56,1.171300000,0.0000
108.134.126.133,<->,100.206.91.45,1,50,0,0,1,50,1.170504000,0.0000
221.102.56.25,<->,192.65.64.124,0,0,1,56,1,56,1.170462000,0.0000
215.158.239.79,<->,143.13.124.234,1,50,0,0,1,50,1.169804000,0.0000
84.200.127.223,<->,6.95.3.106,0,0,1,56,1,56,1.169591000,0.0000
246.253.198.51,<->,116.77.119.226,1,50,0,0,1,50,1.169209000,0.0000
213.186.61.87,<->,144.85.170.254,0,0,1,56,1,56,1.168902000,0.0000
215.158.3.33,<->,99.73.241.125,0,0,1,50,1,50,1.168768000,0.0000
220.20.200.112,<->,132.216.159.4,1,264,0,0,1,264,1.168654000,0.0000
133.178.226.199,<->,115.162.222.218,1,56,0,0,1,56,1.168113000,0.0000
221.102.56.69,<->,6.74.97.41,0,0,1,56,1,56,1.166267000,0.0000
112.208.20.199,<->,99.72.196.59,0,0,1,50,1,50,1.166109000,0.0000
246.254.97.104,<->,210.231.140.55,1,50,0,0,1,50,1.165869000,0.0000
197.113.64.243,<->,136.25.188.253,0,0,1,56,1,56,1.165833000,0.0000
215.158.239.182,<->,57.210.104.45,1,56,0,0,1,56,1.165573000,0.0000
210.209.251.211,<->,98.67.151.76,0,0,1,75,1,75,1.164735000,0.0000
195.43.145.245,<->,136.25.188.178,0,0,1,56,1,56,1.164700000,0.0000
159.57.90.68,<->,109.222.208.59,0,0,1,50,1,50,1.164303000,0.0000
142.227.67.192,<->,136.25.188.198,0,0,1,50,1,50,1.164196000,0.0000
204.58.34.150,<->,136.25.188.179,0,0,1,50,1,50,1.163850000,0.0000
199.82.190.234,<->,136.25.188.176,0,0,1,56,1,56,1.163379000,0.0000
136.25.189.93,<->,98.219.126.140,1,56,0,0,1,56,1.163342000,0.0000
215.158.239.79,<->,199.82.190.234,1,56,0,0,1,56,1.162518000,0.0000
69.22.182.164,<->,50.224.76.234,0,0,1,56,1,56,1.162302000,0.0000
215.158.239.68,<->,202.33.23.96,1,56,0,0,1,56,1.161971000,0.0000
142.248.47.73,<->,136.25.188.54,0,0,1,50,1,50,1.161599000,0.0000
215.158.239.78,<->,195.55.11.216,1,56,0,0,1,56,1.161426000,0.0000
199.111.112.177,<->,8.182.235.164,0,0,1,50,1,50,1.160608000,0.0000
213.186.52.80,<->,144.85.170.208,0,0,1,56,1,56,1.160294000,0.0000
144.87.235.222,<->,109.127.101.16,1,529,0,0,1,529,1.159756000,0.0000
215.158.239.48,<->,207.228.230.155,1,56,0,0,1,56,1.159441000,0.0000
199.81.232.212,<->,136.25.188.176,0,0,1,50,1,50,1.158956000,0.0000
195.5.79.82,<->,136.25.188.45,0,0,1,50,1,50,1.158595000,0.0000
215.158.239.79,<->,143.79.196.178,1,56,0,0,1,56,1.157808000,0.0000
104.190.120.170,<->,50.224.76.230,0,0,1,50,1,50,1.157458000,0.0000
192.64.204.68,<->,125.57.94.174,1,50,0,0,1,50,1.157101000,0.0000
114.180.165.79,<->,92.27.219.153,0,0,1,56,1,56,1.156592000,0.0000
221.102.56.69,<->,192.65.241.179,0,0,1,56,1,56,1.156167000,0.0000
93.214.143.185,<->,50.224.76.234,0,0,1,50,1,50,1.155729000,0.0000
194.233.86.79,<->,136.25.188.197,0,0,1,56,1,56,1.155320000,0.0000
215.158.239.201,<->,192.226.44.75,1,56,0,0,1,56,1.154707000,0.0000
221.196.123.31,<->,136.25.188.173,0,0,1,56,1,56,1.154638000,0.0000
202.33.126.121,<->,136.25.188.209,0,0,1,56,1,56,1.154495000,0.0000
159.137.162.213,<->,117.49.144.192,1,50,0,0,1,50,1.154339000,0.0000
214.85.127.177,<->,50.224.76.235,0,0,1,56,1,56,1.154082000,0.0000
97.80.160.1,<->,8.52.169.61,0,0,1,50,1,50,1.154048000,0.0000
231.142.16.195,<->,136.25.188.252,0,0,1,56,1,56,1.152824000,0.0000
98.129.85.211,<->,97.4.157.23,1,92,0,0,1,92,1.152213000,0.0000
142.229.136.46,<->,136.25.188.178,0,0,1,56,1,56,1.152134000,0.0000
53.200.150.117,<->,48.55.149.22,0,0,1,50,1,50,1.151536000,0.0000
215.158.140.27,<->,126.219.196.240,1,56,0,0,1,56,1.150599000,0.0000
136.114.101.39,<->,136.25.188.202,0,0,1,56,1,56,1.150304000,0.0000
204.58.34.150,<->,136.25.188.54,0,0,1,50,1,50,1.150259000,0.0000
218.233.211.196,<->,8.220.202.4,0,0,1,50,1,50,1.150088000,0.0000
133.178.226.14,<->,96.155.60.212,1,56,0,0,1,56,1.150074000,0.0000
207.162.131.219,<->,8.182.253.209,0,0,1,50,1,50,1.149911000,0.0000
215.158.239.78,<->,199.20.5.104,1,56,0,0,1,56,1.149844000,0.0000
50.224.76.248,<->,6.75.72.161,1,56,0,0,1,56,1.148262000,0.0000
132.168.198.158,<->,50.145.220.35,1,56,0,0,1,56,1.147943000,0.0000
69.243.202.119,<->,8.252.221.236,0,0,1,50,1,50,1.147667000,0.0000
142.228.58.183,<->,136.25.188.255,0,0,1,50,1,50,1.147428000,0.0000
220.20.200.55,<->,127.62.25.159,1,50,0,0,1,50,1.147405000,0.0000
97.34.178.244,<->,50.224.102.155,0,0,1,56,1,56,1.147229000,0.0000
199.33.141.117,<->,136.25.188.236,0,0,1,50,1,50,1.147146000,0.0000
149.128.96.82,<->,133.178.226.76,0,0,1,56,1,56,1.146963000,0.0000
136.25.188.222,<->,80.47.111.87,1,56,0,0,1,56,1.146660000,0.0000
136.181.42.3,<->,107.13.12.217,1,56,0,0,1,56,1.146390000,0.0000
66.47.82.31,<->,8.252.222.134,0,0,1,56,1,56,1.145826000,0.0000
204.3.40.131,<->,136.25.188.174,0,0,1,56,1,56,1.145407000,0.0000
205.127.108.115,<->,33.233.141.69,0,0,1,56,1,56,1.144789000,0.0000
199.14.140.0,<->,136.25.188.163,0,0,1,50,1,50,1.144496000,0.0000
56.121.53.122,<->,17.199.155.30,1,435,0,0,1,435,1.143960000,0.0000
215.158.140.27,<->,122.158.179.48,1,56,0,0,1,56,1.143683000,0.0000
50.224.76.230,<->,6.4.63.97,1,50,0,0,1,50,1.143346000,0.0000
199.82.179.248,<->,136.25.188.242,0,0,1,56,1,56,1.143106000,0.0000
231.142.226.241,<->,136.25.188.198,0,0,1,50,1,50,1.142607000,0.0000
215.158.239.78,<->,196.91.93.155,1,56,0,0,1,56,1.142518000,0.0000
159.240.4.24,<->,8.20.87.92,0,0,1,50,1,50,1.142489000,0.0000
136.181.42.3,<->,111.25.52.96,1,56,0,0,1,56,1.142320000,0.0000
132.249.70.23,<->,8.222.6.181,1,56,0,0,1,56,1.142029000,0.0000
139.163.16.148,<->,102.240.109.181,1,50,0,0,1,50,1.141940000,0.0000
205.127.108.115,<->,33.233.141.1,0,0,1,56,1,56,1.141144000,0.0000
195.15.133.115,<->,136.25.188.240,0,0,1,56,1,56,1.139843000,0.0000
113.23.77.201,<->,101.126.182.154,0,0,1,50,1,50,1.139825000,0.0000
195.42.108.172,<->,136.25.188.243,0,0,1,56,1,56,1.139598000,0.0000
204.56.12.188,<->,136.25.188.55,0,0,1,56,1,56,1.139384000,0.0000
159.190.106.139,<->,8.182.226.78,0,0,1,50,1,50,1.138209000,0.0000
205.127.108.115,<->,33.233.141.72,0,0,1,56,1,56,1.138172000,0.0000
204.62.115.169,<->,136.25.188.237,0,0,1,56,1,56,1.137723000,0.0000
159.36.243.10,<->,8.52.187.224,0,0,1,50,1,50,1.137642000,0.0000
231.142.117.95,<->,136.25.188.175,0,0,1,50,1,50,1.137411000,0.0000
136.181.42.3,<->,91.40.231.175,1,56,0,0,1,56,1.137123000,0.0000
136.181.42.3,<->,8.49.69.216,1,56,0,0,1,56,1.136948000,0.0000
221.102.143.189,<->,220.80.213.14,0,0,1,56,1,56,1.136791000,0.0000
231.140.151.20,<->,136.25.188.253,0,0,1,50,1,50,1.136260000,0.0000
109.119.182.228,<->,8.182.251.47,0,0,1,50,1,50,1.136243000,0.0000
134.160.217.145,<->,92.27.219.61,0,0,1,599,1,599,1.135999000,0.0000
195.43.33.186,<->,136.25.188.225,0,0,1,56,1,56,1.135875000,0.0000
144.85.170.254,<->,91.69.185.208,1,56,0,0,1,56,1.135723000,0.0000
199.50.60.196,<->,136.25.188.242,0,0,1,56,1,56,1.135708000,0.0000
215.158.239.56,<->,199.20.28.102,1,56,0,0,1,56,1.135433000,0.0000
137.194.151.102,<->,50.224.76.235,0,0,1,56,1,56,1.135278000,0.0000
204.140.145.221,<->,8.182.241.177,0,0,1,56,1,56,1.135104000,0.0000
243.49.83.90,<->,129.92.112.143,0,0,1,1040,1,1040,1.134490000,0.0000
143.79.216.80,<->,136.25.188.46,0,0,1,56,1,56,1.133106000,0.0000
100.230.43.160,<->,50.224.72.162,0,0,1,50,1,50,1.133061000,0.0000
215.158.239.76,<->,199.82.190.234,1,56,0,0,1,56,1.132948000,0.0000
207.101.163.98,<->,8.182.224.87,0,0,1,56,1,56,1.132433000,0.0000
159.178.66.219,<->,8.52.133.228,0,0,1,56,1,56,1.132248000,0.0000
56.124.246.90,<->,8.220.176.253,0,0,1,50,1,50,1.132077000,0.0000
102.231.186.190,<->,8.49.69.216,1,56,0,0,1,56,1.131924000,0.0000
207.58.49.250,<->,136.25.188.175,0,0,1,50,1,50,1.131491000,0.0000
200.175.234.79,<->,53.214.237.69,1,50,0,0,1,50,1.130983000,0.0000
120.123.160.244,<->,50.224.76.235,0,0,1,50,1,50,1.130813000,0.0000
143.135.228.52,<->,136.25.188.225,0,0,1,50,1,50,1.130305000,0.0000
231.142.252.179,<->,136.25.188.178,0,0,1,50,1,50,1.130080000,0.0000
195.70.106.10,<->,136.25.188.255,0,0,1,50,1,50,1.129124000,0.0000
144.85.170.254,<->,98.87.146.72,1,56,0,0,1,56,1.128234000,0.0000
195.14.65.48,<->,136.25.188.174,0,0,1,56,1,56,1.128223000,0.0000
252.189.160.163,<->,8.182.241.177,0,0,1,56,1,56,1.128039000,0.0000
109.207.237.37,<->,50.224.76.235,0,0,1,50,1,50,1.126428000,0.0000
50.51.20.222,<->,8.220.176.253,0,0,1,56,1,56,1.126204000,0.0000
143.13.117.23,<->,136.25.188.160,0,0,1,50,1,50,1.125835000,0.0000
215.158.238.100,<->,145.116.209.83,1,56,0,0,1,56,1.125787000,0.0000
215.158.239.78,<->,196.94.212.182,1,56,0,0,1,56,1.125717000,0.0000
205.127.108.113,<->,33.233.141.41,0,0,1,56,1,56,1.125702000,0.0000
88.202.152.49,<->,50.224.76.234,0,0,1,50,1,50,1.125318000,0.0000
129.224.112.252,<->,97.242.126.195,1,56,0,0,1,56,1.125300000,0.0000
199.15.122.164,<->,136.25.188.198,0,0,1,50,1,50,1.125262000,0.0000
92.27.4.173,<->,89.183.104.149,0,0,1,50,1,50,1.124316000,0.0000
243.117.93.219,<->,159.137.243.250,0,0,1,50,1,50,1.123892000,0.0000
221.102.56.69,<->,98.128.109.60,0,0,1,56,1,56,1.123394000,0.0000
194.232.1.138,<->,136.25.188.242,0,0,1,50,1,50,1.122851000,0.0000
220.20.200.137,<->,136.177.72.3,1,50,0,0,1,50,1.122710000,0.0000
136.181.51.96,<->,54.50.73.135,1,56,0,0,1,56,1.122158000,0.0000
142.205.232.34,<->,136.25.188.53,0,0,1,56,1,56,1.121760000,0.0000
127.79.24.44,<->,50.224.76.235,0,0,1,50,1,50,1.121522000,0.0000
199.14.3.9,<->,136.25.188.255,0,0,1,56,1,56,1.121204000,0.0000
197.113.99.140,<->,136.25.188.178,0,0,1,56,1,56,1.121051000,0.0000
50.224.76.234,<->,48.129.152.119,1,56,0,0,1,56,1.120864000,0.0000
215.158.239.85,<->,199.20.6.101,1,56,0,0,1,56,1.120712000,0.0000
215.158.238.6,<->,207.201.134.57,1,56,0,0,1,56,1.120498000,0.0000
206.241.112.70,<->,97.168.71.84,0,0,1,56,1,56,1.120167000,0.0000
215.158.239.92,<->,199.51.197.185,1,50,0,0,1,50,1.120013000,0.0000
142.205.232.34,<->,8.252.222.132,0,0,1,56,1,56,1.119619000,0.0000
132.216.20.184,<->,80.40.56.122,0,0,1,56,1,56,1.119485000,0.0000
215.158.239.182,<->,80.47.161.166,1,56,0,0,1,56,1.118791000,0.0000
101.238.103.211,<->,8.55.221.148,1,81,0,0,1,81,1.118342000,0.0000
50.224.76.234,<->,38.12.28.107,1,50,0,0,1,50,1.117867000,0.0000
199.32.195.137,<->,136.25.188.238,0,0,1,56,1,56,1.116112000,0.0000
197.161.240.141,<->,136.25.188.239,0,0,1,56,1,56,1.116029000,0.0000
215.158.239.94,<->,204.226.53.177,1,56,0,0,1,56,1.115556000,0.0000
144.85.170.208,<->,98.87.146.78,1,56,0,0,1,56,1.115207000,0.0000
231.140.94.203,<->,136.25.188.45,0,0,1,56,1,56,1.114713000,0.0000
133.178.226.198,<->,29.211.110.77,1,56,0,0,1,56,1.114568000,0.0000
207.236.234.31,<->,136.25.188.175,0,0,1,50,1,50,1.113859000,0.0000
207.63.96.194,<->,136.25.188.220,0,0,1,50,1,50,1.113716000,0.0000
143.134.14.45,<->,136.25.188.176,0,0,1,50,1,50,1.113499000,0.0000
129.224.112.252,<->,97.242.126.200,1,56,0,0,1,56,1.113305000,0.0000
220.28.108.254,<->,136.25.189.94,0,0,1,56,1,56,1.113221000,0.0000
210.209.251.211,<->,101.70.96.205,0,0,1,50,1,50,1.112101000,0.0000
97.18.65.129,<->,8.220.176.253,0,0,1,56,1,56,1.111922000,0.0000
215.158.239.87,<->,199.20.31.0,1,56,0,0,1,56,1.111248000,0.0000
215.158.239.77,<->,204.21.105.164,1,50,0,0,1,50,1.110736000,0.0000
159.137.162.213,<->,121.124.232.8,1,50,0,0,1,50,1.109615000,0.0000
195.126.25.205,<->,136.25.188.236,0,0,1,56,1,56,1.108849000,0.0000
144.85.170.254,<->,98.87.144.231,1,56,0,0,1,56,1.108661000,0.0000
197.107.3.206,<->,136.25.188.238,0,0,1,132,1,132,1.108257000,0.0000
143.155.227.59,<->,133.178.226.38,0,0,1,56,1,56,1.107736000,0.0000
249.101.237.43,<->,54.51.14.53,1,56,0,0,1,56,1.107489000,0.0000
204.186.230.242,<->,136.25.188.255,0,0,1,56,1,56,1.107456000,0.0000
195.127.98.238,<->,136.25.188.225,0,0,1,50,1,50,1.106499000,0.0000
207.78.112.114,<->,50.224.76.234,0,0,1,50,1,50,1.106320000,0.0000
199.83.63.202,<->,136.25.188.174,0,0,1,50,1,50,1.106141000,0.0000
221.102.51.197,<->,99.74.87.243,0,0,1,56,1,56,1.106110000,0.0000
53.213.200.116,<->,48.53.37.167,0,0,1,56,1,56,1.105975000,0.0000
250.108.93.107,<->,159.137.162.213,0,0,1,50,1,50,1.105926000,0.0000
215.158.239.84,<->,194.202.251.104,1,56,0,0,1,56,1.105498000,0.0000
111.20.168.13,<->,54.37.219.162,1,50,0,0,1,50,1.105293000,0.0000
53.214.235.47,<->,48.55.115.26,0,0,1,50,1,50,1.105063000,0.0000
207.6.70.5,<->,8.182.224.248,0,0,1,56,1,56,1.104341000,0.0000
246.108.122.37,<->,80.40.11.119,0,0,1,50,1,50,1.104200000,0.0000
159.137.162.213,<->,38.90.68.83,1,50,0,0,1,50,1.103783000,0.0000
199.83.103.210,<->,136.25.188.222,0,0,1,50,1,50,1.103414000,0.0000
199.69.57.220,<->,136.25.188.252,0,0,1,50,1,50,1.103114000,0.0000
215.158.239.58,<->,196.88.77.226,1,50,0,0,1,50,1.101329000,0.0000
195.15.133.115,<->,136.25.188.46,0,0,1,56,1,56,1.101049000,0.0000
205.127.108.113,<->,33.233.141.75,0,0,1,56,1,56,1.101028000,0.0000
199.32.150.99,<->,136.25.188.176,0,0,1,50,1,50,1.100848000,0.0000
193.86.141.14,<->,109.222.254.133,0,0,1,50,1,50,1.099855000,0.0000
221.102.123.23,<->,56.112.225.140,1,50,0,0,1,50,1.099083000,0.0000
215.158.238.79,<->,139.163.161.34,1,56,0,0,1,56,1.098842000,0.0000
142.167.167.81,<->,136.25.188.242,0,0,1,56,1,56,1.098674000,0.0000
144.87.238.91,<->,8.182.244.179,0,0,1,50,1,50,1.098359000,0.0000
215.158.239.56,<->,199.20.7.188,1,56,0,0,1,56,1.098277000,0.0000
220.20.200.6,<->,53.65.17.168,1,50,0,0,1,50,1.098196000,0.0000
117.34.239.188,<->,8.31.37.163,0,0,1,50,1,50,1.097965000,0.0000
58.203.179.178,<->,8.252.221.222,0,0,1,50,1,50,1.097939000,0.0000
136.25.188.224,<->,113.23.104.246,1,56,0,0,1,56,1.097682000,0.0000
80.41.32.232,<->,38.173.151.23,1,56,0,0,1,56,1.097629000,0.0000
50.224.76.235,<->,29.95.75.90,1,56,0,0,1,56,1.097573000,0.0000
109.222.246.96,<->,33.240.41.79,1,50,0,0,1,50,1.096901000,0.0000
46.129.181.226,<->,8.52.168.141,0,0,1,50,1,50,1.096850000,0.0000
56.8.55.61,<->,8.182.226.78,0,0,1,50,1,50,1.096780000,0.0000
202.33.125.70,<->,136.25.188.252,0,0,1,56,1,56,1.096164000,0.0000
141.86.1.26,<->,133.183.157.3,0,0,1,56,1,56,1.095998000,0.0000
215.158.239.57,<->,199.20.30.163,1,56,0,0,1,56,1.095891000,0.0000
192.228.80.165,<->,133.32.39.1,0,0,1,56,1,56,1.095775000,0.0000
220.78.195.137,<->,8.52.222.23,0,0,1,50,1,50,1.095055000,0.0000
199.73.176.81,<->,136.25.188.52,0,0,1,56,1,56,1.095036000,0.0000
214.237.191.234,<->,8.43.215.120,0,0,1,56,1,56,1.095027000,0.0000
247.136.139.38,<->,100.124.212.251,1,50,0,0,1,50,1.094848000,0.0000
220.20.200.99,<->,132.216.159.4,1,718,0,0,1,718,1.094736000,0.0000
215.158.239.58,<->,196.91.209.210,1,56,0,0,1,56,1.094245000,0.0000
50.224.108.164,<->,50.54.143.245,1,50,0,0,1,50,1.092986000,0.0000
251.24.86.2,<->,8.252.222.239,0,0,1,56,1,56,1.092861000,0.0000
199.69.149.135,<->,136.25.188.177,0,0,1,50,1,50,1.092543000,0.0000
143.23.179.141,<->,136.25.188.220,0,0,1,50,1,50,1.092063000,0.0000
66.47.82.31,<->,8.252.222.46,0,0,1,56,1,56,1.092022000,0.0000
205.127.108.114,<->,111.20.168.155,0,0,1,56,1,56,1.091352000,0.0000
100.122.42.250,<->,8.182.226.78,0,0,1,50,1,50,1.090697000,0.0000
80.40.63.6,<->,22.36.147.6,1,50,0,0,1,50,1.090676000,0.0000
50.49.172.140,<->,8.220.202.151,0,0,1,56,1,56,1.090662000,0.0000
215.158.239.3,<->,129.150.75.195,1,56,0,0,1,56,1.090494000,0.0000
215.158.239.59,<->,199.20.29.237,1,56,0,0,1,56,1.090220000,0.0000
205.127.108.113,<->,101.224.89.186,0,0,1,56,1,56,1.089989000,0.0000
141.111.200.214,<->,80.38.16.211,0,0,1,50,1,50,1.089449000,0.0000
100.192.167.54,<->,8.52.189.207,0,0,1,50,1,50,1.088789000,0.0000
197.113.99.101,<->,136.25.188.222,0,0,1,56,1,56,1.088747000,0.0000
100.206.84.172,<->,92.162.253.126,0,0,1,50,1,50,1.088282000,0.0000
247.136.137.133,<->,205.239.143.251,1,50,0,0,1,50,1.088224000,0.0000
207.236.28.188,<->,136.25.188.209,0,0,1,56,1,56,1.088154000,0.0000
195.78.220.158,<->,50.224.76.235,0,0,1,50,1,50,1.086739000,0.0000
89.183.104.251,<->,67.240.73.44,1,50,0,0,1,50,1.086592000,0.0000
53.231.85.230,<->,33.233.141.39,0,0,1,50,1,50,1.086370000,0.0000
139.36.120.120,<->,136.25.189.193,0,0,1,56,1,56,1.086059000,0.0000
202.33.46.188,<->,136.25.188.236,0,0,1,56,1,56,1.085975000,0.0000
53.160.193.35,<->,48.53.186.56,0,0,1,50,1,50,1.085806000,0.0000
129.225.3.123,<->,89.183.104.188,0,0,1,56,1,56,1.085544000,0.0000
143.95.114.109,<->,136.25.188.253,0,0,1,50,1,50,1.085329000,0.0000
220.85.11.250,<->,50.224.76.234,0,0,1,50,1,50,1.084953000,0.0000
215.158.239.101,<->,129.222.36.34,1,56,0,0,1,56,1.084734000,0.0000
111.230.154.167,<->,50.224.76.235,0,0,1,56,1,56,1.084659000,0.0000
141.61.66.157,<->,80.27.155.70,0,0,1,56,1,56,1.083778000,0.0000
152.105.243.218,<->,8.252.221.197,0,0,1,50,1,50,1.083112000,0.0000
143.22.110.83,<->,8.182.226.78,0,0,1,50,1,50,1.082710000,0.0000
80.40.63.6,<->,8.45.168.98,1,50,0,0,1,50,1.082663000,0.0000
246.253.253.170,<->,139.33.174.24,1,50,0,0,1,50,1.082497000,0.0000
232.31.192.215,<->,97.198.118.56,0,0,1,56,1,56,1.082198000,0.0000
137.21.23.51,<->,8.37.203.183,1,56,0,0,1,56,1.081102000,0.0000
199.32.147.42,<->,136.25.188.45,0,0,1,50,1,50,1.080296000,0.0000
129.224.112.252,<->,97.242.126.202,1,56,0,0,1,56,1.080240000,0.0000
142.206.165.64,<->,136.25.188.236,0,0,1,56,1,56,1.079231000,0.0000
195.61.156.13,<->,8.182.250.65,0,0,1,56,1,56,1.079145000,0.0000
204.61.10.56,<->,136.25.188.252,0,0,1,56,1,56,1.079069000,0.0000
215.158.238.109,<->,145.116.209.92,1,56,0,0,1,56,1.078772000,0.0000
252.98.138.253,<->,159.57.90.68,1,50,0,0,1,50,1.078633000,0.0000
91.48.164.164,<->,8.52.163.19,0,0,1,50,1,50,1.077952000,0.0000
97.126.113.45,<->,82.195.35.44,1,50,0,0,1,50,1.077876000,0.0000
229.45.205.24,<->,220.50.226.64,1,50,0,0,1,50,1.077172000,0.0000
159.15.122.2,<->,8.52.222.220,0,0,1,50,1,50,1.076400000,0.0000
124.40.37.23,<->,80.40.11.119,0,0,1,50,1,50,1.076148000,0.0000
142.240.51.65,<->,136.25.188.222,0,0,1,56,1,56,1.075714000,0.0000
146.249.226.104,<->,8.252.222.157,0,0,1,56,1,56,1.074651000,0.0000
142.244.99.151,<->,136.25.188.198,0,0,1,56,1,56,1.074188000,0.0000
215.158.140.74,<->,83.252.34.178,1,50,0,0,1,50,1.073894000,0.0000
207.61.81.191,<->,136.25.188.254,0,0,1,50,1,50,1.073006000,0.0000
115.119.97.98,<->,50.224.89.243,0,0,1,56,1,56,1.072869000,0.0000
143.10.35.111,<->,136.25.188.160,0,0,1,50,1,50,1.072763000,0.0000
91.231.194.48,<->,8.222.6.254,1,50,0,0,1,50,1.071337000,0.0000
243.117.107.187,<->,80.38.1.52,0,0,1,50,1,50,1.070694000,0.0000
215.158.239.56,<->,143.13.81.196,1,50,0,0,1,50,1.070681000,0.0000
246.253.253.170,<->,231.255.129.230,1,50,0,0,1,50,1.070659000,0.0000
204.185.52.138,<->,136.25.188.252,0,0,1,56,1,56,1.070125000,0.0000
139.246.60.47,<->,8.250.152.93,0,0,1,56,1,56,1.069741000,0.0000
143.76.13.229,<->,136.25.188.239,0,0,1,56,1,56,1.069068000,0.0000
111.146.168.112,<->,53.213.158.211,1,56,0,0,1,56,1.068570000,0.0000
80.27.102.65,<->,8.252.222.63,0,0,1,56,1,56,1.068240000,0.0000
215.158.239.56,<->,143.20.163.42,1,50,0,0,1,50,1.068203000,0.0000
192.67.130.147,<->,8.20.81.7,1,50,0,0,1,50,1.067869000,0.0000
215.158.239.76,<->,207.115.235.64,1,56,0,0,1,56,1.067599000,0.0000
215.158.239.79,<->,143.13.81.196,1,50,0,0,1,50,1.066763000,0.0000
215.158.239.92,<->,195.83.120.106,1,56,0,0,1,56,1.065369000,0.0000
215.158.239.57,<->,143.13.81.196,1,50,0,0,1,50,1.065268000,0.0000
142.244.64.54,<->,136.25.188.222,0,0,1,56,1,56,1.065236000,0.0000
111.147.75.105,<->,53.251.227.246,1,50,0,0,1,50,1.064968000,0.0000
133.54.43.41,<->,93.208.41.137,1,50,0,0,1,50,1.064917000,0.0000
93.181.154.9,<->,89.183.104.245,0,0,1,56,1,56,1.064890000,0.0000
215.158.239.99,<->,143.13.81.196,1,50,0,0,1,50,1.064310000,0.0000
204.62.94.45,<->,136.25.188.163,0,0,1,56,1,56,1.063441000,0.0000
117.63.136.24,<->,92.27.219.21,0,0,1,50,1,50,1.063176000,0.0000
192.64.221.208,<->,38.64.18.154,1,50,0,0,1,50,1.062135000,0.0000
204.35.170.185,<->,50.224.76.230,0,0,1,56,1,56,1.061698000,0.0000
109.1.9.150,<->,93.90.207.116,1,50,0,0,1,50,1.061078000,0.0000
215.158.239.253,<->,56.97.187.116,1,56,0,0,1,56,1.061077000,0.0000
215.158.239.76,<->,204.61.75.214,1,56,0,0,1,56,1.061006000,0.0000
207.190.25.69,<->,136.25.188.237,0,0,1,50,1,50,1.060469000,0.0000
210.209.251.214,<->,137.137.124.27,0,0,1,50,1,50,1.058200000,0.0000
215.158.239.57,<->,196.106.79.216,1,56,0,0,1,56,1.057978000,0.0000
140.30.2.28,<->,66.11.238.118,0,0,1,50,1,50,1.057777000,0.0000
195.55.62.187,<->,136.25.188.243,0,0,1,56,1,56,1.057729000,0.0000
144.54.90.253,<->,8.250.148.31,0,0,1,56,1,56,1.057149000,0.0000
215.158.239.92,<->,199.20.63.99,1,56,0,0,1,56,1.056825000,0.0000
58.202.212.54,<->,50.224.76.234,0,0,1,56,1,56,1.056748000,0.0000
109.222.200.93,<->,105.233.101.111,1,56,0,0,1,56,1.056745000,0.0000
248.239.175.62,<->,133.73.194.24,1,50,0,0,1,50,1.056452000,0.0000
142.249.87.206,<->,136.25.188.252,0,0,1,56,1,56,1.056392000,0.0000
136.181.50.197,<->,106.176.67.97,1,50,0,0,1,50,1.056340000,0.0000
215.158.239.78,<->,195.55.155.189,1,56,0,0,1,56,1.056279000,0.0000
204.200.48.192,<->,136.25.188.54,0,0,1,56,1,56,1.056188000,0.0000
204.184.40.37,<->,136.25.188.174,0,0,1,56,1,56,1.056149000,0.0000
89.164.10.227,<->,50.224.76.234,0,0,1,56,1,56,1.056003000,0.0000
139.47.193.207,<->,33.233.141.1,0,0,1,50,1,50,1.055661000,0.0000
144.85.170.246,<->,98.87.145.167,1,56,0,0,1,56,1.055381000,0.0000
215.158.238.169,<->,80.47.184.252,1,56,0,0,1,56,1.055078000,0.0000
215.158.239.79,<->,199.20.4.232,1,50,0,0,1,50,1.053767000,0.0000
230.156.243.220,<->,8.252.222.158,0,0,1,50,1,50,1.053469000,0.0000
215.158.239.92,<->,195.14.225.55,1,56,0,0,1,56,1.053288000,0.0000
196.119.216.12,<->,50.223.3.228,0,0,1,56,1,56,1.052954000,0.0000
221.54.10.148,<->,92.27.194.147,0,0,1,56,1,56,1.052455000,0.0000
100.190.29.184,<->,8.220.178.203,0,0,1,50,1,50,1.052304000,0.0000
89.90.113.239,<->,82.231.227.44,0,0,1,56,1,56,1.051636000,0.0000
215.158.239.96,<->,199.20.28.226,1,56,0,0,1,56,1.051387000,0.0000
192.67.166.64,<->,56.114.235.120,1,194,0,0,1,194,1.050727000,0.0000
111.146.254.148,<->,53.245.233.186,1,109,0,0,1,109,1.050351000,0.0000
119.184.224.85,<->,109.1.24.200,0,0,1,851,1,851,1.049760000,0.0000
80.40.43.150,<->,8.209.235.29,1,56,0,0,1,56,1.049227000,0.0000
192.67.157.242,<->,103.164.150.13,1,50,0,0,1,50,1.049095000,0.0000
212.249.34.44,<->,196.148.165.183,0,0,1,562,1,562,1.048829000,0.0000
132.51.185.8,<->,8.52.222.23,0,0,1,50,1,50,1.048172000,0.0000
195.54.52.61,<->,136.25.188.163,0,0,1,56,1,56,1.047621000,0.0000
142.255.19.224,<->,136.25.188.163,0,0,1,50,1,50,1.047229000,0.0000
234.182.161.111,<->,97.126.31.73,0,0,1,50,1,50,1.047112000,0.0000
109.222.222.44,<->,91.41.25.109,1,56,0,0,1,56,1.046950000,0.0000
142.247.210.85,<->,136.25.188.225,0,0,1,56,1,56,1.046749000,0.0000
204.58.165.79,<->,136.25.188.160,0,0,1,56,1,56,1.046702000,0.0000
133.178.226.200,<->,65.26.114.236,1,56,0,0,1,56,1.046644000,0.0000
118.12.226.110,<->,50.224.76.248,0,0,1,56,1,56,1.046563000,0.0000
97.126.106.44,<->,54.52.248.208,1,50,0,0,1,50,1.046510000,0.0000
207.61.157.223,<->,136.25.188.243,0,0,1,56,1,56,1.046356000,0.0000
197.158.92.103,<->,139.163.86.75,0,0,1,56,1,56,1.045873000,0.0000
215.158.239.92,<->,143.134.247.196,1,50,0,0,1,50,1.045185000,0.0000
197.144.29.95,<->,8.20.87.182,0,0,1,56,1,56,1.044908000,0.0000
145.76.230.104,<->,33.233.141.231,0,0,1,56,1,56,1.044275000,0.0000
204.56.128.71,<->,136.25.188.175,0,0,1,56,1,56,1.044012000,0.0000
207.239.222.32,<->,136.25.188.176,0,0,1,50,1,50,1.043723000,0.0000
215.158.239.78,<->,143.134.247.196,1,50,0,0,1,50,1.043697000,0.0000
199.81.182.147,<->,136.25.188.52,0,0,1,56,1,56,1.043695000,0.0000
17.255.107.2,<->,8.220.176.253,0,0,1,56,1,56,1.043226000,0.0000
207.58.114.73,<->,136.25.188.220,0,0,1,50,1,50,1.043226000,0.0000
215.158.239.76,<->,196.91.44.119,1,56,0,0,1,56,1.043194000,0.0000
249.101.236.84,<->,53.213.100.206,1,50,0,0,1,50,1.043151000,0.0000
220.20.200.17,<->,92.27.255.126,1,50,0,0,1,50,1.042588000,0.0000
215.158.239.92,<->,195.14.19.63,1,56,0,0,1,56,1.042573000,0.0000
246.254.97.113,<->,158.19.152.114,1,56,0,0,1,56,1.042447000,0.0000
221.102.56.69,<->,80.42.218.23,0,0,1,56,1,56,1.041828000,0.0000
100.224.166.72,<->,8.52.242.68,0,0,1,56,1,56,1.041543000,0.0000
133.32.39.1,<->,14.75.233.199,1,50,0,0,1,50,1.041387000,0.0000
192.64.211.100,<->,14.30.152.105,1,56,0,0,1,56,1.041064000,0.0000
89.183.104.150,<->,33.57.78.90,1,50,0,0,1,50,1.040968000,0.0000
215.158.239.49,<->,207.236.58.178,1,50,0,0,1,50,1.040551000,0.0000
221.102.56.69,<->,109.3.152.35,0,0,1,56,1,56,1.040446000,0.0000
97.151.151.182,<->,8.52.133.228,0,0,1,50,1,50,1.040296000,0.0000
214.237.183.201,<->,0.195.210.46,0,0,1,56,1,56,1.039453000,0.0000
220.55.138.47,<->,8.182.232.138,0,0,1,56,1,56,1.039409000,0.0000
159.223.99.62,<->,8.52.188.75,0,0,1,56,1,56,1.039401000,0.0000
93.181.154.49,<->,92.27.219.217,0,0,1,50,1,50,1.039300000,0.0000
246.253.169.16,<->,97.19.22.19,1,50,0,0,1,50,1.038734000,0.0000
220.20.200.142,<->,127.255.84.41,1,50,0,0,1,50,1.038378000,0.0000
111.151.231.56,<->,8.252.221.167,0,0,1,56,1,56,1.038339000,0.0000
207.59.3.222,<->,136.25.188.252,0,0,1,56,1,56,1.038039000,0.0000
143.68.90.47,<->,136.25.188.177,0,0,1,56,1,56,1.037950000,0.0000
142.206.236.158,<->,136.25.188.222,0,0,1,50,1,50,1.037867000,0.0000
50.224.76.235,<->,0.241.13.184,1,50,0,0,1,50,1.036996000,0.0000
192.67.134.61,<->,121.31.106.231,1,50,0,0,1,50,1.036773000,0.0000
206.149.2.93,<->,8.220.176.253,0,0,1,50,1,50,1.036650000,0.0000
199.82.206.205,<->,136.25.188.176,0,0,1,56,1,56,1.036615000,0.0000
141.174.241.48,<->,80.38.16.208,0,0,1,50,1,50,1.036597000,0.0000
110.16.211.248,<->,50.224.76.235,0,0,1,50,1,50,1.036045000,0.0000
54.38.197.120,<->,48.54.248.0,0,0,1,56,1,56,1.035843000,0.0000
215.158.239.194,<->,53.176.57.216,1,56,0,0,1,56,1.035722000,0.0000
53.244.110.182,<->,48.53.107.207,0,0,1,56,1,56,1.035600000,0.0000
8.191.1.253,<->,8.43.206.150,0,0,1,56,1,56,1.035411000,0.0000
221.94.36.174,<->,50.224.76.234,0,0,1,50,1,50,1.034993000,0.0000
203.215.2.29,<->,42.204.12.30,1,56,0,0,1,56,1.034645000,0.0000
195.71.179.70,<->,136.25.188.220,0,0,1,56,1,56,1.034108000,0.0000
125.42.81.5,<->,80.41.29.200,0,0,1,684,1,684,1.034037000,0.0000
142.220.62.73,<->,136.25.188.52,0,0,1,50,1,50,1.033695000,0.0000
207.191.136.103,<->,136.25.188.46,0,0,1,56,1,56,1.033661000,0.0000
193.53.171.7,<->,80.38.7.235,0,0,1,56,1,56,1.033274000,0.0000
199.33.30.127,<->,136.25.188.255,0,0,1,56,1,56,1.032859000,0.0000
199.120.22.127,<->,136.25.188.223,0,0,1,56,1,56,1.032762000,0.0000
120.207.134.63,<->,92.27.194.233,0,0,1,50,1,50,1.032506000,0.0000
133.178.226.14,<->,96.155.60.202,1,56,0,0,1,56,1.032502000,0.0000
203.144.209.172,<->,8.20.87.144,0,0,1,50,1,50,1.031452000,0.0000
215.158.238.85,<->,8.255.1.161,1,56,0,0,1,56,1.031262000,0.0000
218.4.181.154,<->,58.43.188.11,1,50,0,0,1,50,1.031162000,0.0000
125.85.102.191,<->,8.52.189.42,0,0,1,50,1,50,1.030719000,0.0000
239.66.125.236,<->,92.27.27.178,0,0,1,50,1,50,1.030583000,0.0000
199.15.47.5,<->,136.25.188.162,0,0,1,50,1,50,1.030471000,0.0000
143.20.49.158,<->,136.25.188.220,0,0,1,50,1,50,1.030455000,0.0000
26.200.175.254,<->,8.52.189.207,0,0,1,50,1,50,1.030313000,0.0000
143.42.56.226,<->,136.25.188.45,0,0,1,50,1,50,1.030246000,0.0000
50.224.76.235,<->,30.183.186.22,1,56,0,0,1,56,1.030080000,0.0000
195.4.254.231,<->,136.25.188.53,0,0,1,56,1,56,1.029520000,0.0000
97.11.164.237,<->,53.214.115.253,1,50,0,0,1,50,1.028621000,0.0000
111.20.62.109,<->,101.70.127.229,0,0,1,50,1,50,1.027858000,0.0000
247.136.162.79,<->,26.218.95.13,1,50,0,0,1,50,1.027763000,0.0000
17.255.107.2,<->,8.220.198.188,0,0,1,56,1,56,1.027699000,0.0000
136.116.28.246,<->,89.64.114.178,1,56,0,0,1,56,1.027423000,0.0000
92.27.194.147,<->,0.37.173.190,1,56,0,0,1,56,1.027231000,0.0000
136.25.188.220,<->,8.227.55.120,1,56,0,0,1,56,1.027015000,0.0000
147.183.119.67,<->,8.252.221.236,0,0,1,56,1,56,1.026297000,0.0000
142.191.29.150,<->,136.25.188.177,0,0,1,50,1,50,1.025630000,0.0000
221.102.56.69,<->,192.65.178.170,0,0,1,56,1,56,1.025509000,0.0000
199.73.53.130,<->,136.25.188.209,0,0,1,50,1,50,1.025483000,0.0000
192.229.216.117,<->,97.151.151.182,1,50,0,0,1,50,1.025423000,0.0000
195.54.153.245,<->,136.25.188.252,0,0,1,56,1,56,1.025109000,0.0000
252.98.135.226,<->,106.5.211.6,1,56,0,0,1,56,1.024893000,0.0000
115.166.122.250,<->,101.224.89.168,0,0,1,56,1,56,1.024735000,0.0000
215.158.103.203,<->,131.74.153.132,1,50,0,0,1,50,1.024500000,0.0000
53.224.89.221,<->,8.228.219.242,0,0,1,50,1,50,1.023980000,0.0000
220.80.187.186,<->,8.45.175.127,1,50,0,0,1,50,1.023085000,0.0000
210.221.109.12,<->,54.58.106.235,1,50,0,0,1,50,1.022900000,0.0000
56.9.98.237,<->,8.182.253.209,0,0,1,50,1,50,1.021887000,0.0000
199.121.242.135,<->,136.25.188.177,0,0,1,56,1,56,1.021549000,0.0000
199.68.169.72,<->,136.25.188.178,0,0,1,50,1,50,1.021427000,0.0000
133.56.201.50,<->,8.52.189.221,0,0,1,56,1,56,1.021299000,0.0000
133.178.226.201,<->,113.23.114.107,1,56,0,0,1,56,1.020824000,0.0000
22.36.16.223,<->,8.182.224.248,0,0,1,50,1,50,1.019524000,0.0000
132.249.91.21,<->,80.41.49.163,0,0,1,50,1,50,1.018970000,0.0000
144.85.170.248,<->,98.87.144.220,1,56,0,0,1,56,1.018501000,0.0000
199.82.203.84,<->,136.25.188.241,0,0,1,56,1,56,1.017882000,0.0000
127.62.26.151,<->,92.162.253.36,0,0,1,50,1,50,1.017869000,0.0000
17.34.35.51,<->,8.220.200.124,0,0,1,50,1,50,1.017579000,0.0000
102.83.209.113,<->,8.45.162.111,1,87,0,0,1,87,1.017192000,0.0000
220.20.200.28,<->,119.159.22.233,1,50,0,0,1,50,1.016786000,0.0000
215.158.239.51,<->,199.20.31.227,1,56,0,0,1,56,1.016352000,0.0000
231.142.216.133,<->,136.25.188.237,0,0,1,56,1,56,1.016297000,0.0000
194.245.226.192,<->,8.252.222.179,0,0,1,56,1,56,1.015619000,0.0000
132.128.61.42,<->,80.41.0.92,0,0,1,50,1,50,1.014658000,0.0000
109.1.57.207,<->,8.159.21.186,1,50,0,0,1,50,1.014389000,0.0000
194.232.162.50,<->,136.25.188.178,0,0,1,56,1,56,1.013960000,0.0000
17.113.2.125,<->,8.220.176.253,0,0,1,50,1,50,1.013690000,0.0000
196.240.255.160,<->,136.25.188.45,0,0,1,56,1,56,1.013166000,0.0000
159.58.186.67,<->,8.20.87.155,0,0,1,50,1,50,1.012811000,0.0000
145.116.118.225,<->,53.181.140.67,1,56,0,0,1,56,1.012499000,0.0000
97.19.21.205,<->,8.182.252.86,0,0,1,56,1,56,1.011891000,0.0000
243.49.82.0,<->,99.72.165.242,0,0,1,56,1,56,1.011891000,0.0000
198.206.15.35,<->,8.220.176.253,0,0,1,56,1,56,1.011855000,0.0000
215.158.239.14,<->,139.161.104.53,1,56,0,0,1,56,1.010994000,0.0000
36.123.54.247,<->,8.20.87.5,0,0,1,56,1,56,1.009929000,0.0000
50.224.76.248,<->,42.34.255.152,1,56,0,0,1,56,1.009739000,0.0000
138.126.42.228,<->,50.224.76.235,0,0,1,50,1,50,1.009733000,0.0000
215.158.239.86,<->,199.20.31.30,1,56,0,0,1,56,1.009714000,0.0000
202.33.192.45,<->,136.25.188.220,0,0,1,56,1,56,1.009354000,0.0000
140.68.13.66,<->,8.252.222.29,0,0,1,56,1,56,1.009044000,0.0000
145.166.11.36,<->,8.182.250.65,0,0,1,50,1,50,1.008758000,0.0000
202.33.35.129,<->,136.25.188.52,0,0,1,56,1,56,1.008382000,0.0000
215.158.239.96,<->,195.42.60.97,1,50,0,0,1,50,1.008187000,0.0000
200.174.223.60,<->,53.148.128.124,1,56,0,0,1,56,1.008186000,0.0000
142.240.181.149,<->,136.25.188.226,0,0,1,56,1,56,1.008168000,0.0000
132.128.49.14,<->,35.56.97.244,0,0,1,50,1,50,1.007838000,0.0000
145.89.27.67,<->,8.53.119.89,1,50,0,0,1,50,1.006827000,0.0000
195.14.170.189,<->,136.25.188.53,0,0,1,56,1,56,1.006223000,0.0000
132.128.61.174,<->,6.122.200.0,0,0,1,141,1,141,1.005985000,0.0000
142.241.238.68,<->,136.25.188.55,0,0,1,56,1,56,1.005971000,0.0000
221.102.56.69,<->,192.67.74.7,0,0,1,56,1,56,1.005569000,0.0000
251.24.84.172,<->,8.252.222.46,0,0,1,56,1,56,1.005428000,0.0000
195.43.107.19,<->,136.25.188.226,0,0,1,50,1,50,1.005418000,0.0000
144.85.170.254,<->,17.90.66.204,1,56,0,0,1,56,1.005063000,0.0000
109.222.217.163,<->,82.193.202.117,1,56,0,0,1,56,1.005056000,0.0000
215.158.140.185,<->,144.252.156.92,1,50,0,0,1,50,1.004956000,0.0000
215.158.239.56,<->,199.20.31.169,1,56,0,0,1,56,1.004400000,0.0000
220.28.114.28,<->,136.25.188.248,0,0,1,56,1,56,1.003936000,0.0000
217.9.223.242,<->,89.183.104.170,0,0,1,50,1,50,1.003917000,0.0000
202.33.243.69,<->,136.25.188.252,0,0,1,56,1,56,1.003190000,0.0000
215.158.238.2,<->,144.253.55.170,1,56,0,0,1,56,1.002485000,0.0000
132.18.67.30,<->,102.83.7.112,0,0,1,50,1,50,1.002327000,0.0000
133.54.25.80,<->,130.13.251.210,1,56,0,0,1,56,1.001763000,0.0000
204.21.9.178,<->,136.25.188.46,0,0,1,50,1,50,1.001624000,0.0000
39.176.44.203,<->,8.220.187.2,0,0,1,56,1,56,1.001195000,0.0000
144.86.145.164,<->,83.96.62.35,1,50,0,0,1,50,1.000951000,0.0000
101.70.121.187,<->,54.55.110.117,1,50,0,0,1,50,1.000737000,0.0000
199.82.249.125,<->,136.25.188.253,0,0,1,50,1,50,1.000649000,0.0000
199.14.254.16,<->,136.25.188.252,0,0,1,50,1,50,1.000135000,0.0000
199.14.254.16,<->,136.25.188.52,0,0,1,50,1,50,0.999936000,0.0000
199.73.47.28,<->,136.25.188.176,0,0,1,56,1,56,0.999643000,0.0000
126.198.76.241,<->,97.198.118.56,0,0,1,56,1,56,0.999328000,0.0000
215.158.239.60,<->,98.219.126.175,1,56,0,0,1,56,0.999135000,0.0000
204.187.136.157,<->,136.25.188.173,0,0,1,56,1,56,0.999047000,0.0000
199.82.216.129,<->,136.25.188.253,0,0,1,56,1,56,0.998833000,0.0000
232.31.192.204,<->,97.198.118.56,0,0,1,56,1,56,0.997587000,0.0000
132.249.70.100,<->,91.42.195.218,1,244,0,0,1,244,0.997321000,0.0000
215.158.239.48,<->,199.20.28.7,1,56,0,0,1,56,0.996812000,0.0000
215.158.238.155,<->,8.203.131.211,1,56,0,0,1,56,0.996214000,0.0000
207.190.47.234,<->,136.25.188.225,0,0,1,56,1,56,0.996060000,0.0000
204.185.53.33,<->,136.25.188.198,0,0,1,56,1,56,0.995940000,0.0000
204.60.154.66,<->,136.25.188.198,0,0,1,56,1,56,0.995653000,0.0000
142.227.161.52,<->,136.25.188.220,0,0,1,50,1,50,0.995493000,0.0000
246.253.198.51,<->,112.9.237.77,1,50,0,0,1,50,0.995422000,0.0000
218.138.21.44,<->,8.220.179.115,0,0,1,50,1,50,0.995295000,0.0000
109.221.142.67,<->,50.224.76.235,0,0,1,50,1,50,0.994122000,0.0000
207.57.21.233,<->,136.25.188.54,0,0,1,50,1,50,0.993573000,0.0000
144.54.85.229,<->,136.25.188.226,0,0,1,56,1,56,0.993529000,0.0000
247.136.164.69,<->,8.209.235.29,1,50,0,0,1,50,0.993334000,0.0000
202.33.35.129,<->,136.25.188.174,0,0,1,56,1,56,0.993277000,0.0000
207.173.127.99,<->,136.25.188.160,0,0,1,56,1,56,0.993080000,0.0000
221.102.123.190,<->,98.131.227.91,1,56,0,0,1,56,0.992498000,0.0000
215.158.239.76,<->,207.213.91.147,1,56,0,0,1,56,0.992277000,0.0000
207.62.17.82,<->,136.25.188.177,0,0,1,56,1,56,0.992140000,0.0000
195.54.85.50,<->,136.25.188.177,0,0,1,50,1,50,0.991827000,0.0000
246.253.217.173,<->,197.33.123.67,1,50,0,0,1,50,0.991702000,0.0000
80.41.56.143,<->,8.209.235.29,1,50,0,0,1,50,0.991570000,0.0000
142.191.237.192,<->,136.25.188.255,0,0,1,56,1,56,0.990975000,0.0000
215.158.239.56,<->,142.241.242.229,1,56,0,0,1,56,0.990909000,0.0000
111.20.40.252,<->,109.222.250.37,0,0,1,50,1,50,0.990515000,0.0000
8.182.253.209,<->,6.133.234.122,1,56,0,0,1,56,0.990375000,0.0000
158.73.248.94,<->,89.183.110.72,0,0,1,1439,1,1439,0.989978000,0.0000
215.158.239.87,<->,204.1.158.85,1,50,0,0,1,50,0.989854000,0.0000
196.146.24.52,<->,97.243.220.36,1,64,0,0,1,64,0.989681000,0.0000
50.224.108.164,<->,17.94.133.141,1,50,0,0,1,50,0.987429000,0.0000
17.33.88.103,<->,8.52.139.80,0,0,1,56,1,56,0.987202000,0.0000
50.224.76.235,<->,0.159.34.250,1,56,0,0,1,56,0.987101000,0.0000
136.128.124.227,<->,8.183.24.179,0,0,1,56,1,56,0.986905000,0.0000
139.193.141.200,<->,131.160.156.25,1,56,0,0,1,56,0.986839000,0.0000
215.158.239.50,<->,199.20.6.38,1,56,0,0,1,56,0.986009000,0.0000
239.66.104.94,<->,97.198.118.56,0,0,1,56,1,56,0.985260000,0.0000
69.243.104.90,<->,8.252.221.198,0,0,1,56,1,56,0.984641000,0.0000
75.31.153.171,<->,8.252.221.222,0,0,1,50,1,50,0.983529000,0.0000
199.68.64.226,<->,136.25.188.255,0,0,1,56,1,56,0.983299000,0.0000
195.126.184.184,<->,136.25.188.197,0,0,1,56,1,56,0.983265000,0.0000
199.27.21.253,<->,8.220.189.63,0,0,1,50,1,50,0.982593000,0.0000
109.222.230.147,<->,14.71.93.20,1,56,0,0,1,56,0.982247000,0.0000
139.47.194.179,<->,100.92.48.176,0,0,1,391,1,391,0.981275000,0.0000
199.39.238.203,<->,136.25.188.178,0,0,1,56,1,56,0.980970000,0.0000
243.49.81.42,<->,213.38.145.249,0,0,1,256,1,256,0.980891000,0.0000
213.186.61.91,<->,80.38.5.0,0,0,1,50,1,50,0.980649000,0.0000
109.222.198.150,<->,56.114.235.120,1,507,0,0,1,507,0.979859000,0.0000
133.178.226.198,<->,125.84.55.74,1,56,0,0,1,56,0.979538000,0.0000
144.78.84.179,<->,144.70.14.37,0,0,1,50,1,50,0.978634000,0.0000
210.218.99.216,<->,56.120.235.2,1,595,0,0,1,595,0.978343000,0.0000
215.158.239.93,<->,204.226.46.90,1,56,0,0,1,56,0.978065000,0.0000
195.68.58.205,<->,136.25.188.46,0,0,1,56,1,56,0.978034000,0.0000
144.85.170.208,<->,91.69.185.186,1,56,0,0,1,56,0.977654000,0.0000
101.67.174.17,<->,8.52.186.156,0,0,1,50,1,50,0.977502000,0.0000
215.158.238.101,<->,145.116.209.82,1,56,0,0,1,56,0.976246000,0.0000
50.224.76.235,<->,6.73.186.38,1,50,0,0,1,50,0.976035000,0.0000
111.151.239.49,<->,97.183.193.182,0,0,1,50,1,50,0.975103000,0.0000
54.39.227.121,<->,48.52.89.17,0,0,1,50,1,50,0.975040000,0.0000
192.65.173.125,<->,8.55.220.143,1,50,0,0,1,50,0.973903000,0.0000
204.153.206.219,<->,8.182.235.164,0,0,1,50,1,50,0.973840000,0.0000
232.31.43.146,<->,97.198.118.56,0,0,1,56,1,56,0.973676000,0.0000
100.224.23.128,<->,89.183.104.181,0,0,1,56,1,56,0.973568000,0.0000
143.29.161.66,<->,50.224.76.230,0,0,1,50,1,50,0.973175000,0.0000
111.151.239.15,<->,97.183.193.182,0,0,1,50,1,50,0.972975000,0.0000
215.158.239.56,<->,207.191.82.117,1,56,0,0,1,56,0.972810000,0.0000
142.254.255.65,<->,136.25.188.198,0,0,1,50,1,50,0.972061000,0.0000
145.161.90.199,<->,8.252.222.149,0,0,1,56,1,56,0.971070000,0.0000
204.61.36.1,<->,136.25.188.220,0,0,1,56,1,56,0.970586000,0.0000
199.82.220.187,<->,136.25.188.242,0,0,1,56,1,56,0.970579000,0.0000
158.5.93.145,<->,50.224.76.234,0,0,1,50,1,50,0.969971000,0.0000
144.85.170.245,<->,91.69.181.133,1,56,0,0,1,56,0.969872000,0.0000
215.158.239.86,<->,195.40.124.55,1,56,0,0,1,56,0.969756000,0.0000
113.179.35.228,<->,92.27.27.174,0,0,1,56,1,56,0.969311000,0.0000
144.72.195.98,<->,100.95.171.81,0,0,1,50,1,50,0.968740000,0.0000
142.255.231.173,<->,136.25.188.255,0,0,1,50,1,50,0.968486000,0.0000
92.27.219.159,<->,54.38.18.155,1,50,0,0,1,50,0.968392000,0.0000
202.178.8.212,<->,97.127.83.152,0,0,1,50,1,50,0.967603000,0.0000
195.4.91.153,<->,136.25.188.222,0,0,1,56,1,56,0.967245000,0.0000
215.158.140.240,<->,113.93.9.90,1,56,0,0,1,56,0.967135000,0.0000
215.171.65.110,<->,133.32.39.44,0,0,1,50,1,50,0.966887000,0.0000
204.61.129.216,<->,136.25.188.162,0,0,1,50,1,50,0.966582000,0.0000
215.158.239.50,<->,196.104.175.12,1,56,0,0,1,56,0.966406000,0.0000
133.178.226.20,<->,0.195.237.14,1,56,0,0,1,56,0.966161000,0.0000
136.25.188.46,<->,41.129.26.187,1,50,0,0,1,50,0.966105000,0.0000
249.101.194.239,<->,112.208.20.255,1,50,0,0,1,50,0.966101000,0.0000
116.234.157.117,<->,50.224.76.234,0,0,1,56,1,56,0.966002000,0.0000
232.31.192.207,<->,97.198.118.56,0,0,1,56,1,56,0.965851000,0.0000
8.52.189.169,<->,6.15.207.94,1,56,0,0,1,56,0.965796000,0.0000
213.186.52.50,<->,144.85.170.254,0,0,1,56,1,56,0.965795000,0.0000
233.145.158.169,<->,80.40.57.143,0,0,1,50,1,50,0.965700000,0.0000
132.213.244.180,<->,8.53.7.199,0,0,1,56,1,56,0.965590000,0.0000
195.14.186.121,<->,136.25.188.177,0,0,1,50,1,50,0.964869000,0.0000
195.40.157.134,<->,136.25.188.54,0,0,1,56,1,56,0.963465000,0.0000
89.183.104.226,<->,33.57.78.122,1,50,0,0,1,50,0.962253000,0.0000
148.155.131.56,<->,89.183.104.250,0,0,1,79,1,79,0.961923000,0.0000
195.4.117.168,<->,136.25.188.175,0,0,1,50,1,50,0.960627000,0.0000
207.200.195.90,<->,8.252.222.220,0,0,1,56,1,56,0.959452000,0.0000
215.158.140.27,<->,59.158.134.20,1,56,0,0,1,56,0.959409000,0.0000
142.228.71.173,<->,136.25.188.198,0,0,1,50,1,50,0.959408000,0.0000
215.158.239.101,<->,129.222.36.132,1,56,0,0,1,56,0.958231000,0.0000
142.255.231.173,<->,136.25.188.237,0,0,1,50,1,50,0.958045000,0.0000
248.239.64.14,<->,8.55.216.92,1,56,0,0,1,56,0.958037000,0.0000
215.158.239.97,<->,199.20.30.178,1,56,0,0,1,56,0.957793000,0.0000
98.212.218.241,<->,50.224.76.248,0,0,1,56,1,56,0.957635000,0.0000
137.21.23.51,<->,8.204.75.19,1,56,0,0,1,56,0.955687000,0.0000
89.216.124.92,<->,54.50.145.179,1,50,0,0,1,50,0.955641000,0.0000
198.71.42.62,<->,159.137.201.71,0,0,1,50,1,50,0.955580000,0.0000
133.73.198.233,<->,8.52.250.106,0,0,1,56,1,56,0.954824000,0.0000
141.182.241.55,<->,8.252.221.198,0,0,1,56,1,56,0.954734000,0.0000
195.55.150.21,<->,136.25.188.176,0,0,1,56,1,56,0.954612000,0.0000
142.207.145.245,<->,136.25.188.54,0,0,1,56,1,56,0.954129000,0.0000
80.53.19.114,<->,8.52.185.0,0,0,1,56,1,56,0.954066000,0.0000
215.158.238.76,<->,139.163.161.50,1,56,0,0,1,56,0.954062000,0.0000
145.252.126.18,<->,113.123.103.236,1,50,0,0,1,50,0.953533000,0.0000
207.191.203.53,<->,136.25.188.46,0,0,1,56,1,56,0.953198000,0.0000
142.191.20.120,<->,136.25.188.163,0,0,1,56,1,56,0.953146000,0.0000
199.73.206.67,<->,136.25.188.254,0,0,1,56,1,56,0.952788000,0.0000
221.102.56.69,<->,6.74.93.51,0,0,1,56,1,56,0.952738000,0.0000
199.69.15.64,<->,136.25.188.174,0,0,1,56,1,56,0.952555000,0.0000
204.2.117.32,<->,136.25.188.55,0,0,1,56,1,56,0.952067000,0.0000
109.1.45.170,<->,56.114.235.120,1,559,0,0,1,559,0.951704000,0.0000
97.85.150.178,<->,8.52.173.15,0,0,1,50,1,50,0.951668000,0.0000
215.158.238.146,<->,139.163.161.62,1,56,0,0,1,56,0.951302000,0.0000
207.162.131.21,<->,8.182.241.177,0,0,1,56,1,56,0.951127000,0.0000
139.163.96.101,<->,135.81.38.138,1,56,0,0,1,56,0.950847000,0.0000
215.158.239.79,<->,196.92.199.220,1,56,0,0,1,56,0.950486000,0.0000
53.245.127.102,<->,48.52.155.79,0,0,1,50,1,50,0.950471000,0.0000
213.186.52.88,<->,144.71.46.221,0,0,1,56,1,56,0.950415000,0.0000
99.183.200.170,<->,8.43.219.233,0,0,1,50,1,50,0.949664000,0.0000
255.15.224.164,<->,215.158.140.27,0,0,1,56,1,56,0.949337000,0.0000
109.127.101.16,<->,99.73.230.108,0,0,1,557,1,557,0.949250000,0.0000
195.55.54.192,<->,136.25.188.241,0,0,1,50,1,50,0.948929000,0.0000
220.20.200.143,<->,133.199.160.225,1,50,0,0,1,50,0.948803000,0.0000
215.158.239.94,<->,199.20.23.73,1,56,0,0,1,56,0.948668000,0.0000
195.41.208.112,<->,136.25.188.226,0,0,1,56,1,56,0.947788000,0.0000
142.182.19.240,<->,50.224.76.230,0,0,1,50,1,50,0.947667000,0.0000
134.240.212.232,<->,50.224.76.234,0,0,1,56,1,56,0.946950000,0.0000
133.178.226.90,<->,96.155.60.194,1,56,0,0,1,56,0.946784000,0.0000
129.224.112.252,<->,97.242.126.182,1,56,0,0,1,56,0.946687000,0.0000
192.67.134.61,<->,133.225.140.219,1,50,0,0,1,50,0.946179000,0.0000
80.40.109.15,<->,8.55.211.213,1,56,0,0,1,56,0.945560000,0.0000
207.61.42.201,<->,136.25.188.176,0,0,1,56,1,56,0.945245000,0.0000
27.9.50.162,<->,0.195.210.42,0,0,1,50,1,50,0.944467000,0.0000
139.33.174.20,<->,111.147.83.196,0,0,1,50,1,50,0.944090000,0.0000
207.51.134.215,<->,8.220.178.73,0,0,1,50,1,50,0.943898000,0.0000
215.158.209.250,<->,80.27.157.207,0,0,1,56,1,56,0.943236000,0.0000
144.92.40.106,<->,132.18.67.29,1,50,0,0,1,50,0.942910000,0.0000
215.158.239.93,<->,199.20.29.75,1,56,0,0,1,56,0.942417000,0.0000
143.68.135.57,<->,136.25.188.255,0,0,1,50,1,50,0.942281000,0.0000
139.33.174.21,<->,111.147.83.196,0,0,1,50,1,50,0.941728000,0.0000
129.224.112.252,<->,97.242.126.194,1,56,0,0,1,56,0.941450000,0.0000
207.190.228.76,<->,136.25.188.174,0,0,1,50,1,50,0.940206000,0.0000
133.178.227.247,<->,99.74.26.149,1,56,0,0,1,56,0.939944000,0.0000
143.42.218.33,<->,136.25.188.253,0,0,1,50,1,50,0.939692000,0.0000
215.158.239.34,<->,96.135.154.130,1,56,0,0,1,56,0.939626000,0.0000
192.67.176.62,<->,26.218.94.114,1,56,0,0,1,56,0.939410000,0.0000
136.25.188.209,<->,8.227.55.209,1,56,0,0,1,56,0.937688000,0.0000
215.158.140.27,<->,201.47.124.151,1,56,0,0,1,56,0.937629000,0.0000
220.20.200.143,<->,144.83.60.138,1,50,0,0,1,50,0.937339000,0.0000
102.59.37.17,<->,8.53.3.213,0,0,1,50,1,50,0.937280000,0.0000
204.1.252.23,<->,136.25.188.55,0,0,1,56,1,56,0.936932000,0.0000
101.112.197.61,<->,64.162.251.79,1,50,0,0,1,50,0.936123000,0.0000
215.158.238.155,<->,8.203.131.210,1,56,0,0,1,56,0.935955000,0.0000
82.231.227.39,<->,8.55.221.134,1,50,0,0,1,50,0.935789000,0.0000
136.25.189.94,<->,89.90.95.212,1,56,0,0,1,56,0.935750000,0.0000
99.72.115.232,<->,8.55.211.213,1,56,0,0,1,56,0.935620000,0.0000
204.184.134.252,<->,136.25.188.53,0,0,1,56,1,56,0.935367000,0.0000
159.23.227.242,<->,125.156.219.10,1,56,0,0,1,56,0.934961000,0.0000
136.25.188.198,<->,8.227.55.58,1,56,0,0,1,56,0.934780000,0.0000
246.253.253.99,<->,100.123.122.202,1,56,0,0,1,56,0.934701000,0.0000
136.25.188.178,<->,59.158.77.214,1,56,0,0,1,56,0.934173000,0.0000
231.143.10.120,<->,136.25.188.253,0,0,1,56,1,56,0.933096000,0.0000
8.222.6.41,<->,8.52.132.227,0,0,1,56,1,56,0.932125000,0.0000
215.158.209.250,<->,80.27.152.110,0,0,1,56,1,56,0.931572000,0.0000
246.253.168.231,<->,119.119.168.190,1,50,0,0,1,50,0.930807000,0.0000
215.158.238.100,<->,8.240.148.59,1,56,0,0,1,56,0.930794000,0.0000
50.224.76.230,<->,33.251.112.218,1,50,0,0,1,50,0.930578000,0.0000
142.249.56.74,<->,136.25.188.222,0,0,1,50,1,50,0.930343000,0.0000
142.240.226.24,<->,136.25.188.163,0,0,1,50,1,50,0.930010000,0.0000
142.207.19.147,<->,136.25.188.252,0,0,1,56,1,56,0.929960000,0.0000
109.214.186.222,<->,50.224.76.248,0,0,1,56,1,56,0.929479000,0.0000
215.158.239.70,<->,207.16.32.235,1,93,0,0,1,93,0.929415000,0.0000
97.175.121.18,<->,8.20.87.86,0,0,1,56,1,56,0.928441000,0.0000
195.70.94.211,<->,50.224.76.234,0,0,1,50,1,50,0.928331000,0.0000
199.73.133.114,<->,136.25.188.252,0,0,1,50,1,50,0.928284000,0.0000
129.225.135.203,<->,129.225.132.224,0,0,1,50,1,50,0.927840000,0.0000
215.158.238.82,<->,106.188.252.178,1,56,0,0,1,56,0.927709000,0.0000
220.28.104.193,<->,215.158.238.84,0,0,1,56,1,56,0.926848000,0.0000
215.158.239.113,<->,129.222.39.214,1,56,0,0,1,56,0.926504000,0.0000
131.191.242.144,<->,50.224.76.235,0,0,1,50,1,50,0.925842000,0.0000
215.158.209.250,<->,80.27.154.164,0,0,1,56,1,56,0.925751000,0.0000
136.25.188.253,<->,41.143.205.110,1,50,0,0,1,50,0.925184000,0.0000
145.176.8.235,<->,6.74.197.79,0,0,1,56,1,56,0.924917000,0.0000
112.38.205.206,<->,92.168.217.253,0,0,1,56,1,56,0.924554000,0.0000
224.148.1.28,<->,210.231.140.55,1,50,0,0,1,50,0.924545000,0.0000
142.207.110.80,<->,136.25.188.239,0,0,1,50,1,50,0.924364000,0.0000
54.39.91.119,<->,48.53.63.228,0,0,1,50,1,50,0.924362000,0.0000
215.158.239.69,<->,142.240.149.67,1,50,0,0,1,50,0.924161000,0.0000
231.142.234.72,<->,136.25.188.177,0,0,1,56,1,56,0.923643000,0.0000
143.129.188.152,<->,136.25.188.177,0,0,1,56,1,56,0.923561000,0.0000
199.15.32.198,<->,136.25.188.226,0,0,1,50,1,50,0.923399000,0.0000
56.8.148.82,<->,8.182.239.2,0,0,1,50,1,50,0.922382000,0.0000
136.25.188.254,<->,8.227.55.190,1,56,0,0,1,56,0.922034000,0.0000
195.55.62.182,<->,136.25.188.242,0,0,1,50,1,50,0.921310000,0.0000
136.25.188.239,<->,8.227.55.207,1,56,0,0,1,56,0.920809000,0.0000
213.186.61.53,<->,144.85.170.254,0,0,1,56,1,56,0.920664000,0.0000
199.121.6.22,<->,136.25.188.253,0,0,1,56,1,56,0.920530000,0.0000
215.158.238.51,<->,129.222.36.33,1,56,0,0,1,56,0.918995000,0.0000
207.101.163.204,<->,8.182.224.248,0,0,1,56,1,56,0.917942000,0.0000
195.5.199.239,<->,136.25.188.252,0,0,1,50,1,50,0.917896000,0.0000
195.41.102.103,<->,136.25.188.242,0,0,1,50,1,50,0.917144000,0.0000
143.44.10.143,<->,136.25.188.52,0,0,1,50,1,50,0.917090000,0.0000
142.248.105.238,<->,136.25.188.252,0,0,1,50,1,50,0.916468000,0.0000
204.200.59.77,<->,136.25.188.253,0,0,1,132,1,132,0.916123000,0.0000
142.236.26.46,<->,136.25.188.197,0,0,1,56,1,56,0.915930000,0.0000
17.245.1.120,<->,8.220.239.104,0,0,1,50,1,50,0.915561000,0.0000
100.216.218.106,<->,8.52.222.23,0,0,1,50,1,50,0.914992000,0.0000
215.158.239.69,<->,199.106.231.197,1,56,0,0,1,56,0.914640000,0.0000
143.89.244.135,<->,136.25.188.209,0,0,1,56,1,56,0.914629000,0.0000
136.25.188.242,<->,8.227.55.221,1,56,0,0,1,56,0.913787000,0.0000
194.253.240.189,<->,50.223.3.228,0,0,1,56,1,56,0.913685000,0.0000
72.157.195.82,<->,0.195.210.42,0,0,1,50,1,50,0.912767000,0.0000
223.120.101.156,<->,8.252.222.162,0,0,1,56,1,56,0.912159000,0.0000
199.12.122.204,<->,8.252.222.162,0,0,1,56,1,56,0.912016000,0.0000
156.150.35.85,<->,8.252.222.60,0,0,1,56,1,56,0.911998000,0.0000
100.161.107.233,<->,100.93.168.223,0,0,1,50,1,50,0.911486000,0.0000
204.2.5.87,<->,136.25.188.176,0,0,1,50,1,50,0.911274000,0.0000
249.101.84.132,<->,53.231.92.29,1,50,0,0,1,50,0.910405000,0.0000
142.182.77.110,<->,136.25.188.178,0,0,1,50,1,50,0.910302000,0.0000
194.195.200.120,<->,50.224.76.230,0,0,1,56,1,56,0.909970000,0.0000
204.184.88.31,<->,136.25.188.220,0,0,1,56,1,56,0.909745000,0.0000
17.6.58.27,<->,8.220.189.63,0,0,1,50,1,50,0.909311000,0.0000
199.71.115.136,<->,136.25.188.243,0,0,1,50,1,50,0.908860000,0.0000
246.253.212.143,<->,207.177.131.98,1,50,0,0,1,50,0.907954000,0.0000
101.224.182.5,<->,8.252.222.215,0,0,1,152,1,152,0.906929000,0.0000
137.21.22.142,<->,58.43.188.11,1,50,0,0,1,50,0.906519000,0.0000
204.200.58.95,<->,136.25.188.53,0,0,1,56,1,56,0.905878000,0.0000
133.178.227.151,<->,56.1.237.247,1,50,0,0,1,50,0.905819000,0.0000
66.241.176.131,<->,0.195.210.42,0,0,1,50,1,50,0.905631000,0.0000
215.158.239.84,<->,142.241.4.24,1,50,0,0,1,50,0.904576000,0.0000
142.241.62.232,<->,136.25.188.196,0,0,1,50,1,50,0.904130000,0.0000
207.60.99.227,<->,136.25.188.254,0,0,1,50,1,50,0.903647000,0.0000
215.158.238.124,<->,145.116.209.82,1,56,0,0,1,56,0.903619000,0.0000
207.172.146.233,<->,136.25.188.163,0,0,1,56,1,56,0.903524000,0.0000
145.116.118.68,<->,66.13.81.240,1,50,0,0,1,50,0.903223000,0.0000
200.10.139.22,<->,8.252.221.196,0,0,1,56,1,56,0.902667000,0.0000
215.158.239.79,<->,142.221.177.85,1,56,0,0,1,56,0.902555000,0.0000
195.55.79.254,<->,136.25.188.241,0,0,1,50,1,50,0.902425000,0.0000
229.45.129.61,<->,129.19.188.26,1,56,0,0,1,56,0.902297000,0.0000
199.80.208.98,<->,136.25.188.162,0,0,1,50,1,50,0.902268000,0.0000
206.199.123.151,<->,139.163.5.140,0,0,1,349,1,349,0.901982000,0.0000
231.140.129.63,<->,136.25.188.175,0,0,1,56,1,56,0.901078000,0.0000
17.198.121.6,<->,8.220.186.114,0,0,1,56,1,56,0.900969000,0.0000
145.192.174.193,<->,8.52.222.23,0,0,1,50,1,50,0.899701000,0.0000
17.68.77.212,<->,8.220.188.50,0,0,1,50,1,50,0.899097000,0.0000
143.72.73.116,<->,136.25.188.52,0,0,1,56,1,56,0.898617000,0.0000
232.31.149.177,<->,132.249.70.169,0,0,1,56,1,56,0.898569000,0.0000
199.38.75.183,<->,136.25.188.236,0,0,1,50,1,50,0.898560000,0.0000
159.70.47.29,<->,144.86.146.31,0,0,1,50,1,50,0.897468000,0.0000
220.28.85.14,<->,215.158.239.55,0,0,1,56,1,56,0.897315000,0.0000
200.174.99.189,<->,53.160.81.233,1,56,0,0,1,56,0.896730000,0.0000
215.158.140.27,<->,57.9.192.236,1,56,0,0,1,56,0.896461000,0.0000
207.236.238.63,<->,136.25.188.239,0,0,1,56,1,56,0.896455000,0.0000
97.182.5.191,<->,8.53.4.211,0,0,1,56,1,56,0.895991000,0.0000
222.110.172.72,<->,215.158.140.87,0,0,1,50,1,50,0.895845000,0.0000
144.72.193.220,<->,100.92.137.57,0,0,1,201,1,201,0.895452000,0.0000
136.25.188.229,<->,80.57.141.173,1,56,0,0,1,56,0.895430000,0.0000
112.208.20.81,<->,99.72.196.59,0,0,1,50,1,50,0.895430000,0.0000
61.125.123.245,<->,8.252.221.198,0,0,1,50,1,50,0.895118000,0.0000
215.158.239.84,<->,199.20.29.219,1,56,0,0,1,56,0.894903000,0.0000
215.158.238.33,<->,113.23.104.213,1,56,0,0,1,56,0.894544000,0.0000
215.158.239.50,<->,207.59.29.37,1,56,0,0,1,56,0.893681000,0.0000
199.14.43.119,<->,136.25.188.55,0,0,1,50,1,50,0.893560000,0.0000
207.60.250.4,<->,136.25.188.54,0,0,1,50,1,50,0.893463000,0.0000
215.158.239.85,<->,194.199.215.226,1,56,0,0,1,56,0.893338000,0.0000
195.14.248.228,<->,136.25.188.44,0,0,1,56,1,56,0.892712000,0.0000
89.152.249.100,<->,8.182.239.159,0,0,1,56,1,56,0.892599000,0.0000
215.158.239.78,<->,199.20.30.22,1,50,0,0,1,50,0.891541000,0.0000
221.102.154.17,<->,192.64.236.238,0,0,1,141,1,141,0.891117000,0.0000
215.158.239.57,<->,199.20.29.60,1,56,0,0,1,56,0.890525000,0.0000
231.143.10.120,<->,136.25.188.241,0,0,1,56,1,56,0.890344000,0.0000
207.60.128.121,<->,136.25.188.55,0,0,1,50,1,50,0.889503000,0.0000
53.201.200.21,<->,48.55.88.154,0,0,1,56,1,56,0.889023000,0.0000
202.33.33.176,<->,136.25.188.240,0,0,1,56,1,56,0.888906000,0.0000
207.236.200.87,<->,136.25.188.176,0,0,1,56,1,56,0.888294000,0.0000
215.158.239.84,<->,199.20.31.92,1,56,0,0,1,56,0.888273000,0.0000
100.200.205.57,<->,8.182.239.159,0,0,1,56,1,56,0.888229000,0.0000
127.255.90.90,<->,92.162.253.30,0,0,1,50,1,50,0.887158000,0.0000
221.101.9.15,<->,144.87.238.89,1,50,0,0,1,50,0.887097000,0.0000
199.120.158.118,<->,136.25.188.45,0,0,1,56,1,56,0.887040000,0.0000
143.134.50.181,<->,136.25.188.252,0,0,1,50,1,50,0.886137000,0.0000
142.182.77.110,<->,136.25.188.54,0,0,1,50,1,50,0.885818000,0.0000
207.60.250.4,<->,136.25.188.253,0,0,1,50,1,50,0.885288000,0.0000
100.95.240.201,<->,27.12.1.152,1,50,0,0,1,50,0.885086000,0.0000
141.20.135.250,<->,97.126.104.141,0,0,1,50,1,50,0.885077000,0.0000
98.158.149.215,<->,50.224.76.248,0,0,1,50,1,50,0.884723000,0.0000
133.54.16.199,<->,117.130.2.181,1,50,0,0,1,50,0.884672000,0.0000
195.41.105.248,<->,136.25.188.163,0,0,1,50,1,50,0.884554000,0.0000
111.147.75.52,<->,50.145.12.104,1,50,0,0,1,50,0.884336000,0.0000
100.190.29.184,<->,8.220.198.246,0,0,1,50,1,50,0.884043000,0.0000
142.249.90.133,<->,136.25.188.210,0,0,1,56,1,56,0.883792000,0.0000
193.64.94.36,<->,80.42.160.38,0,0,1,50,1,50,0.883336000,0.0000
213.186.52.92,<->,144.85.170.254,0,0,1,56,1,56,0.883291000,0.0000
197.81.94.173,<->,136.25.188.226,0,0,1,56,1,56,0.883288000,0.0000
133.178.226.227,<->,8.47.189.8,1,56,0,0,1,56,0.883030000,0.0000
215.158.238.51,<->,129.222.36.49,1,56,0,0,1,56,0.883019000,0.0000
215.158.239.76,<->,143.13.147.47,1,50,0,0,1,50,0.882836000,0.0000
132.18.67.31,<->,100.93.216.39,0,0,1,56,1,56,0.882735000,0.0000
215.158.239.97,<->,199.20.28.166,1,56,0,0,1,56,0.882649000,0.0000
215.158.238.66,<->,198.204.76.255,1,56,0,0,1,56,0.882412000,0.0000
199.68.45.42,<->,136.25.188.222,0,0,1,50,1,50,0.881914000,0.0000
221.102.56.69,<->,6.74.255.56,0,0,1,56,1,56,0.881247000,0.0000
132.214.63.61,<->,58.43.188.13,1,50,0,0,1,50,0.880516000,0.0000
195.4.114.173,<->,136.25.188.253,0,0,1,56,1,56,0.879847000,0.0000
242.6.91.85,<->,136.25.189.34,0,0,1,56,1,56,0.878846000,0.0000
109.222.209.65,<->,66.241.199.76,1,50,0,0,1,50,0.878396000,0.0000
143.134.36.86,<->,136.25.188.237,0,0,1,56,1,56,0.878224000,0.0000
194.232.1.138,<->,136.25.188.176,0,0,1,50,1,50,0.877156000,0.0000
194.210.64.211,<->,8.182.224.87,0,0,1,50,1,50,0.877124000,0.0000
207.62.165.29,<->,136.25.188.175,0,0,1,50,1,50,0.876773000,0.0000
233.97.211.191,<->,100.93.191.61,0,0,1,50,1,50,0.876535000,0.0000
194.210.66.160,<->,8.182.241.177,0,0,1,50,1,50,0.876205000,0.0000
210.209.251.211,<->,111.147.85.3,0,0,1,50,1,50,0.875839000,0.0000
111.151.237.34,<->,97.183.199.229,0,0,1,50,1,50,0.875688000,0.0000
215.158.239.94,<->,143.20.210.71,1,50,0,0,1,50,0.874987000,0.0000
8.252.213.192,<->,8.250.155.12,0,0,1,56,1,56,0.874945000,0.0000
192.67.227.187,<->,8.52.178.109,0,0,1,50,1,50,0.874478000,0.0000
195.71.91.148,<->,136.25.188.209,0,0,1,50,1,50,0.874240000,0.0000
195.43.4.73,<->,136.25.188.226,0,0,1,56,1,56,0.873906000,0.0000
144.85.170.208,<->,98.87.124.2,1,56,0,0,1,56,0.873574000,0.0000
221.102.56.69,<->,98.128.50.78,0,0,1,56,1,56,0.873284000,0.0000
136.25.188.239,<->,8.227.55.87,1,56,0,0,1,56,0.872567000,0.0000
142.241.27.40,<->,136.25.188.178,0,0,1,50,1,50,0.872270000,0.0000
144.85.170.254,<->,139.128.103.160,1,56,0,0,1,56,0.871652000,0.0000
210.231.140.55,<->,109.1.30.25,0,0,1,50,1,50,0.870588000,0.0000
140.8.232.203,<->,0.195.210.42,0,0,1,56,1,56,0.870529000,0.0000
215.158.239.56,<->,199.20.28.255,1,56,0,0,1,56,0.869788000,0.0000
207.173.170.28,<->,136.25.188.254,0,0,1,56,1,56,0.869134000,0.0000
36.123.55.193,<->,8.20.87.7,0,0,1,87,1,87,0.869127000,0.0000
199.52.130.58,<->,136.25.188.176,0,0,1,56,1,56,0.868866000,0.0000
215.158.239.86,<->,199.20.28.255,1,56,0,0,1,56,0.868401000,0.0000
192.67.172.34,<->,100.124.212.246,1,50,0,0,1,50,0.868139000,0.0000
231.142.35.166,<->,136.25.188.255,0,0,1,56,1,56,0.867485000,0.0000
98.67.140.71,<->,91.42.246.36,1,56,0,0,1,56,0.867015000,0.0000
215.158.239.50,<->,199.20.28.255,1,56,0,0,1,56,0.866452000,0.0000
220.55.88.152,<->,106.4.62.248,1,50,0,0,1,50,0.865432000,0.0000
207.162.188.43,<->,8.182.226.78,0,0,1,56,1,56,0.865337000,0.0000
215.158.239.94,<->,207.191.250.159,1,50,0,0,1,50,0.865299000,0.0000
122.96.128.51,<->,80.40.11.172,0,0,1,50,1,50,0.864751000,0.0000
215.158.238.205,<->,122.159.115.147,1,56,0,0,1,56,0.864724000,0.0000
238.110.17.82,<->,50.224.76.235,0,0,1,56,1,56,0.864693000,0.0000
109.1.37.147,<->,105.201.228.55,1,56,0,0,1,56,0.864564000,0.0000
146.193.47.81,<->,8.252.221.197,0,0,1,56,1,56,0.864291000,0.0000
17.121.0.251,<->,8.220.234.165,0,0,1,50,1,50,0.863257000,0.0000
199.72.100.251,<->,136.25.188.241,0,0,1,87,1,87,0.863152000,0.0000
204.17.28.74,<->,50.224.76.230,0,0,1,50,1,50,0.862355000,0.0000
142.248.11.247,<->,136.25.188.55,0,0,1,50,1,50,0.861369000,0.0000
98.67.140.71,<->,53.240.86.156,1,56,0,0,1,56,0.861024000,0.0000
199.33.64.236,<->,136.25.188.238,0,0,1,56,1,56,0.860834000,0.0000
215.158.239.78,<->,194.199.207.228,1,56,0,0,1,56,0.860779000,0.0000
95.244.98.18,<->,8.252.222.134,0,0,1,56,1,56,0.860438000,0.0000
215.158.239.97,<->,196.89.34.232,1,56,0,0,1,56,0.860233000,0.0000
204.62.41.84,<->,136.25.188.196,0,0,1,56,1,56,0.859958000,0.0000
204.184.96.13,<->,136.25.188.178,0,0,1,93,1,93,0.859643000,0.0000
136.114.101.11,<->,136.25.188.202,0,0,1,56,1,56,0.859328000,0.0000
215.158.140.13,<->,192.170.84.43,1,56,0,0,1,56,0.858869000,0.0000
215.158.239.48,<->,199.20.31.118,1,56,0,0,1,56,0.858420000,0.0000
215.158.140.27,<->,144.65.45.181,1,56,0,0,1,56,0.858252000,0.0000
197.113.99.197,<->,136.25.188.242,0,0,1,132,1,132,0.857703000,0.0000
220.20.200.37,<->,144.83.60.153,1,50,0,0,1,50,0.857427000,0.0000
212.153.120.119,<->,136.25.188.252,0,0,1,50,1,50,0.856668000,0.0000
145.76.231.17,<->,111.20.168.180,0,0,1,718,1,718,0.856583000,0.0000
215.158.239.49,<->,195.4.5.226,1,50,0,0,1,50,0.856527000,0.0000
207.190.29.70,<->,136.25.188.225,0,0,1,50,1,50,0.856267000,0.0000
215.158.30.219,<->,8.252.222.42,0,0,1,56,1,56,0.856003000,0.0000
100.228.42.147,<->,100.168.37.238,1,56,0,0,1,56,0.855588000,0.0000
204.185.182.150,<->,136.25.188.174,0,0,1,56,1,56,0.855251000,0.0000
200.175.141.134,<->,54.59.66.233,1,50,0,0,1,50,0.854382000,0.0000
215.158.239.96,<->,142.248.94.208,1,50,0,0,1,50,0.853422000,0.0000
142.191.20.120,<->,136.25.188.227,0,0,1,56,1,56,0.853125000,0.0000
159.194.180.52,<->,139.193.141.206,0,0,1,56,1,56,0.852894000,0.0000
66.47.31.172,<->,8.252.222.205,0,0,1,56,1,56,0.852045000,0.0000
215.158.239.95,<->,199.20.5.71,1,56,0,0,1,56,0.850507000,0.0000
215.158.239.49,<->,199.20.31.92,1,56,0,0,1,56,0.849187000,0.0000
197.113.99.204,<->,136.25.188.227,0,0,1,56,1,56,0.849134000,0.0000
192.65.118.85,<->,8.45.162.111,1,56,0,0,1,56,0.848482000,0.0000
215.158.239.78,<->,204.226.94.126,1,56,0,0,1,56,0.848276000,0.0000
195.70.153.110,<->,136.25.188.225,0,0,1,56,1,56,0.848042000,0.0000
117.38.98.160,<->,50.224.76.230,0,0,1,50,1,50,0.847345000,0.0000
247.136.177.126,<->,141.46.197.44,1,56,0,0,1,56,0.847089000,0.0000
92.27.219.49,<->,67.225.124.134,1,50,0,0,1,50,0.846666000,0.0000
215.158.239.57,<->,142.241.222.107,1,56,0,0,1,56,0.845687000,0.0000
84.242.135.61,<->,50.224.76.235,0,0,1,50,1,50,0.845017000,0.0000
136.25.189.4,<->,98.219.126.140,1,56,0,0,1,56,0.844813000,0.0000
122.195.249.211,<->,50.224.76.234,0,0,1,50,1,50,0.844631000,0.0000
17.59.146.123,<->,8.52.154.255,0,0,1,56,1,56,0.844580000,0.0000
249.101.93.184,<->,159.57.90.68,1,56,0,0,1,56,0.844572000,0.0000
221.102.143.189,<->,80.41.80.157,0,0,1,141,1,141,0.843740000,0.0000
158.85.62.60,<->,133.178.226.197,0,0,1,56,1,56,0.843468000,0.0000
210.158.44.170,<->,136.128.50.214,1,50,0,0,1,50,0.843140000,0.0000
199.39.40.249,<->,136.25.188.236,0,0,1,50,1,50,0.843052000,0.0000
192.64.204.221,<->,105.133.26.208,1,50,0,0,1,50,0.843005000,0.0000
109.1.2.246,<->,26.218.94.112,1,50,0,0,1,50,0.842902000,0.0000
204.186.92.108,<->,136.25.188.236,0,0,1,56,1,56,0.842824000,0.0000
205.20.150.175,<->,109.1.16.10,0,0,1,50,1,50,0.842481000,0.0000
142.244.205.129,<->,136.25.188.162,0,0,1,56,1,56,0.842450000,0.0000
111.147.208.7,<->,53.214.99.190,1,56,0,0,1,56,0.842186000,0.0000
142.236.184.190,<->,136.25.188.175,0,0,1,50,1,50,0.842175000,0.0000
200.174.205.190,<->,53.160.87.174,1,56,0,0,1,56,0.842089000,0.0000
215.158.30.178,<->,8.252.222.189,0,0,1,56,1,56,0.842046000,0.0000
252.253.8.169,<->,0.195.210.46,0,0,1,56,1,56,0.841986000,0.0000
215.158.239.79,<->,199.20.6.144,1,56,0,0,1,56,0.841889000,0.0000
204.131.36.178,<->,0.195.210.33,0,0,1,56,1,56,0.841843000,0.0000
199.32.191.131,<->,136.25.188.209,0,0,1,56,1,56,0.841571000,0.0000
218.138.21.138,<->,215.158.103.203,0,0,1,50,1,50,0.841539000,0.0000
99.187.125.121,<->,8.20.87.11,0,0,1,56,1,56,0.841301000,0.0000
207.173.241.126,<->,136.25.188.199,0,0,1,56,1,56,0.841216000,0.0000
144.86.148.17,<->,92.162.221.215,1,50,0,0,1,50,0.840790000,0.0000
111.147.249.144,<->,50.145.213.17,1,50,0,0,1,50,0.840769000,0.0000
204.58.218.182,<->,136.25.188.177,0,0,1,56,1,56,0.840472000,0.0000
68.72.92.217,<->,8.252.221.206,0,0,1,56,1,56,0.840351000,0.0000
215.158.239.57,<->,199.20.28.189,1,56,0,0,1,56,0.840070000,0.0000
89.86.110.223,<->,8.252.223.162,0,0,1,56,1,56,0.839466000,0.0000
220.28.104.193,<->,136.25.188.213,0,0,1,56,1,56,0.839418000,0.0000
100.182.234.231,<->,8.52.132.185,0,0,1,50,1,50,0.839315000,0.0000
215.158.239.86,<->,199.20.31.92,1,56,0,0,1,56,0.839212000,0.0000
215.158.239.35,<->,92.175.142.172,1,56,0,0,1,56,0.838836000,0.0000
204.3.7.235,<->,136.25.188.209,0,0,1,56,1,56,0.838401000,0.0000
111.181.118.201,<->,8.55.195.124,1,141,0,0,1,141,0.838229000,0.0000
109.222.211.98,<->,53.188.156.97,1,56,0,0,1,56,0.837952000,0.0000
215.158.239.95,<->,196.238.162.142,1,56,0,0,1,56,0.836400000,0.0000
97.198.117.226,<->,50.106.134.239,1,394,0,0,1,394,0.836319000,0.0000
143.123.198.246,<->,50.224.76.230,0,0,1,56,1,56,0.834850000,0.0000
100.93.144.126,<->,27.12.1.152,1,50,0,0,1,50,0.833092000,0.0000
215.158.238.232,<->,100.216.78.145,1,56,0,0,1,56,0.832982000,0.0000
195.55.53.51,<->,136.25.188.46,0,0,1,50,1,50,0.832548000,0.0000
199.80.3.106,<->,136.25.188.162,0,0,1,56,1,56,0.831638000,0.0000
159.137.162.213,<->,117.128.121.205,1,50,0,0,1,50,0.830979000,0.0000
221.102.56.69,<->,98.128.50.14,0,0,1,56,1,56,0.829978000,0.0000
198.206.82.208,<->,111.147.191.15,0,0,1,61,1,61,0.829842000,0.0000
141.134.183.188,<->,8.252.222.142,0,0,1,50,1,50,0.828914000,0.0000
91.41.83.140,<->,8.228.209.115,0,0,1,56,1,56,0.828629000,0.0000
136.25.188.54,<->,8.227.55.201,1,56,0,0,1,56,0.828532000,0.0000
207.72.120.226,<->,8.252.222.172,0,0,1,56,1,56,0.827357000,0.0000
136.25.188.162,<->,8.227.55.188,1,56,0,0,1,56,0.827211000,0.0000
192.170.241.103,<->,8.252.221.167,0,0,1,56,1,56,0.826800000,0.0000
133.32.39.39,<->,17.2.1.166,1,50,0,0,1,50,0.826441000,0.0000
215.158.239.49,<->,199.121.105.18,1,50,0,0,1,50,0.825990000,0.0000
213.155.77.98,<->,136.25.188.177,0,0,1,56,1,56,0.825849000,0.0000
159.109.250.48,<->,106.5.211.4,1,50,0,0,1,50,0.825598000,0.0000
116.163.40.218,<->,92.27.219.18,0,0,1,50,1,50,0.825485000,0.0000
142.178.151.102,<->,50.224.76.234,0,0,1,50,1,50,0.824994000,0.0000
246.253.253.107,<->,100.108.23.169,1,56,0,0,1,56,0.824241000,0.0000
215.158.239.58,<->,142.228.75.143,1,50,0,0,1,50,0.824079000,0.0000
138.98.203.225,<->,122.192.129.142,1,50,0,0,1,50,0.823893000,0.0000
145.252.112.120,<->,117.23.71.110,1,50,0,0,1,50,0.822778000,0.0000
115.139.55.246,<->,50.224.76.235,0,0,1,56,1,56,0.822629000,0.0000
142.236.213.69,<->,136.25.188.226,0,0,1,50,1,50,0.822504000,0.0000
239.227.66.217,<->,221.102.143.189,1,141,0,0,1,141,0.822477000,0.0000
138.121.99.24,<->,8.220.202.24,0,0,1,50,1,50,0.821470000,0.0000
136.25.188.47,<->,113.23.104.246,1,56,0,0,1,56,0.820663000,0.0000
237.15.238.95,<->,92.27.219.235,0,0,1,56,1,56,0.820417000,0.0000
97.53.41.61,<->,8.182.245.10,0,0,1,50,1,50,0.820112000,0.0000
199.81.31.221,<->,136.25.188.253,0,0,1,50,1,50,0.819390000,0.0000
207.63.85.62,<->,136.25.188.209,0,0,1,50,1,50,0.819158000,0.0000
215.158.239.68,<->,195.80.101.217,1,56,0,0,1,56,0.818513000,0.0000
144.85.170.208,<->,98.87.146.141,1,56,0,0,1,56,0.818122000,0.0000
221.102.143.189,<->,192.64.72.222,0,0,1,141,1,141,0.817513000,0.0000
195.125.104.107,<->,136.25.188.199,0,0,1,50,1,50,0.816394000,0.0000
50.223.3.228,<->,35.55.6.121,1,56,0,0,1,56,0.816227000,0.0000
98.236.90.61,<->,54.43.51.222,1,50,0,0,1,50,0.816130000,0.0000
17.240.202.152,<->,8.220.188.50,0,0,1,50,1,50,0.816033000,0.0000
112.208.20.81,<->,6.72.38.245,0,0,1,50,1,50,0.816005000,0.0000
195.5.199.239,<->,136.25.188.177,0,0,1,50,1,50,0.815347000,0.0000
207.63.2.86,<->,136.25.188.176,0,0,1,50,1,50,0.814231000,0.0000
109.1.9.162,<->,106.5.211.9,1,50,0,0,1,50,0.813943000,0.0000
144.87.238.91,<->,8.182.136.93,0,0,1,50,1,50,0.813586000,0.0000
197.7.105.66,<->,8.182.241.177,0,0,1,56,1,56,0.813581000,0.0000
215.158.103.203,<->,53.73.20.119,1,50,0,0,1,50,0.813060000,0.0000
139.163.7.204,<->,33.241.5.24,1,56,0,0,1,56,0.812897000,0.0000
53.148.20.156,<->,48.52.87.32,0,0,1,56,1,56,0.812657000,0.0000
144.85.170.246,<->,98.87.124.55,1,56,0,0,1,56,0.812344000,0.0000
144.85.170.208,<->,91.69.185.208,1,56,0,0,1,56,0.812103000,0.0000
247.136.136.55,<->,40.219.15.82,1,50,0,0,1,50,0.811946000,0.0000
195.13.183.230,<->,136.25.188.176,0,0,1,56,1,56,0.811442000,0.0000
215.158.239.96,<->,194.199.215.226,1,56,0,0,1,56,0.810731000,0.0000
204.62.143.9,<->,136.25.188.198,0,0,1,93,1,93,0.810353000,0.0000
215.158.238.50,<->,129.222.39.90,1,56,0,0,1,56,0.810160000,0.0000
159.73.142.167,<->,8.176.37.62,0,0,1,56,1,56,0.809288000,0.0000
92.27.219.160,<->,53.214.238.61,1,50,0,0,1,50,0.808662000,0.0000
17.213.58.90,<->,8.220.190.86,0,0,1,56,1,56,0.808277000,0.0000
143.42.52.16,<->,136.25.188.53,0,0,1,50,1,50,0.807589000,0.0000
197.7.74.19,<->,8.182.239.190,0,0,1,50,1,50,0.807232000,0.0000
194.237.93.242,<->,136.25.188.179,0,0,1,50,1,50,0.807212000,0.0000
8.176.49.169,<->,0.220.255.202,1,50,0,0,1,50,0.806865000,0.0000
159.23.227.171,<->,127.159.185.21,1,50,0,0,1,50,0.806764000,0.0000
159.137.255.191,<->,121.120.77.98,1,50,0,0,1,50,0.806105000,0.0000
96.150.228.172,<->,8.52.188.70,0,0,1,56,1,56,0.805363000,0.0000
133.62.79.123,<->,8.252.222.50,0,0,1,50,1,50,0.805327000,0.0000
207.20.199.84,<->,0.195.210.44,0,0,1,56,1,56,0.805062000,0.0000
215.158.239.95,<->,194.199.215.226,1,56,0,0,1,56,0.803793000,0.0000
196.89.228.33,<->,136.25.188.220,0,0,1,56,1,56,0.803563000,0.0000
137.24.196.227,<->,89.183.110.72,0,0,1,56,1,56,0.803377000,0.0000
215.158.239.78,<->,143.42.235.166,1,50,0,0,1,50,0.802896000,0.0000
215.158.239.57,<->,195.81.120.214,1,56,0,0,1,56,0.802734000,0.0000
50.224.76.235,<->,38.71.185.219,1,50,0,0,1,50,0.802361000,0.0000
215.158.140.74,<->,83.232.78.125,1,56,0,0,1,56,0.802338000,0.0000
215.158.239.68,<->,207.191.245.10,1,56,0,0,1,56,0.801731000,0.0000
159.137.162.213,<->,50.72.253.151,1,50,0,0,1,50,0.801535000,0.0000
212.164.143.229,<->,101.85.230.99,1,50,0,0,1,50,0.801118000,0.0000
143.94.34.93,<->,136.25.188.196,0,0,1,56,1,56,0.800004000,0.0000
142.221.144.87,<->,136.25.188.241,0,0,1,56,1,56,0.799540000,0.0000
73.94.145.187,<->,0.195.210.42,0,0,1,56,1,56,0.798450000,0.0000
120.126.50.203,<->,50.224.76.248,0,0,1,50,1,50,0.798207000,0.0000
139.163.5.140,<->,42.47.113.167,1,50,0,0,1,50,0.797572000,0.0000
111.147.242.144,<->,8.18.125.73,1,50,0,0,1,50,0.797527000,0.0000
210.209.251.214,<->,80.41.205.81,0,0,1,50,1,50,0.797516000,0.0000
207.162.145.221,<->,8.182.253.40,0,0,1,50,1,50,0.797501000,0.0000
215.158.239.85,<->,204.226.14.183,1,56,0,0,1,56,0.796675000,0.0000
215.158.239.32,<->,101.161.158.219,1,50,0,0,1,50,0.796435000,0.0000
215.158.239.113,<->,129.222.39.189,1,56,0,0,1,56,0.796404000,0.0000
215.158.140.80,<->,96.156.169.112,1,56,0,0,1,56,0.796372000,0.0000
232.31.148.11,<->,97.198.118.56,0,0,1,56,1,56,0.795902000,0.0000
192.170.157.185,<->,136.62.168.88,0,0,1,141,1,141,0.795483000,0.0000
6.145.166.119,<->,0.195.210.46,0,0,1,50,1,50,0.795115000,0.0000
111.14.20.30,<->,8.252.222.36,0,0,1,56,1,56,0.795061000,0.0000
220.28.65.9,<->,133.178.227.30,0,0,1,56,1,56,0.794867000,0.0000
215.158.239.48,<->,199.20.6.196,1,56,0,0,1,56,0.794526000,0.0000
144.54.85.138,<->,136.25.188.226,0,0,1,56,1,56,0.794301000,0.0000
56.189.215.197,<->,8.52.171.236,0,0,1,56,1,56,0.793864000,0.0000
114.41.29.88,<->,99.74.26.152,0,0,1,56,1,56,0.793540000,0.0000
246.253.253.107,<->,109.127.101.16,1,557,0,0,1,557,0.793514000,0.0000
136.25.188.234,<->,100.224.202.178,1,56,0,0,1,56,0.793330000,0.0000
137.19.241.43,<->,6.209.77.113,1,56,0,0,1,56,0.793232000,0.0000
195.214.29.232,<->,50.223.3.228,0,0,1,56,1,56,0.793067000,0.0000
207.57.125.44,<->,136.25.188.52,0,0,1,50,1,50,0.791881000,0.0000
215.201.235.99,<->,144.85.170.254,0,0,1,50,1,50,0.790841000,0.0000
93.48.197.173,<->,89.183.104.239,0,0,1,50,1,50,0.790725000,0.0000
142.229.141.107,<->,136.25.188.254,0,0,1,50,1,50,0.790403000,0.0000
194.237.93.242,<->,136.25.188.209,0,0,1,50,1,50,0.790137000,0.0000
199.96.138.28,<->,50.224.76.234,0,0,1,50,1,50,0.788580000,0.0000
215.158.239.79,<->,204.3.164.81,1,50,0,0,1,50,0.788040000,0.0000
247.118.197.173,<->,8.182.226.78,0,0,1,50,1,50,0.787937000,0.0000
232.31.148.12,<->,97.198.118.56,0,0,1,56,1,56,0.787782000,0.0000
243.49.81.32,<->,101.123.191.104,0,0,1,56,1,56,0.787634000,0.0000
249.101.82.5,<->,139.33.174.178,1,50,0,0,1,50,0.787604000,0.0000
139.117.42.223,<->,109.222.210.246,0,0,1,56,1,56,0.787589000,0.0000
223.120.101.156,<->,8.252.222.47,0,0,1,56,1,56,0.787334000,0.0000
205.175.193.162,<->,50.224.76.234,0,0,1,56,1,56,0.786899000,0.0000
111.150.206.152,<->,6.73.247.16,0,0,1,56,1,56,0.786529000,0.0000
136.18.16.95,<->,8.182.245.10,0,0,1,50,1,50,0.786423000,0.0000
215.158.140.27,<->,134.172.159.168,1,56,0,0,1,56,0.785704000,0.0000
142.236.78.144,<->,136.25.188.253,0,0,1,56,1,56,0.785667000,0.0000
133.178.226.77,<->,96.155.60.244,1,56,0,0,1,56,0.784664000,0.0000
94.192.85.101,<->,8.252.222.108,0,0,1,56,1,56,0.784526000,0.0000
204.200.56.185,<->,136.25.188.252,0,0,1,56,1,56,0.784386000,0.0000
215.158.239.76,<->,207.167.180.154,1,56,0,0,1,56,0.784094000,0.0000
215.158.239.76,<->,195.40.116.61,1,56,0,0,1,56,0.783514000,0.0000
210.158.44.191,<->,102.45.233.201,1,50,0,0,1,50,0.783242000,0.0000
132.244.73.42,<->,108.134.108.240,0,0,1,50,1,50,0.783182000,0.0000
89.86.110.126,<->,8.252.223.120,0,0,1,56,1,56,0.782768000,0.0000
8.20.87.88,<->,6.145.173.32,1,56,0,0,1,56,0.782177000,0.0000
144.71.42.15,<->,105.200.46.248,1,50,0,0,1,50,0.781530000,0.0000
203.215.188.184,<->,124.42.185.84,1,56,0,0,1,56,0.781411000,0.0000
117.155.180.110,<->,99.75.44.80,0,0,1,50,1,50,0.781012000,0.0000
141.20.135.250,<->,129.13.225.25,0,0,1,50,1,50,0.780560000,0.0000
104.237.170.147,<->,50.224.76.248,0,0,1,50,1,50,0.780481000,0.0000
144.86.149.237,<->,124.50.117.248,1,50,0,0,1,50,0.779958000,0.0000
155.219.37.89,<->,136.25.188.225,0,0,1,50,1,50,0.779131000,0.0000
215.158.58.140,<->,99.74.27.166,0,0,1,56,1,56,0.778759000,0.0000
111.147.209.101,<->,53.201.142.135,1,56,0,0,1,56,0.778755000,0.0000
202.60.223.159,<->,8.252.221.207,0,0,1,56,1,56,0.778320000,0.0000
119.128.250.34,<->,50.224.76.248,0,0,1,50,1,50,0.778087000,0.0000
94.192.85.101,<->,8.252.222.92,0,0,1,56,1,56,0.777666000,0.0000
207.92.58.74,<->,192.64.206.74,0,0,1,50,1,50,0.777655000,0.0000
158.200.13.147,<->,8.20.87.156,0,0,1,50,1,50,0.777570000,0.0000
128.221.182.45,<->,50.224.76.235,0,0,1,50,1,50,0.777422000,0.0000
215.158.239.58,<->,207.114.231.138,1,56,0,0,1,56,0.776982000,0.0000
195.7.177.255,<->,136.25.188.239,0,0,1,50,1,50,0.776837000,0.0000
221.102.56.69,<->,192.67.86.35,0,0,1,56,1,56,0.776831000,0.0000
215.158.239.77,<->,207.213.183.113,1,56,0,0,1,56,0.776604000,0.0000
136.25.188.163,<->,8.227.55.195,1,56,0,0,1,56,0.776511000,0.0000
195.70.97.164,<->,136.25.188.255,0,0,1,50,1,50,0.776360000,0.0000
232.31.43.149,<->,97.198.118.56,0,0,1,56,1,56,0.776165000,0.0000
213.186.52.38,<->,50.224.105.37,0,0,1,56,1,56,0.776076000,0.0000
199.122.103.22,<->,136.25.188.255,0,0,1,50,1,50,0.775719000,0.0000
232.31.241.228,<->,97.198.118.56,0,0,1,56,1,56,0.774402000,0.0000
220.50.215.93,<->,89.216.125.215,0,0,1,56,1,56,0.774363000,0.0000
218.138.240.252,<->,8.220.234.189,0,0,1,50,1,50,0.774279000,0.0000
132.18.67.29,<->,100.94.157.198,0,0,1,56,1,56,0.773066000,0.0000
53.203.244.195,<->,48.53.80.15,0,0,1,56,1,56,0.772851000,0.0000
232.31.192.217,<->,97.198.118.56,0,0,1,56,1,56,0.772835000,0.0000
207.239.139.212,<->,136.25.188.176,0,0,1,56,1,56,0.772414000,0.0000
89.152.249.246,<->,8.182.239.159,0,0,1,56,1,56,0.772297000,0.0000
50.224.76.235,<->,0.245.16.144,1,50,0,0,1,50,0.772064000,0.0000
207.190.82.188,<->,136.25.188.254,0,0,1,56,1,56,0.771959000,0.0000
221.102.56.69,<->,213.38.232.168,0,0,1,56,1,56,0.770944000,0.0000
215.158.238.111,<->,145.116.209.80,1,56,0,0,1,56,0.770352000,0.0000
105.203.241.189,<->,50.224.76.248,0,0,1,50,1,50,0.770268000,0.0000
136.181.47.228,<->,82.195.35.34,1,50,0,0,1,50,0.770242000,0.0000
157.214.227.165,<->,50.224.75.112,0,0,1,50,1,50,0.769748000,0.0000
215.158.239.77,<->,142.249.122.150,1,56,0,0,1,56,0.769653000,0.0000
50.224.76.234,<->,30.183.186.118,1,56,0,0,1,56,0.769482000,0.0000
202.33.229.219,<->,136.25.188.236,0,0,1,56,1,56,0.769244000,0.0000
215.158.239.87,<->,116.106.60.161,1,56,0,0,1,56,0.769191000,0.0000
196.119.218.162,<->,50.224.76.235,0,0,1,50,1,50,0.767801000,0.0000
136.25.188.162,<->,8.227.55.199,1,56,0,0,1,56,0.766286000,0.0000
215.158.238.226,<->,140.190.46.212,1,56,0,0,1,56,0.766015000,0.0000
97.11.170.243,<->,53.243.10.49,1,50,0,0,1,50,0.765238000,0.0000
109.222.216.239,<->,53.189.46.201,1,56,0,0,1,56,0.764777000,0.0000
220.20.200.134,<->,33.157.240.98,1,50,0,0,1,50,0.764552000,0.0000
89.183.104.148,<->,29.135.81.110,1,50,0,0,1,50,0.764448000,0.0000
245.241.43.37,<->,8.204.53.229,1,56,0,0,1,56,0.764104000,0.0000
50.23.41.165,<->,8.52.171.120,0,0,1,50,1,50,0.764058000,0.0000
132.249.70.183,<->,53.94.69.91,1,56,0,0,1,56,0.764058000,0.0000
199.82.89.20,<->,136.25.188.227,0,0,1,50,1,50,0.763949000,0.0000
232.31.155.15,<->,97.198.118.56,0,0,1,56,1,56,0.763658000,0.0000
94.24.8.153,<->,92.27.219.38,0,0,1,50,1,50,0.763434000,0.0000
195.70.3.100,<->,136.25.188.176,0,0,1,50,1,50,0.763404000,0.0000
216.184.1.109,<->,136.25.188.201,0,0,1,56,1,56,0.762253000,0.0000
95.245.113.50,<->,8.252.221.199,0,0,1,56,1,56,0.761726000,0.0000
215.158.239.79,<->,199.15.79.21,1,56,0,0,1,56,0.761610000,0.0000
215.158.140.27,<->,60.110.124.96,1,56,0,0,1,56,0.761439000,0.0000
207.191.169.148,<->,136.25.188.45,0,0,1,56,1,56,0.761421000,0.0000
50.23.41.165,<->,8.52.224.51,0,0,1,50,1,50,0.761341000,0.0000
200.174.199.230,<->,53.200.182.229,1,56,0,0,1,56,0.761156000,0.0000
232.31.192.223,<->,97.198.118.56,0,0,1,56,1,56,0.760741000,0.0000
215.158.239.97,<->,199.20.30.244,1,56,0,0,1,56,0.760722000,0.0000
215.158.239.59,<->,199.20.30.147,1,93,0,0,1,93,0.760639000,0.0000
136.128.35.207,<->,8.176.8.87,0,0,1,56,1,56,0.760466000,0.0000
97.22.56.160,<->,8.183.24.211,0,0,1,56,1,56,0.760463000,0.0000
215.158.239.76,<->,199.106.112.188,1,56,0,0,1,56,0.760250000,0.0000
215.158.239.50,<->,196.88.141.143,1,56,0,0,1,56,0.760229000,0.0000
138.37.118.244,<->,92.162.253.48,0,0,1,50,1,50,0.759657000,0.0000
109.1.21.151,<->,26.218.94.114,1,50,0,0,1,50,0.759072000,0.0000
144.85.170.208,<->,111.216.99.92,1,50,0,0,1,50,0.759042000,0.0000
215.158.239.248,<->,122.159.122.92,1,56,0,0,1,56,0.758755000,0.0000
136.25.188.162,<->,8.227.55.102,1,56,0,0,1,56,0.758478000,0.0000
229.59.207.106,<->,50.224.80.64,0,0,1,50,1,50,0.758206000,0.0000
129.92.114.30,<->,54.54.203.214,1,125,0,0,1,125,0.757784000,0.0000
207.63.119.212,<->,136.25.188.54,0,0,1,50,1,50,0.756481000,0.0000
143.22.109.149,<->,8.182.226.78,0,0,1,56,1,56,0.756264000,0.0000
220.80.162.195,<->,8.55.216.92,1,56,0,0,1,56,0.756248000,0.0000
56.161.195.18,<->,8.52.137.40,0,0,1,50,1,50,0.755999000,0.0000
207.61.62.32,<->,136.25.188.177,0,0,1,56,1,56,0.755667000,0.0000
143.135.224.130,<->,136.25.188.226,0,0,1,56,1,56,0.755602000,0.0000
136.25.189.202,<->,129.222.39.173,1,56,0,0,1,56,0.754701000,0.0000
208.24.194.54,<->,8.43.155.247,0,0,1,56,1,56,0.754667000,0.0000
215.158.239.84,<->,199.20.29.231,1,56,0,0,1,56,0.754550000,0.0000
139.163.83.153,<->,98.150.54.68,1,50,0,0,1,50,0.754504000,0.0000
199.50.155.29,<->,136.25.188.46,0,0,1,50,1,50,0.754112000,0.0000
202.178.9.232,<->,133.32.2.73,0,0,1,50,1,50,0.754069000,0.0000
145.19.5.174,<->,53.229.128.45,1,56,0,0,1,56,0.753964000,0.0000
231.143.36.229,<->,136.25.188.46,0,0,1,56,1,56,0.752647000,0.0000
232.31.155.21,<->,97.198.118.56,0,0,1,56,1,56,0.752634000,0.0000
142.200.230.208,<->,50.224.76.235,0,0,1,50,1,50,0.752407000,0.0000
215.158.239.76,<->,196.106.7.103,1,56,0,0,1,56,0.752023000,0.0000
136.25.189.202,<->,129.222.39.50,1,56,0,0,1,56,0.752001000,0.0000
92.66.73.171,<->,50.224.76.248,0,0,1,56,1,56,0.751761000,0.0000
195.13.5.21,<->,136.25.188.162,0,0,1,56,1,56,0.751300000,0.0000
215.158.239.225,<->,212.249.34.46,1,67,0,0,1,67,0.750792000,0.0000
207.162.185.28,<->,8.182.227.180,0,0,1,50,1,50,0.750772000,0.0000
215.158.239.59,<->,199.20.5.35,1,56,0,0,1,56,0.750142000,0.0000
215.158.238.80,<->,113.23.104.203,1,56,0,0,1,56,0.749938000,0.0000
210.209.251.214,<->,144.87.235.222,0,0,1,50,1,50,0.749132000,0.0000
127.168.165.134,<->,8.176.8.225,0,0,1,56,1,56,0.747525000,0.0000
215.158.239.95,<->,199.20.29.8,1,56,0,0,1,56,0.747407000,0.0000
147.58.211.46,<->,8.252.221.214,0,0,1,56,1,56,0.747038000,0.0000
231.140.32.67,<->,136.25.188.252,0,0,1,50,1,50,0.747004000,0.0000
221.102.56.69,<->,109.0.215.102,0,0,1,56,1,56,0.746711000,0.0000
143.132.244.132,<->,136.25.188.177,0,0,1,56,1,56,0.746498000,0.0000
215.158.238.51,<->,129.222.36.77,1,56,0,0,1,56,0.746426000,0.0000
215.158.239.78,<->,196.90.0.243,1,56,0,0,1,56,0.746355000,0.0000
239.66.104.92,<->,97.198.118.56,0,0,1,56,1,56,0.746272000,0.0000
215.158.239.113,<->,129.222.36.65,1,56,0,0,1,56,0.745757000,0.0000
92.162.253.34,<->,92.27.68.141,1,50,0,0,1,50,0.745123000,0.0000
213.186.59.159,<->,144.85.170.246,0,0,1,56,1,56,0.743689000,0.0000
136.25.188.176,<->,8.227.55.220,1,56,0,0,1,56,0.743578000,0.0000
109.1.21.151,<->,8.55.135.127,1,50,0,0,1,50,0.743140000,0.0000
109.222.243.128,<->,14.27.123.221,1,56,0,0,1,56,0.742915000,0.0000
215.158.239.50,<->,196.90.18.111,1,56,0,0,1,56,0.742101000,0.0000
139.5.114.37,<->,8.52.184.161,0,0,1,56,1,56,0.741058000,0.0000
193.94.11.240,<->,97.126.92.131,0,0,1,50,1,50,0.740719000,0.0000
199.51.154.75,<->,136.25.188.225,0,0,1,56,1,56,0.740449000,0.0000
8.52.182.119,<->,8.3.252.131,1,50,0,0,1,50,0.739731000,0.0000
136.25.188.200,<->,100.224.202.176,1,56,0,0,1,56,0.739601000,0.0000
194.237.189.237,<->,136.25.188.252,0,0,1,56,1,56,0.738619000,0.0000
93.95.39.140,<->,50.224.76.248,0,0,1,50,1,50,0.738157000,0.0000
142.236.142.220,<->,136.25.188.209,0,0,1,50,1,50,0.737974000,0.0000
232.31.148.13,<->,97.198.118.56,0,0,1,56,1,56,0.737756000,0.0000
232.31.155.11,<->,97.198.118.56,0,0,1,56,1,56,0.737472000,0.0000
112.208.147.230,<->,89.183.110.72,0,0,1,56,1,56,0.737380000,0.0000
104.213.111.229,<->,50.224.76.234,0,0,1,56,1,56,0.736943000,0.0000
195.55.27.178,<->,136.25.188.174,0,0,1,56,1,56,0.736821000,0.0000
142.208.56.155,<->,136.25.188.253,0,0,1,56,1,56,0.736086000,0.0000
204.123.32.211,<->,139.193.141.200,0,0,1,56,1,56,0.735737000,0.0000
107.10.167.99,<->,8.52.186.119,0,0,1,56,1,56,0.735554000,0.0000
124.46.191.127,<->,92.162.253.137,0,0,1,50,1,50,0.735501000,0.0000
54.37.224.121,<->,48.54.142.19,0,0,1,50,1,50,0.735105000,0.0000
197.32.230.217,<->,145.252.127.155,0,0,1,50,1,50,0.734529000,0.0000
142.222.40.123,<->,8.252.222.143,0,0,1,50,1,50,0.733879000,0.0000
221.102.143.189,<->,6.73.237.197,0,0,1,141,1,141,0.733811000,0.0000
222.78.57.246,<->,8.20.81.41,1,50,0,0,1,50,0.733792000,0.0000
239.71.80.85,<->,84.22.52.96,1,56,0,0,1,56,0.733091000,0.0000
215.158.239.48,<->,204.2.250.243,1,56,0,0,1,56,0.732819000,0.0000
142.248.247.189,<->,136.25.188.222,0,0,1,50,1,50,0.732750000,0.0000
159.137.210.33,<->,114.234.174.140,1,50,0,0,1,50,0.731766000,0.0000
148.238.148.147,<->,89.183.110.72,0,0,1,56,1,56,0.731160000,0.0000
132.216.20.150,<->,102.231.186.33,0,0,1,56,1,56,0.730359000,0.0000
101.224.182.5,<->,6.73.247.62,0,0,1,951,1,951,0.729189000,0.0000
136.25.188.220,<->,8.227.55.42,1,56,0,0,1,56,0.729184000,0.0000
117.6.100.72,<->,50.224.76.234,0,0,1,56,1,56,0.729111000,0.0000
232.31.43.151,<->,97.198.118.56,0,0,1,56,1,56,0.729039000,0.0000
109.222.222.94,<->,53.234.162.13,1,125,0,0,1,125,0.728802000,0.0000
207.58.161.119,<->,136.25.188.252,0,0,1,50,1,50,0.728654000,0.0000
129.187.1.149,<->,100.182.186.91,0,0,1,50,1,50,0.728461000,0.0000
195.40.165.103,<->,136.25.188.45,0,0,1,56,1,56,0.728365000,0.0000
8.20.87.92,<->,6.145.149.209,1,56,0,0,1,56,0.727973000,0.0000
115.113.157.92,<->,92.27.219.243,0,0,1,50,1,50,0.726306000,0.0000
17.88.221.236,<->,8.52.134.29,0,0,1,50,1,50,0.725890000,0.0000
221.102.56.69,<->,102.81.240.180,0,0,1,56,1,56,0.725835000,0.0000
192.64.64.176,<->,112.208.20.194,1,50,0,0,1,50,0.725581000,0.0000
232.31.108.53,<->,97.198.118.56,0,0,1,56,1,56,0.725566000,0.0000
215.158.239.97,<->,143.20.9.17,1,50,0,0,1,50,0.725435000,0.0000
215.158.239.56,<->,207.188.31.83,1,56,0,0,1,56,0.725361000,0.0000
92.27.219.159,<->,53.251.236.164,1,50,0,0,1,50,0.724759000,0.0000
125.193.251.207,<->,50.224.76.230,0,0,1,56,1,56,0.724693000,0.0000
53.161.235.49,<->,48.53.35.88,0,0,1,50,1,50,0.724614000,0.0000
215.158.239.56,<->,196.90.83.92,1,56,0,0,1,56,0.724401000,0.0000
215.158.140.240,<->,122.159.30.58,1,56,0,0,1,56,0.723799000,0.0000
199.121.54.19,<->,136.25.188.253,0,0,1,50,1,50,0.723513000,0.0000
97.203.12.51,<->,8.182.227.35,0,0,1,56,1,56,0.723278000,0.0000
207.57.206.169,<->,136.25.188.177,0,0,1,56,1,56,0.723266000,0.0000
194.206.249.165,<->,8.182.226.78,0,0,1,50,1,50,0.722918000,0.0000
215.158.239.92,<->,196.90.83.92,1,56,0,0,1,56,0.722274000,0.0000
199.15.77.28,<->,136.25.188.198,0,0,1,132,1,132,0.721986000,0.0000
142.190.51.173,<->,136.25.188.236,0,0,1,56,1,56,0.721807000,0.0000
210.236.82.159,<->,8.183.25.25,0,0,1,56,1,56,0.721758000,0.0000
215.158.238.80,<->,113.23.104.246,1,56,0,0,1,56,0.721393000,0.0000
213.221.90.194,<->,144.85.170.208,0,0,1,56,1,56,0.720801000,0.0000
145.255.249.236,<->,80.38.60.123,0,0,1,50,1,50,0.720674000,0.0000
53.148.153.145,<->,8.52.222.253,0,0,1,56,1,56,0.720593000,0.0000
142.227.103.149,<->,136.25.188.255,0,0,1,56,1,56,0.720561000,0.0000
199.14.203.15,<->,136.25.188.163,0,0,1,56,1,56,0.720172000,0.0000
215.158.238.119,<->,145.116.209.92,1,56,0,0,1,56,0.719764000,0.0000
215.61.216.185,<->,133.32.39.0,0,0,1,56,1,56,0.719266000,0.0000
142.252.114.229,<->,136.25.188.253,0,0,1,56,1,56,0.718522000,0.0000
138.126.13.23,<->,50.224.76.235,0,0,1,50,1,50,0.718169000,0.0000
144.74.36.1,<->,8.182.226.78,0,0,1,50,1,50,0.718002000,0.0000
246.254.97.113,<->,139.33.175.144,1,340,0,0,1,340,0.717998000,0.0000
215.158.239.78,<->,195.83.97.243,1,56,0,0,1,56,0.717992000,0.0000
215.158.239.92,<->,199.20.6.166,1,56,0,0,1,56,0.717936000,0.0000
112.29.96.63,<->,50.224.76.235,0,0,1,56,1,56,0.717872000,0.0000
138.74.30.197,<->,89.90.125.158,1,50,0,0,1,50,0.717375000,0.0000
215.158.239.97,<->,199.20.7.56,1,56,0,0,1,56,0.716241000,0.0000
206.243.192.207,<->,92.162.253.203,0,0,1,50,1,50,0.715728000,0.0000
159.137.162.213,<->,105.105.201.106,1,50,0,0,1,50,0.713290000,0.0000
215.158.239.76,<->,199.20.30.82,1,56,0,0,1,56,0.713164000,0.0000
215.158.140.27,<->,68.231.30.240,1,56,0,0,1,56,0.713095000,0.0000
142.227.97.183,<->,136.25.188.222,0,0,1,56,1,56,0.712818000,0.0000
115.67.32.44,<->,50.224.106.182,0,0,1,56,1,56,0.712632000,0.0000
222.16.245.21,<->,192.64.228.248,0,0,1,56,1,56,0.712276000,0.0000
239.66.240.179,<->,144.86.146.31,0,0,1,838,1,838,0.711924000,0.0000
207.173.154.103,<->,136.25.188.55,0,0,1,56,1,56,0.711587000,0.0000
222.68.66.166,<->,132.216.20.84,1,56,0,0,1,56,0.711000000,0.0000
109.119.182.189,<->,89.216.125.35,0,0,1,56,1,56,0.710831000,0.0000
139.5.113.141,<->,133.32.39.1,0,0,1,56,1,56,0.710712000,0.0000
200.175.204.226,<->,53.201.72.62,1,93,0,0,1,93,0.710553000,0.0000
144.85.170.208,<->,98.87.144.198,1,56,0,0,1,56,0.710055000,0.0000
159.137.192.179,<->,138.81.213.82,1,56,0,0,1,56,0.709891000,0.0000
215.158.239.83,<->,98.219.126.140,1,56,0,0,1,56,0.709384000,0.0000
144.85.170.254,<->,91.69.181.168,1,56,0,0,1,56,0.709254000,0.0000
159.137.162.213,<->,110.43.86.177,1,50,0,0,1,50,0.709211000,0.0000
133.96.32.14,<->,8.182.244.19,0,0,1,56,1,56,0.708869000,0.0000
144.85.170.254,<->,91.69.181.217,1,56,0,0,1,56,0.708545000,0.0000
80.41.196.234,<->,8.55.224.156,1,56,0,0,1,56,0.707986000,0.0000
195.41.235.212,<->,136.25.188.222,0,0,1,50,1,50,0.707986000,0.0000
145.16.103.60,<->,8.35.106.57,1,50,0,0,1,50,0.707543000,0.0000
215.158.239.49,<->,199.20.29.238,1,56,0,0,1,56,0.707298000,0.0000
195.124.107.127,<->,136.25.188.238,0,0,1,56,1,56,0.707267000,0.0000
215.158.239.248,<->,139.163.167.61,1,56,0,0,1,56,0.707208000,0.0000
69.128.170.175,<->,6.130.64.218,1,50,0,0,1,50,0.706626000,0.0000
196.240.89.116,<->,136.25.188.196,0,0,1,56,1,56,0.706525000,0.0000
143.20.116.126,<->,136.25.188.163,0,0,1,56,1,56,0.705942000,0.0000
136.25.188.177,<->,30.73.135.115,1,56,0,0,1,56,0.705491000,0.0000
143.20.116.126,<->,136.25.188.225,0,0,1,56,1,56,0.705403000,0.0000
66.63.190.126,<->,8.252.221.197,0,0,1,50,1,50,0.705142000,0.0000
215.158.239.253,<->,8.191.135.47,1,56,0,0,1,56,0.703956000,0.0000
215.158.239.182,<->,113.207.62.154,1,56,0,0,1,56,0.703690000,0.0000
132.220.100.51,<->,8.53.4.76,0,0,1,50,1,50,0.703605000,0.0000
142.207.52.165,<->,136.25.188.55,0,0,1,50,1,50,0.703431000,0.0000
215.158.239.87,<->,195.54.56.77,1,56,0,0,1,56,0.703295000,0.0000
246.254.97.230,<->,111.151.239.173,1,56,0,0,1,56,0.703239000,0.0000
92.27.4.165,<->,80.40.123.105,0,0,1,50,1,50,0.703118000,0.0000
213.38.247.248,<->,8.55.211.213,1,56,0,0,1,56,0.702489000,0.0000
204.200.37.111,<->,136.25.188.55,0,0,1,56,1,56,0.702352000,0.0000
215.158.239.78,<->,143.91.230.145,1,50,0,0,1,50,0.702164000,0.0000
192.64.227.200,<->,125.2.49.79,1,50,0,0,1,50,0.702036000,0.0000
197.161.164.190,<->,136.25.188.253,0,0,1,56,1,56,0.701994000,0.0000
93.141.116.172,<->,92.27.219.39,0,0,1,50,1,50,0.701737000,0.0000
195.55.61.39,<->,136.25.188.239,0,0,1,50,1,50,0.701727000,0.0000
215.158.140.230,<->,132.208.78.60,1,50,0,0,1,50,0.701659000,0.0000
199.90.8.21,<->,8.182.226.42,0,0,1,56,1,56,0.700774000,0.0000
199.52.224.164,<->,136.25.188.45,0,0,1,50,1,50,0.700597000,0.0000
199.39.87.91,<->,136.25.188.242,0,0,1,56,1,56,0.699156000,0.0000
194.237.123.153,<->,136.25.188.211,0,0,1,50,1,50,0.697712000,0.0000
192.67.169.201,<->,100.124.212.156,1,56,0,0,1,56,0.697701000,0.0000
203.212.63.74,<->,8.220.234.4,0,0,1,56,1,56,0.697110000,0.0000
98.232.172.226,<->,6.133.244.165,1,56,0,0,1,56,0.696805000,0.0000
196.200.227.12,<->,8.252.222.185,0,0,1,56,1,56,0.696580000,0.0000
220.28.108.254,<->,215.158.239.47,0,0,1,56,1,56,0.696555000,0.0000
246.254.97.228,<->,56.148.119.56,1,50,0,0,1,50,0.696217000,0.0000
124.30.115.231,<->,50.224.76.235,0,0,1,56,1,56,0.696081000,0.0000
215.158.239.97,<->,196.91.53.11,1,56,0,0,1,56,0.695754000,0.0000
39.189.129.43,<->,8.176.49.169,0,0,1,50,1,50,0.695412000,0.0000
99.187.125.121,<->,8.20.87.6,0,0,1,56,1,56,0.695164000,0.0000
195.5.15.224,<->,136.25.188.54,0,0,1,50,1,50,0.695001000,0.0000
221.102.56.51,<->,192.67.144.122,0,0,1,56,1,56,0.694758000,0.0000
132.123.119.170,<->,8.52.187.74,0,0,1,56,1,56,0.694614000,0.0000
246.253.157.59,<->,119.231.232.223,1,50,0,0,1,50,0.693952000,0.0000
221.102.143.189,<->,192.65.116.41,0,0,1,56,1,56,0.693260000,0.0000
101.70.121.211,<->,53.86.250.203,1,56,0,0,1,56,0.693211000,0.0000
142.166.245.108,<->,136.25.188.174,0,0,1,56,1,56,0.693153000,0.0000
93.181.154.49,<->,89.183.104.191,0,0,1,50,1,50,0.691809000,0.0000
58.143.226.209,<->,8.252.221.237,0,0,1,50,1,50,0.691702000,0.0000
200.175.239.147,<->,53.161.180.137,1,50,0,0,1,50,0.691679000,0.0000
215.158.239.68,<->,199.20.30.255,1,56,0,0,1,56,0.691646000,0.0000
56.114.235.120,<->,8.228.213.135,0,0,1,1076,1,1076,0.691540000,0.0000
139.163.26.238,<->,27.11.188.105,1,50,0,0,1,50,0.689879000,0.0000
199.50.23.168,<->,136.25.188.227,0,0,1,50,1,50,0.689611000,0.0000
142.240.42.99,<->,136.25.188.227,0,0,1,50,1,50,0.688746000,0.0000
58.59.89.41,<->,8.252.221.222,0,0,1,56,1,56,0.687988000,0.0000
210.213.172.204,<->,192.64.205.235,0,0,1,50,1,50,0.687958000,0.0000
204.61.232.192,<->,136.25.188.241,0,0,1,50,1,50,0.687506000,0.0000
202.33.19.155,<->,136.25.188.236,0,0,1,56,1,56,0.687303000,0.0000
213.221.90.199,<->,144.85.170.254,0,0,1,56,1,56,0.687216000,0.0000
36.123.55.203,<->,8.20.87.33,0,0,1,56,1,56,0.687016000,0.0000
194.216.205.175,<->,136.25.188.178,0,0,1,56,1,56,0.686787000,0.0000
98.158.84.242,<->,8.182.226.78,0,0,1,50,1,50,0.686086000,0.0000
138.126.13.23,<->,50.224.76.230,0,0,1,50,1,50,0.685087000,0.0000
95.245.146.158,<->,8.252.222.77,0,0,1,56,1,56,0.684954000,0.0000
195.70.17.138,<->,136.25.188.177,0,0,1,50,1,50,0.684943000,0.0000
224.250.117.119,<->,100.228.42.204,0,0,1,56,1,56,0.683790000,0.0000
215.158.239.86,<->,196.107.82.68,1,56,0,0,1,56,0.683569000,0.0000
133.178.227.79,<->,8.222.6.193,1,56,0,0,1,56,0.683518000,0.0000
204.61.24.8,<->,136.25.188.175,0,0,1,56,1,56,0.683471000,0.0000
204.61.232.192,<->,136.25.188.253,0,0,1,50,1,50,0.681763000,0.0000
194.232.183.97,<->,136.25.188.220,0,0,1,50,1,50,0.681413000,0.0000
149.133.163.104,<->,89.183.110.72,0,0,1,50,1,50,0.681301000,0.0000
205.224.85.211,<->,92.27.8.30,0,0,1,56,1,56,0.679647000,0.0000
198.187.26.113,<->,100.92.195.69,0,0,1,50,1,50,0.679410000,0.0000
215.158.239.92,<->,194.199.212.1,1,56,0,0,1,56,0.678664000,0.0000
207.57.197.191,<->,136.25.188.160,0,0,1,56,1,56,0.678197000,0.0000
50.224.76.248,<->,50.51.78.188,1,56,0,0,1,56,0.677574000,0.0000
195.126.38.57,<->,136.25.188.209,0,0,1,50,1,50,0.676277000,0.0000
205.171.233.183,<->,0.195.210.42,0,0,1,50,1,50,0.675522000,0.0000
130.237.156.145,<->,50.224.76.234,0,0,1,56,1,56,0.675481000,0.0000
99.187.125.121,<->,8.20.87.3,0,0,1,56,1,56,0.675136000,0.0000
92.27.219.33,<->,4.240.67.99,1,50,0,0,1,50,0.675049000,0.0000
215.158.239.59,<->,199.20.28.157,1,56,0,0,1,56,0.675018000,0.0000
136.25.188.198,<->,8.227.55.197,1,56,0,0,1,56,0.674862000,0.0000
207.59.91.167,<->,136.25.188.239,0,0,1,56,1,56,0.674034000,0.0000
86.135.118.11,<->,8.252.222.23,0,0,1,56,1,56,0.673882000,0.0000
215.158.140.27,<->,141.57.126.191,1,56,0,0,1,56,0.673208000,0.0000
242.43.134.86,<->,8.220.190.86,0,0,1,56,1,56,0.673027000,0.0000
215.158.239.95,<->,143.134.191.112,1,56,0,0,1,56,0.672773000,0.0000
207.61.13.21,<->,136.25.188.178,0,0,1,50,1,50,0.672264000,0.0000
142.254.141.3,<->,136.25.188.226,0,0,1,56,1,56,0.672111000,0.0000
204.3.189.5,<->,136.25.188.242,0,0,1,56,1,56,0.671647000,0.0000
198.34.203.242,<->,50.224.76.230,0,0,1,56,1,56,0.670594000,0.0000
215.158.239.76,<->,143.91.230.145,1,50,0,0,1,50,0.670305000,0.0000
197.113.99.238,<->,136.25.188.241,0,0,1,56,1,56,0.670039000,0.0000
144.85.170.208,<->,91.69.181.15,1,56,0,0,1,56,0.669614000,0.0000
215.158.140.162,<->,106.188.254.183,1,192,0,0,1,192,0.669377000,0.0000
98.128.226.115,<->,8.55.224.156,1,56,0,0,1,56,0.669353000,0.0000
112.136.164.234,<->,50.224.76.235,0,0,1,50,1,50,0.669100000,0.0000
144.85.170.254,<->,98.87.146.247,1,56,0,0,1,56,0.668572000,0.0000
221.102.143.189,<->,98.128.164.99,0,0,1,141,1,141,0.667851000,0.0000
98.236.90.195,<->,93.254.7.61,1,50,0,0,1,50,0.667386000,0.0000
207.57.138.227,<->,136.25.188.163,0,0,1,50,1,50,0.667236000,0.0000
215.158.239.57,<->,195.4.4.181,1,50,0,0,1,50,0.666386000,0.0000
100.112.36.136,<->,8.52.188.77,0,0,1,56,1,56,0.666098000,0.0000
132.216.20.184,<->,80.40.43.127,0,0,1,56,1,56,0.665797000,0.0000
220.28.65.9,<->,215.158.140.248,0,0,1,56,1,56,0.665734000,0.0000
143.135.193.209,<->,136.25.188.238,0,0,1,56,1,56,0.665650000,0.0000
136.25.189.27,<->,100.216.78.145,1,56,0,0,1,56,0.665261000,0.0000
139.163.95.3,<->,97.227.196.236,1,56,0,0,1,56,0.665057000,0.0000
136.25.189.202,<->,129.222.39.121,1,56,0,0,1,56,0.664137000,0.0000
210.209.251.214,<->,111.147.131.97,0,0,1,50,1,50,0.664069000,0.0000
144.87.238.89,<->,8.182.243.35,0,0,1,50,1,50,0.663904000,0.0000
17.240.3.26,<->,8.220.188.138,0,0,1,56,1,56,0.663312000,0.0000
139.193.141.137,<->,17.41.67.243,1,56,0,0,1,56,0.662943000,0.0000
136.25.188.239,<->,98.195.175.99,1,56,0,0,1,56,0.662820000,0.0000
221.196.123.201,<->,138.98.250.43,0,0,1,56,1,56,0.661968000,0.0000
215.158.239.92,<->,142.229.173.174,1,56,0,0,1,56,0.660896000,0.0000
243.49.83.90,<->,101.126.186.60,0,0,1,555,1,555,0.659519000,0.0000
122.213.95.243,<->,50.224.76.235,0,0,1,56,1,56,0.658582000,0.0000
215.158.239.78,<->,195.126.181.14,1,56,0,0,1,56,0.658238000,0.0000
136.25.189.196,<->,129.222.36.164,1,56,0,0,1,56,0.658062000,0.0000
159.137.162.213,<->,117.20.151.128,1,50,0,0,1,50,0.657485000,0.0000
221.102.143.189,<->,109.3.178.60,0,0,1,141,1,141,0.657481000,0.0000
142.236.163.250,<->,136.25.188.175,0,0,1,56,1,56,0.655901000,0.0000
199.73.44.127,<->,136.25.188.253,0,0,1,56,1,56,0.654475000,0.0000
144.85.170.208,<->,98.87.147.134,1,56,0,0,1,56,0.654441000,0.0000
137.231.32.86,<->,89.139.241.201,0,0,1,56,1,56,0.654154000,0.0000
204.200.34.12,<->,136.25.188.163,0,0,1,56,1,56,0.653961000,0.0000
199.83.222.225,<->,136.25.188.173,0,0,1,50,1,50,0.653768000,0.0000
99.187.125.122,<->,8.20.87.3,0,0,1,56,1,56,0.653567000,0.0000
132.200.63.92,<->,132.200.62.136,0,0,1,56,1,56,0.653419000,0.0000
54.37.5.99,<->,48.53.34.202,0,0,1,56,1,56,0.653012000,0.0000
220.20.200.69,<->,53.231.26.246,1,50,0,0,1,50,0.651769000,0.0000
69.103.229.5,<->,8.252.222.159,0,0,1,56,1,56,0.650941000,0.0000
215.158.28.178,<->,111.27.225.31,1,50,0,0,1,50,0.650878000,0.0000
196.89.74.120,<->,136.25.188.163,0,0,1,56,1,56,0.650207000,0.0000
195.6.38.82,<->,136.25.188.252,0,0,1,56,1,56,0.650166000,0.0000
192.204.191.129,<->,133.32.39.0,0,0,1,56,1,56,0.649978000,0.0000
152.46.83.147,<->,80.27.158.136,0,0,1,125,1,125,0.649914000,0.0000
136.25.188.49,<->,80.57.141.179,1,56,0,0,1,56,0.649392000,0.0000
89.204.173.123,<->,80.38.57.225,0,0,1,56,1,56,0.649346000,0.0000
17.26.173.37,<->,8.220.178.203,0,0,1,50,1,50,0.649009000,0.0000
56.9.244.173,<->,8.182.241.53,0,0,1,56,1,56,0.648973000,0.0000
133.0.57.72,<->,56.121.54.13,0,0,1,56,1,56,0.648965000,0.0000
139.163.121.135,<->,97.68.91.46,1,56,0,0,1,56,0.648895000,0.0000
136.25.188.46,<->,84.209.172.217,1,56,0,0,1,56,0.648844000,0.0000
206.176.132.3,<->,80.38.41.203,0,0,1,50,1,50,0.647724000,0.0000
213.221.90.199,<->,144.85.170.244,0,0,1,56,1,56,0.647700000,0.0000
89.216.124.92,<->,8.235.214.225,1,50,0,0,1,50,0.647275000,0.0000
100.212.92.208,<->,97.126.31.86,0,0,1,56,1,56,0.646948000,0.0000
215.158.238.176,<->,106.188.251.41,1,56,0,0,1,56,0.646849000,0.0000
231.255.128.157,<->,97.198.123.121,0,0,1,56,1,56,0.646829000,0.0000
138.127.205.200,<->,109.222.255.204,0,0,1,50,1,50,0.646587000,0.0000
136.25.188.163,<->,84.209.172.217,1,56,0,0,1,56,0.646222000,0.0000
104.233.173.202,<->,50.224.76.248,0,0,1,56,1,56,0.646191000,0.0000
50.224.76.235,<->,48.129.85.217,1,56,0,0,1,56,0.645470000,0.0000
215.158.140.216,<->,91.42.195.239,1,56,0,0,1,56,0.645438000,0.0000
138.121.99.24,<->,8.220.188.50,0,0,1,50,1,50,0.645116000,0.0000
8.222.212.2,<->,8.43.183.182,0,0,1,56,1,56,0.644933000,0.0000
221.102.143.189,<->,192.66.172.117,0,0,1,141,1,141,0.644878000,0.0000
136.25.188.162,<->,48.52.231.159,1,50,0,0,1,50,0.644858000,0.0000
93.181.154.76,<->,92.27.219.217,0,0,1,50,1,50,0.644045000,0.0000
238.118.126.42,<->,56.96.128.220,1,56,0,0,1,56,0.643747000,0.0000
195.42.112.159,<->,136.25.188.53,0,0,1,50,1,50,0.642557000,0.0000
92.27.219.253,<->,50.97.8.241,1,50,0,0,1,50,0.642555000,0.0000
143.54.161.12,<->,8.20.87.153,0,0,1,56,1,56,0.642165000,0.0000
80.27.157.212,<->,75.94.224.161,1,56,0,0,1,56,0.641234000,0.0000
210.220.219.152,<->,53.249.54.97,1,267,0,0,1,267,0.641066000,0.0000
199.33.59.225,<->,136.25.188.178,0,0,1,87,1,87,0.641007000,0.0000
215.158.239.78,<->,199.79.54.21,1,56,0,0,1,56,0.640996000,0.0000
136.25.189.202,<->,129.222.39.127,1,56,0,0,1,56,0.640700000,0.0000
194.194.108.97,<->,50.223.3.228,0,0,1,56,1,56,0.639821000,0.0000
196.17.240.209,<->,50.224.76.234,0,0,1,50,1,50,0.639634000,0.0000
100.93.185.72,<->,8.55.224.156,1,141,0,0,1,141,0.638740000,0.0000
220.28.73.211,<->,215.158.239.66,0,0,1,56,1,56,0.638520000,0.0000
210.236.205.21,<->,139.163.121.135,0,0,1,56,1,56,0.638505000,0.0000
204.200.63.242,<->,136.25.188.254,0,0,1,50,1,50,0.638060000,0.0000
159.137.162.213,<->,108.0.246.252,1,50,0,0,1,50,0.637933000,0.0000
231.142.215.70,<->,215.158.239.51,0,0,1,50,1,50,0.637259000,0.0000
198.146.28.67,<->,138.98.237.239,0,0,1,50,1,50,0.636616000,0.0000
139.163.96.101,<->,136.98.131.10,1,56,0,0,1,56,0.636119000,0.0000
215.158.239.96,<->,207.115.153.176,1,56,0,0,1,56,0.635749000,0.0000
205.247.108.183,<->,92.27.27.160,0,0,1,50,1,50,0.634785000,0.0000
199.82.242.44,<->,136.25.188.209,0,0,1,56,1,56,0.634618000,0.0000
230.156.223.131,<->,8.252.222.174,0,0,1,56,1,56,0.634474000,0.0000
141.15.11.120,<->,97.149.24.218,0,0,1,535,1,535,0.634362000,0.0000
215.158.239.113,<->,129.222.36.33,1,56,0,0,1,56,0.634336000,0.0000
54.37.202.190,<->,48.53.136.46,0,0,1,50,1,50,0.634193000,0.0000
220.81.6.61,<->,8.55.221.148,1,50,0,0,1,50,0.633964000,0.0000
92.27.219.189,<->,33.57.78.125,1,50,0,0,1,50,0.633947000,0.0000
198.70.5.37,<->,89.183.110.193,0,0,1,56,1,56,0.633893000,0.0000
215.158.239.56,<->,199.20.30.122,1,56,0,0,1,56,0.632839000,0.0000
129.47.116.119,<->,98.232.172.137,0,0,1,56,1,56,0.632834000,0.0000
224.93.21.36,<->,8.52.222.23,0,0,1,50,1,50,0.632091000,0.0000
215.158.239.95,<->,207.188.25.110,1,56,0,0,1,56,0.631747000,0.0000
215.158.239.76,<->,207.16.32.235,1,56,0,0,1,56,0.631207000,0.0000
96.76.243.91,<->,50.224.76.234,0,0,1,56,1,56,0.630982000,0.0000
195.64.121.91,<->,50.223.3.228,0,0,1,50,1,50,0.630957000,0.0000
142.223.144.174,<->,136.25.188.252,0,0,1,56,1,56,0.630458000,0.0000
247.236.195.202,<->,133.32.39.0,0,0,1,56,1,56,0.630192000,0.0000
195.42.213.87,<->,136.25.188.209,0,0,1,50,1,50,0.630189000,0.0000
215.158.239.93,<->,199.20.29.220,1,56,0,0,1,56,0.629890000,0.0000
132.119.137.71,<->,80.27.158.183,0,0,1,56,1,56,0.629257000,0.0000
215.158.239.205,<->,148.140.162.140,1,56,0,0,1,56,0.628954000,0.0000
199.69.133.234,<->,136.25.188.226,0,0,1,56,1,56,0.628703000,0.0000
231.143.159.131,<->,136.25.188.162,0,0,1,56,1,56,0.628426000,0.0000
120.221.114.218,<->,89.183.104.250,0,0,1,50,1,50,0.628353000,0.0000
215.158.239.56,<->,143.132.118.97,1,50,0,0,1,50,0.628032000,0.0000
215.158.239.30,<->,100.166.21.52,1,56,0,0,1,56,0.628000000,0.0000
215.158.239.92,<->,199.20.30.119,1,56,0,0,1,56,0.627776000,0.0000
146.249.227.87,<->,8.252.221.223,0,0,1,56,1,56,0.627769000,0.0000
129.224.112.220,<->,97.242.126.205,1,56,0,0,1,56,0.627495000,0.0000
142.190.126.17,<->,136.25.188.160,0,0,1,50,1,50,0.627396000,0.0000
215.158.239.93,<->,204.226.53.177,1,56,0,0,1,56,0.627155000,0.0000
215.158.238.102,<->,145.116.209.71,1,56,0,0,1,56,0.626280000,0.0000
215.158.140.228,<->,83.231.251.124,1,50,0,0,1,50,0.625580000,0.0000
136.25.188.46,<->,41.129.198.194,1,56,0,0,1,56,0.624564000,0.0000
194.206.223.38,<->,8.182.227.180,0,0,1,50,1,50,0.624075000,0.0000
195.14.45.24,<->,136.25.188.162,0,0,1,56,1,56,0.623918000,0.0000
50.51.186.123,<->,8.220.189.156,0,0,1,56,1,56,0.623615000,0.0000
139.193.141.139,<->,122.212.85.246,1,56,0,0,1,56,0.623520000,0.0000
50.224.76.235,<->,29.95.130.169,1,50,0,0,1,50,0.623006000,0.0000
215.158.239.113,<->,129.222.39.114,1,56,0,0,1,56,0.621477000,0.0000
220.20.200.123,<->,210.60.25.92,1,50,0,0,1,50,0.621166000,0.0000
143.42.236.181,<->,136.25.188.241,0,0,1,50,1,50,0.620049000,0.0000
108.41.82.75,<->,8.220.190.86,0,0,1,56,1,56,0.619990000,0.0000
220.55.106.26,<->,148.91.130.202,1,50,0,0,1,50,0.619867000,0.0000
142.174.234.224,<->,8.52.175.115,0,0,1,56,1,56,0.617654000,0.0000
215.158.239.99,<->,199.20.28.83,1,56,0,0,1,56,0.617567000,0.0000
36.123.54.244,<->,8.20.87.32,0,0,1,56,1,56,0.617382000,0.0000
215.158.140.27,<->,88.1.225.159,1,56,0,0,1,56,0.617015000,0.0000
215.158.238.153,<->,139.163.161.62,1,56,0,0,1,56,0.615635000,0.0000
141.15.18.19,<->,111.147.79.227,0,0,1,50,1,50,0.615496000,0.0000
204.63.54.20,<->,136.25.188.197,0,0,1,56,1,56,0.615484000,0.0000
206.197.147.242,<->,50.224.76.235,0,0,1,56,1,56,0.615358000,0.0000
221.102.143.189,<->,220.80.8.7,0,0,1,141,1,141,0.615337000,0.0000
132.180.38.22,<->,8.220.202.4,0,0,1,50,1,50,0.615301000,0.0000
133.244.31.122,<->,80.27.154.173,1,50,0,0,1,50,0.615166000,0.0000
216.184.1.91,<->,8.252.222.170,0,0,1,56,1,56,0.613771000,0.0000
215.158.30.254,<->,8.252.222.55,0,0,1,56,1,56,0.613241000,0.0000
215.158.239.58,<->,196.95.63.215,1,56,0,0,1,56,0.613097000,0.0000
207.4.95.36,<->,8.220.178.73,0,0,1,50,1,50,0.612876000,0.0000
207.4.95.36,<->,8.52.187.74,0,0,1,50,1,50,0.612667000,0.0000
194.218.12.122,<->,8.182.243.89,0,0,1,56,1,56,0.612299000,0.0000
142.244.64.7,<->,136.25.188.52,0,0,1,50,1,50,0.612176000,0.0000
145.118.57.252,<->,133.32.39.0,0,0,1,50,1,50,0.612041000,0.0000
246.108.91.178,<->,145.252.114.80,0,0,1,56,1,56,0.611528000,0.0000
215.158.239.84,<->,196.109.217.85,1,56,0,0,1,56,0.611215000,0.0000
207.4.95.36,<->,8.52.180.22,0,0,1,50,1,50,0.610967000,0.0000
199.11.106.188,<->,111.181.118.27,0,0,1,50,1,50,0.610398000,0.0000
48.17.37.157,<->,8.252.221.197,0,0,1,56,1,56,0.610377000,0.0000
139.163.7.121,<->,129.123.156.38,1,50,0,0,1,50,0.609341000,0.0000
194.237.96.103,<->,136.25.188.46,0,0,1,56,1,56,0.609225000,0.0000
136.25.188.223,<->,122.159.245.157,1,56,0,0,1,56,0.608156000,0.0000
207.179.110.12,<->,50.224.76.234,0,0,1,50,1,50,0.607697000,0.0000
141.57.70.80,<->,92.27.219.175,0,0,1,50,1,50,0.607677000,0.0000
93.151.122.182,<->,50.224.76.234,0,0,1,56,1,56,0.607403000,0.0000
221.102.143.189,<->,80.41.54.222,0,0,1,141,1,141,0.607111000,0.0000
79.210.154.10,<->,50.224.76.234,0,0,1,56,1,56,0.606868000,0.0000
98.67.131.24,<->,53.189.131.169,1,56,0,0,1,56,0.605848000,0.0000
220.55.100.127,<->,220.20.202.66,1,50,0,0,1,50,0.605149000,0.0000
97.126.18.95,<->,56.114.235.120,1,1501,0,0,1,1501,0.604920000,0.0000
98.23.123.93,<->,8.252.222.221,0,0,1,50,1,50,0.604781000,0.0000
136.25.189.94,<->,8.203.24.137,1,56,0,0,1,56,0.604747000,0.0000
92.27.194.117,<->,40.220.45.84,1,50,0,0,1,50,0.604736000,0.0000
221.102.56.69,<->,136.181.39.23,0,0,1,56,1,56,0.603953000,0.0000
197.113.99.218,<->,136.25.188.238,0,0,1,56,1,56,0.603871000,0.0000
159.137.162.213,<->,112.9.227.40,1,50,0,0,1,50,0.603856000,0.0000
146.249.226.233,<->,8.252.222.173,0,0,1,56,1,56,0.603802000,0.0000
97.126.13.83,<->,54.52.207.31,1,50,0,0,1,50,0.603582000,0.0000
145.118.217.235,<->,8.43.155.172,0,0,1,56,1,56,0.603441000,0.0000
149.40.27.174,<->,50.224.76.235,0,0,1,56,1,56,0.601799000,0.0000
215.158.239.49,<->,195.80.132.108,1,56,0,0,1,56,0.601625000,0.0000
195.71.154.29,<->,136.25.188.243,0,0,1,50,1,50,0.601347000,0.0000
129.78.116.178,<->,76.100.65.212,1,50,0,0,1,50,0.600712000,0.0000
144.85.170.208,<->,91.69.181.135,1,56,0,0,1,56,0.600665000,0.0000
221.102.56.46,<->,109.3.156.160,0,0,1,56,1,56,0.600569000,0.0000
199.48.57.141,<->,8.252.222.36,0,0,1,56,1,56,0.599906000,0.0000
143.13.155.13,<->,136.25.188.242,0,0,1,56,1,56,0.599796000,0.0000
110.65.202.237,<->,50.224.76.235,0,0,1,56,1,56,0.599588000,0.0000
215.158.239.95,<->,195.54.42.181,1,50,0,0,1,50,0.598923000,0.0000
220.7.96.19,<->,139.163.41.64,0,0,1,56,1,56,0.598732000,0.0000
197.113.99.185,<->,136.25.188.252,0,0,1,56,1,56,0.597686000,0.0000
142.254.64.146,<->,136.25.188.163,0,0,1,56,1,56,0.597610000,0.0000
142.241.156.114,<->,136.25.188.46,0,0,1,56,1,56,0.597045000,0.0000
215.158.239.84,<->,204.226.36.241,1,56,0,0,1,56,0.596717000,0.0000
195.5.57.247,<->,136.25.188.53,0,0,1,50,1,50,0.595886000,0.0000
29.90.217.22,<->,8.31.37.160,0,0,1,50,1,50,0.595719000,0.0000
69.246.61.13,<->,8.252.223.162,0,0,1,50,1,50,0.595528000,0.0000
215.158.140.13,<->,89.64.25.113,1,56,0,0,1,56,0.595485000,0.0000
54.39.227.121,<->,48.55.119.121,0,0,1,50,1,50,0.595184000,0.0000
213.186.52.9,<->,144.85.170.254,0,0,1,56,1,56,0.595092000,0.0000
143.134.194.117,<->,136.25.188.220,0,0,1,50,1,50,0.594053000,0.0000
199.15.22.26,<->,136.25.188.163,0,0,1,56,1,56,0.593430000,0.0000
131.158.117.199,<->,50.224.76.248,0,0,1,50,1,50,0.593346000,0.0000
204.61.153.82,<->,136.25.188.46,0,0,1,56,1,56,0.592212000,0.0000
97.53.94.59,<->,8.182.224.248,0,0,1,50,1,50,0.592022000,0.0000
196.247.213.16,<->,136.25.188.52,0,0,1,56,1,56,0.591237000,0.0000
215.158.239.58,<->,199.20.29.103,1,56,0,0,1,56,0.589644000,0.0000
215.158.239.244,<->,145.234.107.201,1,56,0,0,1,56,0.589136000,0.0000
120.83.221.8,<->,92.162.252.202,0,0,1,50,1,50,0.589027000,0.0000
215.158.239.48,<->,196.92.69.204,1,56,0,0,1,56,0.588756000,0.0000
215.158.239.70,<->,199.20.28.46,1,56,0,0,1,56,0.587799000,0.0000
222.31.62.153,<->,8.52.182.119,0,0,1,50,1,50,0.587640000,0.0000
246.254.97.229,<->,206.243.231.162,1,50,0,0,1,50,0.587493000,0.0000
221.102.56.69,<->,220.80.238.103,0,0,1,56,1,56,0.587355000,0.0000
215.158.239.84,<->,199.20.23.105,1,56,0,0,1,56,0.587155000,0.0000
215.158.239.92,<->,143.44.172.165,1,50,0,0,1,50,0.586718000,0.0000
205.187.74.216,<->,109.1.18.115,0,0,1,50,1,50,0.585920000,0.0000
131.45.239.182,<->,92.162.253.146,0,0,1,50,1,50,0.585332000,0.0000
122.195.239.38,<->,8.182.136.169,0,0,1,56,1,56,0.584855000,0.0000
207.56.56.235,<->,136.25.188.45,0,0,1,50,1,50,0.584719000,0.0000
221.102.143.189,<->,220.81.19.4,0,0,1,141,1,141,0.584223000,0.0000
98.129.68.142,<->,8.45.168.98,1,87,0,0,1,87,0.584046000,0.0000
215.158.239.93,<->,194.251.93.183,1,50,0,0,1,50,0.584017000,0.0000
127.168.165.134,<->,8.176.8.232,0,0,1,56,1,56,0.583510000,0.0000
215.158.239.85,<->,143.44.172.165,1,50,0,0,1,50,0.583216000,0.0000
204.21.42.77,<->,136.25.188.178,0,0,1,50,1,50,0.583169000,0.0000
195.22.148.17,<->,50.224.76.235,0,0,1,50,1,50,0.582863000,0.0000
199.121.8.9,<->,136.25.188.224,0,0,1,56,1,56,0.581635000,0.0000
221.102.143.189,<->,102.83.236.228,0,0,1,141,1,141,0.580885000,0.0000
215.158.140.27,<->,48.114.160.224,1,56,0,0,1,56,0.579750000,0.0000
36.123.55.226,<->,8.20.87.32,0,0,1,56,1,56,0.579122000,0.0000
215.158.238.64,<->,122.159.245.163,1,56,0,0,1,56,0.578769000,0.0000
195.41.226.218,<->,136.25.188.222,0,0,1,56,1,56,0.577702000,0.0000
215.158.239.86,<->,194.199.196.220,1,56,0,0,1,56,0.577426000,0.0000
80.27.155.117,<->,78.46.139.109,1,50,0,0,1,50,0.577243000,0.0000
139.163.169.232,<->,133.178.226.234,0,0,1,56,1,56,0.576739000,0.0000
159.137.162.213,<->,117.39.53.205,1,50,0,0,1,50,0.576583000,0.0000
50.224.76.234,<->,33.135.86.33,1,56,0,0,1,56,0.576476000,0.0000
215.158.239.76,<->,199.20.29.229,1,56,0,0,1,56,0.576209000,0.0000
207.239.46.135,<->,136.25.188.198,0,0,1,56,1,56,0.575613000,0.0000
143.53.71.132,<->,136.25.188.209,0,0,1,56,1,56,0.575466000,0.0000
199.33.65.22,<->,136.25.188.163,0,0,1,56,1,56,0.575291000,0.0000
215.158.239.68,<->,199.20.31.109,1,93,0,0,1,93,0.575213000,0.0000
50.224.76.235,<->,29.91.23.23,1,50,0,0,1,50,0.574936000,0.0000
144.85.170.208,<->,144.61.1.168,1,56,0,0,1,56,0.574915000,0.0000
143.10.172.12,<->,136.25.188.253,0,0,1,56,1,56,0.574542000,0.0000
142.241.170.28,<->,136.25.188.252,0,0,1,50,1,50,0.574539000,0.0000
133.32.39.1,<->,8.45.242.87,1,56,0,0,1,56,0.574212000,0.0000
142.240.128.222,<->,136.25.188.176,0,0,1,56,1,56,0.573842000,0.0000
48.115.165.110,<->,8.252.221.221,0,0,1,56,1,56,0.573752000,0.0000
215.158.239.99,<->,143.44.172.165,1,50,0,0,1,50,0.573650000,0.0000
101.70.112.204,<->,8.232.214.178,1,56,0,0,1,56,0.572744000,0.0000
92.26.148.165,<->,14.124.15.109,0,0,1,50,1,50,0.572446000,0.0000
133.244.28.235,<->,42.197.145.216,1,50,0,0,1,50,0.571904000,0.0000
215.158.239.84,<->,195.96.156.37,1,56,0,0,1,56,0.571696000,0.0000
246.253.253.170,<->,210.231.140.55,1,50,0,0,1,50,0.571122000,0.0000
101.126.189.91,<->,8.55.209.213,1,56,0,0,1,56,0.570910000,0.0000
215.158.140.27,<->,159.194.55.144,1,56,0,0,1,56,0.570623000,0.0000
159.228.245.125,<->,159.137.208.5,0,0,1,50,1,50,0.570364000,0.0000
136.25.188.49,<->,80.57.141.130,1,56,0,0,1,56,0.569891000,0.0000
218.4.179.37,<->,159.42.43.102,1,56,0,0,1,56,0.569677000,0.0000
197.7.105.28,<->,8.182.243.141,0,0,1,56,1,56,0.569099000,0.0000
192.67.159.184,<->,109.219.207.0,1,331,0,0,1,331,0.568878000,0.0000
17.90.64.205,<->,8.220.190.86,0,0,1,56,1,56,0.568594000,0.0000
221.102.143.189,<->,213.38.156.109,0,0,1,141,1,141,0.568469000,0.0000
142.207.206.132,<->,136.25.188.237,0,0,1,50,1,50,0.567606000,0.0000
192.64.217.166,<->,122.109.241.138,1,50,0,0,1,50,0.567191000,0.0000
207.92.28.168,<->,8.182.139.197,0,0,1,50,1,50,0.566574000,0.0000
136.25.188.176,<->,100.200.67.242,1,50,0,0,1,50,0.566541000,0.0000
204.56.119.73,<->,136.25.188.225,0,0,1,50,1,50,0.566168000,0.0000
109.1.61.223,<->,92.27.27.143,0,0,1,56,1,56,0.565877000,0.0000
207.188.104.86,<->,136.25.188.222,0,0,1,56,1,56,0.565373000,0.0000
136.25.188.52,<->,30.73.98.18,1,50,0,0,1,50,0.565158000,0.0000
215.158.239.96,<->,195.13.169.16,1,93,0,0,1,93,0.564270000,0.0000
207.127.112.235,<->,92.27.194.147,0,0,1,56,1,56,0.564170000,0.0000
142.189.65.141,<->,8.20.87.153,0,0,1,56,1,56,0.563887000,0.0000
221.102.56.46,<->,91.251.114.196,0,0,1,703,1,703,0.563309000,0.0000
194.244.41.92,<->,50.224.76.235,0,0,1,50,1,50,0.563305000,0.0000
194.237.250.31,<->,136.25.188.238,0,0,1,56,1,56,0.563133000,0.0000
215.158.239.56,<->,199.51.230.198,1,50,0,0,1,50,0.561804000,0.0000
207.62.38.16,<->,136.25.188.241,0,0,1,56,1,56,0.561038000,0.0000
136.25.188.220,<->,8.227.55.243,1,56,0,0,1,56,0.560472000,0.0000
144.85.170.208,<->,91.69.181.254,1,56,0,0,1,56,0.559980000,0.0000
220.55.113.56,<->,98.219.125.164,1,50,0,0,1,50,0.559972000,0.0000
239.66.108.231,<->,196.148.120.168,0,0,1,50,1,50,0.559253000,0.0000
115.161.92.138,<->,50.224.76.248,0,0,1,50,1,50,0.559240000,0.0000
197.7.112.170,<->,50.223.3.228,0,0,1,56,1,56,0.559215000,0.0000
195.125.11.138,<->,136.25.188.255,0,0,1,56,1,56,0.558596000,0.0000
220.20.200.140,<->,53.231.25.14,1,50,0,0,1,50,0.558148000,0.0000
215.158.239.77,<->,199.20.30.197,1,56,0,0,1,56,0.558101000,0.0000
215.158.239.181,<->,57.210.104.90,1,56,0,0,1,56,0.558039000,0.0000
195.12.2.213,<->,136.25.188.198,0,0,1,89,1,89,0.557598000,0.0000
143.132.56.155,<->,136.25.188.254,0,0,1,56,1,56,0.556943000,0.0000
50.224.76.235,<->,38.30.94.85,1,50,0,0,1,50,0.556930000,0.0000
220.55.96.175,<->,93.147.226.157,1,50,0,0,1,50,0.556803000,0.0000
231.140.192.100,<->,136.25.188.178,0,0,1,56,1,56,0.555730000,0.0000
215.158.239.51,<->,204.56.169.160,1,56,0,0,1,56,0.555699000,0.0000
215.158.140.27,<->,207.88.93.31,1,56,0,0,1,56,0.555606000,0.0000
108.35.240.113,<->,8.52.136.119,0,0,1,50,1,50,0.555531000,0.0000
53.161.254.252,<->,48.54.131.41,0,0,1,93,1,93,0.555424000,0.0000
213.221.90.129,<->,144.85.170.208,0,0,1,56,1,56,0.555104000,0.0000
223.115.93.132,<->,8.252.222.23,0,0,1,56,1,56,0.554281000,0.0000
142.248.11.171,<->,136.25.188.163,0,0,1,50,1,50,0.554219000,0.0000
101.126.187.24,<->,8.55.231.92,1,56,0,0,1,56,0.553881000,0.0000
195.13.157.194,<->,136.25.188.240,0,0,1,50,1,50,0.553731000,0.0000
159.0.4.237,<->,136.25.188.173,0,0,1,56,1,56,0.553562000,0.0000
136.25.188.46,<->,92.57.203.84,1,56,0,0,1,56,0.553462000,0.0000
207.178.51.137,<->,50.224.96.57,0,0,1,50,1,50,0.553267000,0.0000
199.32.189.22,<->,136.25.188.178,0,0,1,56,1,56,0.553154000,0.0000
220.50.242.218,<->,101.70.127.229,0,0,1,256,1,256,0.552116000,0.0000
143.42.41.80,<->,136.25.188.226,0,0,1,56,1,56,0.551438000,0.0000
143.42.41.80,<->,136.25.188.177,0,0,1,56,1,56,0.550864000,0.0000
215.158.239.92,<->,207.191.103.111,1,56,0,0,1,56,0.550815000,0.0000
143.128.136.111,<->,136.25.188.238,0,0,1,50,1,50,0.550560000,0.0000
199.116.164.175,<->,50.223.3.228,0,0,1,56,1,56,0.550491000,0.0000
136.181.46.200,<->,53.240.9.138,1,50,0,0,1,50,0.550200000,0.0000
141.118.203.107,<->,8.252.221.198,0,0,1,50,1,50,0.549879000,0.0000
215.158.239.58,<->,194.238.200.253,1,50,0,0,1,50,0.549703000,0.0000
99.215.70.35,<->,8.182.251.218,0,0,1,50,1,50,0.549528000,0.0000
99.168.205.8,<->,8.52.148.157,0,0,1,50,1,50,0.549360000,0.0000
249.101.113.138,<->,144.95.111.109,1,67,0,0,1,67,0.548653000,0.0000
195.5.243.115,<->,136.25.188.46,0,0,1,50,1,50,0.548412000,0.0000
199.123.182.73,<->,136.25.188.54,0,0,1,56,1,56,0.548194000,0.0000
247.136.209.19,<->,74.249.86.136,1,56,0,0,1,56,0.548025000,0.0000
215.158.239.49,<->,199.20.31.241,1,56,0,0,1,56,0.547172000,0.0000
133.32.39.0,<->,8.193.178.56,1,56,0,0,1,56,0.547118000,0.0000
215.158.140.19,<->,129.222.39.232,1,56,0,0,1,56,0.547102000,0.0000
207.63.119.212,<->,136.25.188.238,0,0,1,50,1,50,0.547067000,0.0000
136.25.188.248,<->,100.224.202.178,1,56,0,0,1,56,0.545898000,0.0000
27.11.210.203,<->,8.220.176.253,0,0,1,56,1,56,0.545787000,0.0000
113.22.2.222,<->,100.228.42.100,0,0,1,56,1,56,0.544833000,0.0000
142.190.91.222,<->,136.25.188.236,0,0,1,50,1,50,0.544612000,0.0000
119.111.182.206,<->,50.224.76.234,0,0,1,50,1,50,0.543729000,0.0000
144.85.170.208,<->,91.69.181.227,1,56,0,0,1,56,0.543070000,0.0000
97.126.113.142,<->,53.180.104.211,1,50,0,0,1,50,0.543017000,0.0000
195.15.140.54,<->,136.25.188.53,0,0,1,56,1,56,0.542752000,0.0000
92.27.219.184,<->,78.44.15.199,1,50,0,0,1,50,0.542692000,0.0000
215.158.239.76,<->,196.1.201.10,1,56,0,0,1,56,0.542284000,0.0000
215.158.239.95,<->,199.20.31.7,1,56,0,0,1,56,0.541429000,0.0000
136.114.101.18,<->,136.25.188.48,0,0,1,56,1,56,0.541315000,0.0000
215.158.239.57,<->,199.20.115.146,1,50,0,0,1,50,0.541115000,0.0000
215.158.49.86,<->,136.116.28.234,0,0,1,56,1,56,0.541089000,0.0000
100.115.92.194,<->,97.110.90.36,1,56,0,0,1,56,0.540816000,0.0000
80.38.16.208,<->,36.116.107.116,1,50,0,0,1,50,0.540579000,0.0000
213.186.52.51,<->,144.85.170.254,0,0,1,56,1,56,0.539267000,0.0000
215.158.239.48,<->,199.20.7.109,1,56,0,0,1,56,0.539249000,0.0000
133.32.39.0,<->,8.193.74.162,1,56,0,0,1,56,0.538973000,0.0000
215.158.239.50,<->,196.107.166.42,1,56,0,0,1,56,0.538844000,0.0000
144.85.170.254,<->,91.69.185.225,1,56,0,0,1,56,0.538584000,0.0000
204.200.63.254,<->,136.25.188.236,0,0,1,56,1,56,0.538311000,0.0000
196.247.213.16,<->,136.25.188.45,0,0,1,56,1,56,0.538147000,0.0000
215.158.239.51,<->,143.42.41.80,1,56,0,0,1,56,0.538127000,0.0000
215.158.140.27,<->,84.209.160.103,1,56,0,0,1,56,0.538122000,0.0000
138.74.30.197,<->,53.195.230.83,1,50,0,0,1,50,0.538087000,0.0000
215.158.239.93,<->,199.20.6.209,1,56,0,0,1,56,0.538040000,0.0000
215.158.239.36,<->,56.115.251.18,1,56,0,0,1,56,0.537801000,0.0000
215.158.239.93,<->,207.166.174.122,1,56,0,0,1,56,0.537342000,0.0000
230.76.194.65,<->,220.81.23.25,0,0,1,334,1,334,0.536942000,0.0000
215.158.239.57,<->,199.20.63.97,1,56,0,0,1,56,0.536269000,0.0000
204.200.32.173,<->,136.25.188.252,0,0,1,50,1,50,0.535247000,0.0000
133.178.226.224,<->,113.207.61.212,1,56,0,0,1,56,0.534938000,0.0000
93.183.125.243,<->,92.162.253.128,0,0,1,1107,1,1107,0.534276000,0.0000
119.45.4.11,<->,92.162.253.75,0,0,1,50,1,50,0.533810000,0.0000
201.205.10.52,<->,144.88.76.44,0,0,1,50,1,50,0.533627000,0.0000
199.72.33.151,<->,136.25.188.198,0,0,1,56,1,56,0.533556000,0.0000
195.71.132.1,<->,136.25.188.253,0,0,1,50,1,50,0.533036000,0.0000
17.228.210.76,<->,8.220.190.86,0,0,1,56,1,56,0.532575000,0.0000
136.123.45.60,<->,8.52.183.96,0,0,1,56,1,56,0.532069000,0.0000
143.155.227.59,<->,136.25.188.225,0,0,1,56,1,56,0.531330000,0.0000
215.158.239.58,<->,199.68.125.89,1,56,0,0,1,56,0.530935000,0.0000
220.20.200.33,<->,127.62.25.159,1,50,0,0,1,50,0.530708000,0.0000
231.140.144.102,<->,136.25.188.220,0,0,1,50,1,50,0.530341000,0.0000
129.68.193.194,<->,8.220.188.50,0,0,1,50,1,50,0.530160000,0.0000
232.31.246.42,<->,139.193.141.139,0,0,1,56,1,56,0.530106000,0.0000
136.25.189.47,<->,29.211.5.81,1,56,0,0,1,56,0.529735000,0.0000
199.15.240.242,<->,136.25.188.241,0,0,1,50,1,50,0.529668000,0.0000
109.93.139.198,<->,8.220.189.63,0,0,1,50,1,50,0.529594000,0.0000
145.11.91.233,<->,50.224.76.235,0,0,1,50,1,50,0.528674000,0.0000
221.102.56.46,<->,192.67.169.78,0,0,1,56,1,56,0.528461000,0.0000
132.152.144.120,<->,50.224.76.235,0,0,1,50,1,50,0.528183000,0.0000
199.38.118.206,<->,136.25.188.237,0,0,1,56,1,56,0.527291000,0.0000
215.158.239.56,<->,199.20.29.163,1,56,0,0,1,56,0.526435000,0.0000
69.246.48.221,<->,8.252.222.49,0,0,1,50,1,50,0.525029000,0.0000
138.98.197.173,<->,89.183.98.97,1,50,0,0,1,50,0.524969000,0.0000
205.104.181.26,<->,100.93.115.150,0,0,1,50,1,50,0.524298000,0.0000
117.7.29.229,<->,50.224.76.234,0,0,1,56,1,56,0.524275000,0.0000
215.158.140.240,<->,57.210.104.91,1,56,0,0,1,56,0.523846000,0.0000
75.31.150.242,<->,8.252.221.198,0,0,1,50,1,50,0.522949000,0.0000
100.92.54.183,<->,22.5.212.226,1,50,0,0,1,50,0.522622000,0.0000
117.32.177.100,<->,50.224.76.234,0,0,1,50,1,50,0.522087000,0.0000
196.233.230.61,<->,8.182.139.40,0,0,1,50,1,50,0.521793000,0.0000
145.76.225.245,<->,80.27.159.59,0,0,1,50,1,50,0.521537000,0.0000
221.102.56.69,<->,98.128.56.58,0,0,1,56,1,56,0.521262000,0.0000
69.246.48.221,<->,8.252.222.174,0,0,1,50,1,50,0.521250000,0.0000
215.158.239.84,<->,204.3.184.181,1,56,0,0,1,56,0.520960000,0.0000
121.4.83.222,<->,50.224.76.235,0,0,1,50,1,50,0.519807000,0.0000
144.92.163.176,<->,53.167.48.249,1,50,0,0,1,50,0.519685000,0.0000
207.172.228.166,<->,136.25.188.225,0,0,1,56,1,56,0.519585000,0.0000
132.118.97.71,<->,80.41.3.223,0,0,1,50,1,50,0.519461000,0.0000
133.178.226.14,<->,96.155.60.234,1,56,0,0,1,56,0.519307000,0.0000
136.25.189.94,<->,89.90.95.217,1,56,0,0,1,56,0.518952000,0.0000
207.204.177.249,<->,50.224.76.234,0,0,1,50,1,50,0.518263000,0.0000
243.117.82.11,<->,133.54.30.179,0,0,1,50,1,50,0.517183000,0.0000
145.95.194.36,<->,92.27.219.190,0,0,1,50,1,50,0.516815000,0.0000
149.96.133.55,<->,50.224.76.235,0,0,1,50,1,50,0.516278000,0.0000
215.158.239.48,<->,195.127.160.117,1,50,0,0,1,50,0.516239000,0.0000
144.92.163.176,<->,50.145.122.87,1,50,0,0,1,50,0.515850000,0.0000
143.68.35.157,<->,136.25.188.253,0,0,1,50,1,50,0.515413000,0.0000
215.158.140.27,<->,8.192.205.47,1,56,0,0,1,56,0.514975000,0.0000
215.158.239.95,<->,142.221.133.113,1,50,0,0,1,50,0.514906000,0.0000
201.67.129.213,<->,84.4.11.133,1,50,0,0,1,50,0.514809000,0.0000
220.20.200.145,<->,206.134.128.204,1,50,0,0,1,50,0.514707000,0.0000
204.61.58.190,<->,136.25.188.196,0,0,1,50,1,50,0.513752000,0.0000
215.158.239.92,<->,207.61.42.124,1,50,0,0,1,50,0.513461000,0.0000
126.198.202.200,<->,108.134.118.34,0,0,1,56,1,56,0.512893000,0.0000
215.158.140.27,<->,106.7.35.103,1,56,0,0,1,56,0.512492000,0.0000
207.63.14.182,<->,136.25.188.226,0,0,1,56,1,56,0.512347000,0.0000
143.132.20.42,<->,136.25.188.163,0,0,1,50,1,50,0.511809000,0.0000
142.190.84.68,<->,136.25.188.55,0,0,1,56,1,56,0.511579000,0.0000
113.22.2.221,<->,100.228.42.100,0,0,1,56,1,56,0.511520000,0.0000
105.106.112.147,<->,50.224.76.234,0,0,1,56,1,56,0.511170000,0.0000
215.158.239.48,<->,207.61.42.124,1,50,0,0,1,50,0.511049000,0.0000
199.69.16.7,<->,136.25.188.46,0,0,1,56,1,56,0.510888000,0.0000
199.57.193.8,<->,50.223.3.228,0,0,1,56,1,56,0.510414000,0.0000
192.64.213.119,<->,133.183.156.125,1,50,0,0,1,50,0.510098000,0.0000
210.213.250.181,<->,8.52.246.161,0,0,1,56,1,56,0.509950000,0.0000
89.204.9.122,<->,8.182.253.209,0,0,1,56,1,56,0.509504000,0.0000
207.6.70.159,<->,8.182.139.197,0,0,1,56,1,56,0.509096000,0.0000
215.158.239.18,<->,122.158.246.232,1,56,0,0,1,56,0.508990000,0.0000
199.39.246.95,<->,136.25.188.163,0,0,1,56,1,56,0.508265000,0.0000
215.158.239.96,<->,207.61.227.81,1,56,0,0,1,56,0.507834000,0.0000
215.158.239.57,<->,204.3.69.99,1,56,0,0,1,56,0.507634000,0.0000
89.204.29.47,<->,8.182.226.78,0,0,1,56,1,56,0.507482000,0.0000
215.158.103.203,<->,124.20.100.129,1,56,0,0,1,56,0.507299000,0.0000
207.92.19.255,<->,8.182.243.141,0,0,1,56,1,56,0.507237000,0.0000
195.40.59.37,<->,136.25.188.209,0,0,1,50,1,50,0.506986000,0.0000
199.121.168.2,<->,136.25.188.196,0,0,1,56,1,56,0.506802000,0.0000
203.236.63.34,<->,136.25.188.241,0,0,1,56,1,56,0.506480000,0.0000
207.190.226.56,<->,136.25.188.239,0,0,1,56,1,56,0.506362000,0.0000
215.158.239.78,<->,207.167.190.60,1,50,0,0,1,50,0.505926000,0.0000
215.158.140.27,<->,193.4.149.154,1,56,0,0,1,56,0.505671000,0.0000
220.80.133.58,<->,8.55.224.156,1,141,0,0,1,141,0.504952000,0.0000
247.136.131.250,<->,8.55.211.213,1,56,0,0,1,56,0.504073000,0.0000
215.158.239.58,<->,199.20.31.91,1,50,0,0,1,50,0.503883000,0.0000
220.55.108.80,<->,137.44.153.229,1,56,0,0,1,56,0.503744000,0.0000
199.121.168.2,<->,136.25.188.52,0,0,1,56,1,56,0.502958000,0.0000
144.87.238.91,<->,8.182.252.86,0,0,1,50,1,50,0.502728000,0.0000
50.224.76.235,<->,38.0.14.50,1,50,0,0,1,50,0.501376000,0.0000
238.110.17.81,<->,50.224.76.235,0,0,1,56,1,56,0.501171000,0.0000
215.158.239.50,<->,199.39.229.223,1,50,0,0,1,50,0.501168000,0.0000
221.102.56.69,<->,102.83.220.113,0,0,1,56,1,56,0.500913000,0.0000
207.62.177.19,<->,136.25.188.239,0,0,1,50,1,50,0.500649000,0.0000
215.158.239.58,<->,142.240.134.17,1,50,0,0,1,50,0.500339000,0.0000
199.111.93.250,<->,8.182.228.158,0,0,1,50,1,50,0.499867000,0.0000
192.170.179.3,<->,133.178.226.197,0,0,1,56,1,56,0.499643000,0.0000
119.119.219.159,<->,80.41.29.163,0,0,1,50,1,50,0.499427000,0.0000
220.20.200.41,<->,42.105.196.8,1,1111,0,0,1,1111,0.498871000,0.0000
216.144.221.162,<->,215.158.140.177,0,0,1,50,1,50,0.498814000,0.0000
138.74.97.124,<->,133.54.28.251,0,0,1,56,1,56,0.498136000,0.0000
207.188.53.186,<->,136.25.188.160,0,0,1,50,1,50,0.497695000,0.0000
215.158.239.56,<->,195.14.36.68,1,56,0,0,1,56,0.497373000,0.0000
252.98.149.68,<->,140.146.142.42,1,50,0,0,1,50,0.497243000,0.0000
17.249.7.20,<->,8.220.176.253,0,0,1,56,1,56,0.497213000,0.0000
139.5.114.37,<->,8.52.184.170,0,0,1,56,1,56,0.496953000,0.0000
117.55.14.34,<->,8.182.234.114,0,0,1,50,1,50,0.496498000,0.0000
80.57.78.105,<->,8.252.221.181,0,0,1,56,1,56,0.495939000,0.0000
221.102.56.69,<->,109.1.60.22,0,0,1,56,1,56,0.495752000,0.0000
137.44.153.226,<->,80.38.59.60,0,0,1,50,1,50,0.495635000,0.0000
109.222.201.157,<->,53.200.94.254,1,50,0,0,1,50,0.495077000,0.0000
215.158.239.96,<->,196.107.117.216,1,56,0,0,1,56,0.494672000,0.0000
195.55.52.115,<->,136.25.188.252,0,0,1,50,1,50,0.493704000,0.0000
142.248.82.29,<->,136.25.188.196,0,0,1,50,1,50,0.493359000,0.0000
199.80.150.135,<->,136.25.188.196,0,0,1,50,1,50,0.492611000,0.0000
215.158.238.135,<->,122.159.245.149,1,56,0,0,1,56,0.491005000,0.0000
199.72.20.117,<->,136.25.188.209,0,0,1,50,1,50,0.490924000,0.0000
192.170.241.194,<->,8.252.222.249,0,0,1,56,1,56,0.490231000,0.0000
137.167.89.215,<->,8.220.190.86,0,0,1,50,1,50,0.489894000,0.0000
215.158.239.99,<->,194.251.125.110,1,56,0,0,1,56,0.489693000,0.0000
114.231.95.5,<->,92.27.219.231,0,0,1,50,1,50,0.489472000,0.0000
58.60.36.23,<->,8.252.222.134,0,0,1,68,1,68,0.489342000,0.0000
215.158.140.184,<->,127.168.65.198,1,50,0,0,1,50,0.489283000,0.0000
204.3.159.38,<->,136.25.188.254,0,0,1,50,1,50,0.489140000,0.0000
220.20.200.68,<->,121.105.196.56,1,50,0,0,1,50,0.488355000,0.0000
204.185.57.134,<->,136.25.188.240,0,0,1,56,1,56,0.488188000,0.0000
196.247.87.19,<->,136.25.188.252,0,0,1,56,1,56,0.488168000,0.0000
192.228.30.100,<->,6.73.247.16,0,0,1,56,1,56,0.486596000,0.0000
195.6.110.67,<->,136.25.188.220,0,0,1,56,1,56,0.486004000,0.0000
215.158.239.85,<->,199.20.31.245,1,56,0,0,1,56,0.485983000,0.0000
149.197.244.196,<->,144.71.43.240,0,0,1,56,1,56,0.485477000,0.0000
199.33.51.133,<->,136.25.188.198,0,0,1,50,1,50,0.485433000,0.0000
111.2.136.21,<->,8.182.252.86,0,0,1,50,1,50,0.484542000,0.0000
215.158.239.78,<->,207.16.17.95,1,132,0,0,1,132,0.484509000,0.0000
35.61.123.109,<->,8.252.223.146,0,0,1,76,1,76,0.484420000,0.0000
200.174.199.251,<->,54.36.13.173,1,56,0,0,1,56,0.484406000,0.0000
133.32.39.0,<->,14.71.93.60,1,56,0,0,1,56,0.483421000,0.0000
144.85.170.254,<->,91.69.185.155,1,56,0,0,1,56,0.483226000,0.0000
143.23.224.168,<->,136.25.188.220,0,0,1,50,1,50,0.482841000,0.0000
199.15.217.215,<->,136.25.188.45,0,0,1,50,1,50,0.481646000,0.0000
97.126.4.255,<->,27.10.93.204,1,56,0,0,1,56,0.481108000,0.0000
120.118.68.174,<->,50.224.76.234,0,0,1,50,1,50,0.481079000,0.0000
215.158.239.57,<->,207.40.77.92,1,56,0,0,1,56,0.480182000,0.0000
112.7.58.75,<->,50.224.76.230,0,0,1,50,1,50,0.480161000,0.0000
218.138.21.44,<->,8.220.190.86,0,0,1,50,1,50,0.479340000,0.0000
215.158.239.79,<->,204.226.109.227,1,50,0,0,1,50,0.478865000,0.0000
130.206.82.110,<->,50.224.76.235,0,0,1,56,1,56,0.477809000,0.0000
133.54.17.198,<->,127.73.171.5,1,56,0,0,1,56,0.477281000,0.0000
220.55.78.167,<->,119.53.54.165,1,50,0,0,1,50,0.477027000,0.0000
199.80.148.235,<->,136.25.188.160,0,0,1,56,1,56,0.476985000,0.0000
195.14.252.131,<->,136.25.188.239,0,0,1,56,1,56,0.475636000,0.0000
148.226.51.110,<->,50.224.76.230,0,0,1,50,1,50,0.475051000,0.0000
221.102.56.69,<->,109.2.12.217,0,0,1,56,1,56,0.474681000,0.0000
215.158.238.100,<->,100.120.38.6,1,56,0,0,1,56,0.473876000,0.0000
215.158.238.244,<->,215.158.34.76,1,56,0,0,1,56,0.472582000,0.0000
144.85.170.254,<->,92.111.174.86,1,56,0,0,1,56,0.472565000,0.0000
204.58.140.60,<->,136.25.188.210,0,0,1,56,1,56,0.472223000,0.0000
215.158.239.120,<->,109.206.125.189,1,56,0,0,1,56,0.471868000,0.0000
159.165.71.215,<->,8.45.253.203,1,56,0,0,1,56,0.471544000,0.0000
129.254.96.10,<->,80.38.33.214,0,0,1,50,1,50,0.470541000,0.0000
215.158.239.58,<->,207.115.51.177,1,50,0,0,1,50,0.470324000,0.0000
251.24.105.206,<->,8.182.227.180,0,0,1,50,1,50,0.469756000,0.0000
159.137.162.213,<->,112.24.92.10,1,50,0,0,1,50,0.469539000,0.0000
231.142.30.40,<->,136.25.188.163,0,0,1,56,1,56,0.469513000,0.0000
195.7.21.17,<->,136.25.188.254,0,0,1,56,1,56,0.469126000,0.0000
148.132.60.151,<->,92.162.253.217,0,0,1,50,1,50,0.468511000,0.0000
143.129.189.14,<->,136.25.188.225,0,0,1,56,1,56,0.468040000,0.0000
215.158.239.76,<->,199.78.166.34,1,56,0,0,1,56,0.467146000,0.0000
215.158.239.56,<->,142.247.252.8,1,50,0,0,1,50,0.467126000,0.0000
142.255.132.250,<->,136.25.188.253,0,0,1,50,1,50,0.466746000,0.0000
104.245.45.167,<->,50.224.76.230,0,0,1,50,1,50,0.466526000,0.0000
215.158.239.49,<->,207.191.194.245,1,56,0,0,1,56,0.466404000,0.0000
221.163.98.137,<->,92.162.253.37,0,0,1,50,1,50,0.466023000,0.0000
215.158.140.216,<->,50.239.48.167,1,56,0,0,1,56,0.465823000,0.0000
142.236.7.253,<->,136.25.188.174,0,0,1,56,1,56,0.465477000,0.0000
195.42.106.196,<->,136.25.188.222,0,0,1,50,1,50,0.465173000,0.0000
142.227.168.94,<->,136.25.188.242,0,0,1,50,1,50,0.464394000,0.0000
207.162.155.76,<->,8.182.227.206,0,0,1,50,1,50,0.464125000,0.0000
252.36.154.206,<->,8.252.222.162,0,0,1,50,1,50,0.464011000,0.0000
192.65.81.245,<->,109.127.101.16,1,499,0,0,1,499,0.463791000,0.0000
136.25.188.236,<->,108.47.170.254,1,56,0,0,1,56,0.463438000,0.0000
229.69.191.88,<->,92.27.219.36,0,0,1,50,1,50,0.463197000,0.0000
138.98.151.44,<->,124.50.117.254,1,50,0,0,1,50,0.462739000,0.0000
142.240.138.78,<->,136.25.188.178,0,0,1,56,1,56,0.462544000,0.0000
54.37.53.245,<->,48.53.243.255,0,0,1,56,1,56,0.462212000,0.0000
221.102.56.46,<->,6.75.141.235,0,0,1,56,1,56,0.461754000,0.0000
220.81.47.225,<->,129.158.112.159,1,56,0,0,1,56,0.460862000,0.0000
231.142.148.128,<->,215.158.239.77,0,0,1,50,1,50,0.460595000,0.0000
207.173.19.189,<->,136.25.188.174,0,0,1,56,1,56,0.460495000,0.0000
246.254.97.230,<->,139.33.174.12,1,50,0,0,1,50,0.460378000,0.0000
200.175.51.143,<->,53.213.63.93,1,56,0,0,1,56,0.459621000,0.0000
215.158.239.76,<->,207.166.82.223,1,56,0,0,1,56,0.459007000,0.0000
93.95.33.176,<->,50.224.76.234,0,0,1,50,1,50,0.458985000,0.0000
195.70.134.244,<->,136.25.188.253,0,0,1,50,1,50,0.458856000,0.0000
8.252.213.192,<->,8.250.155.16,0,0,1,56,1,56,0.458490000,0.0000
53.203.244.195,<->,48.54.252.54,0,0,1,56,1,56,0.458032000,0.0000
199.68.213.222,<->,136.25.188.239,0,0,1,50,1,50,0.456657000,0.0000
139.163.81.178,<->,98.156.220.248,1,56,0,0,1,56,0.456102000,0.0000
109.119.182.247,<->,8.182.244.19,0,0,1,50,1,50,0.455685000,0.0000
246.44.136.14,<->,124.55.36.202,1,56,0,0,1,56,0.455284000,0.0000
97.126.14.75,<->,53.240.123.131,1,50,0,0,1,50,0.455046000,0.0000
159.57.90.68,<->,139.254.211.64,0,0,1,56,1,56,0.454792000,0.0000
215.158.239.49,<->,199.20.28.91,1,56,0,0,1,56,0.454726000,0.0000
215.158.238.120,<->,143.155.227.57,1,56,0,0,1,56,0.454380000,0.0000
215.158.239.86,<->,199.20.28.26,1,56,0,0,1,56,0.454280000,0.0000
133.12.161.201,<->,8.220.176.253,0,0,1,50,1,50,0.453472000,0.0000
97.126.19.126,<->,27.51.239.160,1,56,0,0,1,56,0.452213000,0.0000
117.13.158.151,<->,50.224.76.234,0,0,1,56,1,56,0.451012000,0.0000
192.229.220.60,<->,111.151.238.139,1,56,0,0,1,56,0.450547000,0.0000
197.113.64.188,<->,136.25.188.46,0,0,1,56,1,56,0.450120000,0.0000
157.214.169.148,<->,50.224.76.248,0,0,1,50,1,50,0.449656000,0.0000
126.149.134.158,<->,50.224.76.235,0,0,1,56,1,56,0.449360000,0.0000
143.245.251.3,<->,8.20.87.195,0,0,1,50,1,50,0.448758000,0.0000
149.161.10.42,<->,50.224.76.248,0,0,1,50,1,50,0.448486000,0.0000
209.18.32.202,<->,8.220.188.50,0,0,1,56,1,56,0.448061000,0.0000
142.240.117.12,<->,136.25.188.45,0,0,1,50,1,50,0.447337000,0.0000
43.55.251.75,<->,8.252.222.133,0,0,1,50,1,50,0.447327000,0.0000
204.250.33.215,<->,33.107.83.207,1,50,0,0,1,50,0.447060000,0.0000
99.170.105.20,<->,89.183.104.139,0,0,1,56,1,56,0.447036000,0.0000
199.55.33.227,<->,8.182.227.180,0,0,1,50,1,50,0.445922000,0.0000
215.158.239.57,<->,196.106.58.186,1,56,0,0,1,56,0.445762000,0.0000
199.39.45.26,<->,136.25.188.45,0,0,1,50,1,50,0.445564000,0.0000
92.27.27.173,<->,82.130.189.215,1,50,0,0,1,50,0.445557000,0.0000
195.5.41.65,<->,136.25.188.241,0,0,1,50,1,50,0.445546000,0.0000
89.204.235.110,<->,50.224.91.41,0,0,1,56,1,56,0.445498000,0.0000
92.27.64.227,<->,8.252.222.37,0,0,1,50,1,50,0.445454000,0.0000
215.158.238.88,<->,145.116.209.4,1,56,0,0,1,56,0.445185000,0.0000
124.46.191.127,<->,92.162.252.81,0,0,1,730,1,730,0.444950000,0.0000
193.81.55.4,<->,92.162.253.244,0,0,1,50,1,50,0.443924000,0.0000
253.244.5.101,<->,50.224.76.235,0,0,1,56,1,56,0.443795000,0.0000
80.41.3.199,<->,8.55.211.213,1,56,0,0,1,56,0.443716000,0.0000
215.158.239.77,<->,199.20.31.28,1,56,0,0,1,56,0.443356000,0.0000
215.158.239.51,<->,199.20.28.104,1,56,0,0,1,56,0.443278000,0.0000
215.158.239.69,<->,196.106.64.72,1,56,0,0,1,56,0.443158000,0.0000
110.222.166.99,<->,50.224.76.235,0,0,1,50,1,50,0.442410000,0.0000
143.87.27.65,<->,8.52.182.119,0,0,1,56,1,56,0.442139000,0.0000
143.72.72.239,<->,136.25.188.252,0,0,1,50,1,50,0.442054000,0.0000
17.194.236.193,<->,8.220.188.50,0,0,1,50,1,50,0.442018000,0.0000
144.85.170.254,<->,91.69.185.128,1,56,0,0,1,56,0.441785000,0.0000
142.190.160.240,<->,136.25.188.242,0,0,1,50,1,50,0.441256000,0.0000
215.158.140.27,<->,106.188.193.47,1,56,0,0,1,56,0.441137000,0.0000
143.24.218.165,<->,8.20.87.206,0,0,1,50,1,50,0.440767000,0.0000
215.158.239.76,<->,199.20.30.73,1,56,0,0,1,56,0.440755000,0.0000
215.158.239.35,<->,8.236.31.22,1,56,0,0,1,56,0.440701000,0.0000
143.20.20.122,<->,50.224.76.234,0,0,1,56,1,56,0.440370000,0.0000
199.51.214.192,<->,136.25.188.198,0,0,1,56,1,56,0.439867000,0.0000
215.158.140.27,<->,148.247.42.185,1,56,0,0,1,56,0.439349000,0.0000
215.158.239.58,<->,196.92.45.73,1,56,0,0,1,56,0.438993000,0.0000
197.106.83.199,<->,136.25.188.55,0,0,1,56,1,56,0.438383000,0.0000
101.70.121.187,<->,82.193.206.120,1,50,0,0,1,50,0.437986000,0.0000
221.163.98.141,<->,92.162.253.191,0,0,1,50,1,50,0.437413000,0.0000
246.254.97.112,<->,139.114.139.232,1,56,0,0,1,56,0.436949000,0.0000
133.135.201.113,<->,129.6.83.6,0,0,1,56,1,56,0.435448000,0.0000
248.225.27.2,<->,56.114.235.120,1,816,0,0,1,816,0.434134000,0.0000
136.25.188.236,<->,8.227.55.253,1,56,0,0,1,56,0.433765000,0.0000
215.158.239.79,<->,199.20.6.140,1,56,0,0,1,56,0.432714000,0.0000
133.32.39.0,<->,8.193.178.40,1,56,0,0,1,56,0.432219000,0.0000
142.244.125.239,<->,136.25.188.198,0,0,1,56,1,56,0.431799000,0.0000
199.68.205.254,<->,136.25.188.45,0,0,1,50,1,50,0.431516000,0.0000
199.32.132.206,<->,136.25.188.220,0,0,1,56,1,56,0.431410000,0.0000
136.177.72.3,<->,92.162.253.170,0,0,1,50,1,50,0.431240000,0.0000
197.113.99.62,<->,136.25.188.226,0,0,1,56,1,56,0.431075000,0.0000
100.94.92.99,<->,8.4.158.70,1,50,0,0,1,50,0.430852000,0.0000
221.102.56.69,<->,109.1.92.249,0,0,1,56,1,56,0.430370000,0.0000
144.85.170.208,<->,98.87.147.122,1,56,0,0,1,56,0.430045000,0.0000
139.193.141.139,<->,126.198.102.162,1,56,0,0,1,56,0.429587000,0.0000
199.72.168.144,<->,136.25.188.225,0,0,1,50,1,50,0.429550000,0.0000
207.62.87.215,<->,136.25.188.46,0,0,1,50,1,50,0.429327000,0.0000
132.216.20.76,<->,101.126.180.109,0,0,1,50,1,50,0.429282000,0.0000
145.252.125.198,<->,116.96.63.23,1,50,0,0,1,50,0.429222000,0.0000
136.153.134.210,<->,8.52.222.23,0,0,1,56,1,56,0.428566000,0.0000
17.139.200.50,<->,8.220.202.151,0,0,1,56,1,56,0.428344000,0.0000
213.38.136.197,<->,8.45.175.127,1,141,0,0,1,141,0.428056000,0.0000
221.102.56.69,<->,98.128.33.24,0,0,1,56,1,56,0.427712000,0.0000
136.181.43.98,<->,56.114.235.120,1,760,0,0,1,760,0.426714000,0.0000
215.158.239.113,<->,129.222.39.87,1,56,0,0,1,56,0.426639000,0.0000
195.71.60.137,<->,136.25.188.238,0,0,1,50,1,50,0.426191000,0.0000
136.25.188.254,<->,113.23.104.247,1,56,0,0,1,56,0.425416000,0.0000
215.158.239.101,<->,129.222.39.143,1,56,0,0,1,56,0.425299000,0.0000
94.192.23.95,<->,8.252.221.237,0,0,1,50,1,50,0.424918000,0.0000
231.141.60.32,<->,50.224.76.234,0,0,1,56,1,56,0.424788000,0.0000
246.253.198.51,<->,112.86.88.202,1,50,0,0,1,50,0.424780000,0.0000
199.69.114.237,<->,136.25.188.163,0,0,1,56,1,56,0.424658000,0.0000
69.103.57.90,<->,8.252.222.63,0,0,1,56,1,56,0.424471000,0.0000
138.60.35.151,<->,8.52.176.86,0,0,1,50,1,50,0.424310000,0.0000
215.158.239.97,<->,207.191.156.69,1,50,0,0,1,50,0.423963000,0.0000
192.176.58.4,<->,136.25.188.209,0,0,1,56,1,56,0.423958000,0.0000
215.158.239.201,<->,192.226.44.66,1,56,0,0,1,56,0.423930000,0.0000
92.162.253.36,<->,27.199.161.199,1,50,0,0,1,50,0.423699000,0.0000
142.236.50.26,<->,136.25.188.175,0,0,1,56,1,56,0.421688000,0.0000
142.228.163.52,<->,136.25.188.242,0,0,1,50,1,50,0.421603000,0.0000
133.178.226.37,<->,96.155.60.246,1,56,0,0,1,56,0.419958000,0.0000
199.53.111.156,<->,136.25.188.252,0,0,1,56,1,56,0.419291000,0.0000
195.14.248.228,<->,136.25.188.238,0,0,1,56,1,56,0.418995000,0.0000
93.181.154.68,<->,92.27.219.151,0,0,1,50,1,50,0.418644000,0.0000
89.183.107.124,<->,35.62.70.46,1,61,0,0,1,61,0.418289000,0.0000
215.158.239.48,<->,195.83.199.181,1,56,0,0,1,56,0.417609000,0.0000
145.252.121.82,<->,119.53.190.76,1,50,0,0,1,50,0.417568000,0.0000
204.3.166.30,<->,136.25.188.253,0,0,1,50,1,50,0.417165000,0.0000
195.71.60.137,<->,136.25.188.178,0,0,1,50,1,50,0.417046000,0.0000
207.191.166.85,<->,136.25.188.160,0,0,1,50,1,50,0.416591000,0.0000
116.142.209.67,<->,50.224.76.234,0,0,1,50,1,50,0.414973000,0.0000
200.174.194.174,<->,54.37.1.37,1,56,0,0,1,56,0.414947000,0.0000
133.178.226.224,<->,8.53.223.192,1,56,0,0,1,56,0.414566000,0.0000
133.178.226.37,<->,96.155.60.193,1,56,0,0,1,56,0.414063000,0.0000
48.17.210.32,<->,8.252.222.132,0,0,1,56,1,56,0.414003000,0.0000
206.243.231.162,<->,111.146.255.212,0,0,1,50,1,50,0.413708000,0.0000
246.253.253.107,<->,111.151.239.135,1,56,0,0,1,56,0.413145000,0.0000
119.209.96.190,<->,50.224.76.234,0,0,1,50,1,50,0.412973000,0.0000
215.158.239.48,<->,195.96.140.134,1,56,0,0,1,56,0.412964000,0.0000
108.46.247.60,<->,8.220.176.253,0,0,1,50,1,50,0.412217000,0.0000
199.72.51.138,<->,136.25.188.253,0,0,1,56,1,56,0.412187000,0.0000
97.126.114.234,<->,53.230.101.77,1,50,0,0,1,50,0.412145000,0.0000
232.31.229.85,<->,139.163.41.64,0,0,1,50,1,50,0.412126000,0.0000
215.158.239.56,<->,196.91.200.82,1,56,0,0,1,56,0.411920000,0.0000
194.238.244.139,<->,136.25.188.53,0,0,1,50,1,50,0.411615000,0.0000
8.252.221.181,<->,8.37.249.22,1,56,0,0,1,56,0.411436000,0.0000
215.158.140.172,<->,109.186.239.83,1,50,0,0,1,50,0.410662000,0.0000
204.200.52.99,<->,136.25.188.178,0,0,1,132,1,132,0.410155000,0.0000
145.221.35.19,<->,8.182.250.192,0,0,1,50,1,50,0.410114000,0.0000
204.200.173.134,<->,136.25.188.241,0,0,1,56,1,56,0.410085000,0.0000
220.28.108.254,<->,136.25.189.42,0,0,1,56,1,56,0.409633000,0.0000
216.103.78.156,<->,50.224.76.234,0,0,1,50,1,50,0.409542000,0.0000
221.102.56.69,<->,220.80.171.36,0,0,1,56,1,56,0.409480000,0.0000
109.222.208.65,<->,54.43.5.17,1,50,0,0,1,50,0.409429000,0.0000
195.6.249.171,<->,136.25.188.46,0,0,1,50,1,50,0.409018000,0.0000
215.158.239.58,<->,199.20.29.134,1,56,0,0,1,56,0.408989000,0.0000
142.207.225.232,<->,136.25.188.254,0,0,1,56,1,56,0.408579000,0.0000
142.207.225.232,<->,136.25.188.176,0,0,1,56,1,56,0.408039000,0.0000
204.60.97.95,<->,136.25.188.177,0,0,1,56,1,56,0.408026000,0.0000
221.102.56.46,<->,98.129.37.28,0,0,1,102,1,102,0.407390000,0.0000
195.70.242.180,<->,136.25.188.241,0,0,1,56,1,56,0.406965000,0.0000
136.25.188.230,<->,80.57.141.206,1,56,0,0,1,56,0.406880000,0.0000
97.126.114.234,<->,53.230.103.170,1,50,0,0,1,50,0.406735000,0.0000
53.214.109.33,<->,8.228.214.88,0,0,1,56,1,56,0.406038000,0.0000
192.170.241.202,<->,8.252.222.235,0,0,1,56,1,56,0.405243000,0.0000
207.236.28.230,<->,136.25.188.252,0,0,1,50,1,50,0.405164000,0.0000
138.42.27.182,<->,56.121.33.48,0,0,1,50,1,50,0.404583000,0.0000
215.158.239.36,<->,138.28.170.248,1,50,0,0,1,50,0.404557000,0.0000
215.158.239.70,<->,196.93.60.100,1,56,0,0,1,56,0.404418000,0.0000
146.200.165.115,<->,0.195.210.42,0,0,1,56,1,56,0.404401000,0.0000
215.158.239.76,<->,196.90.47.255,1,50,0,0,1,50,0.403982000,0.0000
8.252.223.230,<->,8.176.12.107,1,56,0,0,1,56,0.403608000,0.0000
143.53.35.6,<->,136.25.188.253,0,0,1,50,1,50,0.403052000,0.0000
215.158.239.57,<->,199.20.7.45,1,56,0,0,1,56,0.402420000,0.0000
215.158.239.34,<->,129.252.72.175,1,56,0,0,1,56,0.402239000,0.0000
200.174.10.198,<->,54.36.230.207,1,56,0,0,1,56,0.401949000,0.0000
50.224.76.230,<->,6.212.127.225,1,56,0,0,1,56,0.401861000,0.0000
215.158.140.27,<->,133.73.194.16,1,56,0,0,1,56,0.401818000,0.0000
215.158.239.76,<->,204.226.0.149,1,50,0,0,1,50,0.401743000,0.0000
145.252.116.199,<->,100.120.38.6,1,56,0,0,1,56,0.400958000,0.0000
221.102.101.45,<->,139.254.211.64,1,56,0,0,1,56,0.400162000,0.0000
221.102.143.189,<->,192.65.51.237,0,0,1,56,1,56,0.400127000,0.0000
221.196.122.34,<->,136.25.188.173,0,0,1,56,1,56,0.399878000,0.0000
215.158.239.50,<->,195.43.72.104,1,56,0,0,1,56,0.399840000,0.0000
192.229.210.156,<->,50.51.40.109,1,50,0,0,1,50,0.399546000,0.0000
215.158.239.244,<->,112.235.95.53,1,56,0,0,1,56,0.399446000,0.0000
215.158.239.93,<->,207.190.52.97,1,56,0,0,1,56,0.399275000,0.0000
133.178.226.49,<->,57.107.26.56,1,56,0,0,1,56,0.399275000,0.0000
220.28.73.211,<->,215.158.238.90,0,0,1,56,1,56,0.399264000,0.0000
249.101.127.5,<->,54.38.108.23,1,125,0,0,1,125,0.399115000,0.0000
142.229.196.25,<->,136.25.188.241,0,0,1,56,1,56,0.398676000,0.0000
215.158.239.181,<->,113.207.62.162,1,56,0,0,1,56,0.398053000,0.0000
194.238.242.251,<->,136.25.188.225,0,0,1,56,1,56,0.397911000,0.0000
247.136.139.247,<->,132.18.67.28,1,50,0,0,1,50,0.397682000,0.0000
143.43.237.167,<->,136.25.188.198,0,0,1,56,1,56,0.397645000,0.0000
69.246.45.220,<->,8.252.222.148,0,0,1,56,1,56,0.397505000,0.0000
221.102.56.69,<->,80.40.106.78,0,0,1,56,1,56,0.397282000,0.0000
192.67.181.145,<->,50.248.185.173,1,50,0,0,1,50,0.396990000,0.0000
197.107.77.140,<->,136.25.188.163,0,0,1,56,1,56,0.396469000,0.0000
74.141.177.167,<->,8.252.221.198,0,0,1,50,1,50,0.396404000,0.0000
139.163.1.138,<->,116.229.128.136,1,50,0,0,1,50,0.396069000,0.0000
215.158.239.57,<->,207.59.196.167,1,56,0,0,1,56,0.395898000,0.0000
224.234.193.175,<->,8.20.87.254,0,0,1,56,1,56,0.395888000,0.0000
133.32.39.0,<->,14.71.90.213,1,56,0,0,1,56,0.395741000,0.0000
215.158.239.97,<->,196.90.47.255,1,50,0,0,1,50,0.395443000,0.0000
197.106.249.131,<->,136.25.188.209,0,0,1,56,1,56,0.395426000,0.0000
247.136.130.61,<->,193.51.144.204,1,56,0,0,1,56,0.395234000,0.0000
98.219.117.2,<->,80.38.56.218,0,0,1,50,1,50,0.394938000,0.0000
215.158.239.99,<->,196.105.59.105,1,56,0,0,1,56,0.394753000,0.0000
109.1.57.207,<->,50.224.76.235,0,0,1,56,1,56,0.394169000,0.0000
215.158.239.93,<->,204.2.105.52,1,56,0,0,1,56,0.393870000,0.0000
99.75.54.228,<->,33.107.91.35,1,50,0,0,1,50,0.393612000,0.0000
199.72.84.129,<->,136.25.188.177,0,0,1,50,1,50,0.393568000,0.0000
142.254.200.98,<->,136.25.188.198,0,0,1,56,1,56,0.393252000,0.0000
221.163.98.137,<->,92.162.252.202,0,0,1,50,1,50,0.393228000,0.0000
200.175.152.251,<->,54.37.202.190,1,50,0,0,1,50,0.393201000,0.0000
145.116.209.76,<->,136.25.188.203,0,0,1,56,1,56,0.392872000,0.0000
133.178.226.90,<->,96.155.60.244,1,56,0,0,1,56,0.392861000,0.0000
145.186.93.66,<->,53.167.130.141,1,50,0,0,1,50,0.392802000,0.0000
200.14.164.203,<->,0.195.210.8,0,0,1,50,1,50,0.392434000,0.0000
199.82.70.213,<->,136.25.188.222,0,0,1,56,1,56,0.392259000,0.0000
221.102.120.63,<->,100.241.191.28,1,56,0,0,1,56,0.391898000,0.0000
215.158.239.94,<->,207.114.153.94,1,56,0,0,1,56,0.391111000,0.0000
197.113.99.59,<->,136.25.188.225,0,0,1,56,1,56,0.389996000,0.0000
207.62.95.240,<->,136.25.188.199,0,0,1,56,1,56,0.389931000,0.0000
194.237.188.20,<->,136.25.188.198,0,0,1,56,1,56,0.389341000,0.0000
89.204.34.26,<->,8.182.253.100,0,0,1,56,1,56,0.389200000,0.0000
117.20.48.130,<->,50.224.76.235,0,0,1,50,1,50,0.389172000,0.0000
129.92.112.227,<->,53.84.229.56,1,56,0,0,1,56,0.388177000,0.0000
192.67.143.37,<->,97.91.14.64,1,56,0,0,1,56,0.386904000,0.0000
215.158.238.120,<->,113.23.21.215,1,56,0,0,1,56,0.386714000,0.0000
89.154.147.189,<->,50.224.120.135,0,0,1,56,1,56,0.386701000,0.0000
131.175.194.72,<->,92.27.219.21,0,0,1,56,1,56,0.386510000,0.0000
142.253.237.24,<->,136.25.188.238,0,0,1,50,1,50,0.386142000,0.0000
247.136.134.246,<->,192.169.60.182,1,56,0,0,1,56,0.385869000,0.0000
132.3.107.145,<->,78.49.145.199,1,50,0,0,1,50,0.385291000,0.0000
213.221.90.192,<->,144.85.170.208,0,0,1,56,1,56,0.385028000,0.0000
144.85.170.208,<->,111.38.51.83,1,56,0,0,1,56,0.384805000,0.0000
138.98.178.182,<->,116.108.180.63,1,50,0,0,1,50,0.384580000,0.0000
17.61.227.235,<->,8.220.179.94,0,0,1,50,1,50,0.384292000,0.0000
247.136.162.79,<->,129.222.39.105,1,50,0,0,1,50,0.384224000,0.0000
215.158.239.56,<->,194.251.72.11,1,50,0,0,1,50,0.383755000,0.0000
111.147.151.251,<->,54.53.209.53,1,56,0,0,1,56,0.383598000,0.0000
90.240.3.93,<->,53.148.184.48,1,56,0,0,1,56,0.383470000,0.0000
192.67.181.145,<->,100.224.242.186,1,50,0,0,1,50,0.383435000,0.0000
196.88.26.109,<->,136.25.188.53,0,0,1,50,1,50,0.383229000,0.0000
132.213.199.19,<->,8.52.154.27,0,0,1,56,1,56,0.382963000,0.0000
142.227.45.230,<->,136.25.188.52,0,0,1,56,1,56,0.382732000,0.0000
136.25.189.202,<->,129.222.39.124,1,56,0,0,1,56,0.382650000,0.0000
100.116.238.33,<->,92.27.27.167,0,0,1,50,1,50,0.382261000,0.0000
117.252.133.1,<->,50.224.76.234,0,0,1,56,1,56,0.381330000,0.0000
196.21.39.101,<->,92.27.27.148,0,0,1,50,1,50,0.381286000,0.0000
215.158.239.48,<->,143.94.230.214,1,56,0,0,1,56,0.381105000,0.0000
231.255.132.167,<->,145.19.8.119,0,0,1,50,1,50,0.381105000,0.0000
246.253.198.51,<->,114.155.143.126,1,50,0,0,1,50,0.380370000,0.0000
221.102.56.46,<->,100.182.164.197,0,0,1,56,1,56,0.379607000,0.0000
204.200.56.84,<->,136.25.188.54,0,0,1,56,1,56,0.379445000,0.0000
142.253.228.242,<->,136.25.188.225,0,0,1,50,1,50,0.378265000,0.0000
142.249.224.241,<->,136.25.188.220,0,0,1,50,1,50,0.378097000,0.0000
194.237.216.206,<->,136.25.188.243,0,0,1,50,1,50,0.378061000,0.0000
136.25.188.163,<->,8.227.55.175,1,56,0,0,1,56,0.377803000,0.0000
215.158.239.77,<->,199.80.210.102,1,93,0,0,1,93,0.377564000,0.0000
143.193.10.182,<->,8.183.25.25,0,0,1,56,1,56,0.376929000,0.0000
142.208.120.204,<->,136.25.188.198,0,0,1,56,1,56,0.376579000,0.0000
207.57.195.72,<->,136.25.188.209,0,0,1,56,1,56,0.376565000,0.0000
196.29.116.141,<->,50.223.3.228,0,0,1,56,1,56,0.374971000,0.0000
198.157.156.29,<->,139.163.5.140,0,0,1,56,1,56,0.374660000,0.0000
195.40.112.222,<->,136.25.188.241,0,0,1,56,1,56,0.374491000,0.0000
207.3.215.218,<->,50.223.3.228,0,0,1,56,1,56,0.374138000,0.0000
139.163.5.140,<->,121.166.170.76,1,267,0,0,1,267,0.373739000,0.0000
195.5.138.166,<->,136.25.188.45,0,0,1,50,1,50,0.373493000,0.0000
133.213.24.157,<->,8.53.11.126,0,0,1,56,1,56,0.373429000,0.0000
17.27.56.184,<->,8.220.189.81,0,0,1,50,1,50,0.373338000,0.0000
247.136.157.176,<->,8.55.140.54,1,56,0,0,1,56,0.372867000,0.0000
156.142.121.160,<->,8.252.221.197,0,0,1,50,1,50,0.372825000,0.0000
159.57.90.83,<->,89.183.104.137,0,0,1,50,1,50,0.372362000,0.0000
142.228.48.148,<->,136.25.188.252,0,0,1,50,1,50,0.372207000,0.0000
212.164.143.185,<->,132.213.199.17,1,56,0,0,1,56,0.371365000,0.0000
218.147.52.203,<->,8.176.54.2,0,0,1,56,1,56,0.371332000,0.0000
210.226.164.244,<->,54.43.249.8,1,50,0,0,1,50,0.370862000,0.0000
196.88.26.109,<->,136.25.188.52,0,0,1,50,1,50,0.370368000,0.0000
192.64.228.244,<->,120.150.227.165,1,56,0,0,1,56,0.369727000,0.0000
199.14.90.176,<->,136.25.188.163,0,0,1,56,1,56,0.369419000,0.0000
215.158.239.95,<->,199.20.4.233,1,56,0,0,1,56,0.369330000,0.0000
204.187.158.135,<->,136.25.188.178,0,0,1,56,1,56,0.368407000,0.0000
159.137.162.213,<->,105.111.73.135,1,50,0,0,1,50,0.367735000,0.0000
207.61.59.172,<->,136.25.188.198,0,0,1,50,1,50,0.366048000,0.0000
232.31.28.211,<->,99.72.224.17,0,0,1,50,1,50,0.365906000,0.0000
112.208.20.199,<->,100.92.157.52,0,0,1,50,1,50,0.365576000,0.0000
159.137.162.213,<->,105.108.227.231,1,50,0,0,1,50,0.365565000,0.0000
253.66.34.47,<->,8.52.171.120,0,0,1,56,1,56,0.365350000,0.0000
92.27.219.246,<->,88.5.66.212,1,56,0,0,1,56,0.364929000,0.0000
215.158.239.99,<->,142.227.100.148,1,50,0,0,1,50,0.364810000,0.0000
149.235.39.67,<->,145.252.120.231,0,0,1,50,1,50,0.363362000,0.0000
142.228.75.39,<->,136.25.188.160,0,0,1,50,1,50,0.362414000,0.0000
195.126.38.57,<->,136.25.188.177,0,0,1,50,1,50,0.360016000,0.0000
53.201.48.249,<->,48.53.115.143,0,0,1,56,1,56,0.359937000,0.0000
144.95.254.55,<->,137.19.245.24,0,0,1,56,1,56,0.359710000,0.0000
205.89.143.65,<->,50.224.76.234,0,0,1,50,1,50,0.359463000,0.0000
144.85.170.254,<->,91.69.181.255,1,56,0,0,1,56,0.358732000,0.0000
159.137.226.155,<->,89.183.98.97,1,50,0,0,1,50,0.356698000,0.0000
112.208.20.81,<->,102.50.183.146,0,0,1,50,1,50,0.355852000,0.0000
200.174.223.64,<->,53.161.35.31,1,93,0,0,1,93,0.354791000,0.0000
215.158.239.79,<->,143.128.227.162,1,50,0,0,1,50,0.354100000,0.0000
89.153.91.164,<->,82.130.83.146,1,56,0,0,1,56,0.354092000,0.0000
247.136.162.79,<->,220.20.253.61,1,50,0,0,1,50,0.353391000,0.0000
231.141.56.107,<->,136.25.188.178,0,0,1,56,1,56,0.353276000,0.0000
220.20.206.14,<->,129.78.117.164,0,0,1,50,1,50,0.353055000,0.0000
136.128.35.207,<->,133.178.226.191,0,0,1,83,1,83,0.352936000,0.0000
218.4.179.37,<->,159.42.43.112,1,56,0,0,1,56,0.352243000,0.0000
112.208.20.81,<->,100.92.157.52,0,0,1,50,1,50,0.352229000,0.0000
138.5.92.214,<->,97.198.98.33,0,0,1,50,1,50,0.352131000,0.0000
194.233.123.96,<->,136.25.188.222,0,0,1,56,1,56,0.351618000,0.0000
207.236.2.165,<->,136.25.188.177,0,0,1,50,1,50,0.351338000,0.0000
53.201.231.216,<->,48.53.35.6,0,0,1,50,1,50,0.351286000,0.0000
112.12.176.125,<->,50.224.76.234,0,0,1,50,1,50,0.350854000,0.0000
112.225.115.46,<->,50.224.76.235,0,0,1,50,1,50,0.350677000,0.0000
130.1.23.14,<->,80.38.16.211,0,0,1,50,1,50,0.350533000,0.0000
196.97.162.45,<->,133.32.39.1,0,0,1,56,1,56,0.349576000,0.0000
215.158.239.96,<->,194.199.198.183,1,56,0,0,1,56,0.348722000,0.0000
129.95.133.231,<->,8.193.65.211,0,0,1,56,1,56,0.348580000,0.0000
215.158.239.69,<->,195.41.26.19,1,56,0,0,1,56,0.348217000,0.0000
142.249.254.162,<->,136.25.188.241,0,0,1,56,1,56,0.348124000,0.0000
215.158.238.118,<->,100.216.78.145,1,56,0,0,1,56,0.347949000,0.0000
194.233.73.10,<->,136.25.188.225,0,0,1,56,1,56,0.347749000,0.0000
133.32.39.1,<->,8.191.1.176,1,56,0,0,1,56,0.347305000,0.0000
204.61.232.46,<->,136.25.188.53,0,0,1,56,1,56,0.347084000,0.0000
215.158.239.96,<->,199.20.29.176,1,56,0,0,1,56,0.347009000,0.0000
215.158.239.197,<->,212.249.34.46,1,67,0,0,1,67,0.346773000,0.0000
101.65.255.233,<->,100.224.138.151,1,56,0,0,1,56,0.346716000,0.0000
204.226.202.94,<->,50.224.76.235,0,0,1,50,1,50,0.346071000,0.0000
215.158.239.50,<->,199.20.29.149,1,56,0,0,1,56,0.346021000,0.0000
202.33.49.114,<->,136.25.188.162,0,0,1,56,1,56,0.345869000,0.0000
132.216.159.29,<->,92.162.253.30,0,0,1,50,1,50,0.345205000,0.0000
194.234.135.124,<->,136.25.188.242,0,0,1,56,1,56,0.344296000,0.0000
213.221.90.202,<->,144.85.170.248,0,0,1,56,1,56,0.343960000,0.0000
215.158.238.133,<->,143.155.227.33,1,56,0,0,1,56,0.343346000,0.0000
192.67.181.42,<->,124.22.107.37,1,56,0,0,1,56,0.343141000,0.0000
199.52.136.207,<->,136.25.188.252,0,0,1,50,1,50,0.343034000,0.0000
90.240.140.159,<->,53.244.244.128,1,56,0,0,1,56,0.342643000,0.0000
195.54.71.167,<->,136.25.188.227,0,0,1,56,1,56,0.342039000,0.0000
197.113.99.91,<->,136.25.188.253,0,0,1,56,1,56,0.341751000,0.0000
247.136.181.176,<->,38.64.107.17,1,50,0,0,1,50,0.341626000,0.0000
215.158.238.85,<->,145.116.209.76,1,56,0,0,1,56,0.341485000,0.0000
50.224.76.235,<->,29.220.119.83,1,56,0,0,1,56,0.341336000,0.0000
215.158.239.94,<->,199.20.29.73,1,56,0,0,1,56,0.340522000,0.0000
145.235.126.55,<->,50.224.76.234,0,0,1,56,1,56,0.339926000,0.0000
231.140.157.228,<->,136.25.188.226,0,0,1,56,1,56,0.339904000,0.0000
92.168.217.228,<->,78.151.34.195,1,56,0,0,1,56,0.339056000,0.0000
215.158.239.95,<->,194.186.217.194,1,56,0,0,1,56,0.338797000,0.0000
215.158.132.36,<->,133.32.39.1,0,0,1,56,1,56,0.338552000,0.0000
221.102.56.69,<->,192.67.161.246,0,0,1,56,1,56,0.338303000,0.0000
221.102.143.189,<->,220.81.54.34,0,0,1,141,1,141,0.338082000,0.0000
210.158.44.0,<->,111.151.238.96,1,50,0,0,1,50,0.337432000,0.0000
120.159.169.25,<->,50.224.76.230,0,0,1,50,1,50,0.336565000,0.0000
121.5.245.69,<->,101.253.111.244,0,0,1,56,1,56,0.335839000,0.0000
204.200.41.151,<->,136.25.188.255,0,0,1,56,1,56,0.335469000,0.0000
17.6.117.77,<->,8.220.188.138,0,0,1,56,1,56,0.334246000,0.0000
215.158.239.77,<->,195.83.72.213,1,56,0,0,1,56,0.334192000,0.0000
206.195.206.101,<->,129.92.113.35,0,0,1,56,1,56,0.333226000,0.0000
58.202.67.48,<->,8.252.221.237,0,0,1,50,1,50,0.333225000,0.0000
215.158.239.99,<->,199.20.31.39,1,56,0,0,1,56,0.332890000,0.0000
192.229.220.63,<->,111.151.238.139,1,56,0,0,1,56,0.332865000,0.0000
215.158.239.93,<->,195.5.144.201,1,50,0,0,1,50,0.332313000,0.0000
148.155.131.56,<->,92.27.27.185,0,0,1,50,1,50,0.332021000,0.0000
195.3.118.142,<->,8.252.222.140,0,0,1,50,1,50,0.331621000,0.0000
144.64.138.107,<->,129.254.101.205,1,50,0,0,1,50,0.331546000,0.0000
144.87.235.222,<->,120.83.145.40,1,292,0,0,1,292,0.331500000,0.0000
210.137.205.233,<->,144.85.170.246,0,0,1,56,1,56,0.331494000,0.0000
199.69.142.235,<->,136.25.188.222,0,0,1,56,1,56,0.331459000,0.0000
231.142.47.124,<->,136.25.188.45,0,0,1,50,1,50,0.331296000,0.0000
204.130.137.8,<->,0.195.210.46,0,0,1,56,1,56,0.331134000,0.0000
221.102.56.46,<->,192.64.112.18,0,0,1,56,1,56,0.330595000,0.0000
147.58.211.37,<->,8.252.221.213,0,0,1,56,1,56,0.330515000,0.0000
204.200.50.7,<->,136.25.188.198,0,0,1,50,1,50,0.330476000,0.0000
215.158.239.85,<->,199.20.6.68,1,56,0,0,1,56,0.330335000,0.0000
130.79.65.92,<->,8.252.222.205,0,0,1,56,1,56,0.329844000,0.0000
159.190.89.148,<->,8.182.253.40,0,0,1,50,1,50,0.329373000,0.0000
129.28.175.197,<->,50.224.76.230,0,0,1,56,1,56,0.329313000,0.0000
119.159.22.233,<->,92.162.253.161,0,0,1,50,1,50,0.327961000,0.0000
215.158.140.184,<->,39.189.135.157,1,50,0,0,1,50,0.327412000,0.0000
133.178.226.215,<->,131.31.253.219,1,56,0,0,1,56,0.327386000,0.0000
50.224.76.234,<->,38.182.145.45,1,50,0,0,1,50,0.327093000,0.0000
215.158.140.27,<->,149.161.153.103,1,56,0,0,1,56,0.327062000,0.0000
246.253.253.169,<->,139.33.174.13,1,50,0,0,1,50,0.326788000,0.0000
204.200.54.126,<->,136.25.188.226,0,0,1,56,1,56,0.326562000,0.0000
142.208.46.85,<->,136.25.188.209,0,0,1,50,1,50,0.326537000,0.0000
101.70.115.232,<->,53.161.31.120,1,50,0,0,1,50,0.326442000,0.0000
204.56.7.227,<->,136.25.188.226,0,0,1,50,1,50,0.326407000,0.0000
207.236.2.165,<->,136.25.188.45,0,0,1,50,1,50,0.326316000,0.0000
133.178.227.159,<->,100.237.111.179,1,50,0,0,1,50,0.325212000,0.0000
137.69.84.28,<->,8.182.252.86,0,0,1,50,1,50,0.325159000,0.0000
95.77.217.246,<->,50.224.76.235,0,0,1,50,1,50,0.324273000,0.0000
215.158.239.56,<->,199.20.28.145,1,56,0,0,1,56,0.324095000,0.0000
195.65.122.97,<->,8.182.228.158,0,0,1,50,1,50,0.324045000,0.0000
204.187.173.185,<->,136.25.188.198,0,0,1,56,1,56,0.323851000,0.0000
17.5.228.52,<->,8.220.185.236,0,0,1,56,1,56,0.323739000,0.0000
215.158.239.96,<->,199.69.134.39,1,50,0,0,1,50,0.322703000,0.0000
215.158.238.144,<->,80.57.141.219,1,56,0,0,1,56,0.321710000,0.0000
215.158.140.27,<->,140.163.223.215,1,56,0,0,1,56,0.321270000,0.0000
8.182.245.10,<->,6.20.17.204,1,50,0,0,1,50,0.320954000,0.0000
202.77.250.77,<->,8.252.222.175,0,0,1,56,1,56,0.320613000,0.0000
202.33.202.124,<->,136.25.188.240,0,0,1,56,1,56,0.320422000,0.0000
200.175.88.134,<->,136.25.188.196,0,0,1,50,1,50,0.320376000,0.0000
204.200.44.157,<->,136.25.188.209,0,0,1,56,1,56,0.319667000,0.0000
215.201.227.68,<->,144.85.170.244,0,0,1,56,1,56,0.318948000,0.0000
197.106.125.98,<->,136.25.188.163,0,0,1,56,1,56,0.318920000,0.0000
142.229.6.90,<->,136.25.188.197,0,0,1,50,1,50,0.318799000,0.0000
112.105.25.216,<->,91.231.193.200,0,0,1,50,1,50,0.318748000,0.0000
142.228.48.148,<->,136.25.188.236,0,0,1,50,1,50,0.318353000,0.0000
112.104.254.44,<->,92.27.27.165,0,0,1,56,1,56,0.318285000,0.0000
246.253.168.231,<->,112.11.94.153,1,50,0,0,1,50,0.317834000,0.0000
145.10.193.189,<->,50.224.76.234,0,0,1,50,1,50,0.317601000,0.0000
111.151.237.12,<->,50.224.105.38,0,0,1,56,1,56,0.317066000,0.0000
54.37.1.37,<->,48.53.6.121,0,0,1,56,1,56,0.316542000,0.0000
69.220.6.1,<->,8.252.221.206,0,0,1,56,1,56,0.316522000,0.0000
50.224.76.235,<->,17.12.130.178,1,56,0,0,1,56,0.315956000,0.0000
215.158.140.12,<->,129.222.39.198,1,56,0,0,1,56,0.315735000,0.0000
92.27.4.183,<->,82.198.194.236,0,0,1,50,1,50,0.315628000,0.0000
215.158.239.70,<->,199.20.29.39,1,56,0,0,1,56,0.315474000,0.0000
142.237.201.159,<->,136.25.188.241,0,0,1,56,1,56,0.314424000,0.0000
204.200.53.246,<->,136.25.188.220,0,0,1,132,1,132,0.313861000,0.0000
215.158.239.96,<->,194.251.159.84,1,50,0,0,1,50,0.313756000,0.0000
215.158.238.223,<->,143.155.227.33,1,56,0,0,1,56,0.313692000,0.0000
196.200.77.166,<->,50.223.3.228,0,0,1,50,1,50,0.313131000,0.0000
152.99.196.203,<->,0.195.210.42,0,0,1,56,1,56,0.312470000,0.0000
207.86.243.25,<->,8.252.222.221,0,0,1,56,1,56,0.311956000,0.0000
69.128.79.174,<->,53.68.31.204,1,56,0,0,1,56,0.311859000,0.0000
199.71.190.149,<->,136.25.188.177,0,0,1,50,1,50,0.310096000,0.0000
53.249.52.16,<->,50.224.109.239,0,0,1,56,1,56,0.309882000,0.0000
215.158.239.96,<->,199.20.30.134,1,56,0,0,1,56,0.309319000,0.0000
199.60.209.85,<->,97.198.117.219,0,0,1,56,1,56,0.308234000,0.0000
202.77.250.77,<->,8.252.222.148,0,0,1,56,1,56,0.307890000,0.0000
220.83.116.142,<->,97.4.116.46,1,50,0,0,1,50,0.307810000,0.0000
215.158.140.27,<->,123.101.54.16,1,56,0,0,1,56,0.307471000,0.0000
192.170.241.192,<->,8.252.221.166,0,0,1,56,1,56,0.307452000,0.0000
238.118.126.97,<->,91.51.57.236,1,50,0,0,1,50,0.306690000,0.0000
142.223.185.59,<->,136.25.188.177,0,0,1,56,1,56,0.306681000,0.0000
57.133.55.41,<->,50.224.76.248,0,0,1,50,1,50,0.306617000,0.0000
192.170.241.192,<->,99.74.27.4,0,0,1,56,1,56,0.306277000,0.0000
213.186.52.86,<->,144.85.170.254,0,0,1,56,1,56,0.306179000,0.0000
215.158.239.95,<->,199.106.230.90,1,56,0,0,1,56,0.305873000,0.0000
199.80.96.193,<->,50.224.76.235,0,0,1,50,1,50,0.305517000,0.0000
89.155.31.210,<->,8.183.25.124,0,0,1,56,1,56,0.305476000,0.0000
97.182.7.27,<->,8.220.178.246,0,0,1,50,1,50,0.305277000,0.0000
221.102.143.189,<->,98.128.110.36,0,0,1,141,1,141,0.304166000,0.0000
115.83.161.215,<->,35.56.96.84,0,0,1,50,1,50,0.303184000,0.0000
133.178.226.255,<->,97.4.157.0,1,50,0,0,1,50,0.301984000,0.0000
215.158.239.76,<->,199.78.34.73,1,56,0,0,1,56,0.301181000,0.0000
139.163.5.140,<->,29.165.29.168,1,50,0,0,1,50,0.301067000,0.0000
195.6.18.221,<->,136.25.188.45,0,0,1,50,1,50,0.300609000,0.0000
194.237.14.36,<->,136.25.188.238,0,0,1,56,1,56,0.300022000,0.0000
215.158.239.48,<->,196.105.127.143,1,56,0,0,1,56,0.299955000,0.0000
198.8.34.104,<->,139.163.5.140,0,0,1,50,1,50,0.299045000,0.0000
92.26.154.123,<->,14.94.93.84,0,0,1,50,1,50,0.299008000,0.0000
215.158.239.51,<->,199.20.4.160,1,56,0,0,1,56,0.299005000,0.0000
195.5.31.103,<->,136.25.188.176,0,0,1,50,1,50,0.298790000,0.0000
199.32.124.159,<->,136.25.188.55,0,0,1,50,1,50,0.298734000,0.0000
195.70.174.195,<->,136.25.188.226,0,0,1,56,1,56,0.298400000,0.0000
213.186.52.49,<->,144.85.170.208,0,0,1,56,1,56,0.298074000,0.0000
195.13.140.158,<->,136.25.188.209,0,0,1,132,1,132,0.297082000,0.0000
194.233.73.10,<->,136.25.188.239,0,0,1,56,1,56,0.296200000,0.0000
221.102.143.189,<->,109.3.153.204,0,0,1,141,1,141,0.296001000,0.0000
100.198.81.146,<->,8.20.87.155,0,0,1,50,1,50,0.295889000,0.0000
221.102.56.46,<->,192.67.185.2,0,0,1,56,1,56,0.295702000,0.0000
202.124.181.75,<->,8.252.221.236,0,0,1,50,1,50,0.295101000,0.0000
199.14.207.55,<->,136.25.188.160,0,0,1,56,1,56,0.294879000,0.0000
89.183.104.189,<->,27.41.227.36,1,50,0,0,1,50,0.294713000,0.0000
221.102.143.189,<->,192.66.169.73,0,0,1,56,1,56,0.294653000,0.0000
207.60.13.88,<->,136.25.188.252,0,0,1,50,1,50,0.294494000,0.0000
215.158.140.27,<->,29.209.4.208,1,56,0,0,1,56,0.294309000,0.0000
195.5.14.64,<->,136.25.188.242,0,0,1,50,1,50,0.294067000,0.0000
195.0.26.234,<->,108.134.126.45,0,0,1,50,1,50,0.292956000,0.0000
144.87.238.89,<->,8.183.25.124,0,0,1,50,1,50,0.292490000,0.0000
97.126.4.255,<->,27.10.94.65,1,56,0,0,1,56,0.292338000,0.0000
215.158.239.76,<->,207.191.122.139,1,56,0,0,1,56,0.292314000,0.0000
215.158.239.182,<->,100.224.132.151,1,56,0,0,1,56,0.291361000,0.0000
199.51.121.87,<->,136.25.188.252,0,0,1,50,1,50,0.291261000,0.0000
220.20.253.61,<->,145.16.33.197,0,0,1,50,1,50,0.290978000,0.0000
142.248.52.1,<->,136.25.188.198,0,0,1,50,1,50,0.290769000,0.0000
213.221.90.156,<->,50.224.76.234,0,0,1,56,1,56,0.290594000,0.0000
126.198.149.124,<->,99.72.69.129,0,0,1,50,1,50,0.290409000,0.0000
149.192.23.223,<->,136.25.189.47,0,0,1,56,1,56,0.290195000,0.0000
54.37.31.141,<->,48.54.90.198,0,0,1,50,1,50,0.290010000,0.0000
80.38.39.168,<->,0.82.61.6,1,50,0,0,1,50,0.289483000,0.0000
207.188.217.118,<->,136.25.188.252,0,0,1,56,1,56,0.289448000,0.0000
136.25.188.240,<->,8.255.92.246,1,56,0,0,1,56,0.289307000,0.0000
109.222.200.93,<->,105.65.93.60,1,56,0,0,1,56,0.289192000,0.0000
215.158.239.0,<->,215.158.127.152,1,56,0,0,1,56,0.289043000,0.0000
8.220.189.63,<->,6.101.72.29,1,50,0,0,1,50,0.288923000,0.0000
196.247.34.76,<->,136.25.188.253,0,0,1,56,1,56,0.288674000,0.0000
89.216.125.163,<->,53.224.84.147,1,50,0,0,1,50,0.288544000,0.0000
159.137.162.213,<->,93.215.154.0,1,50,0,0,1,50,0.288148000,0.0000
197.105.54.16,<->,136.25.188.52,0,0,1,50,1,50,0.287813000,0.0000
136.181.48.230,<->,53.230.100.50,1,56,0,0,1,56,0.286040000,0.0000
197.7.105.185,<->,8.183.25.25,0,0,1,56,1,56,0.285387000,0.0000
138.20.8.9,<->,8.220.202.59,0,0,1,50,1,50,0.285248000,0.0000
243.117.125.59,<->,220.55.100.127,0,0,1,50,1,50,0.285202000,0.0000
210.220.219.150,<->,50.239.32.214,1,56,0,0,1,56,0.284708000,0.0000
210.158.44.46,<->,145.255.183.195,1,50,0,0,1,50,0.284195000,0.0000
215.158.42.95,<->,133.178.226.223,0,0,1,56,1,56,0.284009000,0.0000
215.158.239.48,<->,194.203.230.244,1,56,0,0,1,56,0.283883000,0.0000
119.45.10.75,<->,92.162.253.119,0,0,1,50,1,50,0.283841000,0.0000
215.158.238.201,<->,53.231.140.175,1,50,0,0,1,50,0.283799000,0.0000
204.61.201.44,<->,136.25.188.254,0,0,1,50,1,50,0.283296000,0.0000
215.158.239.86,<->,199.20.30.215,1,56,0,0,1,56,0.282797000,0.0000
144.85.170.254,<->,97.22.63.173,1,56,0,0,1,56,0.282764000,0.0000
194.237.110.86,<->,136.25.188.46,0,0,1,56,1,56,0.282622000,0.0000
194.194.156.183,<->,50.223.3.228,0,0,1,50,1,50,0.281923000,0.0000
220.50.242.203,<->,215.158.239.109,0,0,1,56,1,56,0.281417000,0.0000
143.155.227.33,<->,133.178.226.90,0,0,1,56,1,56,0.281412000,0.0000
199.32.116.94,<->,136.25.188.226,0,0,1,56,1,56,0.280983000,0.0000
195.7.204.209,<->,136.25.188.242,0,0,1,50,1,50,0.280644000,0.0000
116.141.20.175,<->,50.224.76.230,0,0,1,50,1,50,0.280521000,0.0000
142.229.188.92,<->,136.25.188.163,0,0,1,56,1,56,0.279757000,0.0000
143.155.227.33,<->,136.25.188.220,0,0,1,56,1,56,0.279629000,0.0000
207.188.245.68,<->,136.25.188.177,0,0,1,50,1,50,0.279456000,0.0000
131.22.119.229,<->,92.162.253.172,0,0,1,50,1,50,0.279231000,0.0000
215.158.239.49,<->,196.108.121.89,1,56,0,0,1,56,0.278390000,0.0000
215.158.239.95,<->,199.20.28.234,1,56,0,0,1,56,0.278321000,0.0000
207.56.239.111,<->,136.25.188.225,0,0,1,56,1,56,0.278317000,0.0000
80.40.80.132,<->,8.55.211.213,1,56,0,0,1,56,0.278112000,0.0000
136.25.188.29,<->,53.208.237.45,1,56,0,0,1,56,0.277506000,0.0000
215.158.238.66,<->,143.155.227.33,1,56,0,0,1,56,0.277170000,0.0000
195.70.127.107,<->,136.25.188.210,0,0,1,50,1,50,0.277124000,0.0000
125.199.233.239,<->,8.182.230.134,0,0,1,56,1,56,0.277105000,0.0000
141.232.245.107,<->,91.251.76.107,0,0,1,50,1,50,0.276278000,0.0000
215.158.140.27,<->,114.150.180.191,1,56,0,0,1,56,0.275935000,0.0000
215.158.239.56,<->,199.20.7.93,1,56,0,0,1,56,0.275783000,0.0000
195.71.86.203,<->,136.25.188.211,0,0,1,50,1,50,0.275507000,0.0000
233.169.18.253,<->,136.25.188.243,0,0,1,56,1,56,0.275443000,0.0000
202.33.241.197,<->,136.25.188.252,0,0,1,56,1,56,0.275377000,0.0000
215.158.239.87,<->,195.55.181.10,1,50,0,0,1,50,0.275134000,0.0000
199.32.126.132,<->,136.25.188.45,0,0,1,56,1,56,0.274782000,0.0000
122.172.176.39,<->,50.224.76.235,0,0,1,56,1,56,0.274544000,0.0000
209.91.171.63,<->,8.220.190.86,0,0,1,50,1,50,0.274385000,0.0000
220.55.64.92,<->,105.201.86.57,1,50,0,0,1,50,0.273384000,0.0000
199.68.119.238,<->,136.25.188.53,0,0,1,50,1,50,0.273029000,0.0000
215.158.239.56,<->,143.89.225.38,1,50,0,0,1,50,0.273010000,0.0000
195.4.59.185,<->,136.25.188.253,0,0,1,56,1,56,0.272938000,0.0000
220.55.112.205,<->,139.181.243.246,1,50,0,0,1,50,0.272754000,0.0000
215.158.239.58,<->,207.191.253.169,1,50,0,0,1,50,0.272629000,0.0000
215.158.30.219,<->,136.25.188.51,0,0,1,56,1,56,0.272447000,0.0000
215.158.239.182,<->,68.231.30.24,1,56,0,0,1,56,0.271976000,0.0000
61.125.166.13,<->,8.252.222.61,0,0,1,56,1,56,0.271851000,0.0000
204.61.201.44,<->,136.25.188.178,0,0,1,50,1,50,0.271038000,0.0000
220.55.91.137,<->,112.84.117.133,1,50,0,0,1,50,0.270591000,0.0000
111.146.160.51,<->,53.214.239.188,1,50,0,0,1,50,0.270437000,0.0000
199.53.241.8,<->,136.25.188.178,0,0,1,50,1,50,0.270330000,0.0000
204.61.232.46,<->,136.25.188.225,0,0,1,56,1,56,0.270202000,0.0000
215.158.239.78,<->,207.228.66.131,1,50,0,0,1,50,0.269300000,0.0000
215.158.238.116,<->,145.116.209.93,1,56,0,0,1,56,0.269257000,0.0000
142.190.39.7,<->,136.25.188.241,0,0,1,56,1,56,0.269107000,0.0000
215.158.239.84,<->,199.106.134.127,1,56,0,0,1,56,0.269074000,0.0000
99.115.52.80,<->,8.220.179.94,0,0,1,56,1,56,0.268721000,0.0000
48.16.198.210,<->,8.252.221.197,0,0,1,50,1,50,0.268105000,0.0000
74.19.77.65,<->,50.224.76.235,0,0,1,50,1,50,0.267853000,0.0000
195.126.186.115,<->,136.25.188.174,0,0,1,50,1,50,0.267336000,0.0000
194.237.117.52,<->,136.25.188.243,0,0,1,56,1,56,0.267332000,0.0000
143.20.129.97,<->,136.25.188.254,0,0,1,56,1,56,0.267309000,0.0000
220.20.200.107,<->,132.216.159.4,1,791,0,0,1,791,0.266864000,0.0000
204.200.37.77,<->,136.25.188.177,0,0,1,56,1,56,0.266811000,0.0000
50.224.76.235,<->,17.25.64.204,1,56,0,0,1,56,0.266671000,0.0000
215.158.140.202,<->,72.151.67.38,1,192,0,0,1,192,0.266645000,0.0000
215.158.239.99,<->,199.20.6.216,1,56,0,0,1,56,0.266600000,0.0000
222.28.123.161,<->,50.224.76.234,0,0,1,56,1,56,0.266500000,0.0000
215.158.239.71,<->,207.188.86.6,1,56,0,0,1,56,0.266177000,0.0000
197.46.47.36,<->,8.52.178.229,0,0,1,50,1,50,0.265888000,0.0000
8.52.246.3,<->,8.42.79.134,1,56,0,0,1,56,0.265852000,0.0000
215.158.239.92,<->,196.88.174.103,1,56,0,0,1,56,0.265744000,0.0000
215.158.239.56,<->,196.90.141.188,1,50,0,0,1,50,0.265603000,0.0000
215.158.239.50,<->,199.32.187.69,1,50,0,0,1,50,0.265361000,0.0000
221.102.56.69,<->,109.3.172.183,0,0,1,56,1,56,0.265359000,0.0000
215.158.239.253,<->,113.24.0.18,1,56,0,0,1,56,0.265312000,0.0000
194.222.49.28,<->,50.223.3.228,0,0,1,50,1,50,0.264967000,0.0000
129.95.133.231,<->,14.119.194.95,0,0,1,50,1,50,0.264518000,0.0000
80.27.153.103,<->,4.129.110.82,1,56,0,0,1,56,0.264349000,0.0000
117.10.216.132,<->,50.224.76.235,0,0,1,56,1,56,0.264296000,0.0000
10.186.7.79,<->,8.52.179.217,0,0,1,50,1,50,0.264162000,0.0000
53.181.160.213,<->,8.228.215.154,0,0,1,50,1,50,0.264078000,0.0000
159.137.162.213,<->,6.212.69.136,1,50,0,0,1,50,0.263766000,0.0000
215.158.239.76,<->,207.190.173.163,1,56,0,0,1,56,0.263689000,0.0000
8.228.221.102,<->,0.48.112.144,1,609,0,0,1,609,0.263679000,0.0000
142.227.66.226,<->,136.25.188.198,0,0,1,50,1,50,0.263347000,0.0000
215.158.140.27,<->,8.219.187.239,1,56,0,0,1,56,0.263295000,0.0000
215.158.239.85,<->,199.20.30.22,1,50,0,0,1,50,0.262591000,0.0000
89.183.111.155,<->,8.163.116.117,1,50,0,0,1,50,0.262518000,0.0000
247.136.184.130,<->,210.209.251.211,1,50,0,0,1,50,0.262426000,0.0000
139.5.114.37,<->,8.52.184.173,0,0,1,56,1,56,0.261226000,0.0000
142.191.122.134,<->,136.25.188.45,0,0,1,50,1,50,0.261089000,0.0000
111.147.71.150,<->,53.245.79.95,1,56,0,0,1,56,0.260583000,0.0000
215.158.239.56,<->,199.20.30.229,1,56,0,0,1,56,0.259840000,0.0000
246.108.92.97,<->,139.193.141.139,0,0,1,56,1,56,0.259334000,0.0000
145.110.157.4,<->,50.223.3.228,0,0,1,56,1,56,0.259051000,0.0000
215.158.239.84,<->,196.104.15.90,1,50,0,0,1,50,0.258838000,0.0000
207.239.217.224,<->,136.25.188.225,0,0,1,50,1,50,0.258713000,0.0000
100.124.212.156,<->,80.41.38.205,0,0,1,50,1,50,0.258442000,0.0000
200.175.80.143,<->,53.243.9.83,1,50,0,0,1,50,0.258245000,0.0000
239.66.58.12,<->,138.98.204.211,0,0,1,566,1,566,0.258165000,0.0000
215.158.239.92,<->,199.32.187.69,1,50,0,0,1,50,0.257259000,0.0000
215.158.239.56,<->,199.20.31.137,1,56,0,0,1,56,0.257012000,0.0000
204.185.99.10,<->,136.25.188.46,0,0,1,56,1,56,0.256798000,0.0000
215.158.238.201,<->,100.216.78.145,1,56,0,0,1,56,0.256559000,0.0000
97.127.127.14,<->,54.58.183.105,1,50,0,0,1,50,0.256461000,0.0000
221.102.143.189,<->,220.80.132.255,0,0,1,141,1,141,0.256227000,0.0000
215.158.239.48,<->,199.20.30.82,1,56,0,0,1,56,0.255987000,0.0000
50.224.76.235,<->,4.241.131.82,1,50,0,0,1,50,0.255835000,0.0000
133.164.32.53,<->,54.50.173.203,1,50,0,0,1,50,0.255290000,0.0000
195.5.157.190,<->,136.25.188.173,0,0,1,50,1,50,0.254643000,0.0000
80.27.153.100,<->,4.129.110.82,1,56,0,0,1,56,0.254472000,0.0000
159.137.152.55,<->,133.178.226.66,0,0,1,56,1,56,0.254113000,0.0000
215.158.239.78,<->,143.128.227.162,1,50,0,0,1,50,0.254059000,0.0000
215.158.239.92,<->,199.106.140.78,1,56,0,0,1,56,0.253510000,0.0000
199.111.145.156,<->,8.182.227.180,0,0,1,50,1,50,0.253275000,0.0000
243.117.82.44,<->,129.78.117.164,0,0,1,50,1,50,0.253195000,0.0000
152.43.76.51,<->,8.252.222.60,0,0,1,56,1,56,0.252495000,0.0000
220.20.200.86,<->,35.107.149.134,1,50,0,0,1,50,0.252139000,0.0000
142.254.141.3,<->,136.25.188.225,0,0,1,56,1,56,0.251546000,0.0000
252.98.180.173,<->,112.208.20.152,1,50,0,0,1,50,0.251139000,0.0000
143.155.227.33,<->,136.25.188.226,0,0,1,56,1,56,0.251009000,0.0000
139.249.95.234,<->,100.120.38.6,1,56,0,0,1,56,0.250796000,0.0000
144.87.235.222,<->,115.151.119.83,1,50,0,0,1,50,0.250383000,0.0000
231.142.160.54,<->,136.25.188.53,0,0,1,56,1,56,0.249618000,0.0000
215.158.239.96,<->,207.63.146.161,1,56,0,0,1,56,0.247444000,0.0000
145.18.193.4,<->,128.91.191.99,1,56,0,0,1,56,0.247258000,0.0000
246.253.168.245,<->,57.7.1.42,1,50,0,0,1,50,0.246867000,0.0000
127.159.140.231,<->,98.232.172.244,0,0,1,50,1,50,0.246796000,0.0000
215.158.239.49,<->,195.81.38.28,1,56,0,0,1,56,0.246639000,0.0000
94.192.105.48,<->,8.252.222.157,0,0,1,56,1,56,0.246631000,0.0000
32.235.1.60,<->,8.220.202.4,0,0,1,56,1,56,0.246412000,0.0000
139.148.43.59,<->,8.182.227.29,0,0,1,50,1,50,0.245965000,0.0000
215.158.239.84,<->,199.20.30.50,1,56,0,0,1,56,0.245447000,0.0000
215.158.239.57,<->,199.20.31.175,1,56,0,0,1,56,0.245338000,0.0000
195.15.42.227,<->,136.25.188.52,0,0,1,50,1,50,0.244922000,0.0000
192.229.215.71,<->,4.240.210.61,1,50,0,0,1,50,0.244716000,0.0000
115.85.162.14,<->,50.224.76.230,0,0,1,50,1,50,0.244429000,0.0000
247.203.163.230,<->,50.224.76.230,0,0,1,56,1,56,0.244244000,0.0000
133.178.226.197,<->,106.188.254.175,1,56,0,0,1,56,0.243681000,0.0000
246.254.97.229,<->,54.58.153.140,1,87,0,0,1,87,0.243659000,0.0000
195.14.19.180,<->,136.25.188.242,0,0,1,50,1,50,0.243642000,0.0000
207.173.199.186,<->,136.25.188.196,0,0,1,56,1,56,0.243272000,0.0000
194.237.3.118,<->,136.25.188.46,0,0,1,56,1,56,0.243089000,0.0000
197.198.21.33,<->,80.38.52.42,0,0,1,56,1,56,0.242869000,0.0000
136.25.188.202,<->,80.57.141.142,1,56,0,0,1,56,0.242603000,0.0000
142.175.130.184,<->,50.223.3.230,0,0,1,50,1,50,0.242273000,0.0000
159.137.162.213,<->,122.205.7.221,1,50,0,0,1,50,0.241830000,0.0000
197.146.98.193,<->,8.20.87.144,0,0,1,56,1,56,0.241267000,0.0000
159.248.57.67,<->,136.25.188.209,0,0,1,56,1,56,0.240780000,0.0000
139.163.20.162,<->,89.154.151.249,1,50,0,0,1,50,0.240649000,0.0000
195.41.121.95,<->,136.25.188.241,0,0,1,50,1,50,0.240353000,0.0000
210.95.218.224,<->,8.220.178.166,0,0,1,56,1,56,0.239656000,0.0000
136.25.188.209,<->,41.169.88.140,1,56,0,0,1,56,0.239589000,0.0000
220.20.200.57,<->,132.216.159.29,1,150,0,0,1,150,0.239030000,0.0000
89.155.144.53,<->,8.183.25.124,0,0,1,56,1,56,0.238374000,0.0000
143.44.10.143,<->,136.25.188.176,0,0,1,50,1,50,0.238233000,0.0000
221.102.56.46,<->,98.129.24.188,0,0,1,56,1,56,0.236902000,0.0000
207.235.168.89,<->,50.224.76.235,0,0,1,50,1,50,0.235498000,0.0000
195.55.148.0,<->,136.25.188.238,0,0,1,50,1,50,0.235137000,0.0000
199.68.238.166,<->,136.25.188.239,0,0,1,56,1,56,0.234260000,0.0000
195.5.195.237,<->,136.25.188.175,0,0,1,56,1,56,0.234095000,0.0000
215.158.238.91,<->,145.116.209.92,1,56,0,0,1,56,0.233338000,0.0000
122.206.38.212,<->,50.224.76.235,0,0,1,50,1,50,0.233061000,0.0000
247.136.171.196,<->,26.218.94.114,1,50,0,0,1,50,0.232395000,0.0000
248.225.29.34,<->,141.20.135.250,1,50,0,0,1,50,0.232174000,0.0000
143.155.227.33,<->,133.178.226.31,0,0,1,56,1,56,0.232087000,0.0000
111.181.100.149,<->,56.114.235.120,1,285,0,0,1,285,0.231896000,0.0000
98.219.126.37,<->,80.38.52.231,0,0,1,50,1,50,0.231519000,0.0000
252.98.149.193,<->,212.249.34.46,1,81,0,0,1,81,0.230974000,0.0000
109.222.252.84,<->,53.231.94.178,1,50,0,0,1,50,0.230614000,0.0000
137.109.175.154,<->,109.1.27.116,0,0,1,50,1,50,0.230442000,0.0000
133.208.38.103,<->,111.146.217.37,0,0,1,50,1,50,0.230429000,0.0000
246.253.253.96,<->,145.242.124.31,1,50,0,0,1,50,0.229975000,0.0000
215.158.239.85,<->,199.20.28.227,1,56,0,0,1,56,0.228692000,0.0000
122.245.156.85,<->,50.224.76.230,0,0,1,50,1,50,0.228665000,0.0000
136.25.188.255,<->,8.227.55.173,1,56,0,0,1,56,0.228521000,0.0000
215.158.239.76,<->,199.20.31.158,1,56,0,0,1,56,0.228110000,0.0000
215.158.239.58,<->,204.226.121.155,1,56,0,0,1,56,0.227447000,0.0000
210.158.44.13,<->,127.206.193.79,1,1197,0,0,1,1197,0.227258000,0.0000
202.33.127.224,<->,136.25.188.220,0,0,1,56,1,56,0.226134000,0.0000
120.165.152.110,<->,92.27.219.217,0,0,1,56,1,56,0.226031000,0.0000
239.36.168.170,<->,80.27.153.2,0,0,1,50,1,50,0.226004000,0.0000
17.248.138.62,<->,8.220.190.86,0,0,1,50,1,50,0.225887000,0.0000
247.136.233.125,<->,100.224.242.153,1,50,0,0,1,50,0.225142000,0.0000
142.223.172.112,<->,136.25.188.178,0,0,1,56,1,56,0.224055000,0.0000
192.64.252.158,<->,27.116.207.55,1,56,0,0,1,56,0.223943000,0.0000
205.225.222.236,<->,35.56.96.142,0,0,1,56,1,56,0.223488000,0.0000
192.67.157.104,<->,119.78.222.103,1,50,0,0,1,50,0.223217000,0.0000
247.136.192.215,<->,158.184.75.213,1,56,0,0,1,56,0.223178000,0.0000
124.31.227.155,<->,50.224.76.234,0,0,1,56,1,56,0.223130000,0.0000
127.143.148.147,<->,0.195.210.42,0,0,1,50,1,50,0.223038000,0.0000
206.243.231.162,<->,111.147.176.215,0,0,1,50,1,50,0.222992000,0.0000
205.170.188.93,<->,50.224.76.235,0,0,1,50,1,50,0.222780000,0.0000
56.8.169.243,<->,8.182.226.122,0,0,1,50,1,50,0.222209000,0.0000
139.114.215.223,<->,89.139.242.246,0,0,1,56,1,56,0.221845000,0.0000
8.220.191.154,<->,6.124.60.228,1,50,0,0,1,50,0.220664000,0.0000
215.158.239.58,<->,143.44.228.84,1,50,0,0,1,50,0.220558000,0.0000
220.243.198.21,<->,8.252.222.85,0,0,1,56,1,56,0.219832000,0.0000
220.20.200.109,<->,132.216.159.4,1,1021,0,0,1,1021,0.219832000,0.0000
82.237.235.84,<->,56.114.235.120,1,221,0,0,1,221,0.219249000,0.0000
215.158.239.68,<->,195.55.52.123,1,89,0,0,1,89,0.219096000,0.0000
215.158.30.229,<->,8.252.222.59,0,0,1,56,1,56,0.219057000,0.0000
204.21.247.24,<->,136.25.188.252,0,0,1,56,1,56,0.216923000,0.0000
204.123.249.197,<->,8.182.248.147,0,0,1,50,1,50,0.216885000,0.0000
142.244.102.123,<->,136.25.188.178,0,0,1,56,1,56,0.216698000,0.0000
215.158.239.70,<->,195.6.240.39,1,50,0,0,1,50,0.215801000,0.0000
215.158.140.87,<->,83.232.28.226,1,50,0,0,1,50,0.215612000,0.0000
50.224.76.234,<->,30.179.242.210,1,56,0,0,1,56,0.215555000,0.0000
195.12.232.125,<->,136.25.188.196,0,0,1,56,1,56,0.215302000,0.0000
136.25.188.53,<->,101.224.63.210,1,56,0,0,1,56,0.214827000,0.0000
97.168.88.160,<->,54.36.97.247,1,50,0,0,1,50,0.214158000,0.0000
199.33.90.170,<->,136.25.188.199,0,0,1,56,1,56,0.213846000,0.0000
202.178.8.72,<->,80.38.21.150,0,0,1,50,1,50,0.213521000,0.0000
194.204.149.101,<->,50.223.3.228,0,0,1,50,1,50,0.213150000,0.0000
195.13.157.94,<->,136.25.188.242,0,0,1,50,1,50,0.212763000,0.0000
132.212.185.37,<->,80.42.130.250,0,0,1,50,1,50,0.212677000,0.0000
100.218.114.30,<->,8.252.221.249,0,0,1,50,1,50,0.212561000,0.0000
99.162.77.146,<->,53.69.165.159,1,56,0,0,1,56,0.211503000,0.0000
80.41.9.195,<->,8.49.69.216,1,50,0,0,1,50,0.211358000,0.0000
199.39.255.127,<->,136.25.188.45,0,0,1,50,1,50,0.211313000,0.0000
220.20.200.87,<->,33.148.97.180,1,50,0,0,1,50,0.210789000,0.0000
221.102.56.69,<->,109.2.14.67,0,0,1,56,1,56,0.210492000,0.0000
17.249.7.20,<->,8.220.234.159,0,0,1,56,1,56,0.210361000,0.0000
104.242.12.102,<->,50.224.76.230,0,0,1,50,1,50,0.210109000,0.0000
235.42.34.20,<->,215.158.238.104,0,0,1,56,1,56,0.209468000,0.0000
215.158.239.86,<->,196.93.217.19,1,56,0,0,1,56,0.209075000,0.0000
142.252.240.15,<->,136.25.188.175,0,0,1,50,1,50,0.208776000,0.0000
139.33.175.144,<->,111.146.238.44,0,0,1,329,1,329,0.208395000,0.0000
204.187.94.208,<->,136.25.188.174,0,0,1,56,1,56,0.208365000,0.0000
220.20.200.56,<->,119.159.22.233,1,50,0,0,1,50,0.208143000,0.0000
220.20.200.137,<->,124.46.191.127,1,50,0,0,1,50,0.207807000,0.0000
195.122.196.132,<->,50.223.3.228,0,0,1,50,1,50,0.207443000,0.0000
202.33.241.197,<->,136.25.188.240,0,0,1,56,1,56,0.207158000,0.0000
119.207.123.153,<->,109.1.24.236,0,0,1,50,1,50,0.207134000,0.0000
202.33.250.128,<->,136.25.188.253,0,0,1,56,1,56,0.207089000,0.0000
142.255.51.0,<->,136.25.188.222,0,0,1,56,1,56,0.206654000,0.0000
130.101.149.241,<->,8.52.245.44,0,0,1,50,1,50,0.206585000,0.0000
132.187.21.147,<->,8.182.245.110,0,0,1,50,1,50,0.206362000,0.0000
220.80.238.163,<->,8.45.172.190,1,294,0,0,1,294,0.206351000,0.0000
218.4.183.100,<->,8.202.89.92,1,50,0,0,1,50,0.206213000,0.0000
50.224.76.235,<->,6.72.205.67,1,56,0,0,1,56,0.205376000,0.0000
17.99.162.116,<->,8.52.189.207,0,0,1,50,1,50,0.205176000,0.0000
192.67.144.154,<->,30.179.117.60,1,56,0,0,1,56,0.203626000,0.0000
211.168.225.235,<->,210.229.230.22,0,0,1,56,1,56,0.203270000,0.0000
215.158.239.78,<->,194.203.39.243,1,56,0,0,1,56,0.202257000,0.0000
199.38.135.45,<->,136.25.188.242,0,0,1,50,1,50,0.202020000,0.0000
138.43.230.96,<->,136.25.188.44,0,0,1,56,1,56,0.201721000,0.0000
239.66.218.254,<->,139.163.41.64,0,0,1,56,1,56,0.201571000,0.0000
248.239.173.39,<->,221.102.143.189,1,141,0,0,1,141,0.200839000,0.0000
215.158.239.57,<->,196.93.237.136,1,56,0,0,1,56,0.200759000,0.0000
129.201.127.101,<->,50.224.76.235,0,0,1,56,1,56,0.200738000,0.0000
213.186.59.207,<->,144.85.170.246,0,0,1,56,1,56,0.200258000,0.0000
80.42.155.7,<->,8.44.70.165,1,56,0,0,1,56,0.199886000,0.0000
116.255.114.125,<->,50.224.76.234,0,0,1,56,1,56,0.199840000,0.0000
229.45.205.2,<->,33.107.81.163,1,50,0,0,1,50,0.199781000,0.0000
194.237.2.156,<->,136.25.188.198,0,0,1,56,1,56,0.199203000,0.0000
133.178.226.14,<->,99.192.168.150,1,56,0,0,1,56,0.198466000,0.0000
17.136.192.115,<->,8.220.200.124,0,0,1,50,1,50,0.198284000,0.0000
89.155.61.186,<->,80.38.51.106,0,0,1,75,1,75,0.197779000,0.0000
215.158.239.79,<->,195.55.46.208,1,50,0,0,1,50,0.197604000,0.0000
142.255.37.135,<->,136.25.188.225,0,0,1,56,1,56,0.197571000,0.0000
215.158.140.7,<->,91.57.169.16,1,56,0,0,1,56,0.197402000,0.0000
215.158.239.78,<->,142.228.171.164,1,50,0,0,1,50,0.197176000,0.0000
207.62.63.248,<->,136.25.188.54,0,0,1,50,1,50,0.196549000,0.0000
139.244.182.239,<->,8.220.191.251,0,0,1,50,1,50,0.196293000,0.0000
200.175.139.115,<->,54.37.5.99,1,56,0,0,1,56,0.195800000,0.0000
139.47.253.215,<->,111.147.243.205,0,0,1,528,1,528,0.195333000,0.0000
112.21.231.57,<->,80.38.41.124,0,0,1,56,1,56,0.194232000,0.0000
159.137.231.128,<->,134.53.247.233,1,50,0,0,1,50,0.193961000,0.0000
204.200.62.131,<->,101.224.204.164,0,0,1,50,1,50,0.193907000,0.0000
229.45.57.4,<->,33.107.91.35,1,50,0,0,1,50,0.193556000,0.0000
89.183.108.71,<->,78.44.110.102,1,50,0,0,1,50,0.193328000,0.0000
215.158.42.204,<->,8.252.221.212,0,0,1,56,1,56,0.193102000,0.0000
136.25.189.85,<->,98.219.126.175,1,56,0,0,1,56,0.192821000,0.0000
192.205.242.85,<->,133.178.226.214,0,0,1,56,1,56,0.191761000,0.0000
142.207.227.148,<->,136.25.188.226,0,0,1,56,1,56,0.191742000,0.0000
195.68.164.36,<->,136.25.188.238,0,0,1,56,1,56,0.190990000,0.0000
221.102.56.69,<->,6.74.193.170,0,0,1,56,1,56,0.190764000,0.0000
207.60.205.57,<->,136.25.188.242,0,0,1,50,1,50,0.190754000,0.0000
143.20.5.146,<->,136.25.188.241,0,0,1,50,1,50,0.190692000,0.0000
215.158.30.238,<->,8.252.222.41,0,0,1,56,1,56,0.190657000,0.0000
143.68.192.161,<->,136.25.188.53,0,0,1,56,1,56,0.190396000,0.0000
215.158.239.95,<->,199.20.30.137,1,56,0,0,1,56,0.189517000,0.0000
247.136.234.120,<->,8.45.253.200,1,56,0,0,1,56,0.189308000,0.0000
142.240.168.221,<->,136.25.188.210,0,0,1,56,1,56,0.188955000,0.0000
132.250.195.48,<->,6.138.238.145,0,0,1,50,1,50,0.187171000,0.0000
144.85.170.244,<->,98.87.144.84,1,56,0,0,1,56,0.186970000,0.0000
139.36.119.127,<->,133.178.226.235,0,0,1,56,1,56,0.186697000,0.0000
205.107.152.23,<->,109.1.7.226,0,0,1,50,1,50,0.186661000,0.0000
195.70.175.8,<->,136.25.188.252,0,0,1,50,1,50,0.186398000,0.0000
207.61.74.26,<->,136.25.188.163,0,0,1,56,1,56,0.185803000,0.0000
206.243.235.195,<->,109.1.7.226,0,0,1,50,1,50,0.185595000,0.0000
142.206.47.161,<->,92.27.194.147,0,0,1,68,1,68,0.185479000,0.0000
111.147.206.204,<->,53.69.124.66,1,50,0,0,1,50,0.184556000,0.0000
101.70.127.164,<->,53.210.61.139,1,56,0,0,1,56,0.184422000,0.0000
215.158.239.68,<->,199.20.31.72,1,56,0,0,1,56,0.184053000,0.0000
193.22.183.181,<->,92.27.219.193,0,0,1,50,1,50,0.184021000,0.0000
139.163.161.169,<->,133.32.39.20,0,0,1,56,1,56,0.183897000,0.0000
207.61.74.26,<->,136.25.188.176,0,0,1,56,1,56,0.183469000,0.0000
142.246.107.19,<->,138.98.237.231,0,0,1,50,1,50,0.183416000,0.0000
215.158.239.220,<->,53.231.141.46,1,50,0,0,1,50,0.183414000,0.0000
192.67.129.87,<->,33.78.121.128,1,56,0,0,1,56,0.183308000,0.0000
136.25.188.236,<->,30.73.95.215,1,56,0,0,1,56,0.183134000,0.0000
144.87.238.55,<->,144.87.235.175,0,0,1,50,1,50,0.182619000,0.0000
148.151.110.48,<->,97.126.31.86,0,0,1,50,1,50,0.182126000,0.0000
195.13.185.107,<->,136.25.188.178,0,0,1,56,1,56,0.181452000,0.0000
195.64.145.70,<->,8.182.244.179,0,0,1,50,1,50,0.181419000,0.0000
215.158.239.84,<->,143.91.200.242,1,56,0,0,1,56,0.181347000,0.0000
207.22.2.241,<->,92.27.194.147,0,0,1,56,1,56,0.181258000,0.0000
234.124.221.110,<->,97.198.98.32,0,0,1,50,1,50,0.180571000,0.0000
207.59.57.219,<->,136.25.188.196,0,0,1,50,1,50,0.180191000,0.0000
205.107.152.205,<->,109.1.7.226,0,0,1,50,1,50,0.178055000,0.0000
123.153.224.242,<->,92.162.253.108,0,0,1,50,1,50,0.177955000,0.0000
102.254.104.31,<->,97.198.108.233,0,0,1,56,1,56,0.177225000,0.0000
207.58.177.183,<->,136.25.188.253,0,0,1,50,1,50,0.176238000,0.0000
144.87.238.89,<->,8.182.227.71,0,0,1,50,1,50,0.175884000,0.0000
221.102.143.189,<->,102.83.155.28,0,0,1,56,1,56,0.175347000,0.0000
115.121.102.239,<->,35.56.101.201,0,0,1,50,1,50,0.175230000,0.0000
215.158.238.67,<->,8.240.116.201,1,56,0,0,1,56,0.175014000,0.0000
207.236.165.249,<->,136.25.188.177,0,0,1,50,1,50,0.174498000,0.0000
193.15.140.40,<->,50.224.76.235,0,0,1,56,1,56,0.173336000,0.0000
215.158.239.86,<->,199.20.30.122,1,56,0,0,1,56,0.172951000,0.0000
145.176.8.232,<->,102.83.21.26,0,0,1,56,1,56,0.172491000,0.0000
92.27.27.178,<->,76.96.121.38,1,50,0,0,1,50,0.171750000,0.0000
109.222.200.34,<->,54.42.32.66,1,56,0,0,1,56,0.171612000,0.0000
207.56.239.246,<->,136.25.188.254,0,0,1,50,1,50,0.171572000,0.0000
142.175.72.165,<->,50.224.76.230,0,0,1,50,1,50,0.171022000,0.0000
216.184.1.91,<->,8.252.222.27,0,0,1,56,1,56,0.170520000,0.0000
195.126.169.171,<->,136.25.188.255,0,0,1,50,1,50,0.169916000,0.0000
231.136.192.239,<->,136.25.188.220,0,0,1,50,1,50,0.169511000,0.0000
207.61.74.26,<->,136.25.188.45,0,0,1,56,1,56,0.168317000,0.0000
112.12.147.43,<->,50.224.76.230,0,0,1,50,1,50,0.168202000,0.0000
195.126.195.51,<->,136.25.188.163,0,0,1,50,1,50,0.167196000,0.0000
215.158.239.68,<->,195.7.4.172,1,50,0,0,1,50,0.166184000,0.0000
197.109.192.192,<->,136.25.188.254,0,0,1,50,1,50,0.166168000,0.0000
207.172.124.98,<->,136.25.188.46,0,0,1,56,1,56,0.165646000,0.0000
194.207.30.214,<->,50.224.76.235,0,0,1,50,1,50,0.165111000,0.0000
207.56.239.246,<->,136.25.188.220,0,0,1,50,1,50,0.164624000,0.0000
231.143.135.39,<->,136.25.188.209,0,0,1,56,1,56,0.163529000,0.0000
102.45.233.201,<->,92.162.252.139,0,0,1,50,1,50,0.163131000,0.0000
142.252.79.72,<->,136.25.188.163,0,0,1,56,1,56,0.162660000,0.0000
205.127.108.114,<->,33.233.141.2,0,0,1,56,1,56,0.162241000,0.0000
121.79.59.152,<->,92.162.253.163,0,0,1,50,1,50,0.161837000,0.0000
195.126.169.171,<->,136.25.188.242,0,0,1,50,1,50,0.161360000,0.0000
142.208.39.25,<->,136.25.188.162,0,0,1,56,1,56,0.161307000,0.0000
207.56.239.246,<->,136.25.188.253,0,0,1,50,1,50,0.160885000,0.0000
195.51.161.187,<->,8.182.234.113,0,0,1,50,1,50,0.159672000,0.0000
101.164.9.247,<->,8.52.181.8,0,0,1,50,1,50,0.159541000,0.0000
222.16.241.187,<->,192.67.157.171,0,0,1,50,1,50,0.159327000,0.0000
144.87.238.91,<->,8.182.227.180,0,0,1,50,1,50,0.158885000,0.0000
60.100.101.24,<->,8.252.222.30,0,0,1,50,1,50,0.158764000,0.0000
215.158.239.73,<->,98.219.126.140,1,56,0,0,1,56,0.158133000,0.0000
252.189.115.2,<->,92.162.253.126,0,0,1,50,1,50,0.156654000,0.0000
210.209.251.211,<->,80.41.38.205,0,0,1,50,1,50,0.156257000,0.0000
95.245.202.233,<->,8.252.221.196,0,0,1,56,1,56,0.156078000,0.0000
149.92.32.188,<->,92.162.253.66,0,0,1,50,1,50,0.156066000,0.0000
132.216.159.4,<->,92.162.253.42,0,0,1,50,1,50,0.155864000,0.0000
215.158.239.57,<->,199.20.30.111,1,141,0,0,1,141,0.155807000,0.0000
207.58.249.61,<->,136.25.188.54,0,0,1,50,1,50,0.155531000,0.0000
215.158.238.247,<->,192.231.44.29,1,56,0,0,1,56,0.155305000,0.0000
101.164.9.247,<->,8.52.169.61,0,0,1,50,1,50,0.154967000,0.0000
243.117.106.157,<->,80.38.36.175,0,0,1,50,1,50,0.154938000,0.0000
199.69.122.48,<->,136.25.188.44,0,0,1,50,1,50,0.154409000,0.0000
192.67.160.11,<->,48.105.167.149,1,50,0,0,1,50,0.153682000,0.0000
136.25.188.211,<->,50.150.173.115,1,56,0,0,1,56,0.153585000,0.0000
220.28.114.28,<->,215.158.239.54,0,0,1,56,1,56,0.153092000,0.0000
213.38.202.60,<->,8.55.211.213,1,56,0,0,1,56,0.152649000,0.0000
215.158.239.101,<->,129.222.39.167,1,56,0,0,1,56,0.151129000,0.0000
102.83.205.217,<->,8.55.209.213,1,56,0,0,1,56,0.150685000,0.0000
215.158.30.184,<->,136.25.188.193,0,0,1,56,1,56,0.150583000,0.0000
17.36.53.25,<->,8.220.200.124,0,0,1,50,1,50,0.150088000,0.0000
215.158.239.99,<->,195.4.121.48,1,50,0,0,1,50,0.149735000,0.0000
199.38.236.20,<->,136.25.188.163,0,0,1,50,1,50,0.149410000,0.0000
145.252.126.29,<->,119.231.171.14,1,50,0,0,1,50,0.149392000,0.0000
248.239.171.126,<->,221.102.56.69,1,56,0,0,1,56,0.149261000,0.0000
159.137.162.213,<->,103.186.254.87,1,50,0,0,1,50,0.149186000,0.0000
221.102.56.46,<->,213.38.232.157,0,0,1,56,1,56,0.148453000,0.0000
159.137.162.213,<->,122.217.246.204,1,50,0,0,1,50,0.147637000,0.0000
252.98.139.211,<->,139.33.175.144,1,50,0,0,1,50,0.147256000,0.0000
215.158.238.89,<->,145.116.209.93,1,56,0,0,1,56,0.147069000,0.0000
145.16.29.114,<->,120.60.249.108,1,50,0,0,1,50,0.146678000,0.0000
68.76.35.119,<->,8.252.221.223,0,0,1,56,1,56,0.145940000,0.0000
249.101.116.54,<->,206.243.231.162,1,103,0,0,1,103,0.145429000,0.0000
137.44.239.78,<->,8.220.202.4,0,0,1,50,1,50,0.145236000,0.0000
101.164.9.247,<->,8.52.185.0,0,0,1,50,1,50,0.144468000,0.0000
192.67.179.218,<->,127.155.247.137,1,50,0,0,1,50,0.143883000,0.0000
215.158.239.234,<->,192.226.44.116,1,56,0,0,1,56,0.143524000,0.0000
159.64.219.139,<->,8.31.37.173,0,0,1,56,1,56,0.143226000,0.0000
136.25.188.163,<->,8.227.55.217,1,56,0,0,1,56,0.143119000,0.0000
199.15.252.123,<->,136.25.188.177,0,0,1,56,1,56,0.142952000,0.0000
215.158.239.79,<->,199.20.31.159,1,56,0,0,1,56,0.142802000,0.0000
142.255.148.143,<->,136.25.188.162,0,0,1,50,1,50,0.142578000,0.0000
241.0.218.79,<->,215.158.140.27,0,0,1,56,1,56,0.142286000,0.0000
101.164.9.247,<->,8.52.185.118,0,0,1,50,1,50,0.142043000,0.0000
248.225.25.172,<->,138.127.204.229,1,50,0,0,1,50,0.140844000,0.0000
80.40.63.107,<->,8.55.224.156,1,56,0,0,1,56,0.140702000,0.0000
195.55.155.53,<->,136.25.188.54,0,0,1,50,1,50,0.140683000,0.0000
204.58.222.8,<->,136.25.188.175,0,0,1,50,1,50,0.139325000,0.0000
221.98.84.169,<->,98.131.228.45,1,50,0,0,1,50,0.137906000,0.0000
80.38.53.9,<->,0.34.37.102,1,50,0,0,1,50,0.137090000,0.0000
215.158.239.182,<->,106.188.226.67,1,56,0,0,1,56,0.136258000,0.0000
215.158.239.85,<->,204.0.247.88,1,56,0,0,1,56,0.135869000,0.0000
245.150.27.157,<->,8.182.136.143,0,0,1,50,1,50,0.133745000,0.0000
143.33.110.161,<->,8.182.239.190,0,0,1,50,1,50,0.133533000,0.0000
133.178.226.14,<->,96.155.60.249,1,56,0,0,1,56,0.132941000,0.0000
144.85.170.254,<->,98.87.144.155,1,56,0,0,1,56,0.132830000,0.0000
101.224.89.134,<->,53.231.93.146,1,50,0,0,1,50,0.132483000,0.0000
195.70.116.13,<->,136.25.188.162,0,0,1,56,1,56,0.131942000,0.0000
158.235.101.245,<->,109.222.213.126,0,0,1,56,1,56,0.131871000,0.0000
142.167.151.105,<->,136.25.188.52,0,0,1,56,1,56,0.131782000,0.0000
101.224.89.248,<->,53.149.149.124,1,56,0,0,1,56,0.131497000,0.0000
215.158.239.78,<->,199.20.28.221,1,56,0,0,1,56,0.131090000,0.0000
215.158.239.93,<->,195.81.124.45,1,56,0,0,1,56,0.130880000,0.0000
220.20.200.48,<->,116.123.12.248,1,248,0,0,1,248,0.130801000,0.0000
146.235.109.66,<->,8.252.221.195,0,0,1,1224,1,1224,0.130759000,0.0000
220.20.200.169,<->,129.19.135.195,1,50,0,0,1,50,0.129395000,0.0000
133.178.226.28,<->,96.155.60.212,1,56,0,0,1,56,0.128093000,0.0000
215.158.239.99,<->,199.20.5.176,1,56,0,0,1,56,0.126868000,0.0000
158.159.95.185,<->,50.224.76.234,0,0,1,50,1,50,0.126044000,0.0000
215.158.239.99,<->,207.59.15.37,1,50,0,0,1,50,0.125888000,0.0000
215.158.140.27,<->,112.70.164.219,1,56,0,0,1,56,0.125215000,0.0000
196.89.228.140,<->,136.25.188.241,0,0,1,56,1,56,0.125063000,0.0000
207.86.243.25,<->,8.252.222.223,0,0,1,56,1,56,0.124864000,0.0000
195.43.49.234,<->,136.25.188.177,0,0,1,56,1,56,0.124635000,0.0000
99.75.190.89,<->,8.55.237.110,1,141,0,0,1,141,0.124308000,0.0000
215.158.239.59,<->,199.20.31.218,1,56,0,0,1,56,0.123907000,0.0000
145.48.251.217,<->,8.52.164.238,0,0,1,56,1,56,0.123169000,0.0000
111.147.189.183,<->,53.149.218.13,1,56,0,0,1,56,0.123034000,0.0000
92.162.253.162,<->,0.48.110.81,1,50,0,0,1,50,0.123001000,0.0000
247.136.156.74,<->,100.124.212.156,1,50,0,0,1,50,0.122092000,0.0000
128.65.94.113,<->,50.224.76.234,0,0,1,50,1,50,0.121858000,0.0000
199.73.34.80,<->,136.25.188.225,0,0,1,56,1,56,0.121238000,0.0000
199.33.198.154,<->,136.25.188.227,0,0,1,56,1,56,0.120736000,0.0000
204.56.107.102,<->,136.25.188.45,0,0,1,56,1,56,0.120543000,0.0000
192.67.179.181,<->,27.198.249.65,1,50,0,0,1,50,0.120469000,0.0000
215.158.239.101,<->,129.222.39.128,1,56,0,0,1,56,0.120367000,0.0000
207.172.190.167,<->,136.25.188.252,0,0,1,56,1,56,0.120181000,0.0000
136.181.39.100,<->,53.189.56.13,1,50,0,0,1,50,0.119591000,0.0000
113.188.212.241,<->,101.224.204.158,0,0,1,56,1,56,0.119450000,0.0000
130.173.241.227,<->,50.224.76.234,0,0,1,50,1,50,0.119404000,0.0000
215.158.239.49,<->,142.190.173.110,1,56,0,0,1,56,0.119382000,0.0000
199.72.48.53,<->,136.25.188.222,0,0,1,50,1,50,0.119326000,0.0000
8.220.190.86,<->,6.101.113.132,1,50,0,0,1,50,0.118211000,0.0000
231.143.96.2,<->,136.25.188.198,0,0,1,68,1,68,0.117540000,0.0000
222.31.15.60,<->,8.220.239.84,0,0,1,56,1,56,0.117183000,0.0000
215.158.238.121,<->,112.220.206.22,1,56,0,0,1,56,0.116668000,0.0000
207.191.229.134,<->,136.25.188.196,0,0,1,50,1,50,0.116510000,0.0000
58.133.235.83,<->,8.252.222.63,0,0,1,50,1,50,0.116193000,0.0000
215.158.239.182,<->,106.188.226.65,1,56,0,0,1,56,0.115956000,0.0000
53.231.92.109,<->,33.233.141.19,0,0,1,50,1,50,0.115184000,0.0000
137.74.4.104,<->,105.133.200.122,1,50,0,0,1,50,0.115110000,0.0000
220.28.85.14,<->,136.25.189.24,0,0,1,56,1,56,0.114246000,0.0000
142.221.77.155,<->,136.25.188.225,0,0,1,50,1,50,0.114190000,0.0000
210.95.218.219,<->,50.224.103.30,0,0,1,56,1,56,0.113028000,0.0000
204.187.124.135,<->,136.25.188.46,0,0,1,56,1,56,0.112485000,0.0000
215.158.238.247,<->,192.231.44.28,1,56,0,0,1,56,0.111624000,0.0000
215.158.239.93,<->,194.251.117.13,1,56,0,0,1,56,0.111174000,0.0000
138.98.147.26,<->,106.18.220.73,1,50,0,0,1,50,0.110988000,0.0000
53.149.69.158,<->,48.53.172.18,0,0,1,56,1,56,0.110900000,0.0000
215.158.238.7,<->,8.188.227.111,1,56,0,0,1,56,0.110691000,0.0000
133.178.226.80,<->,96.155.60.247,1,56,0,0,1,56,0.110557000,0.0000
221.102.56.46,<->,192.64.90.213,0,0,1,1227,1,1227,0.109233000,0.0000
199.15.252.152,<->,136.25.188.225,0,0,1,50,1,50,0.107998000,0.0000
195.15.166.92,<->,136.25.188.177,0,0,1,56,1,56,0.107487000,0.0000
145.76.230.104,<->,111.20.168.24,0,0,1,56,1,56,0.107369000,0.0000
143.52.16.152,<->,136.25.188.209,0,0,1,56,1,56,0.107125000,0.0000
91.43.31.208,<->,89.216.126.0,0,0,1,50,1,50,0.106241000,0.0000
215.158.239.58,<->,196.94.143.43,1,56,0,0,1,56,0.105869000,0.0000
204.34.191.204,<->,50.224.76.234,0,0,1,50,1,50,0.104895000,0.0000
216.144.6.220,<->,215.158.140.195,0,0,1,50,1,50,0.104057000,0.0000
95.245.148.131,<->,8.252.221.207,0,0,1,56,1,56,0.103946000,0.0000
222.78.138.95,<->,50.224.76.234,0,0,1,50,1,50,0.103857000,0.0000
196.29.247.64,<->,50.224.97.203,0,0,1,50,1,50,0.103761000,0.0000
220.28.114.28,<->,133.178.227.6,0,0,1,56,1,56,0.103501000,0.0000
195.127.59.18,<->,136.25.188.54,0,0,1,56,1,56,0.103247000,0.0000
205.127.108.113,<->,33.233.141.32,0,0,1,56,1,56,0.103062000,0.0000
144.85.170.254,<->,91.69.185.232,1,56,0,0,1,56,0.102583000,0.0000
137.181.238.64,<->,8.43.215.120,0,0,1,50,1,50,0.102380000,0.0000
215.158.140.27,<->,106.188.228.48,1,56,0,0,1,56,0.101889000,0.0000
142.252.30.106,<->,136.25.188.174,0,0,1,50,1,50,0.101715000,0.0000
142.249.110.104,<->,136.25.188.238,0,0,1,50,1,50,0.101658000,0.0000
215.158.140.27,<->,118.20.110.35,1,56,0,0,1,56,0.101326000,0.0000
215.158.239.95,<->,194.234.179.27,1,50,0,0,1,50,0.101165000,0.0000
215.158.140.87,<->,114.75.170.84,1,56,0,0,1,56,0.100981000,0.0000
86.135.66.19,<->,8.252.222.49,0,0,1,56,1,56,0.100631000,0.0000
220.18.254.59,<->,99.167.136.236,0,0,1,203,1,203,0.100625000,0.0000
207.65.149.227,<->,50.224.76.230,0,0,1,50,1,50,0.100566000,0.0000
142.244.58.158,<->,136.25.188.209,0,0,1,50,1,50,0.100365000,0.0000
195.55.121.2,<->,136.25.188.252,0,0,1,50,1,50,0.100022000,0.0000
221.101.9.15,<->,207.23.75.43,1,50,0,0,1,50,0.100014000,0.0000
129.243.217.199,<->,80.27.157.224,0,0,1,56,1,56,0.099042000,0.0000
247.136.253.56,<->,22.250.157.130,1,56,0,0,1,56,0.098565000,0.0000
111.40.71.197,<->,92.27.27.181,0,0,1,50,1,50,0.098447000,0.0000
231.142.8.154,<->,136.25.188.238,0,0,1,56,1,56,0.097651000,0.0000
205.127.108.114,<->,33.233.141.227,0,0,1,56,1,56,0.097636000,0.0000
33.233.141.230,<->,17.62.194.122,1,56,0,0,1,56,0.097396000,0.0000
197.119.129.152,<->,8.183.25.25,0,0,1,56,1,56,0.097172000,0.0000
136.25.188.167,<->,100.224.202.157,1,56,0,0,1,56,0.096954000,0.0000
54.37.130.82,<->,48.53.35.207,0,0,1,56,1,56,0.096859000,0.0000
243.148.62.228,<->,0.195.210.8,0,0,1,56,1,56,0.096774000,0.0000
206.195.23.101,<->,192.229.216.117,0,0,1,56,1,56,0.096472000,0.0000
195.70.162.184,<->,8.52.171.120,0,0,1,50,1,50,0.096458000,0.0000
126.198.147.25,<->,111.147.69.132,0,0,1,50,1,50,0.096296000,0.0000
148.35.244.117,<->,139.193.141.139,0,0,1,56,1,56,0.096008000,0.0000
227.23.167.178,<->,89.183.108.5,0,0,1,50,1,50,0.094971000,0.0000
195.40.113.60,<->,136.25.188.45,0,0,1,56,1,56,0.094078000,0.0000
215.158.239.182,<->,111.150.82.231,1,56,0,0,1,56,0.093955000,0.0000
199.111.108.192,<->,8.182.229.19,0,0,1,50,1,50,0.092972000,0.0000
204.120.45.212,<->,80.38.50.48,0,0,1,50,1,50,0.092146000,0.0000
144.69.83.28,<->,115.139.125.174,1,50,0,0,1,50,0.091767000,0.0000
158.14.120.148,<->,101.224.206.46,0,0,1,56,1,56,0.091691000,0.0000
246.253.157.15,<->,124.119.31.199,1,50,0,0,1,50,0.091593000,0.0000
97.53.116.162,<->,8.182.136.20,0,0,1,56,1,56,0.091437000,0.0000
206.198.164.31,<->,139.163.5.140,0,0,1,50,1,50,0.091365000,0.0000
213.186.61.59,<->,144.85.170.246,0,0,1,56,1,56,0.091080000,0.0000
215.158.239.97,<->,142.221.13.37,1,56,0,0,1,56,0.090960000,0.0000
8.52.246.6,<->,8.42.79.134,1,56,0,0,1,56,0.090505000,0.0000
87.1.164.149,<->,8.52.154.162,0,0,1,56,1,56,0.090239000,0.0000
139.33.175.144,<->,97.126.106.44,0,0,1,1452,1,1452,0.089936000,0.0000
124.126.187.13,<->,111.20.168.22,0,0,1,50,1,50,0.089093000,0.0000
142.191.36.3,<->,136.25.188.238,0,0,1,50,1,50,0.088341000,0.0000
231.140.176.16,<->,136.25.188.44,0,0,1,50,1,50,0.087757000,0.0000
238.118.126.64,<->,17.197.194.55,1,50,0,0,1,50,0.087503000,0.0000
199.82.219.155,<->,136.25.188.46,0,0,1,50,1,50,0.087203000,0.0000
97.126.113.29,<->,53.190.213.15,1,488,0,0,1,488,0.087008000,0.0000
111.146.199.215,<->,97.110.90.234,1,50,0,0,1,50,0.086496000,0.0000
207.57.158.246,<->,136.25.188.53,0,0,1,50,1,50,0.086016000,0.0000
204.184.202.173,<->,136.25.188.222,0,0,1,56,1,56,0.085896000,0.0000
133.107.19.189,<->,6.74.97.64,0,0,1,56,1,56,0.085473000,0.0000
246.254.97.112,<->,56.114.235.120,1,567,0,0,1,567,0.085370000,0.0000
195.159.251.156,<->,50.224.76.234,0,0,1,50,1,50,0.085202000,0.0000
143.134.235.228,<->,136.25.188.237,0,0,1,50,1,50,0.085079000,0.0000
131.99.146.125,<->,50.224.76.234,0,0,1,50,1,50,0.084767000,0.0000
197.113.64.180,<->,136.25.188.254,0,0,1,56,1,56,0.083807000,0.0000
215.158.239.56,<->,199.20.31.247,1,56,0,0,1,56,0.083381000,0.0000
221.196.122.173,<->,136.25.188.226,0,0,1,56,1,56,0.081205000,0.0000
131.99.146.125,<->,50.224.76.230,0,0,1,50,1,50,0.080939000,0.0000
220.20.200.186,<->,193.21.28.207,1,50,0,0,1,50,0.080916000,0.0000
198.213.121.62,<->,50.224.76.230,0,0,1,50,1,50,0.080476000,0.0000
240.140.135.61,<->,145.252.115.55,0,0,1,50,1,50,0.080189000,0.0000
199.68.100.152,<->,136.25.188.176,0,0,1,56,1,56,0.080052000,0.0000
215.158.239.87,<->,207.228.147.30,1,76,0,0,1,76,0.079713000,0.0000
92.27.219.46,<->,27.76.47.236,1,50,0,0,1,50,0.079418000,0.0000
215.158.239.50,<->,196.91.242.68,1,56,0,0,1,56,0.079413000,0.0000
136.25.189.196,<->,129.222.39.112,1,56,0,0,1,56,0.079021000,0.0000
204.43.213.57,<->,50.224.76.234,0,0,1,56,1,56,0.078681000,0.0000
89.155.5.148,<->,8.182.227.71,0,0,1,56,1,56,0.078487000,0.0000
145.79.71.159,<->,8.220.181.167,0,0,1,50,1,50,0.078284000,0.0000
220.55.111.137,<->,129.254.96.5,1,50,0,0,1,50,0.077442000,0.0000
53.231.85.150,<->,33.233.141.20,0,0,1,50,1,50,0.077290000,0.0000
218.4.176.27,<->,8.207.172.239,1,56,0,0,1,56,0.076472000,0.0000
215.158.239.57,<->,207.213.233.200,1,56,0,0,1,56,0.076413000,0.0000
199.70.213.175,<->,136.25.188.225,0,0,1,56,1,56,0.075340000,0.0000
133.178.226.202,<->,56.28.207.218,1,56,0,0,1,56,0.075016000,0.0000
123.89.134.64,<->,92.162.253.134,0,0,1,50,1,50,0.074932000,0.0000
215.158.239.50,<->,207.60.212.34,1,56,0,0,1,56,0.074784000,0.0000
91.251.118.155,<->,8.45.175.127,1,50,0,0,1,50,0.074473000,0.0000
220.20.200.118,<->,144.83.60.153,1,50,0,0,1,50,0.074349000,0.0000
116.172.212.6,<->,50.224.76.235,0,0,1,50,1,50,0.074212000,0.0000
133.244.30.133,<->,119.111.182.129,1,50,0,0,1,50,0.073762000,0.0000
247.136.175.22,<->,56.114.235.120,1,876,0,0,1,876,0.073718000,0.0000
199.81.87.108,<->,136.25.188.225,0,0,1,89,1,89,0.071978000,0.0000
138.121.99.24,<->,8.220.176.253,0,0,1,50,1,50,0.071719000,0.0000
159.23.226.39,<->,73.80.222.209,1,50,0,0,1,50,0.071544000,0.0000
144.89.109.66,<->,101.224.89.159,0,0,1,50,1,50,0.071475000,0.0000
142.227.208.147,<->,136.25.188.209,0,0,1,50,1,50,0.071270000,0.0000
132.18.67.31,<->,102.50.89.121,0,0,1,50,1,50,0.070729000,0.0000
210.220.219.152,<->,53.231.146.1,1,50,0,0,1,50,0.070654000,0.0000
194.238.244.139,<->,136.25.188.253,0,0,1,50,1,50,0.070321000,0.0000
202.33.81.124,<->,136.25.188.240,0,0,1,56,1,56,0.070141000,0.0000
216.39.137.168,<->,137.137.71.215,0,0,1,56,1,56,0.070078000,0.0000
144.87.238.89,<->,8.182.244.19,0,0,1,50,1,50,0.069734000,0.0000
133.178.226.234,<->,115.162.222.166,1,56,0,0,1,56,0.069186000,0.0000
199.72.36.168,<->,136.25.188.198,0,0,1,56,1,56,0.069108000,0.0000
106.213.32.103,<->,8.252.222.141,0,0,1,50,1,50,0.068560000,0.0000
145.252.120.50,<->,117.37.105.131,1,56,0,0,1,56,0.068399000,0.0000
143.44.47.150,<->,136.25.188.209,0,0,1,56,1,56,0.067851000,0.0000
138.121.99.24,<->,8.220.239.30,0,0,1,50,1,50,0.066264000,0.0000
143.43.195.76,<->,136.25.188.236,0,0,1,56,1,56,0.065771000,0.0000
133.178.226.200,<->,29.214.216.100,1,56,0,0,1,56,0.065423000,0.0000
133.178.226.202,<->,72.151.67.120,1,56,0,0,1,56,0.065183000,0.0000
197.161.214.193,<->,136.25.188.225,0,0,1,87,1,87,0.064125000,0.0000
99.92.11.156,<->,8.52.133.71,0,0,1,50,1,50,0.063187000,0.0000
204.200.61.167,<->,136.25.188.177,0,0,1,132,1,132,0.062846000,0.0000
136.25.188.55,<->,8.227.55.229,1,56,0,0,1,56,0.061797000,0.0000
117.35.249.200,<->,50.224.76.230,0,0,1,50,1,50,0.061435000,0.0000
197.45.40.171,<->,8.52.186.161,0,0,1,50,1,50,0.060707000,0.0000
89.183.104.186,<->,33.57.74.146,1,50,0,0,1,50,0.059616000,0.0000
159.137.162.213,<->,117.47.221.215,1,50,0,0,1,50,0.059579000,0.0000
195.43.118.8,<->,136.25.188.178,0,0,1,56,1,56,0.059540000,0.0000
215.158.239.76,<->,202.33.2.145,1,56,0,0,1,56,0.059534000,0.0000
194.237.254.104,<->,136.25.188.236,0,0,1,56,1,56,0.059199000,0.0000
149.13.40.114,<->,50.224.76.235,0,0,1,56,1,56,0.057847000,0.0000
133.178.226.161,<->,54.52.195.79,1,56,0,0,1,56,0.057689000,0.0000
215.158.239.58,<->,199.20.29.229,1,56,0,0,1,56,0.056763000,0.0000
94.195.50.10,<->,8.252.221.205,0,0,1,50,1,50,0.055379000,0.0000
113.192.25.253,<->,92.27.219.32,0,0,1,50,1,50,0.055166000,0.0000
202.33.237.102,<->,136.25.188.240,0,0,1,56,1,56,0.055050000,0.0000
195.70.37.130,<->,136.25.188.52,0,0,1,56,1,56,0.054427000,0.0000
98.232.166.102,<->,57.211.62.3,1,56,0,0,1,56,0.053802000,0.0000
231.142.5.48,<->,136.25.188.254,0,0,1,50,1,50,0.053042000,0.0000
195.55.61.107,<->,136.25.188.227,0,0,1,56,1,56,0.052771000,0.0000
43.52.108.187,<->,8.252.221.204,0,0,1,50,1,50,0.052538000,0.0000
220.20.200.248,<->,119.159.22.233,1,50,0,0,1,50,0.052531000,0.0000
144.86.148.17,<->,84.214.213.193,1,50,0,0,1,50,0.052469000,0.0000
239.190.195.116,<->,101.70.99.237,0,0,1,50,1,50,0.052321000,0.0000
117.37.43.86,<->,8.31.37.169,0,0,1,56,1,56,0.052246000,0.0000
197.113.99.162,<->,136.25.188.252,0,0,1,56,1,56,0.051991000,0.0000
204.61.95.32,<->,8.52.185.143,0,0,1,50,1,50,0.051843000,0.0000
142.245.147.40,<->,136.25.188.253,0,0,1,56,1,56,0.051384000,0.0000
215.158.140.27,<->,133.147.123.25,1,56,0,0,1,56,0.051074000,0.0000
112.11.67.228,<->,92.27.219.155,0,0,1,50,1,50,0.051064000,0.0000
218.147.52.203,<->,8.182.141.189,0,0,1,56,1,56,0.051008000,0.0000
215.158.239.57,<->,204.3.233.160,1,56,0,0,1,56,0.050527000,0.0000
159.137.243.168,<->,143.52.91.253,1,56,0,0,1,56,0.050297000,0.0000
225.53.87.107,<->,159.137.189.208,0,0,1,50,1,50,0.048671000,0.0000
215.158.239.110,<->,109.126.137.238,1,50,0,0,1,50,0.048562000,0.0000
159.70.27.69,<->,144.86.146.31,0,0,1,50,1,50,0.048526000,0.0000
50.224.76.235,<->,50.183.208.169,1,50,0,0,1,50,0.048084000,0.0000
53.148.184.48,<->,48.54.187.73,0,0,1,56,1,56,0.047900000,0.0000
246.253.198.51,<->,126.109.98.254,1,50,0,0,1,50,0.047192000,0.0000
195.15.2.61,<->,136.25.188.242,0,0,1,56,1,56,0.046889000,0.0000
195.68.103.22,<->,136.25.188.175,0,0,1,56,1,56,0.046564000,0.0000
145.116.209.4,<->,136.25.188.203,0,0,1,56,1,56,0.046208000,0.0000
194.45.207.41,<->,138.98.197.173,0,0,1,50,1,50,0.045981000,0.0000
127.52.61.99,<->,89.183.111.52,0,0,1,56,1,56,0.045882000,0.0000
22.36.22.18,<->,8.182.226.78,0,0,1,50,1,50,0.045714000,0.0000
204.95.192.118,<->,50.224.96.57,0,0,1,50,1,50,0.045661000,0.0000
89.183.111.52,<->,33.150.36.202,1,56,0,0,1,56,0.045336000,0.0000
192.229.210.156,<->,50.10.84.183,1,56,0,0,1,56,0.044959000,0.0000
139.33.174.95,<->,97.126.14.75,0,0,1,50,1,50,0.044375000,0.0000
215.158.239.58,<->,195.4.214.13,1,50,0,0,1,50,0.044356000,0.0000
199.68.100.152,<->,136.25.188.174,0,0,1,56,1,56,0.044148000,0.0000
215.158.239.58,<->,199.20.30.109,1,56,0,0,1,56,0.043641000,0.0000
199.72.30.100,<->,136.25.188.220,0,0,1,56,1,56,0.043143000,0.0000
199.33.17.180,<->,136.25.188.252,0,0,1,56,1,56,0.042622000,0.0000
207.57.142.46,<->,136.25.188.55,0,0,1,56,1,56,0.042606000,0.0000
231.140.124.238,<->,136.25.188.242,0,0,1,50,1,50,0.041912000,0.0000
195.55.229.202,<->,136.25.188.177,0,0,1,56,1,56,0.041644000,0.0000
199.20.30.79,<->,196.148.128.191,0,0,1,50,1,50,0.041425000,0.0000
92.27.27.148,<->,33.57.74.151,1,50,0,0,1,50,0.041306000,0.0000
76.145.196.38,<->,8.52.222.199,0,0,1,50,1,50,0.041106000,0.0000
93.181.134.50,<->,92.27.219.253,0,0,1,50,1,50,0.040958000,0.0000
194.232.26.38,<->,136.25.188.163,0,0,1,50,1,50,0.040816000,0.0000
92.27.219.164,<->,33.57.78.94,1,50,0,0,1,50,0.040520000,0.0000
213.186.61.11,<->,50.224.110.87,0,0,1,56,1,56,0.040518000,0.0000
195.5.52.146,<->,136.25.188.243,0,0,1,50,1,50,0.040366000,0.0000
215.158.239.70,<->,199.20.29.81,1,56,0,0,1,56,0.040166000,0.0000
246.254.97.105,<->,145.250.89.228,1,56,0,0,1,56,0.039871000,0.0000
98.16.139.251,<->,8.52.171.31,0,0,1,50,1,50,0.039822000,0.0000
220.20.200.6,<->,144.83.60.136,1,50,0,0,1,50,0.039574000,0.0000
139.148.100.213,<->,8.182.239.241,0,0,1,56,1,56,0.039070000,0.0000
215.158.239.51,<->,199.20.7.145,1,56,0,0,1,56,0.039044000,0.0000
93.181.154.62,<->,92.27.27.154,0,0,1,50,1,50,0.039043000,0.0000
93.181.153.42,<->,92.27.219.184,0,0,1,50,1,50,0.039020000,0.0000
220.55.113.199,<->,122.238.96.221,1,50,0,0,1,50,0.038271000,0.0000
215.158.239.79,<->,195.41.216.49,1,56,0,0,1,56,0.038197000,0.0000
215.158.140.178,<->,140.173.227.85,1,56,0,0,1,56,0.037905000,0.0000
224.148.1.28,<->,132.18.67.29,1,56,0,0,1,56,0.037684000,0.0000
192.64.215.144,<->,33.57.78.94,1,50,0,0,1,50,0.037377000,0.0000
210.220.219.153,<->,139.33.175.144,1,267,0,0,1,267,0.037168000,0.0000
249.176.101.34,<->,246.254.97.230,0,0,1,56,1,56,0.036904000,0.0000
199.50.226.137,<->,136.25.188.226,0,0,1,50,1,50,0.036695000,0.0000
195.55.134.63,<->,136.25.188.174,0,0,1,50,1,50,0.036411000,0.0000
137.160.131.4,<->,8.182.244.19,0,0,1,50,1,50,0.036060000,0.0000
233.85.146.164,<->,144.85.170.254,0,0,1,56,1,56,0.035939000,0.0000
99.72.140.170,<->,33.78.194.97,1,50,0,0,1,50,0.035505000,0.0000
142.182.62.39,<->,136.25.188.175,0,0,1,50,1,50,0.035357000,0.0000
93.224.188.210,<->,89.183.104.244,0,0,1,50,1,50,0.035317000,0.0000
143.12.162.87,<->,136.25.188.173,0,0,1,56,1,56,0.035240000,0.0000
92.27.27.173,<->,33.57.74.185,1,56,0,0,1,56,0.033502000,0.0000
122.193.78.143,<->,50.224.76.234,0,0,1,50,1,50,0.033303000,0.0000
246.253.157.15,<->,113.59.49.51,1,50,0,0,1,50,0.033242000,0.0000
215.158.239.59,<->,199.20.28.37,1,56,0,0,1,56,0.033230000,0.0000
133.178.226.28,<->,96.155.60.213,1,56,0,0,1,56,0.032835000,0.0000
200.174.217.174,<->,54.37.202.190,1,50,0,0,1,50,0.032249000,0.0000
100.215.74.116,<->,33.233.141.107,0,0,1,50,1,50,0.031767000,0.0000
247.136.252.223,<->,210.209.251.211,1,50,0,0,1,50,0.031495000,0.0000
215.158.238.89,<->,145.116.209.71,1,56,0,0,1,56,0.031364000,0.0000
142.241.17.213,<->,136.25.188.239,0,0,1,56,1,56,0.030864000,0.0000
215.158.238.51,<->,129.222.36.56,1,56,0,0,1,56,0.030857000,0.0000
159.137.162.213,<->,125.199.182.204,1,50,0,0,1,50,0.030707000,0.0000
195.65.65.233,<->,8.182.243.89,0,0,1,56,1,56,0.029753000,0.0000
127.107.211.40,<->,50.224.76.234,0,0,1,56,1,56,0.029271000,0.0000
159.135.57.93,<->,8.52.187.74,0,0,1,50,1,50,0.029153000,0.0000
136.25.189.196,<->,129.222.39.192,1,56,0,0,1,56,0.028938000,0.0000
35.33.29.101,<->,33.233.141.114,0,0,1,56,1,56,0.028927000,0.0000
215.158.42.8,<->,133.178.226.176,0,0,1,56,1,56,0.027991000,0.0000
142.248.156.89,<->,136.25.188.177,0,0,1,56,1,56,0.027549000,0.0000
111.147.237.184,<->,104.143.73.202,1,50,0,0,1,50,0.027248000,0.0000
246.253.198.51,<->,57.234.142.227,1,50,0,0,1,50,0.026833000,0.0000
111.20.171.168,<->,33.233.141.25,0,0,1,50,1,50,0.026665000,0.0000
199.5.237.236,<->,50.224.96.57,0,0,1,50,1,50,0.026459000,0.0000
218.188.29.5,<->,80.27.158.180,0,0,1,50,1,50,0.026343000,0.0000
210.158.44.69,<->,193.87.5.172,1,50,0,0,1,50,0.026263000,0.0000
195.55.223.117,<->,136.25.188.176,0,0,1,50,1,50,0.026257000,0.0000
204.200.33.164,<->,136.25.188.253,0,0,1,50,1,50,0.026012000,0.0000
212.241.174.245,<->,80.27.157.20,0,0,1,50,1,50,0.024884000,0.0000
255.46.252.69,<->,109.222.246.96,0,0,1,56,1,56,0.024570000,0.0000
128.204.129.154,<->,50.224.76.230,0,0,1,50,1,50,0.024467000,0.0000
137.69.181.98,<->,8.182.227.214,0,0,1,50,1,50,0.024426000,0.0000
199.14.236.189,<->,136.25.188.240,0,0,1,50,1,50,0.023942000,0.0000
53.149.56.125,<->,48.54.89.201,0,0,1,50,1,50,0.023912000,0.0000
216.144.178.49,<->,215.158.140.184,0,0,1,50,1,50,0.023360000,0.0000
145.37.210.250,<->,50.224.76.235,0,0,1,50,1,50,0.022408000,0.0000
98.128.69.239,<->,8.55.221.134,1,50,0,0,1,50,0.022017000,0.0000
215.158.66.212,<->,133.178.226.197,0,0,1,56,1,56,0.021757000,0.0000
17.199.106.163,<->,8.220.189.81,0,0,1,50,1,50,0.021743000,0.0000
92.162.253.11,<->,89.152.226.167,1,50,0,0,1,50,0.021541000,0.0000
102.34.34.14,<->,98.67.158.12,0,0,1,50,1,50,0.021256000,0.0000
89.183.110.72,<->,0.70.165.207,1,50,0,0,1,50,0.021253000,0.0000
246.253.198.51,<->,112.87.183.154,1,50,0,0,1,50,0.021160000,0.0000
136.25.188.202,<->,80.57.141.218,1,56,0,0,1,56,0.020947000,0.0000
199.122.177.159,<->,136.25.188.225,0,0,1,50,1,50,0.020915000,0.0000
215.158.239.95,<->,199.20.28.0,1,56,0,0,1,56,0.019336000,0.0000
100.182.151.25,<->,8.37.245.94,1,141,0,0,1,141,0.019132000,0.0000
246.253.212.143,<->,109.51.250.51,1,50,0,0,1,50,0.019086000,0.0000
195.6.118.47,<->,136.25.188.174,0,0,1,56,1,56,0.018795000,0.0000
138.98.180.141,<->,134.245.87.117,1,50,0,0,1,50,0.018120000,0.0000
99.187.125.122,<->,8.20.87.10,0,0,1,56,1,56,0.018113000,0.0000
215.158.239.68,<->,199.20.28.15,1,56,0,0,1,56,0.018026000,0.0000
159.80.9.83,<->,8.183.25.124,0,0,1,50,1,50,0.017858000,0.0000
220.28.65.9,<->,136.25.189.26,0,0,1,56,1,56,0.017349000,0.0000
117.158.196.212,<->,100.92.87.46,0,0,1,50,1,50,0.017264000,0.0000
109.91.119.23,<->,14.73.201.149,0,0,1,50,1,50,0.016918000,0.0000
197.113.64.202,<->,136.25.188.242,0,0,1,56,1,56,0.015617000,0.0000
199.111.71.92,<->,50.224.76.235,0,0,1,50,1,50,0.014961000,0.0000
215.158.239.50,<->,199.20.30.157,1,132,0,0,1,132,0.014891000,0.0000
102.224.165.225,<->,8.55.194.110,1,56,0,0,1,56,0.014837000,0.0000
142.207.122.132,<->,136.25.188.53,0,0,1,50,1,50,0.013523000,0.0000
109.127.156.13,<->,8.220.176.253,0,0,1,50,1,50,0.012812000,0.0000
111.20.168.209,<->,17.62.194.122,1,56,0,0,1,56,0.012664000,0.0000
192.205.38.163,<->,133.32.39.0,0,0,1,56,1,56,0.012511000,0.0000
133.32.39.0,<->,14.71.95.237,1,56,0,0,1,56,0.012413000,0.0000
215.158.238.78,<->,139.163.161.34,1,56,0,0,1,56,0.011683000,0.0000
100.190.251.237,<->,8.220.176.253,0,0,1,50,1,50,0.010996000,0.0000
112.220.206.122,<->,82.237.235.220,0,0,1,50,1,50,0.010137000,0.0000
100.190.29.184,<->,8.220.176.253,0,0,1,50,1,50,0.009645000,0.0000
199.70.39.110,<->,136.25.188.237,0,0,1,50,1,50,0.008987000,0.0000
215.158.239.78,<->,199.20.28.167,1,56,0,0,1,56,0.008731000,0.0000
97.126.27.248,<->,53.191.207.209,1,50,0,0,1,50,0.008143000,0.0000
239.36.85.129,<->,136.25.188.55,0,0,1,50,1,50,0.007744000,0.0000
195.124.7.219,<->,136.25.188.177,0,0,1,56,1,56,0.007589000,0.0000
231.140.159.21,<->,136.25.188.175,0,0,1,56,1,56,0.007172000,0.0000
220.20.200.125,<->,35.62.67.89,1,50,0,0,1,50,0.007093000,0.0000
109.198.138.168,<->,0.195.210.46,0,0,1,56,1,56,0.007091000,0.0000
204.2.4.234,<->,136.25.188.178,0,0,1,56,1,56,0.006995000,0.0000
221.102.122.48,<->,139.254.211.64,1,56,0,0,1,56,0.006484000,0.0000
50.224.76.235,<->,29.217.228.88,1,56,0,0,1,56,0.006276000,0.0000
204.21.78.129,<->,136.25.188.253,0,0,1,56,1,56,0.006257000,0.0000
143.52.220.13,<->,136.25.188.53,0,0,1,50,1,50,0.005591000,0.0000
53.161.58.87,<->,48.53.19.205,0,0,1,56,1,56,0.005125000,0.0000
97.126.27.248,<->,53.83.245.42,1,50,0,0,1,50,0.004996000,0.0000
111.181.98.129,<->,8.55.195.24,1,50,0,0,1,50,0.004957000,0.0000
210.209.251.211,<->,192.64.106.47,0,0,1,50,1,50,0.004714000,0.0000
246.45.211.17,<->,215.158.209.250,1,56,0,0,1,56,0.004538000,0.0000
249.101.97.200,<->,50.145.202.200,1,56,0,0,1,56,0.004507000,0.0000
101.126.178.62,<->,8.55.195.24,1,50,0,0,1,50,0.004179000,0.0000
159.155.173.24,<->,50.224.80.64,0,0,1,56,1,56,0.003924000,0.0000
199.121.82.30,<->,136.25.188.255,0,0,1,56,1,56,0.003550000,0.0000
143.128.150.39,<->,136.25.188.176,0,0,1,56,1,56,0.003533000,0.0000
218.147.52.202,<->,8.176.60.38,0,0,1,56,1,56,0.002569000,0.0000
145.234.87.101,<->,136.25.189.47,0,0,1,56,1,56,0.002505000,0.0000
122.184.13.50,<->,8.52.223.102,0,0,1,56,1,56,0.002385000,0.0000
133.32.39.0,<->,124.37.24.172,1,56,0,0,1,56,0.002273000,0.0000
212.118.48.193,<->,8.52.169.61,0,0,1,50,1,50,0.002019000,0.0000
142.249.240.234,<->,136.25.188.46,0,0,1,50,1,50,0.001878000,0.0000
252.98.138.179,<->,100.230.5.11,1,50,0,0,1,50,0.001746000,0.0000
133.165.252.43,<->,109.127.101.16,1,509,0,0,1,509,0.001689000,0.0000
139.128.9.2,<->,8.182.224.248,0,0,1,50,1,50,0.001542000,0.0000
247.136.244.156,<->,53.229.7.78,1,56,0,0,1,56,0.001386000,0.0000
80.38.35.47,<->,33.57.119.145,1,50,0,0,1,50,0.000939000,0.0000
215.158.239.92,<->,199.20.28.129,1,56,0,0,1,56,0.000665000,0.0000
215.158.239.69,<->,199.20.22.89,1,93,0,0,1,93,0.000536000,0.0000
