src,sep,dst,inframes,inbytes,outframes,outbytes,totalframes,totalbytes,relstart,duration
123.153.228.196,<->,92.162.253.159,0,0,1181,1448476,1181,1448476,0.009082000,0.8144
133.178.226.196,<->,100.224.243.115,534,444265,0,0,534,444265,0.003770000,1.9859
133.178.226.214,<->,100.224.243.106,412,419001,0,0,412,419001,1.033266000,0.9531
215.158.33.1,<->,133.178.226.43,0,0,233,216077,233,216077,0.003738000,1.1988
215.158.239.20,<->,96.135.154.114,227,164106,0,0,227,164106,0.557902000,1.1939
136.25.189.55,<->,80.56.246.217,219,198591,0,0,219,198591,0.858701000,0.1864
192.228.188.15,<->,133.178.227.105,0,0,207,184390,207,184390,0.578327000,0.6445
215.158.33.13,<->,133.178.226.55,0,0,194,103587,194,103587,0.297602000,1.6089
215.158.49.51,<->,136.116.28.231,0,0,184,268696,184,268696,0.009736000,0.2048
215.158.58.243,<->,8.252.222.232,0,0,159,228508,159,228508,0.293633000,0.2976
133.178.226.244,<->,97.28.132.56,140,54803,0,0,140,54803,0.595135000,0.0481
136.25.189.94,<->,8.188.181.66,140,130068,0,0,140,130068,0.092443000,1.2372
220.28.115.46,<->,215.158.238.144,0,0,137,139135,137,139135,0.114772000,1.8226
123.34.158.243,<->,35.56.96.143,0,0,129,24748,129,24748,0.028847000,1.9290
215.158.23.56,<->,8.255.92.213,125,167491,0,0,125,167491,0.010687000,1.9795
220.28.108.254,<->,215.158.238.129,0,0,123,125736,123,125736,0.067222000,1.8413
133.178.226.173,<->,84.18.223.130,123,179211,0,0,123,179211,0.019485000,1.9333
133.178.227.28,<->,8.255.87.80,122,114629,0,0,122,114629,0.805956000,0.2763
133.178.226.255,<->,17.128.69.208,121,49318,0,0,121,49318,1.097032000,0.8203
215.158.197.12,<->,8.252.222.153,0,0,102,65805,102,65805,0.156842000,0.2233
133.8.10.153,<->,101.224.89.150,0,0,100,101358,100,101358,1.389019000,0.2168
215.158.49.76,<->,136.116.28.231,0,0,99,135316,99,135316,0.383139000,1.5861
133.178.226.23,<->,100.120.38.6,93,89278,0,0,93,89278,0.065617000,1.8643
215.158.61.192,<->,99.74.26.134,0,0,90,102068,90,102068,0.990784000,0.9951
133.178.226.22,<->,100.120.38.6,90,88712,0,0,90,88712,0.038646000,1.9189
215.158.238.146,<->,100.120.38.6,89,89496,0,0,89,89496,0.084543000,1.8991
215.158.238.144,<->,100.216.78.145,88,85068,0,0,88,85068,0.029746000,1.8931
215.158.238.246,<->,215.158.132.243,86,56163,0,0,86,56163,1.929533000,0.0626
215.158.33.13,<->,133.178.226.33,0,0,86,77845,86,77845,0.053557000,1.7911
133.178.226.41,<->,100.120.38.6,86,88677,0,0,86,88677,0.025230000,1.9145
133.8.10.153,<->,33.233.141.0,0,0,86,92251,86,92251,0.002194000,0.1387
220.28.104.193,<->,215.158.238.146,0,0,83,82954,83,82954,0.021540000,1.9015
138.89.205.200,<->,56.121.51.247,0,0,83,25075,83,25075,0.010432000,1.9824
215.158.238.69,<->,100.120.38.6,82,77990,0,0,82,77990,0.052482000,1.8707
218.4.183.196,<->,111.151.238.110,82,9800,0,0,82,9800,0.038965000,1.9168
133.178.227.10,<->,131.141.219.100,81,16523,0,0,81,16523,0.711907000,1.1499
215.158.238.69,<->,98.219.126.140,76,72139,0,0,76,72139,0.031345000,1.9365
133.178.227.44,<->,100.224.133.155,75,110483,0,0,75,110483,0.469718000,0.0262
99.167.132.172,<->,99.167.61.227,75,4950,0,0,75,4950,0.389922000,1.5895
159.127.185.253,<->,92.27.219.16,0,0,73,8698,73,8698,0.082940000,1.4473
133.178.226.55,<->,100.120.38.6,71,65250,0,0,71,65250,0.048219000,1.8978
254.210.93.43,<->,50.224.49.195,0,0,71,26948,71,26948,0.027318000,1.9025
215.158.238.152,<->,100.120.38.6,71,68870,0,0,71,68870,0.012190000,1.9331
136.25.188.41,<->,112.105.203.101,70,88434,0,0,70,88434,1.533710000,0.4268
215.158.133.55,<->,98.128.150.163,0,0,70,14504,70,14504,0.169776000,1.7282
220.28.114.28,<->,215.158.238.88,0,0,69,68750,69,68750,0.217262000,1.7006
220.28.85.14,<->,215.158.238.153,0,0,69,70865,69,70865,0.091891000,1.8519
192.170.254.72,<->,136.25.189.10,0,0,69,62803,69,62803,0.082592000,0.1606
215.158.239.2,<->,96.135.154.146,65,69257,0,0,65,69257,0.076229000,0.9992
215.158.238.130,<->,145.116.206.214,63,6192,0,0,63,6192,0.003266000,1.9717
133.244.31.120,<->,80.27.154.173,62,85759,0,0,62,85759,0.918608000,0.3340
215.158.238.68,<->,98.219.126.175,61,61613,0,0,61,61613,0.158169000,1.7744
123.129.29.205,<->,33.233.141.106,0,0,58,17776,58,17776,0.124125000,1.8120
123.129.29.204,<->,33.233.141.46,0,0,58,28652,58,28652,0.028652000,1.8128
220.28.73.211,<->,215.158.238.79,0,0,58,60132,58,60132,0.022175000,1.9241
111.147.195.158,<->,97.110.90.234,57,71690,0,0,57,71690,0.475834000,1.4736
139.36.119.84,<->,136.25.189.209,0,0,55,30588,55,30588,0.951108000,0.3069
123.129.29.200,<->,33.233.141.46,0,0,54,20595,54,20595,0.051090000,1.8997
252.98.149.218,<->,144.85.169.244,53,79712,0,0,53,79712,0.607329000,1.3714
220.28.108.254,<->,215.158.238.70,0,0,53,52175,53,52175,0.063314000,1.8591
120.175.132.220,<->,80.41.8.194,0,0,53,20542,53,20542,0.004926000,1.9114
210.212.142.117,<->,80.27.158.215,0,0,52,5508,52,5508,0.256305000,1.0103
215.158.239.3,<->,215.158.127.155,52,49334,0,0,52,49334,0.088356000,1.7654
123.129.29.200,<->,33.233.141.118,0,0,52,23258,52,23258,0.068380000,1.9211
218.4.182.130,<->,132.216.20.244,52,64641,0,0,52,64641,0.052196000,0.6995
220.28.85.14,<->,215.158.238.129,0,0,52,47866,52,47866,0.014609000,1.9196
215.158.238.153,<->,100.120.38.6,51,47614,0,0,51,47614,0.060163000,1.7392
220.28.85.14,<->,215.158.238.101,0,0,51,51874,51,51874,0.050292000,1.9202
129.236.114.39,<->,101.224.89.156,0,0,50,5370,50,5370,0.180553000,1.1188
215.158.238.117,<->,100.120.38.6,50,45826,0,0,50,45826,0.031098000,1.6779
101.70.117.204,<->,53.180.145.146,50,12410,0,0,50,12410,0.011157000,1.9311
145.19.13.114,<->,14.27.112.65,50,75200,0,0,50,75200,0.010941000,1.9774
220.28.73.211,<->,215.158.238.147,0,0,49,47172,49,47172,0.031080000,1.9602
215.158.238.145,<->,100.216.78.145,49,46382,0,0,49,46382,0.026902000,1.8800
215.158.238.110,<->,100.216.78.145,49,50513,0,0,49,50513,0.000635000,1.8474
215.158.140.199,<->,29.211.120.86,48,72192,0,0,48,72192,1.463267000,0.5118
129.236.73.9,<->,33.233.141.32,0,0,48,32281,48,32281,0.368051000,1.6192
220.28.104.193,<->,215.158.238.147,0,0,48,45506,48,45506,0.158028000,1.7679
215.158.238.139,<->,98.219.126.175,48,50198,0,0,48,50198,0.089174000,1.7096
215.158.238.111,<->,100.120.38.6,48,47608,0,0,48,47608,0.032686000,1.3699
133.178.227.94,<->,98.191.25.53,47,15520,0,0,47,15520,0.190927000,1.7707
215.158.43.154,<->,133.178.227.119,0,0,47,15667,47,15667,0.070817000,1.7821
215.158.238.68,<->,100.120.38.6,47,44420,0,0,47,44420,0.048587000,1.9491
215.158.238.129,<->,100.120.38.6,46,46903,0,0,46,46903,0.372050000,1.5732
215.158.238.145,<->,98.219.126.140,46,44980,0,0,46,44980,0.358146000,1.5878
220.28.104.193,<->,215.158.238.77,0,0,46,45764,46,45764,0.071496000,1.9101
218.4.164.231,<->,97.110.90.219,45,47968,0,0,45,47968,0.886091000,0.5696
144.46.53.11,<->,133.178.227.119,0,0,45,11456,45,11456,0.128611000,1.8009
215.158.238.100,<->,98.219.126.175,45,45598,0,0,45,45598,0.034135000,1.8956
133.178.227.95,<->,98.191.25.53,44,14887,0,0,44,14887,0.102310000,1.5353
220.28.108.254,<->,215.158.238.85,0,0,44,47873,44,47873,0.085145000,1.9043
249.101.236.137,<->,99.216.103.248,44,19930,0,0,44,19930,0.029148000,1.9400
215.158.238.153,<->,98.219.126.140,44,44840,0,0,44,44840,0.017930000,1.9478
215.158.197.18,<->,8.252.222.234,0,0,43,28584,43,28584,1.854944000,0.1374
215.158.34.85,<->,8.176.8.81,0,0,43,16528,43,16528,1.481245000,0.4808
247.136.241.135,<->,215.158.133.30,43,11873,0,0,43,11873,0.169456000,1.7517
144.46.53.11,<->,133.178.227.97,0,0,43,10764,43,10764,0.106151000,1.7695
215.158.238.147,<->,100.120.38.6,43,41372,0,0,43,41372,0.099883000,1.6038
231.193.31.131,<->,102.231.187.128,0,0,43,10963,43,10963,0.024320000,1.6416
159.194.2.95,<->,138.98.233.218,0,0,43,50676,43,50676,0.013030000,1.9847
215.158.238.79,<->,100.120.38.6,42,38900,0,0,42,38900,0.268936000,1.6489
246.254.97.112,<->,132.105.33.215,41,59361,0,0,41,59361,0.551519000,0.0653
215.158.239.25,<->,96.135.154.105,41,33593,0,0,41,33593,0.301490000,1.4230
192.64.218.107,<->,8.255.92.38,41,13248,0,0,41,13248,0.128935000,1.7802
215.158.238.153,<->,98.219.126.175,41,41918,0,0,41,41918,0.097086000,1.8444
93.181.154.90,<->,92.27.27.171,0,0,41,5844,41,5844,0.025143000,1.7151
220.28.115.46,<->,215.158.238.71,0,0,41,40846,41,40846,0.015134000,1.7678
111.20.172.118,<->,33.233.141.41,0,0,40,32222,40,32222,0.878461000,0.0049
220.28.64.202,<->,50.224.80.75,0,0,40,16860,40,16860,0.381102000,1.5464
133.178.226.174,<->,100.120.38.6,40,29296,0,0,40,29296,0.345916000,1.6229
220.28.73.211,<->,215.158.140.162,0,0,40,48069,40,48069,0.297589000,1.6590
215.158.239.38,<->,215.158.127.140,40,32109,0,0,40,32109,0.092035000,1.7645
215.158.238.128,<->,98.219.126.140,40,42692,0,0,40,42692,0.041527000,1.7910
215.158.238.138,<->,100.120.38.6,39,37504,0,0,39,37504,0.557965000,1.3249
140.81.105.230,<->,80.38.12.219,0,0,39,8678,39,8678,0.525168000,1.3904
210.224.219.234,<->,100.94.222.87,0,0,39,8872,39,8872,0.035931000,1.9357
133.178.227.28,<->,133.56.180.94,39,17803,0,0,39,17803,0.005433000,1.8472
215.158.238.110,<->,56.20.122.75,39,55227,0,0,39,55227,0.000620000,1.9111
102.83.246.39,<->,8.240.117.69,38,56636,0,0,38,56636,0.258861000,1.4030
215.158.238.70,<->,98.219.126.140,38,38269,0,0,38,38269,0.074501000,1.7121
220.28.108.254,<->,215.158.238.137,0,0,38,38816,38,38816,0.041351000,1.9545
139.163.17.139,<->,102.240.121.162,38,16646,0,0,38,16646,0.002472000,1.9824
220.28.109.52,<->,136.25.188.168,0,0,37,28324,37,28324,0.227263000,1.7102
133.8.10.152,<->,33.233.141.28,0,0,37,50625,37,50625,0.140126000,1.6551
158.14.109.76,<->,145.16.41.83,0,0,37,51501,37,51501,0.077388000,1.9137
220.28.85.14,<->,215.158.238.152,0,0,37,38578,37,38578,0.069244000,1.6022
220.28.109.52,<->,136.25.188.165,0,0,37,31765,37,31765,0.022022000,1.5385
215.158.238.76,<->,100.120.38.6,37,35189,0,0,37,35189,0.000070000,1.9813
215.158.238.110,<->,98.219.126.140,36,38420,0,0,36,38420,0.289730000,1.3179
199.86.122.136,<->,108.134.106.92,0,0,36,15311,36,15311,0.110071000,1.8673
102.249.242.199,<->,8.228.218.233,0,0,36,19867,36,19867,0.046141000,1.4708
138.98.174.211,<->,99.167.15.52,36,17808,0,0,36,17808,0.025383000,1.9467
220.28.109.52,<->,136.25.188.212,0,0,35,34274,35,34274,0.114384000,1.8396
220.28.115.46,<->,215.158.238.124,0,0,34,34246,34,34246,0.060430000,1.7386
133.178.226.43,<->,100.120.38.6,34,31683,0,0,34,31683,0.054589000,1.9173
220.28.73.211,<->,215.158.238.109,0,0,34,35289,34,35289,0.025422000,1.8930
220.28.109.52,<->,136.25.188.214,0,0,34,34006,34,34006,0.008352000,1.3955
215.158.238.153,<->,100.216.78.145,33,35816,0,0,33,35816,0.462175000,1.4955
215.158.238.144,<->,98.219.126.140,33,33853,0,0,33,33853,0.092460000,1.5698
99.167.15.52,<->,97.198.98.222,0,0,33,7224,33,7224,0.053013000,1.8865
133.178.227.30,<->,133.56.180.44,33,43090,0,0,33,43090,0.051918000,0.5918
129.92.112.242,<->,109.92.190.87,33,13365,0,0,33,13365,0.042691000,1.9223
252.98.138.44,<->,89.153.118.184,33,5865,0,0,33,5865,0.031609000,1.9652
146.15.20.243,<->,80.27.158.181,0,0,32,19552,32,19552,0.254188000,1.5879
220.28.115.46,<->,215.158.238.246,0,0,32,29997,32,29997,0.226881000,1.5770
215.158.30.229,<->,8.252.222.59,0,0,32,19516,32,19516,0.166712000,1.7804
136.25.189.41,<->,96.156.169.219,32,34129,0,0,32,34129,0.159293000,1.6052
215.158.238.77,<->,100.120.38.6,32,30665,0,0,32,30665,0.154241000,1.6825
215.158.238.102,<->,100.216.78.145,32,31087,0,0,32,31087,0.154117000,1.7927
215.158.61.221,<->,8.252.221.166,0,0,32,46366,32,46366,0.097567000,0.1191
133.178.226.21,<->,100.120.38.6,32,30370,0,0,32,30370,0.038599000,1.8300
220.28.115.46,<->,215.158.238.145,0,0,32,29633,32,29633,0.035093000,1.9556
210.220.219.177,<->,54.53.118.167,32,4792,0,0,32,4792,0.034992000,1.9414
220.28.104.193,<->,215.158.238.109,0,0,32,29769,32,29769,0.031088000,1.8554
252.98.138.44,<->,106.176.217.83,32,2752,0,0,32,2752,0.023321000,1.8628
215.158.238.212,<->,129.80.130.60,31,36874,0,0,31,36874,0.921981000,0.0535
215.158.133.55,<->,6.228.16.194,0,0,31,10440,31,10440,0.445125000,1.2553
216.184.1.126,<->,136.25.188.245,0,0,31,16781,31,16781,0.347125000,1.6358
136.25.188.192,<->,98.219.126.140,31,33510,0,0,31,33510,0.159568000,1.3475
215.158.23.50,<->,192.204.123.10,31,39956,0,0,31,39956,0.082991000,1.9089
215.158.238.146,<->,98.219.126.140,31,32585,0,0,31,32585,0.079786000,1.6793
215.158.238.101,<->,100.120.38.6,31,31010,0,0,31,31010,0.052436000,1.8705
144.87.238.89,<->,8.182.253.100,0,0,31,11568,31,11568,0.039389000,1.9586
215.158.238.71,<->,100.120.38.6,31,33024,0,0,31,33024,0.034494000,1.7437
101.87.173.115,<->,100.228.42.97,0,0,31,23444,31,23444,0.007905000,1.8027
100.230.43.160,<->,50.224.72.162,0,0,30,12156,30,12156,0.681220000,1.3091
224.213.229.201,<->,109.222.200.21,0,0,30,34569,30,34569,0.628483000,1.0834
129.236.114.39,<->,33.233.141.10,0,0,30,18654,30,18654,0.124070000,0.0470
139.163.81.178,<->,17.71.161.34,30,9255,0,0,30,9255,0.110957000,1.7763
215.158.239.220,<->,159.61.250.241,30,40156,0,0,30,40156,0.094132000,1.5057
220.28.115.46,<->,133.178.227.45,0,0,30,26030,30,26030,0.074951000,1.6778
220.28.73.211,<->,133.178.227.36,0,0,30,26076,30,26076,0.019755000,1.9080
220.28.85.14,<->,215.158.238.194,0,0,30,24703,30,24703,0.018411000,1.9791
215.158.238.145,<->,100.120.38.6,29,26897,0,0,29,26897,0.422704000,1.4829
220.28.114.28,<->,215.158.238.103,0,0,29,31115,29,31115,0.099904000,1.8824
139.241.56.116,<->,100.93.227.11,0,0,29,42221,29,42221,0.090819000,1.8880
101.70.121.77,<->,91.250.62.235,29,41296,0,0,29,41296,0.025042000,1.9745
246.253.253.107,<->,109.203.238.95,29,7298,0,0,29,7298,0.007809000,0.0042
210.220.219.182,<->,54.51.230.10,29,5160,0,0,29,5160,0.002168000,1.9348
146.240.17.87,<->,50.224.76.229,0,0,28,38619,28,38619,1.646305000,0.1367
215.158.238.201,<->,139.241.115.236,28,28115,0,0,28,28115,1.563747000,0.0808
215.158.239.11,<->,215.158.127.166,28,29545,0,0,28,29545,0.476503000,1.4509
215.158.239.24,<->,215.158.127.166,28,35389,0,0,28,35389,0.411323000,1.3196
224.229.14.103,<->,97.198.108.252,0,0,28,13599,28,13599,0.169460000,1.8133
216.184.2.32,<->,8.252.222.169,0,0,28,18196,28,18196,0.167952000,1.7961
220.28.114.28,<->,215.158.238.152,0,0,28,27213,28,27213,0.133926000,1.8138
159.57.90.68,<->,145.208.190.226,0,0,28,35143,28,35143,0.122909000,0.2182
215.158.238.68,<->,100.216.78.145,28,29144,0,0,28,29144,0.114126000,1.8216
235.42.35.226,<->,215.158.23.59,0,0,28,38808,28,38808,0.111035000,1.8811
215.158.238.70,<->,100.120.38.6,28,26885,0,0,28,26885,0.095460000,1.4437
109.222.249.211,<->,56.140.239.139,28,16188,0,0,28,16188,0.057252000,1.9105
215.158.238.79,<->,98.219.126.175,28,28862,0,0,28,28862,0.045028000,1.8891
133.178.226.84,<->,100.120.38.6,28,28013,0,0,28,28013,0.044520000,1.6852
220.50.242.203,<->,136.25.189.195,0,0,28,19459,28,19459,0.039797000,1.6335
204.39.197.90,<->,35.56.97.193,0,0,28,1988,28,1988,0.024462000,1.9517
109.222.249.182,<->,96.232.2.179,28,4928,0,0,28,4928,0.007324000,1.9276
144.81.195.144,<->,136.25.188.37,0,0,27,37342,27,37342,0.738554000,0.3209
215.158.239.237,<->,120.49.159.72,27,14745,0,0,27,14745,0.520885000,1.4489
111.42.21.99,<->,8.176.8.69,0,0,27,5761,27,5761,0.365761000,1.5697
99.181.53.171,<->,8.52.240.121,0,0,27,7898,27,7898,0.329297000,1.2706
136.25.188.170,<->,80.57.208.108,27,17535,0,0,27,17535,0.267878000,1.6860
220.28.85.14,<->,215.158.238.137,0,0,27,27806,27,27806,0.228911000,1.7511
216.184.1.112,<->,8.252.222.169,0,0,27,15266,27,15266,0.226326000,1.7234
215.158.238.131,<->,100.216.78.145,27,27018,0,0,27,27018,0.144440000,1.2048
133.178.226.8,<->,100.120.38.6,27,29420,0,0,27,29420,0.131435000,1.2309
136.25.189.24,<->,96.156.169.196,27,16702,0,0,27,16702,0.105712000,1.8202
215.158.238.117,<->,98.219.126.175,27,24314,0,0,27,24314,0.072293000,1.8786
220.28.65.9,<->,215.158.238.130,0,0,27,26102,27,26102,0.050883000,1.6801
246.108.106.235,<->,111.147.92.14,0,0,27,9065,27,9065,0.040416000,1.9480
144.34.64.236,<->,139.163.34.3,0,0,27,33588,27,33588,0.035764000,1.9436
215.158.238.108,<->,100.120.38.6,27,27022,0,0,27,27022,0.006765000,1.7545
215.158.238.102,<->,100.120.38.6,26,25081,0,0,26,25081,0.349623000,1.5190
133.178.226.20,<->,100.120.38.6,26,25323,0,0,26,25323,0.203448000,1.4397
133.178.227.9,<->,133.56.180.25,26,29235,0,0,26,29235,0.089478000,1.7575
139.241.56.102,<->,109.2.42.159,0,0,26,35056,26,35056,0.086103000,1.9040
215.158.239.25,<->,215.158.127.166,26,19981,0,0,26,19981,0.055780000,1.8787
205.127.108.115,<->,101.224.89.170,0,0,26,13644,26,13644,0.042410000,1.9322
220.28.65.9,<->,133.178.227.8,0,0,26,18952,26,18952,0.041466000,1.9146
215.158.238.244,<->,100.216.78.145,26,19209,0,0,26,19209,0.022493000,1.9137
58.143.230.90,<->,8.252.221.223,0,0,26,8382,26,8382,0.012475000,1.8809
144.232.205.250,<->,6.228.9.53,0,0,25,8186,25,8186,0.951786000,0.9229
215.158.239.27,<->,96.135.154.115,25,22146,0,0,25,22146,0.834362000,1.0496
215.158.238.109,<->,100.120.38.6,25,22650,0,0,25,22650,0.526522000,1.2047
220.28.104.193,<->,215.158.238.117,0,0,25,25667,25,25667,0.329411000,1.3837
220.28.108.254,<->,215.158.238.146,0,0,25,24916,25,24916,0.229465000,1.6353
215.158.238.152,<->,98.219.126.175,25,20589,0,0,25,20589,0.120737000,1.8004
220.28.73.211,<->,215.158.238.131,0,0,25,23422,25,23422,0.109505000,1.7769
139.241.56.117,<->,129.1.97.120,0,0,25,33600,25,33600,0.089052000,1.9015
220.83.79.113,<->,139.241.56.116,25,33600,0,0,25,33600,0.087180000,1.9035
139.241.56.102,<->,109.0.247.120,0,0,25,10048,25,10048,0.087102000,1.9040
192.65.116.33,<->,139.241.56.117,25,33600,0,0,25,33600,0.086894000,1.9026
144.46.53.233,<->,80.42.153.245,0,0,25,33600,25,33600,0.083523000,1.9040
247.136.233.174,<->,139.241.56.102,25,33600,0,0,25,33600,0.057581000,1.9041
139.241.56.102,<->,80.41.244.122,0,0,25,10048,25,10048,0.056865000,1.9041
139.69.162.20,<->,8.252.222.168,0,0,25,15317,25,15317,0.045880000,1.8066
220.28.73.211,<->,215.158.140.84,0,0,25,22356,25,22356,0.027502000,1.9595
215.158.239.61,<->,8.222.48.115,25,14269,0,0,25,14269,0.025241000,1.5807
192.67.123.168,<->,139.241.56.117,25,33600,0,0,25,33600,0.024044000,1.9128
247.136.133.71,<->,139.241.56.102,25,33600,0,0,25,33600,0.012682000,1.9182
220.28.73.211,<->,215.158.238.117,0,0,25,25601,25,25601,0.008951000,1.4837
215.158.238.130,<->,98.219.126.175,25,25958,0,0,25,25958,0.007651000,1.8692
101.224.182.5,<->,92.162.253.239,0,0,24,35177,24,35177,1.205908000,0.2519
139.163.161.50,<->,136.25.188.201,0,0,24,15836,24,15836,0.896992000,0.9188
139.144.241.233,<->,98.67.154.32,0,0,24,14730,24,14730,0.632376000,1.1311
220.28.85.14,<->,215.158.238.76,0,0,24,25861,24,25861,0.424233000,1.4794
220.28.109.52,<->,136.25.188.166,0,0,24,23282,24,23282,0.415219000,1.5758
133.178.227.37,<->,133.56.180.93,24,24374,0,0,24,24374,0.263298000,1.6953
215.158.238.71,<->,98.219.126.140,24,19273,0,0,24,19273,0.240453000,1.7282
139.114.131.88,<->,8.182.239.159,0,0,24,5581,24,5581,0.204222000,1.7028
215.158.30.165,<->,8.252.222.145,0,0,24,14104,24,14104,0.195669000,1.3283
133.178.227.37,<->,100.216.78.145,24,20122,0,0,24,20122,0.139153000,1.7969
136.114.101.11,<->,136.25.188.202,0,0,24,15255,24,15255,0.124185000,1.8649
192.67.131.111,<->,8.55.143.211,24,14252,0,0,24,14252,0.105518000,1.8925
139.241.56.117,<->,6.138.251.242,0,0,24,4504,24,4504,0.095749000,1.8243
139.241.56.117,<->,99.75.199.162,0,0,24,33544,24,33544,0.092178000,1.9006
192.64.237.86,<->,139.241.56.102,24,32144,0,0,24,32144,0.091095000,1.8289
159.215.65.184,<->,136.25.188.202,0,0,24,12936,24,12936,0.090849000,1.8730
139.241.56.102,<->,129.1.86.108,0,0,24,9616,24,9616,0.089112000,1.8289
220.83.110.127,<->,139.241.56.102,24,33544,0,0,24,33544,0.088189000,1.9038
239.227.98.245,<->,139.241.56.102,24,34654,0,0,24,34654,0.087406000,1.9040
220.28.85.14,<->,215.158.238.128,0,0,24,24792,24,24792,0.050962000,1.9176
215.158.239.232,<->,100.244.13.12,24,10144,0,0,24,10144,0.035711000,1.9586
215.158.238.126,<->,100.120.38.6,23,21806,0,0,23,21806,0.246398000,1.5805
133.178.227.119,<->,8.176.12.111,23,8512,0,0,23,8512,0.198782000,1.3083
138.74.30.197,<->,89.90.107.236,23,9283,0,0,23,9283,0.182140000,1.7356
139.241.56.117,<->,102.51.223.0,0,0,23,33486,23,33486,0.095165000,1.9006
139.241.56.117,<->,99.73.229.194,0,0,23,33486,23,33486,0.093426000,1.9006
139.241.56.117,<->,99.72.199.26,0,0,23,33210,23,33210,0.092454000,1.9006
139.241.56.117,<->,99.75.228.122,0,0,23,11130,23,11130,0.091469000,1.9006
139.241.56.117,<->,98.128.18.123,0,0,23,33210,23,33210,0.088416000,1.9018
139.241.56.116,<->,100.95.51.182,0,0,23,33210,23,33210,0.088409000,1.9020
139.241.56.105,<->,6.228.57.59,0,0,23,33210,23,33210,0.088348000,1.9038
247.136.245.95,<->,139.241.56.117,23,33210,0,0,23,33210,0.088249000,1.9019
139.241.56.117,<->,100.182.137.34,0,0,23,1470,23,1470,0.088177000,1.9019
215.158.23.60,<->,94.110.153.218,23,31734,0,0,23,31734,0.087954000,1.8321
144.253.55.144,<->,80.40.14.25,0,0,23,33486,23,33486,0.083647000,1.9040
215.158.23.28,<->,111.150.185.79,23,30775,0,0,23,30775,0.060017000,1.9012
139.241.56.117,<->,99.73.108.156,0,0,23,33486,23,33486,0.058141000,1.9040
139.241.56.102,<->,109.0.193.78,0,0,23,33090,23,33090,0.057253000,1.9041
247.136.207.38,<->,144.46.53.239,23,33210,0,0,23,33210,0.045256000,1.9062
133.178.227.36,<->,133.56.180.46,23,12344,0,0,23,12344,0.040233000,1.9571
215.158.238.144,<->,100.120.38.6,23,23010,0,0,23,23010,0.038218000,1.8145
136.25.188.246,<->,100.224.202.187,23,14531,0,0,23,14531,0.030585000,1.5307
215.158.23.54,<->,120.154.225.199,23,32729,0,0,23,32729,0.019292000,1.9174
220.28.73.211,<->,215.158.238.86,0,0,23,22824,23,22824,0.011111000,1.7601
242.6.57.233,<->,139.163.17.164,0,0,23,4599,23,4599,0.009236000,1.9779
215.158.140.181,<->,100.224.243.91,22,29153,0,0,22,29153,1.417742000,0.5743
215.158.140.78,<->,215.158.58.202,22,11558,0,0,22,11558,1.196915000,0.4791
215.158.239.1,<->,215.158.127.140,22,28127,0,0,22,28127,1.099685000,0.7935
206.243.235.195,<->,92.27.8.96,0,0,22,13711,22,13711,1.016125000,0.1563
100.228.42.147,<->,100.168.37.238,22,7902,0,0,22,7902,0.478649000,1.5183
220.28.109.52,<->,136.25.188.164,0,0,22,22048,22,22048,0.406314000,1.5079
215.158.238.118,<->,100.120.38.6,22,21121,0,0,22,21121,0.378690000,1.5009
220.28.108.254,<->,215.158.238.139,0,0,22,24127,22,24127,0.346832000,1.5374
215.158.30.187,<->,8.252.222.131,0,0,22,11816,22,11816,0.312193000,1.4036
220.28.85.14,<->,215.158.238.138,0,0,22,22995,22,22995,0.311524000,1.3253
133.178.227.76,<->,133.56.180.15,22,27310,0,0,22,27310,0.206096000,1.7360
215.158.239.199,<->,192.229.43.21,22,8734,0,0,22,8734,0.166240000,1.6526
216.184.1.115,<->,136.25.188.164,0,0,22,13599,22,13599,0.157503000,1.7621
139.163.161.19,<->,136.25.188.219,0,0,22,15270,22,15270,0.123963000,1.5951
220.28.108.254,<->,215.158.238.108,0,0,22,23460,22,23460,0.071268000,1.8336
215.158.23.26,<->,113.23.111.152,22,30237,0,0,22,30237,0.059334000,1.9355
133.178.227.86,<->,133.55.11.211,22,4246,0,0,22,4246,0.056478000,1.8755
136.25.189.7,<->,96.156.169.209,22,10742,0,0,22,10742,0.046338000,1.7931
215.158.238.103,<->,100.216.78.145,22,22314,0,0,22,22314,0.042704000,1.1530
133.178.227.61,<->,133.56.180.46,22,16936,0,0,22,16936,0.035196000,1.8055
133.178.227.7,<->,133.56.180.78,22,14681,0,0,22,14681,0.023985000,1.7555
215.158.238.139,<->,100.120.38.6,22,21362,0,0,22,21362,0.022523000,1.9336
220.28.114.28,<->,215.158.238.137,0,0,22,22113,22,22113,0.012603000,1.7184
101.235.68.176,<->,8.20.81.65,21,17785,0,0,21,17785,1.281799000,0.3919
215.158.132.255,<->,8.252.223.67,0,0,21,20269,21,20269,1.187526000,0.0911
136.25.188.233,<->,100.224.202.187,21,13513,0,0,21,13513,0.754213000,1.2139
136.25.188.166,<->,100.224.202.176,21,9609,0,0,21,9609,0.439907000,1.4565
215.158.239.3,<->,215.158.127.154,21,22382,0,0,21,22382,0.381752000,1.0926
133.178.226.56,<->,100.120.38.6,21,19233,0,0,21,19233,0.278205000,1.6046
220.28.115.46,<->,215.158.238.252,0,0,21,18434,21,18434,0.246790000,1.6842
215.158.239.115,<->,159.61.251.14,21,30384,0,0,21,30384,0.207294000,0.0364
220.28.108.254,<->,215.158.238.71,0,0,21,21058,21,21058,0.162005000,1.8041
215.158.238.219,<->,98.219.126.140,21,19582,0,0,21,19582,0.134409000,1.7262
102.254.20.36,<->,97.198.122.218,0,0,21,1957,21,1957,0.133715000,1.8525
215.158.238.128,<->,98.219.126.175,21,17918,0,0,21,17918,0.125380000,1.7752
192.228.25.249,<->,133.178.226.213,0,0,21,24189,21,24189,0.123386000,1.7569
192.64.227.158,<->,92.27.51.117,21,10716,0,0,21,10716,0.093599000,1.8919
215.158.23.52,<->,126.219.102.69,21,30231,0,0,21,30231,0.080505000,1.8763
92.27.51.127,<->,6.228.36.29,0,0,21,10716,21,10716,0.058201000,1.8913
136.25.189.208,<->,111.42.25.227,21,11487,0,0,21,11487,0.035953000,1.3840
136.25.189.22,<->,96.156.169.210,21,12209,0,0,21,12209,0.035670000,1.7146
192.64.251.234,<->,142.202.168.22,21,6888,0,0,21,6888,0.035138000,1.8803
220.28.114.28,<->,215.158.238.79,0,0,21,20098,21,20098,0.033265000,1.8083
159.137.218.90,<->,102.231.187.175,0,0,21,7640,21,7640,0.030995000,1.9274
133.178.226.85,<->,96.155.60.211,21,14400,0,0,21,14400,0.022977000,1.8745
133.178.227.6,<->,133.56.180.93,21,14241,0,0,21,14241,0.008794000,1.9421
92.27.219.142,<->,0.240.189.235,21,3192,0,0,21,3192,0.003851000,1.9755
133.135.214.225,<->,129.6.83.5,0,0,20,25436,20,25436,0.972176000,0.8431
215.158.140.180,<->,131.31.145.204,20,28615,0,0,20,28615,0.883081000,0.8809
111.147.255.174,<->,53.232.227.250,20,27745,0,0,20,27745,0.865276000,0.9666
136.25.188.235,<->,98.219.126.140,20,22388,0,0,20,22388,0.747499000,1.2419
17.18.69.246,<->,8.220.176.253,0,0,20,5130,20,5130,0.556892000,1.3792
215.158.238.91,<->,100.120.38.6,20,18999,0,0,20,18999,0.531243000,0.8997
255.17.29.136,<->,8.220.205.146,0,0,20,11483,20,11483,0.240747000,1.7208
220.28.73.211,<->,215.158.238.146,0,0,20,19486,20,19486,0.224233000,1.6115
136.25.188.56,<->,96.155.61.54,20,10956,0,0,20,10956,0.213020000,1.7341
136.25.188.57,<->,100.216.78.145,20,20473,0,0,20,20473,0.185958000,1.6326
136.25.188.244,<->,97.174.232.235,20,12140,0,0,20,12140,0.141318000,1.8450
220.28.115.46,<->,215.158.238.79,0,0,20,18794,20,18794,0.108138000,1.6264
109.1.58.175,<->,92.27.102.178,20,9721,0,0,20,9721,0.099971000,1.8916
220.28.109.52,<->,136.25.188.232,0,0,20,18341,20,18341,0.082353000,1.4937
92.27.51.116,<->,80.40.41.53,0,0,20,9401,20,9401,0.071996000,1.8947
210.227.197.43,<->,50.224.61.115,0,0,20,7219,20,7219,0.050866000,1.8979
136.25.188.169,<->,96.155.61.28,20,12236,0,0,20,12236,0.049668000,1.7443
145.116.209.93,<->,136.25.188.231,0,0,20,14152,20,14152,0.043103000,1.3311
215.188.8.186,<->,136.25.189.215,0,0,20,13705,20,13705,0.038655000,0.5974
195.55.27.126,<->,136.25.188.176,0,0,20,2180,20,2180,0.038151000,1.9531
247.136.220.220,<->,139.241.56.102,20,25639,0,0,20,25639,0.030239000,1.8801
133.178.226.94,<->,100.120.38.6,20,17628,0,0,20,17628,0.029889000,1.5315
132.165.186.130,<->,92.162.253.47,0,0,20,7360,20,7360,0.026470000,1.9644
215.158.238.118,<->,98.219.126.140,20,21097,0,0,20,21097,0.025686000,1.8936
136.25.188.230,<->,80.57.141.163,20,9356,0,0,20,9356,0.012424000,1.4086
220.55.111.131,<->,8.222.6.110,19,28321,0,0,19,28321,1.519081000,0.3162
93.181.154.66,<->,92.27.219.140,0,0,19,3225,19,3225,1.127029000,0.6184
127.225.105.100,<->,100.92.156.116,0,0,19,26997,19,26997,0.820372000,1.1094
136.25.189.93,<->,96.156.169.210,19,11583,0,0,19,11583,0.657551000,1.2777
215.158.238.86,<->,98.219.126.175,19,20726,0,0,19,20726,0.574494000,1.3816
215.158.238.131,<->,100.120.38.6,19,19693,0,0,19,19693,0.542323000,0.8409
109.222.230.185,<->,53.208.110.227,19,9198,0,0,19,9198,0.388617000,1.1982
220.28.85.14,<->,215.158.238.71,0,0,19,17821,19,17821,0.333824000,1.5868
220.28.114.28,<->,215.158.238.41,0,0,19,17990,19,17990,0.233387000,1.6583
220.28.114.28,<->,215.158.238.70,0,0,19,20096,19,20096,0.151183000,1.7541
220.28.85.14,<->,215.158.238.110,0,0,19,17128,19,17128,0.120936000,1.7814
220.80.38.227,<->,139.241.56.117,19,24864,0,0,19,24864,0.096433000,1.9010
145.116.209.71,<->,136.25.188.51,0,0,19,10815,19,10815,0.083901000,1.5647
132.165.186.130,<->,92.162.252.174,0,0,19,6992,19,6992,0.083235000,1.8678
111.20.172.119,<->,111.20.168.9,0,0,19,25857,19,25857,0.075804000,1.7853
220.28.73.211,<->,215.158.238.254,0,0,19,17900,19,17900,0.075651000,1.7610
136.25.188.247,<->,97.174.232.226,19,10055,0,0,19,10055,0.064596000,1.7448
136.25.189.42,<->,96.156.169.251,19,11983,0,0,19,11983,0.062799000,1.8887
193.22.56.246,<->,80.41.51.42,0,0,19,26188,19,26188,0.044222000,1.8697
215.158.239.92,<->,195.49.2.75,19,2375,0,0,19,2375,0.040223000,1.8290
215.158.239.177,<->,192.224.20.69,19,10679,0,0,19,10679,0.034981000,1.8599
111.147.200.132,<->,53.231.73.49,19,24776,0,0,19,24776,0.034630000,1.7994
215.158.61.189,<->,8.176.8.196,0,0,19,12748,19,12748,0.034074000,1.8345
192.64.197.124,<->,8.55.143.211,18,12400,0,0,18,12400,1.507480000,0.4748
220.28.73.211,<->,215.158.238.76,0,0,18,16018,18,16018,1.196365000,0.7413
254.126.111.238,<->,6.228.27.68,0,0,18,1381,18,1381,0.624550000,1.3099
215.158.238.89,<->,100.216.78.145,18,20925,0,0,18,20925,0.617640000,1.3117
111.146.212.59,<->,89.204.9.34,18,13905,0,0,18,13905,0.546414000,0.8984
215.188.8.186,<->,215.158.239.194,0,0,18,8957,18,8957,0.540433000,1.3419
159.237.225.83,<->,103.150.193.74,18,6046,0,0,18,6046,0.485048000,1.3053
246.254.97.103,<->,193.94.10.149,18,1770,0,0,18,1770,0.420188000,1.4868
53.231.94.20,<->,33.233.141.47,0,0,18,5723,18,5723,0.371515000,0.9645
215.158.238.94,<->,33.209.217.237,18,21645,0,0,18,21645,0.361552000,1.6371
215.158.239.97,<->,199.82.192.73,18,3867,0,0,18,3867,0.266693000,1.4371
111.151.237.12,<->,50.224.105.38,0,0,18,26823,18,26823,0.178601000,0.1151
220.28.115.46,<->,215.158.238.68,0,0,18,17370,18,17370,0.087778000,0.9791
92.27.219.203,<->,29.222.157.238,18,24139,0,0,18,24139,0.085989000,1.8845
215.158.238.87,<->,100.216.78.145,18,17944,0,0,18,17944,0.078001000,1.4066
101.70.123.195,<->,53.149.26.42,18,9282,0,0,18,9282,0.057987000,1.7138
136.25.188.167,<->,100.224.166.161,18,10576,0,0,18,10576,0.055453000,1.5341
133.178.227.16,<->,133.56.180.55,18,22841,0,0,18,22841,0.055081000,1.7660
215.158.238.136,<->,98.219.126.175,18,15044,0,0,18,15044,0.053410000,1.9434
136.25.188.198,<->,29.214.108.150,18,24661,0,0,18,24661,0.039700000,1.8643
133.178.226.74,<->,133.56.180.75,18,21060,0,0,18,21060,0.033900000,1.6898
220.28.108.254,<->,215.158.238.110,0,0,18,19336,18,19336,0.031951000,1.9189
204.200.19.3,<->,0.195.210.33,0,0,18,2138,18,2138,0.024810000,1.9137
139.163.83.153,<->,98.150.54.68,18,9455,0,0,18,9455,0.021749000,0.7328
215.158.238.119,<->,98.219.126.175,18,18298,0,0,18,18298,0.020811000,1.8914
133.178.227.27,<->,133.56.180.83,18,16502,0,0,18,16502,0.016378000,1.9632
215.158.140.79,<->,100.216.78.145,18,15410,0,0,18,15410,0.005254000,1.9036
136.25.189.24,<->,96.156.169.209,18,14330,0,0,18,14330,0.002952000,1.5711
215.158.239.219,<->,215.62.250.163,17,9534,0,0,17,9534,1.650712000,0.0970
215.158.195.23,<->,53.231.141.142,17,4731,0,0,17,4731,1.530910000,0.2892
148.184.118.184,<->,0.195.210.42,0,0,17,12275,17,12275,1.251861000,0.7100
192.224.146.178,<->,133.178.226.55,0,0,17,17240,17,17240,0.963918000,0.0386
139.5.114.123,<->,136.25.188.195,0,0,17,11316,17,11316,0.867352000,0.9779
220.28.108.254,<->,215.158.238.152,0,0,17,16717,17,16717,0.558750000,1.0171
215.158.239.24,<->,215.158.127.173,17,11674,0,0,17,11674,0.461695000,1.5254
213.155.77.129,<->,98.236.252.215,0,0,17,2166,17,2166,0.453747000,1.5097
220.28.109.52,<->,136.25.188.59,0,0,17,16889,17,16889,0.425862000,1.4165
220.28.73.211,<->,215.158.238.88,0,0,17,14366,17,14366,0.335813000,0.9872
136.25.188.202,<->,56.97.186.151,17,12573,0,0,17,12573,0.274395000,1.5003
133.178.227.52,<->,100.216.78.145,17,16824,0,0,17,16824,0.238194000,1.0244
133.178.227.28,<->,133.56.180.44,17,13985,0,0,17,13985,0.191871000,1.6396
204.60.234.12,<->,136.25.188.173,0,0,17,9149,17,9149,0.186547000,1.6366
246.108.107.182,<->,80.40.4.150,0,0,17,10249,17,10249,0.160155000,1.7884
136.25.188.255,<->,100.224.202.188,17,7815,0,0,17,7815,0.133997000,1.8568
215.158.238.86,<->,0.195.237.14,17,17176,0,0,17,17176,0.130087000,1.6909
136.25.189.5,<->,96.156.169.239,17,11381,0,0,17,11381,0.116583000,1.6110
215.158.238.125,<->,0.195.253.228,17,17918,0,0,17,17918,0.114757000,1.7062
50.224.89.243,<->,42.83.15.123,17,13341,0,0,17,13341,0.109876000,1.7667
136.25.189.21,<->,96.156.169.165,17,10285,0,0,17,10285,0.099349000,1.8542
220.28.65.9,<->,133.178.227.52,0,0,17,9775,17,9775,0.098519000,1.8393
216.184.2.83,<->,8.252.222.155,0,0,17,9877,17,9877,0.097794000,1.6931
136.25.189.61,<->,96.156.169.216,17,11693,0,0,17,11693,0.097234000,1.7773
159.215.65.180,<->,136.25.188.202,0,0,17,7845,17,7845,0.095291000,1.8632
215.158.238.128,<->,100.216.78.145,17,16225,0,0,17,16225,0.090294000,1.3654
220.28.114.28,<->,215.158.238.136,0,0,17,15878,17,15878,0.088979000,1.3902
210.221.107.50,<->,8.37.222.100,17,8405,0,0,17,8405,0.088977000,1.7472
215.158.239.8,<->,96.135.154.143,17,15533,0,0,17,15533,0.088333000,1.5850
159.64.157.34,<->,97.198.98.50,0,0,17,21148,17,21148,0.073748000,1.9104
205.127.108.114,<->,33.233.141.33,0,0,17,9015,17,9015,0.070170000,1.7675
215.158.238.176,<->,8.191.7.104,17,18277,0,0,17,18277,0.053865000,1.8826
99.75.168.172,<->,33.250.123.50,17,25080,0,0,17,25080,0.045955000,1.8810
220.80.180.55,<->,139.241.56.117,17,24750,0,0,17,24750,0.035140000,1.6808
136.25.189.36,<->,96.156.169.209,17,8965,0,0,17,8965,0.031367000,1.7604
220.28.73.211,<->,215.158.238.201,0,0,17,10114,17,10114,0.030833000,1.8251
159.215.65.139,<->,136.25.188.58,0,0,17,10869,17,10869,0.028686000,1.5916
220.28.115.46,<->,215.158.238.254,0,0,17,16340,17,16340,0.018746000,1.8878
215.158.239.57,<->,145.13.164.192,17,20597,0,0,17,20597,0.010935000,1.1791
99.187.125.122,<->,8.20.87.33,0,0,16,20263,16,20263,1.251596000,0.0642
215.158.238.130,<->,100.120.38.6,16,15679,0,0,16,15679,1.029219000,0.8873
8.182.224.150,<->,6.20.46.236,16,6864,0,0,16,6864,0.952222000,0.9861
144.87.238.91,<->,8.182.245.110,0,0,16,5526,16,5526,0.884061000,0.9989
136.25.188.56,<->,100.224.202.187,16,11352,0,0,16,11352,0.843413000,0.8449
215.158.239.62,<->,192.205.36.221,16,7984,0,0,16,7984,0.757865000,0.6628
145.19.8.119,<->,97.4.40.49,16,9474,0,0,16,9474,0.557465000,1.4353
139.69.162.56,<->,8.252.222.43,0,0,16,8120,16,8120,0.441212000,1.4925
210.220.219.150,<->,98.197.185.155,16,3080,0,0,16,3080,0.439264000,1.1452
133.178.227.21,<->,133.56.180.18,16,8738,0,0,16,8738,0.432756000,1.5595
215.158.238.131,<->,0.195.253.228,16,15314,0,0,16,15314,0.311836000,1.5805
216.184.1.90,<->,8.252.222.169,0,0,16,8185,16,8185,0.304824000,1.3004
215.158.239.60,<->,8.222.48.41,16,8024,0,0,16,8024,0.287930000,1.2387
136.25.188.212,<->,56.51.205.162,16,7760,0,0,16,7760,0.283160000,1.5223
136.25.188.233,<->,100.224.202.157,16,10397,0,0,16,10397,0.272630000,1.4249
138.45.90.226,<->,136.25.188.232,0,0,16,9586,16,9586,0.250701000,1.7420
139.163.161.33,<->,136.25.188.58,0,0,16,7944,16,7944,0.170939000,1.2867
215.158.239.88,<->,8.222.48.140,16,8544,0,0,16,8544,0.132558000,1.8403
136.25.189.37,<->,96.156.169.239,16,8648,0,0,16,8648,0.125709000,1.8659
212.241.174.245,<->,80.27.157.20,0,0,16,11726,16,11726,0.086702000,1.7911
136.25.188.56,<->,96.155.61.44,16,11344,0,0,16,11344,0.082181000,1.3377
139.205.240.222,<->,136.129.57.93,0,0,16,2800,16,2800,0.078646000,0.8450
133.178.227.37,<->,133.56.180.35,16,11320,0,0,16,11320,0.064309000,1.3890
220.28.114.28,<->,136.25.189.25,0,0,16,9092,16,9092,0.062960000,1.8451
43.52.162.153,<->,8.252.221.206,0,0,16,5115,16,5115,0.050848000,1.7581
220.28.85.14,<->,133.178.227.7,0,0,16,9012,16,9012,0.045202000,1.8112
215.158.61.255,<->,8.252.222.75,0,0,16,8425,16,8425,0.035720000,1.1620
139.241.56.102,<->,6.74.85.210,0,0,16,23294,16,23294,0.028996000,1.9502
133.178.227.76,<->,133.56.180.90,16,20382,0,0,16,20382,0.028555000,1.9538
220.28.109.52,<->,136.25.188.219,0,0,16,16072,16,16072,0.028462000,1.5513
220.28.109.52,<->,136.25.188.192,0,0,16,18624,16,18624,0.019686000,1.2123
133.178.227.7,<->,133.56.180.44,16,10790,0,0,16,10790,0.016698000,1.7319
215.158.30.184,<->,136.25.188.193,0,0,16,11716,16,11716,0.016572000,1.8044
136.25.189.63,<->,96.156.169.239,16,9248,0,0,16,9248,0.016233000,1.7558
133.178.226.67,<->,133.56.180.18,16,7968,0,0,16,7968,0.000960000,1.7708
220.28.73.211,<->,215.158.238.70,0,0,15,14045,15,14045,1.106799000,0.8361
215.158.238.41,<->,100.120.38.6,15,14166,0,0,15,14166,0.854404000,0.9381
215.158.34.33,<->,8.252.222.42,0,0,15,10247,15,10247,0.583433000,0.4255
215.158.30.187,<->,8.252.222.57,0,0,15,12723,15,12723,0.524100000,0.9411
220.28.85.14,<->,215.158.140.81,0,0,15,9203,15,9203,0.432156000,1.5214
215.158.238.68,<->,0.195.237.14,15,15110,0,0,15,15110,0.407403000,1.3484
215.158.239.83,<->,139.163.161.50,15,8323,0,0,15,8323,0.360065000,1.6021
215.158.239.75,<->,111.52.91.196,15,10672,0,0,15,10672,0.347973000,1.6232
139.69.162.39,<->,136.25.188.170,0,0,15,10107,15,10107,0.327316000,1.2613
136.25.189.37,<->,96.156.169.236,15,8307,0,0,15,8307,0.326453000,1.4367
136.25.189.23,<->,56.28.207.205,15,8187,0,0,15,8187,0.291969000,1.2472
137.39.55.11,<->,100.228.42.205,0,0,15,6097,15,6097,0.248898000,1.3526
220.28.104.193,<->,215.158.238.88,0,0,15,16770,15,16770,0.228178000,1.1991
215.158.238.217,<->,98.219.126.140,15,11140,0,0,15,11140,0.178088000,1.8189
215.158.239.79,<->,142.207.250.149,15,3249,0,0,15,3249,0.173884000,0.5468
215.158.239.63,<->,97.174.232.234,15,8587,0,0,15,8587,0.141427000,1.6404
215.158.238.116,<->,100.120.38.6,15,14270,0,0,15,14270,0.131278000,1.1785
139.163.161.17,<->,136.25.188.58,0,0,15,7787,15,7787,0.124751000,1.7509
136.25.188.217,<->,98.219.126.175,15,11384,0,0,15,11384,0.124474000,1.7545
94.192.0.164,<->,8.252.221.223,0,0,15,4802,15,4802,0.123851000,1.7438
136.25.189.36,<->,96.156.169.218,15,6923,0,0,15,6923,0.113346000,1.8514
136.25.188.165,<->,100.224.166.146,15,9246,0,0,15,9246,0.109230000,1.7691
216.184.1.203,<->,99.74.26.99,0,0,15,11735,15,11735,0.096960000,1.8973
139.241.56.102,<->,6.75.247.82,0,0,15,15664,15,15664,0.091876000,1.9079
136.25.189.37,<->,96.156.169.207,15,6883,0,0,15,6883,0.087720000,1.5850
139.69.162.57,<->,136.25.188.219,0,0,15,7627,15,7627,0.070681000,1.6784
210.229.230.18,<->,205.187.74.148,15,6341,0,0,15,6341,0.067826000,1.8885
136.25.188.200,<->,111.52.91.255,15,7735,0,0,15,7735,0.061365000,1.8587
215.158.238.192,<->,100.216.78.145,15,12777,0,0,15,12777,0.058857000,0.7111
212.105.232.45,<->,97.126.114.4,0,0,15,1213,15,1213,0.057086000,1.9038
220.28.109.52,<->,136.25.188.248,0,0,15,15061,15,15061,0.055731000,0.8132
220.28.73.211,<->,215.158.140.249,0,0,15,9506,15,9506,0.048944000,1.9439
133.178.226.67,<->,133.56.180.2,15,13098,0,0,15,13098,0.045088000,1.7690
215.158.238.40,<->,100.120.38.6,15,12489,0,0,15,12489,0.040152000,1.9597
220.28.73.211,<->,133.178.226.67,0,0,15,13438,15,13438,0.038975000,1.7521
215.158.238.109,<->,98.219.126.140,15,15223,0,0,15,15223,0.036355000,1.5958
136.25.189.34,<->,133.56.180.32,15,19395,0,0,15,19395,0.030055000,1.9188
215.158.61.191,<->,8.176.8.248,0,0,15,14743,15,14743,0.029677000,1.9213
220.28.65.9,<->,136.25.188.217,0,0,15,15397,15,15397,0.022834000,1.5739
133.178.226.74,<->,133.56.180.25,15,12357,0,0,15,12357,0.013646000,1.8903
139.69.162.39,<->,8.252.222.43,0,0,15,8515,15,8515,0.008642000,1.7848
109.222.230.147,<->,95.221.118.55,15,1238,0,0,15,1238,0.007920000,1.7307
99.187.125.122,<->,8.20.87.2,0,0,14,16087,14,16087,1.742109000,0.2331
215.158.238.124,<->,100.120.38.6,14,13324,0,0,14,13324,1.104651000,0.7956
215.158.33.1,<->,133.178.226.95,0,0,14,12579,14,12579,0.949787000,0.9447
159.215.65.159,<->,136.25.188.212,0,0,14,7278,14,7278,0.796607000,0.9809
215.158.238.79,<->,0.195.253.228,14,15563,0,0,14,15563,0.779017000,0.3372
216.184.1.126,<->,8.252.222.164,0,0,14,8126,14,8126,0.715780000,1.2760
215.158.238.128,<->,100.120.38.6,14,14147,0,0,14,14147,0.688467000,1.1965
215.158.140.171,<->,98.219.126.140,14,18073,0,0,14,18073,0.666107000,0.5440
215.158.238.76,<->,98.219.126.175,14,14324,0,0,14,14324,0.632765000,1.3004
215.158.34.7,<->,8.252.222.42,0,0,14,7588,14,7588,0.624975000,1.1198
215.158.239.115,<->,145.182.137.222,14,6429,0,0,14,6429,0.588282000,0.9839
215.158.238.129,<->,0.195.253.228,14,14966,0,0,14,14966,0.535663000,0.6990
136.25.188.166,<->,100.224.202.184,14,9006,0,0,14,9006,0.520647000,1.1186
136.25.189.52,<->,96.156.169.210,14,6102,0,0,14,6102,0.496040000,1.4034
133.178.227.52,<->,133.56.180.25,14,6843,0,0,14,6843,0.418755000,1.5588
215.158.61.224,<->,8.252.222.66,0,0,14,13563,14,13563,0.396242000,0.8886
139.161.104.215,<->,133.178.226.180,0,0,14,10475,14,10475,0.354612000,1.2577
111.147.248.174,<->,97.110.90.232,14,2614,0,0,14,2614,0.317179000,0.7839
133.178.226.54,<->,100.120.38.6,14,13238,0,0,14,13238,0.295277000,1.6011
133.178.227.24,<->,133.56.180.57,14,17942,0,0,14,17942,0.294216000,1.2620
215.158.238.137,<->,0.195.237.14,14,13832,0,0,14,13832,0.266372000,1.1551
139.163.96.101,<->,50.129.35.163,14,2177,0,0,14,2177,0.264163000,1.7260
215.158.239.57,<->,207.61.203.69,14,3536,0,0,14,3536,0.262178000,0.7959
215.158.238.90,<->,0.195.253.228,14,13518,0,0,14,13518,0.243970000,1.1900
215.158.239.233,<->,100.244.13.12,14,5004,0,0,14,5004,0.240527000,1.3726
139.69.162.38,<->,8.252.222.169,0,0,14,9102,14,9102,0.231744000,1.5505
136.25.189.40,<->,96.156.169.207,14,8190,0,0,14,8190,0.221673000,1.5593
220.28.73.211,<->,133.178.227.63,0,0,14,12322,14,12322,0.199705000,1.6698
215.158.239.25,<->,215.158.127.164,14,12704,0,0,14,12704,0.183892000,1.0002
136.25.189.22,<->,96.156.169.238,14,9006,0,0,14,9006,0.160657000,1.7503
215.158.239.113,<->,129.222.39.134,14,13682,0,0,14,13682,0.160237000,1.7393
215.171.65.110,<->,133.32.39.44,0,0,14,1149,14,1149,0.156980000,1.8288
136.25.189.38,<->,96.156.169.216,14,7534,0,0,14,7534,0.147709000,1.6503
159.215.65.153,<->,136.25.188.233,0,0,14,6958,14,6958,0.127876000,1.4974
215.158.140.170,<->,144.95.111.33,14,4942,0,0,14,4942,0.125817000,1.8293
145.116.209.71,<->,136.25.188.58,0,0,14,6454,14,6454,0.113084000,1.1624
194.251.88.58,<->,97.198.98.47,0,0,14,3808,14,3808,0.111668000,1.8490
133.178.226.61,<->,112.220.206.18,14,18054,0,0,14,18054,0.109813000,1.6207
205.127.108.115,<->,101.224.89.214,0,0,14,8645,14,8645,0.106267000,1.7065
133.178.227.37,<->,133.56.180.44,14,8502,0,0,14,8502,0.100113000,1.8245
216.184.2.64,<->,8.252.222.137,0,0,14,8718,14,8718,0.095912000,0.8169
133.178.227.30,<->,133.56.180.78,14,6940,0,0,14,6940,0.094241000,1.8531
192.64.90.176,<->,128.154.170.88,14,6044,0,0,14,6044,0.093477000,1.7323
220.28.85.14,<->,215.158.238.116,0,0,14,13426,14,13426,0.087968000,1.3176
139.241.56.117,<->,100.92.203.223,0,0,14,20384,14,20384,0.087652000,1.6698
139.241.56.116,<->,99.75.36.216,0,0,14,5150,14,5150,0.084659000,1.6725
215.158.30.165,<->,8.252.222.137,0,0,14,7006,14,7006,0.082713000,1.7802
215.158.238.71,<->,98.219.126.175,14,14739,0,0,14,14739,0.081055000,1.7916
247.136.236.16,<->,22.249.199.122,14,7796,0,0,14,7796,0.080744000,0.5876
111.146.228.90,<->,53.201.176.118,14,4648,0,0,14,4648,0.079911000,1.8281
136.25.188.160,<->,8.222.7.23,14,18422,0,0,14,18422,0.072463000,1.8262
139.163.161.48,<->,136.25.188.219,0,0,14,6334,14,6334,0.065559000,1.7149
132.151.133.132,<->,53.75.173.116,14,3054,0,0,14,3054,0.062944000,1.5654
215.158.58.209,<->,6.73.247.102,0,0,14,15623,14,15623,0.056693000,1.5515
215.158.6.140,<->,8.252.222.249,0,0,14,7516,14,7516,0.054760000,1.7603
133.178.227.255,<->,126.219.54.44,14,5380,0,0,14,5380,0.054396000,1.2757
216.184.1.103,<->,8.252.222.128,0,0,14,7269,14,7269,0.052827000,1.2711
106.168.190.214,<->,102.50.235.188,0,0,14,1620,14,1620,0.051398000,1.1759
136.25.189.4,<->,96.156.169.196,14,9503,0,0,14,9503,0.032888000,1.8362
215.158.238.229,<->,98.219.126.140,14,10589,0,0,14,10589,0.027897000,1.4059
215.158.61.225,<->,8.252.222.64,0,0,14,10836,14,10836,0.026868000,0.5909
133.178.226.30,<->,29.214.108.158,14,16653,0,0,14,16653,0.026689000,1.9652
136.25.189.4,<->,96.156.169.178,14,8382,0,0,14,8382,0.025243000,1.4851
215.158.238.123,<->,145.116.209.86,14,7677,0,0,14,7677,0.022584000,1.9284
220.28.115.46,<->,215.158.238.78,0,0,14,11061,14,11061,0.021754000,1.7937
205.127.108.114,<->,33.233.141.34,0,0,14,9019,14,9019,0.018724000,1.9462
80.42.151.30,<->,22.250.173.71,14,21056,0,0,14,21056,0.017780000,1.9663
246.253.253.97,<->,8.20.81.30,14,9980,0,0,14,9980,0.006855000,1.4201
215.158.23.33,<->,69.132.194.106,14,20104,0,0,14,20104,0.004995000,1.8484
215.158.239.38,<->,215.158.127.142,14,14820,0,0,14,14820,0.004213000,1.9290
215.158.195.54,<->,80.46.112.244,13,12683,0,0,13,12683,1.804543000,0.0011
111.20.168.11,<->,72.210.211.251,13,19347,0,0,13,19347,1.737079000,0.1304
215.158.239.230,<->,208.34.52.202,13,17493,0,0,13,17493,1.510861000,0.0234
220.28.85.14,<->,136.25.188.57,0,0,13,13603,13,13603,1.348833000,0.2388
215.158.238.69,<->,0.195.253.228,13,13951,0,0,13,13951,1.119969000,0.7677
58.164.238.72,<->,0.195.210.33,0,0,13,1575,13,1575,0.919498000,1.0078
133.178.226.72,<->,98.219.126.140,13,12222,0,0,13,12222,0.887120000,0.5325
215.158.238.85,<->,98.219.126.140,13,13595,0,0,13,13595,0.853827000,1.1274
215.158.6.143,<->,8.252.222.212,0,0,13,10084,13,10084,0.831295000,1.0610
118.215.223.33,<->,92.27.219.198,0,0,13,16477,13,16477,0.791729000,1.1631
139.163.161.48,<->,136.25.188.57,0,0,13,8457,13,8457,0.646841000,1.1967
102.50.232.104,<->,57.110.204.222,13,14415,0,0,13,14415,0.633271000,0.9208
139.246.60.46,<->,8.52.185.185,0,0,13,9241,13,9241,0.627353000,0.8344
136.25.189.63,<->,96.156.169.209,13,8529,0,0,13,8529,0.571718000,1.3748
139.5.114.82,<->,136.25.188.213,0,0,13,7601,13,7601,0.549204000,1.4087
136.25.188.170,<->,56.97.186.28,13,6377,0,0,13,6377,0.450423000,1.3477
215.158.239.37,<->,215.158.127.143,13,13262,0,0,13,13262,0.441525000,1.4877
136.25.189.24,<->,100.216.78.145,13,11351,0,0,13,11351,0.416671000,1.4082
100.230.43.160,<->,50.224.72.12,0,0,13,4507,13,4507,0.404234000,0.9704
204.3.186.15,<->,136.25.188.46,0,0,13,3389,13,3389,0.392243000,1.2264
136.25.189.36,<->,96.156.169.204,13,4361,0,0,13,4361,0.359807000,1.3837
222.79.69.11,<->,215.158.239.35,0,0,13,6249,13,6249,0.331098000,1.3511
139.69.162.56,<->,8.252.222.169,0,0,13,5913,13,5913,0.267603000,1.5421
239.66.241.243,<->,97.126.113.29,0,0,13,6619,13,6619,0.258476000,1.5160
200.174.97.45,<->,53.231.93.91,13,4863,0,0,13,4863,0.256305000,1.7317
136.25.189.54,<->,96.156.169.207,13,5529,0,0,13,5529,0.216058000,1.5685
136.25.189.8,<->,96.156.169.238,13,8922,0,0,13,8922,0.212851000,1.2722
192.204.123.52,<->,136.25.189.83,0,0,13,16081,13,16081,0.207450000,1.7892
136.114.101.19,<->,136.25.188.200,0,0,13,8377,13,8377,0.205125000,1.7145
133.178.226.33,<->,100.120.38.6,13,12868,0,0,13,12868,0.198975000,1.6206
220.28.109.52,<->,136.25.188.58,0,0,13,13179,13,13179,0.198169000,1.1549
220.28.73.211,<->,215.158.238.68,0,0,13,14042,13,14042,0.188692000,0.8749
215.158.238.95,<->,33.209.217.213,13,18288,0,0,13,18288,0.186443000,1.6711
136.25.188.166,<->,111.52.91.115,13,6432,0,0,13,6432,0.150381000,1.7910
136.114.101.30,<->,136.25.188.214,0,0,13,7009,13,7009,0.136965000,1.7381
80.41.49.252,<->,22.250.210.0,13,19552,0,0,13,19552,0.135830000,1.8123
136.25.188.246,<->,100.224.202.157,13,8003,0,0,13,8003,0.128741000,1.7889
133.178.227.6,<->,133.56.180.8,13,8177,0,0,13,8177,0.125811000,1.4237
136.25.188.233,<->,56.97.186.28,13,7361,0,0,13,7361,0.113759000,1.7700
221.102.143.189,<->,220.83.124.90,0,0,13,10646,13,10646,0.092106000,1.7902
133.178.227.52,<->,133.56.180.53,13,6578,0,0,13,6578,0.086780000,1.8782
215.158.238.95,<->,145.116.209.86,13,7223,0,0,13,7223,0.081279000,1.7877
111.150.74.19,<->,99.74.26.99,0,0,13,11529,13,11529,0.072323000,1.8662
136.25.188.177,<->,29.214.108.150,13,17092,0,0,13,17092,0.069664000,1.8419
133.178.227.16,<->,133.56.180.83,13,8025,0,0,13,8025,0.060547000,1.9024
136.25.189.15,<->,126.219.194.11,13,16352,0,0,13,16352,0.059472000,1.8508
220.28.85.14,<->,215.158.238.108,0,0,13,12226,13,12226,0.056840000,1.1913
247.136.162.181,<->,136.117.43.13,13,5976,0,0,13,5976,0.056177000,1.8236
192.67.172.133,<->,144.91.199.60,13,11567,0,0,13,11567,0.055474000,1.8852
136.25.189.10,<->,96.156.169.224,13,10289,0,0,13,10289,0.054954000,1.8204
220.28.109.52,<->,136.25.188.235,0,0,13,12784,13,12784,0.053711000,1.0480
111.147.177.227,<->,53.230.16.127,13,18334,0,0,13,18334,0.052238000,0.9899
192.205.36.194,<->,136.25.188.58,0,0,13,4481,13,4481,0.049386000,1.6885
159.215.65.169,<->,136.25.188.247,0,0,13,7025,13,7025,0.046332000,0.5559
220.28.104.193,<->,215.158.238.40,0,0,13,17677,13,17677,0.044921000,0.8312
215.158.239.218,<->,33.235.161.209,13,8190,0,0,13,8190,0.032051000,1.8935
220.28.85.14,<->,133.178.227.54,0,0,13,12090,13,12090,0.030640000,1.8345
136.25.188.230,<->,96.155.60.243,13,7585,0,0,13,7585,0.028961000,1.9470
136.25.189.17,<->,96.135.155.20,13,15601,0,0,13,15601,0.027193000,1.6763
139.241.56.105,<->,100.94.59.215,0,0,13,18926,13,18926,0.026797000,1.9260
205.127.108.115,<->,33.233.141.107,0,0,13,7688,13,7688,0.025501000,1.9617
106.168.191.252,<->,102.50.246.13,0,0,13,2586,13,2586,0.019912000,1.2292
220.28.115.46,<->,215.158.140.246,0,0,13,10109,13,10109,0.019523000,1.7592
220.28.115.46,<->,133.178.226.74,0,0,13,13542,13,13542,0.015353000,0.9914
136.25.189.0,<->,96.135.155.4,13,14649,0,0,13,14649,0.013657000,1.9226
80.41.7.76,<->,8.55.208.173,13,10711,0,0,13,10711,0.012827000,0.6168
139.163.17.135,<->,102.227.77.109,13,5600,0,0,13,5600,0.004129000,1.9521
138.45.90.177,<->,136.25.188.212,0,0,13,7094,13,7094,0.002734000,1.8117
215.158.239.89,<->,139.163.161.48,13,8697,0,0,13,8697,0.000582000,0.9317
139.163.96.101,<->,105.110.16.247,13,2124,0,0,13,2124,0.000272000,1.7858
215.158.32.49,<->,8.252.222.234,0,0,12,7660,12,7660,1.859111000,0.0729
215.158.239.76,<->,194.251.125.222,12,7983,0,0,12,7983,1.558492000,0.0830
136.25.188.194,<->,111.52.91.227,12,7427,0,0,12,7427,1.036481000,0.7801
220.28.109.52,<->,136.25.188.167,0,0,12,11989,12,11989,0.791651000,0.8343
159.215.65.128,<->,136.25.188.201,0,0,12,6732,12,6732,0.631595000,1.1692
136.25.189.21,<->,96.156.169.204,12,6324,0,0,12,6324,0.617028000,1.3694
215.158.238.78,<->,100.120.38.6,12,12664,0,0,12,12664,0.559031000,1.1506
129.236.114.39,<->,101.224.89.175,0,0,12,14836,12,14836,0.532268000,1.2820
147.183.19.90,<->,8.252.221.230,0,0,12,2815,12,2815,0.481300000,1.4520
136.25.188.166,<->,111.52.91.239,12,6597,0,0,12,6597,0.472982000,1.4573
215.158.61.238,<->,8.252.222.2,0,0,12,7351,12,7351,0.471134000,1.0339
136.25.189.43,<->,96.156.169.165,12,7116,0,0,12,7116,0.451781000,1.4964
215.158.238.89,<->,100.120.38.6,12,13292,0,0,12,13292,0.402186000,0.6479
215.158.238.79,<->,98.219.126.140,12,11188,0,0,12,11188,0.391854000,1.5607
215.158.239.46,<->,100.224.202.145,12,9684,0,0,12,9684,0.373512000,1.2574
215.158.238.100,<->,0.195.253.228,12,13602,0,0,12,13602,0.339362000,0.8343
215.158.239.73,<->,133.56.180.78,12,6772,0,0,12,6772,0.327187000,1.5530
215.158.238.101,<->,0.195.237.14,12,12177,0,0,12,12177,0.303267000,0.8470
133.178.227.22,<->,133.56.180.44,12,6044,0,0,12,6044,0.291734000,1.6848
147.58.211.37,<->,8.252.221.200,0,0,12,9765,12,9765,0.286986000,1.4257
215.158.239.74,<->,56.97.186.30,12,6412,0,0,12,6412,0.278418000,1.5436
215.158.44.182,<->,136.25.189.83,0,0,12,15052,12,15052,0.272446000,1.6333
216.184.2.61,<->,8.252.222.42,0,0,12,6700,12,6700,0.271772000,1.5353
215.158.239.45,<->,56.97.186.4,12,5284,0,0,12,5284,0.257820000,0.9584
215.158.140.207,<->,124.43.95.12,12,5789,0,0,12,5789,0.255491000,1.5497
215.158.238.41,<->,98.219.126.140,12,12617,0,0,12,12617,0.252033000,1.5961
133.178.226.74,<->,133.56.180.36,12,7558,0,0,12,7558,0.221726000,1.5914
136.25.189.25,<->,96.156.169.239,12,5396,0,0,12,5396,0.217932000,1.5255
220.28.115.46,<->,215.158.238.108,0,0,12,12538,12,12538,0.202770000,0.6478
113.22.2.221,<->,100.228.42.100,0,0,12,9328,12,9328,0.201691000,1.7464
136.25.189.29,<->,133.56.180.22,12,15068,0,0,12,15068,0.194238000,1.4960
215.158.239.73,<->,192.205.36.205,12,6372,0,0,12,6372,0.182493000,1.7474
215.158.140.198,<->,144.95.111.33,12,4236,0,0,12,4236,0.181089000,1.6465
133.178.227.21,<->,133.56.180.45,12,8022,0,0,12,8022,0.176217000,1.7980
145.76.225.248,<->,80.27.157.216,0,0,12,6294,12,6294,0.169193000,1.7390
136.25.188.174,<->,126.219.194.182,12,15804,0,0,12,15804,0.157394000,1.5892
215.158.239.44,<->,8.222.48.156,12,5260,0,0,12,5260,0.155773000,1.6253
215.158.239.61,<->,56.97.186.28,12,6076,0,0,12,6076,0.151571000,1.6826
133.178.227.10,<->,133.56.180.43,12,9894,0,0,12,9894,0.127032000,1.8382
215.158.238.144,<->,0.195.253.228,12,11876,0,0,12,11876,0.123306000,1.7072
215.158.239.93,<->,142.237.129.145,12,2442,0,0,12,2442,0.121366000,0.7342
246.253.253.170,<->,159.220.151.123,12,8208,0,0,12,8208,0.113718000,1.6726
133.178.226.29,<->,111.151.239.8,12,15372,0,0,12,15372,0.103153000,1.7811
136.25.189.42,<->,96.156.169.207,12,7497,0,0,12,7497,0.096855000,1.6773
133.178.227.40,<->,133.56.180.34,12,15359,0,0,12,15359,0.091229000,1.8930
133.178.227.27,<->,133.56.180.34,12,15632,0,0,12,15632,0.081395000,1.7740
133.178.227.6,<->,100.216.78.145,12,5666,0,0,12,5666,0.072196000,1.5494
133.178.227.27,<->,8.191.7.88,12,13144,0,0,12,13144,0.068076000,1.9129
247.136.184.114,<->,132.163.66.239,12,1681,0,0,12,1681,0.065064000,1.9117
220.39.233.182,<->,215.158.238.134,0,0,12,15516,12,15516,0.064768000,1.6032
220.28.109.52,<->,136.25.188.233,0,0,12,12084,12,12084,0.054048000,1.8378
215.158.238.138,<->,0.195.253.228,12,10063,0,0,12,10063,0.043826000,1.8370
215.158.140.225,<->,100.216.78.145,12,4828,0,0,12,4828,0.039198000,1.9143
220.28.104.193,<->,215.158.238.79,0,0,12,11944,12,11944,0.038337000,1.8695
215.158.30.229,<->,8.252.222.32,0,0,12,5646,12,5646,0.034604000,1.4767
133.178.227.27,<->,133.56.180.33,12,15447,0,0,12,15447,0.033642000,1.1380
215.158.239.77,<->,8.50.171.223,12,15028,0,0,12,15028,0.030659000,1.9491
210.235.164.125,<->,97.4.43.222,12,8798,0,0,12,8798,0.026420000,0.9089
194.222.45.226,<->,99.72.129.28,0,0,12,716,12,716,0.024565000,1.7882
138.45.90.192,<->,136.25.188.168,0,0,12,6547,12,6547,0.020975000,1.7182
136.25.188.47,<->,122.159.245.149,12,15820,0,0,12,15820,0.018230000,1.9052
205.243.108.176,<->,92.27.194.136,0,0,12,1905,12,1905,0.005406000,1.6153
129.80.83.17,<->,35.56.100.21,0,0,11,1090,11,1090,1.968533000,0.0017
129.225.134.164,<->,129.225.132.97,0,0,11,5397,11,5397,1.756638000,0.2168
129.225.134.164,<->,129.225.132.80,0,0,11,5427,11,5427,1.550539000,0.1496
215.158.239.93,<->,207.61.73.223,11,3342,0,0,11,3342,1.366668000,0.3033
220.55.96.42,<->,8.222.6.181,11,16291,0,0,11,16291,1.279232000,0.0710
220.28.65.9,<->,215.158.238.131,0,0,11,11306,11,11306,1.194897000,0.5213
111.147.80.171,<->,97.85.66.113,11,1341,0,0,11,1341,1.130487000,0.0870
215.158.30.184,<->,8.252.222.57,0,0,11,6281,11,6281,1.122965000,0.5146
215.158.238.103,<->,100.120.38.6,11,10120,0,0,11,10120,1.110476000,0.4994
143.119.40.233,<->,8.182.241.177,0,0,11,4966,11,4966,1.101634000,0.6816
8.182.244.19,<->,6.21.254.254,11,4571,0,0,11,4571,0.965150000,0.3763
220.28.109.52,<->,136.25.188.50,0,0,11,8895,11,8895,0.918447000,0.9108
99.187.125.122,<->,8.20.87.3,0,0,11,12434,11,12434,0.610465000,0.0431
136.25.188.234,<->,106.188.183.102,11,4799,0,0,11,4799,0.586947000,0.5305
215.158.239.83,<->,98.219.126.140,11,9409,0,0,11,9409,0.528742000,1.3883
220.28.85.14,<->,215.158.140.80,0,0,11,9923,11,9923,0.511978000,1.3751
136.25.189.84,<->,56.28.207.191,11,5655,0,0,11,5655,0.501776000,1.4351
215.158.239.195,<->,80.31.246.206,11,2827,0,0,11,2827,0.476655000,1.4996
133.178.227.60,<->,133.56.180.1,11,8235,0,0,11,8235,0.467633000,1.3858
136.25.189.7,<->,96.156.169.204,11,5943,0,0,11,5943,0.400115000,1.5896
215.158.238.147,<->,98.219.126.140,11,10368,0,0,11,10368,0.382470000,1.0687
195.41.112.6,<->,136.25.188.227,0,0,11,2823,11,2823,0.339242000,0.0524
215.158.238.97,<->,80.47.111.25,11,14255,0,0,11,14255,0.318032000,1.5209
215.158.239.49,<->,145.13.164.183,11,14399,0,0,11,14399,0.316085000,1.6347
220.28.115.46,<->,215.158.238.103,0,0,11,7224,11,7224,0.297686000,1.0378
133.178.226.226,<->,8.254.21.53,11,14276,0,0,11,14276,0.294465000,1.6714
215.158.140.201,<->,100.224.132.154,11,14088,0,0,11,14088,0.290821000,0.1318
145.182.137.223,<->,136.25.188.41,0,0,11,9853,11,9853,0.284843000,0.1903
136.25.189.7,<->,96.156.169.207,11,5655,0,0,11,5655,0.270859000,1.6521
215.158.61.195,<->,8.176.8.89,0,0,11,6319,11,6319,0.248447000,1.6273
220.28.114.28,<->,215.158.238.253,0,0,11,9673,11,9673,0.243574000,1.0416
205.127.108.113,<->,101.224.89.159,0,0,11,7713,11,7713,0.243229000,1.2552
136.25.188.160,<->,8.42.43.23,11,14239,0,0,11,14239,0.222801000,1.7768
215.158.6.147,<->,8.252.222.212,0,0,11,11453,11,11453,0.216286000,1.4789
215.158.238.81,<->,8.42.43.86,11,14591,0,0,11,14591,0.206246000,1.7325
136.25.189.26,<->,96.156.169.218,11,4287,0,0,11,4287,0.203055000,1.7497
133.178.227.23,<->,133.56.180.25,11,6095,0,0,11,6095,0.197729000,1.6636
215.158.239.44,<->,100.224.167.70,11,6143,0,0,11,6143,0.196788000,1.7165
133.178.226.66,<->,98.219.126.140,11,6736,0,0,11,6736,0.193933000,1.2592
133.178.226.43,<->,96.155.60.252,11,5561,0,0,11,5561,0.183128000,1.2661
136.25.188.167,<->,100.224.166.122,11,7856,0,0,11,7856,0.183007000,1.6106
247.136.131.134,<->,144.91.199.50,11,5714,0,0,11,5714,0.179594000,1.6496
139.241.56.117,<->,98.129.89.174,0,0,11,14616,11,14616,0.177518000,1.8101
247.136.130.205,<->,144.91.199.50,11,8331,0,0,11,8331,0.177278000,1.6517
215.158.6.147,<->,8.252.222.249,0,0,11,7824,11,7824,0.175340000,1.5249
194.253.80.60,<->,8.252.222.206,0,0,11,1827,11,1827,0.170940000,1.6759
136.25.189.30,<->,133.56.180.57,11,13383,0,0,11,13383,0.164383000,1.5318
215.158.61.183,<->,8.176.8.176,0,0,11,7462,11,7462,0.161117000,1.7709
220.39.233.182,<->,215.158.238.66,0,0,11,14623,11,14623,0.151889000,1.8180
210.156.69.212,<->,202.227.161.108,11,16038,0,0,11,16038,0.147958000,1.6354
133.178.227.79,<->,133.56.180.11,11,12124,0,0,11,12124,0.147192000,1.7842
215.158.238.194,<->,98.219.126.175,11,11313,0,0,11,11313,0.140739000,1.8214
139.36.119.72,<->,8.176.8.80,0,0,11,9383,11,9383,0.119455000,0.5712
136.25.189.78,<->,96.135.155.12,11,14639,0,0,11,14639,0.110921000,1.7269
136.25.188.245,<->,56.97.186.148,11,9062,0,0,11,9062,0.110884000,0.7638
215.158.238.83,<->,8.42.43.86,11,13063,0,0,11,13063,0.109397000,1.8277
136.25.188.175,<->,131.1.195.231,11,14236,0,0,11,14236,0.106607000,1.7361
215.158.239.70,<->,126.219.194.40,11,14348,0,0,11,14348,0.106434000,1.6079
139.36.120.125,<->,99.74.26.158,0,0,11,7055,11,7055,0.106001000,1.8306
136.25.188.229,<->,96.155.60.196,11,6623,0,0,11,6623,0.095394000,1.7339
232.31.30.241,<->,100.94.156.86,0,0,11,11208,11,11208,0.089088000,1.8740
133.178.227.40,<->,133.56.180.32,11,13978,0,0,11,13978,0.087360000,1.6347
136.25.188.230,<->,96.155.60.252,11,8615,0,0,11,8615,0.083411000,1.6221
216.184.1.125,<->,8.252.222.170,0,0,11,9339,11,9339,0.079960000,1.4883
93.236.5.150,<->,35.56.99.76,0,0,11,5824,11,5824,0.075484000,1.5452
220.28.114.28,<->,133.178.227.29,0,0,11,7730,11,7730,0.074275000,1.2474
133.178.226.25,<->,96.155.60.205,11,11129,0,0,11,11129,0.073962000,1.4627
205.127.108.115,<->,111.20.168.209,0,0,11,6307,11,6307,0.072210000,1.8824
215.158.239.69,<->,96.156.169.223,11,12175,0,0,11,12175,0.071899000,1.8293
215.158.239.45,<->,192.205.36.214,11,5935,0,0,11,5935,0.062531000,1.8963
215.158.30.219,<->,8.252.222.42,0,0,11,5272,11,5272,0.059574000,0.9657
136.25.189.84,<->,96.156.169.173,11,6591,0,0,11,6591,0.056234000,1.8445
109.206.167.116,<->,50.224.92.97,0,0,11,956,11,956,0.049569000,1.1359
215.158.239.73,<->,97.174.232.166,11,4143,0,0,11,4143,0.044558000,1.9374
192.65.71.62,<->,139.241.56.102,11,14616,0,0,11,14616,0.042472000,1.9284
195.89.52.197,<->,8.252.222.220,0,0,11,1111,11,1111,0.036247000,1.8618
205.127.108.115,<->,33.233.141.116,0,0,11,7489,11,7489,0.026393000,1.9638
133.178.227.4,<->,133.56.180.77,11,5279,0,0,11,5279,0.026004000,1.9363
215.158.239.78,<->,145.13.164.170,11,14016,0,0,11,14016,0.014675000,1.9751
133.178.227.8,<->,133.56.180.53,11,5280,0,0,11,5280,0.013824000,1.9593
136.25.188.195,<->,97.174.232.254,11,6519,0,0,11,6519,0.012285000,1.2670
215.158.239.87,<->,96.135.155.13,11,14479,0,0,11,14479,0.007959000,1.6723
205.127.108.115,<->,101.224.89.252,0,0,11,5786,11,5786,0.006786000,1.7928
203.214.74.80,<->,8.37.252.35,11,9554,0,0,11,9554,0.000300000,1.6826
144.75.218.248,<->,53.231.66.30,10,7395,0,0,10,7395,1.556649000,0.4399
215.158.239.205,<->,113.23.83.65,10,7856,0,0,10,7856,1.407958000,0.3114
215.158.239.63,<->,159.215.65.152,10,5698,0,0,10,5698,1.395158000,0.5661
255.29.205.169,<->,80.41.46.174,0,0,10,2318,10,2318,1.346168000,0.4839
220.28.108.254,<->,215.158.238.90,0,0,10,10071,10,10071,1.281085000,0.7087
220.28.104.193,<->,133.178.227.39,0,0,10,10667,10,10667,1.268737000,0.4676
136.25.188.238,<->,41.60.116.4,10,2309,0,0,10,2309,1.241477000,0.0408
207.92.55.136,<->,8.252.222.39,0,0,10,4252,10,4252,1.192980000,0.5603
215.158.127.19,<->,8.176.8.110,0,0,10,4164,10,4164,1.171298000,0.7212
138.45.90.244,<->,136.25.188.202,0,0,10,5130,10,5130,1.135262000,0.6963
53.231.94.186,<->,33.233.141.19,0,0,10,5108,10,5108,1.035362000,0.9159
215.158.238.194,<->,215.158.43.2,10,10417,0,0,10,10417,0.870459000,0.0873
136.114.101.37,<->,136.25.188.51,0,0,10,3890,10,3890,0.855965000,0.5706
136.25.188.255,<->,100.224.202.155,10,2043,0,0,10,2043,0.832476000,1.1600
207.188.255.22,<->,136.25.188.55,0,0,10,2696,10,2696,0.808291000,0.4489
220.38.163.255,<->,215.158.140.216,0,0,10,13636,10,13636,0.785563000,0.1815
240.207.22.74,<->,0.195.210.44,0,0,10,2497,10,2497,0.744515000,0.5162
218.111.223.222,<->,8.220.176.253,0,0,10,2834,10,2834,0.672536000,1.0097
142.206.163.206,<->,136.25.188.252,0,0,10,2696,10,2696,0.667098000,1.0519
215.158.44.201,<->,136.25.189.15,0,0,10,9530,10,9530,0.638990000,1.2252
141.163.50.125,<->,8.252.222.28,0,0,10,3004,10,3004,0.631343000,1.1690
215.158.239.87,<->,207.213.143.199,10,4771,0,0,10,4771,0.617565000,1.1192
215.158.30.229,<->,136.25.188.244,0,0,10,5827,10,5827,0.608848000,0.6123
136.25.189.39,<->,96.156.169.196,10,5146,0,0,10,5146,0.530795000,1.2382
215.158.239.36,<->,96.135.154.158,10,9723,0,0,10,9723,0.523814000,1.2980
215.158.49.86,<->,136.116.28.234,0,0,10,12372,10,12372,0.495434000,0.0454
220.28.65.9,<->,215.158.238.111,0,0,10,9588,10,9588,0.483654000,0.7573
136.25.188.49,<->,100.224.202.157,10,9417,0,0,10,9417,0.469066000,1.3765
216.184.1.109,<->,136.25.188.201,0,0,10,4177,10,4177,0.462146000,0.3001
192.205.36.215,<->,136.25.188.164,0,0,10,6330,10,6330,0.458708000,1.4178
133.178.226.77,<->,126.219.194.143,10,12770,0,0,10,12770,0.444634000,1.3286
133.178.226.167,<->,100.120.38.6,10,7828,0,0,10,7828,0.443853000,0.3489
220.39.233.200,<->,136.25.188.208,0,0,10,13474,10,13474,0.443425000,1.5000
215.158.239.74,<->,8.222.48.156,10,6146,0,0,10,6146,0.428503000,1.3111
220.28.85.14,<->,133.178.226.72,0,0,10,6397,10,6397,0.428399000,1.5630
198.206.21.236,<->,100.93.217.200,0,0,10,6247,10,6247,0.424695000,1.5535
136.25.189.38,<->,96.156.169.167,10,6882,0,0,10,6882,0.385121000,1.3816
8.252.221.197,<->,4.123.45.57,10,5419,0,0,10,5419,0.378627000,1.5753
215.158.239.75,<->,8.222.48.162,10,5434,0,0,10,5434,0.346016000,1.5694
215.158.239.55,<->,192.205.36.215,10,6178,0,0,10,6178,0.344892000,0.9413
215.158.238.98,<->,131.1.195.249,10,13822,0,0,10,13822,0.337056000,1.6431
223.114.203.219,<->,8.252.222.174,0,0,10,3796,10,3796,0.329586000,1.4692
215.158.44.193,<->,136.25.189.13,0,0,10,11850,10,11850,0.321097000,1.5666
69.243.74.39,<->,8.252.221.236,0,0,10,3683,10,3683,0.297559000,1.3014
192.204.123.39,<->,136.25.189.83,0,0,10,11770,10,11770,0.297510000,1.5459
136.25.188.242,<->,8.222.7.25,10,12626,0,0,10,12626,0.294154000,1.5779
101.87.213.152,<->,100.228.42.117,0,0,10,6442,10,6442,0.290577000,1.5827
133.178.227.16,<->,133.56.180.33,10,13150,0,0,10,13150,0.281695000,1.4066
215.158.239.75,<->,138.45.90.195,10,6634,0,0,10,6634,0.272346000,1.3912
207.21.165.50,<->,8.252.222.176,0,0,10,1752,10,1752,0.239032000,0.8382
133.178.227.29,<->,100.216.78.145,10,7770,0,0,10,7770,0.236899000,1.7212
136.25.189.25,<->,96.156.169.167,10,6402,0,0,10,6402,0.236724000,1.4957
220.28.108.254,<->,136.25.188.195,0,0,10,10667,10,10667,0.231398000,1.3105
215.158.61.182,<->,8.176.8.224,0,0,10,8516,10,8516,0.228201000,1.5554
215.158.239.75,<->,100.216.78.145,10,8499,0,0,10,8499,0.219538000,1.3456
19.195.169.123,<->,8.20.87.144,0,0,10,4472,10,4472,0.218557000,0.5931
215.158.239.196,<->,8.33.227.54,10,12830,0,0,10,12830,0.208124000,0.0771
215.158.239.89,<->,98.219.126.140,10,7405,0,0,10,7405,0.201360000,0.7494
193.34.14.255,<->,111.147.113.114,0,0,10,6920,10,6920,0.198720000,1.8008
129.92.117.26,<->,53.239.138.161,10,2435,0,0,10,2435,0.198181000,0.1700
109.222.223.196,<->,98.197.184.11,10,1875,0,0,10,1875,0.190723000,0.9547
215.158.238.47,<->,145.116.209.88,10,5088,0,0,10,5088,0.184877000,1.8137
136.25.189.30,<->,29.212.180.224,10,12834,0,0,10,12834,0.182740000,1.8148
215.158.239.67,<->,136.114.101.86,10,5506,0,0,10,5506,0.170231000,1.7407
133.178.226.41,<->,96.155.60.252,10,5842,0,0,10,5842,0.164194000,1.7747
247.136.134.84,<->,22.249.49.193,10,15040,0,0,10,15040,0.163443000,1.7143
215.158.195.21,<->,53.231.227.65,10,7326,0,0,10,7326,0.157465000,0.3135
111.150.74.14,<->,99.74.26.99,0,0,10,9250,10,9250,0.156489000,1.7526
133.178.227.14,<->,133.56.180.23,10,10552,0,0,10,10552,0.153560000,1.7020
138.45.90.179,<->,136.25.188.235,0,0,10,7146,10,7146,0.151508000,1.4069
215.158.239.76,<->,199.20.30.150,10,4428,0,0,10,4428,0.145232000,1.0887
220.39.233.187,<->,133.178.226.90,0,0,10,12690,10,12690,0.136773000,1.8123
136.25.189.78,<->,80.56.79.105,10,13006,0,0,10,13006,0.119157000,1.4870
215.158.239.92,<->,145.13.164.209,10,10306,0,0,10,10306,0.110983000,1.4150
133.178.226.66,<->,133.56.180.1,10,6241,0,0,10,6241,0.110559000,1.7683
246.253.134.201,<->,148.99.224.201,10,5204,0,0,10,5204,0.110243000,1.2954
136.25.188.221,<->,8.222.212.20,10,12626,0,0,10,12626,0.108684000,1.5586
246.253.253.215,<->,207.205.106.161,10,1210,0,0,10,1210,0.106363000,1.8456
215.158.238.64,<->,126.219.194.148,10,12514,0,0,10,12514,0.106145000,1.7908
215.158.238.70,<->,98.219.126.175,10,8292,0,0,10,8292,0.102841000,0.8811
139.241.56.117,<->,100.92.28.107,0,0,10,13160,10,13160,0.096585000,1.8573
133.178.227.24,<->,133.56.180.22,10,8610,0,0,10,8610,0.095468000,1.8203
136.25.188.169,<->,96.155.61.44,10,6314,0,0,10,6314,0.087007000,1.8387
215.158.239.36,<->,96.135.154.122,10,9526,0,0,10,9526,0.086658000,1.9102
223.138.187.12,<->,89.183.104.242,0,0,10,11916,10,11916,0.085502000,1.7559
215.158.238.130,<->,0.195.237.14,10,10543,0,0,10,10543,0.081815000,1.7868
136.25.188.38,<->,56.19.241.69,10,7157,0,0,10,7157,0.078482000,1.5968
136.25.189.93,<->,98.219.126.140,10,4573,0,0,10,4573,0.076299000,1.8312
215.158.239.205,<->,50.239.8.3,10,7900,0,0,10,7900,0.071506000,0.9508
249.101.217.108,<->,193.34.14.177,10,6920,0,0,10,6920,0.069809000,1.7994
133.178.226.31,<->,57.160.181.228,10,12978,0,0,10,12978,0.063154000,1.8620
136.25.189.24,<->,96.156.169.218,10,7258,0,0,10,7258,0.059922000,1.0847
133.178.226.84,<->,96.155.60.211,10,7756,0,0,10,7756,0.057265000,1.1280
215.158.238.215,<->,100.216.78.145,10,4406,0,0,10,4406,0.056085000,1.8278
210.221.107.50,<->,8.37.242.166,10,4910,0,0,10,4910,0.055810000,1.7865
92.27.219.134,<->,33.57.74.161,10,3236,0,0,10,3236,0.051836000,0.6673
133.178.226.7,<->,8.222.7.23,10,13074,0,0,10,13074,0.042813000,1.8733
136.25.189.41,<->,96.156.169.208,10,7682,0,0,10,7682,0.037384000,1.9250
220.28.109.52,<->,136.25.188.49,0,0,10,8054,10,8054,0.034523000,1.8091
139.241.56.104,<->,80.42.215.104,0,0,10,14560,10,14560,0.034395000,1.6803
215.158.58.168,<->,6.73.247.121,0,0,10,3069,10,3069,0.031196000,1.9470
133.178.227.45,<->,133.56.180.25,10,5410,0,0,10,5410,0.028792000,1.9417
215.158.140.57,<->,100.216.78.145,10,5334,0,0,10,5334,0.027230000,1.9053
215.158.44.194,<->,136.25.189.59,0,0,10,12834,10,12834,0.025072000,1.8521
136.25.189.62,<->,96.156.169.251,10,5698,0,0,10,5698,0.019390000,1.9365
136.25.188.57,<->,96.155.61.30,10,4858,0,0,10,4858,0.019273000,1.6825
193.34.14.170,<->,80.40.56.251,0,0,10,9680,10,9680,0.014746000,1.8014
205.243.108.184,<->,89.183.107.67,0,0,10,1451,10,1451,0.014288000,1.5610
139.241.56.117,<->,99.75.98.129,0,0,10,13160,10,13160,0.013289000,1.8587
215.158.239.59,<->,80.56.79.21,10,12722,0,0,10,12722,0.011484000,1.7710
192.64.252.249,<->,139.241.56.102,10,13160,0,0,10,13160,0.010877000,1.8593
247.136.245.5,<->,125.34.158.127,10,7925,0,0,10,7925,0.004659000,1.8923
220.28.115.46,<->,133.178.227.22,0,0,10,6093,10,6093,0.004034000,1.8221
128.158.165.112,<->,0.195.210.42,0,0,9,2027,9,2027,1.763358000,0.0096
221.102.56.46,<->,98.128.228.57,0,0,9,3138,9,3138,1.543821000,0.3194
144.253.54.6,<->,136.25.189.95,0,0,9,11248,9,11248,1.464270000,0.0008
197.161.251.39,<->,136.25.188.178,0,0,9,2380,9,2380,1.372411000,0.1230
216.184.1.82,<->,136.25.188.201,0,0,9,6799,9,6799,1.342473000,0.6156
195.42.123.47,<->,136.25.188.54,0,0,9,1888,9,1888,1.272416000,0.7233
220.28.104.193,<->,215.158.238.131,0,0,9,7473,9,7473,1.269026000,0.6989
101.87.213.136,<->,100.228.42.117,0,0,9,2861,9,2861,1.235284000,0.6875
136.25.189.86,<->,96.156.169.226,9,6701,0,0,9,6701,1.213330000,0.7294
215.158.239.51,<->,194.237.112.226,9,1795,0,0,9,1795,1.154128000,0.2042
252.98.139.157,<->,137.39.55.59,9,2772,0,0,9,2772,1.050328000,0.6346
213.191.193.86,<->,133.32.39.40,0,0,9,848,9,848,0.973642000,0.8920
215.158.239.48,<->,143.42.77.148,9,2192,0,0,9,2192,0.904651000,0.9389
133.178.226.77,<->,96.155.60.247,9,3254,0,0,9,3254,0.845640000,1.0590
133.32.39.45,<->,83.225.157.222,9,515,0,0,9,515,0.836995000,0.6027
216.184.1.112,<->,8.252.222.170,0,0,9,4236,9,4236,0.833747000,0.6860
220.28.108.254,<->,215.158.238.193,0,0,9,9540,9,9540,0.811694000,1.0860
220.28.115.46,<->,133.178.227.60,0,0,9,8374,9,8374,0.794060000,0.7246
100.230.151.30,<->,80.27.157.131,0,0,9,3361,9,3361,0.792203000,0.2473
136.25.188.203,<->,56.23.171.36,9,5261,0,0,9,5261,0.730240000,1.0553
220.28.114.28,<->,133.178.226.74,0,0,9,10016,9,10016,0.694941000,0.2308
221.102.143.189,<->,213.38.214.143,0,0,9,7226,9,7226,0.663304000,0.3848
100.123.0.59,<->,92.162.253.130,0,0,9,8558,9,8558,0.651757000,0.0240
136.114.101.44,<->,136.25.188.58,0,0,9,5853,9,5853,0.622849000,1.1968
215.158.238.87,<->,100.120.38.6,9,8812,0,0,9,8812,0.585568000,0.5583
133.178.226.93,<->,100.120.38.6,9,7679,0,0,9,7679,0.583634000,0.2218
215.158.239.90,<->,145.116.209.92,9,6047,0,0,9,6047,0.572517000,0.6638
136.177.72.3,<->,92.162.253.154,0,0,9,3885,9,3885,0.554749000,0.9808
215.158.238.82,<->,91.57.173.10,9,11589,0,0,9,11589,0.547356000,1.3379
133.178.226.41,<->,96.155.60.211,9,5847,0,0,9,5847,0.513923000,1.4005
136.25.188.194,<->,80.57.141.205,9,8681,0,0,9,8681,0.506562000,1.1918
136.25.188.219,<->,96.155.61.30,9,4517,0,0,9,4517,0.501974000,1.3264
215.158.61.193,<->,136.25.188.41,0,0,9,6815,9,6815,0.499260000,1.4515
145.242.124.39,<->,102.51.175.212,0,0,9,3939,9,3939,0.475385000,0.1470
204.200.43.11,<->,136.25.188.226,0,0,9,3042,9,3042,0.474130000,1.4002
136.25.188.244,<->,100.224.138.230,9,3757,0,0,9,3757,0.469277000,1.4789
136.25.189.77,<->,96.156.169.212,9,12309,0,0,9,12309,0.469168000,1.4668
53.231.66.9,<->,33.233.141.61,0,0,9,6532,9,6532,0.463416000,1.4713
220.28.115.46,<->,215.158.238.131,0,0,9,7992,9,7992,0.451044000,0.4683
136.25.189.40,<->,96.156.169.199,9,4005,0,0,9,4005,0.448107000,1.3940
215.158.61.237,<->,8.252.222.251,0,0,9,10430,9,10430,0.429813000,0.8474
133.178.227.76,<->,133.56.180.48,9,8653,0,0,9,8653,0.417457000,1.4864
215.158.239.62,<->,100.216.78.145,9,8946,0,0,9,8946,0.414727000,0.8844
192.65.40.50,<->,8.55.224.156,9,5677,0,0,9,5677,0.413655000,0.5465
215.158.61.191,<->,8.176.8.232,0,0,9,8350,9,8350,0.405767000,1.1655
142.248.178.25,<->,136.25.188.220,0,0,9,2180,9,2180,0.403239000,1.3093
142.227.70.185,<->,136.25.188.55,0,0,9,2228,9,2228,0.395612000,1.4149
139.241.56.117,<->,102.50.62.113,0,0,9,11705,9,11705,0.394754000,1.5015
215.158.239.40,<->,215.158.127.181,9,8055,0,0,9,8055,0.390638000,1.4037
215.158.238.38,<->,192.224.20.69,9,6298,0,0,9,6298,0.376100000,1.5186
136.25.189.15,<->,29.212.198.189,9,11685,0,0,9,11685,0.358835000,1.5272
136.25.188.243,<->,72.34.26.103,9,1829,0,0,9,1829,0.353883000,1.1102
136.25.189.62,<->,96.156.169.237,9,5341,0,0,9,5341,0.350492000,1.3454
136.25.188.198,<->,29.214.108.122,9,11290,0,0,9,11290,0.346721000,1.6287
136.25.188.231,<->,56.28.207.204,9,4717,0,0,9,4717,0.336312000,1.1768
136.25.188.244,<->,96.156.169.204,9,6629,0,0,9,6629,0.329782000,1.3208
207.221.197.178,<->,92.27.219.54,0,0,9,518,9,518,0.327011000,1.4289
137.137.105.184,<->,98.87.187.248,9,4423,0,0,9,4423,0.314769000,1.2877
220.60.81.134,<->,136.25.189.1,0,0,9,11829,9,11829,0.305309000,1.5981
220.28.108.254,<->,215.158.238.233,0,0,9,8268,9,8268,0.293948000,1.2858
136.25.188.239,<->,8.222.7.23,9,11205,0,0,9,11205,0.293597000,1.6086
215.158.239.65,<->,96.155.60.206,9,7413,0,0,9,7413,0.287650000,1.3755
136.25.188.220,<->,131.1.195.247,9,9951,0,0,9,9951,0.285313000,1.6010
133.178.227.16,<->,133.56.180.47,9,9701,0,0,9,9701,0.270487000,1.5056
215.158.239.91,<->,8.222.48.142,9,5205,0,0,9,5205,0.266708000,1.6948
216.184.2.182,<->,136.25.189.15,0,0,9,11861,9,11861,0.263009000,1.3774
136.25.188.177,<->,33.209.217.213,9,12597,0,0,9,12597,0.262524000,1.7039
133.178.227.16,<->,8.191.7.221,9,9866,0,0,9,9866,0.256819000,1.7192
145.13.164.203,<->,136.25.189.45,0,0,9,10189,9,10189,0.255882000,1.6621
215.158.3.219,<->,99.74.26.100,0,0,9,5831,9,5831,0.254608000,1.5242
215.158.61.182,<->,8.176.8.242,0,0,9,5595,9,5595,0.252388000,1.4429
215.158.238.115,<->,80.47.111.106,9,11397,0,0,9,11397,0.252206000,1.5961
192.205.36.227,<->,136.25.188.166,0,0,9,4685,9,4685,0.244089000,1.2187
215.158.239.59,<->,126.219.194.5,9,11397,0,0,9,11397,0.242518000,1.5329
220.28.85.14,<->,215.158.140.95,0,0,9,7966,9,7966,0.241062000,1.7527
220.60.81.139,<->,136.25.189.1,0,0,9,9157,9,9157,0.236508000,1.3819
92.162.253.147,<->,42.105.214.217,9,13536,0,0,9,13536,0.232415000,1.4720
111.150.74.72,<->,99.74.26.99,0,0,9,4757,9,4757,0.227160000,1.7567
215.158.2.115,<->,8.176.8.71,0,0,9,3557,9,3557,0.219645000,1.3937
195.40.208.207,<->,136.25.188.236,0,0,9,2783,9,2783,0.212922000,1.7098
215.158.61.182,<->,136.25.189.222,0,0,9,5486,9,5486,0.205399000,1.7241
136.25.189.1,<->,29.211.228.197,9,10765,0,0,9,10765,0.202621000,0.9396
136.25.189.20,<->,96.156.169.239,9,5557,0,0,9,5557,0.190863000,1.2936
133.178.226.21,<->,96.155.60.254,9,6317,0,0,9,6317,0.187636000,1.5022
215.158.239.76,<->,215.158.44.185,9,11621,0,0,9,11621,0.184412000,1.8110
133.178.226.41,<->,96.155.60.205,9,5861,0,0,9,5861,0.175729000,1.6885
136.25.188.201,<->,96.155.60.255,9,4941,0,0,9,4941,0.175135000,1.6289
215.158.30.165,<->,8.252.222.155,0,0,9,5253,9,5253,0.172488000,1.4577
133.178.227.16,<->,133.56.180.22,9,9685,0,0,9,9685,0.167704000,1.7979
105.122.175.61,<->,6.122.200.225,0,0,9,8368,9,8368,0.167297000,1.8169
215.158.3.188,<->,133.178.227.138,0,0,9,6570,9,6570,0.166445000,1.4545
133.178.226.55,<->,96.155.60.254,9,7587,0,0,9,7587,0.165223000,0.9770
215.158.30.238,<->,8.252.222.57,0,0,9,4161,9,4161,0.159175000,1.8000
136.25.189.28,<->,126.219.194.17,9,11269,0,0,9,11269,0.157430000,1.7930
221.101.9.15,<->,144.87.238.89,9,2529,0,0,9,2529,0.153903000,1.4041
215.158.239.3,<->,215.158.58.200,9,8852,0,0,9,8852,0.151812000,1.4021
199.32.229.83,<->,136.25.188.46,0,0,9,2212,9,2212,0.147828000,1.2869
215.158.127.59,<->,8.176.8.182,0,0,9,5532,9,5532,0.146848000,1.7431
215.158.238.241,<->,8.240.116.237,9,9745,0,0,9,9745,0.146243000,1.4683
222.78.57.246,<->,8.20.81.41,9,6394,0,0,9,6394,0.143971000,0.3838
215.158.238.73,<->,33.209.217.201,9,12394,0,0,9,12394,0.142481000,1.7327
220.28.73.211,<->,133.178.226.75,0,0,9,4572,9,4572,0.139907000,1.4594
215.158.239.95,<->,204.226.109.183,9,4045,0,0,9,4045,0.139679000,0.3085
133.178.227.60,<->,133.56.180.75,9,4552,0,0,9,4552,0.139075000,1.6601
215.158.239.237,<->,136.158.73.44,9,2214,0,0,9,2214,0.138393000,1.6865
136.25.189.77,<->,126.219.194.11,9,12305,0,0,9,12305,0.132084000,1.7311
136.25.188.211,<->,100.224.202.188,9,5203,0,0,9,5203,0.130771000,1.7745
133.178.227.14,<->,133.56.180.24,9,11643,0,0,9,11643,0.127624000,1.7471
215.158.238.40,<->,0.195.237.14,9,8539,0,0,9,8539,0.127176000,1.0276
215.158.238.133,<->,197.125.126.182,9,11541,0,0,9,11541,0.126486000,1.7434
231.143.109.135,<->,136.25.188.255,0,0,9,1305,9,1305,0.126404000,0.7903
220.28.65.9,<->,215.158.238.233,0,0,9,7935,9,7935,0.125341000,1.5180
136.25.189.39,<->,96.156.169.208,9,4989,0,0,9,4989,0.124380000,1.6313
136.25.188.249,<->,80.57.208.50,9,5517,0,0,9,5517,0.121535000,0.5455
133.178.226.61,<->,8.222.212.1,9,11717,0,0,9,11717,0.121119000,1.8408
215.158.239.94,<->,96.135.155.29,9,10317,0,0,9,10317,0.119673000,1.8684
220.28.114.28,<->,133.178.226.67,0,0,9,4835,9,4835,0.119554000,1.6480
215.158.239.227,<->,53.191.179.79,9,9437,0,0,9,9437,0.115556000,1.8698
215.158.239.61,<->,56.97.186.150,9,5244,0,0,9,5244,0.114351000,1.4941
139.241.56.102,<->,98.128.108.168,0,0,9,12887,9,12887,0.111610000,1.8599
220.28.85.14,<->,215.158.239.53,0,0,9,10416,9,10416,0.111282000,1.8807
136.25.189.94,<->,96.156.169.209,9,6253,0,0,9,6253,0.109200000,1.7095
215.158.239.76,<->,195.55.36.24,9,4437,0,0,9,4437,0.103599000,1.6341
136.25.189.5,<->,96.156.169.197,9,6077,0,0,9,6077,0.101169000,1.3970
136.25.189.6,<->,96.156.169.209,9,2629,0,0,9,2629,0.099153000,1.8347
220.28.114.28,<->,215.158.239.90,0,0,9,8596,9,8596,0.096808000,1.8703
145.13.164.182,<->,136.25.189.59,0,0,9,11445,9,11445,0.096696000,1.7252
133.178.226.18,<->,8.222.7.15,9,10317,0,0,9,10317,0.095977000,1.7259
192.65.150.36,<->,139.241.56.117,9,13103,0,0,9,13103,0.094618000,1.8573
216.184.1.124,<->,8.252.222.27,0,0,9,3904,9,3904,0.094157000,0.9320
111.147.160.213,<->,33.250.6.41,9,4353,0,0,9,4353,0.089159000,1.8345
215.158.239.66,<->,56.97.186.7,9,4733,0,0,9,4733,0.088549000,1.3881
215.158.239.76,<->,199.20.31.1,9,1751,0,0,9,1751,0.086553000,0.7096
205.127.108.113,<->,33.233.141.16,0,0,9,4857,9,4857,0.085129000,1.7281
133.178.226.90,<->,122.158.245.145,9,11605,0,0,9,11605,0.084774000,1.6987
136.25.189.55,<->,56.28.207.196,9,4253,0,0,9,4253,0.072744000,1.7238
146.15.20.243,<->,80.27.158.180,0,0,9,6338,9,6338,0.070618000,1.8203
159.162.41.250,<->,8.182.251.42,0,0,9,4086,9,4086,0.053880000,1.8895
133.178.226.72,<->,133.56.180.35,9,4220,0,0,9,4220,0.053466000,1.5800
215.158.238.130,<->,98.219.126.140,9,8301,0,0,9,8301,0.051999000,1.5061
215.158.238.64,<->,29.211.6.17,9,11493,0,0,9,11493,0.050484000,1.9478
215.158.30.219,<->,136.25.188.51,0,0,9,5212,9,5212,0.049567000,1.5395
136.25.189.39,<->,98.219.126.175,9,7028,0,0,9,7028,0.048670000,1.8972
215.158.238.142,<->,33.209.217.230,9,10120,0,0,9,10120,0.048055000,1.5167
254.64.119.99,<->,92.27.219.243,0,0,9,1008,9,1008,0.047999000,1.7507
136.25.188.163,<->,29.214.108.159,9,11473,0,0,9,11473,0.047619000,1.5617
239.227.67.235,<->,221.102.56.29,9,6664,0,0,9,6664,0.046752000,1.8786
220.28.108.254,<->,215.158.238.118,0,0,9,9007,9,9007,0.046341000,0.3075
68.73.105.222,<->,8.252.221.236,0,0,9,3525,9,3525,0.043080000,1.6301
139.241.56.117,<->,6.138.226.73,0,0,9,665,9,665,0.041548000,1.8413
139.241.56.116,<->,100.95.6.205,0,0,9,13103,9,13103,0.041520000,1.8413
215.158.238.87,<->,98.219.126.140,9,7893,0,0,9,7893,0.040627000,1.8132
145.13.164.247,<->,136.25.189.0,0,0,9,11653,9,11653,0.039733000,1.9555
215.158.61.191,<->,8.176.8.197,0,0,9,6222,9,6222,0.034337000,1.8872
106.163.116.4,<->,89.183.104.227,0,0,9,1368,9,1368,0.025001000,1.7482
215.158.238.83,<->,104.3.163.38,9,11381,0,0,9,11381,0.024369000,1.9551
207.62.191.87,<->,136.25.188.177,0,0,9,2728,9,2728,0.022193000,1.1398
120.171.208.194,<->,35.56.98.220,0,0,9,1224,9,1224,0.020147000,1.5395
133.178.227.10,<->,133.56.180.2,9,6455,0,0,9,6455,0.017805000,1.2593
138.45.90.152,<->,136.25.188.201,0,0,9,6549,9,6549,0.016982000,1.7765
215.158.238.251,<->,8.191.7.104,9,11461,0,0,9,11461,0.014570000,1.9394
139.241.56.117,<->,80.41.8.158,0,0,9,13103,9,13103,0.012204000,1.8588
248.225.27.2,<->,53.231.73.29,9,13284,0,0,9,13284,0.011732000,1.8551
99.187.125.151,<->,8.20.87.11,0,0,9,11260,9,11260,0.006570000,1.4822
139.36.120.120,<->,8.176.8.80,0,0,9,4349,9,4349,0.005251000,1.3547
215.158.239.94,<->,199.20.63.99,9,3414,0,0,9,3414,0.004896000,1.7692
136.25.188.225,<->,26.253.227.124,8,1826,0,0,8,1826,1.818292000,0.1215
215.158.239.79,<->,194.251.75.182,8,2272,0,0,8,2272,1.797697000,0.1630
136.25.188.176,<->,41.154.159.9,8,1985,0,0,8,1985,1.795195000,0.0252
215.158.239.79,<->,204.56.177.45,8,2106,0,0,8,2106,1.771377000,0.2185
108.134.109.74,<->,8.37.200.100,8,10450,0,0,8,10450,1.766846000,0.0596
215.158.238.101,<->,100.216.78.145,8,8399,0,0,8,8399,1.741546000,0.2200
221.102.56.69,<->,6.74.201.88,0,0,8,2352,8,2352,1.625450000,0.2474
137.137.103.123,<->,123.212.48.165,8,3652,0,0,8,3652,1.619575000,0.2780
244.1.41.59,<->,136.25.188.178,0,0,8,2072,8,2072,1.593158000,0.0824
142.220.219.246,<->,136.25.188.46,0,0,8,2171,8,2171,1.573318000,0.4251
231.140.186.59,<->,215.158.239.87,0,0,8,2098,8,2098,1.572800000,0.2343
232.31.177.109,<->,92.27.8.136,0,0,8,11919,8,11919,1.529489000,0.4521
210.221.107.50,<->,8.37.245.94,8,7032,0,0,8,7032,1.491415000,0.3504
215.158.30.240,<->,8.252.222.189,0,0,8,4575,8,4575,1.482750000,0.3986
132.123.44.21,<->,8.37.122.231,8,4765,0,0,8,4765,1.452359000,0.4816
215.158.32.179,<->,6.73.247.101,0,0,8,7743,8,7743,1.429607000,0.0244
136.25.189.10,<->,96.156.169.218,8,9378,0,0,8,9378,1.420385000,0.5041
215.158.239.92,<->,199.20.30.144,8,2318,0,0,8,2318,1.411582000,0.2981
107.11.228.91,<->,0.195.210.33,0,0,8,961,8,961,1.399002000,0.5519
246.253.253.107,<->,56.148.119.56,8,5500,0,0,8,5500,1.397822000,0.0833
82.248.207.148,<->,8.220.239.66,0,0,8,3101,8,3101,1.378969000,0.5427
136.25.188.232,<->,100.224.166.158,8,3817,0,0,8,3817,1.356886000,0.1259
215.158.239.85,<->,207.236.235.100,8,2091,0,0,8,2091,1.265584000,0.1937
215.158.239.78,<->,142.182.132.235,8,2834,0,0,8,2834,1.243400000,0.6073
215.158.238.90,<->,100.120.38.6,8,7280,0,0,8,7280,1.211406000,0.4792
195.6.251.116,<->,136.25.188.175,0,0,8,2096,8,2096,1.202221000,0.2042
195.54.134.173,<->,136.25.188.177,0,0,8,2087,8,2087,1.158228000,0.1889
216.184.1.198,<->,99.74.26.99,0,0,8,6909,8,6909,1.137426000,0.4770
215.158.239.45,<->,145.116.209.76,8,5994,0,0,8,5994,1.120090000,0.7819
142.221.253.237,<->,136.25.188.209,0,0,8,1874,8,1874,1.106123000,0.8813
199.68.121.14,<->,136.25.188.174,0,0,8,3116,8,3116,1.056816000,0.7659
220.28.85.14,<->,215.158.238.229,0,0,8,6135,8,6135,1.036378000,0.8548
215.158.238.125,<->,100.120.38.6,8,7712,0,0,8,7712,1.001423000,0.9618
215.158.238.115,<->,136.138.112.201,8,10040,0,0,8,10040,0.992863000,0.9864
69.243.89.2,<->,8.252.222.149,0,0,8,2418,8,2418,0.971007000,0.8615
215.158.30.252,<->,8.252.222.42,0,0,8,4284,8,4284,0.954003000,0.8536
136.25.189.24,<->,56.28.207.191,8,10826,0,0,8,10826,0.952059000,0.2469
138.74.30.197,<->,137.170.15.145,8,7249,0,0,8,7249,0.929997000,0.3592
220.28.73.211,<->,215.158.238.108,0,0,8,7790,8,7790,0.894788000,0.4770
220.28.85.14,<->,215.158.238.84,0,0,8,8453,8,8453,0.884717000,0.3606
247.136.153.249,<->,126.198.78.25,8,400,0,0,8,400,0.862236000,0.8295
204.200.50.182,<->,136.25.188.174,0,0,8,2226,8,2226,0.858839000,0.4208
136.114.101.87,<->,136.25.188.194,0,0,8,6144,8,6144,0.841403000,1.0324
216.184.2.48,<->,136.25.188.213,0,0,8,4920,8,4920,0.822617000,1.0371
215.158.239.70,<->,207.213.95.31,8,2284,0,0,8,2284,0.731035000,1.0835
215.158.239.23,<->,96.135.154.142,8,6779,0,0,8,6779,0.710650000,0.8917
136.25.188.192,<->,100.224.138.218,8,3216,0,0,8,3216,0.703740000,0.9576
136.25.189.46,<->,126.219.194.33,8,10216,0,0,8,10216,0.688067000,1.2454
215.158.239.225,<->,212.249.34.46,8,6918,0,0,8,6918,0.685586000,0.0652
218.138.21.138,<->,215.158.103.203,0,0,8,6408,8,6408,0.673584000,0.1680
215.158.61.243,<->,8.176.8.248,0,0,8,5543,8,5543,0.661117000,1.2188
199.82.209.42,<->,136.25.188.236,0,0,8,4616,8,4616,0.652536000,1.2320
111.20.172.118,<->,101.224.89.228,0,0,8,5148,8,5148,0.624480000,0.5088
136.25.189.62,<->,96.156.169.208,8,4464,0,0,8,4464,0.613447000,0.6369
246.253.253.170,<->,231.255.129.230,8,10344,0,0,8,10344,0.607030000,0.2724
215.158.238.83,<->,91.57.173.21,8,10024,0,0,8,10024,0.604050000,1.3696
193.36.78.114,<->,89.183.108.40,0,0,8,4250,8,4250,0.582421000,1.3687
133.178.227.2,<->,133.56.180.90,8,7974,0,0,8,7974,0.579450000,1.2710
97.22.56.160,<->,8.183.24.211,0,0,8,5824,8,5824,0.564512000,0.8360
136.25.188.200,<->,100.224.202.146,8,11714,0,0,8,11714,0.563094000,0.0470
133.178.227.27,<->,133.56.180.5,8,10375,0,0,8,10375,0.558212000,1.3239
193.74.180.128,<->,139.163.71.70,0,0,8,6356,8,6356,0.557677000,1.4113
215.158.239.71,<->,145.13.164.229,8,10344,0,0,8,10344,0.542168000,1.3049
219.250.188.94,<->,8.252.222.173,0,0,8,1954,8,1954,0.531391000,1.2749
231.44.187.208,<->,192.64.198.194,0,0,8,1557,8,1557,0.529868000,0.8631
215.158.61.182,<->,8.176.8.219,0,0,8,9628,8,9628,0.526552000,1.4119
192.205.36.216,<->,136.25.188.164,0,0,8,4392,8,4392,0.522288000,1.4528
142.220.96.49,<->,136.25.188.198,0,0,8,2096,8,2096,0.521149000,0.4249
246.254.97.228,<->,56.148.119.56,8,5484,0,0,8,5484,0.507303000,0.1889
133.178.227.19,<->,133.56.180.89,8,10462,0,0,8,10462,0.506412000,1.4314
136.25.188.229,<->,100.224.166.158,8,4012,0,0,8,4012,0.490067000,0.7660
215.158.239.44,<->,8.222.48.144,8,4224,0,0,8,4224,0.481690000,1.3790
215.158.239.48,<->,199.20.29.10,8,2549,0,0,8,2549,0.480540000,0.5196
133.178.227.57,<->,133.56.180.34,8,10405,0,0,8,10405,0.469213000,1.2181
143.134.143.212,<->,136.25.188.227,0,0,8,3306,8,3306,0.458929000,0.3629
194.233.0.17,<->,136.25.188.241,0,0,8,2706,8,2706,0.456745000,0.9299
215.158.238.85,<->,100.120.38.6,8,7986,0,0,8,7986,0.456379000,1.3622
207.193.113.191,<->,8.252.222.141,0,0,8,3071,8,3071,0.454015000,1.4780
215.158.238.135,<->,104.3.168.202,8,9712,0,0,8,9712,0.450998000,1.3241
220.20.200.40,<->,113.173.246.17,8,11462,0,0,8,11462,0.448069000,0.9300
215.158.238.83,<->,29.211.6.10,8,8960,0,0,8,8960,0.444286000,1.4198
220.28.115.46,<->,215.158.238.87,0,0,8,8528,8,8528,0.440006000,1.2310
139.248.30.199,<->,100.228.42.154,0,0,8,4648,8,4648,0.425908000,1.4935
92.27.219.188,<->,27.11.166.221,8,1592,0,0,8,1592,0.411671000,0.3359
133.178.227.62,<->,133.56.180.36,8,4016,0,0,8,4016,0.410950000,0.7465
215.158.239.57,<->,207.191.213.206,8,2018,0,0,8,2018,0.407622000,1.0355
215.158.239.92,<->,196.95.49.18,8,1000,0,0,8,1000,0.400484000,1.4702
139.241.56.102,<->,100.182.136.77,0,0,8,11647,8,11647,0.391892000,1.5060
215.158.239.23,<->,96.135.154.114,8,7566,0,0,8,7566,0.385328000,1.1455
136.25.188.193,<->,100.224.202.157,8,5869,0,0,8,5869,0.379934000,1.1338
205.127.108.114,<->,33.233.141.117,0,0,8,3821,8,3821,0.368175000,1.6284
196.112.116.208,<->,0.195.210.46,0,0,8,1480,8,1480,0.367631000,0.3697
139.47.193.207,<->,33.233.141.73,0,0,8,10292,8,10292,0.363511000,0.3489
251.24.86.2,<->,8.252.222.179,0,0,8,1543,8,1543,0.363401000,0.6800
205.127.108.113,<->,101.224.89.175,0,0,8,3405,8,3405,0.361083000,1.3831
139.248.30.198,<->,100.228.42.154,0,0,8,3486,8,3486,0.353227000,1.6260
215.158.238.147,<->,0.195.253.228,8,8028,0,0,8,8028,0.349863000,1.6003
133.178.226.28,<->,33.209.217.238,8,9995,0,0,8,9995,0.341448000,1.4710
139.241.56.105,<->,98.129.32.167,0,0,8,11647,8,11647,0.338230000,1.6453
220.28.104.193,<->,133.178.227.4,0,0,8,7948,8,7948,0.337992000,0.3971
136.25.188.177,<->,29.214.108.180,8,8518,0,0,8,8518,0.318832000,1.5278
144.232.206.149,<->,0.195.210.46,0,0,8,4472,8,4472,0.311683000,0.7137
111.20.172.119,<->,33.233.141.95,0,0,8,10832,8,10832,0.311117000,0.9213
92.27.219.158,<->,33.57.77.138,8,3402,0,0,8,3402,0.307206000,0.9710
133.178.226.235,<->,8.47.189.87,8,9326,0,0,8,9326,0.300135000,1.3201
215.158.239.197,<->,212.249.34.46,8,6872,0,0,8,6872,0.296892000,0.0499
136.25.189.92,<->,96.156.169.216,8,6488,0,0,8,6488,0.293997000,1.3597
192.228.25.194,<->,133.178.226.212,0,0,8,10541,8,10541,0.290611000,1.5019
215.158.239.204,<->,192.224.146.69,8,7959,0,0,8,7959,0.289922000,0.1608
159.220.151.125,<->,80.40.3.11,0,0,8,4722,8,4722,0.278567000,1.6717
98.197.185.159,<->,8.228.219.58,0,0,8,1596,8,1596,0.274752000,1.4995
204.62.218.163,<->,136.25.188.236,0,0,8,2706,8,2706,0.273717000,0.8404
220.28.85.14,<->,136.25.189.55,0,0,8,7466,8,7466,0.271654000,1.5103
215.158.239.97,<->,199.122.59.17,8,2203,0,0,8,2203,0.269783000,0.3719
133.178.227.1,<->,133.56.180.11,8,9097,0,0,8,9097,0.269583000,1.7144
92.26.156.28,<->,14.71.95.20,0,0,8,3530,8,3530,0.267491000,1.4756
136.25.188.161,<->,8.222.7.38,8,10280,0,0,8,10280,0.259096000,1.6047
133.178.227.76,<->,133.56.180.95,8,7424,0,0,8,7424,0.256566000,1.6889
215.158.44.211,<->,136.25.189.0,0,0,8,9880,8,9880,0.256384000,1.4635
136.25.189.55,<->,96.156.169.209,8,5584,0,0,8,5584,0.250517000,1.5567
136.25.189.21,<->,96.156.169.248,8,5096,0,0,8,5096,0.249504000,1.3997
215.158.239.9,<->,215.158.127.153,8,5455,0,0,8,5455,0.246378000,1.4309
220.28.114.28,<->,136.25.189.5,0,0,8,7145,8,7145,0.237074000,1.6539
220.28.85.14,<->,215.158.140.234,0,0,8,3324,8,3324,0.236629000,1.7157
215.158.239.94,<->,199.20.4.42,8,1692,0,0,8,1692,0.233998000,1.6195
215.158.238.69,<->,97.174.232.194,8,8767,0,0,8,8767,0.224827000,1.7306
215.158.239.89,<->,139.69.162.50,8,4240,0,0,8,4240,0.220876000,1.5438
139.241.56.105,<->,99.75.239.150,0,0,8,11647,8,11647,0.219460000,1.6275
215.158.239.95,<->,207.114.160.1,8,1890,0,0,8,1890,0.219447000,1.1626
215.158.239.93,<->,126.219.191.6,8,10360,0,0,8,10360,0.219066000,1.7529
133.178.226.14,<->,96.155.60.202,8,3646,0,0,8,3646,0.214626000,0.7788
133.178.227.16,<->,131.22.233.154,8,8993,0,0,8,8993,0.211746000,1.6499
220.28.73.211,<->,215.158.238.90,0,0,8,5924,8,5924,0.210996000,1.6517
136.25.188.220,<->,8.222.212.21,8,9360,0,0,8,9360,0.208295000,1.7183
207.61.246.212,<->,136.25.188.253,0,0,8,3548,8,3548,0.203419000,0.2375
133.178.226.66,<->,133.56.180.44,8,5801,0,0,8,5801,0.189818000,0.7973
205.127.108.115,<->,33.233.141.230,0,0,8,3811,8,3811,0.188874000,1.5352
194.253.94.195,<->,8.252.222.221,0,0,8,836,8,836,0.184164000,1.7870
54.59.122.154,<->,48.53.175.153,0,0,8,872,8,872,0.181521000,1.7507
97.126.115.85,<->,97.46.125.17,8,3138,0,0,8,3138,0.172593000,1.6686
133.178.226.3,<->,96.155.60.253,8,4047,0,0,8,4047,0.167506000,1.5049
98.23.102.124,<->,8.252.221.249,0,0,8,5229,8,5229,0.164035000,1.7246
215.158.238.82,<->,8.42.43.88,8,10680,0,0,8,10680,0.163919000,1.8239
215.158.238.134,<->,8.255.92.247,8,10136,0,0,8,10136,0.157972000,1.3959
97.126.115.85,<->,97.46.127.17,8,8023,0,0,8,8023,0.155039000,1.7491
136.25.189.1,<->,120.154.71.8,8,9216,0,0,8,9216,0.153461000,1.3809
215.158.238.72,<->,91.57.173.10,8,10232,0,0,8,10232,0.147687000,1.2351
215.158.239.11,<->,215.158.127.140,8,4531,0,0,8,4531,0.147633000,1.7204
215.158.238.68,<->,98.219.126.140,8,6912,0,0,8,6912,0.146557000,1.0263
192.228.25.244,<->,133.178.226.196,0,0,8,7846,8,7846,0.144155000,1.7917
212.241.174.245,<->,80.27.152.99,0,0,8,5675,8,5675,0.136649000,1.4791
205.127.108.113,<->,33.233.141.232,0,0,8,3474,8,3474,0.135963000,1.4242
215.158.239.94,<->,145.13.164.216,8,10776,0,0,8,10776,0.134671000,1.5022
215.158.238.128,<->,0.195.237.14,8,8819,0,0,8,8819,0.131401000,1.6196
215.158.238.144,<->,98.219.126.175,8,7981,0,0,8,7981,0.128957000,1.8096
133.178.226.18,<->,111.151.239.8,8,10072,0,0,8,10072,0.127850000,1.6130
53.231.73.173,<->,48.54.81.68,0,0,8,11808,8,11808,0.127757000,1.5289
133.178.227.52,<->,133.56.180.38,8,5290,0,0,8,5290,0.124351000,1.4212
220.50.242.213,<->,215.158.239.104,0,0,8,7080,8,7080,0.121656000,1.8036
133.178.226.57,<->,98.219.126.175,8,8774,0,0,8,8774,0.121485000,1.7215
220.28.73.211,<->,215.158.238.217,0,0,8,5887,8,5887,0.120892000,1.7944
133.178.226.94,<->,96.155.60.210,8,5948,0,0,8,5948,0.119460000,1.3528
220.28.108.254,<->,133.178.227.6,0,0,8,6295,8,6295,0.118974000,1.5969
136.25.188.226,<->,91.57.173.63,8,10616,0,0,8,10616,0.115063000,1.7707
136.25.188.197,<->,8.222.7.55,8,10344,0,0,8,10344,0.109101000,1.7801
136.25.189.62,<->,56.28.207.196,8,5136,0,0,8,5136,0.108224000,1.6443
139.241.56.105,<->,99.72.168.169,0,0,8,11647,8,11647,0.107825000,1.7463
111.150.187.250,<->,8.252.223.160,0,0,8,9800,8,9800,0.105484000,1.6580
136.25.188.47,<->,8.255.92.247,8,9960,0,0,8,9960,0.103941000,1.8681
136.114.101.39,<->,136.25.188.169,0,0,8,5744,8,5744,0.103105000,1.0364
215.158.238.75,<->,91.57.173.63,8,8144,0,0,8,8144,0.102280000,1.7921
220.28.114.28,<->,215.158.238.111,0,0,8,8017,8,8017,0.099964000,1.8926
215.158.239.45,<->,98.219.126.140,8,5927,0,0,8,5927,0.097627000,1.8765
136.25.189.53,<->,96.156.169.173,8,5056,0,0,8,5056,0.096485000,1.7815
215.158.239.195,<->,53.208.30.76,8,3932,0,0,8,3932,0.096296000,1.8621
53.231.73.23,<->,48.54.81.68,0,0,8,11808,8,11808,0.094554000,1.7207
215.158.239.99,<->,126.219.191.5,8,8024,0,0,8,8024,0.092438000,1.8130
139.241.56.117,<->,102.51.218.25,0,0,8,10249,8,10249,0.088925000,1.6688
139.241.56.117,<->,100.93.223.40,0,0,8,10249,8,10249,0.088803000,1.6689
215.158.238.108,<->,98.219.126.140,8,10248,0,0,8,10248,0.088742000,1.5353
215.158.239.78,<->,133.146.0.201,8,10360,0,0,8,10360,0.085422000,1.6432
133.178.227.24,<->,133.56.180.7,8,10236,0,0,8,10236,0.085286000,1.1555
133.178.226.30,<->,96.155.60.216,8,1469,0,0,8,1469,0.084587000,1.0659
215.158.239.59,<->,145.13.164.216,8,10216,0,0,8,10216,0.081132000,1.4933
111.20.172.118,<->,33.233.141.227,0,0,8,6753,8,6753,0.081024000,0.8847
220.185.79.194,<->,89.183.108.132,0,0,8,936,8,936,0.079601000,1.5822
220.28.85.14,<->,215.158.238.216,0,0,8,8005,8,8005,0.079040000,0.0054
215.158.238.138,<->,98.219.126.140,8,6052,0,0,8,6052,0.078854000,1.7332
215.158.238.95,<->,131.1.195.229,8,10274,0,0,8,10274,0.078780000,1.8027
215.158.239.86,<->,120.154.71.91,8,10520,0,0,8,10520,0.077927000,1.8873
136.25.188.232,<->,97.174.232.253,8,3296,0,0,8,3296,0.073459000,1.3758
133.178.227.14,<->,133.56.180.5,8,9938,0,0,8,9938,0.073384000,1.6924
111.147.116.176,<->,92.27.51.117,8,5046,0,0,8,5046,0.072776000,1.9043
247.136.242.29,<->,221.102.56.46,8,7448,0,0,8,7448,0.071368000,1.7131
215.158.239.84,<->,215.158.44.228,8,10152,0,0,8,10152,0.068350000,1.8119
133.178.226.28,<->,96.155.60.195,8,3350,0,0,8,3350,0.067498000,1.5209
136.25.188.221,<->,8.42.43.37,8,10216,0,0,8,10216,0.067230000,1.1165
91.231.195.136,<->,27.231.94.211,8,1058,0,0,8,1058,0.066978000,1.4813
215.158.140.248,<->,100.216.78.145,8,6050,0,0,8,6050,0.065352000,1.8942
136.25.188.220,<->,8.222.212.25,8,10536,0,0,8,10536,0.064903000,1.8295
133.178.226.61,<->,8.222.7.46,8,10408,0,0,8,10408,0.064737000,1.7352
133.178.226.77,<->,29.214.108.120,8,8928,0,0,8,8928,0.059809000,1.7750
133.178.227.76,<->,133.56.180.49,8,10507,0,0,8,10507,0.059609000,1.9124
215.158.44.186,<->,136.25.189.59,0,0,8,10376,8,10376,0.058298000,1.8192
215.158.238.221,<->,158.85.50.151,8,8723,0,0,8,8723,0.057526000,1.9101
139.241.56.105,<->,100.94.110.169,0,0,8,10248,8,10248,0.053508000,1.6360
114.83.250.130,<->,91.231.195.136,0,0,8,1058,8,1058,0.049897000,1.5016
215.158.239.216,<->,111.151.237.67,8,4520,0,0,8,4520,0.049879000,1.1136
112.8.200.82,<->,39.248.89.159,0,0,8,3686,8,3686,0.048402000,0.4929
215.158.61.191,<->,8.176.8.247,0,0,8,6703,8,6703,0.046221000,1.2469
133.178.227.76,<->,133.56.180.89,8,3480,0,0,8,3480,0.043076000,1.3086
136.114.101.19,<->,136.25.188.249,0,0,8,5680,8,5680,0.042746000,1.8088
133.178.227.76,<->,133.56.180.0,8,9154,0,0,8,9154,0.036671000,1.3169
133.178.226.25,<->,100.120.38.6,8,7923,0,0,8,7923,0.036548000,1.6482
143.35.73.5,<->,136.25.188.220,0,0,8,1837,8,1837,0.035361000,0.0340
215.158.239.79,<->,207.228.202.14,8,1970,0,0,8,1970,0.035215000,1.2557
139.241.56.102,<->,100.182.138.165,0,0,8,10249,8,10249,0.032581000,1.6805
220.28.85.14,<->,215.158.140.245,0,0,8,4536,8,4536,0.031462000,1.6482
139.241.56.102,<->,109.1.26.47,0,0,8,11647,8,11647,0.031175000,1.9501
198.30.207.215,<->,35.56.98.42,0,0,8,1180,8,1180,0.030885000,1.5350
139.241.56.117,<->,6.74.85.210,0,0,8,11647,8,11647,0.029429000,1.9501
215.158.140.231,<->,8.40.51.206,8,8524,0,0,8,8524,0.029196000,1.8811
145.13.164.185,<->,136.25.189.34,0,0,8,9640,8,9640,0.027718000,1.5192
215.158.239.79,<->,199.20.5.129,8,3827,0,0,8,3827,0.027385000,1.4508
239.66.72.43,<->,102.50.37.229,0,0,8,7746,8,7746,0.026140000,1.7838
133.178.227.30,<->,133.56.180.25,8,5540,0,0,8,5540,0.025667000,1.9536
215.158.239.224,<->,192.226.44.84,8,4473,0,0,8,4473,0.023610000,1.0075
136.25.188.197,<->,8.222.7.56,8,10232,0,0,8,10232,0.023107000,1.7272
198.70.5.37,<->,89.183.110.193,0,0,8,587,8,587,0.019233000,0.4797
215.158.239.94,<->,8.215.68.83,8,10504,0,0,8,10504,0.018226000,1.9743
136.25.188.57,<->,133.56.180.45,8,4208,0,0,8,4208,0.017235000,1.7580
136.25.188.198,<->,33.209.217.237,8,9967,0,0,8,9967,0.017164000,1.3741
215.158.239.80,<->,98.219.126.140,8,3867,0,0,8,3867,0.017071000,1.3026
136.25.189.26,<->,96.156.169.208,8,4304,0,0,8,4304,0.016525000,0.5295
136.25.189.18,<->,96.135.155.22,8,10248,0,0,8,10248,0.016489000,1.5029
220.28.114.28,<->,215.158.140.95,0,0,8,4038,8,4038,0.014901000,1.4752
136.25.189.38,<->,96.156.169.249,8,4776,0,0,8,4776,0.014581000,1.4727
69.128.140.233,<->,54.38.66.136,8,896,0,0,8,896,0.013078000,1.7513
215.158.239.66,<->,100.224.166.158,8,6510,0,0,8,6510,0.011953000,1.9416
207.62.191.87,<->,136.25.188.163,0,0,8,2416,8,2416,0.011407000,1.0927
207.190.92.240,<->,136.25.188.45,0,0,8,2419,8,2419,0.009204000,1.2819
142.227.29.180,<->,136.25.188.226,0,0,8,1874,8,1874,0.008404000,0.7798
192.204.123.61,<->,136.25.189.47,0,0,8,10152,8,10152,0.007198000,1.9545
136.25.189.63,<->,96.156.169.238,8,3624,0,0,8,3624,0.007190000,0.5776
129.92.115.88,<->,33.239.63.145,8,2019,0,0,8,2019,0.002725000,1.9567
133.178.227.4,<->,133.56.180.53,8,3738,0,0,8,3738,0.001371000,1.8719
215.158.238.64,<->,126.219.194.151,8,9832,0,0,8,9832,0.000163000,1.9260
136.25.188.220,<->,133.183.252.51,7,1486,0,0,7,1486,1.909964000,0.0760
132.240.84.216,<->,80.27.159.58,0,0,7,1536,7,1536,1.803646000,0.1236
195.71.77.50,<->,136.25.188.209,0,0,7,2368,7,2368,1.764655000,0.1892
142.220.219.246,<->,136.25.188.52,0,0,7,1866,7,1866,1.684853000,0.3117
136.25.188.251,<->,97.174.232.234,7,4299,0,0,7,4299,1.644206000,0.2753
136.25.188.178,<->,95.99.148.203,7,1778,0,0,7,1778,1.576524000,0.3333
215.158.239.77,<->,199.70.96.26,7,1588,0,0,7,1588,1.557445000,0.2464
215.158.239.70,<->,204.56.185.101,7,1584,0,0,7,1584,1.554359000,0.1951
195.55.16.198,<->,136.25.188.227,0,0,7,1888,7,1888,1.438276000,0.5601
143.10.250.108,<->,136.25.188.160,0,0,7,2517,7,2517,1.350407000,0.5322
136.114.101.94,<->,136.25.188.194,0,0,7,3851,7,3851,1.341412000,0.2469
143.53.50.46,<->,136.25.188.163,0,0,7,1935,7,1935,1.335151000,0.2143
231.142.6.77,<->,136.25.188.52,0,0,7,2370,7,2370,1.325538000,0.2491
144.81.101.239,<->,144.71.42.15,0,0,7,5641,7,5641,1.314404000,0.2115
215.158.239.96,<->,207.236.235.100,7,1781,0,0,7,1781,1.310348000,0.2479
210.236.203.57,<->,91.231.193.139,0,0,7,763,7,763,1.307125000,0.1195
215.158.238.139,<->,0.195.253.228,7,6390,0,0,7,6390,1.296340000,0.4672
136.25.188.48,<->,80.57.141.130,7,5191,0,0,7,5191,1.287524000,0.1402
220.28.114.28,<->,215.158.239.63,0,0,7,8731,7,8731,1.276886000,0.3392
195.12.245.216,<->,136.25.188.174,0,0,7,2165,7,2165,1.273276000,0.3907
159.223.99.62,<->,8.52.185.129,0,0,7,2616,7,2616,1.248184000,0.4698
136.25.188.53,<->,50.176.223.89,7,1845,0,0,7,1845,1.241736000,0.4042
215.158.239.79,<->,199.68.63.106,7,2339,0,0,7,2339,1.226924000,0.0348
195.43.122.84,<->,136.25.188.54,0,0,7,1881,7,1881,1.218504000,0.2476
99.187.125.122,<->,8.20.87.34,0,0,7,8224,7,8224,1.213468000,0.0217
215.158.238.231,<->,215.158.34.90,7,9063,0,0,7,9063,1.203579000,0.0201
215.158.239.51,<->,195.15.18.212,7,1704,0,0,7,1704,1.177461000,0.2072
159.57.90.83,<->,109.222.201.90,0,0,7,6218,7,6218,1.163447000,0.1956
210.221.107.50,<->,8.222.6.39,7,2981,0,0,7,2981,1.160715000,0.3521
199.70.188.9,<->,136.25.188.237,0,0,7,1797,7,1797,1.156597000,0.6047
215.158.239.56,<->,204.56.52.178,7,1784,0,0,7,1784,1.147334000,0.2796
195.41.200.52,<->,136.25.188.209,0,0,7,1799,7,1799,1.138005000,0.4243
215.158.61.195,<->,8.176.8.176,0,0,7,6757,7,6757,1.131461000,0.7995
136.114.101.93,<->,136.25.188.48,0,0,7,8797,7,8797,1.106583000,0.1476
207.56.104.108,<->,136.25.188.177,0,0,7,1784,7,1784,1.088729000,0.6984
195.4.55.57,<->,136.25.188.174,0,0,7,2153,7,2153,1.083367000,0.5381
136.114.101.65,<->,136.25.188.228,0,0,7,5099,7,5099,1.072494000,0.7007
215.158.238.201,<->,98.219.126.175,7,4486,0,0,7,4486,1.050984000,0.8938
133.178.227.2,<->,133.56.180.95,7,8895,0,0,7,8895,1.040635000,0.8760
215.158.61.189,<->,8.176.8.176,0,0,7,5252,7,5252,1.017029000,0.9161
220.28.114.28,<->,133.178.227.10,0,0,7,4816,7,4816,1.003808000,0.9283
66.59.16.129,<->,8.252.221.230,0,0,7,2622,7,2622,1.002943000,0.8874
215.158.239.84,<->,204.226.116.98,7,2932,0,0,7,2932,0.990885000,0.3618
159.109.242.246,<->,53.148.157.117,7,7426,0,0,7,7426,0.988242000,0.6300
215.158.239.80,<->,145.116.209.76,7,4679,0,0,7,4679,0.985488000,0.2270
111.146.175.140,<->,97.110.90.232,7,907,0,0,7,907,0.969388000,0.6134
215.158.239.49,<->,199.80.0.226,7,2597,0,0,7,2597,0.962313000,0.5556
215.158.239.93,<->,199.20.31.230,7,2533,0,0,7,2533,0.955934000,0.9053
69.103.234.233,<->,8.252.222.23,0,0,7,1717,7,1717,0.955370000,0.8652
142.236.30.149,<->,136.25.188.255,0,0,7,2951,7,2951,0.933518000,0.4636
136.25.189.22,<->,96.156.169.209,7,4998,0,0,7,4998,0.913960000,0.9691
216.184.2.64,<->,215.158.239.45,0,0,7,5707,7,5707,0.895561000,0.2391
126.226.46.137,<->,0.195.210.46,0,0,7,3123,7,3123,0.892258000,0.5956
215.158.239.99,<->,199.20.30.93,7,2597,0,0,7,2597,0.881834000,1.0882
215.158.239.99,<->,207.239.54.9,7,1717,0,0,7,1717,0.868816000,0.3812
159.13.238.91,<->,54.92.199.224,7,668,0,0,7,668,0.868146000,0.2286
192.224.20.42,<->,133.178.227.245,0,0,7,7787,7,7787,0.846010000,1.1330
133.178.227.23,<->,100.224.133.166,7,5115,0,0,7,5115,0.823451000,0.6698
101.224.182.5,<->,8.252.222.215,0,0,7,9176,7,9176,0.812228000,0.0947
136.25.188.226,<->,8.222.212.42,7,9019,0,0,7,9019,0.794569000,0.9812
215.158.239.95,<->,199.20.29.161,7,2323,0,0,7,2323,0.785810000,0.5695
142.252.215.125,<->,136.25.188.53,0,0,7,2925,7,2925,0.770172000,0.6615
231.140.140.223,<->,136.25.188.176,0,0,7,1777,7,1777,0.769454000,0.2757
142.228.82.251,<->,136.25.188.173,0,0,7,3536,7,3536,0.766103000,1.1722
53.231.85.213,<->,48.54.81.68,0,0,7,10332,7,10332,0.763477000,1.0986
139.163.17.164,<->,133.129.49.254,7,979,0,0,7,979,0.762320000,0.1547
220.28.73.211,<->,136.25.189.53,0,0,7,4444,7,4444,0.731045000,1.0187
194.232.206.196,<->,136.25.188.198,0,0,7,2362,7,2362,0.729329000,0.5043
215.158.239.84,<->,195.6.27.157,7,4892,0,0,7,4892,0.726495000,0.7744
142.255.45.106,<->,136.25.188.163,0,0,7,1787,7,1787,0.711501000,0.3893
133.178.227.21,<->,133.56.180.35,7,4035,0,0,7,4035,0.685605000,1.0572
133.178.226.57,<->,100.120.38.6,7,7031,0,0,7,7031,0.670590000,0.1894
215.158.238.70,<->,97.174.232.172,7,5164,0,0,7,5164,0.662968000,1.2248
159.215.65.177,<->,136.25.188.212,0,0,7,4171,7,4171,0.658914000,0.8591
215.158.239.81,<->,159.215.65.177,7,4043,0,0,7,4043,0.657721000,0.9188
195.55.44.158,<->,136.25.188.225,0,0,7,4332,7,4332,0.656726000,0.3481
215.158.238.99,<->,136.138.112.226,7,8715,0,0,7,8715,0.651227000,1.0130
215.158.239.87,<->,126.219.194.82,7,8235,0,0,7,8235,0.645339000,1.2321
196.148.124.252,<->,143.20.35.28,7,4614,0,0,7,4614,0.605780000,0.5540
220.28.109.52,<->,136.25.188.218,0,0,7,6714,7,6714,0.602836000,0.8204
129.236.114.39,<->,111.20.168.155,0,0,7,3823,7,3823,0.600154000,1.0200
246.254.97.105,<->,145.250.89.228,7,4107,0,0,7,4107,0.598897000,0.5366
136.25.189.95,<->,96.156.169.176,7,4027,0,0,7,4027,0.597590000,0.9913
92.27.65.36,<->,8.252.222.36,0,0,7,1682,7,1682,0.594156000,0.7259
136.25.188.44,<->,111.151.239.52,7,9083,0,0,7,9083,0.581694000,1.0733
233.121.195.221,<->,8.183.25.124,0,0,7,2853,7,2853,0.575494000,0.2115
136.25.189.59,<->,8.50.171.247,7,8971,0,0,7,8971,0.563777000,1.2078
133.32.39.39,<->,17.2.1.166,7,502,0,0,7,502,0.551558000,0.2456
136.25.189.13,<->,96.156.169.244,7,7147,0,0,7,7147,0.548288000,1.3545
80.40.205.101,<->,8.55.224.156,7,4611,0,0,7,4611,0.522292000,0.9800
133.178.226.7,<->,69.150.168.203,7,9019,0,0,7,9019,0.517464000,1.2994
133.178.226.70,<->,133.56.180.23,7,6811,0,0,7,6811,0.495896000,1.4916
136.25.188.197,<->,100.224.202.175,7,3929,0,0,7,3929,0.493411000,1.0778
136.25.188.255,<->,126.219.194.183,7,8153,0,0,7,8153,0.487603000,1.4017
136.25.189.59,<->,80.56.79.41,7,8891,0,0,7,8891,0.484438000,1.3673
133.178.227.2,<->,8.240.116.180,7,7589,0,0,7,7589,0.478767000,1.3007
215.158.239.76,<->,199.20.28.113,7,1566,0,0,7,1566,0.477692000,1.1091
140.126.225.28,<->,98.232.164.173,0,0,7,2293,7,2293,0.474189000,1.3935
215.158.238.83,<->,8.255.92.246,7,8699,0,0,7,8699,0.470178000,1.1916
204.186.176.194,<->,136.25.188.238,0,0,7,1730,7,1730,0.466405000,0.9007
207.57.161.89,<->,136.25.188.220,0,0,7,4333,7,4333,0.465093000,1.2421
106.188.184.108,<->,56.121.54.220,0,0,7,4084,7,4084,0.462753000,0.0712
246.253.253.99,<->,8.20.81.65,7,6014,0,0,7,6014,0.454736000,1.4811
136.25.189.22,<->,96.156.169.196,7,5675,0,0,7,5675,0.447142000,1.3826
136.25.188.211,<->,100.224.202.151,7,1952,0,0,7,1952,0.435507000,1.5270
192.228.25.162,<->,133.178.226.201,0,0,7,7907,7,7907,0.430219000,1.4995
215.158.239.93,<->,196.93.0.180,7,2980,0,0,7,2980,0.426687000,1.4694
136.25.188.177,<->,100.224.202.172,7,3680,0,0,7,3680,0.424800000,1.1130
215.158.239.75,<->,159.215.65.143,7,3947,0,0,7,3947,0.423309000,1.4979
136.25.188.208,<->,29.214.108.119,7,8763,0,0,7,8763,0.418969000,1.4838
220.28.104.193,<->,133.178.226.43,0,0,7,5510,7,5510,0.416008000,1.4856
220.28.104.193,<->,215.158.238.78,0,0,7,6230,7,6230,0.411846000,0.9886
220.28.65.9,<->,215.158.239.66,0,0,7,4494,7,4494,0.406949000,1.4046
136.25.189.43,<->,96.156.169.209,7,5515,0,0,7,5515,0.401591000,1.5858
215.158.239.67,<->,136.114.101.65,7,5571,0,0,7,5571,0.397074000,0.5293
136.25.189.14,<->,96.156.169.245,7,8675,0,0,7,8675,0.396315000,1.5783
215.158.239.56,<->,204.61.60.38,7,2020,0,0,7,2020,0.391144000,1.0476
136.138.112.246,<->,136.25.188.175,0,0,7,8763,7,8763,0.390750000,1.5248
215.158.238.72,<->,57.210.107.42,7,9099,0,0,7,9099,0.375064000,1.5105
220.20.200.164,<->,84.236.193.94,7,5104,0,0,7,5104,0.374843000,1.5135
215.158.238.136,<->,100.120.38.6,7,5736,0,0,7,5736,0.374532000,0.5103
136.25.188.255,<->,111.151.239.1,7,9019,0,0,7,9019,0.358687000,1.5818
133.178.226.84,<->,98.219.126.175,7,5890,0,0,7,5890,0.354809000,1.5990
136.25.188.226,<->,29.211.6.85,7,9067,0,0,7,9067,0.341198000,1.6193
215.158.61.193,<->,136.25.189.222,0,0,7,6102,7,6102,0.330490000,1.5358
215.158.140.247,<->,98.219.126.175,7,6763,0,0,7,6763,0.329901000,0.9574
205.127.108.115,<->,33.233.141.1,0,0,7,5472,7,5472,0.328710000,1.5933
204.141.228.248,<->,8.252.222.220,0,0,7,707,7,707,0.328014000,1.6543
136.25.188.234,<->,100.224.202.157,7,3542,0,0,7,3542,0.325130000,1.3327
195.42.161.86,<->,136.25.188.198,0,0,7,1791,7,1791,0.324570000,0.4558
247.136.212.186,<->,121.12.84.230,7,8852,0,0,7,8852,0.324062000,1.5293
143.52.171.63,<->,136.25.188.176,0,0,7,1795,7,1795,0.321285000,0.5116
133.178.226.61,<->,57.210.107.43,7,8955,0,0,7,8955,0.317715000,1.3945
126.108.237.91,<->,92.168.217.253,0,0,7,2478,7,2478,0.316406000,1.5968
215.158.239.84,<->,199.20.28.11,7,1937,0,0,7,1937,0.315773000,1.1000
136.25.188.254,<->,132.97.204.206,7,1669,0,0,7,1669,0.313509000,0.1953
143.134.172.207,<->,136.25.188.253,0,0,7,1783,7,1783,0.313508000,1.0753
136.25.189.77,<->,133.56.180.55,7,8699,0,0,7,8699,0.308736000,1.1538
199.68.83.137,<->,136.25.188.222,0,0,7,1829,7,1829,0.303101000,0.9017
215.158.238.75,<->,112.220.206.8,7,8571,0,0,7,8571,0.296449000,1.5629
133.178.226.37,<->,126.219.194.116,7,9323,0,0,7,9323,0.293677000,1.5945
145.170.227.223,<->,8.52.187.43,0,0,7,3311,7,3311,0.292888000,1.4331
194.232.178.85,<->,136.25.188.163,0,0,7,1805,7,1805,0.289381000,0.1070
136.25.188.227,<->,126.219.247.70,7,8907,0,0,7,8907,0.281750000,1.6000
141.175.156.208,<->,8.252.222.36,0,0,7,2503,7,2503,0.279346000,0.1941
215.158.61.255,<->,8.252.221.166,0,0,7,2658,7,2658,0.275413000,1.2433
136.25.188.226,<->,91.57.173.62,7,8827,0,0,7,8827,0.272838000,1.6414
215.158.140.60,<->,139.8.186.137,7,7728,0,0,7,7728,0.267154000,1.4268
199.15.254.108,<->,136.25.188.224,0,0,7,2217,7,2217,0.262246000,0.7859
229.42.55.249,<->,92.27.219.203,0,0,7,9772,7,9772,0.260494000,1.6740
215.158.61.252,<->,8.252.222.2,0,0,7,4465,7,4465,0.256673000,1.2810
136.25.188.177,<->,29.214.108.81,7,9127,0,0,7,9127,0.256203000,1.2286
133.178.227.73,<->,133.56.180.25,7,3540,0,0,7,3540,0.253375000,1.6736
136.25.188.254,<->,8.222.7.47,7,9115,0,0,7,9115,0.250937000,1.6640
212.70.227.60,<->,56.121.60.30,0,0,7,7797,7,7797,0.249648000,1.6559
56.121.46.242,<->,8.240.117.207,7,2468,0,0,7,2468,0.249151000,1.5751
216.184.2.165,<->,136.25.189.59,0,0,7,9179,7,9179,0.246931000,1.6189
199.68.139.129,<->,136.25.188.174,0,0,7,1792,7,1792,0.244532000,0.2407
220.28.115.46,<->,215.158.238.187,0,0,7,3875,7,3875,0.242858000,1.6956
215.158.238.135,<->,33.209.217.203,7,9707,0,0,7,9707,0.242475000,1.6756
231.143.119.44,<->,136.25.188.177,0,0,7,2845,7,2845,0.241945000,1.1277
8.252.223.140,<->,8.240.116.229,7,7674,0,0,7,7674,0.241569000,1.5763
220.28.65.9,<->,215.158.238.40,0,0,7,7560,7,7560,0.236966000,0.0507
220.39.233.196,<->,215.158.238.75,0,0,7,9083,7,9083,0.235734000,1.7537
143.53.209.117,<->,136.25.188.163,0,0,7,1372,7,1372,0.235153000,0.4353
220.28.73.211,<->,215.158.140.251,0,0,7,5521,7,5521,0.234026000,0.9404
133.178.227.27,<->,126.219.246.223,7,8107,0,0,7,8107,0.232037000,1.7588
136.25.189.0,<->,8.215.68.83,7,9179,0,0,7,9179,0.225428000,1.6748
139.241.56.117,<->,102.51.187.203,0,0,7,10191,7,10191,0.221009000,1.6798
143.129.198.157,<->,136.25.188.176,0,0,7,2167,7,2167,0.218997000,0.4612
129.175.139.42,<->,8.252.222.226,0,0,7,9076,7,9076,0.218747000,1.7483
136.25.189.14,<->,120.154.71.52,7,8955,0,0,7,8955,0.208880000,1.5815
199.38.102.159,<->,136.25.188.198,0,0,7,2167,7,2167,0.208512000,0.4915
136.25.189.25,<->,96.156.169.236,7,6347,0,0,7,6347,0.207619000,1.0414
220.87.252.199,<->,139.163.96.101,0,0,7,1708,7,1708,0.207605000,1.5857
215.158.239.57,<->,133.146.0.254,7,7971,0,0,7,7971,0.205902000,1.7640
215.158.238.91,<->,0.195.253.228,7,6993,0,0,7,6993,0.205127000,0.5063
139.163.96.101,<->,82.239.157.195,7,1869,0,0,7,1869,0.202742000,1.5382
136.25.189.10,<->,96.156.169.166,7,4667,0,0,7,4667,0.201616000,1.5420
133.178.226.7,<->,126.219.194.116,7,9307,0,0,7,9307,0.197381000,1.5537
136.25.188.223,<->,69.150.168.234,7,8843,0,0,7,8843,0.195409000,1.6174
199.33.16.158,<->,136.25.188.52,0,0,7,1536,7,1536,0.194574000,1.4613
205.127.108.114,<->,33.233.141.6,0,0,7,3563,7,3563,0.191976000,1.8075
220.28.104.193,<->,215.158.238.119,0,0,7,4342,7,4342,0.190831000,1.7081
215.158.239.11,<->,215.158.127.153,7,5044,0,0,7,5044,0.186182000,1.3389
204.60.76.43,<->,136.25.188.238,0,0,7,1428,7,1428,0.184213000,1.7083
215.158.239.217,<->,56.19.241.86,7,3772,0,0,7,3772,0.179460000,1.4511
215.158.238.80,<->,8.42.43.36,7,8811,0,0,7,8811,0.176288000,1.6458
220.55.69.95,<->,35.56.3.196,7,3689,0,0,7,3689,0.175163000,1.5941
231.142.103.130,<->,136.25.188.177,0,0,7,1794,7,1794,0.174479000,0.2367
133.178.227.16,<->,133.56.180.48,7,8916,0,0,7,8916,0.173514000,1.8237
229.102.86.37,<->,80.41.53.231,0,0,7,506,7,506,0.171665000,1.3393
215.158.239.58,<->,196.95.163.249,7,2779,0,0,7,2779,0.166945000,0.1927
99.72.97.154,<->,89.155.205.212,7,9202,0,0,7,9202,0.165153000,1.5594
80.40.4.150,<->,0.195.202.28,7,5563,0,0,7,5563,0.164923000,1.6338
136.25.188.56,<->,100.224.202.145,7,3419,0,0,7,3419,0.163953000,1.7551
220.28.85.14,<->,215.158.239.55,0,0,7,4436,7,4436,0.162598000,1.7483
220.28.109.52,<->,136.25.188.234,0,0,7,8806,7,8806,0.161173000,0.7595
136.25.189.9,<->,96.156.169.208,7,4451,0,0,7,4451,0.160588000,1.6647
144.88.76.38,<->,129.124.149.19,7,5595,0,0,7,5595,0.159986000,1.3578
136.138.112.219,<->,136.25.188.211,0,0,7,8763,7,8763,0.156785000,1.6113
207.20.191.116,<->,8.252.222.176,0,0,7,1500,7,1500,0.155578000,0.8882
129.47.116.119,<->,98.232.172.137,0,0,7,2512,7,2512,0.153630000,0.3867
220.28.115.46,<->,215.158.238.76,0,0,7,4187,7,4187,0.150656000,1.7934
136.114.101.18,<->,136.25.188.48,0,0,7,3483,7,3483,0.149312000,0.3920
136.25.188.211,<->,8.222.7.58,7,9259,0,0,7,9259,0.145937000,1.5315
220.39.233.181,<->,136.25.188.237,0,0,7,9147,7,9147,0.143365000,1.8126
215.158.239.87,<->,126.219.194.5,7,8395,0,0,7,8395,0.142793000,1.4890
133.178.226.7,<->,57.210.107.26,7,7843,0,0,7,7843,0.142378000,1.7931
215.158.238.82,<->,57.210.107.42,7,9435,0,0,7,9435,0.141509000,1.7469
207.62.98.53,<->,136.25.188.227,0,0,7,3275,7,3275,0.139273000,0.9580
220.20.200.109,<->,132.216.159.4,7,3779,0,0,7,3779,0.137259000,0.0826
136.25.188.169,<->,56.97.186.164,7,5937,0,0,7,5937,0.135627000,1.7455
133.178.227.76,<->,100.50.96.236,7,8322,0,0,7,8322,0.134167000,1.5234
220.28.73.211,<->,136.25.188.213,0,0,7,4706,7,4706,0.132369000,1.3571
207.22.224.140,<->,0.195.210.46,0,0,7,1776,7,1776,0.131583000,1.8545
146.235.109.66,<->,8.252.221.195,0,0,7,8968,7,8968,0.130759000,1.7019
143.129.198.157,<->,136.25.188.241,0,0,7,2382,7,2382,0.130528000,0.1892
136.25.189.33,<->,29.211.228.178,7,7875,0,0,7,7875,0.129861000,1.6271
215.158.61.195,<->,8.176.8.226,0,0,7,7269,7,7269,0.128678000,1.7321
133.178.226.57,<->,96.155.60.205,7,3537,0,0,7,3537,0.128556000,1.7830
215.158.238.100,<->,100.120.38.6,7,5266,0,0,7,5266,0.126954000,0.3310
69.103.234.233,<->,8.252.222.28,0,0,7,1717,7,1717,0.126672000,0.9942
136.25.188.211,<->,8.222.7.56,7,9003,0,0,7,9003,0.124889000,1.6891
133.178.227.76,<->,133.56.180.59,7,7323,0,0,7,7323,0.124484000,1.8592
136.25.189.57,<->,29.211.228.200,7,9099,0,0,7,9099,0.123928000,1.8520
133.178.227.57,<->,133.56.180.21,7,7878,0,0,7,7878,0.123700000,1.6843
136.138.112.226,<->,136.25.188.160,0,0,7,9083,7,9083,0.123450000,1.7792
133.178.227.19,<->,133.56.180.33,7,6291,0,0,7,6291,0.120936000,1.7801
136.25.188.233,<->,56.97.186.17,7,3411,0,0,7,3411,0.119528000,0.9210
220.28.65.9,<->,215.158.238.215,0,0,7,4642,7,4642,0.118423000,1.7840
199.33.17.43,<->,136.25.188.53,0,0,7,2225,7,2225,0.117119000,1.5746
215.158.140.76,<->,8.190.217.55,7,7890,0,0,7,7890,0.116146000,1.8317
207.59.20.253,<->,136.25.188.209,0,0,7,2154,7,2154,0.114278000,0.7040
139.241.56.102,<->,80.40.51.71,0,0,7,10191,7,10191,0.109114000,1.6699
215.158.239.96,<->,199.15.213.31,7,4258,0,0,7,4258,0.103887000,1.2898
124.64.43.233,<->,109.222.200.118,0,0,7,6038,7,6038,0.103389000,1.5673
215.158.239.73,<->,100.224.166.120,7,3890,0,0,7,3890,0.097046000,1.4286
136.25.189.59,<->,96.156.169.162,7,7467,0,0,7,7467,0.096486000,1.8451
142.227.201.92,<->,136.25.188.177,0,0,7,2144,7,2144,0.096100000,1.8632
136.25.189.29,<->,8.50.171.231,7,9259,0,0,7,9259,0.095641000,1.8759
136.25.188.254,<->,8.42.43.66,7,9163,0,0,7,9163,0.094456000,1.6904
133.201.2.177,<->,100.228.42.83,0,0,7,5383,7,5383,0.092372000,1.2068
133.178.226.80,<->,122.158.245.89,7,9147,0,0,7,9147,0.092327000,1.8256
114.90.99.163,<->,0.195.210.42,0,0,7,3723,7,3723,0.092321000,0.6648
215.158.239.47,<->,56.97.186.37,7,5051,0,0,7,5051,0.091722000,1.7124
139.241.56.117,<->,99.75.233.204,0,0,7,10192,7,10192,0.090836000,1.6669
215.158.238.212,<->,215.158.43.0,7,5086,0,0,7,5086,0.090649000,1.5674
139.241.56.116,<->,100.92.203.223,0,0,7,10191,7,10191,0.090250000,1.6680
136.25.188.250,<->,100.224.202.176,7,4528,0,0,7,4528,0.089359000,1.4740
136.25.189.36,<->,96.156.169.210,7,4019,0,0,7,4019,0.088731000,1.2094
215.158.238.135,<->,113.23.20.105,7,8955,0,0,7,8955,0.087558000,1.5889
133.178.227.76,<->,133.56.180.9,7,9059,0,0,7,9059,0.086042000,0.9338
215.158.239.57,<->,142.166.44.108,7,1873,0,0,7,1873,0.084861000,1.3630
43.52.3.19,<->,8.252.222.31,0,0,7,1784,7,1784,0.084533000,0.1430
139.241.56.117,<->,99.72.90.7,0,0,7,10192,7,10192,0.084317000,1.6698
215.158.238.82,<->,112.220.206.8,7,9003,0,0,7,9003,0.083605000,1.0321
220.39.233.209,<->,133.178.226.77,0,0,7,9051,7,9051,0.083377000,1.8296
195.127.107.104,<->,136.25.188.209,0,0,7,2593,7,2593,0.082973000,0.4693
215.158.239.21,<->,215.158.127.147,7,4886,0,0,7,4886,0.082731000,0.7126
133.178.227.1,<->,133.56.180.49,7,9092,0,0,7,9092,0.081269000,1.5096
220.28.114.28,<->,215.158.238.130,0,0,7,7126,7,7126,0.079630000,1.4001
133.178.226.90,<->,80.47.111.5,7,8747,0,0,7,8747,0.077699000,1.5779
139.241.56.117,<->,102.83.62.25,0,0,7,10191,7,10191,0.076242000,1.6697
133.178.227.8,<->,133.56.180.25,7,3787,0,0,7,3787,0.069968000,1.9270
145.182.137.222,<->,136.25.188.41,0,0,7,6488,7,6488,0.068698000,1.8595
89.153.90.193,<->,35.55.57.164,7,844,0,0,7,844,0.066921000,1.7191
53.231.66.30,<->,48.54.107.188,0,0,7,10332,7,10332,0.066805000,1.8044
215.158.44.247,<->,136.25.189.15,0,0,7,8731,7,8731,0.066473000,1.4953
215.158.238.118,<->,100.216.78.145,7,4516,0,0,7,4516,0.064335000,0.2836
133.178.227.57,<->,133.56.180.79,7,9164,0,0,7,9164,0.063110000,1.8939
114.83.250.187,<->,35.56.97.251,0,0,7,941,7,941,0.057670000,1.5045
136.25.189.18,<->,8.50.171.138,7,8891,0,0,7,8891,0.056483000,1.8851
133.178.227.57,<->,133.56.180.6,7,9229,0,0,7,9229,0.056463000,1.9320
215.158.238.65,<->,112.220.206.100,7,9195,0,0,7,9195,0.053361000,1.6087
136.25.189.14,<->,96.156.169.234,7,8259,0,0,7,8259,0.052536000,1.8019
136.25.189.46,<->,29.212.199.229,7,9003,0,0,7,9003,0.051729000,1.4692
192.204.123.1,<->,136.25.189.18,0,0,7,8795,7,8795,0.049903000,1.8600
136.25.189.17,<->,126.219.194.18,7,8795,0,0,7,8795,0.047923000,1.7741
215.158.239.26,<->,215.158.127.173,7,4013,0,0,7,4013,0.047482000,1.3550
205.243.108.178,<->,89.153.90.52,0,0,7,1112,7,1112,0.046740000,1.5037
133.178.227.40,<->,133.56.180.95,7,4603,0,0,7,4603,0.044469000,1.3779
192.67.143.126,<->,144.253.55.185,7,10191,0,0,7,10191,0.044206000,1.6800
215.158.238.73,<->,8.42.43.24,7,9067,0,0,7,9067,0.042041000,1.7830
246.253.253.213,<->,207.2.91.41,7,828,0,0,7,828,0.039357000,1.7958
139.163.17.129,<->,102.232.100.126,7,2174,0,0,7,2174,0.037834000,1.7063
221.102.143.189,<->,213.38.199.25,0,0,7,4882,7,4882,0.037189000,0.7212
136.25.189.40,<->,96.156.169.210,7,3131,0,0,7,3131,0.037063000,1.1153
133.178.227.2,<->,133.56.180.9,7,9092,0,0,7,9092,0.036814000,1.5952
139.241.56.117,<->,6.72.35.95,0,0,7,10191,7,10191,0.036487000,1.6802
204.63.182.172,<->,136.25.188.242,0,0,7,715,7,715,0.035177000,1.7795
247.136.189.52,<->,139.241.56.117,7,10191,0,0,7,10191,0.034828000,1.6803
192.67.143.126,<->,144.253.55.184,7,10192,0,0,7,10192,0.033070000,1.6800
220.28.114.28,<->,215.158.238.186,0,0,7,3814,7,3814,0.032715000,1.9040
6.145.166.151,<->,0.195.210.44,0,0,7,1323,7,1323,0.032334000,0.5911
220.28.85.14,<->,133.178.226.66,0,0,7,4137,7,4137,0.032212000,1.6240
192.204.123.22,<->,136.25.189.12,0,0,7,9083,7,9083,0.027767000,1.8511
215.158.238.83,<->,29.211.6.45,7,9099,0,0,7,9099,0.024845000,1.8767
215.158.239.49,<->,29.209.59.232,7,7731,0,0,7,7731,0.024014000,1.9192
133.178.226.37,<->,8.222.212.26,7,9163,0,0,7,9163,0.023520000,1.8339
136.25.188.197,<->,122.159.245.164,7,8779,0,0,7,8779,0.023272000,1.9540
215.158.61.189,<->,8.176.8.247,0,0,7,5568,7,5568,0.021885000,1.4317
246.253.253.101,<->,215.158.133.8,7,6010,0,0,7,6010,0.021696000,1.8507
215.158.238.66,<->,106.188.251.194,7,7862,0,0,7,7862,0.020652000,1.8830
215.158.238.134,<->,91.57.173.61,7,8731,0,0,7,8731,0.020625000,1.8217
136.25.189.14,<->,29.212.180.213,7,7811,0,0,7,7811,0.018580000,1.7942
215.158.239.92,<->,207.213.60.85,7,2076,0,0,7,2076,0.016828000,0.2349
221.102.56.69,<->,109.1.60.236,0,0,7,2058,7,2058,0.015751000,0.6795
129.236.114.39,<->,33.233.141.74,0,0,7,7194,7,7194,0.014554000,1.5026
207.236.207.74,<->,136.25.188.175,0,0,7,1439,7,1439,0.014392000,0.4686
215.158.238.73,<->,8.42.43.91,7,8923,0,0,7,8923,0.014151000,1.3315
136.25.189.77,<->,96.156.169.231,7,8051,0,0,7,8051,0.013595000,1.9676
215.158.239.79,<->,80.56.79.90,7,9478,0,0,7,9478,0.011744000,1.7690
215.158.238.82,<->,80.47.111.89,7,9323,0,0,7,9323,0.011209000,1.5274
133.178.227.14,<->,133.56.180.22,7,7976,0,0,7,7976,0.010284000,1.8822
145.13.164.200,<->,136.25.189.29,0,0,7,8195,7,8195,0.009636000,1.9376
133.178.227.24,<->,131.22.233.139,7,7790,0,0,7,7790,0.008475000,1.9177
215.158.195.25,<->,53.231.144.135,7,8625,0,0,7,8625,0.007117000,1.8751
136.25.188.178,<->,33.209.217.228,7,9487,0,0,7,9487,0.006895000,1.8198
215.158.238.135,<->,8.42.43.75,7,9051,0,0,7,9051,0.003839000,1.7555
215.158.239.85,<->,204.3.95.160,7,763,0,0,7,763,0.003597000,1.8101
220.60.81.164,<->,136.25.189.46,0,0,7,8843,7,8843,0.002529000,1.9644
133.178.226.80,<->,91.57.173.10,7,8843,0,0,7,8843,0.001712000,1.7222
136.25.189.78,<->,8.215.68.89,7,9275,0,0,7,9275,0.000491000,1.8653
17.143.152.222,<->,8.220.190.86,0,0,6,2081,6,2081,1.914723000,0.0769
231.141.44.225,<->,136.25.188.227,0,0,6,1481,6,1481,1.825048000,0.1569
143.135.166.237,<->,136.25.188.177,0,0,6,1905,6,1905,1.803241000,0.1922
215.158.239.93,<->,199.20.105.87,6,1489,0,0,6,1489,1.756993000,0.1567
98.128.112.144,<->,8.45.175.127,6,3302,0,0,6,3302,1.754751000,0.2179
199.15.202.72,<->,136.25.188.174,0,0,6,1662,6,1662,1.753803000,0.2080
136.96.191.218,<->,136.25.188.198,0,0,6,1672,6,1672,1.751599000,0.1122
204.61.154.98,<->,136.25.188.209,0,0,6,1484,6,1484,1.741797000,0.1828
244.1.41.59,<->,136.25.188.163,0,0,6,1469,6,1469,1.740537000,0.0783
215.158.239.92,<->,204.61.154.98,6,1484,0,0,6,1484,1.728247000,0.1767
220.28.108.254,<->,133.178.227.4,0,0,6,6170,6,6170,1.711631000,0.0577
215.158.239.97,<->,199.33.218.12,6,1489,0,0,6,1489,1.678913000,0.1971
207.56.99.96,<->,136.25.188.236,0,0,6,1605,6,1605,1.675341000,0.2231
221.102.56.46,<->,80.40.10.88,0,0,6,3156,6,3156,1.645746000,0.3281
199.15.232.65,<->,136.25.188.174,0,0,6,1550,6,1550,1.608676000,0.1957
57.154.233.234,<->,50.224.76.230,0,0,6,1253,6,1253,1.603058000,0.2579
143.134.201.119,<->,136.25.188.208,0,0,6,1538,6,1538,1.602640000,0.2532
215.158.140.81,<->,98.219.126.175,6,6079,0,0,6,6079,1.593305000,0.0002
145.3.163.230,<->,136.25.188.253,0,0,6,1241,6,1241,1.588719000,0.3971
133.178.226.95,<->,100.120.38.6,6,5401,0,0,6,5401,1.582105000,0.0683
215.158.239.105,<->,215.158.61.189,6,3776,0,0,6,3776,1.579033000,0.3810
146.249.227.195,<->,8.252.222.140,0,0,6,1540,6,1540,1.571467000,0.2061
142.244.238.65,<->,136.25.188.220,0,0,6,1489,6,1489,1.568790000,0.1987
142.229.16.33,<->,136.25.188.199,0,0,6,1488,6,1488,1.550134000,0.2164
204.200.44.112,<->,136.25.188.197,0,0,6,1473,6,1473,1.539328000,0.1316
144.101.142.22,<->,136.25.188.253,0,0,6,1469,6,1469,1.537904000,0.0312
159.162.25.67,<->,8.182.251.218,0,0,6,1352,6,1352,1.520240000,0.1683
212.70.99.177,<->,8.220.200.124,0,0,6,2608,6,2608,1.511461000,0.4254
199.122.62.229,<->,136.25.188.236,0,0,6,1775,6,1775,1.508171000,0.1979
142.167.129.36,<->,136.25.188.242,0,0,6,1672,6,1672,1.503998000,0.2996
215.158.61.243,<->,8.176.8.197,0,0,6,5482,6,5482,1.496487000,0.4546
98.105.42.28,<->,8.252.222.46,0,0,6,1469,6,1469,1.476997000,0.1341
195.41.100.177,<->,136.25.188.236,0,0,6,1481,6,1481,1.464979000,0.4708
215.158.239.92,<->,142.248.16.154,6,3329,0,0,6,3329,1.462352000,0.2869
204.61.12.222,<->,136.25.188.220,0,0,6,1490,6,1490,1.461142000,0.2439
199.72.43.25,<->,136.25.188.160,0,0,6,1661,6,1661,1.445384000,0.4526
204.200.37.111,<->,136.25.188.238,0,0,6,2162,6,2162,1.416820000,0.4892
195.15.226.84,<->,136.25.188.252,0,0,6,1483,6,1483,1.414875000,0.1693
142.195.173.168,<->,136.25.188.242,0,0,6,1651,6,1651,1.410475000,0.3274
215.158.239.70,<->,195.81.47.95,6,1656,0,0,6,1656,1.405476000,0.5392
218.111.161.49,<->,8.220.176.253,0,0,6,1638,6,1638,1.403632000,0.3667
136.25.188.246,<->,56.23.171.47,6,3542,0,0,6,3542,1.397170000,0.5754
199.39.46.92,<->,136.25.188.243,0,0,6,1394,6,1394,1.389234000,0.4596
142.221.6.28,<->,136.25.188.252,0,0,6,1483,6,1483,1.360816000,0.2215
221.102.56.46,<->,192.64.248.163,0,0,6,1900,6,1900,1.351113000,0.1862
194.232.233.141,<->,136.25.188.238,0,0,6,1488,6,1488,1.345348000,0.5285
145.13.164.229,<->,136.25.189.2,0,0,6,5654,6,5654,1.335540000,0.6111
215.158.239.56,<->,199.20.109.177,6,2100,0,0,6,2100,1.324135000,0.5252
199.71.8.221,<->,136.25.188.252,0,0,6,1488,6,1488,1.308814000,0.6878
142.253.219.46,<->,136.25.188.253,0,0,6,1488,6,1488,1.303145000,0.2484
136.25.189.29,<->,96.135.155.29,6,7294,0,0,6,7294,1.300796000,0.3446
132.18.67.29,<->,111.147.180.135,0,0,6,3597,6,3597,1.300257000,0.4894
142.248.197.65,<->,136.25.188.239,0,0,6,1273,6,1273,1.297985000,0.2619
204.200.46.60,<->,136.25.188.178,0,0,6,1475,6,1475,1.296186000,0.1951
228.205.242.55,<->,159.137.247.157,0,0,6,8202,6,8202,1.259002000,0.4768
143.10.50.22,<->,136.25.188.197,0,0,6,1490,6,1490,1.237246000,0.3108
199.69.182.51,<->,136.25.188.255,0,0,6,1662,6,1662,1.236883000,0.3478
143.134.208.181,<->,136.25.188.224,0,0,6,1678,6,1678,1.232903000,0.2354
143.10.117.183,<->,136.25.188.255,0,0,6,2136,6,2136,1.226909000,0.5442
215.158.239.58,<->,199.20.31.129,6,1606,0,0,6,1606,1.225650000,0.2786
207.56.104.108,<->,136.25.188.54,0,0,6,1482,6,1482,1.225436000,0.7325
136.141.45.155,<->,101.70.127.50,0,0,6,2454,6,2454,1.203778000,0.1455
215.158.239.92,<->,199.20.7.43,6,2885,0,0,6,2885,1.198209000,0.4095
199.15.38.78,<->,136.25.188.239,0,0,6,1258,6,1258,1.198039000,0.2779
215.158.239.96,<->,195.83.105.182,6,1688,0,0,6,1688,1.175697000,0.6895
97.126.0.114,<->,56.121.22.229,6,1948,0,0,6,1948,1.172182000,0.1763
144.232.192.125,<->,132.168.198.156,0,0,6,2604,6,2604,1.165445000,0.1506
215.158.239.22,<->,96.135.154.156,6,5396,0,0,6,5396,1.156014000,0.4317
199.83.56.50,<->,136.25.188.53,0,0,6,1482,6,1482,1.131799000,0.7899
145.116.209.71,<->,136.25.188.59,0,0,6,3806,6,3806,1.129724000,0.4409
215.158.239.51,<->,196.91.5.248,6,1688,0,0,6,1688,1.125501000,0.7899
136.25.188.221,<->,8.222.212.42,6,7838,0,0,6,7838,1.123770000,0.8418
111.199.225.227,<->,0.195.210.44,0,0,6,522,6,522,1.120614000,0.1226
142.253.240.20,<->,136.25.188.211,0,0,6,1490,6,1490,1.101341000,0.2848
254.126.111.238,<->,109.2.122.176,0,0,6,1476,6,1476,1.094851000,0.6661
220.50.215.89,<->,50.224.80.75,0,0,6,2222,6,2222,1.088340000,0.8008
215.158.239.92,<->,142.223.243.28,6,1487,0,0,6,1487,1.087638000,0.2673
195.14.10.115,<->,136.25.188.236,0,0,6,1556,6,1556,1.087493000,0.3432
137.69.224.129,<->,8.182.243.141,0,0,6,1148,6,1148,1.073483000,0.3582
17.22.250.252,<->,8.20.87.187,0,0,6,2400,6,2400,1.062229000,0.0962
254.177.165.75,<->,215.158.238.94,0,0,6,4894,6,4894,1.061380000,0.2395
142.208.234.83,<->,136.25.188.224,0,0,6,1484,6,1484,1.052551000,0.2198
136.25.188.163,<->,6.141.223.146,6,1199,0,0,6,1199,1.034839000,0.0560
144.72.195.98,<->,102.50.40.7,0,0,6,5619,6,5619,1.030277000,0.4773
220.20.200.112,<->,132.216.159.4,6,4159,0,0,6,4159,1.003935000,0.1647
111.146.208.32,<->,54.53.138.166,6,1674,0,0,6,1674,1.002450000,0.9137
215.158.30.252,<->,136.25.188.234,0,0,6,3503,6,3503,0.996778000,0.4310
142.236.216.98,<->,136.25.188.253,0,0,6,2819,6,2819,0.995482000,0.6749
215.158.239.96,<->,195.55.37.34,6,1483,0,0,6,1483,0.986478000,0.1638
215.158.239.206,<->,137.107.106.103,6,4822,0,0,6,4822,0.976936000,0.9528
113.224.111.103,<->,50.224.89.241,0,0,6,1039,6,1039,0.976357000,0.2231
138.100.120.14,<->,8.52.163.19,0,0,6,1684,6,1684,0.970299000,0.0885
142.244.253.29,<->,136.25.188.238,0,0,6,2445,6,2445,0.970126000,0.0397
210.220.219.182,<->,53.200.149.3,6,6193,0,0,6,6193,0.967929000,0.5411
97.11.170.243,<->,53.243.12.169,6,1217,0,0,6,1217,0.961968000,0.5715
97.11.170.243,<->,53.214.127.174,6,2786,0,0,6,2786,0.955087000,0.2842
133.32.39.1,<->,14.75.233.199,6,5169,0,0,6,5169,0.948999000,0.0635
8.182.243.141,<->,6.133.205.181,6,1148,0,0,6,1148,0.945007000,0.1895
215.158.239.48,<->,143.42.138.19,6,1507,0,0,6,1507,0.942747000,0.4876
215.158.239.24,<->,215.158.127.152,6,7877,0,0,6,7877,0.937847000,0.2894
215.158.239.21,<->,96.135.154.142,6,5841,0,0,6,5841,0.913651000,0.9821
207.61.104.245,<->,136.25.188.220,0,0,6,1657,6,1657,0.907976000,0.2567
215.158.239.73,<->,111.52.91.112,6,2501,0,0,6,2501,0.905010000,0.1617
199.38.106.248,<->,136.25.188.237,0,0,6,1482,6,1482,0.904592000,0.3473
215.158.239.93,<->,199.14.85.95,6,1453,0,0,6,1453,0.902750000,0.2038
81.96.70.52,<->,80.27.158.234,0,0,6,1472,6,1472,0.902067000,0.0503
215.158.239.56,<->,199.72.57.71,6,1481,0,0,6,1481,0.901825000,0.1907
143.44.245.177,<->,136.25.188.220,0,0,6,1621,6,1621,0.882020000,0.3844
143.132.196.96,<->,136.25.188.52,0,0,6,1226,6,1226,0.878243000,0.0380
215.158.239.69,<->,207.188.63.169,6,1487,0,0,6,1487,0.865347000,0.3322
194.232.237.196,<->,136.25.188.220,0,0,6,1486,6,1486,0.864900000,0.5588
215.158.238.147,<->,0.195.237.14,6,5224,0,0,6,5224,0.862191000,1.0755
215.158.239.49,<->,145.13.164.193,6,6662,0,0,6,6662,0.861463000,0.8626
99.151.84.213,<->,8.182.224.180,0,0,6,1634,6,1634,0.854643000,0.3558
207.61.88.169,<->,136.25.188.177,0,0,6,1285,6,1285,0.852649000,1.0029
215.158.239.92,<->,194.251.130.243,6,1650,0,0,6,1650,0.847146000,0.1593
215.158.239.79,<->,195.4.176.240,6,1480,0,0,6,1480,0.835615000,0.2649
111.150.186.97,<->,6.73.247.116,0,0,6,8703,6,8703,0.835137000,0.0085
142.234.32.238,<->,8.52.175.115,0,0,6,1181,6,1181,0.834502000,1.0378
215.158.238.82,<->,126.219.194.141,6,6246,0,0,6,6246,0.823650000,0.9437
215.158.239.56,<->,196.89.223.114,6,5630,0,0,6,5630,0.821857000,0.6321
215.158.239.48,<->,195.126.170.210,6,2132,0,0,6,2132,0.821237000,0.8170
199.80.85.234,<->,136.25.188.225,0,0,6,1661,6,1661,0.817732000,0.2596
195.4.32.221,<->,136.25.188.238,0,0,6,1860,6,1860,0.815273000,0.6100
215.158.238.203,<->,98.219.126.175,6,5470,0,0,6,5470,0.805162000,1.1542
215.158.239.55,<->,100.224.202.145,6,3758,0,0,6,3758,0.798961000,0.8664
215.158.239.56,<->,194.237.78.238,6,1489,0,0,6,1489,0.794744000,0.1801
215.158.239.56,<->,195.13.248.126,6,2676,0,0,6,2676,0.785553000,0.4901
195.71.148.54,<->,136.25.188.174,0,0,6,1391,6,1391,0.775296000,0.1535
207.62.152.200,<->,136.25.188.174,0,0,6,1544,6,1544,0.765151000,0.5218
220.28.115.46,<->,215.158.239.82,0,0,6,5429,6,5429,0.761319000,1.0665
207.61.58.64,<->,136.25.188.198,0,0,6,1600,6,1600,0.759020000,0.4582
216.79.129.253,<->,8.183.25.124,0,0,6,1432,6,1432,0.740915000,0.3235
215.158.238.91,<->,100.216.78.145,6,6082,0,0,6,6082,0.719334000,0.2035
235.65.148.186,<->,92.27.219.23,0,0,6,5496,6,5496,0.713686000,1.2167
129.236.114.39,<->,33.233.141.76,0,0,6,6431,6,6431,0.712399000,0.9362
133.178.226.93,<->,96.155.60.205,6,4599,0,0,6,4599,0.709856000,1.1073
142.229.18.200,<->,136.25.188.45,0,0,6,1451,6,1451,0.705706000,1.1107
220.28.109.52,<->,136.25.188.228,0,0,6,5897,6,5897,0.702012000,0.8270
215.158.239.51,<->,195.6.47.59,6,1528,0,0,6,1528,0.700874000,1.1697
142.229.89.36,<->,136.25.188.236,0,0,6,1443,6,1443,0.697995000,0.5373
99.162.77.146,<->,53.243.9.83,6,1740,0,0,6,1740,0.692790000,1.2345
159.162.33.63,<->,8.182.227.71,0,0,6,2257,6,2257,0.692664000,1.1730
215.158.239.68,<->,196.93.217.19,6,1765,0,0,6,1765,0.691480000,0.2497
192.204.123.11,<->,136.25.189.29,0,0,6,6726,6,6726,0.687881000,0.8395
133.178.226.61,<->,8.42.43.75,6,7790,0,0,6,7790,0.682905000,1.1882
109.1.58.226,<->,103.115.97.227,6,987,0,0,6,987,0.679661000,0.8560
143.129.192.211,<->,136.25.188.176,0,0,6,1487,6,1487,0.677766000,0.2080
192.67.94.121,<->,112.208.20.177,6,1043,0,0,6,1043,0.677066000,1.2444
66.47.141.130,<->,8.252.222.150,0,0,6,1820,6,1820,0.662403000,0.7982
133.178.226.23,<->,96.155.60.254,6,3034,0,0,6,3034,0.646686000,1.3509
197.113.99.241,<->,136.25.188.163,0,0,6,2750,6,2750,0.635066000,1.1091
215.158.239.77,<->,204.1.219.196,6,1451,0,0,6,1451,0.631845000,0.6090
136.25.188.238,<->,108.130.46.151,6,1256,0,0,6,1256,0.625829000,0.0345
95.244.92.36,<->,8.252.221.206,0,0,6,1883,6,1883,0.602275000,1.0693
142.221.254.70,<->,136.25.188.242,0,0,6,2130,6,2130,0.588664000,1.0561
133.178.227.41,<->,8.240.116.180,6,6421,0,0,6,6421,0.586301000,1.1617
159.36.5.214,<->,136.25.188.253,0,0,6,1476,6,1476,0.578295000,0.0345
215.158.239.96,<->,142.254.70.115,6,2341,0,0,6,2341,0.577262000,0.4668
204.20.159.71,<->,136.25.188.253,0,0,6,1483,6,1483,0.575565000,0.0584
204.2.103.102,<->,136.25.188.196,0,0,6,1482,6,1482,0.575550000,0.2599
89.155.251.27,<->,8.182.227.14,0,0,6,2734,6,2734,0.569544000,0.2196
220.28.104.193,<->,215.158.238.84,0,0,6,3443,6,3443,0.569323000,0.3575
136.25.188.211,<->,100.224.202.189,6,2509,0,0,6,2509,0.566111000,0.6135
111.147.237.123,<->,0.195.218.61,6,942,0,0,6,942,0.565815000,1.3497
215.158.239.86,<->,29.209.59.196,6,5262,0,0,6,5262,0.565593000,1.3292
220.28.73.211,<->,133.178.227.4,0,0,6,4476,6,4476,0.561748000,1.4160
215.158.239.87,<->,204.56.187.168,6,1274,0,0,6,1274,0.553286000,0.1730
136.25.188.47,<->,111.151.239.87,6,7742,0,0,6,7742,0.550964000,1.2860
148.211.214.186,<->,139.47.239.40,0,0,6,763,6,763,0.550848000,0.9984
215.158.238.133,<->,33.209.217.212,6,7084,0,0,6,7084,0.548686000,1.1132
142.167.148.25,<->,136.25.188.237,0,0,6,1488,6,1488,0.547890000,0.1973
195.70.205.92,<->,136.25.188.238,0,0,6,1299,6,1299,0.546617000,0.2110
207.236.205.138,<->,136.25.188.242,0,0,6,1329,6,1329,0.546414000,0.2102
143.134.29.192,<->,136.25.188.53,0,0,6,1389,6,1389,0.542163000,0.3403
142.220.64.205,<->,136.25.188.174,0,0,6,1287,6,1287,0.541557000,0.3816
143.68.254.229,<->,136.25.188.198,0,0,6,1482,6,1482,0.539324000,0.9363
143.128.136.182,<->,136.25.188.53,0,0,6,1489,6,1489,0.534656000,0.5310
136.25.188.172,<->,122.159.245.163,6,8030,0,0,6,8030,0.532527000,1.3520
133.56.201.50,<->,8.52.189.207,0,0,6,2226,6,2226,0.529911000,0.4410
136.25.188.44,<->,80.47.111.72,6,7374,0,0,6,7374,0.529601000,1.4369
215.158.133.22,<->,8.176.8.183,0,0,6,2642,6,2642,0.526485000,1.3742
139.148.178.253,<->,8.182.253.40,0,0,6,1237,6,1237,0.525519000,0.0934
207.61.57.220,<->,136.25.188.173,0,0,6,2757,6,2757,0.519439000,0.9998
195.70.205.92,<->,136.25.188.226,0,0,6,1514,6,1514,0.514340000,0.1719
247.136.221.242,<->,133.73.194.45,6,1623,0,0,6,1623,0.513278000,0.6827
215.158.239.85,<->,199.51.197.185,6,1262,0,0,6,1262,0.497490000,0.3201
194.252.68.50,<->,0.195.210.33,0,0,6,729,6,729,0.496239000,1.1225
159.215.65.173,<->,136.25.188.228,0,0,6,1734,6,1734,0.493912000,0.8992
207.58.49.144,<->,136.25.188.198,0,0,6,1267,6,1267,0.492511000,1.4513
136.25.188.177,<->,100.224.202.175,6,2066,0,0,6,2066,0.488283000,0.8501
215.158.239.48,<->,195.127.171.142,6,1500,0,0,6,1500,0.484802000,0.1845
231.142.17.21,<->,136.25.188.199,0,0,6,1486,6,1486,0.478803000,1.4913
136.25.189.29,<->,33.209.219.165,6,6206,0,0,6,6206,0.474958000,1.2663
142.220.120.173,<->,136.25.188.176,0,0,6,1344,6,1344,0.474601000,0.2752
58.143.193.33,<->,8.252.222.134,0,0,6,1484,6,1484,0.474186000,0.1726
215.158.30.253,<->,8.252.222.57,0,0,6,2648,6,2648,0.471559000,0.8607
199.14.179.172,<->,136.25.188.255,0,0,6,2861,6,2861,0.468783000,0.9640
221.102.143.189,<->,220.80.156.5,0,0,6,2925,6,2925,0.461958000,1.1767
215.158.239.68,<->,194.251.72.26,6,1320,0,0,6,1320,0.460717000,0.1722
192.204.123.54,<->,136.25.189.57,0,0,6,8126,6,8126,0.459728000,1.2710
215.158.30.254,<->,8.252.222.55,0,0,6,4016,6,4016,0.458178000,0.1550
215.158.239.51,<->,199.121.171.59,6,2645,0,0,6,2645,0.457322000,1.0707
215.158.239.66,<->,96.155.60.207,6,2430,0,0,6,2430,0.448260000,0.9954
199.72.28.204,<->,136.25.188.238,0,0,6,1483,6,1483,0.448039000,0.5661
215.158.239.211,<->,145.82.220.164,6,1974,0,0,6,1974,0.443752000,0.4264
136.25.189.76,<->,80.56.79.71,6,7960,0,0,6,7960,0.438845000,1.4225
195.85.122.92,<->,80.42.160.193,0,0,6,708,6,708,0.436564000,1.5072
215.158.61.183,<->,8.176.8.224,0,0,6,6298,6,6298,0.429339000,1.4164
152.19.29.118,<->,145.16.82.40,0,0,6,6285,6,6285,0.427783000,1.4378
215.158.61.145,<->,8.176.8.224,0,0,6,5796,6,5796,0.414057000,1.4375
136.25.188.237,<->,104.3.168.213,6,7774,0,0,6,7774,0.408695000,0.8772
215.158.239.44,<->,111.52.91.239,6,3301,0,0,6,3301,0.408370000,1.3427
136.25.189.16,<->,29.211.228.165,6,6102,0,0,6,6102,0.404288000,1.2964
136.25.188.45,<->,126.219.247.59,6,7790,0,0,6,7790,0.403299000,1.5719
136.25.189.57,<->,8.215.68.89,6,7630,0,0,6,7630,0.400165000,1.4522
136.25.188.192,<->,100.224.138.208,6,3030,0,0,6,3030,0.400130000,1.2007
143.89.63.84,<->,136.25.188.253,0,0,6,1888,6,1888,0.399183000,0.2769
136.25.188.220,<->,131.36.198.35,6,8497,0,0,6,8497,0.397879000,1.5155
142.207.48.53,<->,136.25.188.163,0,0,6,1668,6,1668,0.397067000,0.3632
215.158.239.48,<->,199.20.28.93,6,1608,0,0,6,1608,0.396080000,0.2896
136.25.189.33,<->,8.222.98.100,6,7014,0,0,6,7014,0.391562000,1.4916
215.158.238.133,<->,122.159.245.155,6,7486,0,0,6,7486,0.390652000,1.5408
136.25.189.20,<->,96.156.169.238,6,5838,0,0,6,5838,0.387778000,1.3357
220.28.115.46,<->,215.158.238.146,0,0,6,5964,6,5964,0.385079000,1.5065
136.25.188.226,<->,80.47.111.72,6,7694,0,0,6,7694,0.384503000,1.2810
8.20.87.92,<->,6.145.149.209,6,1562,0,0,6,1562,0.380650000,0.3423
143.42.0.200,<->,136.25.188.198,0,0,6,1603,6,1603,0.380613000,0.5881
222.68.66.166,<->,132.216.20.84,6,1406,0,0,6,1406,0.379864000,0.3311
215.158.238.64,<->,131.36.198.50,6,8186,0,0,6,8186,0.379157000,1.3005
145.7.22.134,<->,100.228.42.103,0,0,6,1774,6,1774,0.377491000,1.1362
215.158.239.94,<->,133.56.180.55,6,7854,0,0,6,7854,0.377270000,1.4865
220.28.73.211,<->,215.158.140.88,0,0,6,3678,6,3678,0.376959000,1.5629
136.25.189.34,<->,126.219.194.91,6,6676,0,0,6,6676,0.375351000,1.4571
215.158.238.82,<->,80.47.111.73,6,7358,0,0,6,7358,0.374535000,1.6130
142.248.143.211,<->,136.25.188.196,0,0,6,1224,6,1224,0.374025000,0.0384
102.118.144.248,<->,100.228.42.160,0,0,6,2009,6,2009,0.371876000,1.2904
215.158.238.190,<->,131.22.233.154,6,6426,0,0,6,6426,0.368481000,1.5307
142.236.194.239,<->,136.25.188.54,0,0,6,1992,6,1992,0.361427000,0.5335
136.25.188.44,<->,112.235.95.74,6,7662,0,0,6,7662,0.360692000,1.5542
220.28.114.28,<->,136.25.189.23,0,0,6,3362,6,3362,0.359074000,1.2146
136.25.188.253,<->,111.151.239.53,6,7694,0,0,6,7694,0.358608000,1.3604
97.94.150.221,<->,50.224.108.163,0,0,6,1860,6,1860,0.353799000,0.1972
111.42.21.99,<->,8.176.8.86,0,0,6,2491,6,2491,0.349825000,1.3074
133.178.227.76,<->,133.56.180.82,6,7705,0,0,6,7705,0.349663000,1.1437
136.25.188.199,<->,8.255.92.251,6,6534,0,0,6,6534,0.348411000,1.1954
195.13.125.184,<->,136.25.188.237,0,0,6,1479,6,1479,0.339758000,0.1732
142.220.64.205,<->,136.25.188.178,0,0,6,1286,6,1286,0.337584000,0.3048
215.158.239.52,<->,138.45.90.210,6,3574,0,0,6,3574,0.337572000,1.0334
136.25.188.176,<->,84.14.253.204,6,1891,0,0,6,1891,0.336227000,0.3783
215.158.239.204,<->,8.235.72.34,6,1356,0,0,6,1356,0.335672000,1.2414
221.102.56.46,<->,80.41.223.64,0,0,6,1702,6,1702,0.334943000,0.5803
221.102.143.189,<->,6.74.79.98,0,0,6,6766,6,6766,0.334892000,0.6089
215.158.238.126,<->,0.195.237.14,6,6762,0,0,6,6762,0.333526000,1.3696
146.188.134.161,<->,89.183.109.119,0,0,6,1591,6,1591,0.333525000,1.6474
199.83.1.136,<->,136.25.188.46,0,0,6,1603,6,1603,0.332033000,0.3112
215.158.214.223,<->,8.176.8.88,0,0,6,3750,6,3750,0.330305000,1.5716
215.158.238.133,<->,112.220.206.126,6,7502,0,0,6,7502,0.326311000,1.5811
215.158.239.96,<->,194.232.14.110,6,1444,0,0,6,1444,0.326297000,0.5744
133.178.226.60,<->,8.222.212.8,6,7886,0,0,6,7886,0.324777000,1.6555
111.150.187.184,<->,8.252.223.131,0,0,6,6672,6,6672,0.322624000,1.5555
136.25.189.27,<->,96.156.169.210,6,3238,0,0,6,3238,0.321177000,1.5596
201.143.50.223,<->,8.252.222.62,0,0,6,1823,6,1823,0.320328000,0.0178
199.33.119.216,<->,136.25.188.163,0,0,6,1462,6,1462,0.319839000,0.4083
207.193.109.109,<->,136.25.188.174,0,0,6,1481,6,1481,0.319783000,0.4379
223.122.173.123,<->,0.195.210.46,0,0,6,1829,6,1829,0.319494000,0.7823
215.158.239.50,<->,199.72.51.187,6,1963,0,0,6,1963,0.318416000,0.4712
215.158.239.100,<->,91.40.201.100,6,1338,0,0,6,1338,0.317109000,1.1105
80.41.11.154,<->,53.148.181.151,6,4767,0,0,6,4767,0.314619000,1.4491
136.25.188.230,<->,133.56.180.88,6,2726,0,0,6,2726,0.313773000,1.2344
192.204.123.37,<->,136.25.189.77,0,0,6,7934,6,7934,0.313681000,1.6291
80.42.184.215,<->,8.55.237.110,6,2068,0,0,6,2068,0.309885000,1.2449
215.158.239.72,<->,111.52.91.115,6,2536,0,0,6,2536,0.308778000,1.3636
220.39.233.164,<->,215.158.238.64,0,0,6,7806,6,7806,0.308241000,1.4765
99.162.77.146,<->,53.243.12.169,6,1417,0,0,6,1417,0.306543000,1.1623
136.25.188.254,<->,29.214.108.128,6,7742,0,0,6,7742,0.304893000,1.6152
215.158.239.56,<->,204.226.93.164,6,1424,0,0,6,1424,0.304838000,0.6115
199.50.23.168,<->,136.25.188.44,0,0,6,1443,6,1443,0.301055000,0.6093
231.142.143.107,<->,215.158.239.48,0,0,6,1875,6,1875,0.300907000,0.2140
136.25.188.49,<->,96.156.169.176,6,3238,0,0,6,3238,0.300721000,1.3457
215.158.238.190,<->,8.190.217.84,6,6357,0,0,6,6357,0.300460000,1.6225
204.56.13.140,<->,136.25.188.174,0,0,6,1236,6,1236,0.300198000,0.0394
133.178.226.31,<->,8.42.43.59,6,7630,0,0,6,7630,0.297585000,1.5731
215.158.61.145,<->,8.176.8.179,0,0,6,4018,6,4018,0.297318000,0.7761
215.158.239.62,<->,139.5.114.133,6,3126,0,0,6,3126,0.297083000,0.7328
210.222.223.220,<->,136.25.188.38,0,0,6,5315,6,5315,0.296414000,0.8882
136.25.189.32,<->,56.161.218.54,6,7918,0,0,6,7918,0.295922000,1.5619
136.25.189.31,<->,56.28.207.214,6,6726,0,0,6,6726,0.295615000,1.6536
215.158.238.41,<->,0.195.253.228,6,6434,0,0,6,6434,0.293232000,1.1013
215.158.238.47,<->,145.116.209.75,6,3042,0,0,6,3042,0.288179000,1.0445
133.178.226.18,<->,8.42.43.65,6,7374,0,0,6,7374,0.287403000,1.5943
136.25.188.175,<->,57.160.181.238,6,8416,0,0,6,8416,0.281391000,1.5161
133.178.226.29,<->,126.219.194.151,6,7806,0,0,6,7806,0.281215000,1.3836
215.158.140.231,<->,33.209.217.8,6,6523,0,0,6,6523,0.280854000,1.3967
215.158.238.64,<->,131.1.195.187,6,8494,0,0,6,8494,0.279339000,1.4241
149.250.115.24,<->,136.25.188.160,0,0,6,7182,6,7182,0.274076000,1.4163
207.102.130.131,<->,8.252.222.187,0,0,6,1457,6,1457,0.272494000,1.4998
89.183.107.124,<->,35.62.70.46,6,573,0,0,6,573,0.266427000,0.1091
215.158.238.97,<->,91.57.173.21,6,7582,0,0,6,7582,0.264962000,1.7138
200.174.154.235,<->,54.38.214.95,6,2836,0,0,6,2836,0.263739000,1.5213
220.28.104.193,<->,215.158.239.72,0,0,6,5320,6,5320,0.261097000,1.7141
100.174.4.83,<->,8.182.227.71,0,0,6,1721,6,1721,0.260772000,0.2627
139.163.96.101,<->,29.128.255.1,6,1674,0,0,6,1674,0.259714000,1.6578
199.80.178.34,<->,136.25.188.222,0,0,6,1495,6,1495,0.256611000,0.2423
133.178.227.22,<->,133.56.180.94,6,3165,0,0,6,3165,0.256196000,1.6285
133.178.226.28,<->,29.214.108.120,6,5534,0,0,6,5534,0.251142000,1.5857
99.169.247.245,<->,8.20.87.254,0,0,6,1800,6,1800,0.247631000,1.7200
136.25.189.58,<->,29.214.108.255,6,6774,0,0,6,6774,0.247015000,1.6757
136.25.188.44,<->,8.222.7.55,6,7662,0,0,6,7662,0.246822000,1.3803
143.132.118.227,<->,136.25.188.173,0,0,6,1800,6,1800,0.246335000,0.1998
139.36.120.116,<->,99.74.87.236,0,0,6,3107,6,3107,0.245837000,0.3213
215.158.239.87,<->,29.211.228.203,6,6982,0,0,6,6982,0.245261000,1.6051
215.158.238.83,<->,57.210.107.1,6,5739,0,0,6,5739,0.243426000,1.4954
207.83.29.78,<->,139.163.7.204,0,0,6,2736,6,2736,0.242748000,1.6451
215.158.61.191,<->,136.25.189.202,0,0,6,3788,6,3788,0.239982000,1.4430
136.25.188.254,<->,91.57.173.26,6,7646,0,0,6,7646,0.239494000,1.6573
111.147.134.209,<->,54.58.49.91,6,670,0,0,6,670,0.238462000,1.7550
149.250.115.7,<->,133.178.226.90,0,0,6,7406,6,7406,0.236233000,1.6023
136.25.188.45,<->,122.158.245.146,6,7870,0,0,6,7870,0.235242000,1.4541
43.52.205.17,<->,8.252.222.149,0,0,6,2467,6,2467,0.233443000,0.3350
220.60.81.132,<->,136.25.189.77,0,0,6,7822,6,7822,0.233235000,1.5224
247.136.208.249,<->,221.102.56.69,6,1764,0,0,6,1764,0.233134000,1.6612
136.25.188.236,<->,131.1.232.85,6,6886,0,0,6,6886,0.229851000,1.5815
136.25.189.13,<->,29.212.180.227,6,7646,0,0,6,7646,0.229831000,1.6921
215.158.239.95,<->,96.156.169.202,6,7582,0,0,6,7582,0.228128000,1.7203
215.158.140.83,<->,139.8.186.137,6,6298,0,0,6,6298,0.226418000,1.6164
136.25.189.95,<->,96.156.169.218,6,3862,0,0,6,3862,0.224650000,1.0970
138.79.143.196,<->,98.108.20.240,0,0,6,2275,6,2275,0.223363000,0.9292
215.158.44.185,<->,136.25.189.28,0,0,6,5486,6,5486,0.222637000,1.6327
149.57.173.231,<->,139.163.96.101,0,0,6,1602,6,1602,0.221781000,1.6765
215.158.239.95,<->,142.237.129.145,6,1287,0,0,6,1287,0.221301000,0.3789
215.158.140.88,<->,98.219.126.175,6,1944,0,0,6,1944,0.220825000,1.3991
136.25.189.1,<->,29.212.198.167,6,7422,0,0,6,7422,0.220231000,1.7488
215.158.140.93,<->,8.53.216.233,6,6708,0,0,6,6708,0.218567000,1.6191
215.158.238.145,<->,97.174.232.216,6,4992,0,0,6,4992,0.217814000,1.6882
215.158.239.24,<->,96.135.154.114,6,5098,0,0,6,5098,0.216703000,1.6826
136.25.188.173,<->,91.57.173.54,6,7758,0,0,6,7758,0.216216000,1.6780
133.178.226.7,<->,8.42.43.40,6,6230,0,0,6,6230,0.214805000,1.3060
136.25.188.197,<->,29.211.6.54,6,8030,0,0,6,8030,0.214518000,1.7321
215.158.238.67,<->,126.219.194.106,6,8268,0,0,6,8268,0.212707000,1.3957
215.158.238.143,<->,8.42.43.9,6,7790,0,0,6,7790,0.210746000,1.5094
215.158.239.87,<->,196.88.134.222,6,1266,0,0,6,1266,0.208539000,0.2256
97.126.112.237,<->,53.86.85.35,6,3200,0,0,6,3200,0.208476000,0.9027
196.97.162.45,<->,133.32.39.1,0,0,6,2201,6,2201,0.207071000,0.1171
143.13.34.41,<->,136.25.188.242,0,0,6,1953,6,1953,0.205437000,0.6948
215.158.238.129,<->,97.174.232.252,6,3793,0,0,6,3793,0.200850000,1.6380
136.25.188.172,<->,8.255.92.214,6,6678,0,0,6,6678,0.200539000,1.6316
215.158.238.90,<->,100.216.78.145,6,5830,0,0,6,5830,0.199841000,0.4570
215.158.238.143,<->,113.23.104.221,6,7470,0,0,6,7470,0.199168000,1.6175
215.158.140.84,<->,53.231.142.158,6,2687,0,0,6,2687,0.197702000,0.0538
215.158.61.202,<->,8.176.8.188,0,0,6,5991,6,5991,0.196071000,1.4758
215.158.239.71,<->,80.56.79.10,6,7854,0,0,6,7854,0.195964000,1.7019
199.80.3.28,<->,136.25.188.163,0,0,6,5372,6,5372,0.195876000,1.1018
136.25.189.13,<->,126.219.194.25,6,8046,0,0,6,8046,0.195353000,1.6855
133.178.227.27,<->,8.240.116.196,6,6495,0,0,6,6495,0.195180000,1.4976
215.158.238.135,<->,131.1.232.134,6,7710,0,0,6,7710,0.194214000,1.6066
215.158.239.32,<->,8.252.214.212,6,2625,0,0,6,2625,0.192346000,1.6198
136.25.188.210,<->,122.158.245.86,6,7630,0,0,6,7630,0.192149000,1.7472
215.158.140.88,<->,98.219.126.140,6,4887,0,0,6,4887,0.189466000,1.7351
142.208.205.70,<->,136.25.188.196,0,0,6,1669,6,1669,0.187237000,0.4033
220.28.114.28,<->,215.158.238.187,0,0,6,2315,6,2315,0.185516000,1.8027
136.25.188.252,<->,8.42.43.58,6,7902,0,0,6,7902,0.182249000,1.5700
136.25.189.81,<->,96.156.169.163,6,5550,0,0,6,5550,0.180690000,1.1031
220.28.108.254,<->,133.178.227.21,0,0,6,3064,6,3064,0.176446000,1.7946
95.245.75.254,<->,8.252.222.160,0,0,6,2934,6,2934,0.176386000,1.7085
133.178.226.77,<->,96.155.60.232,6,2473,0,0,6,2473,0.175954000,1.4817
207.92.34.215,<->,8.252.222.63,0,0,6,1490,6,1490,0.175639000,0.0778
142.229.148.211,<->,136.25.188.224,0,0,6,2115,6,2115,0.175292000,0.3960
136.25.189.33,<->,56.28.207.192,6,5598,0,0,6,5598,0.173647000,1.7287
215.158.239.59,<->,126.219.194.19,6,7614,0,0,6,7614,0.170971000,1.7927
215.158.238.82,<->,29.211.6.62,6,7614,0,0,6,7614,0.169207000,1.6771
199.15.37.187,<->,136.25.188.222,0,0,6,2857,6,2857,0.169181000,1.7944
215.158.61.202,<->,136.25.188.35,0,0,6,6133,6,6133,0.168312000,1.6693
136.25.188.45,<->,8.42.43.90,6,8014,0,0,6,8014,0.168167000,1.8090
136.25.189.17,<->,29.214.108.215,6,7310,0,0,6,7310,0.168105000,1.6001
207.231.198.197,<->,8.252.222.236,0,0,6,4263,6,4263,0.166955000,1.7946
215.158.238.94,<->,112.220.206.18,6,7598,0,0,6,7598,0.166206000,1.6496
215.158.238.32,<->,80.47.111.67,6,7694,0,0,6,7694,0.164045000,1.6109
194.234.232.96,<->,136.25.188.176,0,0,6,1227,6,1227,0.163082000,1.4416
133.178.227.20,<->,133.56.180.27,6,3033,0,0,6,3033,0.160197000,1.7837
136.25.189.28,<->,96.156.169.223,6,6790,0,0,6,6790,0.160083000,1.6408
136.25.188.226,<->,57.160.181.250,6,7630,0,0,6,7630,0.159329000,1.6676
215.158.61.189,<->,8.176.8.210,0,0,6,2249,6,2249,0.159285000,1.8216
215.158.239.73,<->,98.219.126.140,6,4740,0,0,6,4740,0.158049000,1.2937
136.25.188.252,<->,8.222.7.47,6,7822,0,0,6,7822,0.156942000,1.4917
215.158.238.190,<->,139.8.186.137,6,6532,0,0,6,6532,0.156492000,1.2562
215.158.239.84,<->,149.163.129.215,6,7502,0,0,6,7502,0.155422000,1.8019
215.158.238.133,<->,91.57.173.21,6,7982,0,0,6,7982,0.155104000,1.7234
207.86.243.25,<->,8.252.222.220,0,0,6,606,6,606,0.154815000,1.8393
215.158.238.92,<->,145.116.209.90,6,3242,0,0,6,3242,0.152795000,1.6321
215.158.140.75,<->,8.240.116.171,6,6493,0,0,6,6493,0.151611000,1.4478
215.158.61.195,<->,8.176.8.236,0,0,6,3045,6,3045,0.151597000,1.7128
133.178.227.4,<->,133.56.180.93,6,3246,0,0,6,3246,0.151515000,1.4049
233.97.211.191,<->,100.93.191.61,0,0,6,1269,6,1269,0.150261000,0.7262
124.46.191.127,<->,92.162.252.81,0,0,6,8250,6,8250,0.148156000,0.2968
215.158.239.94,<->,204.1.227.231,6,1669,0,0,6,1669,0.148121000,0.4941
136.25.189.54,<->,96.156.169.239,6,3126,0,0,6,3126,0.147851000,0.2847
215.158.140.231,<->,131.1.194.192,6,6189,0,0,6,6189,0.147083000,1.2390
199.52.80.127,<->,136.25.188.174,0,0,6,1661,6,1661,0.146868000,0.2417
136.25.188.255,<->,56.161.218.63,6,7774,0,0,6,7774,0.145739000,1.4022
133.178.226.31,<->,91.57.173.37,6,7518,0,0,6,7518,0.145487000,1.7441
195.13.82.22,<->,136.25.188.54,0,0,6,1806,6,1806,0.144748000,0.3658
136.25.189.29,<->,80.56.79.89,6,8459,0,0,6,8459,0.143681000,0.9581
133.178.226.77,<->,29.214.108.151,6,7726,0,0,6,7726,0.142831000,1.5349
215.158.238.67,<->,142.234.196.228,6,7710,0,0,6,7710,0.142574000,1.7439
133.178.226.28,<->,33.209.217.221,6,8269,0,0,6,8269,0.139799000,1.6192
215.158.239.58,<->,199.20.30.10,6,3049,0,0,6,3049,0.138573000,1.7690
136.25.189.1,<->,126.219.194.7,6,8295,0,0,6,8295,0.136295000,1.7143
220.39.233.164,<->,215.158.238.81,0,0,6,7806,6,7806,0.135616000,1.6714
215.158.238.176,<->,100.50.96.223,6,7184,0,0,6,7184,0.134911000,1.6822
215.158.239.94,<->,199.72.66.120,6,2341,0,0,6,2341,0.134745000,0.6722
133.178.227.138,<->,80.47.111.38,6,5261,0,0,6,5261,0.133480000,1.4448
215.158.140.62,<->,98.219.126.175,6,6975,0,0,6,6975,0.133090000,0.0002
136.25.189.60,<->,100.216.78.145,6,5319,0,0,6,5319,0.132349000,1.6578
204.2.108.115,<->,136.25.188.242,0,0,6,1482,6,1482,0.130973000,0.2452
215.158.239.94,<->,196.104.233.238,6,2788,0,0,6,2788,0.128897000,0.4885
215.158.239.94,<->,204.61.239.79,6,1445,0,0,6,1445,0.126916000,0.3856
139.163.20.162,<->,89.154.151.249,6,499,0,0,6,499,0.126762000,0.0949
133.178.226.61,<->,69.150.168.247,6,7854,0,0,6,7854,0.126521000,1.7817
199.71.19.20,<->,136.25.188.175,0,0,6,1443,6,1443,0.126232000,0.4673
136.25.188.47,<->,112.220.206.126,6,7534,0,0,6,7534,0.125191000,1.6977
199.51.86.248,<->,136.25.188.237,0,0,6,3510,6,3510,0.124308000,1.4814
120.85.4.6,<->,109.1.58.185,0,0,6,9024,6,9024,0.124203000,1.6403
136.25.188.226,<->,126.219.247.16,6,7694,0,0,6,7694,0.123835000,1.7675
97.190.215.135,<->,57.144.153.193,6,454,0,0,6,454,0.123364000,1.8043
133.178.226.28,<->,29.214.108.105,6,8261,0,0,6,8261,0.122763000,1.8250
145.13.164.50,<->,133.178.227.251,0,0,6,4331,6,4331,0.121687000,1.8090
136.25.189.0,<->,126.219.194.27,6,7614,0,0,6,7614,0.121618000,1.7576
133.178.227.7,<->,133.56.180.36,6,3036,0,0,6,3036,0.120976000,1.5945
215.158.238.64,<->,80.47.111.90,6,7566,0,0,6,7566,0.120897000,1.7986
215.158.238.133,<->,33.209.217.237,6,8479,0,0,6,8479,0.120330000,1.6596
215.158.238.110,<->,100.224.166.115,6,3174,0,0,6,3174,0.119278000,1.1734
205.127.108.114,<->,33.233.141.227,0,0,6,2781,6,2781,0.119098000,1.4220
80.42.169.15,<->,57.203.184.17,6,3043,0,0,6,3043,0.117213000,1.6349
215.158.239.86,<->,80.56.79.58,6,7598,0,0,6,7598,0.117125000,1.6498
215.158.238.132,<->,131.144.113.216,6,7774,0,0,6,7774,0.116885000,1.7652
139.163.17.129,<->,100.28.44.153,6,1404,0,0,6,1404,0.116739000,1.6510
195.42.224.23,<->,136.25.188.225,0,0,6,1661,6,1661,0.116264000,0.4613
207.173.245.15,<->,136.25.188.252,0,0,6,1705,6,1705,0.116085000,0.1399
136.25.188.160,<->,131.144.113.212,6,7934,0,0,6,7934,0.115763000,1.8062
136.138.112.200,<->,136.25.188.221,0,0,6,7278,6,7278,0.114246000,1.6821
133.178.226.94,<->,96.155.60.252,6,4038,0,0,6,4038,0.113366000,1.2067
215.158.238.149,<->,131.1.232.169,6,7774,0,0,6,7774,0.110689000,1.7516
142.229.169.5,<->,136.25.188.255,0,0,6,1883,6,1883,0.109732000,0.4889
136.25.188.45,<->,80.47.111.24,6,7902,0,0,6,7902,0.108922000,1.6474
246.253.134.201,<->,131.144.207.116,6,3030,0,0,6,3030,0.105512000,1.7860
215.158.239.231,<->,192.226.44.94,6,3335,0,0,6,3335,0.103505000,1.5094
100.50.96.237,<->,8.252.223.141,0,0,6,6636,6,6636,0.102566000,1.4280
138.98.183.177,<->,38.176.218.98,6,552,0,0,6,552,0.102460000,1.6935
133.178.227.57,<->,133.56.180.30,6,7633,0,0,6,7633,0.100452000,1.5760
136.25.189.15,<->,120.154.71.73,6,7870,0,0,6,7870,0.100395000,1.6451
215.201.245.121,<->,8.182.226.78,0,0,6,1878,6,1878,0.100360000,0.6583
136.25.188.254,<->,126.219.194.170,6,7614,0,0,6,7614,0.100138000,1.7425
215.158.140.231,<->,106.188.252.171,6,6421,0,0,6,6421,0.099887000,1.6623
215.158.239.34,<->,96.135.154.111,6,6645,0,0,6,6645,0.099328000,1.5347
136.25.188.254,<->,8.190.216.202,6,7822,0,0,6,7822,0.097505000,1.5543
231.143.137.170,<->,136.25.188.46,0,0,6,2104,6,2104,0.097195000,1.7897
133.178.227.16,<->,8.240.116.213,6,6668,0,0,6,6668,0.096583000,1.6106
192.205.36.140,<->,136.25.188.234,0,0,6,3790,6,3790,0.096057000,1.8140
136.25.188.224,<->,104.3.168.214,6,8062,0,0,6,8062,0.095344000,1.8509
76.179.71.28,<->,8.252.221.207,0,0,6,3584,6,3584,0.094837000,0.9022
215.158.238.189,<->,8.219.186.185,6,1701,0,0,6,1701,0.094288000,0.9092
205.127.108.113,<->,33.233.141.12,0,0,6,2223,6,2223,0.092408000,1.2282
136.25.189.2,<->,80.56.79.104,6,7000,0,0,6,7000,0.091309000,1.3461
133.178.227.41,<->,133.56.180.40,6,7675,0,0,6,7675,0.089437000,1.4920
215.158.61.243,<->,136.25.189.215,0,0,6,4204,6,4204,0.088475000,1.8817
204.3.186.162,<->,136.25.188.253,0,0,6,1158,6,1158,0.087992000,0.0761
133.178.227.76,<->,133.56.180.41,6,6665,0,0,6,6665,0.086014000,0.4540
197.113.64.185,<->,136.25.188.173,0,0,6,1972,6,1972,0.085781000,0.6302
215.158.239.68,<->,204.61.205.154,6,1370,0,0,6,1370,0.085305000,1.8001
215.158.238.73,<->,126.219.194.105,6,7566,0,0,6,7566,0.083689000,1.6115
215.158.238.148,<->,122.159.245.169,6,7774,0,0,6,7774,0.081964000,1.5646
136.25.188.222,<->,8.42.43.27,6,7790,0,0,6,7790,0.081781000,1.7192
136.25.189.59,<->,96.156.169.252,6,5566,0,0,6,5566,0.080864000,1.8652
215.158.238.33,<->,112.235.95.68,6,7566,0,0,6,7566,0.080515000,1.8661
192.204.123.38,<->,136.25.189.1,0,0,6,7438,6,7438,0.080413000,1.8080
215.158.238.251,<->,89.86.110.223,6,6794,0,0,6,6794,0.079128000,1.5838
215.158.140.76,<->,8.191.7.118,6,6589,0,0,6,6589,0.079035000,1.7097
215.158.239.32,<->,215.158.127.181,6,5329,0,0,6,5329,0.078412000,1.4445
145.13.164.163,<->,136.25.189.13,0,0,6,7470,6,7470,0.078135000,0.8892
246.254.97.112,<->,111.151.237.104,6,1974,0,0,6,1974,0.076081000,1.6407
96.58.68.79,<->,8.220.234.159,0,0,6,3814,6,3814,0.075295000,1.8307
136.25.189.1,<->,29.211.228.215,6,7662,0,0,6,7662,0.075000000,1.8024
215.158.61.183,<->,8.176.8.218,0,0,6,4423,6,4423,0.073952000,1.1233
215.158.239.95,<->,33.209.219.82,6,6737,0,0,6,6737,0.073852000,1.7909
136.25.189.61,<->,96.156.169.226,6,4182,0,0,6,4182,0.072227000,1.9040
215.158.238.64,<->,122.159.245.162,6,7806,0,0,6,7806,0.071425000,1.6083
133.178.226.37,<->,29.214.108.190,6,7662,0,0,6,7662,0.070436000,1.3350
199.70.191.248,<->,136.25.188.44,0,0,6,1480,6,1480,0.068185000,0.3200
145.180.135.157,<->,136.25.188.40,0,0,6,2406,6,2406,0.067885000,0.5431
215.158.61.191,<->,8.176.8.250,0,0,6,5803,6,5803,0.066032000,1.9240
215.158.239.76,<->,199.15.31.20,6,1773,0,0,6,1773,0.064401000,0.0894
204.200.36.112,<->,136.25.188.253,0,0,6,1824,6,1824,0.063222000,0.0567
215.158.239.95,<->,207.213.231.184,6,1334,0,0,6,1334,0.060551000,1.4096
215.158.238.133,<->,122.159.245.162,6,7598,0,0,6,7598,0.058629000,1.8835
246.108.107.211,<->,100.95.73.41,0,0,6,1946,6,1946,0.058086000,1.8515
133.178.226.61,<->,29.214.108.106,6,7806,0,0,6,7806,0.055824000,1.4871
215.158.239.58,<->,143.135.90.118,6,1485,0,0,6,1485,0.053375000,0.2385
215.158.238.67,<->,113.23.104.213,6,7502,0,0,6,7502,0.052836000,1.6400
215.158.238.144,<->,97.174.232.172,6,3033,0,0,6,3033,0.052255000,1.6838
215.158.61.191,<->,8.176.8.229,0,0,6,3357,6,3357,0.049070000,1.8584
215.158.239.50,<->,120.154.131.36,6,8293,0,0,6,8293,0.048628000,1.5809
136.25.189.21,<->,96.156.169.225,6,3334,0,0,6,3334,0.047143000,1.5918
149.250.115.70,<->,133.178.227.76,0,0,6,6369,6,6369,0.045705000,1.6037
199.38.111.142,<->,136.25.188.174,0,0,6,1769,6,1769,0.045032000,1.3131
220.28.85.14,<->,133.178.227.6,0,0,6,3515,6,3515,0.044485000,1.7097
215.158.239.58,<->,199.71.14.28,6,1360,0,0,6,1360,0.043578000,0.0233
136.25.188.220,<->,111.151.239.73,6,7630,0,0,6,7630,0.043310000,1.8910
215.158.238.75,<->,131.1.195.220,6,8542,0,0,6,8542,0.041710000,1.8508
133.178.227.27,<->,133.56.180.47,6,7748,0,0,6,7748,0.039817000,1.9521
133.178.226.71,<->,8.191.7.223,6,6432,0,0,6,6432,0.039602000,1.8632
199.39.63.93,<->,136.25.188.255,0,0,6,1491,6,1491,0.036571000,0.2375
220.28.65.9,<->,215.158.140.250,0,0,6,3334,6,3334,0.036284000,1.7514
215.158.140.60,<->,104.3.168.139,6,6679,0,0,6,6679,0.035336000,1.8771
136.25.189.1,<->,126.219.194.9,6,8179,0,0,6,8179,0.034510000,1.1019
133.178.227.27,<->,33.209.219.58,6,6820,0,0,6,6820,0.034061000,1.6054
222.65.17.30,<->,89.90.104.87,6,2190,0,0,6,2190,0.033352000,0.3588
215.158.239.86,<->,96.156.169.203,6,7694,0,0,6,7694,0.033220000,1.4212
215.158.61.243,<->,136.25.188.41,0,0,6,5697,6,5697,0.033170000,1.4364
204.200.58.145,<->,136.25.188.225,0,0,6,1823,6,1823,0.032311000,0.0576
215.158.238.177,<->,8.240.116.180,6,7454,0,0,6,7454,0.032136000,1.1497
136.25.188.227,<->,112.220.206.7,6,7838,0,0,6,7838,0.031628000,1.5526
220.28.104.193,<->,215.158.238.144,0,0,6,6169,6,6169,0.031520000,1.8983
136.25.189.0,<->,133.224.119.43,6,8142,0,0,6,8142,0.031121000,0.8810
136.25.189.35,<->,120.154.71.23,6,7582,0,0,6,7582,0.030489000,1.9095
205.127.108.115,<->,33.233.141.11,0,0,6,2015,6,2015,0.029812000,1.8248
197.161.241.164,<->,136.25.188.196,0,0,6,2213,6,2213,0.027486000,1.2672
220.28.104.193,<->,215.158.238.145,0,0,6,5333,6,5333,0.027169000,1.7899
195.41.238.252,<->,136.25.188.198,0,0,6,3447,6,3447,0.026949000,0.9602
92.27.27.146,<->,48.110.5.37,6,8122,0,0,6,8122,0.026198000,1.6827
136.25.188.237,<->,29.214.108.158,6,7438,0,0,6,7438,0.025517000,1.4863
133.178.226.49,<->,126.219.194.181,6,6430,0,0,6,6430,0.023867000,1.3578
215.158.239.17,<->,96.135.154.155,6,6804,0,0,6,6804,0.023428000,1.2830
215.158.239.79,<->,207.239.64.55,6,1249,0,0,6,1249,0.022459000,0.0249
142.255.56.186,<->,136.25.188.52,0,0,6,1372,6,1372,0.020882000,1.4408
136.25.189.94,<->,96.156.169.239,6,4054,0,0,6,4054,0.019841000,1.9707
133.178.226.61,<->,106.188.236.164,6,8126,0,0,6,8126,0.019805000,1.6878
215.158.238.99,<->,119.196.23.2,6,7726,0,0,6,7726,0.017200000,1.6702
89.183.109.28,<->,35.55.57.164,6,726,0,0,6,726,0.015777000,1.8754
215.158.30.238,<->,8.252.222.41,0,0,6,2332,6,2332,0.015421000,1.7043
133.178.226.25,<->,96.155.60.255,6,3034,0,0,6,3034,0.014011000,1.7912
215.158.3.130,<->,8.176.8.90,0,0,6,1758,6,1758,0.012735000,0.3995
192.67.130.85,<->,136.152.86.129,6,5020,0,0,6,5020,0.012354000,0.5430
215.158.238.81,<->,56.161.218.20,6,7774,0,0,6,7774,0.011131000,1.8034
133.178.226.7,<->,126.219.194.105,6,7806,0,0,6,7806,0.010463000,1.5433
215.158.238.92,<->,145.116.209.91,6,1559,0,0,6,1559,0.010389000,1.9675
136.25.189.12,<->,96.156.169.169,6,7430,0,0,6,7430,0.009851000,1.6378
136.119.203.229,<->,136.25.188.30,0,0,6,1632,6,1632,0.008752000,0.1587
220.81.6.61,<->,8.55.221.148,6,1614,0,0,6,1614,0.007657000,1.9323
215.158.238.75,<->,131.1.195.185,6,8412,0,0,6,8412,0.006735000,1.9462
215.158.238.90,<->,100.224.166.161,6,2178,0,0,6,2178,0.006489000,1.3541
215.158.6.190,<->,8.252.222.19,0,0,6,3629,6,3629,0.005872000,1.7510
136.25.189.6,<->,96.156.169.167,6,3374,0,0,6,3374,0.005498000,1.0870
54.59.122.154,<->,48.53.143.192,0,0,6,1034,6,1034,0.004712000,1.1353
142.190.228.6,<->,136.25.188.209,0,0,6,1606,6,1606,0.001911000,0.3506
199.52.31.51,<->,136.25.188.173,0,0,6,1672,6,1672,0.001628000,0.9636
215.158.238.129,<->,98.219.126.175,6,6532,0,0,6,6532,0.000218000,1.6171
136.25.188.58,<->,133.56.180.203,5,5258,0,0,5,5258,1.970420000,0.0008
220.28.115.46,<->,215.158.140.247,0,0,5,3971,5,3971,1.912638000,0.0001
50.224.89.243,<->,50.25.80.46,5,1071,0,0,5,1071,1.906213000,0.0468
215.158.239.58,<->,199.20.28.27,5,2107,0,0,5,2107,1.886435000,0.0358
253.220.0.66,<->,136.25.188.226,0,0,5,1302,5,1302,1.875761000,0.0992
132.216.159.29,<->,92.162.253.28,0,0,5,1845,5,1845,1.848531000,0.1275
220.20.200.91,<->,132.216.159.4,5,5522,0,0,5,5522,1.848523000,0.0619
138.12.41.193,<->,50.224.108.137,0,0,5,1807,5,1807,1.829722000,0.1060
129.19.150.122,<->,50.224.108.164,0,0,5,908,5,908,1.805791000,0.1751
210.231.140.55,<->,109.1.37.80,0,0,5,4818,5,4818,1.804652000,0.1554
220.28.114.28,<->,215.158.140.199,0,0,5,6072,5,6072,1.797580000,0.1452
199.81.208.250,<->,136.25.188.163,0,0,5,2130,5,2130,1.784699000,0.1538
215.158.239.11,<->,215.158.127.152,5,3850,0,0,5,3850,1.743469000,0.0186
220.28.65.9,<->,215.158.238.76,0,0,5,5020,5,5020,1.739280000,0.0001
93.181.154.23,<->,92.27.219.145,0,0,5,1745,5,1745,1.736247000,0.1969
248.225.27.2,<->,82.193.207.46,5,3049,0,0,5,3049,1.719218000,0.1462
215.158.61.182,<->,8.176.8.196,0,0,5,3020,5,3020,1.673122000,0.2656
89.152.249.182,<->,8.182.239.159,0,0,5,1252,5,1252,1.671301000,0.2272
199.39.215.192,<->,136.25.188.176,0,0,5,2621,5,2621,1.652606000,0.2751
215.158.238.24,<->,137.254.204.253,5,2691,0,0,5,2691,1.648978000,0.2845
22.36.17.171,<->,8.182.227.71,0,0,5,1148,5,1148,1.619098000,0.0341
133.178.226.254,<->,111.150.74.50,5,6665,0,0,5,6665,1.608070000,0.2008
136.25.188.199,<->,109.221.20.33,5,1303,0,0,5,1303,1.598290000,0.0985
246.253.168.245,<->,149.45.186.44,5,1560,0,0,5,1560,1.593764000,0.1444
80.247.151.43,<->,8.52.135.159,0,0,5,1233,5,1233,1.559246000,0.0308
215.158.239.69,<->,142.248.16.154,5,2086,0,0,5,2086,1.557325000,0.4415
136.25.188.174,<->,100.228.244.4,5,779,0,0,5,779,1.543350000,0.2871
53.231.85.206,<->,48.55.113.111,0,0,5,1654,5,1654,1.519119000,0.3701
8.183.24.79,<->,6.245.226.89,5,1359,0,0,5,1359,1.517155000,0.2636
98.129.34.250,<->,8.55.224.156,5,4307,0,0,5,4307,1.512132000,0.4380
215.158.239.56,<->,199.20.29.26,5,2624,0,0,5,2624,1.511664000,0.3497
17.46.87.216,<->,8.53.0.43,0,0,5,2190,5,2190,1.506253000,0.2615
215.158.239.82,<->,80.57.141.226,5,3272,0,0,5,3272,1.501113000,0.2039
247.136.237.194,<->,221.102.143.189,5,3749,0,0,5,3749,1.480154000,0.2339
104.247.202.21,<->,39.248.149.53,0,0,5,1757,5,1757,1.479049000,0.3780
221.102.143.189,<->,80.41.44.252,0,0,5,3913,5,3913,1.467472000,0.5307
142.205.49.233,<->,136.25.188.225,0,0,5,1331,5,1331,1.467344000,0.0396
204.2.109.51,<->,136.25.188.225,0,0,5,2019,5,2019,1.464686000,0.3838
136.25.189.5,<->,56.28.207.191,5,3961,0,0,5,3961,1.455003000,0.4518
129.26.244.132,<->,103.244.181.234,5,385,0,0,5,385,1.454408000,0.2848
139.193.141.139,<->,105.201.186.230,5,1304,0,0,5,1304,1.453176000,0.2976
204.2.36.142,<->,136.25.188.54,0,0,5,779,5,779,1.451684000,0.5170
221.102.56.34,<->,100.182.141.178,0,0,5,4285,5,4285,1.444088000,0.1535
215.158.140.245,<->,0.195.253.228,5,5064,0,0,5,5064,1.438311000,0.1350
215.158.239.58,<->,199.106.41.213,5,1416,0,0,5,1416,1.432105000,0.3201
215.158.239.50,<->,194.232.219.52,5,1854,0,0,5,1854,1.431255000,0.2710
248.239.184.227,<->,221.102.56.46,5,3177,0,0,5,3177,1.428840000,0.1510
215.158.239.56,<->,199.20.29.175,5,1515,0,0,5,1515,1.419793000,0.5278
197.107.15.174,<->,136.25.188.253,0,0,5,1272,5,1272,1.411334000,0.2049
215.158.239.96,<->,194.234.245.232,5,730,0,0,5,730,1.409700000,0.5831
97.19.5.28,<->,8.182.226.78,0,0,5,4278,5,4278,1.405235000,0.3553
142.206.27.11,<->,136.25.188.220,0,0,5,1295,5,1295,1.404864000,0.0518
138.121.99.24,<->,8.220.188.50,0,0,5,2400,5,2400,1.395406000,0.1249
215.158.239.94,<->,207.115.122.109,5,1031,0,0,5,1031,1.394037000,0.4418
192.65.124.121,<->,8.45.173.68,5,5376,0,0,5,5376,1.387341000,0.3799
98.67.155.83,<->,53.224.64.121,5,1880,0,0,5,1880,1.363405000,0.4864
8.182.230.134,<->,6.133.233.121,5,1543,0,0,5,1543,1.360616000,0.5360
210.220.218.67,<->,17.43.172.58,5,1777,0,0,5,1777,1.354407000,0.2654
215.158.239.76,<->,195.70.107.117,5,1082,0,0,5,1082,1.347782000,0.4439
215.158.239.70,<->,194.250.221.100,5,2629,0,0,5,2629,1.345678000,0.2617
197.113.99.228,<->,136.25.188.176,0,0,5,2035,5,2035,1.341750000,0.4000
199.33.86.253,<->,136.25.188.254,0,0,5,1351,5,1351,1.338565000,0.6371
199.15.175.78,<->,136.25.188.220,0,0,5,1254,5,1254,1.329420000,0.5258
99.162.77.146,<->,54.37.113.65,5,2524,0,0,5,2524,1.321292000,0.2313
132.249.70.93,<->,8.37.218.73,5,5753,0,0,5,5753,1.317049000,0.0877
215.158.239.93,<->,199.15.43.224,5,1108,0,0,5,1108,1.315949000,0.0182
248.225.25.84,<->,53.231.144.231,5,2490,0,0,5,2490,1.315914000,0.1359
142.228.90.12,<->,136.25.188.253,0,0,5,2712,5,2712,1.313854000,0.4429
215.158.61.208,<->,8.252.221.246,0,0,5,5531,5,5531,1.313001000,0.0065
221.102.143.189,<->,80.41.25.56,0,0,5,3696,5,3696,1.308173000,0.2413
138.55.219.111,<->,8.52.179.217,0,0,5,853,5,853,1.302137000,0.1564
215.158.49.48,<->,136.116.28.230,0,0,5,5965,5,5965,1.275262000,0.1094
136.25.188.36,<->,53.231.225.223,5,3566,0,0,5,3566,1.273880000,0.0610
137.231.11.95,<->,136.25.188.255,0,0,5,1529,5,1529,1.255326000,0.0733
139.163.6.161,<->,115.233.224.12,5,760,0,0,5,760,1.251984000,0.5835
133.178.227.27,<->,133.56.180.7,5,6510,0,0,5,6510,1.251334000,0.7472
109.222.199.189,<->,0.195.212.152,5,2540,0,0,5,2540,1.247809000,0.0543
106.152.213.55,<->,101.224.206.44,0,0,5,546,5,546,1.238548000,0.6036
218.4.180.68,<->,111.151.239.4,5,2411,0,0,5,2411,1.235639000,0.2187
215.158.239.25,<->,96.135.154.115,5,4878,0,0,5,4878,1.231191000,0.2534
136.25.188.165,<->,133.56.180.94,5,3433,0,0,5,3433,1.229806000,0.7680
111.14.251.154,<->,8.182.243.141,0,0,5,767,5,767,1.227373000,0.6433
247.136.159.39,<->,144.72.193.201,5,4876,0,0,5,4876,1.222571000,0.1016
98.129.116.148,<->,8.45.252.128,5,1239,0,0,5,1239,1.219225000,0.6715
144.72.193.17,<->,99.75.53.165,0,0,5,4846,5,4846,1.211069000,0.0931
249.101.118.139,<->,144.72.193.17,5,4846,0,0,5,4846,1.207033000,0.1001
220.60.81.155,<->,215.158.239.78,0,0,5,6817,5,6817,1.200687000,0.5920
194.237.11.86,<->,136.25.188.198,0,0,5,1962,5,1962,1.194599000,0.3698
215.158.239.203,<->,137.107.106.106,5,2389,0,0,5,2389,1.191839000,0.2601
221.102.143.189,<->,102.81.176.170,0,0,5,3481,5,3481,1.186943000,0.3385
215.158.30.165,<->,8.252.222.41,0,0,5,3889,5,3889,1.180344000,0.7294
207.239.140.47,<->,136.25.188.239,0,0,5,1383,5,1383,1.177440000,0.7397
215.158.239.55,<->,80.57.141.179,5,2619,0,0,5,2619,1.175383000,0.1187
249.101.209.15,<->,210.209.251.214,5,2356,0,0,5,2356,1.171944000,0.8161
205.224.35.9,<->,139.193.141.207,0,0,5,1205,5,1205,1.171044000,0.2452
194.237.204.62,<->,136.25.188.243,0,0,5,1947,5,1947,1.168587000,0.2623
145.221.38.45,<->,8.182.226.42,0,0,5,806,5,806,1.159907000,0.2877
142.167.63.71,<->,136.25.188.176,0,0,5,1213,5,1213,1.151800000,0.2227
196.251.77.66,<->,8.252.222.176,0,0,5,1438,5,1438,1.144928000,0.2173
215.158.239.50,<->,199.20.31.38,5,779,0,0,5,779,1.136176000,0.4902
136.25.189.209,<->,96.234.109.145,5,2158,0,0,5,2158,1.136016000,0.3159
204.200.43.11,<->,136.25.188.173,0,0,5,779,5,779,1.134187000,0.6281
98.236.87.230,<->,54.39.102.167,5,2082,0,0,5,2082,1.127781000,0.1745
215.158.239.92,<->,194.202.228.183,5,1415,0,0,5,1415,1.127641000,0.5696
215.158.239.78,<->,195.15.42.1,5,1883,0,0,5,1883,1.126175000,0.4744
220.28.115.46,<->,133.178.227.7,0,0,5,5509,5,5509,1.121739000,0.4201
207.62.135.29,<->,136.25.188.198,0,0,5,1261,5,1261,1.113330000,0.5446
220.38.162.21,<->,215.158.238.109,0,0,5,2932,5,2932,1.103303000,0.5393
60.101.197.67,<->,8.252.221.207,0,0,5,3147,5,3147,1.100932000,0.7595
215.158.239.92,<->,204.226.3.45,5,1189,0,0,5,1189,1.100704000,0.7437
215.158.239.93,<->,199.20.5.208,5,1596,0,0,5,1596,1.095716000,0.4194
196.246.195.215,<->,136.25.188.54,0,0,5,2027,5,2027,1.093750000,0.1200
215.158.140.17,<->,100.224.141.62,5,3267,0,0,5,3267,1.087975000,0.8430
93.181.154.60,<->,92.27.219.143,0,0,5,924,5,924,1.067546000,0.4832
195.7.107.175,<->,136.25.188.252,0,0,5,2944,5,2944,1.066925000,0.6471
215.158.239.50,<->,194.237.93.55,5,2639,0,0,5,2639,1.062143000,0.8889
215.158.239.77,<->,204.227.246.253,5,1386,0,0,5,1386,1.056199000,0.1643
248.239.119.105,<->,221.102.143.189,5,4913,0,0,5,4913,1.054964000,0.7996
215.158.239.95,<->,196.90.120.144,5,2720,0,0,5,2720,1.051888000,0.4697
136.25.189.14,<->,8.215.68.65,5,7030,0,0,5,7030,1.050791000,0.9104
215.158.32.171,<->,6.73.247.87,0,0,5,5737,5,5737,1.050398000,0.0010
220.28.108.254,<->,215.158.238.253,0,0,5,3444,5,3444,1.049436000,0.6713
204.3.183.232,<->,136.25.188.198,0,0,5,1175,5,1175,1.047382000,0.2065
111.150.74.74,<->,99.74.26.144,0,0,5,1977,5,1977,1.041126000,0.7524
136.25.189.80,<->,133.56.180.22,5,6513,0,0,5,6513,1.039705000,0.8101
215.158.238.102,<->,145.116.209.93,5,6383,0,0,5,6383,1.032917000,0.8709
204.3.189.5,<->,136.25.188.175,0,0,5,1121,5,1121,1.023927000,0.7586
17.116.39.130,<->,8.20.87.144,0,0,5,2590,5,2590,1.019829000,0.2700
66.58.105.211,<->,8.252.221.198,0,0,5,1725,5,1725,1.018087000,0.4013
111.20.172.119,<->,111.20.168.156,0,0,5,6381,5,6381,1.013197000,0.8201
195.71.130.7,<->,136.25.188.45,0,0,5,2001,5,2001,1.010375000,0.3469
136.25.188.213,<->,80.57.141.187,5,2192,0,0,5,2192,1.007067000,0.6486
204.186.232.252,<->,136.25.188.177,0,0,5,2824,5,2824,1.002601000,0.0002
215.158.30.240,<->,8.252.222.32,0,0,5,4600,5,4600,0.978288000,0.4605
252.98.138.253,<->,159.57.90.68,5,4774,0,0,5,4774,0.971924000,0.0548
220.28.73.211,<->,136.25.189.93,0,0,5,2429,5,2429,0.967419000,0.6648
97.230.215.131,<->,8.52.186.156,0,0,5,1301,5,1301,0.965796000,0.8982
159.223.99.62,<->,8.52.188.75,0,0,5,1102,5,1102,0.961019000,0.0784
215.158.239.76,<->,199.20.28.15,5,2017,0,0,5,2017,0.960184000,0.7719
215.158.239.95,<->,196.95.114.199,5,2075,0,0,5,2075,0.955075000,0.9792
120.36.99.226,<->,80.42.185.56,0,0,5,606,5,606,0.952134000,1.0407
136.25.189.2,<->,126.219.191.9,5,6545,0,0,5,6545,0.951271000,1.0416
220.20.200.99,<->,132.216.159.4,5,4043,0,0,5,4043,0.939072000,0.1557
195.5.232.177,<->,136.25.188.252,0,0,5,2389,5,2389,0.937998000,0.5454
204.60.234.12,<->,136.25.188.226,0,0,5,779,5,779,0.934365000,0.8598
89.155.213.217,<->,8.182.243.141,0,0,5,904,5,904,0.933289000,0.3679
142.190.247.74,<->,136.25.188.225,0,0,5,5036,5,5036,0.932899000,0.3355
215.158.52.230,<->,144.95.104.75,5,289,0,0,5,289,0.932854000,0.8431
215.158.238.190,<->,8.191.7.104,5,5354,0,0,5,5354,0.927023000,0.9058
215.158.61.182,<->,8.176.8.197,0,0,5,4595,5,4595,0.923021000,1.0444
220.28.104.193,<->,215.158.238.100,0,0,5,4686,5,4686,0.917983000,1.0216
215.158.239.55,<->,111.52.91.101,5,1933,0,0,5,1933,0.917509000,0.9916
221.102.114.234,<->,199.12.104.169,5,2173,0,0,5,2173,0.914665000,0.8616
195.71.188.163,<->,136.25.188.162,0,0,5,1303,5,1303,0.909102000,0.3576
220.28.108.254,<->,133.178.227.73,0,0,5,1616,5,1616,0.904250000,0.9297
196.148.174.227,<->,53.243.94.129,5,5036,0,0,5,5036,0.901594000,0.4492
215.158.239.56,<->,142.208.5.166,5,2025,0,0,5,2025,0.900823000,0.7578
210.209.251.211,<->,98.67.151.76,0,0,5,3738,5,3738,0.900390000,0.2643
221.102.56.69,<->,213.38.233.112,0,0,5,1470,5,1470,0.898024000,0.6260
215.158.238.83,<->,80.47.111.86,5,6465,0,0,5,6465,0.894496000,0.7652
215.158.239.104,<->,97.95.162.108,5,2874,0,0,5,2874,0.872473000,1.0730
212.116.196.137,<->,8.182.226.42,0,0,5,838,5,838,0.865292000,0.2463
215.158.238.73,<->,33.209.217.245,5,5809,0,0,5,5809,0.864689000,1.0126
109.222.245.43,<->,101.64.145.123,5,4149,0,0,5,4149,0.854347000,1.0500
148.88.101.5,<->,139.193.141.194,0,0,5,3718,5,3718,0.853155000,0.9018
136.25.189.12,<->,98.28.95.85,5,6401,0,0,5,6401,0.846263000,1.1281
204.62.236.175,<->,136.25.188.255,0,0,5,1368,5,1368,0.846046000,0.6000
215.158.61.243,<->,8.176.8.252,0,0,5,3589,5,3589,0.846007000,0.6844
58.168.69.30,<->,8.252.222.38,0,0,5,1538,5,1538,0.838027000,0.1870
199.83.212.246,<->,136.25.188.52,0,0,5,2633,5,2633,0.831638000,0.4050
195.85.180.58,<->,8.252.222.28,0,0,5,831,5,831,0.831248000,0.0022
215.158.239.86,<->,199.20.28.113,5,1276,0,0,5,1276,0.831166000,0.3380
138.37.223.61,<->,8.182.227.5,0,0,5,1847,5,1847,0.825812000,0.7479
245.161.127.245,<->,8.252.222.148,0,0,5,2629,5,2629,0.821211000,0.4852
133.178.227.2,<->,8.191.7.250,5,6497,0,0,5,6497,0.820787000,0.8416
215.158.238.220,<->,8.219.185.98,5,3715,0,0,5,3715,0.815414000,0.9619
203.117.85.169,<->,0.195.210.42,0,0,5,585,5,585,0.812909000,0.7197
133.178.226.90,<->,126.219.194.171,5,6144,0,0,5,6144,0.811976000,0.8530
212.118.51.50,<->,8.52.185.118,0,0,5,2481,5,2481,0.809451000,0.4612
195.125.10.35,<->,136.25.188.174,0,0,5,1003,5,1003,0.809311000,0.0338
199.58.43.121,<->,8.20.87.153,0,0,5,2361,5,2361,0.809170000,0.8856
136.138.112.210,<->,136.25.188.252,0,0,5,6417,5,6417,0.808861000,1.0927
136.25.189.62,<->,98.219.126.175,5,4161,0,0,5,4161,0.804224000,0.6803
133.178.226.18,<->,8.222.7.47,5,6353,0,0,5,6353,0.799852000,1.0422
133.178.227.242,<->,29.212.136.170,5,4993,0,0,5,4993,0.799793000,0.7113
195.14.69.194,<->,136.25.188.176,0,0,5,1304,5,1304,0.797476000,0.6590
8.55.209.213,<->,6.138.226.138,0,0,5,5452,5,5452,0.792720000,1.1955
133.178.227.39,<->,133.56.180.46,5,2777,0,0,5,2777,0.791856000,0.8632
133.178.227.24,<->,89.86.110.201,5,5387,0,0,5,5387,0.791213000,1.2004
220.28.115.46,<->,215.158.239.72,0,0,5,4081,5,4081,0.774374000,0.6077
133.178.227.29,<->,133.56.180.35,5,2385,0,0,5,2385,0.773506000,1.2101
215.158.239.70,<->,195.126.16.171,5,1335,0,0,5,1335,0.769177000,1.0706
136.25.189.27,<->,96.156.169.199,5,1577,0,0,5,1577,0.763610000,0.8126
92.175.125.211,<->,8.220.184.39,0,0,5,1447,5,1447,0.762000000,0.8812
215.158.238.148,<->,80.47.111.27,5,5257,0,0,5,5257,0.761077000,1.1415
136.25.188.229,<->,80.57.141.173,5,3592,0,0,5,3592,0.760096000,0.1353
231.140.126.19,<->,215.158.239.79,0,0,5,1552,5,1552,0.758482000,0.2471
215.158.238.250,<->,8.240.116.162,5,5534,0,0,5,5534,0.758090000,1.1961
215.158.239.77,<->,194.202.40.232,5,1038,0,0,5,1038,0.740640000,0.0001
53.149.127.239,<->,48.53.178.63,0,0,5,3696,5,3696,0.736024000,0.9000
144.72.195.98,<->,100.92.3.121,0,0,5,4914,5,4914,0.733301000,0.2070
136.25.189.82,<->,29.209.59.247,5,6001,0,0,5,6001,0.732831000,1.2089
221.102.143.189,<->,6.72.58.56,0,0,5,3689,5,3689,0.732535000,0.1689
215.158.238.68,<->,139.163.161.50,5,2527,0,0,5,2527,0.720613000,1.1783
136.25.189.57,<->,29.212.180.233,5,5713,0,0,5,5713,0.716197000,1.1989
215.158.239.94,<->,194.232.3.141,5,2983,0,0,5,2983,0.715555000,0.8157
136.25.188.57,<->,100.224.166.158,5,3982,0,0,5,3982,0.712391000,0.8900
215.158.239.27,<->,96.135.154.156,5,4686,0,0,5,4686,0.710662000,1.0750
195.13.25.19,<->,136.25.188.220,0,0,5,1289,5,1289,0.705345000,0.3472
215.158.239.76,<->,199.20.31.114,5,779,0,0,5,779,0.696070000,0.8786
215.158.239.51,<->,199.20.29.176,5,1494,0,0,5,1494,0.695522000,0.7196
54.69.58.221,<->,8.176.8.238,0,0,5,3034,5,3034,0.688536000,1.1733
207.84.109.3,<->,8.43.221.222,0,0,5,1064,5,1064,0.686984000,0.1396
195.41.122.40,<->,136.25.188.52,0,0,5,1519,5,1519,0.686610000,0.0273
215.158.239.83,<->,136.114.101.87,5,1833,0,0,5,1833,0.681943000,1.2593
136.25.189.17,<->,29.209.59.199,5,6353,0,0,5,6353,0.680654000,1.0754
247.136.226.117,<->,129.16.253.244,5,4784,0,0,5,4784,0.678991000,0.2683
136.25.189.33,<->,133.56.180.57,5,6209,0,0,5,6209,0.678631000,0.6287
215.158.239.58,<->,142.241.246.1,5,1291,0,0,5,1291,0.678318000,0.0695
136.25.189.45,<->,96.156.169.221,5,4289,0,0,5,4289,0.668975000,1.0902
220.28.104.193,<->,215.158.140.249,0,0,5,5152,5,5152,0.667901000,0.8317
89.152.249.100,<->,8.182.239.159,0,0,5,1051,5,1051,0.660653000,0.2318
215.158.239.48,<->,142.191.199.129,5,3065,0,0,5,3065,0.654791000,1.2185
215.158.239.97,<->,199.52.29.67,5,1798,0,0,5,1798,0.646936000,0.7083
224.76.11.202,<->,8.182.136.152,0,0,5,2439,5,2439,0.643633000,0.3875
133.178.227.70,<->,133.56.180.23,5,3449,0,0,5,3449,0.642644000,1.3112
109.3.142.140,<->,8.45.175.127,5,2821,0,0,5,2821,0.642351000,1.3550
220.49.55.254,<->,133.32.39.251,0,0,5,494,5,494,0.639825000,0.0462
133.178.226.77,<->,33.209.217.238,5,7053,0,0,5,7053,0.637546000,1.1233
137.129.0.243,<->,129.47.117.200,5,5665,0,0,5,5665,0.632839000,1.2633
133.178.227.253,<->,126.219.54.44,5,1893,0,0,5,1893,0.629733000,0.5656
215.158.61.183,<->,8.176.8.237,0,0,5,4874,5,4874,0.626234000,1.0722
133.178.227.55,<->,133.56.180.52,5,2247,0,0,5,2247,0.624260000,1.1007
133.178.226.0,<->,100.120.38.6,5,4176,0,0,5,4176,0.622592000,0.0007
136.25.188.224,<->,111.151.239.91,5,6465,0,0,5,6465,0.622144000,0.5440
136.25.188.174,<->,41.157.125.174,5,1134,0,0,5,1134,0.620967000,0.1897
136.25.188.197,<->,29.214.108.191,5,6015,0,0,5,6015,0.618579000,1.2499
199.73.182.207,<->,136.25.188.162,0,0,5,1983,5,1983,0.617894000,0.7758
159.223.99.61,<->,8.52.185.129,0,0,5,405,5,405,0.616324000,1.0005
215.158.239.70,<->,207.239.242.80,5,1538,0,0,5,1538,0.615574000,0.3612
215.158.239.95,<->,199.70.221.36,5,2602,0,0,5,2602,0.614476000,0.9873
136.25.188.220,<->,8.222.212.23,5,6529,0,0,5,6529,0.613638000,1.0562
199.33.113.60,<->,136.25.188.253,0,0,5,1400,5,1400,0.603868000,0.7069
192.65.98.231,<->,132.18.67.30,5,1924,0,0,5,1924,0.602517000,0.1710
215.158.239.71,<->,29.211.228.217,5,5417,0,0,5,5417,0.599713000,1.3748
109.222.193.196,<->,100.83.51.162,5,3481,0,0,5,3481,0.598848000,0.1257
221.102.143.189,<->,220.83.113.171,0,0,5,3529,5,3529,0.594101000,0.5434
215.158.238.83,<->,131.1.232.136,5,3833,0,0,5,3833,0.591225000,1.1324
136.25.189.60,<->,56.28.207.205,5,2465,0,0,5,2465,0.588272000,0.8292
133.178.227.70,<->,133.56.180.50,5,3289,0,0,5,3289,0.587301000,1.3621
220.28.108.254,<->,215.158.239.46,0,0,5,3214,5,3214,0.580298000,1.2650
215.158.61.182,<->,136.25.188.41,0,0,5,3121,5,3121,0.579360000,1.3837
136.25.189.1,<->,96.156.169.201,5,5913,0,0,5,5913,0.576263000,1.2785
220.28.108.254,<->,215.158.140.246,0,0,5,3759,5,3759,0.576249000,1.1555
215.158.239.95,<->,207.166.112.56,5,3289,0,0,5,3289,0.576160000,1.1684
136.25.189.86,<->,96.156.169.236,5,2969,0,0,5,2969,0.575811000,0.7764
142.208.125.122,<->,136.25.188.45,0,0,5,1818,5,1818,0.575630000,0.5669
133.178.226.31,<->,122.158.245.121,5,6433,0,0,5,6433,0.574216000,1.2600
215.158.238.92,<->,131.36.198.58,5,7171,0,0,5,7171,0.572646000,1.1041
215.158.238.134,<->,65.27.220.210,5,6497,0,0,5,6497,0.569400000,1.4224
215.158.30.184,<->,136.25.188.244,0,0,5,3200,5,3200,0.562893000,0.4873
136.25.188.179,<->,122.158.245.134,5,6577,0,0,5,6577,0.560567000,1.2488
195.71.167.102,<->,136.25.188.175,0,0,5,1567,5,1567,0.560468000,0.2464
215.158.239.19,<->,73.69.62.207,5,1988,0,0,5,1988,0.558456000,0.8464
142.236.192.151,<->,136.25.188.220,0,0,5,1384,5,1384,0.558108000,0.1773
215.158.238.94,<->,131.144.113.148,5,6641,0,0,5,6641,0.557344000,1.3312
215.158.239.52,<->,138.45.90.247,5,2409,0,0,5,2409,0.555776000,0.4913
136.25.188.174,<->,80.47.111.106,5,6129,0,0,5,6129,0.553261000,1.2789
109.222.205.151,<->,53.231.158.103,5,1208,0,0,5,1208,0.552741000,0.0011
133.178.226.19,<->,80.47.111.90,5,6337,0,0,5,6337,0.551087000,1.3856
215.158.239.93,<->,196.88.103.114,5,2917,0,0,5,2917,0.547264000,0.1089
215.158.239.56,<->,142.237.129.145,5,1049,0,0,5,1049,0.544123000,0.3323
215.158.238.190,<->,158.85.50.151,5,5695,0,0,5,5695,0.541322000,1.3978
215.158.239.92,<->,142.228.101.183,5,1783,0,0,5,1783,0.536145000,0.5092
50.53.79.13,<->,8.52.178.59,0,0,5,857,5,857,0.533941000,0.6713
215.158.238.67,<->,65.27.228.187,5,6641,0,0,5,6641,0.532104000,1.2426
136.25.188.179,<->,57.210.107.43,5,6609,0,0,5,6609,0.531484000,1.2447
215.158.239.57,<->,204.226.42.240,5,779,0,0,5,779,0.529732000,1.0260
215.158.238.124,<->,145.116.209.82,5,5563,0,0,5,5563,0.529503000,0.3540
142.240.151.157,<->,136.25.188.160,0,0,5,779,5,779,0.527257000,1.1634
210.221.107.50,<->,8.37.249.53,5,1470,0,0,5,1470,0.525048000,0.2450
215.158.238.83,<->,113.23.104.221,5,3998,0,0,5,3998,0.521831000,1.4251
192.64.222.153,<->,22.249.18.74,5,5203,0,0,5,5203,0.521126000,0.9344
133.178.226.49,<->,91.57.173.21,5,3054,0,0,5,3054,0.520753000,1.0572
136.25.188.244,<->,56.97.186.149,5,2258,0,0,5,2258,0.513602000,0.4770
82.117.204.93,<->,8.220.187.125,0,0,5,5149,5,5149,0.505618000,0.6253
215.158.239.79,<->,113.23.100.185,5,6177,0,0,5,6177,0.505101000,0.8838
136.25.188.32,<->,54.49.181.218,5,2785,0,0,5,2785,0.504113000,1.0816
136.25.188.220,<->,100.224.202.182,5,1450,0,0,5,1450,0.503550000,1.0230
137.231.32.86,<->,89.139.241.201,0,0,5,1098,5,1098,0.501231000,0.1529
197.113.99.70,<->,136.25.188.176,0,0,5,1268,5,1268,0.500396000,1.3182
136.25.189.33,<->,29.214.108.255,5,6833,0,0,5,6833,0.499425000,1.4378
136.181.42.94,<->,0.195.216.193,5,2025,0,0,5,2025,0.498766000,1.4327
215.158.239.1,<->,96.135.154.115,5,5225,0,0,5,5225,0.496718000,0.0019
112.208.20.177,<->,98.128.126.190,0,0,5,1265,5,1265,0.494746000,0.9241
136.25.189.1,<->,56.161.218.36,5,6737,0,0,5,6737,0.494287000,1.2346
215.158.238.66,<->,106.188.183.208,5,2100,0,0,5,2100,0.492754000,1.2132
92.38.225.68,<->,8.220.205.146,0,0,5,4240,5,4240,0.489758000,1.4475
133.178.227.24,<->,133.56.180.81,5,3097,0,0,5,3097,0.488524000,0.8101
89.152.249.246,<->,8.182.239.159,0,0,5,1058,5,1058,0.487407000,0.2849
204.3.38.137,<->,136.25.188.255,0,0,5,2637,5,2637,0.483375000,1.0639
200.175.87.179,<->,54.37.9.160,5,3476,0,0,5,3476,0.481859000,1.1214
136.25.188.196,<->,80.47.111.24,5,6321,0,0,5,6321,0.481673000,1.2812
215.158.239.105,<->,215.158.61.243,5,3988,0,0,5,3988,0.479437000,1.2594
215.158.239.84,<->,204.226.110.13,5,1520,0,0,5,1520,0.471566000,0.5103
92.27.27.178,<->,92.12.187.214,5,351,0,0,5,351,0.471034000,1.3126
8.252.223.131,<->,8.219.185.43,5,5729,0,0,5,5729,0.464996000,0.9575
215.158.239.78,<->,8.50.171.199,5,6417,0,0,5,6417,0.462064000,1.1088
136.25.188.199,<->,27.178.41.51,5,6257,0,0,5,6257,0.460202000,1.4021
220.28.65.9,<->,215.158.140.234,0,0,5,4275,5,4275,0.456921000,1.0797
133.178.227.62,<->,133.56.180.35,5,2528,0,0,5,2528,0.456918000,1.0771
215.158.238.140,<->,33.209.217.213,5,6996,0,0,5,6996,0.456327000,1.3583
133.178.227.60,<->,133.56.180.37,5,4710,0,0,5,4710,0.456248000,0.8590
136.25.188.224,<->,106.188.236.197,5,6609,0,0,5,6609,0.456183000,1.3186
133.178.226.18,<->,131.144.114.218,5,6609,0,0,5,6609,0.454955000,1.1828
142.223.114.231,<->,136.25.188.54,0,0,5,1164,5,1164,0.451521000,0.1948
218.4.181.154,<->,133.0.57.72,5,5440,0,0,5,5440,0.449644000,0.0539
215.158.239.58,<->,195.49.238.178,5,1254,0,0,5,1254,0.448866000,1.4594
207.57.85.248,<->,136.25.188.52,0,0,5,1400,5,1400,0.447566000,0.8671
133.178.227.27,<->,133.56.180.31,5,5609,0,0,5,5609,0.446995000,1.2472
215.158.238.47,<->,104.3.168.217,5,6753,0,0,5,6753,0.445554000,1.3134
215.158.238.190,<->,8.220.54.105,5,5652,0,0,5,5652,0.442865000,1.2817
133.178.227.79,<->,111.150.187.176,5,5391,0,0,5,5391,0.440957000,1.0893
215.158.238.64,<->,91.57.173.23,5,6161,0,0,5,6161,0.439448000,0.8358
136.25.188.236,<->,8.222.212.10,5,6417,0,0,5,6417,0.438960000,1.5149
126.243.53.31,<->,0.195.210.46,0,0,5,2110,5,2110,0.438258000,0.7730
215.158.238.78,<->,98.219.126.175,5,4204,0,0,5,4204,0.432496000,1.1111
215.158.239.57,<->,199.15.121.146,5,2004,0,0,5,2004,0.431546000,1.1494
100.120.38.6,<->,92.27.194.38,0,0,5,1534,5,1534,0.430798000,1.1661
101.129.32.178,<->,98.67.158.12,0,0,5,1965,5,1965,0.430129000,0.1757
215.158.238.141,<->,112.220.206.14,5,6849,0,0,5,6849,0.428128000,1.4536
215.158.238.103,<->,98.219.126.140,5,2993,0,0,5,2993,0.423353000,1.5059
144.148.84.204,<->,89.153.90.39,0,0,5,454,5,454,0.421954000,0.8011
146.249.226.127,<->,8.252.222.150,0,0,5,3401,5,3401,0.421700000,0.9973
136.25.189.90,<->,29.211.228.200,5,6663,0,0,5,6663,0.418781000,1.4433
142.191.9.219,<->,136.25.188.241,0,0,5,1502,5,1502,0.417593000,0.0759
215.158.239.36,<->,96.135.154.142,5,4648,0,0,5,4648,0.417333000,0.7712
220.28.73.211,<->,215.158.238.91,0,0,5,4808,5,4808,0.415891000,1.1684
215.158.239.79,<->,199.122.59.17,5,1260,0,0,5,1260,0.412339000,0.3994
136.25.189.30,<->,126.219.191.52,5,6577,0,0,5,6577,0.409588000,1.3297
133.178.226.14,<->,96.155.60.212,5,1163,0,0,5,1163,0.409406000,0.7024
133.178.226.77,<->,27.178.41.18,5,6593,0,0,5,6593,0.408714000,1.2337
215.158.238.92,<->,126.219.132.253,5,6833,0,0,5,6833,0.408408000,1.4155
215.158.239.61,<->,98.219.126.175,5,1778,0,0,5,1778,0.404688000,1.2814
215.158.239.33,<->,215.158.127.160,5,716,0,0,5,716,0.404459000,1.3931
215.158.238.79,<->,100.216.78.145,5,4502,0,0,5,4502,0.402824000,1.4632
220.28.109.52,<->,136.25.188.217,0,0,5,5022,5,5022,0.401204000,0.0005
136.25.188.237,<->,122.158.245.88,5,6273,0,0,5,6273,0.397825000,1.5034
53.213.167.52,<->,48.54.32.146,0,0,5,2503,5,2503,0.391232000,1.3785
136.25.189.57,<->,126.219.194.18,5,6273,0,0,5,6273,0.386639000,1.4629
215.158.239.76,<->,136.139.59.125,5,6609,0,0,5,6609,0.385953000,1.3869
215.158.61.195,<->,8.176.8.188,0,0,5,3490,5,3490,0.384223000,1.4552
136.25.188.160,<->,8.222.212.59,5,6097,0,0,5,6097,0.381528000,1.3669
133.178.226.60,<->,8.42.43.65,5,6401,0,0,5,6401,0.381251000,0.9126
220.28.73.211,<->,136.25.189.7,0,0,5,1697,5,1697,0.381043000,0.8616
246.253.234.255,<->,33.209.218.84,5,1710,0,0,5,1710,0.380931000,1.1060
124.63.50.43,<->,80.41.63.61,0,0,5,4341,5,4341,0.379973000,0.7752
215.158.61.189,<->,8.176.8.208,0,0,5,3534,5,3534,0.378926000,1.3438
133.178.226.28,<->,131.1.253.224,5,6990,0,0,5,6990,0.378092000,1.2920
195.54.86.110,<->,136.25.188.252,0,0,5,2212,5,2212,0.377526000,0.6864
139.69.162.59,<->,136.25.188.58,0,0,5,5041,5,5041,0.376751000,1.3692
210.229.230.22,<->,40.213.154.114,5,514,0,0,5,514,0.374249000,1.3033
152.47.95.34,<->,139.163.96.101,0,0,5,1335,5,1335,0.373099000,1.5259
215.158.238.250,<->,126.219.102.53,5,5505,0,0,5,5505,0.369623000,1.5479
136.25.188.210,<->,29.214.108.183,5,6401,0,0,5,6401,0.365264000,1.3664
215.158.238.64,<->,142.234.196.202,5,6641,0,0,5,6641,0.364289000,1.6274
136.25.189.80,<->,29.211.228.165,5,6289,0,0,5,6289,0.364232000,1.3130
221.102.143.189,<->,220.82.1.242,0,0,5,4073,5,4073,0.362874000,0.3142
220.28.104.193,<->,136.25.188.228,0,0,5,3188,5,3188,0.358871000,1.4513
136.25.189.45,<->,96.156.169.28,5,6225,0,0,5,6225,0.356334000,1.2816
136.25.188.36,<->,111.42.21.99,5,250,0,0,5,250,0.355627000,1.2266
215.158.239.84,<->,199.68.27.118,5,1248,0,0,5,1248,0.355255000,0.7784
91.231.192.190,<->,35.55.57.164,5,603,0,0,5,603,0.354326000,0.9287
199.82.93.225,<->,136.25.188.53,0,0,5,1219,5,1219,0.353936000,0.1871
215.158.239.77,<->,204.226.55.178,5,1866,0,0,5,1866,0.352738000,0.3753
215.158.239.86,<->,8.50.171.139,5,5985,0,0,5,5985,0.348099000,1.3186
199.121.54.163,<->,136.25.188.162,0,0,5,1908,5,1908,0.346062000,0.8771
142.240.20.148,<->,136.25.188.220,0,0,5,1209,5,1209,0.345611000,0.2206
215.158.239.95,<->,29.212.198.189,5,6113,0,0,5,6113,0.343483000,1.1733
215.158.61.182,<->,8.176.8.180,0,0,5,3122,5,3122,0.343273000,0.7568
133.178.227.41,<->,133.56.180.15,5,5401,0,0,5,5401,0.339863000,1.6392
129.236.114.39,<->,101.224.89.150,0,0,5,5657,5,5657,0.339551000,0.0067
202.33.226.149,<->,136.25.188.226,0,0,5,1335,5,1335,0.337699000,0.6367
136.25.189.14,<->,80.56.79.51,5,6561,0,0,5,6561,0.337543000,1.5445
136.25.189.37,<->,98.219.126.175,5,1085,0,0,5,1085,0.336830000,1.2350
220.39.233.198,<->,136.25.188.254,0,0,5,6881,5,6881,0.333971000,1.3236
136.25.189.45,<->,120.154.131.39,5,5732,0,0,5,5732,0.333350000,1.5096
215.158.238.104,<->,80.47.111.66,5,6433,0,0,5,6433,0.332642000,1.0168
194.232.239.61,<->,136.25.188.163,0,0,5,1416,5,1416,0.332308000,0.6280
215.158.239.49,<->,142.236.184.127,5,1079,0,0,5,1079,0.331752000,0.2451
136.25.188.160,<->,57.210.107.38,5,6241,0,0,5,6241,0.329688000,1.4726
215.158.238.133,<->,111.151.70.38,5,6129,0,0,5,6129,0.329355000,1.4439
215.158.30.229,<->,8.252.222.55,0,0,5,3385,5,3385,0.328317000,0.0011
215.158.239.77,<->,192.204.123.37,5,6673,0,0,5,6673,0.327689000,1.3842
215.158.238.148,<->,131.144.113.163,5,6529,0,0,5,6529,0.327490000,1.5397
206.241.112.70,<->,97.168.71.84,0,0,5,1158,5,1158,0.326030000,0.7941
215.158.61.189,<->,8.176.8.215,0,0,5,3553,5,3553,0.321438000,0.6273
215.158.238.64,<->,122.159.245.155,5,6737,0,0,5,6737,0.321384000,1.5464
136.25.188.175,<->,126.219.194.181,5,5494,0,0,5,5494,0.318638000,1.6036
136.25.189.16,<->,96.156.169.244,5,6641,0,0,5,6641,0.317986000,1.3600
136.25.188.211,<->,131.1.195.245,5,6849,0,0,5,6849,0.317410000,1.5061
215.158.238.133,<->,126.219.132.160,5,6865,0,0,5,6865,0.316679000,1.5533
142.244.102.214,<->,136.25.188.242,0,0,5,2684,5,2684,0.314288000,1.1653
136.25.188.173,<->,69.150.168.200,5,6417,0,0,5,6417,0.313258000,1.6477
215.158.239.50,<->,126.219.191.58,5,6321,0,0,5,6321,0.311454000,1.5440
220.55.103.28,<->,127.170.16.85,5,285,0,0,5,285,0.310911000,1.0082
136.25.188.178,<->,33.209.217.201,5,7065,0,0,5,7065,0.310224000,1.4995
215.158.239.69,<->,29.211.228.247,5,6278,0,0,5,6278,0.307401000,0.8984
215.158.238.82,<->,136.138.112.209,5,6417,0,0,5,6417,0.305047000,1.5230
136.25.189.32,<->,96.135.154.247,5,6481,0,0,5,6481,0.304025000,1.4583
128.204.120.234,<->,108.134.98.139,0,0,5,1161,5,1161,0.301581000,1.4254
220.39.233.203,<->,136.25.188.237,0,0,5,6465,5,6465,0.300078000,1.3414
100.214.108.163,<->,8.222.6.141,5,7520,0,0,5,7520,0.299020000,1.4586
215.158.239.86,<->,133.56.180.7,5,6385,0,0,5,6385,0.298801000,1.4872
133.178.226.90,<->,120.154.221.245,5,6577,0,0,5,6577,0.298532000,1.3038
215.158.239.95,<->,199.20.30.38,5,2672,0,0,5,2672,0.297468000,1.3093
215.158.140.228,<->,133.213.24.157,5,1260,0,0,5,1260,0.297372000,0.0265
220.39.233.209,<->,215.158.238.67,0,0,5,6241,5,6241,0.295923000,1.4402
192.228.30.49,<->,100.94.61.134,0,0,5,4962,5,4962,0.295168000,1.1370
133.178.226.38,<->,8.42.43.36,5,6497,0,0,5,6497,0.294668000,1.3492
195.5.63.250,<->,136.25.188.178,0,0,5,1416,5,1416,0.291317000,0.2974
204.130.148.78,<->,0.195.210.46,0,0,5,3864,5,3864,0.288050000,1.6423
215.158.239.79,<->,96.156.169.194,5,5513,0,0,5,5513,0.287283000,1.6375
195.126.184.133,<->,136.25.188.54,0,0,5,1931,5,1931,0.285929000,0.6661
131.69.188.185,<->,92.162.253.153,0,0,5,2712,5,2712,0.285868000,0.0008
215.158.239.78,<->,196.89.223.114,5,1728,0,0,5,1728,0.285161000,0.6110
215.158.238.247,<->,98.219.126.140,5,3293,0,0,5,3293,0.284655000,1.4605
215.158.238.102,<->,145.116.209.76,5,5232,0,0,5,5232,0.284108000,1.4138
215.158.238.67,<->,131.144.114.208,5,6609,0,0,5,6609,0.283799000,1.1464
142.174.234.224,<->,8.52.175.115,0,0,5,913,5,913,0.280631000,0.3492
136.25.189.30,<->,6.15.207.105,5,6497,0,0,5,6497,0.280274000,0.9620
136.25.189.83,<->,29.212.199.27,5,6241,0,0,5,6241,0.280216000,1.6228
199.73.218.199,<->,136.25.188.174,0,0,5,1156,5,1156,0.278759000,1.2307
204.200.38.162,<->,136.25.188.252,0,0,5,1397,5,1397,0.278396000,0.1328
215.158.238.92,<->,131.1.195.220,5,7060,0,0,5,7060,0.277683000,1.4731
215.158.239.4,<->,29.211.5.198,5,5813,0,0,5,5813,0.277033000,1.4749
206.195.88.219,<->,102.51.87.198,0,0,5,3033,5,3033,0.276626000,0.8496
215.158.239.69,<->,199.20.30.21,5,2705,0,0,5,2705,0.273563000,1.4097
215.158.140.229,<->,131.144.112.246,5,5361,0,0,5,5361,0.273456000,1.5158
136.25.189.59,<->,133.56.180.0,5,6561,0,0,5,6561,0.273340000,1.1914
215.158.239.50,<->,194.234.172.202,5,2072,0,0,5,2072,0.272252000,1.3799
133.178.226.29,<->,8.42.43.37,5,6385,0,0,5,6385,0.269738000,1.5334
136.25.189.18,<->,96.156.169.215,5,6433,0,0,5,6433,0.268754000,1.2358
231.143.114.45,<->,136.25.188.225,0,0,5,2021,5,2021,0.268647000,0.7082
215.158.239.75,<->,129.175.139.13,5,2649,0,0,5,2649,0.260712000,0.9923
232.31.246.42,<->,139.193.141.139,0,0,5,1298,5,1298,0.260546000,0.2696
199.32.179.123,<->,136.25.188.252,0,0,5,1261,5,1261,0.259768000,0.4407
109.222.209.65,<->,66.241.199.76,5,1064,0,0,5,1064,0.259539000,0.6189
215.158.238.135,<->,126.219.194.151,5,6193,0,0,5,6193,0.259298000,1.0107
215.158.239.69,<->,8.50.171.169,5,6481,0,0,5,6481,0.257509000,1.4460
215.158.239.68,<->,143.94.204.181,5,1864,0,0,5,1864,0.257289000,0.3132
143.42.108.80,<->,136.25.188.44,0,0,5,1817,5,1817,0.255820000,1.4063
136.25.188.197,<->,122.158.245.102,5,6241,0,0,5,6241,0.255605000,1.1806
202.8.158.61,<->,139.163.7.204,0,0,5,1250,5,1250,0.253908000,1.5226
133.178.227.57,<->,104.3.168.149,5,6198,0,0,5,6198,0.253153000,1.7189
215.158.239.70,<->,126.219.194.88,5,6106,0,0,5,6106,0.251216000,1.6781
133.178.226.7,<->,122.158.49.128,5,3705,0,0,5,3705,0.250115000,1.6956
215.158.238.116,<->,145.116.209.93,5,6356,0,0,5,6356,0.249831000,0.9533
215.158.239.87,<->,142.227.16.45,5,1836,0,0,5,1836,0.249642000,0.2600
133.178.226.90,<->,126.219.247.8,5,6241,0,0,5,6241,0.249335000,1.7051
133.178.226.199,<->,8.47.189.28,5,4914,0,0,5,4914,0.248648000,1.6896
136.25.188.45,<->,106.188.236.165,5,6577,0,0,5,6577,0.248596000,1.4577
133.178.226.61,<->,57.160.181.228,5,6433,0,0,5,6433,0.247666000,1.4881
145.116.209.76,<->,136.25.188.203,0,0,5,1887,5,1887,0.246067000,1.7090
215.158.238.143,<->,8.190.216.200,5,6865,0,0,5,6865,0.244570000,1.6663
95.247.18.232,<->,8.252.222.29,0,0,5,1887,5,1887,0.244250000,0.4905
204.3.154.98,<->,136.25.188.196,0,0,5,2009,5,2009,0.243578000,0.5654
199.121.170.163,<->,136.25.188.241,0,0,5,2602,5,2602,0.242585000,1.6281
136.25.189.12,<->,96.156.169.171,5,2689,0,0,5,2689,0.242209000,1.7479
215.158.30.252,<->,8.252.222.230,0,0,5,4747,5,4747,0.240112000,0.4523
133.178.226.19,<->,8.219.187.251,5,5852,0,0,5,5852,0.237262000,1.6975
136.25.188.220,<->,131.36.198.57,5,7194,0,0,5,7194,0.234590000,1.5888
133.178.227.76,<->,113.23.14.134,5,5461,0,0,5,5461,0.233947000,1.5646
215.158.239.49,<->,126.219.194.17,5,6337,0,0,5,6337,0.232745000,1.2020
220.50.242.203,<->,136.25.188.34,0,0,5,3425,5,3425,0.232695000,1.2078
192.204.123.39,<->,136.25.189.33,0,0,5,6689,5,6689,0.232607000,1.3890
195.84.18.201,<->,0.195.210.33,0,0,5,1571,5,1571,0.231610000,0.2570
204.61.38.125,<->,136.25.188.238,0,0,5,1100,5,1100,0.231450000,0.0331
215.158.239.35,<->,96.135.154.110,5,3365,0,0,5,3365,0.231168000,1.5792
136.25.188.175,<->,131.1.253.244,5,7102,0,0,5,7102,0.230497000,1.7432
215.158.238.47,<->,131.1.195.229,5,7122,0,0,5,7122,0.230034000,1.6730
215.158.238.190,<->,106.188.244.254,5,5593,0,0,5,5593,0.230019000,1.5365
139.254.208.128,<->,129.243.217.199,5,2050,0,0,5,2050,0.228468000,1.6402
80.41.48.44,<->,0.38.147.27,5,6921,0,0,5,6921,0.227959000,1.3760
215.158.238.152,<->,139.163.161.50,5,3279,0,0,5,3279,0.227775000,1.4222
215.158.239.95,<->,126.219.194.82,5,5401,0,0,5,5401,0.226868000,1.4758
120.83.21.34,<->,92.27.27.164,0,0,5,2561,5,2561,0.226691000,1.7036
204.200.35.226,<->,136.25.188.177,0,0,5,1281,5,1281,0.226348000,0.6496
215.158.238.81,<->,112.220.206.14,5,6417,0,0,5,6417,0.225932000,1.4280
136.25.188.160,<->,27.178.41.51,5,6337,0,0,5,6337,0.225255000,1.5300
215.158.239.78,<->,8.255.92.169,5,6865,0,0,5,6865,0.224779000,1.7372
133.178.227.36,<->,133.56.180.35,5,2705,0,0,5,2705,0.224413000,1.5591
136.25.188.175,<->,113.23.20.117,5,6689,0,0,5,6689,0.224117000,1.7650
220.28.115.46,<->,215.158.238.69,0,0,5,4746,5,4746,0.223704000,1.4149
215.158.239.69,<->,195.49.62.93,5,2021,0,0,5,2021,0.222915000,1.6500
215.158.239.231,<->,54.38.248.166,5,4065,0,0,5,4065,0.221410000,1.6364
136.25.188.163,<->,57.160.181.181,5,5465,0,0,5,5465,0.221239000,1.6433
136.25.189.11,<->,56.28.207.205,5,1385,0,0,5,1385,0.220890000,1.5436
207.190.81.152,<->,136.25.188.252,0,0,5,1231,5,1231,0.217721000,0.2308
136.25.188.221,<->,106.188.236.230,5,6545,0,0,5,6545,0.217484000,1.0422
136.25.189.2,<->,96.135.155.20,5,6353,0,0,5,6353,0.216239000,1.5520
215.158.238.47,<->,131.1.195.234,5,5954,0,0,5,5954,0.216164000,1.3419
215.158.238.75,<->,33.209.217.201,5,6870,0,0,5,6870,0.215449000,1.6696
215.158.238.114,<->,80.47.111.66,5,6433,0,0,5,6433,0.214864000,1.3511
136.25.188.177,<->,131.1.195.222,5,6904,0,0,5,6904,0.214702000,1.1347
136.25.188.254,<->,29.214.108.74,5,6545,0,0,5,6545,0.213505000,1.5491
136.25.189.21,<->,96.156.169.239,5,3585,0,0,5,3585,0.212709000,1.4101
121.23.5.158,<->,89.183.104.248,0,0,5,5668,5,5668,0.210984000,1.5036
136.25.189.11,<->,98.219.126.175,5,2587,0,0,5,2587,0.210645000,1.5131
215.158.61.145,<->,8.176.8.181,0,0,5,3224,5,3224,0.209160000,0.9039
136.25.189.80,<->,29.211.93.22,5,6017,0,0,5,6017,0.208815000,1.6299
145.16.34.73,<->,54.69.65.112,5,499,0,0,5,499,0.206657000,1.1404
136.25.189.30,<->,56.28.207.192,5,6433,0,0,5,6433,0.206377000,0.9782
136.62.206.172,<->,136.25.188.177,0,0,5,1669,5,1669,0.204962000,0.0710
136.25.188.163,<->,131.36.198.24,5,6035,0,0,5,6035,0.204008000,1.6892
133.178.226.70,<->,133.56.180.7,5,4449,0,0,5,4449,0.203804000,1.2571
136.25.188.243,<->,104.3.163.7,5,6289,0,0,5,6289,0.202864000,1.4728
215.158.239.73,<->,56.97.186.37,5,2177,0,0,5,2177,0.201490000,0.9170
215.158.238.196,<->,215.158.6.215,5,5405,0,0,5,5405,0.201366000,1.2818
215.158.238.193,<->,100.216.78.145,5,2712,0,0,5,2712,0.200865000,0.9861
129.16.253.232,<->,89.216.125.35,0,0,5,5004,5,5004,0.200049000,0.0985
136.25.188.210,<->,106.188.236.198,5,6625,0,0,5,6625,0.199888000,1.4718
144.74.36.234,<->,137.19.242.61,0,0,5,595,5,595,0.199518000,1.5915
142.255.169.41,<->,136.25.188.178,0,0,5,2621,5,2621,0.198836000,0.6852
133.178.227.16,<->,111.150.187.245,5,5601,0,0,5,5601,0.198346000,1.7696
195.65.179.46,<->,8.182.243.141,0,0,5,904,5,904,0.197121000,0.3164
195.41.103.56,<->,136.25.188.46,0,0,5,994,5,994,0.196783000,0.0328
133.178.226.18,<->,69.150.169.36,5,6257,0,0,5,6257,0.196639000,1.5467
136.25.189.31,<->,96.156.169.231,5,5609,0,0,5,5609,0.196433000,1.7252
143.77.187.28,<->,8.252.222.162,0,0,5,1207,5,1207,0.196429000,0.1266
215.158.140.168,<->,215.158.58.202,5,2066,0,0,5,2066,0.196185000,1.3078
205.127.108.113,<->,33.233.141.231,0,0,5,2586,5,2586,0.194816000,1.4303
220.39.233.187,<->,133.178.226.7,0,0,5,6465,5,6465,0.194765000,1.5887
111.147.74.255,<->,53.232.229.106,5,5434,0,0,5,5434,0.194509000,1.6125
207.188.247.218,<->,136.25.188.238,0,0,5,1255,5,1255,0.194010000,1.0375
215.158.238.64,<->,104.3.168.217,5,6545,0,0,5,6545,0.193464000,1.2948
221.102.56.46,<->,91.251.114.196,0,0,5,3067,5,3067,0.192391000,0.3709
215.158.238.190,<->,89.86.110.227,5,5523,0,0,5,5523,0.191424000,1.3381
133.178.227.57,<->,133.56.180.32,5,5502,0,0,5,5502,0.190588000,1.6844
136.25.189.80,<->,118.20.100.145,5,5545,0,0,5,5545,0.190262000,1.5590
215.158.61.202,<->,8.176.8.183,0,0,5,3265,5,3265,0.189310000,1.3820
215.158.238.83,<->,104.3.168.212,5,6625,0,0,5,6625,0.188748000,1.6599
215.158.239.57,<->,80.56.79.74,5,6900,0,0,5,6900,0.188155000,1.4225
133.178.226.84,<->,98.219.126.140,5,2995,0,0,5,2995,0.187463000,1.7669
215.158.239.57,<->,80.56.79.10,5,6721,0,0,5,6721,0.186588000,1.7854
133.12.93.126,<->,50.224.61.152,0,0,5,7480,5,7480,0.184936000,1.4384
112.208.20.158,<->,101.238.100.15,0,0,5,1524,5,1524,0.184280000,1.0780
215.158.238.67,<->,27.178.41.58,5,6353,0,0,5,6353,0.184168000,1.5916
215.158.238.221,<->,139.8.186.146,5,5550,0,0,5,5550,0.183459000,1.4884
136.25.188.223,<->,8.222.212.59,5,6353,0,0,5,6353,0.183141000,1.4783
204.56.105.249,<->,136.25.188.236,0,0,5,928,5,928,0.182815000,0.0462
215.158.238.120,<->,113.23.20.249,5,5065,0,0,5,5065,0.181716000,1.5291
215.158.238.135,<->,122.159.245.149,5,5281,0,0,5,5281,0.181238000,1.4153
136.25.189.62,<->,56.28.207.191,5,2073,0,0,5,2073,0.180729000,1.7094
136.25.189.45,<->,133.224.119.42,5,6737,0,0,5,6737,0.178213000,1.7847
215.158.239.69,<->,195.55.157.19,5,1164,0,0,5,1164,0.177186000,0.2907
220.28.104.193,<->,136.25.189.55,0,0,5,3843,5,3843,0.176591000,0.7236
149.250.115.23,<->,136.25.188.253,0,0,5,6481,5,6481,0.176560000,1.6590
215.158.239.94,<->,192.204.123.39,5,6593,0,0,5,6593,0.175522000,1.3957
220.39.233.203,<->,136.25.188.252,0,0,5,6529,5,6529,0.174353000,1.4027
80.38.62.154,<->,35.56.3.196,5,2705,0,0,5,2705,0.173597000,1.3329
147.58.211.37,<->,8.252.221.213,0,0,5,3404,5,3404,0.173324000,0.1572
93.127.111.72,<->,0.195.210.8,0,0,5,2521,5,2521,0.172817000,1.6751
215.158.140.76,<->,8.222.213.8,5,5409,0,0,5,5409,0.172310000,1.5729
136.25.189.57,<->,106.188.253.230,5,6604,0,0,5,6604,0.172046000,1.4257
215.158.61.145,<->,8.176.8.229,0,0,5,4758,5,4758,0.171914000,1.4460
136.25.188.211,<->,126.219.247.38,5,6497,0,0,5,6497,0.170458000,1.5041
136.25.189.14,<->,8.222.58.195,5,6497,0,0,5,6497,0.168951000,0.9327
215.158.140.206,<->,133.20.250.202,5,1921,0,0,5,1921,0.167602000,0.8481
215.158.239.95,<->,80.56.79.48,5,6385,0,0,5,6385,0.167071000,1.7356
136.25.188.197,<->,126.219.194.99,5,6273,0,0,5,6273,0.166884000,1.3341
136.25.188.254,<->,131.1.232.169,5,6257,0,0,5,6257,0.166618000,1.6858
215.158.239.17,<->,8.191.6.86,5,1247,0,0,5,1247,0.163534000,1.8128
136.25.188.45,<->,112.220.206.105,5,6577,0,0,5,6577,0.163476000,1.7319
136.25.188.163,<->,106.188.236.241,5,6465,0,0,5,6465,0.163391000,1.7558
205.127.108.114,<->,33.233.141.2,0,0,5,1497,5,1497,0.162237000,1.3894
221.102.143.189,<->,102.83.183.153,0,0,5,2897,5,2897,0.162070000,1.2987
136.25.188.160,<->,80.47.111.75,5,6369,0,0,5,6369,0.161392000,1.7443
215.158.140.228,<->,137.206.182.219,5,1845,0,0,5,1845,0.160962000,0.0402
103.146.10.15,<->,50.224.80.64,0,0,5,1887,5,1887,0.160365000,0.5945
98.67.143.20,<->,54.58.99.60,5,2592,0,0,5,2592,0.159253000,1.0062
215.158.61.203,<->,8.176.8.244,0,0,5,4601,5,4601,0.158063000,1.1778
35.56.97.26,<->,35.55.57.164,5,609,0,0,5,609,0.157656000,0.8018
197.125.126.182,<->,133.178.226.7,0,0,5,6593,5,6593,0.156677000,1.7658
145.116.119.52,<->,53.239.135.111,5,4334,0,0,5,4334,0.155903000,1.8251
221.102.56.46,<->,220.83.32.78,0,0,5,2300,5,2300,0.155264000,0.5582
8.252.223.176,<->,8.240.116.198,5,5665,0,0,5,5665,0.155172000,1.7849
220.39.233.155,<->,136.25.188.254,0,0,5,6337,5,6337,0.154851000,1.3382
220.28.85.14,<->,136.25.188.202,0,0,5,3583,5,3583,0.154602000,1.8337
133.178.226.67,<->,133.56.180.93,5,2527,0,0,5,2527,0.153517000,1.6130
215.158.239.50,<->,126.219.191.27,5,6417,0,0,5,6417,0.152691000,1.3203
206.226.101.109,<->,89.183.111.204,0,0,5,3478,5,3478,0.151315000,1.8142
136.25.189.59,<->,89.80.251.8,5,6321,0,0,5,6321,0.148922000,1.5097
136.25.189.78,<->,123.166.46.202,5,5777,0,0,5,5777,0.148280000,1.5799
215.158.238.104,<->,113.23.20.233,5,6497,0,0,5,6497,0.148257000,1.4912
215.158.238.135,<->,8.42.43.3,5,6401,0,0,5,6401,0.148074000,1.5432
215.158.239.76,<->,29.213.219.59,5,6684,0,0,5,6684,0.147832000,1.7738
159.57.90.68,<->,97.149.91.221,0,0,5,4774,5,4774,0.147455000,0.1121
215.158.238.238,<->,8.40.50.41,5,5338,0,0,5,5338,0.146827000,1.3482
222.65.22.130,<->,215.158.33.122,5,4462,0,0,5,4462,0.145018000,1.2820
100.83.51.93,<->,97.126.113.243,0,0,5,1039,5,1039,0.143415000,1.5451
133.178.227.60,<->,133.56.180.36,5,2177,0,0,5,2177,0.142750000,1.4661
215.158.239.86,<->,120.154.71.53,5,6417,0,0,5,6417,0.141741000,1.4428
215.158.6.220,<->,133.178.227.24,0,0,5,5732,5,5732,0.141061000,1.6657
215.158.239.99,<->,143.44.139.212,5,2622,0,0,5,2622,0.140273000,1.0508
152.43.87.87,<->,8.252.221.223,0,0,5,1535,5,1535,0.140038000,1.7260
204.2.215.122,<->,136.25.188.176,0,0,5,1086,5,1086,0.138983000,0.0227
136.138.112.200,<->,136.25.188.224,0,0,5,6273,5,6273,0.137770000,1.2380
215.158.238.143,<->,131.1.232.185,5,4673,0,0,5,4673,0.136812000,1.5179
195.5.66.134,<->,136.25.188.225,0,0,5,1182,5,1182,0.134628000,0.2432
133.178.226.80,<->,29.214.108.151,5,6193,0,0,5,6193,0.134243000,1.4078
133.178.227.57,<->,133.56.180.83,5,4625,0,0,5,4625,0.133490000,0.8392
215.158.239.96,<->,195.80.39.73,5,2017,0,0,5,2017,0.132805000,0.8194
215.158.238.47,<->,126.219.194.132,5,6625,0,0,5,6625,0.130903000,1.6660
193.21.28.216,<->,100.94.41.247,0,0,5,4932,5,4932,0.130376000,1.5293
220.28.73.211,<->,215.158.239.66,0,0,5,3380,5,3380,0.130001000,1.2243
215.158.239.71,<->,126.219.194.88,5,6353,0,0,5,6353,0.129196000,1.7491
136.25.189.14,<->,80.56.79.21,5,6641,0,0,5,6641,0.125828000,1.7899
215.158.238.132,<->,106.188.183.107,5,1059,0,0,5,1059,0.124768000,1.7071
159.23.224.190,<->,73.80.222.209,5,5310,0,0,5,5310,0.123179000,0.7610
101.224.206.44,<->,57.211.62.2,5,609,0,0,5,609,0.122975000,1.3319
133.178.226.37,<->,122.158.245.90,5,6465,0,0,5,6465,0.122134000,1.6528
133.178.226.38,<->,29.214.64.76,5,6209,0,0,5,6209,0.119641000,1.2658
197.125.110.212,<->,136.25.189.77,0,0,5,6753,5,6753,0.119510000,1.2607
215.158.238.241,<->,33.209.219.25,5,5330,0,0,5,5330,0.119438000,1.8017
136.25.189.77,<->,126.219.194.17,5,6305,0,0,5,6305,0.119304000,1.8447
215.158.238.142,<->,33.209.217.237,5,6922,0,0,5,6922,0.118785000,1.8744
215.158.239.49,<->,199.20.5.151,5,2669,0,0,5,2669,0.117668000,0.9795
215.158.238.133,<->,131.1.195.249,5,7194,0,0,5,7194,0.117224000,1.6691
215.158.61.222,<->,99.74.26.216,0,0,5,2066,5,2066,0.115497000,1.8811
136.25.189.46,<->,80.56.79.73,5,6994,0,0,5,6994,0.110683000,0.8940
215.158.238.98,<->,27.178.41.16,5,6673,0,0,5,6673,0.110259000,1.7033
136.25.188.173,<->,57.210.107.26,5,6257,0,0,5,6257,0.109897000,1.8187
215.158.239.34,<->,29.211.5.202,5,4308,0,0,5,4308,0.109296000,1.8353
192.204.123.43,<->,136.25.189.2,0,0,5,6689,5,6689,0.109053000,1.8158
215.158.238.67,<->,8.42.43.57,5,6721,0,0,5,6721,0.108022000,1.8663
133.178.227.76,<->,111.150.187.245,5,5326,0,0,5,5326,0.107528000,1.1409
136.25.188.165,<->,100.224.166.120,5,3090,0,0,5,3090,0.106783000,1.3121
89.183.104.148,<->,29.135.81.110,5,955,0,0,5,955,0.105726000,0.6585
199.38.238.137,<->,136.25.188.253,0,0,5,1087,5,1087,0.105512000,0.2004
215.158.238.142,<->,131.1.195.249,5,5890,0,0,5,5890,0.104946000,1.6897
132.211.48.38,<->,80.40.61.48,0,0,5,255,5,255,0.104937000,1.6993
216.184.1.91,<->,8.252.222.27,0,0,5,2299,5,2299,0.104584000,0.0723
133.178.227.2,<->,133.56.180.11,5,6479,0,0,5,6479,0.103293000,1.3637
215.158.61.209,<->,8.252.222.250,0,0,5,2691,5,2691,0.102428000,0.9073
136.25.188.220,<->,100.224.202.148,5,1110,0,0,5,1110,0.101743000,1.2799
221.102.143.189,<->,192.64.238.192,0,0,5,2748,5,2748,0.099094000,0.2958
215.158.238.96,<->,56.161.218.55,5,6417,0,0,5,6417,0.098631000,1.2798
199.82.176.65,<->,136.25.188.177,0,0,5,1350,5,1350,0.096864000,0.3972
215.158.239.70,<->,96.156.169.160,5,5289,0,0,5,5289,0.095987000,1.4750
215.158.238.149,<->,33.209.217.228,5,7234,0,0,5,7234,0.095177000,1.0191
197.107.119.42,<->,136.25.188.252,0,0,5,906,5,906,0.095130000,0.0000
215.158.239.49,<->,96.135.155.15,5,5609,0,0,5,5609,0.094388000,1.4727
124.145.25.255,<->,92.27.27.173,0,0,5,322,5,322,0.089860000,1.5087
136.25.188.210,<->,56.161.218.62,5,6609,0,0,5,6609,0.088211000,1.5601
142.252.174.204,<->,136.25.188.198,0,0,5,1175,5,1175,0.086985000,0.3404
216.184.1.91,<->,8.252.222.170,0,0,5,2619,5,2619,0.085784000,0.5280
215.158.239.110,<->,133.101.98.175,5,1989,0,0,5,1989,0.085337000,0.6374
205.127.108.114,<->,33.233.141.115,0,0,5,3305,5,3305,0.085023000,1.7611
86.135.8.107,<->,8.252.222.158,0,0,5,1319,5,1319,0.083717000,0.5284
221.102.56.46,<->,100.182.164.197,0,0,5,3217,5,3217,0.083213000,0.2964
136.25.188.211,<->,57.160.181.245,5,6497,0,0,5,6497,0.082794000,1.8090
136.25.189.16,<->,29.211.93.22,5,6497,0,0,5,6497,0.082424000,1.6999
215.158.239.49,<->,113.23.14.135,5,6305,0,0,5,6305,0.081880000,1.5481
133.178.227.19,<->,133.56.180.40,5,6528,0,0,5,6528,0.080992000,1.5757
215.158.238.82,<->,136.138.112.217,5,6465,0,0,5,6465,0.080770000,1.3221
133.178.227.14,<->,126.219.246.222,5,5760,0,0,5,5760,0.077871000,1.7088
143.42.110.16,<->,136.25.188.253,0,0,5,1184,5,1184,0.075237000,0.5619
215.158.239.79,<->,118.20.100.147,5,6385,0,0,5,6385,0.074836000,1.7239
143.129.164.35,<->,136.25.188.239,0,0,5,924,5,924,0.073971000,0.0153
220.248.81.33,<->,136.25.188.220,0,0,5,2230,5,2230,0.073185000,0.0447
136.25.188.220,<->,29.214.108.81,5,6959,0,0,5,6959,0.072198000,1.0466
215.158.239.86,<->,199.51.240.0,5,930,0,0,5,930,0.071229000,0.0158
247.115.62.51,<->,136.25.188.253,0,0,5,1239,5,1239,0.071049000,0.2375
215.158.239.95,<->,215.158.44.209,5,6353,0,0,5,6353,0.070764000,1.7828
200.175.118.228,<->,53.148.90.97,5,1380,0,0,5,1380,0.070726000,1.6224
136.25.188.176,<->,100.224.202.149,5,2191,0,0,5,2191,0.069712000,1.8541
215.158.238.133,<->,56.161.218.41,5,6753,0,0,5,6753,0.068075000,1.8663
136.25.188.173,<->,106.188.236.186,5,5985,0,0,5,5985,0.066486000,1.4637
133.178.226.83,<->,96.155.60.250,5,2063,0,0,5,2063,0.065334000,1.5500
215.158.238.198,<->,89.86.110.166,5,5450,0,0,5,5450,0.063230000,1.7710
136.25.188.172,<->,131.1.232.139,5,6593,0,0,5,6593,0.062024000,1.9157
142.228.5.217,<->,136.25.188.52,0,0,5,2014,5,2014,0.060717000,1.4248
136.25.188.208,<->,126.219.247.70,5,6193,0,0,5,6193,0.058676000,1.9407
136.25.189.32,<->,126.219.194.7,5,6017,0,0,5,6017,0.058556000,1.9244
220.28.65.9,<->,215.158.140.248,0,0,5,2833,5,2833,0.058471000,1.5221
142.182.40.182,<->,136.25.188.198,0,0,5,938,5,938,0.056104000,0.0165
215.158.140.93,<->,131.22.233.146,5,5761,0,0,5,5761,0.055635000,1.8977
136.25.189.32,<->,29.209.59.213,5,6657,0,0,5,6657,0.055132000,1.7348
215.158.239.95,<->,204.3.64.250,5,485,0,0,5,485,0.053996000,0.7400
207.62.24.74,<->,136.25.188.163,0,0,5,933,5,933,0.053943000,0.0159
194.232.127.157,<->,136.25.188.236,0,0,5,505,5,505,0.052348000,0.4610
136.25.188.226,<->,126.219.194.116,5,6353,0,0,5,6353,0.051683000,1.5784
136.25.188.199,<->,100.224.202.182,5,2325,0,0,5,2325,0.051439000,1.5056
136.25.189.29,<->,113.92.151.25,5,5517,0,0,5,5517,0.051030000,1.7466
204.200.48.192,<->,136.25.188.178,0,0,5,2273,5,2273,0.050489000,0.7276
106.168.190.223,<->,100.94.147.232,0,0,5,2187,5,2187,0.049360000,1.1887
116.111.122.136,<->,101.73.152.237,0,0,5,644,5,644,0.048803000,0.6770
136.25.188.211,<->,131.144.114.229,5,6289,0,0,5,6289,0.047760000,1.2463
136.25.189.85,<->,98.219.126.175,5,2145,0,0,5,2145,0.047323000,1.5010
215.158.61.182,<->,8.176.8.226,0,0,5,4200,5,4200,0.046784000,1.3401
136.25.189.33,<->,29.214.109.182,5,6561,0,0,5,6561,0.046178000,1.9168
133.178.227.16,<->,131.1.195.25,5,5910,0,0,5,5910,0.046138000,0.6357
215.158.239.77,<->,195.7.8.48,5,924,0,0,5,924,0.045936000,0.0207
195.126.190.87,<->,136.25.188.163,0,0,5,918,5,918,0.045171000,0.0181
220.28.73.211,<->,133.178.227.62,0,0,5,2764,5,2764,0.043446000,0.8634
215.158.238.141,<->,33.209.217.244,5,7219,0,0,5,7219,0.043009000,1.8712
215.158.140.229,<->,111.150.187.223,5,5611,0,0,5,5611,0.042075000,1.6258
222.244.167.142,<->,8.52.188.77,0,0,5,1913,5,1913,0.041096000,1.3130
215.158.140.202,<->,98.219.126.140,5,6013,0,0,5,6013,0.039035000,0.2089
215.158.239.56,<->,195.83.227.71,5,1212,0,0,5,1212,0.036479000,1.1339
215.158.238.133,<->,8.42.43.10,5,6545,0,0,5,6545,0.034945000,1.3753
215.158.140.74,<->,133.199.54.185,5,2901,0,0,5,2901,0.033466000,1.6455
247.136.137.168,<->,8.179.131.127,5,3009,0,0,5,3009,0.033216000,1.8099
53.231.66.21,<->,48.54.81.68,0,0,5,7380,5,7380,0.032638000,1.1605
216.184.2.61,<->,8.252.222.2,0,0,5,3961,5,3961,0.032419000,0.0368
136.25.188.211,<->,106.188.236.151,5,6497,0,0,5,6497,0.031049000,1.8741
133.178.227.27,<->,131.22.233.155,5,5399,0,0,5,5399,0.030980000,1.8609
215.158.238.114,<->,136.139.59.127,5,6177,0,0,5,6177,0.029781000,1.5694
215.158.238.95,<->,111.150.186.233,5,6513,0,0,5,6513,0.029627000,1.8463
136.25.189.62,<->,96.156.169.164,5,2737,0,0,5,2737,0.028898000,0.7828
215.158.239.92,<->,199.15.90.43,5,2122,0,0,5,2122,0.028097000,1.6687
204.187.27.93,<->,136.25.188.178,0,0,5,2679,5,2679,0.027380000,1.9705
133.178.227.19,<->,33.209.219.25,5,5754,0,0,5,5754,0.026572000,1.9559
142.236.213.9,<->,136.25.188.252,0,0,5,1241,5,1241,0.026514000,0.6447
136.25.189.30,<->,96.156.169.162,5,3492,0,0,5,3492,0.025431000,1.9223
204.200.52.179,<->,136.25.188.54,0,0,5,2019,5,2019,0.025090000,1.1151
152.43.87.87,<->,8.252.221.206,0,0,5,1585,5,1585,0.024280000,1.8170
204.21.245.115,<->,136.25.188.227,0,0,5,2001,5,2001,0.023976000,0.9046
136.25.188.255,<->,60.166.83.101,5,1821,0,0,5,1821,0.023485000,1.8818
136.25.188.243,<->,80.47.228.213,5,6529,0,0,5,6529,0.023092000,1.6876
231.142.214.36,<->,136.25.188.209,0,0,5,922,5,922,0.022424000,0.0161
136.25.188.197,<->,112.220.206.12,5,6449,0,0,5,6449,0.021214000,1.4767
215.158.239.49,<->,196.89.239.231,5,3600,0,0,5,3600,0.020907000,0.2841
215.158.238.81,<->,112.220.206.118,5,6433,0,0,5,6433,0.019678000,1.5181
215.158.239.76,<->,196.94.224.209,5,1246,0,0,5,1246,0.019436000,0.5604
215.158.238.229,<->,215.158.43.12,5,1440,0,0,5,1440,0.019044000,0.5561
144.64.138.63,<->,107.250.233.36,5,3594,0,0,5,3594,0.018576000,0.5452
231.141.204.236,<->,136.25.188.243,0,0,5,2051,5,2051,0.018353000,1.2556
136.25.189.83,<->,29.211.228.176,5,5561,0,0,5,5561,0.018334000,1.2303
99.187.125.122,<->,8.20.87.10,0,0,5,6436,5,6436,0.017982000,0.0001
136.25.189.81,<->,116.106.46.84,5,6874,0,0,5,6874,0.017159000,1.6381
195.13.79.155,<->,136.25.188.227,0,0,5,2171,5,2171,0.017040000,1.7287
133.178.227.29,<->,133.56.180.46,5,2529,0,0,5,2529,0.016970000,1.5079
216.184.2.192,<->,136.25.189.28,0,0,5,5386,5,5386,0.016077000,1.6086
221.102.56.46,<->,213.38.232.157,0,0,5,3185,5,3185,0.016065000,0.1324
109.48.48.57,<->,8.182.244.19,0,0,5,2468,5,2468,0.015696000,0.1404
215.158.239.84,<->,204.3.50.238,5,2125,0,0,5,2125,0.015660000,0.8032
136.25.189.24,<->,96.156.169.208,5,4138,0,0,5,4138,0.015266000,1.3567
133.178.227.76,<->,8.191.7.233,5,5369,0,0,5,5369,0.014293000,0.7997
136.25.189.21,<->,56.28.207.196,5,3456,0,0,5,3456,0.014090000,1.5458
215.158.61.191,<->,8.176.8.218,0,0,5,4935,5,4935,0.012998000,1.7206
156.150.157.123,<->,8.252.222.140,0,0,5,1551,5,1551,0.010779000,1.1569
109.1.19.72,<->,22.249.49.193,5,7520,0,0,5,7520,0.009359000,1.9594
133.178.226.37,<->,29.214.64.189,5,6417,0,0,5,6417,0.009339000,1.6882
247.136.212.186,<->,42.255.83.31,5,2453,0,0,5,2453,0.009300000,1.8580
215.158.239.68,<->,199.20.22.50,5,1754,0,0,5,1754,0.007472000,1.3491
129.243.217.199,<->,80.27.153.103,0,0,5,5697,5,5697,0.007373000,1.9767
215.158.238.64,<->,113.23.20.241,5,6561,0,0,5,6561,0.007170000,1.9330
216.184.2.48,<->,136.25.188.212,0,0,5,3033,5,3033,0.006319000,0.6176
246.253.134.209,<->,199.9.92.253,5,921,0,0,5,921,0.005972000,0.4159
215.158.238.82,<->,131.1.253.217,5,7088,0,0,5,7088,0.005268000,1.5466
215.158.239.79,<->,199.72.91.233,5,1278,0,0,5,1278,0.003695000,0.5616
215.158.238.177,<->,126.219.246.238,5,5375,0,0,5,5375,0.003265000,1.7117
215.158.239.57,<->,194.237.139.11,5,1988,0,0,5,1988,0.001939000,1.1980
215.158.140.83,<->,8.222.213.13,5,5380,0,0,5,5380,0.001930000,1.6217
215.158.239.107,<->,215.158.61.202,5,3526,0,0,5,3526,0.001605000,1.7873
220.60.81.139,<->,136.25.189.57,0,0,5,6273,5,6273,0.001575000,0.9046
215.158.239.49,<->,118.20.100.135,5,6417,0,0,5,6417,0.001291000,1.5830
136.25.188.46,<->,126.219.194.148,5,6529,0,0,5,6529,0.001059000,0.9469
207.175.241.91,<->,136.25.188.55,0,0,5,929,5,929,0.000319000,0.0155
215.158.239.29,<->,122.158.246.174,5,7050,0,0,5,7050,0.000195000,1.5915
215.158.238.119,<->,100.120.38.6,4,4181,0,0,4,4181,1.998151000,0.0004
207.100.224.146,<->,0.195.210.44,0,0,4,1588,4,1588,1.973830000,0.0147
215.158.140.195,<->,8.222.7.170,4,3862,0,0,4,3862,1.966883000,0.0085
132.70.176.15,<->,109.222.205.202,0,0,4,1709,4,1709,1.957581000,0.0006
196.89.112.5,<->,136.25.188.160,0,0,4,1902,4,1902,1.931553000,0.0185
215.158.238.6,<->,192.229.42.133,4,2297,0,0,4,2297,1.902591000,0.0821
193.81.55.4,<->,92.162.253.40,0,0,4,4573,4,4573,1.901956000,0.0001
138.98.204.211,<->,119.45.190.118,4,991,0,0,4,991,1.901614000,0.0408
199.38.61.185,<->,136.25.188.55,0,0,4,991,4,991,1.897187000,0.1024
207.58.104.155,<->,136.25.188.53,0,0,4,1883,4,1883,1.886442000,0.0610
195.13.254.149,<->,136.25.188.177,0,0,4,1964,4,1964,1.880561000,0.0337
114.83.212.226,<->,108.134.118.112,0,0,4,4574,4,4574,1.877285000,0.1169
142.207.123.49,<->,136.25.188.163,0,0,4,523,4,523,1.862762000,0.0091
143.95.233.162,<->,136.25.188.225,0,0,4,1521,4,1521,1.862135000,0.1235
215.158.61.189,<->,8.176.8.109,0,0,4,999,4,999,1.853766000,0.0643
215.158.239.240,<->,54.50.105.135,4,2363,0,0,4,2363,1.852028000,0.1120
192.65.90.162,<->,132.250.195.48,4,3516,0,0,4,3516,1.845719000,0.0013
144.72.193.17,<->,101.70.109.51,0,0,4,4141,4,4141,1.845231000,0.1304
143.79.176.241,<->,136.25.188.52,0,0,4,1813,4,1813,1.842675000,0.0184
143.35.82.200,<->,136.25.188.197,0,0,4,1890,4,1890,1.841583000,0.0207
215.158.238.124,<->,98.219.126.140,4,4029,0,0,4,4029,1.837410000,0.0001
220.20.200.95,<->,139.33.210.9,4,1956,0,0,4,1956,1.835034000,0.0002
220.55.77.11,<->,220.50.241.131,4,2071,0,0,4,2071,1.828756000,0.1561
215.158.239.46,<->,136.114.101.93,4,1763,0,0,4,1763,1.820440000,0.1524
136.25.188.238,<->,100.174.69.226,4,1489,0,0,4,1489,1.819809000,0.1524
220.20.200.163,<->,131.69.188.185,4,2382,0,0,4,2382,1.814966000,0.0006
199.71.10.244,<->,136.25.188.238,0,0,4,1121,4,1121,1.806550000,0.0672
216.184.1.115,<->,136.25.188.165,0,0,4,555,4,555,1.802990000,0.1496
195.14.160.106,<->,136.25.188.209,0,0,4,1121,4,1121,1.782173000,0.1818
204.187.220.47,<->,136.25.188.45,0,0,4,2281,4,2281,1.772957000,0.1899
196.148.166.194,<->,53.195.174.8,4,4592,0,0,4,4592,1.758667000,0.2139
215.158.238.102,<->,98.219.126.140,4,3612,0,0,4,3612,1.757420000,0.2373
246.253.253.170,<->,233.145.251.148,4,3321,0,0,4,3321,1.747125000,0.1428
100.206.95.178,<->,80.27.153.136,0,0,4,1762,4,1762,1.742760000,0.0689
207.61.131.146,<->,136.25.188.54,0,0,4,1763,4,1763,1.740665000,0.0174
17.226.144.40,<->,8.53.4.39,0,0,4,995,4,995,1.727010000,0.1586
136.25.188.212,<->,80.57.141.209,4,1819,0,0,4,1819,1.724908000,0.1499
145.72.38.32,<->,136.25.188.252,0,0,4,1774,4,1774,1.724883000,0.1881
215.158.238.118,<->,159.218.248.240,4,3233,0,0,4,3233,1.717477000,0.0416
195.14.255.243,<->,136.25.188.209,0,0,4,1210,4,1210,1.716401000,0.1707
220.28.114.28,<->,215.158.238.90,0,0,4,3454,4,3454,1.715929000,0.2619
239.66.156.251,<->,138.98.204.211,0,0,4,6016,4,6016,1.715108000,0.2392
17.41.129.123,<->,8.53.0.16,0,0,4,1144,4,1144,1.707343000,0.2803
221.101.9.49,<->,145.185.253.130,4,1462,0,0,4,1462,1.703782000,0.1835
145.252.122.253,<->,100.120.38.6,4,1464,0,0,4,1464,1.703003000,0.2513
245.161.124.44,<->,8.252.222.60,0,0,4,1421,4,1421,1.702398000,0.1523
192.64.93.227,<->,8.55.211.213,4,1176,0,0,4,1176,1.675967000,0.2343
210.220.219.181,<->,53.240.183.135,4,1320,0,0,4,1320,1.672620000,0.1436
137.44.153.212,<->,136.25.188.198,0,0,4,1418,4,1418,1.663554000,0.0289
215.158.239.58,<->,196.94.72.151,4,1981,0,0,4,1981,1.643776000,0.1800
98.156.225.133,<->,8.182.226.78,0,0,4,830,4,830,1.642837000,0.0869
205.127.108.114,<->,33.233.141.67,0,0,4,1702,4,1702,1.641390000,0.3454
215.158.239.94,<->,194.199.200.31,4,1199,0,0,4,1199,1.637895000,0.1786
8.235.250.45,<->,8.228.208.45,0,0,4,2036,4,2036,1.637499000,0.2608
215.158.239.95,<->,195.97.145.102,4,1188,0,0,4,1188,1.637464000,0.0000
6.145.165.95,<->,0.195.210.46,0,0,4,1449,4,1449,1.634957000,0.1205
215.158.239.84,<->,199.20.28.104,4,3248,0,0,4,3248,1.633602000,0.3306
246.253.253.208,<->,142.225.12.35,4,516,0,0,4,516,1.629084000,0.2951
139.249.3.26,<->,92.27.219.195,0,0,4,516,4,516,1.625452000,0.0000
97.182.7.133,<->,8.52.153.105,0,0,4,928,4,928,1.619200000,0.3334
215.158.140.172,<->,98.249.65.9,4,3229,0,0,4,3229,1.617899000,0.2688
142.244.59.48,<->,136.25.188.237,0,0,4,1151,4,1151,1.616102000,0.3234
144.83.60.137,<->,92.162.253.95,0,0,4,2351,4,2351,1.612391000,0.2988
159.137.222.214,<->,50.62.237.14,4,2732,0,0,4,2732,1.612012000,0.0624
220.28.109.52,<->,136.25.188.56,0,0,4,3821,4,3821,1.609512000,0.1175
136.25.188.213,<->,80.57.141.161,4,2323,0,0,4,2323,1.608906000,0.1138
127.24.153.155,<->,50.224.108.171,0,0,4,1648,4,1648,1.607080000,0.3633
215.158.61.223,<->,8.176.8.179,0,0,4,1923,4,1923,1.603956000,0.1155
139.163.26.146,<->,101.85.186.19,4,929,0,0,4,929,1.601028000,0.3381
136.25.188.176,<->,30.73.148.141,4,3528,0,0,4,3528,1.600212000,0.2011
246.254.97.103,<->,210.209.251.211,4,3059,0,0,4,3059,1.599660000,0.0695
100.228.42.99,<->,83.192.117.230,4,1412,0,0,4,1412,1.595095000,0.1165
215.158.239.66,<->,145.116.209.92,4,651,0,0,4,651,1.586526000,0.1089
136.25.188.213,<->,56.51.205.162,4,2356,0,0,4,2356,1.583869000,0.4142
195.13.79.155,<->,136.25.188.55,0,0,4,2500,4,2500,1.578669000,0.1739
89.183.107.124,<->,35.62.70.58,4,438,0,0,4,438,1.574898000,0.1278
143.23.190.146,<->,136.25.188.174,0,0,4,2419,4,2419,1.568769000,0.4180
111.20.172.118,<->,33.233.141.42,0,0,4,1642,4,1642,1.561328000,0.0087
142.223.135.254,<->,136.25.188.253,0,0,4,925,4,925,1.552094000,0.0418
195.71.77.53,<->,136.25.188.176,0,0,4,1904,4,1904,1.543371000,0.0917
136.25.189.193,<->,53.231.140.159,4,4656,0,0,4,4656,1.536186000,0.0460
199.15.241.133,<->,136.25.188.253,0,0,4,1163,4,1163,1.526126000,0.0067
215.158.239.109,<->,192.205.38.182,4,2154,0,0,4,2154,1.525533000,0.0929
98.128.148.250,<->,8.49.69.111,4,1973,0,0,4,1973,1.523485000,0.1329
142.240.10.46,<->,136.25.188.198,0,0,4,1892,4,1892,1.519632000,0.3463
215.158.239.79,<->,195.71.91.68,4,1549,0,0,4,1549,1.516017000,0.3130
215.158.239.77,<->,194.237.192.218,4,1372,0,0,4,1372,1.511854000,0.2314
220.20.200.179,<->,144.83.60.138,4,2353,0,0,4,2353,1.511397000,0.1358
207.61.68.151,<->,136.25.188.174,0,0,4,2169,4,2169,1.507863000,0.2772
17.99.120.221,<->,8.53.4.39,0,0,4,810,4,810,1.498263000,0.4186
215.158.140.241,<->,159.137.139.2,4,4590,0,0,4,4590,1.496077000,0.3077
8.176.8.48,<->,8.33.227.22,4,1375,0,0,4,1375,1.492313000,0.0923
143.129.165.208,<->,136.25.188.209,0,0,4,1200,4,1200,1.490681000,0.2228
210.220.219.150,<->,53.231.144.47,4,2115,0,0,4,2115,1.482060000,0.2534
215.158.61.243,<->,8.176.8.102,0,0,4,1127,4,1127,1.475706000,0.0994
143.128.25.212,<->,136.25.188.46,0,0,4,829,4,829,1.475049000,0.0157
215.158.239.56,<->,196.105.24.5,4,1154,0,0,4,1154,1.473161000,0.3794
136.25.188.252,<->,83.226.197.42,4,1019,0,0,4,1019,1.463191000,0.1064
215.158.238.193,<->,215.158.33.121,4,4666,0,0,4,4666,1.458229000,0.0013
136.25.188.224,<->,110.32.234.47,4,1082,0,0,4,1082,1.454308000,0.1127
207.56.62.103,<->,136.25.188.225,0,0,4,1026,4,1026,1.446534000,0.3866
199.72.62.147,<->,136.25.188.220,0,0,4,1084,4,1084,1.444775000,0.2421
144.70.14.36,<->,111.160.232.222,4,1500,0,0,4,1500,1.442306000,0.3116
91.48.164.164,<->,8.52.226.56,0,0,4,1516,4,1516,1.438893000,0.4402
215.158.239.94,<->,145.13.164.171,4,5332,0,0,4,5332,1.433130000,0.5519
139.193.141.143,<->,127.138.6.148,4,1692,0,0,4,1692,1.432274000,0.1395
207.57.139.22,<->,136.25.188.222,0,0,4,1908,4,1908,1.431480000,0.0320
215.158.239.68,<->,204.226.7.236,4,1869,0,0,4,1869,1.425142000,0.4640
82.195.7.180,<->,8.228.209.115,0,0,4,2228,4,2228,1.417174000,0.1075
215.158.61.211,<->,136.25.189.214,0,0,4,1891,4,1891,1.414215000,0.3076
53.86.58.175,<->,8.228.213.135,0,0,4,1207,4,1207,1.408005000,0.1731
138.121.99.24,<->,8.220.200.124,0,0,4,1783,4,1783,1.405277000,0.2778
204.185.2.234,<->,136.25.188.236,0,0,4,1916,4,1916,1.400349000,0.0001
8.252.223.106,<->,8.240.116.203,4,2641,0,0,4,2641,1.395889000,0.4069
207.60.34.137,<->,136.25.188.174,0,0,4,1183,4,1183,1.394150000,0.0816
233.121.8.176,<->,8.182.136.93,0,0,4,1552,4,1552,1.390634000,0.5632
215.158.238.64,<->,8.42.43.38,4,2929,0,0,4,2929,1.385146000,0.4436
194.232.228.105,<->,136.25.188.253,0,0,4,2542,4,2542,1.383023000,0.6152
215.158.103.203,<->,89.193.125.208,4,1469,0,0,4,1469,1.379899000,0.3304
215.158.238.87,<->,98.219.126.175,4,3842,0,0,4,3842,1.372132000,0.5920
215.158.239.57,<->,196.92.47.228,4,1902,0,0,4,1902,1.371958000,0.1804
192.67.139.230,<->,22.63.36.222,4,1028,0,0,4,1028,1.368089000,0.1423
231.142.117.120,<->,215.158.239.99,0,0,4,1201,4,1201,1.365098000,0.6209
206.243.229.66,<->,89.216.125.197,0,0,4,2113,4,2113,1.363495000,0.2985
145.89.76.85,<->,8.204.67.165,4,1971,0,0,4,1971,1.355421000,0.2435
142.190.168.226,<->,136.25.188.209,0,0,4,1157,4,1157,1.353981000,0.4023
224.148.55.181,<->,100.124.212.156,4,1839,0,0,4,1839,1.351368000,0.2828
139.192.40.145,<->,8.52.222.23,0,0,4,1520,4,1520,1.351094000,0.4571
248.80.123.25,<->,133.32.39.0,0,0,4,2131,4,2131,1.350343000,0.1588
132.216.20.179,<->,109.1.50.82,0,0,4,3564,4,3564,1.347763000,0.0484
204.3.189.5,<->,136.25.188.55,0,0,4,2461,4,2461,1.336056000,0.3577
215.158.61.189,<->,8.176.8.197,0,0,4,4548,4,4548,1.332633000,0.4170
215.158.239.232,<->,192.228.30.153,4,1399,0,0,4,1399,1.330800000,0.0730
66.63.121.251,<->,8.252.221.238,0,0,4,1386,4,1386,1.322663000,0.5658
215.158.30.254,<->,8.252.222.189,0,0,4,2523,4,2523,1.321016000,0.2668
136.25.189.86,<->,96.156.169.251,4,3796,0,0,4,3796,1.320865000,0.1809
159.162.41.223,<->,8.182.244.237,0,0,4,1929,4,1929,1.319101000,0.2790
136.25.188.253,<->,56.99.122.10,4,895,0,0,4,895,1.317619000,0.0050
215.158.239.87,<->,199.72.81.3,4,1202,0,0,4,1202,1.312328000,0.2637
8.252.223.130,<->,8.192.205.88,4,1889,0,0,4,1889,1.311190000,0.4693
80.41.26.161,<->,8.179.131.127,4,2588,0,0,4,2588,1.301441000,0.6585
221.102.143.189,<->,98.128.149.196,0,0,4,2668,4,2668,1.297610000,0.2281
195.14.93.212,<->,136.25.188.236,0,0,4,1902,4,1902,1.291060000,0.2142
142.227.168.201,<->,136.25.188.241,0,0,4,2664,4,2664,1.287790000,0.6644
133.178.227.16,<->,133.56.180.15,4,5189,0,0,4,5189,1.286967000,0.7050
86.135.85.27,<->,8.252.222.163,0,0,4,1142,4,1142,1.286357000,0.6265
220.55.106.26,<->,105.67.223.235,4,3426,0,0,4,3426,1.285791000,0.5802
215.158.61.243,<->,8.176.8.224,0,0,4,4911,4,4911,1.283751000,0.6257
220.28.85.14,<->,136.25.189.8,0,0,4,2245,4,2245,1.279789000,0.7144
215.158.239.200,<->,145.82.220.164,4,1096,0,0,4,1096,1.279021000,0.0244
136.25.188.202,<->,80.57.141.161,4,2299,0,0,4,2299,1.278809000,0.0710
220.80.200.232,<->,158.14.42.202,4,342,0,0,4,342,1.264116000,0.4210
195.7.114.141,<->,136.25.188.220,0,0,4,1894,4,1894,1.262553000,0.3299
91.231.220.149,<->,6.228.14.212,0,0,4,1714,4,1714,1.258876000,0.1190
195.15.205.230,<->,136.25.188.46,0,0,4,1124,4,1124,1.258796000,0.2718
195.69.197.9,<->,136.25.188.175,0,0,4,1449,4,1449,1.253877000,0.2026
215.158.127.14,<->,99.74.26.99,0,0,4,1511,4,1511,1.240095000,0.1241
136.181.39.147,<->,0.195.216.195,4,264,0,0,4,264,1.239460000,0.2640
98.101.64.87,<->,8.182.226.42,0,0,4,799,4,799,1.235427000,0.4404
220.20.200.97,<->,35.107.149.134,4,5812,0,0,4,5812,1.232389000,0.0218
220.39.233.218,<->,215.158.238.135,0,0,4,5236,4,5236,1.231382000,0.7233
136.25.188.45,<->,122.159.245.164,4,5444,0,0,4,5444,1.229222000,0.7536
220.60.81.189,<->,215.158.239.69,0,0,4,5220,4,5220,1.219719000,0.6699
248.225.27.2,<->,53.240.100.109,4,2832,0,0,4,2832,1.212500000,0.4804
249.101.209.167,<->,246.108.107.164,4,204,0,0,4,204,1.211570000,0.7638
143.134.32.44,<->,136.25.188.242,0,0,4,1815,4,1815,1.211258000,0.6363
215.158.238.70,<->,0.195.253.228,4,3934,0,0,4,3934,1.210690000,0.4967
111.147.221.66,<->,53.69.106.30,4,2092,0,0,4,2092,1.209857000,0.3485
207.172.137.205,<->,136.25.188.237,0,0,4,1181,4,1181,1.209262000,0.5294
97.198.121.8,<->,80.27.154.150,4,1205,0,0,4,1205,1.206748000,0.1404
144.87.238.89,<->,8.182.241.94,0,0,4,1288,4,1288,1.204750000,0.7320
75.145.6.49,<->,8.252.221.236,0,0,4,1518,4,1518,1.204118000,0.6568
136.25.189.22,<->,98.219.126.175,4,4627,0,0,4,4627,1.202875000,0.0001
97.28.31.82,<->,8.176.53.29,0,0,4,2576,4,2576,1.201746000,0.7423
215.158.238.108,<->,0.195.253.228,4,3625,0,0,4,3625,1.198864000,0.0001
199.36.28.158,<->,99.75.109.64,0,0,4,786,4,786,1.194454000,0.5493
138.0.9.133,<->,80.42.166.226,0,0,4,3014,4,3014,1.194411000,0.2308
195.71.163.209,<->,136.25.188.162,0,0,4,1055,4,1055,1.187963000,0.6244
221.102.143.189,<->,6.74.84.69,0,0,4,3764,4,3764,1.186854000,0.5050
215.158.239.95,<->,199.79.138.142,4,1139,0,0,4,1139,1.186564000,0.6600
215.158.239.56,<->,142.236.54.27,4,1771,0,0,4,1771,1.185112000,0.5510
195.7.234.210,<->,136.25.188.163,0,0,4,1442,4,1442,1.184460000,0.2875
142.221.131.21,<->,136.25.188.239,0,0,4,1204,4,1204,1.180549000,0.4031
215.158.239.101,<->,129.222.39.211,4,3892,0,0,4,3892,1.176622000,0.7710
136.25.188.254,<->,112.220.206.106,4,5140,0,0,4,5140,1.172865000,0.7781
247.136.142.34,<->,14.30.152.106,4,2505,0,0,4,2505,1.169650000,0.2870
109.1.15.105,<->,100.124.212.251,4,1698,0,0,4,1698,1.169581000,0.1195
215.158.239.94,<->,215.158.44.217,4,5476,0,0,4,5476,1.167363000,0.7111
193.21.29.216,<->,89.183.104.177,0,0,4,1480,4,1480,1.165848000,0.1491
215.158.239.51,<->,142.227.29.246,4,1788,0,0,4,1788,1.164866000,0.7853
207.236.29.192,<->,136.25.188.209,0,0,4,1200,4,1200,1.163550000,0.4721
133.178.227.24,<->,133.56.180.32,4,5232,0,0,4,5232,1.163343000,0.7646
136.141.228.139,<->,8.182.224.143,0,0,4,2104,4,2104,1.162913000,0.0860
215.158.239.57,<->,196.104.174.247,4,523,0,0,4,523,1.162836000,0.0400
139.193.141.139,<->,113.130.29.26,4,1360,0,0,4,1360,1.158326000,0.1623
133.178.226.223,<->,100.224.141.92,4,3038,0,0,4,3038,1.158281000,0.0011
6.145.170.142,<->,0.195.210.44,0,0,4,499,4,499,1.152586000,0.1848
142.236.26.159,<->,136.25.188.198,0,0,4,1133,4,1133,1.148773000,0.7354
220.28.65.9,<->,136.25.189.62,0,0,4,2037,4,2037,1.147547000,0.2564
136.25.189.23,<->,96.156.169.250,4,1684,0,0,4,1684,1.140088000,0.6450
215.158.61.182,<->,136.25.188.37,0,0,4,4035,4,4035,1.132538000,0.6653
136.25.189.1,<->,8.255.92.165,4,4884,0,0,4,4884,1.132176000,0.5484
139.205.240.199,<->,0.195.210.46,0,0,4,3080,4,3080,1.130529000,0.4943
207.236.205.138,<->,136.25.188.209,0,0,4,1040,4,1040,1.128755000,0.4046
193.35.127.52,<->,50.224.108.164,0,0,4,352,4,352,1.124560000,0.1187
246.253.198.33,<->,198.114.103.82,4,1269,0,0,4,1269,1.122560000,0.4592
133.165.252.43,<->,132.18.67.27,4,2296,0,0,4,2296,1.120465000,0.1749
215.158.239.70,<->,199.20.100.95,4,928,0,0,4,928,1.117866000,0.2307
220.28.85.14,<->,133.178.227.39,0,0,4,1627,4,1627,1.115436000,0.8408
136.25.189.13,<->,96.156.169.222,4,4156,0,0,4,4156,1.114914000,0.8121
215.158.2.8,<->,8.176.8.71,0,0,4,1420,4,1420,1.111481000,0.1352
197.113.99.146,<->,136.25.188.176,0,0,4,1285,4,1285,1.107710000,0.2704
200.175.155.31,<->,53.149.17.194,4,2439,0,0,4,2439,1.104360000,0.7337
100.235.148.203,<->,8.220.202.4,0,0,4,799,4,799,1.100588000,0.1986
215.158.239.227,<->,192.229.43.21,4,2897,0,0,4,2897,1.099535000,0.0195
205.127.108.113,<->,101.224.89.153,0,0,4,1385,4,1385,1.097783000,0.7454
129.236.73.9,<->,33.233.141.41,0,0,4,1376,4,1376,1.091725000,0.1767
215.158.239.35,<->,50.248.187.107,4,1495,0,0,4,1495,1.091423000,0.7127
139.47.193.207,<->,101.224.89.168,0,0,4,2280,4,2280,1.085491000,0.0001
136.25.189.82,<->,131.144.113.17,4,2977,0,0,4,2977,1.083772000,0.5956
142.191.53.184,<->,136.25.188.255,0,0,4,2592,4,2592,1.077697000,0.6378
224.93.235.38,<->,80.27.157.204,0,0,4,4228,4,4228,1.077186000,0.7838
231.142.170.225,<->,215.158.239.96,0,0,4,1195,4,1195,1.066718000,0.5935
215.158.239.95,<->,202.33.255.47,4,1473,0,0,4,1473,1.065032000,0.3010
215.158.238.75,<->,104.3.168.215,4,5300,0,0,4,5300,1.062002000,0.9230
215.158.239.83,<->,80.57.141.226,4,2635,0,0,4,2635,1.061112000,0.1566
199.71.75.181,<->,136.25.188.237,0,0,4,995,4,995,1.060795000,0.0277
194.237.181.162,<->,136.25.188.52,0,0,4,1220,4,1220,1.054541000,0.1106
136.114.101.39,<->,136.25.188.202,0,0,4,2510,4,2510,1.048206000,0.1021
17.232.218.163,<->,8.220.200.124,0,0,4,1895,4,1895,1.042828000,0.1486
97.11.170.243,<->,53.243.10.49,4,1023,0,0,4,1023,1.038005000,0.1871
133.178.227.37,<->,133.56.180.46,4,2732,0,0,4,2732,1.037765000,0.0605
251.20.81.56,<->,108.134.108.240,0,0,4,3604,4,3604,1.033257000,0.9109
215.158.103.203,<->,54.35.184.63,4,1046,0,0,4,1046,1.031836000,0.4264
95.247.202.207,<->,8.252.222.38,0,0,4,971,4,971,1.029661000,0.2532
121.252.111.148,<->,92.162.253.185,0,0,4,1107,4,1107,1.029002000,0.5661
111.147.128.43,<->,27.187.159.112,4,2018,0,0,4,2018,1.027803000,0.4750
142.249.41.15,<->,136.25.188.252,0,0,4,1360,4,1360,1.025535000,0.4324
50.224.108.164,<->,50.54.143.245,4,687,0,0,4,687,1.024543000,0.0684
144.87.238.89,<->,8.182.226.78,0,0,4,1312,4,1312,1.024157000,0.7453
136.25.189.1,<->,96.156.169.229,4,4380,0,0,4,4380,1.019091000,0.8586
136.25.189.80,<->,8.222.98.139,4,5140,0,0,4,5140,1.013211000,0.6301
136.138.112.227,<->,133.178.226.90,0,0,4,4932,4,4932,1.013129000,0.8316
204.56.73.236,<->,136.25.188.253,0,0,4,1207,4,1207,1.011534000,0.3457
215.158.239.69,<->,207.213.204.99,4,1771,0,0,4,1771,1.008419000,0.7081
215.158.238.135,<->,197.125.126.183,4,5252,0,0,4,5252,1.006521000,0.9899
139.193.141.139,<->,109.0.52.150,4,1363,0,0,4,1363,1.005731000,0.0425
136.25.189.53,<->,96.156.169.236,4,3749,0,0,4,3749,0.998629000,0.3300
195.43.207.94,<->,136.25.188.173,0,0,4,2580,4,2580,0.995609000,0.6954
220.28.85.14,<->,136.25.188.229,0,0,4,3103,4,3103,0.995253000,0.9542
215.158.239.69,<->,38.104.11.1,4,5156,0,0,4,5156,0.995170000,0.6668
136.25.189.80,<->,118.20.100.91,4,4756,0,0,4,4756,0.992922000,0.9612
215.158.239.96,<->,199.106.17.217,4,1160,0,0,4,1160,0.991402000,0.3598
210.158.44.190,<->,124.55.166.114,4,4428,0,0,4,4428,0.988987000,0.1450
215.158.239.76,<->,196.106.13.2,4,1163,0,0,4,1163,0.985170000,0.4701
212.164.143.185,<->,132.213.199.17,4,694,0,0,4,694,0.976969000,0.2434
133.178.227.2,<->,29.211.228.152,4,4359,0,0,4,4359,0.974434000,1.0150
142.244.203.221,<->,136.25.188.225,0,0,4,992,4,992,0.971462000,0.3589
220.28.104.193,<->,133.178.227.61,0,0,4,2079,4,2079,0.969540000,0.8948
138.74.27.44,<->,0.195.216.196,4,4423,0,0,4,4423,0.969445000,0.6371
215.158.140.84,<->,98.219.126.140,4,3020,0,0,4,3020,0.968046000,0.8476
105.201.225.210,<->,50.224.89.243,0,0,4,1287,4,1287,0.963470000,0.7784
142.228.55.242,<->,136.25.188.241,0,0,4,2612,4,2612,0.956426000,0.5331
129.225.3.123,<->,89.183.104.188,0,0,4,1726,4,1726,0.955145000,0.1304
141.35.182.149,<->,8.252.221.207,0,0,4,2554,4,2554,0.952049000,0.5066
50.224.108.164,<->,17.94.133.141,4,352,0,0,4,352,0.950230000,0.0372
89.155.206.148,<->,35.56.97.26,0,0,4,1162,4,1162,0.948966000,0.1688
54.39.125.87,<->,48.53.110.16,0,0,4,2439,4,2439,0.948413000,0.6458
205.148.107.77,<->,192.64.244.21,0,0,4,342,4,342,0.948000000,0.3960
89.183.106.113,<->,89.155.206.148,4,1162,0,0,4,1162,0.947026000,0.1687
199.82.145.50,<->,136.25.188.199,0,0,4,1159,4,1159,0.943423000,0.2816
133.178.226.37,<->,126.219.247.41,4,4788,0,0,4,4788,0.937870000,0.4429
215.158.140.241,<->,139.8.186.147,4,4470,0,0,4,4470,0.933873000,0.7369
109.222.242.54,<->,53.83.54.62,4,2965,0,0,4,2965,0.924541000,0.2383
215.158.3.188,<->,133.178.227.253,0,0,4,3476,4,3476,0.922130000,0.9053
215.158.238.141,<->,131.36.198.123,4,5633,0,0,4,5633,0.920829000,1.0148
221.102.143.189,<->,192.67.160.106,0,0,4,2924,4,2924,0.919496000,0.2198
111.150.186.97,<->,6.73.247.117,0,0,4,5669,4,5669,0.918679000,0.0025
215.158.239.95,<->,195.41.158.62,4,1886,0,0,4,1886,0.918154000,0.7478
249.101.200.68,<->,53.167.151.133,4,2080,0,0,4,2080,0.916103000,0.9556
136.25.189.82,<->,29.209.59.175,4,4900,0,0,4,4900,0.914240000,0.9125
216.184.2.255,<->,136.25.189.15,0,0,4,5236,4,5236,0.913050000,0.5891
195.15.186.62,<->,136.25.188.177,0,0,4,1154,4,1154,0.912716000,0.4728
136.25.188.52,<->,126.219.194.186,4,5188,0,0,4,5188,0.910536000,0.7918
215.158.239.92,<->,195.69.31.186,4,1652,0,0,4,1652,0.907132000,0.5457
215.158.239.113,<->,129.222.36.45,4,2073,0,0,4,2073,0.901561000,1.0722
215.158.239.50,<->,204.3.178.49,4,1691,0,0,4,1691,0.901231000,0.9015
231.138.232.202,<->,136.25.188.174,0,0,4,781,4,781,0.900157000,0.8402
195.13.28.254,<->,136.25.188.177,0,0,4,1543,4,1543,0.894755000,0.4619
215.158.238.135,<->,8.42.43.40,4,5236,0,0,4,5236,0.889751000,0.7893
210.226.164.119,<->,8.235.250.45,4,2036,0,0,4,2036,0.885616000,0.3365
136.25.188.168,<->,100.224.202.185,4,2930,0,0,4,2930,0.883065000,0.6628
215.158.238.135,<->,57.210.107.27,4,5380,0,0,4,5380,0.882688000,0.9067
143.128.118.67,<->,136.25.188.175,0,0,4,602,4,602,0.877713000,0.4055
220.55.79.216,<->,35.56.3.196,4,2092,0,0,4,2092,0.874429000,0.6159
136.25.188.210,<->,91.57.173.62,4,4916,0,0,4,4916,0.874423000,1.0814
215.158.238.83,<->,149.250.115.27,4,5252,0,0,4,5252,0.871419000,1.0873
192.65.97.112,<->,8.55.224.156,4,3651,0,0,4,3651,0.870699000,0.1301
133.178.226.18,<->,122.158.49.128,4,4588,0,0,4,4588,0.869957000,0.7969
220.28.114.28,<->,215.158.239.91,0,0,4,4259,4,4259,0.869909000,0.0001
136.25.188.221,<->,112.235.95.74,4,5028,0,0,4,5028,0.868237000,0.9649
215.158.61.203,<->,136.25.189.202,0,0,4,3454,4,3454,0.866215000,0.8235
215.158.239.77,<->,199.20.30.206,4,2099,0,0,4,2099,0.864552000,0.7607
199.15.175.78,<->,136.25.188.226,0,0,4,1176,4,1176,0.862403000,0.4237
136.25.188.34,<->,127.168.165.134,4,1360,0,0,4,1360,0.862125000,0.1033
192.204.123.54,<->,136.25.189.15,0,0,4,5172,4,5172,0.860482000,1.0938
198.206.114.227,<->,99.75.71.96,0,0,4,659,4,659,0.858654000,0.3025
80.42.171.157,<->,8.55.224.156,4,2668,0,0,4,2668,0.857346000,0.1602
254.242.184.252,<->,117.46.38.254,4,1784,0,0,4,1784,0.857054000,0.9032
215.158.239.79,<->,199.20.4.239,4,1163,0,0,4,1163,0.852573000,0.3140
194.252.199.80,<->,8.252.222.220,0,0,4,1896,4,1896,0.850230000,0.8834
202.33.225.34,<->,136.25.188.225,0,0,4,2884,4,2884,0.848742000,0.3799
136.25.189.18,<->,126.219.194.73,4,4167,0,0,4,4167,0.847848000,1.0701
215.158.239.49,<->,142.227.68.157,4,1578,0,0,4,1578,0.846189000,0.1745
136.25.189.33,<->,126.219.194.74,4,5252,0,0,4,5252,0.845433000,0.9789
136.25.188.176,<->,131.1.195.246,4,4348,0,0,4,4348,0.841591000,0.8074
205.127.108.115,<->,101.224.89.228,0,0,4,2131,4,2131,0.838827000,0.8549
249.85.97.100,<->,56.121.39.173,0,0,4,2072,4,2072,0.836981000,0.2282
133.178.227.54,<->,133.56.180.88,4,1881,0,0,4,1881,0.833847000,0.9389
8.182.244.237,<->,6.21.253.57,4,1712,0,0,4,1712,0.833096000,0.6212
111.146.224.2,<->,53.149.237.205,4,3003,0,0,4,3003,0.832776000,0.6287
82.231.227.39,<->,8.55.221.134,4,1827,0,0,4,1827,0.829930000,0.1058
215.158.61.195,<->,8.176.8.232,0,0,4,4375,4,4375,0.829877000,0.1884
252.98.149.1,<->,54.69.73.125,4,934,0,0,4,934,0.826172000,0.5088
215.158.61.189,<->,8.176.8.229,0,0,4,3590,4,3590,0.824108000,0.8035
215.158.239.57,<->,207.56.174.124,4,1675,0,0,4,1675,0.818365000,0.9090
220.39.233.168,<->,215.158.238.82,0,0,4,5252,4,5252,0.818091000,1.0859
207.236.238.63,<->,136.25.188.239,0,0,4,1144,4,1144,0.815781000,0.0765
133.178.227.76,<->,133.56.180.32,4,1948,0,0,4,1948,0.814197000,1.1297
106.5.211.78,<->,99.160.108.248,0,0,4,1156,4,1156,0.813523000,1.0637
105.201.225.210,<->,50.224.89.241,0,0,4,1287,4,1287,0.810380000,1.0655
136.25.189.12,<->,96.156.169.203,4,3316,0,0,4,3316,0.807387000,0.9009
215.158.239.87,<->,143.42.18.52,4,1752,0,0,4,1752,0.805697000,0.8359
142.221.99.102,<->,136.25.188.227,0,0,4,1173,4,1173,0.803658000,1.0442
204.200.40.49,<->,136.25.188.198,0,0,4,1402,4,1402,0.803105000,0.1424
129.92.116.90,<->,50.239.49.97,4,2751,0,0,4,2751,0.799960000,0.1019
136.25.189.0,<->,126.219.194.89,4,5060,0,0,4,5060,0.799085000,1.0543
129.236.114.39,<->,33.233.141.34,0,0,4,3373,4,3373,0.794965000,0.0820
136.25.189.15,<->,120.154.71.44,4,5124,0,0,4,5124,0.791040000,1.0752
136.25.189.85,<->,56.28.207.205,4,3045,0,0,4,3045,0.790330000,0.9743
247.136.253.140,<->,221.102.143.189,4,2668,0,0,4,2668,0.788973000,0.1430
246.254.97.228,<->,8.20.81.65,4,2232,0,0,4,2232,0.788730000,0.9247
215.158.239.49,<->,199.20.4.94,4,1911,0,0,4,1911,0.784813000,1.2128
148.126.46.235,<->,92.27.27.178,0,0,4,344,4,344,0.784049000,0.5369
215.158.239.57,<->,199.20.30.241,4,646,0,0,4,646,0.783640000,1.1096
197.125.126.250,<->,136.25.188.210,0,0,4,5284,4,5284,0.783272000,0.8804
195.71.51.137,<->,136.25.188.220,0,0,4,1212,4,1212,0.781702000,0.1703
136.25.189.22,<->,98.219.126.140,4,2849,0,0,4,2849,0.781114000,1.1924
126.82.139.21,<->,80.40.24.143,0,0,4,306,4,306,0.780148000,1.1517
215.158.239.93,<->,199.20.5.81,4,1939,0,0,4,1939,0.779930000,0.9797
145.16.59.85,<->,144.85.169.209,4,4715,0,0,4,4715,0.779450000,0.1249
143.134.6.217,<->,136.25.188.177,0,0,4,1218,4,1218,0.776401000,0.0177
247.136.229.231,<->,8.55.119.58,4,1981,0,0,4,1981,0.775059000,0.1377
109.222.238.4,<->,53.231.222.55,4,1214,0,0,4,1214,0.774949000,1.1524
215.158.140.217,<->,112.235.95.54,4,544,0,0,4,544,0.772027000,0.1245
133.178.227.242,<->,80.57.208.190,4,3884,0,0,4,3884,0.771437000,0.4754
194.234.203.117,<->,136.25.188.198,0,0,4,1604,4,1604,0.769142000,0.9680
136.25.188.169,<->,98.219.126.175,4,2551,0,0,4,2551,0.763771000,0.8317
194.237.143.124,<->,136.25.188.222,0,0,4,968,4,968,0.763752000,1.1535
133.178.227.2,<->,8.240.116.203,4,4308,0,0,4,4308,0.763529000,1.2262
215.158.239.81,<->,133.56.180.17,4,2396,0,0,4,2396,0.762964000,0.0014
206.195.202.254,<->,99.72.225.71,0,0,4,2244,4,2244,0.760495000,1.0813
215.158.239.85,<->,196.6.59.44,4,1152,0,0,4,1152,0.757080000,0.6210
97.126.24.188,<->,54.36.66.170,4,438,0,0,4,438,0.757012000,1.0954
97.157.225.68,<->,8.252.222.204,0,0,4,1766,4,1766,0.756816000,0.3912
136.25.189.27,<->,96.156.169.165,4,2356,0,0,4,2356,0.756416000,0.0042
215.158.238.125,<->,100.224.166.115,4,2024,0,0,4,2024,0.755420000,1.1679
215.158.61.202,<->,136.25.188.42,0,0,4,3388,4,3388,0.753427000,1.0202
144.87.238.91,<->,8.183.25.124,0,0,4,1088,4,1088,0.752628000,0.3639
218.147.52.203,<->,8.176.48.218,0,0,4,1412,4,1412,0.749435000,0.0469
133.178.226.220,<->,100.224.163.93,4,3852,0,0,4,3852,0.749094000,0.6516
197.105.108.14,<->,136.25.188.241,0,0,4,1960,4,1960,0.746898000,1.0563
143.23.185.26,<->,136.25.188.253,0,0,4,1545,4,1545,0.746769000,0.5294
231.140.52.82,<->,215.158.239.77,0,0,4,1385,4,1385,0.746306000,1.0035
215.158.61.189,<->,8.176.8.183,0,0,4,1882,4,1882,0.744623000,1.0500
207.239.139.212,<->,136.25.188.176,0,0,4,1118,4,1118,0.738238000,0.0332
136.25.189.16,<->,96.156.169.231,4,4268,0,0,4,4268,0.737051000,1.1602
192.247.239.13,<->,8.220.190.86,0,0,4,1920,4,1920,0.734618000,0.7871
136.25.189.33,<->,96.156.169.49,4,3980,0,0,4,3980,0.733597000,1.1225
136.25.189.32,<->,8.249.253.225,4,5428,0,0,4,5428,0.733202000,1.1869
195.70.125.179,<->,136.25.188.238,0,0,4,1427,4,1427,0.733123000,1.0949
215.158.239.68,<->,199.71.247.119,4,1770,0,0,4,1770,0.731865000,0.0548
247.136.142.34,<->,14.30.152.74,4,5048,0,0,4,5048,0.730812000,0.5804
218.4.182.159,<->,8.192.160.86,4,2939,0,0,4,2939,0.730086000,0.2630
145.48.251.16,<->,133.178.227.134,0,0,4,2096,4,2096,0.729468000,1.2525
220.28.104.193,<->,215.158.239.53,0,0,4,2776,4,2776,0.727796000,0.2922
231.140.140.223,<->,215.158.239.48,0,0,4,1214,4,1214,0.727754000,0.0169
215.158.2.8,<->,8.176.8.90,0,0,4,1732,4,1732,0.726925000,1.2678
215.158.30.178,<->,8.252.222.189,0,0,4,1546,4,1546,0.726151000,1.2542
197.233.125.43,<->,50.224.80.64,0,0,4,2506,4,2506,0.720331000,0.2396
136.25.189.0,<->,29.211.228.200,4,4364,0,0,4,4364,0.719496000,1.2289
215.158.239.92,<->,29.212.198.180,4,5236,0,0,4,5236,0.716492000,0.5930
215.158.239.57,<->,142.244.45.63,4,1360,0,0,4,1360,0.714403000,0.2536
215.158.238.135,<->,106.188.183.96,4,560,0,0,4,560,0.714063000,0.7068
101.70.123.83,<->,8.222.7.16,4,1829,0,0,4,1829,0.713611000,0.3025
215.158.239.50,<->,207.190.144.126,4,1795,0,0,4,1795,0.712745000,0.9697
133.178.226.31,<->,8.255.92.218,4,5140,0,0,4,5140,0.710922000,1.1273
215.158.239.63,<->,80.57.141.216,4,4366,0,0,4,4366,0.710440000,0.0521
136.25.189.196,<->,129.222.39.209,4,1288,0,0,4,1288,0.709967000,1.2073
136.25.188.59,<->,100.224.166.146,4,1244,0,0,4,1244,0.709135000,0.6753
215.158.238.143,<->,106.188.183.107,4,406,0,0,4,406,0.706892000,0.9433
139.163.167.27,<->,133.178.227.245,0,0,4,2235,4,2235,0.705468000,0.0599
136.25.189.15,<->,29.211.228.166,4,4220,0,0,4,4220,0.704458000,1.2583
195.71.136.169,<->,136.25.188.54,0,0,4,1005,4,1005,0.700987000,0.0099
136.25.189.32,<->,56.28.207.202,4,5748,0,0,4,5748,0.698066000,1.0333
133.178.227.16,<->,8.40.51.213,4,4266,0,0,4,4266,0.697306000,1.2660
136.25.189.12,<->,120.154.131.47,4,5480,0,0,4,5480,0.696935000,0.9180
124.46.191.127,<->,92.162.253.137,0,0,4,4028,4,4028,0.696044000,0.0395
129.236.114.39,<->,33.233.141.12,0,0,4,5881,4,5881,0.695462000,0.2670
215.158.238.135,<->,113.23.20.106,4,5140,0,0,4,5140,0.694409000,1.2887
204.200.38.213,<->,136.25.188.162,0,0,4,1790,4,1790,0.690985000,0.5826
195.40.0.40,<->,136.25.188.177,0,0,4,611,4,611,0.690248000,0.8567
136.25.188.226,<->,131.1.232.184,4,4204,0,0,4,4204,0.689991000,1.1398
195.71.149.220,<->,136.25.188.198,0,0,4,1141,4,1141,0.688712000,1.0621
109.222.238.4,<->,8.235.28.201,4,2610,0,0,4,2610,0.687226000,1.0083
143.128.120.135,<->,136.25.188.239,0,0,4,1407,4,1407,0.684615000,0.1776
199.51.129.216,<->,136.25.188.177,0,0,4,2936,4,2936,0.681994000,0.4331
136.25.189.34,<->,96.156.169.220,4,4412,0,0,4,4412,0.681951000,1.0399
136.25.188.179,<->,48.131.156.32,4,5380,0,0,4,5380,0.679193000,0.9753
215.158.239.21,<->,84.200.126.146,4,5632,0,0,4,5632,0.678402000,1.1891
215.158.239.99,<->,199.33.181.32,4,860,0,0,4,860,0.673199000,0.4926
136.25.188.200,<->,100.224.202.176,4,4909,0,0,4,4909,0.668343000,0.0002
215.158.239.93,<->,136.139.59.117,4,4964,0,0,4,4964,0.668257000,1.2698
215.158.239.95,<->,207.236.96.161,4,493,0,0,4,493,0.667510000,0.6340
54.39.125.87,<->,48.53.186.231,0,0,4,2424,4,2424,0.665617000,0.6665
111.147.193.127,<->,53.201.91.18,4,731,0,0,4,731,0.665513000,0.5303
215.158.239.5,<->,8.191.6.121,4,591,0,0,4,591,0.663077000,1.1485
94.192.95.233,<->,8.252.221.238,0,0,4,1088,4,1088,0.659547000,0.3830
136.25.189.1,<->,80.56.79.87,4,4363,0,0,4,4363,0.656962000,0.8534
133.178.226.60,<->,126.219.194.151,4,4922,0,0,4,4922,0.656109000,1.1582
136.25.189.0,<->,8.222.98.120,4,5060,0,0,4,5060,0.655970000,1.2540
156.150.126.238,<->,8.252.222.36,0,0,4,1019,4,1019,0.653465000,0.9884
144.232.206.17,<->,8.252.223.194,0,0,4,1158,4,1158,0.652340000,1.1227
215.158.140.75,<->,8.252.253.148,4,4335,0,0,4,4335,0.651481000,1.3304
133.178.227.2,<->,8.53.216.225,4,4373,0,0,4,4373,0.651462000,1.2328
136.25.189.196,<->,129.222.39.150,4,2777,0,0,4,2777,0.649742000,0.5531
192.65.173.78,<->,8.55.224.156,4,2668,0,0,4,2668,0.649110000,0.3249
215.158.239.77,<->,199.20.5.239,4,2636,0,0,4,2636,0.645795000,0.7186
136.25.188.226,<->,113.23.104.212,4,4644,0,0,4,4644,0.645356000,1.2199
215.158.61.242,<->,8.176.8.248,0,0,4,1828,4,1828,0.643218000,1.2356
215.158.239.68,<->,194.234.173.124,4,1821,0,0,4,1821,0.643148000,0.5532
199.83.239.160,<->,136.25.188.176,0,0,4,2570,4,2570,0.641154000,0.9301
215.158.238.142,<->,111.151.239.1,4,5108,0,0,4,5108,0.640388000,0.7821
136.25.189.33,<->,126.219.191.74,4,2668,0,0,4,2668,0.640182000,0.8443
215.158.239.70,<->,133.146.0.197,4,5060,0,0,4,5060,0.639562000,1.1481
54.36.196.172,<->,48.53.246.158,0,0,4,2778,4,2778,0.635540000,0.6332
136.25.188.178,<->,104.3.168.213,4,5092,0,0,4,5092,0.634487000,0.6964
215.158.238.250,<->,106.188.252.231,4,4316,0,0,4,4316,0.634081000,1.2428
249.101.203.62,<->,54.69.79.171,4,580,0,0,4,580,0.634042000,0.6948
129.225.132.224,<->,129.225.131.153,4,2642,0,0,4,2642,0.633729000,0.7304
220.20.200.50,<->,35.107.149.134,4,5624,0,0,4,5624,0.633666000,0.0351
136.158.219.207,<->,8.220.177.81,0,0,4,1450,4,1450,0.633022000,0.7601
215.158.140.231,<->,8.190.217.21,4,4284,0,0,4,4284,0.632696000,1.3656
136.25.189.0,<->,96.156.169.203,4,5092,0,0,4,5092,0.631220000,0.8244
197.81.31.144,<->,136.25.188.225,0,0,4,1208,4,1208,0.626369000,0.4147
215.158.239.76,<->,195.97.21.76,4,868,0,0,4,868,0.624314000,1.3000
194.233.139.207,<->,136.25.188.55,0,0,4,1964,4,1964,0.621497000,1.0806
215.158.239.58,<->,207.115.116.172,4,1930,0,0,4,1930,0.615196000,0.0900
204.3.189.5,<->,136.25.188.242,0,0,4,1875,4,1875,0.612545000,0.0576
199.51.54.127,<->,136.25.188.253,0,0,4,1781,4,1781,0.610702000,0.5836
133.178.227.8,<->,98.219.126.140,4,2132,0,0,4,2132,0.610521000,1.2983
138.73.24.177,<->,100.228.42.42,0,0,4,1382,4,1382,0.610225000,0.9363
207.61.233.15,<->,136.25.188.236,0,0,4,1420,4,1420,0.607657000,0.4559
145.76.225.245,<->,80.27.158.226,0,0,4,1402,4,1402,0.606034000,0.1850
215.158.30.219,<->,136.25.188.234,0,0,4,3115,4,3115,0.605059000,0.2090
133.178.227.76,<->,126.219.191.10,4,4486,0,0,4,4486,0.604114000,1.1077
133.178.227.1,<->,113.23.14.135,4,4187,0,0,4,4187,0.603527000,1.3221
96.48.188.33,<->,8.53.2.29,0,0,4,1943,4,1943,0.602848000,1.2551
136.25.188.49,<->,80.57.141.179,4,1974,0,0,4,1974,0.600801000,0.0486
215.158.239.93,<->,142.253.111.140,4,1762,0,0,4,1762,0.599085000,0.7852
205.227.96.25,<->,136.25.189.1,0,0,4,3132,4,3132,0.598812000,1.1317
215.158.239.79,<->,215.158.44.209,4,5188,0,0,4,5188,0.595439000,1.0771
215.158.239.70,<->,215.158.44.209,4,4916,0,0,4,4916,0.594275000,0.9803
197.113.64.201,<->,136.25.188.177,0,0,4,1967,4,1967,0.592666000,1.1201
133.178.226.7,<->,119.196.23.71,4,5156,0,0,4,5156,0.591610000,1.1965
215.158.239.94,<->,207.213.125.132,4,2459,0,0,4,2459,0.589142000,1.3899
207.160.220.252,<->,0.195.210.46,0,0,4,2222,4,2222,0.586760000,0.8741
197.113.47.114,<->,0.195.210.14,0,0,4,1185,4,1185,0.586735000,0.9385
133.178.227.16,<->,131.144.116.213,4,4222,0,0,4,4222,0.585196000,1.2768
215.158.238.135,<->,111.151.70.62,4,5076,0,0,4,5076,0.584293000,1.2201
8.252.223.175,<->,8.240.116.198,4,4445,0,0,4,4445,0.584218000,1.3460
215.158.239.247,<->,8.191.14.216,4,1729,0,0,4,1729,0.584160000,1.1610
215.158.238.72,<->,104.3.168.212,4,5140,0,0,4,5140,0.583505000,1.3029
142.241.140.174,<->,136.25.188.238,0,0,4,1158,4,1158,0.582930000,1.1251
215.158.239.166,<->,8.50.169.192,4,932,0,0,4,932,0.582692000,0.3231
132.216.20.252,<->,82.237.234.42,0,0,4,710,4,710,0.581574000,0.0000
199.73.186.99,<->,136.25.188.173,0,0,4,2302,4,2302,0.580214000,0.6611
215.158.239.44,<->,98.219.126.140,4,2530,0,0,4,2530,0.578911000,0.5654
215.158.239.50,<->,142.206.241.125,4,2274,0,0,4,2274,0.576327000,0.6103
215.158.238.223,<->,158.85.50.151,4,4429,0,0,4,4429,0.576058000,1.0664
215.158.238.134,<->,80.47.228.219,4,4124,0,0,4,4124,0.573855000,1.0955
136.25.188.220,<->,104.3.163.27,4,5460,0,0,4,5460,0.572598000,1.4159
215.158.239.68,<->,194.237.122.233,4,1864,0,0,4,1864,0.570158000,0.6701
136.25.188.197,<->,131.36.198.48,4,4487,0,0,4,4487,0.570150000,1.1727
141.89.192.194,<->,0.195.210.42,0,0,4,509,4,509,0.569915000,0.6424
215.158.239.58,<->,194.203.106.186,4,1250,0,0,4,1250,0.564428000,1.3198
139.163.167.38,<->,133.178.226.246,0,0,4,2365,4,2365,0.563249000,1.0828
132.249.71.176,<->,100.94.46.112,0,0,4,1953,4,1953,0.562615000,1.1635
133.178.226.90,<->,131.1.195.230,4,4303,0,0,4,4303,0.562535000,1.3244
215.158.239.51,<->,68.124.221.168,4,5108,0,0,4,5108,0.561268000,1.4280
106.168.190.223,<->,99.72.116.212,0,0,4,563,4,563,0.557905000,0.9990
133.178.227.27,<->,106.188.244.245,4,4522,0,0,4,4522,0.557251000,0.9403
143.44.252.34,<->,136.25.188.198,0,0,4,1783,4,1783,0.555111000,0.9028
133.178.226.29,<->,99.192.168.162,4,5063,0,0,4,5063,0.549108000,1.3838
222.76.103.134,<->,106.5.208.176,4,1982,0,0,4,1982,0.545856000,1.0462
215.158.239.51,<->,196.93.164.219,4,1000,0,0,4,1000,0.545216000,0.8808
215.158.239.31,<->,29.214.74.194,4,473,0,0,4,473,0.543726000,1.3589
136.25.188.235,<->,100.224.202.143,4,2835,0,0,4,2835,0.542884000,0.8680
215.158.239.7,<->,8.191.6.123,4,531,0,0,4,531,0.540336000,1.0249
215.158.239.85,<->,199.106.14.92,4,1805,0,0,4,1805,0.538135000,0.5865
215.158.239.76,<->,106.188.253.234,4,5473,0,0,4,5473,0.538034000,0.9368
53.160.64.136,<->,48.53.33.96,0,0,4,3371,4,3371,0.536615000,0.6403
215.158.239.58,<->,196.108.212.249,4,1892,0,0,4,1892,0.534645000,0.5302
215.158.239.94,<->,96.156.169.221,4,5076,0,0,4,5076,0.533995000,1.0979
69.128.73.245,<->,53.160.1.15,4,6016,0,0,4,6016,0.533903000,0.0002
133.178.227.24,<->,104.3.168.136,4,4263,0,0,4,4263,0.533320000,0.9775
215.158.239.71,<->,33.209.219.82,4,3996,0,0,4,3996,0.531104000,0.4830
202.33.241.209,<->,136.25.188.254,0,0,4,1097,4,1097,0.531053000,1.2010
215.158.239.56,<->,199.20.28.170,4,1906,0,0,4,1906,0.530890000,0.4199
204.186.243.46,<->,136.25.188.255,0,0,4,2864,4,2864,0.530190000,1.3300
136.25.188.226,<->,8.190.216.194,4,5348,0,0,4,5348,0.529699000,1.1784
215.158.239.70,<->,199.20.31.208,4,1249,0,0,4,1249,0.528979000,1.0492
215.158.238.80,<->,29.211.6.17,4,5156,0,0,4,5156,0.528162000,0.9641
215.158.238.123,<->,129.175.139.42,4,5207,0,0,4,5207,0.527741000,1.2539
136.25.188.162,<->,122.158.245.122,4,4852,0,0,4,4852,0.526453000,1.0952
215.158.239.56,<->,199.15.8.170,4,2275,0,0,4,2275,0.526167000,0.6660
215.158.238.75,<->,33.209.217.244,4,5601,0,0,4,5601,0.525960000,1.3952
215.158.239.58,<->,199.20.29.184,4,1971,0,0,4,1971,0.525411000,0.5197
224.148.53.203,<->,132.118.97.71,4,1968,0,0,4,1968,0.523972000,0.2764
215.158.239.92,<->,195.55.126.241,4,1137,0,0,4,1137,0.522513000,0.8899
129.16.253.244,<->,6.74.201.153,0,0,4,3915,4,3915,0.522230000,0.0676
215.158.238.135,<->,113.23.20.95,4,5172,0,0,4,5172,0.521067000,1.3641
210.220.219.177,<->,137.39.55.59,4,1682,0,0,4,1682,0.520975000,0.0071
231.138.132.252,<->,136.25.188.199,0,0,4,999,4,999,0.519176000,0.6513
100.110.29.161,<->,92.27.219.36,0,0,4,328,4,328,0.518239000,0.3877
215.158.239.56,<->,196.91.47.95,4,1979,0,0,4,1979,0.514842000,0.7700
215.158.140.219,<->,53.231.101.25,4,1598,0,0,4,1598,0.514448000,1.4853
215.158.239.4,<->,8.191.6.111,4,704,0,0,4,704,0.513905000,1.1958
136.25.188.44,<->,122.158.245.73,4,5188,0,0,4,5188,0.512353000,1.3546
80.41.9.16,<->,8.55.224.156,4,2668,0,0,4,2668,0.510679000,0.1730
199.69.203.52,<->,136.25.188.175,0,0,4,1904,4,1904,0.506583000,0.2587
221.102.143.189,<->,129.1.112.208,0,0,4,2562,4,2562,0.506037000,0.4390
133.178.226.23,<->,98.219.126.140,4,2360,0,0,4,2360,0.505882000,1.0417
133.178.226.61,<->,96.155.60.202,4,1668,0,0,4,1668,0.501018000,1.0433
202.33.212.240,<->,136.25.188.177,0,0,4,1755,4,1755,0.499396000,1.0116
127.111.95.13,<->,97.126.46.188,0,0,4,278,4,278,0.497907000,1.0177
136.25.188.255,<->,33.209.217.236,4,4251,0,0,4,4251,0.494725000,1.4986
136.25.188.255,<->,131.1.253.250,4,5243,0,0,4,5243,0.493917000,1.2579
136.25.189.81,<->,96.156.169.169,4,4428,0,0,4,4428,0.490658000,1.2206
101.224.178.141,<->,89.183.104.115,0,0,4,356,4,356,0.487617000,1.5008
80.27.157.205,<->,75.92.225.243,4,824,0,0,4,824,0.487246000,0.2295
215.158.238.101,<->,0.195.253.228,4,1753,0,0,4,1753,0.486674000,0.8856
98.23.101.117,<->,89.183.104.249,0,0,4,356,4,356,0.485356000,1.5004
136.25.189.60,<->,96.156.169.207,4,3084,0,0,4,3084,0.485018000,1.1034
215.158.238.133,<->,104.3.168.214,4,4916,0,0,4,4916,0.484639000,1.2692
136.25.188.177,<->,111.2.132.128,4,1060,0,0,4,1060,0.484121000,0.0466
92.59.22.204,<->,92.27.219.203,0,0,4,3135,4,3135,0.484076000,1.0466
136.25.188.193,<->,100.224.202.178,4,2024,0,0,4,2024,0.483740000,1.3761
215.158.239.108,<->,215.158.61.189,4,2107,0,0,4,2107,0.477939000,0.5724
136.25.188.224,<->,32.183.36.249,4,5156,0,0,4,5156,0.476678000,1.4826
199.38.163.163,<->,136.25.188.237,0,0,4,1083,4,1083,0.476241000,0.3098
215.158.238.73,<->,131.1.253.234,4,5416,0,0,4,5416,0.475523000,1.0875
50.224.76.235,<->,48.129.85.217,4,5559,0,0,4,5559,0.475302000,0.0000
215.158.238.85,<->,8.255.1.161,4,1912,0,0,4,1912,0.474588000,0.5567
97.85.150.178,<->,8.52.173.15,0,0,4,1678,4,1678,0.472894000,0.4780
215.158.238.94,<->,38.104.11.41,4,4140,0,0,4,4140,0.472592000,1.4816
136.25.188.175,<->,97.178.252.120,4,1136,0,0,4,1136,0.470159000,0.0535
215.158.238.133,<->,143.227.65.185,4,4932,0,0,4,4932,0.470117000,1.2257
215.158.239.49,<->,199.20.115.15,4,1140,0,0,4,1140,0.468683000,0.1650
136.25.189.81,<->,120.154.131.21,4,5214,0,0,4,5214,0.465754000,1.4996
215.158.238.243,<->,106.188.251.41,4,4278,0,0,4,4278,0.465432000,1.1955
98.23.101.117,<->,92.27.27.162,0,0,4,356,4,356,0.464330000,1.5004
136.25.189.77,<->,96.156.169.162,4,5652,0,0,4,5652,0.463660000,1.4040
215.158.238.113,<->,112.235.95.26,4,4852,0,0,4,4852,0.462100000,1.2968
133.178.226.38,<->,69.150.169.181,4,5348,0,0,4,5348,0.458644000,1.4880
136.25.189.57,<->,96.135.155.31,4,4108,0,0,4,4108,0.458067000,1.3005
133.178.226.18,<->,106.188.236.172,4,5220,0,0,4,5220,0.454032000,1.2468
136.25.188.242,<->,29.211.6.37,4,5252,0,0,4,5252,0.453160000,1.5142
136.138.112.194,<->,133.178.226.7,0,0,4,5124,4,5124,0.451370000,1.4050
89.183.104.115,<->,33.57.74.182,4,356,0,0,4,356,0.449949000,1.5004
246.253.253.169,<->,53.201.86.104,4,1268,0,0,4,1268,0.447211000,1.2836
215.158.239.57,<->,120.154.71.22,4,5172,0,0,4,5172,0.446986000,1.3877
133.178.226.29,<->,126.219.247.41,4,5124,0,0,4,5124,0.445203000,1.1719
192.66.145.148,<->,56.13.192.199,4,3686,0,0,4,3686,0.444065000,0.7766
215.158.239.50,<->,196.109.12.46,4,1168,0,0,4,1168,0.443016000,0.8091
197.81.82.50,<->,0.195.210.46,0,0,4,1544,4,1544,0.442514000,1.2452
136.25.188.167,<->,100.224.202.143,4,2683,0,0,4,2683,0.442324000,0.6562
215.158.239.48,<->,195.6.218.147,4,1869,0,0,4,1869,0.441768000,0.4775
98.236.90.167,<->,53.83.207.25,4,2355,0,0,4,2355,0.440019000,0.1995
215.158.238.40,<->,100.224.166.161,4,2023,0,0,4,2023,0.439930000,1.3175
215.158.238.176,<->,8.240.116.213,4,4836,0,0,4,4836,0.438953000,1.4668
141.163.50.125,<->,8.252.222.156,0,0,4,2068,4,2068,0.437705000,0.8804
133.178.226.18,<->,126.219.247.87,4,5092,0,0,4,5092,0.436200000,1.3409
136.25.188.46,<->,126.219.247.24,4,4868,0,0,4,4868,0.436084000,1.2902
220.28.104.193,<->,215.158.238.70,0,0,4,3992,4,3992,0.434501000,1.4437
195.15.140.54,<->,136.25.188.53,0,0,4,1169,4,1169,0.433391000,0.1084
195.124.211.97,<->,136.25.188.163,0,0,4,1191,4,1191,0.433002000,1.1101
143.20.121.130,<->,133.178.226.28,0,0,4,4724,4,4724,0.432414000,1.4738
89.183.109.84,<->,53.230.56.250,4,1359,0,0,4,1359,0.431203000,0.3939
136.25.188.175,<->,56.161.218.52,4,5252,0,0,4,5252,0.431195000,1.4523
215.158.239.29,<->,106.188.184.165,4,4410,0,0,4,4410,0.430133000,1.4016
215.158.140.206,<->,8.222.7.187,4,4122,0,0,4,4122,0.429770000,1.3840
215.158.238.220,<->,8.240.116.237,4,4344,0,0,4,4344,0.427591000,0.9091
117.31.119.160,<->,92.27.27.145,0,0,4,608,4,608,0.424878000,1.3555
133.178.227.73,<->,133.56.180.94,4,1844,0,0,4,1844,0.424264000,1.4708
215.158.140.83,<->,106.188.245.60,4,4564,0,0,4,4564,0.422755000,0.8785
215.158.238.73,<->,27.178.41.50,4,5300,0,0,4,5300,0.422641000,1.2453
136.25.188.210,<->,131.1.232.184,4,4300,0,0,4,4300,0.422445000,1.2006
142.190.141.209,<->,136.25.188.253,0,0,4,1196,4,1196,0.422387000,0.2749
98.23.121.95,<->,89.183.104.115,0,0,4,356,4,356,0.420844000,1.5006
92.27.128.248,<->,89.183.104.115,0,0,4,356,4,356,0.420748000,1.5006
215.158.61.189,<->,8.176.8.232,0,0,4,2884,4,2884,0.417724000,1.4615
142.227.56.211,<->,136.25.188.198,0,0,4,1029,4,1029,0.417554000,0.6851
158.192.3.218,<->,136.25.188.221,0,0,4,5156,4,5156,0.416238000,1.3845
215.158.238.132,<->,57.210.107.9,4,5396,0,0,4,5396,0.415825000,1.3190
215.158.238.132,<->,136.138.112.247,4,3948,0,0,4,3948,0.415546000,1.1641
92.27.59.105,<->,89.183.104.115,0,0,4,356,4,356,0.415430000,1.5010
195.55.188.47,<->,136.25.188.255,0,0,4,3997,4,3997,0.414891000,0.5275
136.25.188.211,<->,80.47.111.65,4,5140,0,0,4,5140,0.413796000,1.2962
215.158.140.60,<->,122.159.123.91,4,4604,0,0,4,4604,0.413209000,1.5298
207.59.237.91,<->,136.25.188.225,0,0,4,1663,4,1663,0.413032000,1.3433
215.158.61.243,<->,8.176.8.176,0,0,4,1604,4,1604,0.410968000,1.1185
136.25.189.1,<->,29.213.219.57,4,5601,0,0,4,5601,0.408914000,1.2407
136.25.188.198,<->,131.1.195.233,4,5689,0,0,4,5689,0.408703000,1.3201
98.23.101.117,<->,92.27.219.130,0,0,4,356,4,356,0.407961000,1.5004
215.158.239.57,<->,29.214.109.128,4,5140,0,0,4,5140,0.407116000,1.5317
212.70.75.32,<->,133.178.227.27,0,0,4,4634,4,4634,0.406180000,1.4948
196.240.168.35,<->,136.25.188.222,0,0,4,1048,4,1048,0.405943000,0.1451
215.158.140.17,<->,215.158.127.31,4,5542,0,0,4,5542,0.403321000,0.0015
215.158.61.183,<->,8.176.8.211,0,0,4,1663,4,1663,0.403061000,1.0499
192.224.146.176,<->,133.178.226.95,0,0,4,2161,4,2161,0.402683000,0.3266
136.25.189.12,<->,96.156.169.170,4,4364,0,0,4,4364,0.402057000,1.4579
17.21.42.126,<->,8.52.169.61,0,0,4,1697,4,1697,0.401704000,0.0993
215.158.238.134,<->,56.161.218.41,4,5220,0,0,4,5220,0.401002000,1.2323
199.38.125.90,<->,136.25.188.175,0,0,4,2208,4,2208,0.400793000,0.0360
215.158.239.95,<->,199.121.31.89,4,1161,0,0,4,1161,0.398851000,0.7563
136.25.189.83,<->,106.188.253.136,4,5012,0,0,4,5012,0.397940000,1.3149
215.158.238.243,<->,131.144.116.40,4,4343,0,0,4,4343,0.397412000,1.3742
215.158.239.79,<->,29.213.219.71,4,5495,0,0,4,5495,0.397210000,0.8525
215.158.239.76,<->,207.115.98.212,4,1805,0,0,4,1805,0.396279000,0.1870
136.25.188.197,<->,106.188.236.197,4,5140,0,0,4,5140,0.395100000,1.4651
210.220.219.150,<->,206.243.231.162,4,1953,0,0,4,1953,0.394545000,0.1324
200.14.164.203,<->,0.195.210.8,0,0,4,596,4,596,0.392335000,1.5453
215.158.239.76,<->,199.20.7.11,4,1137,0,0,4,1137,0.391593000,1.4593
220.28.85.14,<->,215.158.239.90,0,0,4,1465,4,1465,0.391482000,1.5087
215.158.238.102,<->,0.195.253.228,4,4583,0,0,4,4583,0.390930000,0.8596
215.158.238.141,<->,131.144.113.192,4,5172,0,0,4,5172,0.388210000,1.3390
136.25.189.59,<->,8.249.253.235,4,4980,0,0,4,4980,0.387991000,1.1987
122.133.20.241,<->,89.183.104.233,0,0,4,2130,4,2130,0.387562000,1.4321
136.25.189.2,<->,96.156.169.234,4,4524,0,0,4,4524,0.387419000,1.3288
220.20.200.171,<->,121.105.194.40,4,1561,0,0,4,1561,0.386731000,1.4004
132.168.196.110,<->,53.209.92.194,4,2245,0,0,4,2245,0.386084000,0.1146
192.64.208.5,<->,99.169.47.255,4,2968,0,0,4,2968,0.384250000,1.6040
215.158.238.72,<->,197.125.126.186,4,5188,0,0,4,5188,0.384212000,1.5744
98.23.121.77,<->,89.183.104.115,0,0,4,356,4,356,0.384122000,1.5009
247.136.207.173,<->,53.75.73.51,4,3154,0,0,4,3154,0.383541000,0.2709
215.158.238.135,<->,80.47.111.90,4,4948,0,0,4,4948,0.382878000,0.6807
252.36.152.95,<->,8.252.222.48,0,0,4,1189,4,1189,0.382102000,0.6473
215.158.238.177,<->,68.231.26.200,4,4772,0,0,4,4772,0.381459000,1.5599
215.158.238.149,<->,136.138.112.201,4,5156,0,0,4,5156,0.381305000,1.5115
215.158.238.110,<->,0.195.237.14,4,2394,0,0,4,2394,0.380650000,0.7465
215.158.239.113,<->,129.222.39.54,4,2073,0,0,4,2073,0.379782000,1.1027
193.123.127.223,<->,89.183.104.115,0,0,4,356,4,356,0.379229000,1.5006
215.158.239.50,<->,194.232.3.141,4,2252,0,0,4,2252,0.377906000,1.2792
139.163.96.101,<->,42.108.71.96,4,1072,0,0,4,1072,0.376469000,1.3900
220.28.65.9,<->,215.158.239.81,0,0,4,3391,4,3391,0.375905000,1.1094
136.25.189.9,<->,100.216.78.145,4,4677,0,0,4,4677,0.374236000,1.1481
204.141.230.251,<->,8.252.222.161,0,0,4,1952,4,1952,0.372948000,0.0001
136.25.189.15,<->,29.214.109.128,4,4916,0,0,4,4916,0.372231000,0.9578
133.178.227.242,<->,111.151.237.171,4,4084,0,0,4,4084,0.371818000,1.5452
215.158.239.49,<->,120.154.71.52,4,4980,0,0,4,4980,0.371552000,1.5082
196.246.204.77,<->,136.25.188.178,0,0,4,1302,4,1302,0.368961000,0.8783
143.52.161.152,<->,136.25.188.210,0,0,4,1213,4,1213,0.367413000,1.1823
246.253.217.242,<->,207.92.46.27,4,2324,0,0,4,2324,0.365974000,0.9105
129.236.73.9,<->,101.224.89.249,0,0,4,1376,4,1376,0.364224000,0.2622
215.158.238.139,<->,97.174.232.252,4,2021,0,0,4,2021,0.363056000,1.4944
136.25.188.221,<->,106.188.236.184,4,4836,0,0,4,4836,0.362095000,1.1942
136.25.189.54,<->,96.156.169.199,4,3252,0,0,4,3252,0.361904000,0.0069
200.174.203.233,<->,53.201.72.62,4,2647,0,0,4,2647,0.361551000,1.2713
98.23.101.117,<->,92.27.219.180,0,0,4,356,4,356,0.360203000,1.5002
111.2.157.67,<->,8.183.25.124,0,0,4,3172,4,3172,0.360031000,0.3420
136.25.189.46,<->,98.28.95.68,4,5188,0,0,4,5188,0.359621000,1.1115
245.150.122.254,<->,8.182.241.177,0,0,4,2176,4,2176,0.359438000,0.5923
98.23.101.117,<->,92.27.219.44,0,0,4,356,4,356,0.358682000,1.5006
215.158.238.115,<->,41.141.97.75,4,3832,0,0,4,3832,0.354565000,0.8718
133.178.226.30,<->,99.192.168.150,4,4676,0,0,4,4676,0.350391000,1.1165
210.224.219.234,<->,100.94.222.86,0,0,4,386,4,386,0.350329000,1.3312
215.158.140.76,<->,111.150.187.215,4,4754,0,0,4,4754,0.349381000,1.2128
136.25.189.30,<->,106.188.253.228,4,5526,0,0,4,5526,0.349155000,0.9391
109.1.26.46,<->,53.245.246.100,4,1220,0,0,4,1220,0.348934000,1.5897
136.25.188.173,<->,126.219.132.205,4,5540,0,0,4,5540,0.348530000,1.3112
138.79.143.196,<->,92.27.219.156,0,0,4,1197,4,1197,0.348012000,0.7098
136.25.189.82,<->,29.214.73.131,4,5364,0,0,4,5364,0.347757000,1.6346
215.158.238.134,<->,8.42.43.9,4,5012,0,0,4,5012,0.344490000,1.6320
215.158.238.241,<->,8.190.217.40,4,4393,0,0,4,4393,0.344068000,1.1397
109.222.223.113,<->,53.218.54.83,4,1966,0,0,4,1966,0.341077000,1.1516
224.250.117.119,<->,100.228.42.204,0,0,4,1199,4,1199,0.340782000,0.3430
215.158.238.66,<->,33.209.217.212,4,4342,0,0,4,4342,0.337909000,1.3865
221.102.143.189,<->,220.80.186.56,0,0,4,4598,4,4598,0.336499000,0.6331
199.63.178.200,<->,136.25.188.44,0,0,4,5332,4,5332,0.334343000,1.0839
136.25.189.15,<->,96.156.169.203,4,4860,0,0,4,4860,0.334169000,1.6068
215.158.239.49,<->,133.224.119.41,4,5364,0,0,4,5364,0.334048000,1.5186
129.47.117.224,<->,99.162.71.215,0,0,4,1892,4,1892,0.334009000,1.6252
193.123.127.211,<->,89.183.104.115,0,0,4,356,4,356,0.332491000,1.5008
192.205.47.20,<->,133.178.226.234,0,0,4,3141,4,3141,0.332348000,1.6299
133.178.227.24,<->,100.50.96.170,4,4484,0,0,4,4484,0.331842000,1.5467
215.158.239.87,<->,142.221.134.198,4,2061,0,0,4,2061,0.330288000,0.6133
202.33.253.123,<->,136.25.188.52,0,0,4,1962,4,1962,0.329944000,1.0191
215.158.238.99,<->,111.150.186.223,4,5188,0,0,4,5188,0.329507000,1.6021
215.158.238.88,<->,0.195.237.14,4,4524,0,0,4,4524,0.329242000,1.0296
204.184.84.248,<->,136.25.188.177,0,0,4,1992,4,1992,0.329020000,1.1702
220.28.114.28,<->,215.158.239.61,0,0,4,3763,4,3763,0.328954000,1.3551
136.25.188.175,<->,131.1.195.250,4,5627,0,0,4,5627,0.328799000,1.4852
192.228.25.170,<->,133.178.226.213,0,0,4,3430,4,3430,0.328642000,1.5533
220.28.104.193,<->,215.158.238.254,0,0,4,3262,4,3262,0.326923000,1.0351
207.59.172.221,<->,136.25.188.236,0,0,4,1094,4,1094,0.326813000,0.6245
92.27.53.48,<->,89.183.104.115,0,0,4,356,4,356,0.324722000,1.5006
129.31.141.155,<->,109.222.253.222,0,0,4,1397,4,1397,0.324386000,0.1936
139.163.7.204,<->,130.18.163.63,4,1000,0,0,4,1000,0.323792000,1.5672
220.39.233.211,<->,136.25.188.163,0,0,4,5108,4,5108,0.323064000,1.4566
145.166.15.233,<->,89.183.104.115,0,0,4,356,4,356,0.322585000,1.5006
215.158.239.92,<->,195.55.120.128,4,1401,0,0,4,1401,0.321370000,1.5872
111.20.172.119,<->,33.233.141.62,0,0,4,5385,4,5385,0.320236000,0.0009
98.23.101.117,<->,89.183.104.147,0,0,4,356,4,356,0.320199000,1.5006
143.206.94.255,<->,0.195.210.33,0,0,4,404,4,404,0.318774000,1.3683
218.154.30.233,<->,8.52.222.23,0,0,4,2834,4,2834,0.316172000,0.5581
215.158.61.191,<->,8.176.8.195,0,0,4,4739,4,4739,0.315296000,0.6169
136.25.188.177,<->,29.214.108.122,4,4982,0,0,4,4982,0.314829000,1.5201
215.158.239.69,<->,106.188.253.154,4,4309,0,0,4,4309,0.314469000,1.6382
100.50.96.228,<->,8.252.223.153,0,0,4,4621,4,4621,0.314362000,1.3815
195.13.147.141,<->,136.25.188.55,0,0,4,1793,4,1793,0.314068000,0.4843
136.25.188.210,<->,104.3.168.218,4,4804,0,0,4,4804,0.313783000,1.0484
152.43.90.133,<->,8.252.222.241,0,0,4,876,4,876,0.313048000,0.1779
215.158.238.80,<->,8.42.43.88,4,5412,0,0,4,5412,0.311440000,1.6735
200.174.206.107,<->,54.39.80.35,4,666,0,0,4,666,0.310358000,1.5635
102.41.217.28,<->,92.27.218.131,0,0,4,208,4,208,0.307437000,1.6872
136.25.189.28,<->,120.154.131.20,4,5739,0,0,4,5739,0.307194000,1.6080
142.234.196.215,<->,133.178.226.31,0,0,4,5188,4,5188,0.306240000,1.5736
98.23.101.117,<->,92.27.219.174,0,0,4,356,4,356,0.305811000,1.5003
215.158.238.101,<->,100.224.166.163,4,2023,0,0,4,2023,0.304295000,1.3937
195.55.229.202,<->,136.25.188.236,0,0,4,1785,4,1785,0.303950000,0.5967
132.213.244.180,<->,8.53.4.39,0,0,4,847,4,847,0.303327000,0.4881
194.244.172.173,<->,8.182.226.78,0,0,4,2338,4,2338,0.302981000,0.6003
215.158.239.46,<->,56.97.186.175,4,1101,0,0,4,1101,0.301982000,0.7468
215.158.61.189,<->,8.176.8.248,0,0,4,1645,4,1645,0.300479000,1.4065
215.158.140.93,<->,215.158.6.200,4,5384,0,0,4,5384,0.300420000,1.6584
220.28.114.28,<->,215.158.239.60,0,0,4,3351,4,3351,0.299517000,0.1389
136.25.189.12,<->,96.156.169.162,4,2948,0,0,4,2948,0.299436000,1.5802
100.255.145.206,<->,50.224.108.163,0,0,4,802,4,802,0.298153000,0.2446
220.28.85.14,<->,215.158.238.86,0,0,4,2745,4,2745,0.298024000,1.2848
136.25.188.254,<->,69.150.168.232,4,4788,0,0,4,4788,0.297303000,1.4571
215.158.238.133,<->,122.158.49.136,4,2172,0,0,4,2172,0.296458000,1.3179
215.158.61.193,<->,8.176.8.202,0,0,4,3947,4,3947,0.296354000,1.2424
215.158.238.142,<->,122.159.245.165,4,5140,0,0,4,5140,0.295360000,0.8203
215.158.239.50,<->,118.20.100.122,4,5076,0,0,4,5076,0.295335000,1.2687
92.181.172.215,<->,8.204.53.229,4,1176,0,0,4,1176,0.294575000,0.3787
215.158.239.96,<->,199.38.254.180,4,1202,0,0,4,1202,0.294034000,0.3563
215.158.61.145,<->,136.25.188.37,0,0,4,2112,4,2112,0.293329000,1.6374
197.7.105.185,<->,8.183.25.25,0,0,4,931,4,931,0.293213000,0.5822
243.185.81.59,<->,8.52.179.237,0,0,4,812,4,812,0.290824000,1.4988
215.158.239.49,<->,126.219.191.24,4,4916,0,0,4,4916,0.289616000,1.0817
144.87.238.89,<->,8.183.25.124,0,0,4,2186,4,2186,0.289397000,0.4642
133.178.227.24,<->,29.211.228.245,4,4422,0,0,4,4422,0.289166000,0.9983
215.158.61.203,<->,136.25.188.43,0,0,4,4127,4,4127,0.289086000,1.4541
215.158.239.7,<->,215.158.127.162,4,3222,0,0,4,3222,0.287607000,1.2464
246.253.253.99,<->,54.55.44.79,4,1448,0,0,4,1448,0.286645000,1.0022
136.25.188.173,<->,106.188.236.151,4,5188,0,0,4,5188,0.285859000,1.7112
215.158.239.57,<->,142.227.16.45,4,1200,0,0,4,1200,0.285227000,1.0528
215.158.238.113,<->,136.139.59.103,4,5108,0,0,4,5108,0.283524000,1.5504
111.147.173.53,<->,53.214.245.11,4,418,0,0,4,418,0.283411000,1.0468
215.158.239.197,<->,56.97.186.255,4,752,0,0,4,752,0.283195000,1.4968
136.25.189.0,<->,133.56.180.24,4,4909,0,0,4,4909,0.282538000,1.6457
215.158.238.33,<->,38.104.11.52,4,5236,0,0,4,5236,0.282107000,1.1632
17.143.241.23,<->,8.220.188.138,0,0,4,1086,4,1086,0.281858000,1.4898
204.200.55.93,<->,136.25.188.176,0,0,4,1362,4,1362,0.280992000,0.7561
133.178.227.73,<->,98.219.126.175,4,4314,0,0,4,4314,0.280768000,1.5982
6.145.173.53,<->,0.195.210.44,0,0,4,928,4,928,0.279196000,0.6857
215.158.239.49,<->,29.211.228.235,4,5356,0,0,4,5356,0.274505000,1.3956
207.61.92.202,<->,136.25.188.54,0,0,4,832,4,832,0.274355000,0.0142
133.178.226.38,<->,69.132.194.168,4,5012,0,0,4,5012,0.274263000,1.3605
136.25.188.175,<->,69.150.168.218,4,5028,0,0,4,5028,0.274106000,1.4523
129.236.114.40,<->,111.20.168.12,0,0,4,4865,4,4865,0.273976000,0.0015
136.25.188.163,<->,131.1.195.244,4,5795,0,0,4,5795,0.273426000,1.0694
246.254.97.113,<->,231.255.221.242,4,4248,0,0,4,4248,0.271691000,0.0319
98.219.117.2,<->,80.38.56.218,0,0,4,1295,4,1295,0.271150000,0.1238
133.178.227.24,<->,126.219.102.63,4,4295,0,0,4,4295,0.270879000,1.6371
247.136.253.142,<->,221.102.143.189,4,2668,0,0,4,2668,0.270018000,0.2994
139.248.30.196,<->,100.228.42.154,0,0,4,3479,4,3479,0.269166000,1.0653
136.25.188.223,<->,131.1.232.163,4,4220,0,0,4,4220,0.268984000,1.2431
215.158.140.95,<->,100.216.78.145,4,3681,0,0,4,3681,0.268524000,0.0002
215.158.238.72,<->,57.210.107.36,4,5092,0,0,4,5092,0.267507000,1.4235
215.158.238.75,<->,29.211.6.85,4,5060,0,0,4,5060,0.265748000,1.1704
109.1.59.202,<->,8.179.142.105,4,3613,0,0,4,3613,0.264305000,0.2384
215.158.239.71,<->,29.212.180.226,4,4612,0,0,4,4612,0.262959000,1.5329
8.252.221.223,<->,4.121.64.45,4,1238,0,0,4,1238,0.262701000,1.6351
196.23.12.134,<->,138.98.157.82,0,0,4,1038,4,1038,0.262106000,1.5035
200.174.176.10,<->,54.37.9.160,4,3423,0,0,4,3423,0.260725000,0.9593
136.25.188.236,<->,106.188.236.250,4,5172,0,0,4,5172,0.260642000,1.5387
215.158.239.114,<->,111.151.237.118,4,871,0,0,4,871,0.260258000,1.1533
91.231.223.58,<->,89.183.104.115,0,0,4,356,4,356,0.260216000,1.5008
133.178.226.19,<->,122.158.245.138,4,5300,0,0,4,5300,0.259827000,1.4981
98.23.101.117,<->,92.27.219.35,0,0,4,356,4,356,0.258734000,1.5009
98.23.120.68,<->,89.183.104.115,0,0,4,356,4,356,0.258530000,1.5011
133.178.226.37,<->,104.3.163.55,4,4076,0,0,4,4076,0.258453000,1.4965
133.178.227.76,<->,29.211.228.232,4,4396,0,0,4,4396,0.258396000,1.6322
215.158.238.83,<->,33.209.217.245,4,5763,0,0,4,5763,0.258186000,1.5929
215.158.238.251,<->,120.154.179.8,4,4282,0,0,4,4282,0.256592000,1.6067
215.158.239.88,<->,98.219.126.140,4,3606,0,0,4,3606,0.254905000,1.2811
89.204.235.110,<->,50.224.91.41,0,0,4,1573,4,1573,0.254388000,0.1911
195.41.227.184,<->,136.25.188.254,0,0,4,1208,4,1208,0.254004000,0.2650
215.158.61.202,<->,136.25.188.43,0,0,4,4387,4,4387,0.253977000,0.6080
215.158.239.92,<->,199.20.31.101,4,1695,0,0,4,1695,0.252796000,0.9205
136.25.189.77,<->,116.106.46.57,4,5359,0,0,4,5359,0.252076000,1.4432
133.178.227.2,<->,126.219.132.13,4,4507,0,0,4,4507,0.251579000,1.5322
136.25.188.229,<->,100.224.166.146,4,1893,0,0,4,1893,0.250531000,0.9574
215.158.238.241,<->,100.50.96.201,4,4318,0,0,4,4318,0.248895000,1.7273
215.158.239.85,<->,80.56.79.22,4,4948,0,0,4,4948,0.248669000,1.6261
35.56.31.182,<->,8.182.226.78,0,0,4,2284,4,2284,0.248333000,0.7839
215.158.239.55,<->,129.175.139.25,4,2236,0,0,4,2236,0.246941000,1.4304
199.80.8.197,<->,136.25.188.179,0,0,4,1144,4,1144,0.244061000,0.8332
50.224.76.248,<->,29.211.4.112,4,1143,0,0,4,1143,0.243925000,0.2568
215.158.239.205,<->,148.140.162.140,4,3281,0,0,4,3281,0.243632000,0.3850
195.41.227.184,<->,136.25.188.52,0,0,4,1208,4,1208,0.242441000,0.2531
133.178.227.24,<->,133.56.180.30,4,5118,0,0,4,5118,0.242162000,1.5395
220.28.73.211,<->,215.158.238.218,0,0,4,2871,4,2871,0.242036000,1.6618
215.158.238.33,<->,116.106.60.170,4,4980,0,0,4,4980,0.241994000,1.6323
120.53.101.215,<->,100.94.160.103,0,0,4,1303,4,1303,0.241726000,1.4445
98.23.121.73,<->,89.183.104.115,0,0,4,356,4,356,0.241193000,1.5005
215.158.30.165,<->,8.252.222.55,0,0,4,2676,4,2676,0.239807000,0.8567
231.140.184.139,<->,215.158.239.68,0,0,4,461,4,461,0.238643000,0.6608
215.158.238.243,<->,89.86.110.221,4,4568,0,0,4,4568,0.236917000,1.5588
215.158.238.132,<->,131.144.114.218,4,4980,0,0,4,4980,0.235215000,1.5023
132.216.159.29,<->,92.162.253.30,0,0,4,1643,4,1643,0.235198000,0.1100
133.178.227.1,<->,106.188.252.228,4,4317,0,0,4,4317,0.233073000,1.3394
133.178.226.90,<->,57.160.181.197,4,5380,0,0,4,5380,0.232439000,1.4771
136.25.188.174,<->,29.214.108.191,4,4836,0,0,4,4836,0.231910000,1.0137
36.123.55.203,<->,8.20.87.33,0,0,4,906,4,906,0.231891000,0.4550
215.158.238.146,<->,139.163.161.62,4,2023,0,0,4,2023,0.231514000,0.6542
215.158.140.79,<->,98.219.126.175,4,2641,0,0,4,2641,0.231165000,1.1736
207.193.113.191,<->,8.252.222.177,0,0,4,1128,4,1128,0.230808000,1.5159
80.40.23.244,<->,14.30.152.114,4,3803,0,0,4,3803,0.230467000,1.6565
215.158.239.92,<->,80.56.79.11,4,5076,0,0,4,5076,0.230308000,1.1699
133.178.226.77,<->,8.190.216.200,4,5236,0,0,4,5236,0.230286000,1.3816
215.158.238.141,<->,131.36.198.56,4,4457,0,0,4,4457,0.230211000,1.5547
221.102.143.189,<->,100.94.173.92,0,0,4,564,4,564,0.228865000,1.7446
136.25.188.55,<->,120.154.221.231,4,5220,0,0,4,5220,0.228538000,1.4029
98.129.94.127,<->,97.4.43.222,4,356,0,0,4,356,0.228263000,0.2622
215.158.239.76,<->,29.212.180.246,4,5108,0,0,4,5108,0.228174000,1.3880
215.158.238.177,<->,131.22.233.155,4,4503,0,0,4,4503,0.227622000,1.3216
215.158.239.101,<->,129.222.36.37,4,2268,0,0,4,2268,0.227088000,0.8152
215.158.238.75,<->,57.210.107.41,4,5444,0,0,4,5444,0.226725000,1.6323
215.158.238.45,<->,143.155.227.54,4,3882,0,0,4,3882,0.224861000,0.8542
136.25.188.237,<->,106.188.236.165,4,5188,0,0,4,5188,0.224739000,1.4464
136.25.189.12,<->,29.213.219.87,4,5480,0,0,4,5480,0.223617000,1.5441
133.178.226.77,<->,112.220.206.88,4,5140,0,0,4,5140,0.223600000,1.3059
215.158.239.99,<->,195.55.135.171,4,1209,0,0,4,1209,0.223239000,0.4159
136.25.189.32,<->,8.215.68.89,4,5076,0,0,4,5076,0.223201000,1.4990
136.25.189.94,<->,96.156.169.216,4,4859,0,0,4,4859,0.222733000,1.0141
136.25.189.80,<->,126.219.194.73,4,4562,0,0,4,4562,0.221638000,1.6321
133.178.226.61,<->,69.150.168.216,4,4948,0,0,4,4948,0.221104000,1.4400
215.158.239.96,<->,195.5.233.178,4,1792,0,0,4,1792,0.220488000,0.5760
207.56.138.208,<->,136.25.188.253,0,0,4,1139,4,1139,0.218735000,1.0629
136.25.188.226,<->,122.158.49.130,4,2156,0,0,4,2156,0.218583000,1.3840
136.25.188.198,<->,57.160.181.180,4,5578,0,0,4,5578,0.217086000,1.7632
215.158.238.250,<->,126.219.132.29,4,4324,0,0,4,4324,0.215125000,1.6843
215.158.239.58,<->,196.88.32.12,4,2037,0,0,4,2037,0.213489000,0.0384
136.25.188.254,<->,104.3.163.14,4,5012,0,0,4,5012,0.213407000,1.1370
96.58.68.79,<->,8.220.202.4,0,0,4,564,4,564,0.213037000,0.0601
136.25.188.221,<->,57.210.107.11,4,5284,0,0,4,5284,0.212960000,1.3096
215.158.239.51,<->,195.5.170.96,4,1205,0,0,4,1205,0.210751000,1.4630
215.158.239.49,<->,145.13.164.209,4,5140,0,0,4,5140,0.210266000,1.3928
215.158.239.50,<->,192.204.123.54,4,5028,0,0,4,5028,0.210232000,1.6206
215.158.239.33,<->,215.158.127.169,4,4621,0,0,4,4621,0.209651000,0.5329
136.25.188.227,<->,122.158.245.90,4,5076,0,0,4,5076,0.208146000,1.6172
136.25.189.80,<->,29.214.109.165,4,5284,0,0,4,5284,0.207736000,1.6171
215.158.239.59,<->,29.212.198.183,4,5044,0,0,4,5044,0.207355000,1.2766
142.221.196.250,<->,136.25.188.198,0,0,4,1786,4,1786,0.207287000,1.3531
215.158.239.76,<->,195.5.170.96,4,1205,0,0,4,1205,0.207279000,1.5347
133.178.226.37,<->,91.57.173.47,4,4836,0,0,4,4836,0.207145000,0.9791
198.206.117.169,<->,100.95.71.86,0,0,4,1239,4,1239,0.206738000,0.4305
195.41.227.184,<->,136.25.188.54,0,0,4,1207,4,1207,0.206310000,0.2708
109.222.210.155,<->,54.69.66.184,4,575,0,0,4,575,0.204492000,0.6999
215.158.239.50,<->,195.126.199.229,4,633,0,0,4,633,0.204180000,1.7451
58.242.228.112,<->,8.252.222.133,0,0,4,1909,4,1909,0.203827000,1.4654
207.62.190.212,<->,139.163.7.204,0,0,4,1820,4,1820,0.203540000,1.4606
220.28.65.9,<->,136.25.188.59,0,0,4,2678,4,2678,0.203337000,1.1738
215.158.239.4,<->,215.158.127.169,4,1097,0,0,4,1097,0.202953000,0.7249
136.25.189.77,<->,118.20.100.91,4,5428,0,0,4,5428,0.201540000,1.2597
136.25.188.198,<->,33.209.217.194,4,4425,0,0,4,4425,0.201450000,1.4035
48.129.132.235,<->,8.252.222.199,0,0,4,4660,4,4660,0.200392000,1.6045
215.158.238.67,<->,113.23.21.201,4,4900,0,0,4,4900,0.199727000,1.6801
133.178.226.196,<->,80.47.33.58,4,3912,0,0,4,3912,0.199489000,1.5130
136.95.243.159,<->,100.228.42.97,0,0,4,1444,4,1444,0.197616000,0.0258
215.158.239.56,<->,199.20.6.61,4,1163,0,0,4,1163,0.196782000,0.3890
136.25.189.95,<->,96.156.169.207,4,2428,0,0,4,2428,0.195442000,1.7765
215.158.239.58,<->,196.107.149.137,4,1810,0,0,4,1810,0.194372000,0.8396
207.57.148.180,<->,136.25.188.238,0,0,4,1269,4,1269,0.192679000,1.0363
136.25.189.32,<->,113.23.66.232,4,4948,0,0,4,4948,0.192667000,1.7081
98.23.121.66,<->,89.183.104.115,0,0,4,356,4,356,0.192426000,1.5003
136.25.188.178,<->,120.154.221.218,4,5076,0,0,4,5076,0.190646000,1.7109
195.40.127.28,<->,136.25.188.225,0,0,4,1912,4,1912,0.189804000,0.0345
215.158.239.56,<->,199.20.28.86,4,2277,0,0,4,2277,0.187856000,1.2390
136.25.188.171,<->,100.224.202.157,4,2024,0,0,4,2024,0.187634000,1.2780
136.25.188.47,<->,104.3.163.25,4,5220,0,0,4,5220,0.187528000,1.7620
215.158.140.60,<->,111.150.187.205,4,4370,0,0,4,4370,0.187478000,1.5804
231.143.109.135,<->,136.25.188.52,0,0,4,742,4,742,0.187103000,0.8812
220.28.114.28,<->,133.178.226.8,0,0,4,2973,4,2973,0.186675000,1.1749
136.25.188.52,<->,8.255.92.231,4,5076,0,0,4,5076,0.186549000,1.4708
133.178.227.19,<->,69.150.168.244,4,4196,0,0,4,4196,0.185684000,1.4900
144.71.41.191,<->,33.58.44.223,4,1893,0,0,4,1893,0.185684000,1.6855
215.158.239.84,<->,142.221.133.139,4,1012,0,0,4,1012,0.185045000,0.0157
215.158.238.238,<->,33.209.219.13,4,4216,0,0,4,4216,0.184740000,1.7685
215.158.238.176,<->,126.219.246.252,4,4311,0,0,4,4311,0.184659000,1.3988
136.25.188.55,<->,29.214.108.158,4,4900,0,0,4,4900,0.184319000,0.8907
144.232.206.138,<->,89.183.104.115,0,0,4,356,4,356,0.183928000,1.5005
215.158.239.93,<->,199.20.30.55,4,1035,0,0,4,1035,0.183584000,0.3606
215.158.238.201,<->,98.219.126.140,4,2622,0,0,4,2622,0.181699000,1.4534
215.158.238.83,<->,112.235.95.27,4,5188,0,0,4,5188,0.179786000,1.5567
215.158.238.64,<->,113.23.20.116,4,4852,0,0,4,4852,0.178081000,1.2937
136.25.188.196,<->,30.73.99.38,4,1781,0,0,4,1781,0.177928000,1.5123
136.25.189.1,<->,118.20.100.88,4,5236,0,0,4,5236,0.177600000,1.3036
136.25.188.45,<->,91.57.173.36,4,5236,0,0,4,5236,0.177333000,1.7199
136.25.188.172,<->,106.188.236.186,4,5236,0,0,4,5236,0.176749000,1.5164
252.98.180.157,<->,80.27.155.102,4,2339,0,0,4,2339,0.176403000,0.0010
101.70.121.211,<->,50.239.121.175,4,256,0,0,4,256,0.176318000,1.4399
215.158.238.148,<->,131.1.195.222,4,5513,0,0,4,5513,0.175440000,1.3493
215.158.239.79,<->,199.15.16.24,4,1792,0,0,4,1792,0.175262000,0.7879
215.158.61.191,<->,136.25.188.40,0,0,4,3428,4,3428,0.174173000,1.4404
221.102.113.220,<->,139.254.211.64,4,3230,0,0,4,3230,0.173316000,0.6833
136.25.189.16,<->,29.213.219.69,4,5550,0,0,4,5550,0.172821000,1.7690
136.25.189.34,<->,29.212.199.227,4,5172,0,0,4,5172,0.171023000,1.3850
139.163.96.101,<->,117.37.34.199,4,1068,0,0,4,1068,0.170270000,0.9000
207.21.3.48,<->,8.252.222.23,0,0,4,1795,4,1795,0.169906000,1.1351
220.39.233.186,<->,215.158.238.134,0,0,4,5460,4,5460,0.169889000,1.1538
207.191.137.190,<->,136.25.188.254,0,0,4,1190,4,1190,0.168472000,0.5343
215.158.239.35,<->,8.191.6.109,4,584,0,0,4,584,0.168351000,1.5393
139.194.75.189,<->,8.220.178.203,0,0,4,1274,4,1274,0.168305000,1.5433
215.158.238.148,<->,112.220.206.116,4,3722,0,0,4,3722,0.167974000,1.2387
215.158.61.193,<->,8.176.8.188,0,0,4,4254,4,4254,0.167670000,1.7477
98.129.94.194,<->,8.49.114.128,4,564,0,0,4,564,0.166654000,1.7076
215.158.238.113,<->,139.160.226.167,4,4916,0,0,4,4916,0.166248000,1.6992
133.178.226.29,<->,29.211.6.86,4,5236,0,0,4,5236,0.166161000,1.5821
142.234.196.233,<->,133.178.226.29,0,0,4,5060,4,5060,0.165783000,1.5079
192.67.128.184,<->,144.91.199.50,4,4239,0,0,4,4239,0.165747000,1.1464
100.83.51.93,<->,97.126.113.45,0,0,4,765,4,765,0.165624000,0.8195
220.39.233.164,<->,136.25.188.220,0,0,4,5428,4,5428,0.165012000,1.6430
215.158.239.92,<->,207.213.108.126,4,404,0,0,4,404,0.164874000,0.3200
205.127.108.114,<->,33.233.141.10,0,0,4,1040,4,1040,0.164657000,1.1275
215.158.239.59,<->,96.156.169.148,4,5156,0,0,4,5156,0.163008000,1.1392
136.25.189.31,<->,56.161.218.54,4,5524,0,0,4,5524,0.162895000,1.1430
215.158.238.67,<->,8.190.216.220,4,5284,0,0,4,5284,0.162467000,1.2333
215.158.61.243,<->,8.176.8.182,0,0,4,3660,4,3660,0.161807000,1.5886
215.158.239.30,<->,29.214.74.194,4,3002,0,0,4,3002,0.160290000,1.6698
142.234.196.229,<->,133.178.226.19,0,0,4,5396,4,5396,0.159950000,1.6968
136.25.189.34,<->,120.154.131.37,4,5363,0,0,4,5363,0.157625000,1.6250
204.184.118.17,<->,136.25.188.173,0,0,4,1171,4,1171,0.157458000,0.5385
144.232.206.91,<->,89.183.104.115,0,0,4,356,4,356,0.156611000,1.5002
92.27.219.189,<->,33.57.78.125,4,897,0,0,4,897,0.155879000,0.4779
99.162.77.146,<->,54.37.35.195,4,2627,0,0,4,2627,0.155141000,0.6476
246.253.145.197,<->,195.107.242.74,4,976,0,0,4,976,0.154918000,0.9212
220.39.233.196,<->,133.178.226.90,0,0,4,3676,4,3676,0.153254000,1.2942
136.25.189.8,<->,96.156.169.166,4,2724,0,0,4,2724,0.153222000,1.0379
215.158.239.85,<->,199.20.31.87,4,2017,0,0,4,2017,0.153009000,0.9437
136.25.189.78,<->,80.56.79.87,4,5544,0,0,4,5544,0.152897000,1.7176
194.237.87.119,<->,136.25.188.252,0,0,4,2696,4,2696,0.152356000,0.9882
215.158.238.143,<->,136.138.112.218,4,4964,0,0,4,4964,0.151693000,0.9618
136.25.188.44,<->,69.150.168.246,4,5188,0,0,4,5188,0.151674000,1.0830
136.139.59.118,<->,136.25.188.174,0,0,4,4964,4,4964,0.150484000,1.7927
133.178.227.41,<->,126.219.102.8,4,4377,0,0,4,4377,0.149906000,1.1810
199.122.62.83,<->,136.25.188.252,0,0,4,1223,4,1223,0.147517000,0.0651
204.200.37.111,<->,136.25.188.55,0,0,4,1189,4,1189,0.146393000,0.5479
215.158.61.182,<->,8.176.8.208,0,0,4,3015,4,3015,0.146225000,1.2853
136.25.188.230,<->,80.57.141.141,4,2462,0,0,4,2462,0.145752000,0.1663
215.158.140.93,<->,126.219.191.56,4,4837,0,0,4,4837,0.145738000,1.6012
215.158.239.147,<->,69.132.159.42,4,3076,0,0,4,3076,0.145228000,1.7839
215.158.140.92,<->,111.150.187.223,4,4835,0,0,4,4835,0.144018000,1.5521
194.233.159.170,<->,136.25.188.239,0,0,4,404,4,404,0.143090000,0.5600
215.158.238.223,<->,29.211.6.94,4,4344,0,0,4,4344,0.142073000,1.1182
133.178.226.201,<->,96.114.3.86,4,2946,0,0,4,2946,0.141443000,1.5029
139.241.73.46,<->,129.224.112.221,0,0,4,415,4,415,0.141425000,1.5499
135.207.217.147,<->,98.236.254.37,0,0,4,516,4,516,0.141280000,1.8586
215.158.238.148,<->,131.144.114.231,4,5092,0,0,4,5092,0.140442000,1.2892
136.25.189.33,<->,29.212.180.213,4,5236,0,0,4,5236,0.139619000,0.8841
195.5.40.52,<->,136.25.188.178,0,0,4,1449,4,1449,0.138233000,0.2267
215.158.238.73,<->,131.1.232.163,4,3884,0,0,4,3884,0.138193000,1.7174
215.158.239.71,<->,29.214.109.128,4,5236,0,0,4,5236,0.138058000,1.6790
215.158.238.83,<->,131.1.253.233,4,5581,0,0,4,5581,0.137463000,1.6669
194.233.8.142,<->,136.25.188.177,0,0,4,1257,4,1257,0.137200000,1.0299
136.25.188.47,<->,131.144.113.189,4,4948,0,0,4,4948,0.136328000,1.2329
133.178.227.19,<->,18.202.90.214,4,4428,0,0,4,4428,0.135593000,1.3969
215.158.238.95,<->,131.1.253.227,4,5534,0,0,4,5534,0.134627000,1.4818
220.39.233.217,<->,215.158.238.64,0,0,4,4332,4,4332,0.132267000,1.0955
159.13.141.83,<->,53.167.130.195,4,2503,0,0,4,2503,0.131950000,0.2423
8.182.251.218,<->,6.26.250.106,4,2432,0,0,4,2432,0.131814000,1.0563
215.158.140.241,<->,8.191.7.251,4,4738,0,0,4,4738,0.131777000,1.6177
133.178.226.31,<->,131.144.113.171,4,4900,0,0,4,4900,0.131189000,1.8064
200.175.52.173,<->,53.68.146.9,4,600,0,0,4,600,0.131187000,1.3417
215.158.238.98,<->,80.47.111.106,4,5220,0,0,4,5220,0.130737000,1.5279
247.136.138.229,<->,144.89.245.216,4,2916,0,0,4,2916,0.130720000,1.2518
195.5.209.52,<->,136.25.188.178,0,0,4,1343,4,1343,0.130581000,0.1907
246.253.168.245,<->,131.0.89.188,4,1764,0,0,4,1764,0.130127000,0.1373
136.25.189.78,<->,106.188.253.229,4,4628,0,0,4,4628,0.129878000,1.5459
144.232.206.55,<->,89.183.104.115,0,0,4,356,4,356,0.128872000,1.5006
136.25.188.255,<->,29.214.108.168,4,5656,0,0,4,5656,0.128653000,0.6730
136.25.188.203,<->,80.57.208.31,4,1508,0,0,4,1508,0.127484000,0.0010
215.158.238.113,<->,120.154.221.219,4,5092,0,0,4,5092,0.127245000,1.7332
215.158.239.96,<->,207.213.60.85,4,1557,0,0,4,1557,0.127188000,0.4342
207.239.31.248,<->,136.25.188.252,0,0,4,1155,4,1155,0.127181000,0.5984
136.25.188.196,<->,113.23.20.105,4,4060,0,0,4,4060,0.126272000,1.6377
215.158.238.82,<->,8.255.92.202,4,4964,0,0,4,4964,0.126160000,1.4621
17.249.7.18,<->,8.220.204.147,0,0,4,1696,4,1696,0.125516000,0.1249
215.158.238.64,<->,120.154.221.229,4,5172,0,0,4,5172,0.125168000,1.4192
220.60.81.133,<->,215.158.239.79,0,0,4,5412,4,5412,0.125031000,1.3076
220.28.115.46,<->,136.25.189.39,0,0,4,4391,4,4391,0.124218000,1.8371
197.125.126.244,<->,136.25.188.160,0,0,4,4884,4,4884,0.123777000,1.4192
136.25.188.220,<->,27.178.41.57,4,5252,0,0,4,5252,0.123376000,1.3438
215.158.61.189,<->,8.176.8.106,0,0,4,4694,4,4694,0.123291000,1.5799
215.158.61.182,<->,133.178.226.173,0,0,4,4687,4,4687,0.123221000,1.2042
133.178.226.18,<->,104.3.168.202,4,4788,0,0,4,4788,0.122796000,1.3152
215.158.238.85,<->,100.224.166.163,4,2023,0,0,4,2023,0.122530000,1.5626
136.25.188.202,<->,80.57.141.142,4,1539,0,0,4,1539,0.122215000,0.1204
136.25.188.236,<->,57.160.181.181,4,4308,0,0,4,4308,0.122133000,0.4968
136.25.189.28,<->,29.212.198.166,4,4996,0,0,4,4996,0.121976000,1.7843
136.25.188.239,<->,8.255.92.247,4,4980,0,0,4,4980,0.121277000,1.5158
133.178.227.1,<->,126.219.101.143,4,4331,0,0,4,4331,0.121113000,1.6539
136.25.188.255,<->,104.3.168.218,4,5252,0,0,4,5252,0.120094000,1.6720
133.178.227.27,<->,8.50.170.213,4,4362,0,0,4,4362,0.119353000,1.2206
98.23.101.117,<->,92.27.27.142,0,0,4,356,4,356,0.118529000,1.5002
142.195.47.244,<->,136.25.188.222,0,0,4,1059,4,1059,0.118416000,0.0292
136.25.189.88,<->,96.156.169.160,4,3204,0,0,4,3204,0.117985000,1.2803
136.25.189.59,<->,106.188.253.166,4,5122,0,0,4,5122,0.117866000,1.6387
139.8.186.160,<->,133.178.227.14,0,0,4,4365,4,4365,0.116893000,1.4285
136.25.189.88,<->,29.211.228.247,4,5028,0,0,4,5028,0.115557000,1.2723
215.158.238.126,<->,100.224.166.122,4,1883,0,0,4,1883,0.115104000,1.3803
215.158.238.133,<->,8.42.43.3,4,5220,0,0,4,5220,0.114850000,1.5911
215.158.239.57,<->,196.105.30.196,4,2715,0,0,4,2715,0.113972000,0.0499
136.25.189.85,<->,96.156.169.225,4,4220,0,0,4,4220,0.113624000,1.5236
215.158.238.104,<->,8.190.216.193,4,5204,0,0,4,5204,0.113300000,1.6045
215.158.238.47,<->,119.196.23.41,4,5140,0,0,4,5140,0.113145000,1.5256
215.158.239.57,<->,156.165.37.111,4,5236,0,0,4,5236,0.112656000,1.7568
194.237.116.255,<->,136.25.188.55,0,0,4,1956,4,1956,0.112014000,0.4871
215.158.239.57,<->,142.227.70.96,4,1952,0,0,4,1952,0.111856000,0.0617
253.220.179.237,<->,136.25.188.173,0,0,4,1497,4,1497,0.111211000,0.0325
6.145.150.41,<->,0.195.210.44,0,0,4,597,4,597,0.110709000,1.8260
215.158.239.67,<->,133.56.180.38,4,2444,0,0,4,2444,0.110371000,1.1934
136.25.189.15,<->,116.106.46.75,4,5477,0,0,4,5477,0.110217000,1.8151
97.149.24.218,<->,53.231.73.170,4,1016,0,0,4,1016,0.110214000,1.0793
136.25.188.210,<->,29.214.108.148,4,4980,0,0,4,4980,0.109967000,1.6669
220.28.115.46,<->,215.158.238.129,0,0,4,2970,4,2970,0.108778000,1.2574
136.25.188.177,<->,57.160.181.214,4,5648,0,0,4,5648,0.108420000,1.5328
129.95.133.231,<->,14.119.194.95,0,0,4,673,4,673,0.108257000,0.0987
239.66.218.250,<->,139.163.41.64,0,0,4,909,4,909,0.106727000,1.7787
136.25.188.220,<->,57.160.181.248,4,5140,0,0,4,5140,0.105926000,1.1935
215.158.6.223,<->,8.252.223.176,0,0,4,4378,4,4378,0.105826000,1.6147
215.158.140.175,<->,96.143.113.148,4,2016,0,0,4,2016,0.104824000,1.2802
136.25.189.45,<->,96.156.169.162,4,4476,0,0,4,4476,0.104677000,0.9439
204.200.52.221,<->,136.25.188.252,0,0,4,1152,4,1152,0.104588000,0.2277
136.25.188.199,<->,122.158.245.86,4,4012,0,0,4,4012,0.104200000,0.7332
215.158.140.204,<->,6.73.247.7,4,4093,0,0,4,4093,0.103598000,0.6457
246.108.92.97,<->,139.193.141.139,0,0,4,985,4,985,0.103227000,0.1561
144.87.249.132,<->,8.182.226.78,0,0,4,2345,4,2345,0.103159000,0.1475
136.25.189.80,<->,29.211.228.213,4,5076,0,0,4,5076,0.102186000,0.8036
98.23.101.117,<->,92.27.219.165,0,0,4,356,4,356,0.101084000,1.5005
136.25.188.211,<->,29.214.108.168,4,5695,0,0,4,5695,0.100405000,0.8379
144.232.206.54,<->,89.183.104.115,0,0,4,356,4,356,0.099994000,1.5004
215.158.140.231,<->,113.23.66.41,4,4490,0,0,4,4490,0.099114000,1.2420
215.158.238.143,<->,131.1.195.220,4,4157,0,0,4,4157,0.098513000,1.7905
205.127.108.114,<->,101.224.89.251,0,0,4,818,4,818,0.098381000,0.5341
132.119.137.71,<->,80.27.158.183,0,0,4,1179,4,1179,0.097710000,0.5315
215.158.238.121,<->,126.219.132.160,4,5268,0,0,4,5268,0.097290000,1.3890
215.158.140.75,<->,8.240.116.198,4,5016,0,0,4,5016,0.097118000,1.5731
133.178.227.1,<->,111.150.187.198,4,4564,0,0,4,4564,0.096702000,1.7713
129.175.139.42,<->,8.252.222.241,0,0,4,3993,4,3993,0.095277000,1.4588
215.158.239.42,<->,8.191.6.219,4,2098,0,0,4,2098,0.093093000,1.6316
111.20.172.118,<->,101.224.89.178,0,0,4,2684,4,2684,0.092793000,0.0002
215.158.239.52,<->,97.174.232.172,4,572,0,0,4,572,0.092723000,1.6982
215.158.238.123,<->,131.36.198.56,4,5520,0,0,4,5520,0.091534000,1.4307
133.178.227.57,<->,126.219.132.44,4,4316,0,0,4,4316,0.089935000,1.5303
215.158.238.83,<->,104.3.163.39,4,5284,0,0,4,5284,0.089440000,1.7786
142.218.198.234,<->,8.52.182.30,0,0,4,1097,4,1097,0.088980000,1.2602
133.178.226.212,<->,8.254.21.27,4,1890,0,0,4,1890,0.088091000,1.6607
136.25.188.161,<->,126.219.194.180,4,5252,0,0,4,5252,0.087780000,1.7222
136.25.188.233,<->,56.23.171.47,4,1996,0,0,4,1996,0.087633000,0.9923
133.178.226.90,<->,112.220.206.88,4,4852,0,0,4,4852,0.087328000,1.1203
133.178.226.90,<->,8.188.227.60,4,4820,0,0,4,4820,0.086696000,0.7887
215.158.61.193,<->,8.176.8.255,0,0,4,4212,4,4212,0.086601000,0.8677
136.25.189.7,<->,96.156.169.197,4,3308,0,0,4,3308,0.086531000,0.7393
215.158.239.100,<->,53.231.162.97,4,2293,0,0,4,2293,0.086510000,0.0643
215.158.238.65,<->,8.188.227.36,4,4980,0,0,4,4980,0.086496000,1.6725
136.25.189.0,<->,80.56.79.20,4,4996,0,0,4,4996,0.084850000,1.1358
136.25.188.210,<->,113.23.20.93,4,4900,0,0,4,4900,0.084654000,1.8060
215.158.61.191,<->,8.176.8.219,0,0,4,2725,4,2725,0.084623000,1.6774
220.60.81.132,<->,136.25.189.15,0,0,4,5044,4,5044,0.084045000,1.7746
136.25.188.254,<->,27.178.41.9,4,5268,0,0,4,5268,0.082396000,1.6075
215.158.238.67,<->,106.188.183.120,4,3253,0,0,4,3253,0.082025000,1.7370
215.158.239.92,<->,192.224.21.22,4,5044,0,0,4,5044,0.080927000,1.8897
136.25.189.80,<->,118.20.100.121,4,5284,0,0,4,5284,0.080918000,0.9743
136.25.189.31,<->,98.28.95.84,4,3932,0,0,4,3932,0.080851000,1.6264
246.45.208.172,<->,132.119.137.223,4,1180,0,0,4,1180,0.079641000,1.3568
215.158.238.92,<->,8.190.216.201,4,5396,0,0,4,5396,0.079225000,1.5934
215.158.61.189,<->,136.25.189.194,0,0,4,2372,4,2372,0.078233000,1.5502
136.25.189.2,<->,29.214.73.159,4,5156,0,0,4,5156,0.077819000,1.6111
215.158.61.189,<->,8.176.8.193,0,0,4,2843,4,2843,0.077306000,0.5400
98.23.101.117,<->,89.183.104.169,0,0,4,356,4,356,0.076178000,1.5016
215.158.239.115,<->,89.7.157.66,4,4267,0,0,4,4267,0.076026000,1.8702
201.90.144.82,<->,50.224.96.232,0,0,4,3466,4,3466,0.075844000,1.0746
136.25.188.163,<->,33.209.217.228,4,5806,0,0,4,5806,0.075481000,1.6579
215.158.140.83,<->,106.188.228.23,4,4480,0,0,4,4480,0.075028000,1.6153
144.72.193.17,<->,100.94.73.184,0,0,4,4157,4,4157,0.074833000,0.3091
215.158.239.86,<->,192.204.123.37,4,5268,0,0,4,5268,0.074744000,0.4739
195.51.165.90,<->,8.182.227.180,0,0,4,1654,4,1654,0.074202000,1.1042
199.70.95.222,<->,136.25.188.45,0,0,4,1906,4,1906,0.073204000,0.0277
215.158.239.22,<->,96.135.154.158,4,4005,0,0,4,4005,0.072676000,1.1813
210.220.217.34,<->,102.251.235.53,4,932,0,0,4,932,0.071849000,1.5240
136.25.188.179,<->,106.188.236.250,4,5252,0,0,4,5252,0.071632000,1.3487
136.181.39.230,<->,0.195.216.244,4,2362,0,0,4,2362,0.070553000,0.6610
136.25.188.227,<->,8.222.212.25,4,5524,0,0,4,5524,0.070275000,0.6955
215.158.140.60,<->,113.23.14.216,4,4633,0,0,4,4633,0.069706000,1.0311
215.158.239.77,<->,142.208.41.233,4,882,0,0,4,882,0.069692000,0.0373
133.178.227.243,<->,80.47.111.58,4,3577,0,0,4,3577,0.068377000,1.8106
215.158.238.223,<->,8.40.50.51,4,4492,0,0,4,4492,0.067579000,1.2018
215.158.238.141,<->,131.1.195.185,4,4450,0,0,4,4450,0.066835000,1.8482
215.158.239.85,<->,207.63.198.183,4,1614,0,0,4,1614,0.066713000,1.9304
133.178.227.38,<->,133.56.180.36,4,2027,0,0,4,2027,0.065908000,1.7077
136.25.188.173,<->,29.214.64.170,4,5204,0,0,4,5204,0.065379000,1.3121
200.174.107.227,<->,54.38.66.136,4,712,0,0,4,712,0.065285000,1.1922
215.158.238.134,<->,131.144.113.183,4,4884,0,0,4,4884,0.065248000,1.7781
158.85.50.170,<->,133.178.227.27,0,0,4,4269,4,4269,0.064602000,1.4956
136.25.188.221,<->,131.144.114.210,4,4884,0,0,4,4884,0.064379000,1.5100
136.25.189.57,<->,116.106.46.75,4,5268,0,0,4,5268,0.064225000,1.6987
144.75.81.88,<->,100.228.42.163,0,0,4,2080,4,2080,0.063652000,1.1693
215.158.140.83,<->,192.226.161.39,4,4310,0,0,4,4310,0.063271000,1.6332
215.158.238.67,<->,131.1.253.224,4,5635,0,0,4,5635,0.063067000,0.9075
215.158.30.238,<->,8.252.222.33,0,0,4,1252,4,1252,0.061889000,0.2794
220.28.104.193,<->,133.178.227.44,0,0,4,2415,4,2415,0.061803000,0.2609
194.124.22.48,<->,145.252.126.80,0,0,4,2250,4,2250,0.061505000,0.5932
106.149.180.120,<->,92.27.219.232,0,0,4,3920,4,3920,0.060631000,1.6175
139.163.161.169,<->,133.32.39.20,0,0,4,1027,4,1027,0.060452000,0.1219
136.25.189.83,<->,29.211.228.178,4,5044,0,0,4,5044,0.059788000,1.3161
215.158.238.250,<->,130.165.253.35,4,4277,0,0,4,4277,0.059116000,1.8391
215.158.239.35,<->,29.211.5.201,4,1768,0,0,4,1768,0.057544000,1.1130
136.25.188.210,<->,122.158.245.102,4,5188,0,0,4,5188,0.057454000,1.1418
136.25.188.252,<->,131.1.253.251,4,5460,0,0,4,5460,0.056831000,1.7349
95.246.196.134,<->,8.252.222.44,0,0,4,444,4,444,0.055683000,0.6613
215.158.239.70,<->,204.58.49.172,4,1959,0,0,4,1959,0.055354000,1.8068
215.158.239.28,<->,8.191.6.123,4,1913,0,0,4,1913,0.055218000,1.4020
136.25.188.44,<->,106.188.236.212,4,5268,0,0,4,5268,0.055176000,1.8662
106.186.17.103,<->,100.95.21.226,0,0,4,676,4,676,0.055165000,0.2631
215.158.239.113,<->,215.158.61.242,4,4476,0,0,4,4476,0.054707000,1.1692
149.250.115.21,<->,133.178.226.37,0,0,4,5108,4,5108,0.054216000,1.4995
142.184.37.108,<->,0.195.210.46,0,0,4,1092,4,1092,0.053996000,0.0182
215.158.238.135,<->,112.235.95.21,4,5252,0,0,4,5252,0.053542000,1.6048
212.164.245.218,<->,8.52.188.75,0,0,4,1205,4,1205,0.052849000,0.1191
215.158.238.193,<->,56.100.165.51,4,1978,0,0,4,1978,0.052797000,1.7821
111.150.187.250,<->,8.252.223.153,0,0,4,4343,4,4343,0.052055000,1.1902
136.25.189.24,<->,98.219.126.175,4,2369,0,0,4,2369,0.051878000,0.5375
133.178.226.21,<->,98.219.126.140,4,3381,0,0,4,3381,0.050888000,1.8251
106.168.190.222,<->,99.75.255.41,0,0,4,1549,4,1549,0.050831000,0.9190
215.158.140.172,<->,8.222.7.181,4,3919,0,0,4,3919,0.050436000,1.9460
136.25.189.1,<->,29.212.199.244,4,5332,0,0,4,5332,0.049904000,1.8989
98.23.101.117,<->,89.183.104.160,0,0,4,356,4,356,0.049805000,1.5011
215.158.238.64,<->,33.209.217.230,4,5762,0,0,4,5762,0.049002000,1.8507
215.158.238.176,<->,192.226.161.38,4,4278,0,0,4,4278,0.048337000,1.1821
238.161.178.115,<->,92.27.27.178,0,0,4,336,4,336,0.048287000,0.4390
215.158.140.178,<->,8.222.7.180,4,4146,0,0,4,4146,0.048199000,0.9533
69.128.77.216,<->,54.92.5.14,4,1189,0,0,4,1189,0.048131000,1.9395
215.158.140.76,<->,131.144.112.246,4,4301,0,0,4,4301,0.048091000,0.9951
215.158.239.66,<->,98.219.126.140,4,4912,0,0,4,4912,0.047422000,1.0191
215.158.238.47,<->,8.190.216.193,4,5476,0,0,4,5476,0.047229000,1.6081
216.184.1.90,<->,136.25.188.170,0,0,4,3310,4,3310,0.046922000,0.0559
133.178.226.90,<->,69.150.168.213,4,4980,0,0,4,4980,0.045938000,1.0542
143.72.233.132,<->,136.25.188.179,0,0,4,1549,4,1549,0.045700000,0.2249
148.26.113.23,<->,136.25.189.46,0,0,4,5284,4,5284,0.044977000,1.7612
121.79.59.152,<->,92.162.253.163,0,0,4,4256,4,4256,0.043870000,0.1180
53.231.66.6,<->,48.54.81.68,0,0,4,5904,4,5904,0.043732000,1.7920
207.162.175.71,<->,0.195.210.46,0,0,4,2558,4,2558,0.042081000,1.9430
215.158.238.123,<->,8.188.227.70,4,5140,0,0,4,5140,0.041421000,1.8672
215.158.140.241,<->,106.188.252.228,4,4252,0,0,4,4252,0.041207000,1.6104
215.158.239.30,<->,8.191.6.122,4,971,0,0,4,971,0.041067000,1.8947
218.4.191.217,<->,111.151.239.7,4,2879,0,0,4,2879,0.040931000,0.1800
199.38.61.76,<->,136.25.188.176,0,0,4,1006,4,1006,0.040369000,0.0293
215.158.238.64,<->,106.188.183.119,4,489,0,0,4,489,0.040318000,1.4835
220.28.114.28,<->,215.158.238.234,0,0,4,2192,4,2192,0.040183000,1.2151
215.158.140.76,<->,113.23.66.229,4,4339,0,0,4,4339,0.039936000,1.4202
118.209.218.71,<->,89.183.104.141,0,0,4,3148,4,3148,0.039801000,0.9436
102.83.132.100,<->,89.183.104.231,0,0,4,5584,4,5584,0.039768000,1.9431
136.25.189.90,<->,96.156.169.253,4,5652,0,0,4,5652,0.039687000,1.9367
215.158.239.109,<->,100.224.141.62,4,3340,0,0,4,3340,0.038884000,1.1958
215.158.238.45,<->,69.150.169.154,4,5060,0,0,4,5060,0.038181000,1.7435
136.25.189.52,<->,96.156.169.167,4,2852,0,0,4,2852,0.038098000,0.3714
126.198.202.200,<->,108.134.118.34,0,0,4,884,4,884,0.037629000,0.3571
215.158.238.176,<->,8.221.197.119,4,4660,0,0,4,4660,0.037419000,1.2489
215.158.140.232,<->,100.216.78.145,4,2220,0,0,4,2220,0.037080000,0.6352
133.178.227.79,<->,133.56.180.47,4,2868,0,0,4,2868,0.036023000,1.2778
215.158.239.76,<->,8.255.92.166,4,4268,0,0,4,4268,0.035868000,1.8231
133.178.227.79,<->,104.3.168.53,4,4307,0,0,4,4307,0.035556000,1.5150
247.136.208.15,<->,0.195.206.242,4,628,0,0,4,628,0.035376000,0.0010
136.25.188.255,<->,29.214.108.171,4,4639,0,0,4,4639,0.035350000,1.7066
133.178.226.197,<->,80.47.33.125,4,2716,0,0,4,2716,0.034998000,1.6164
69.128.72.98,<->,54.92.5.14,4,1189,0,0,4,1189,0.034627000,1.9391
101.123.185.203,<->,8.55.208.173,4,1876,0,0,4,1876,0.034259000,0.1461
215.158.238.95,<->,212.70.75.121,4,280,0,0,4,280,0.033786000,1.5728
215.158.238.113,<->,126.219.132.160,4,4172,0,0,4,4172,0.032303000,1.6504
215.158.61.182,<->,8.176.8.178,0,0,4,2320,4,2320,0.030409000,1.4117
207.60.79.224,<->,136.25.188.238,0,0,4,404,4,404,0.030124000,0.2444
132.222.168.221,<->,97.91.14.64,4,5044,0,0,4,5044,0.029678000,1.5176
53.244.1.12,<->,35.56.101.110,0,0,4,2937,4,2937,0.029534000,1.4240
215.158.238.113,<->,112.235.95.60,4,5092,0,0,4,5092,0.029061000,1.8449
215.158.239.84,<->,199.52.193.186,4,1764,0,0,4,1764,0.028466000,0.3535
221.102.143.189,<->,109.3.187.34,0,0,4,2542,4,2542,0.027462000,0.4362
204.130.124.99,<->,8.252.222.177,0,0,4,1279,4,1279,0.027011000,1.8908
113.188.212.241,<->,101.224.204.158,0,0,4,1054,4,1054,0.026470000,0.0870
133.178.226.38,<->,8.222.212.8,4,5364,0,0,4,5364,0.025976000,1.9340
215.158.44.254,<->,136.25.189.80,0,0,4,5076,4,5076,0.024998000,0.4518
8.252.223.176,<->,8.219.184.149,4,4596,0,0,4,4596,0.022829000,1.6536
215.158.238.99,<->,136.139.59.124,4,3546,0,0,4,3546,0.022472000,1.4318
136.25.188.228,<->,0.195.253.228,4,3713,0,0,4,3713,0.022048000,1.2728
136.25.188.44,<->,112.235.95.24,4,5284,0,0,4,5284,0.021713000,1.5427
192.228.25.203,<->,133.178.226.213,0,0,4,2930,4,2930,0.020902000,1.4983
215.158.238.148,<->,149.250.115.40,4,4916,0,0,4,4916,0.020439000,1.8069
199.33.29.229,<->,136.25.188.177,0,0,4,1784,4,1784,0.019743000,0.9274
136.25.188.237,<->,131.144.113.162,4,4996,0,0,4,4996,0.019244000,1.1971
200.174.202.55,<->,53.149.154.111,4,782,0,0,4,782,0.019033000,1.5512
215.158.6.195,<->,133.178.227.70,0,0,4,4326,4,4326,0.017720000,1.6655
136.25.189.1,<->,96.156.169.233,4,5667,0,0,4,5667,0.017151000,1.6813
215.158.238.236,<->,131.144.114.249,4,4412,0,0,4,4412,0.016532000,1.9321
136.25.189.25,<->,96.156.169.165,4,1308,0,0,4,1308,0.016067000,1.2603
220.28.108.254,<->,133.178.227.45,0,0,4,2425,4,2425,0.015421000,1.3653
215.158.238.188,<->,126.219.191.7,4,4683,0,0,4,4683,0.014496000,1.6513
144.87.238.55,<->,144.87.235.175,0,0,4,993,4,993,0.013695000,0.1683
215.158.140.60,<->,158.85.50.137,4,4255,0,0,4,4255,0.013505000,0.7568
106.168.191.70,<->,80.42.185.5,0,0,4,790,4,790,0.012895000,1.6927
215.158.239.34,<->,96.135.154.148,4,4500,0,0,4,4500,0.012418000,1.5289
136.25.189.29,<->,96.156.169.195,4,5476,0,0,4,5476,0.012298000,1.2050
192.64.252.158,<->,27.116.207.55,4,3642,0,0,4,3642,0.012028000,1.6378
220.60.81.139,<->,136.25.189.34,0,0,4,5124,4,5124,0.011826000,0.7786
92.27.59.73,<->,89.183.104.115,0,0,4,356,4,356,0.011387000,1.5005
215.158.238.81,<->,119.196.23.0,4,5316,0,0,4,5316,0.011290000,1.7120
143.227.65.146,<->,133.178.226.31,0,0,4,4868,4,4868,0.010183000,1.9843
215.158.238.67,<->,131.144.113.193,4,5012,0,0,4,5012,0.009690000,1.8087
215.158.239.50,<->,199.20.31.81,4,1880,0,0,4,1880,0.008792000,1.6401
215.158.238.67,<->,112.220.206.22,4,1905,0,0,4,1905,0.008501000,1.0532
136.25.189.81,<->,96.150.228.235,4,5060,0,0,4,5060,0.007171000,1.6964
148.157.186.140,<->,80.40.40.164,0,0,4,482,4,482,0.007118000,1.6272
215.158.61.203,<->,136.25.189.243,0,0,4,2060,4,2060,0.007073000,1.5467
215.158.238.80,<->,126.219.132.169,4,5300,0,0,4,5300,0.006994000,1.9871
215.158.238.250,<->,120.154.179.31,4,4404,0,0,4,4404,0.006882000,1.9753
215.158.239.70,<->,207.213.60.85,4,1172,0,0,4,1172,0.006699000,0.2197
215.158.140.195,<->,8.222.7.154,4,4117,0,0,4,4117,0.006470000,1.6409
215.158.239.85,<->,131.2.102.9,4,5332,0,0,4,5332,0.005874000,1.6616
136.25.188.173,<->,111.151.239.87,4,5412,0,0,4,5412,0.005452000,1.7171
136.25.188.226,<->,69.150.168.246,4,5092,0,0,4,5092,0.005391000,1.4902
220.28.108.254,<->,136.25.189.55,0,0,4,3189,4,3189,0.005315000,1.6772
215.158.239.85,<->,196.94.223.242,4,1149,0,0,4,1149,0.004655000,0.8400
138.20.59.183,<->,8.53.2.255,0,0,4,1976,4,1976,0.004279000,1.8292
143.76.120.199,<->,136.25.188.224,0,0,4,1316,4,1316,0.002133000,0.4058
195.15.219.41,<->,136.25.188.226,0,0,4,2861,4,2861,0.001691000,0.1961
215.158.140.75,<->,29.214.109.175,4,4205,0,0,4,4205,0.001598000,1.8523
215.158.140.75,<->,89.86.110.196,4,4391,0,0,4,4391,0.000598000,1.4017
92.27.27.154,<->,33.57.78.108,4,204,0,0,4,204,0.000241000,1.6836
215.158.238.110,<->,100.120.38.6,3,3015,0,0,3,3015,1.994257000,0.0002
192.64.222.89,<->,159.57.90.83,3,3557,0,0,3,3557,1.945551000,0.0000
136.25.189.193,<->,53.231.140.114,3,1856,0,0,3,1856,1.942393000,0.0337
233.169.19.77,<->,136.25.188.199,0,0,3,752,3,752,1.930873000,0.0316
215.158.239.85,<->,207.188.252.26,3,2143,0,0,3,2143,1.927222000,0.0234
246.254.97.109,<->,56.114.235.120,3,1632,0,0,3,1632,1.920540000,0.0650
215.158.30.229,<->,8.252.222.136,0,0,3,1558,3,1558,1.912304000,0.0695
215.158.238.85,<->,0.195.253.228,3,2580,0,0,3,2580,1.905653000,0.0000
136.25.189.29,<->,96.156.169.150,3,1727,0,0,3,1727,1.895457000,0.0439
132.249.70.208,<->,98.197.185.18,3,300,0,0,3,300,1.895308000,0.0022
220.28.115.46,<->,215.158.238.253,0,0,3,2323,3,2323,1.892271000,0.0626
220.20.200.8,<->,144.83.60.153,3,747,0,0,3,747,1.886416000,0.0537
246.254.97.104,<->,210.209.251.214,3,736,0,0,3,736,1.883624000,0.0432
136.181.43.39,<->,111.151.239.68,3,1550,0,0,3,1550,1.880097000,0.0654
139.47.193.207,<->,101.224.89.249,0,0,3,3438,3,3438,1.877677000,0.0000
222.65.25.133,<->,89.74.85.198,3,648,0,0,3,648,1.872003000,0.0806
17.124.213.2,<->,8.52.148.157,0,0,3,1486,3,1486,1.870597000,0.0604
88.11.96.99,<->,50.224.76.234,0,0,3,793,3,793,1.870376000,0.0000
215.158.239.57,<->,199.20.6.97,3,1583,0,0,3,1583,1.865586000,0.0707
195.14.209.131,<->,136.25.188.239,0,0,3,999,3,999,1.857438000,0.0046
215.158.61.224,<->,136.25.189.214,0,0,3,1622,3,1622,1.856091000,0.0227
129.254.96.7,<->,80.38.33.214,0,0,3,1718,3,1718,1.852115000,0.0730
247.136.231.39,<->,231.255.222.140,3,1004,0,0,3,1004,1.850605000,0.0642
199.122.11.131,<->,136.25.188.243,0,0,3,1516,3,1516,1.835557000,0.0174
221.98.66.193,<->,98.249.162.2,3,799,0,0,3,799,1.834115000,0.1105
215.158.239.95,<->,194.251.120.44,3,1062,0,0,3,1062,1.833516000,0.1645
129.225.135.32,<->,129.225.132.95,0,0,3,291,3,291,1.832252000,0.1312
221.102.56.46,<->,192.65.102.184,0,0,3,1879,3,1879,1.827579000,0.1663
136.25.188.225,<->,97.80.224.204,3,544,0,0,3,544,1.816148000,0.0474
109.1.37.80,<->,100.230.5.7,3,2877,0,0,3,2877,1.814832000,0.1226
92.181.45.37,<->,8.204.53.229,3,882,0,0,3,882,1.809382000,0.0176
109.222.241.232,<->,54.53.96.198,3,2077,0,0,3,2077,1.796186000,0.1352
100.124.212.248,<->,56.121.35.245,0,0,3,1190,3,1190,1.794929000,0.0650
102.231.177.209,<->,8.20.81.32,3,1421,0,0,3,1421,1.793160000,0.1127
192.64.245.110,<->,100.124.212.156,3,1626,0,0,3,1626,1.789794000,0.1258
215.158.239.85,<->,199.20.29.216,3,1862,0,0,3,1862,1.781614000,0.0199
215.158.239.79,<->,196.106.76.163,3,1821,0,0,3,1821,1.779851000,0.0097
139.47.239.85,<->,80.32.150.19,3,653,0,0,3,653,1.779815000,0.1418
136.181.33.175,<->,111.151.239.49,3,1616,0,0,3,1616,1.779520000,0.0893
192.228.30.207,<->,133.178.227.208,0,0,3,655,3,655,1.778161000,0.0001
215.158.239.56,<->,207.166.123.127,3,1676,0,0,3,1676,1.777968000,0.2173
121.77.99.114,<->,80.42.131.27,0,0,3,510,3,510,1.770965000,0.1762
216.184.1.125,<->,8.252.222.27,0,0,3,2294,3,2294,1.770566000,0.1110
221.102.56.46,<->,192.67.115.24,0,0,3,630,3,630,1.767843000,0.0382
6.145.152.249,<->,0.195.210.44,0,0,3,359,3,359,1.764471000,0.0001
124.46.191.127,<->,92.162.253.144,0,0,3,2319,3,2319,1.758990000,0.0420
222.20.241.60,<->,221.102.112.165,0,0,3,759,3,759,1.752165000,0.0529
215.158.61.189,<->,8.176.8.206,0,0,3,1801,3,1801,1.743291000,0.1878
207.59.202.58,<->,136.25.188.220,0,0,3,2147,3,2147,1.739982000,0.0488
142.236.202.155,<->,136.25.188.241,0,0,3,1701,3,1701,1.737097000,0.2009
195.14.209.131,<->,136.25.188.209,0,0,3,999,3,999,1.736421000,0.0170
204.3.63.170,<->,136.25.188.236,0,0,3,883,3,883,1.733063000,0.0092
245.161.127.146,<->,8.252.222.187,0,0,3,1662,3,1662,1.732933000,0.1661
139.33.174.178,<->,111.147.174.227,0,0,3,2888,3,2888,1.729803000,0.0402
196.245.4.133,<->,136.25.188.220,0,0,3,1376,3,1376,1.728350000,0.2697
220.20.200.32,<->,131.45.239.178,3,1828,0,0,3,1828,1.726858000,0.1264
111.146.238.243,<->,54.36.97.247,3,1972,0,0,3,1972,1.724246000,0.1710
195.7.64.30,<->,136.25.188.54,0,0,3,1217,3,1217,1.722362000,0.1862
215.158.239.93,<->,196.89.60.33,3,1051,0,0,3,1051,1.721746000,0.2582
216.184.1.103,<->,8.252.222.169,0,0,3,1886,3,1886,1.721707000,0.0619
136.25.188.160,<->,41.158.141.108,3,973,0,0,3,973,1.720766000,0.1331
195.14.150.149,<->,136.25.188.242,0,0,3,1653,3,1653,1.714142000,0.1696
215.158.239.84,<->,195.14.209.14,3,1671,0,0,3,1671,1.713579000,0.1683
139.193.141.143,<->,18.51.113.202,3,1950,0,0,3,1950,1.712355000,0.1433
215.158.239.74,<->,100.216.78.145,3,3580,0,0,3,3580,1.704968000,0.2523
144.88.76.130,<->,53.231.73.123,3,1996,0,0,3,1996,1.703292000,0.1067
215.158.103.203,<->,54.69.96.25,3,311,0,0,3,311,1.696488000,0.1960
132.249.141.243,<->,8.52.178.109,0,0,3,1266,3,1266,1.694052000,0.2409
199.121.245.90,<->,136.25.188.225,0,0,3,1677,3,1677,1.692752000,0.1769
205.37.248.20,<->,136.25.189.82,0,0,3,1791,3,1791,1.691099000,0.2682
218.147.52.203,<->,8.176.58.168,0,0,3,1436,3,1436,1.684014000,0.0329
207.61.254.156,<->,136.25.188.178,0,0,3,752,3,752,1.679740000,0.2147
102.224.161.117,<->,89.90.112.31,3,1622,0,0,3,1622,1.678606000,0.1117
56.8.55.61,<->,8.183.25.25,0,0,3,803,3,803,1.678131000,0.2290
205.127.108.113,<->,33.233.141.66,0,0,3,1101,3,1101,1.676820000,0.2349
247.136.186.211,<->,100.230.5.11,3,2880,0,0,3,2880,1.671986000,0.0431
240.222.50.211,<->,0.195.210.46,0,0,3,2018,3,2018,1.670073000,0.2949
142.221.120.6,<->,136.25.188.225,0,0,3,1059,3,1059,1.669156000,0.3053
231.140.53.86,<->,215.158.239.95,0,0,3,1675,3,1675,1.668220000,0.3228
249.101.238.119,<->,111.20.62.72,3,1762,0,0,3,1762,1.667448000,0.0523
215.158.239.82,<->,80.57.141.131,3,814,0,0,3,814,1.662159000,0.1831
56.114.235.120,<->,35.56.101.154,0,0,3,1896,3,1896,1.659725000,0.1061
204.187.4.191,<->,136.25.188.176,0,0,3,1673,3,1673,1.656101000,0.1693
215.158.58.169,<->,6.73.247.119,0,0,3,4075,3,4075,1.652552000,0.1069
222.65.18.206,<->,132.128.61.54,3,1488,0,0,3,1488,1.651804000,0.3325
142.252.3.127,<->,136.25.188.199,0,0,3,1121,3,1121,1.650884000,0.3139
215.158.239.79,<->,199.20.5.204,3,1671,0,0,3,1671,1.643468000,0.2944
92.27.219.185,<->,54.46.22.61,3,616,0,0,3,616,1.641644000,0.2130
215.158.61.243,<->,8.176.8.249,0,0,3,2053,3,2053,1.641139000,0.3569
136.25.189.82,<->,29.209.59.172,3,1748,0,0,3,1748,1.634348000,0.1121
142.247.198.125,<->,136.25.188.242,0,0,3,1663,3,1663,1.630739000,0.3361
196.148.134.124,<->,144.83.112.139,3,353,0,0,3,353,1.629130000,0.0523
142.228.165.119,<->,136.25.188.253,0,0,3,1226,3,1226,1.627849000,0.2286
93.181.154.111,<->,92.27.219.197,0,0,3,154,3,154,1.627803000,0.3626
199.98.24.198,<->,8.252.222.179,0,0,3,1594,3,1594,1.626911000,0.1830
197.113.64.202,<->,136.25.188.53,0,0,3,1112,3,1112,1.626124000,0.2715
143.94.195.175,<->,136.25.188.174,0,0,3,1383,3,1383,1.624547000,0.3139
215.158.239.56,<->,196.168.46.78,3,752,0,0,3,752,1.619982000,0.2691
215.158.239.56,<->,195.54.40.211,3,1667,0,0,3,1667,1.617324000,0.1629
215.158.239.95,<->,145.13.164.194,3,3087,0,0,3,3087,1.615421000,0.1459
97.240.249.56,<->,97.126.28.102,0,0,3,209,3,209,1.604404000,0.0006
58.169.247.106,<->,0.195.210.42,0,0,3,1427,3,1427,1.603082000,0.2316
233.30.195.29,<->,8.20.87.187,0,0,3,676,3,676,1.594179000,0.1593
215.158.239.48,<->,196.88.42.114,3,1667,0,0,3,1667,1.591373000,0.2942
144.86.235.98,<->,17.61.199.251,3,352,0,0,3,352,1.590424000,0.0600
215.158.239.224,<->,192.226.44.117,3,735,0,0,3,735,1.589608000,0.3432
204.200.55.151,<->,136.25.188.178,0,0,3,1052,3,1052,1.587706000,0.1298
252.2.178.146,<->,92.27.219.178,0,0,3,836,3,836,1.587075000,0.1029
133.178.227.1,<->,133.56.180.40,3,3997,0,0,3,3997,1.587027000,0.2164
103.237.231.113,<->,8.52.185.185,0,0,3,881,3,881,1.586825000,0.1294
204.200.55.151,<->,136.25.188.255,0,0,3,1695,3,1695,1.585701000,0.1241
192.229.210.156,<->,50.55.217.174,3,926,0,0,3,926,1.584807000,0.0923
212.70.3.113,<->,136.25.188.178,0,0,3,1318,3,1318,1.584253000,0.3485
128.141.90.222,<->,0.195.210.42,0,0,3,809,3,809,1.583954000,0.2498
215.158.239.79,<->,199.122.172.88,3,1441,0,0,3,1441,1.583818000,0.3830
221.102.143.189,<->,192.65.21.248,0,0,3,2351,3,2351,1.582185000,0.1596
215.158.239.96,<->,196.89.113.76,3,1358,0,0,3,1358,1.581609000,0.4031
133.178.227.138,<->,8.191.15.138,3,1347,0,0,3,1347,1.581195000,0.0013
136.25.189.59,<->,80.56.79.90,3,4196,0,0,3,4196,1.579802000,0.4087
111.20.172.119,<->,33.233.141.27,0,0,3,3942,3,3942,1.579101000,0.0003
8.183.25.25,<->,6.133.204.253,3,832,0,0,3,832,1.573716000,0.4202
249.101.106.130,<->,53.214.109.118,3,1986,0,0,3,1986,1.572188000,0.4075
142.241.142.229,<->,136.25.188.174,0,0,3,1669,3,1669,1.570414000,0.3389
246.254.97.112,<->,53.214.86.130,3,1418,0,0,3,1418,1.568846000,0.2224
220.55.97.164,<->,111.151.237.44,3,3731,0,0,3,3731,1.565240000,0.0217
215.158.239.69,<->,207.166.98.166,3,1673,0,0,3,1673,1.565036000,0.3793
97.126.4.233,<->,54.53.182.18,3,1813,0,0,3,1813,1.563639000,0.2126
95.245.108.6,<->,8.252.221.236,0,0,3,1657,3,1657,1.563186000,0.3017
215.158.238.83,<->,111.150.186.251,3,2735,0,0,3,2735,1.563099000,0.3539
248.239.131.180,<->,8.45.168.98,3,1243,0,0,3,1243,1.559896000,0.3387
101.70.96.209,<->,54.42.178.167,3,449,0,0,3,449,1.559819000,0.0853
53.160.78.66,<->,48.54.99.153,0,0,3,2154,3,2154,1.558426000,0.3244
195.43.54.218,<->,136.25.188.198,0,0,3,1693,3,1693,1.557669000,0.3224
215.158.239.56,<->,199.20.6.208,3,1386,0,0,3,1386,1.556624000,0.3493
56.8.135.115,<->,8.182.139.168,0,0,3,521,3,521,1.556590000,0.0590
215.158.140.214,<->,113.23.83.164,3,4294,0,0,3,4294,1.556484000,0.1835
215.158.140.87,<->,132.213.244.180,3,1833,0,0,3,1833,1.556312000,0.1961
8.252.222.35,<->,8.219.184.146,3,4159,0,0,3,4159,1.556230000,0.0018
207.162.155.243,<->,8.182.138.83,0,0,3,1003,3,1003,1.553961000,0.2152
136.25.189.92,<->,98.219.126.140,3,2714,0,0,3,2714,1.552942000,0.2212
215.158.239.96,<->,196.168.46.78,3,752,0,0,3,752,1.551408000,0.2908
129.224.112.252,<->,97.242.126.186,3,296,0,0,3,296,1.549820000,0.2981
142.229.195.2,<->,136.25.188.222,0,0,3,1674,3,1674,1.548963000,0.2070
220.28.65.9,<->,215.158.238.69,0,0,3,2681,3,2681,1.548073000,0.3041
215.158.239.84,<->,195.42.14.160,3,1045,0,0,3,1045,1.547245000,0.2218
215.158.103.203,<->,41.137.75.125,3,1456,0,0,3,1456,1.541764000,0.1682
119.119.7.60,<->,0.195.210.46,0,0,3,1221,3,1221,1.541013000,0.0234
215.158.239.77,<->,142.255.141.124,3,1665,0,0,3,1665,1.540559000,0.2329
207.3.186.105,<->,8.52.178.37,0,0,3,993,3,993,1.537661000,0.3079
142.236.5.158,<->,136.25.188.174,0,0,3,1338,3,1338,1.536910000,0.1705
207.57.193.77,<->,136.25.188.220,0,0,3,1699,3,1699,1.536887000,0.2149
143.72.76.146,<->,136.25.188.198,0,0,3,1686,3,1686,1.534360000,0.2159
199.14.159.50,<->,136.25.188.227,0,0,3,1676,3,1676,1.533727000,0.1883
199.73.35.72,<->,136.25.188.253,0,0,3,1679,3,1679,1.531999000,0.1588
143.72.66.34,<->,136.25.188.239,0,0,3,1037,3,1037,1.531977000,0.2922
195.14.118.234,<->,136.25.188.252,0,0,3,1680,3,1680,1.531481000,0.1907
133.135.217.174,<->,129.6.83.11,0,0,3,747,3,747,1.530642000,0.0470
196.89.250.4,<->,136.25.188.209,0,0,3,1038,3,1038,1.525814000,0.2786
214.80.63.214,<->,139.163.66.167,0,0,3,1210,3,1210,1.525540000,0.1431
121.249.250.115,<->,92.27.219.18,0,0,3,402,3,402,1.523709000,0.0001
99.73.144.173,<->,98.57.212.245,3,2317,0,0,3,2317,1.523470000,0.1798
97.168.64.3,<->,54.55.198.23,3,1842,0,0,3,1842,1.520519000,0.2449
215.158.239.92,<->,199.20.29.151,3,1706,0,0,3,1706,1.518465000,0.3595
246.253.253.97,<->,111.151.239.191,3,2422,0,0,3,2422,1.517927000,0.0260
136.25.188.253,<->,97.233.59.95,3,1010,0,0,3,1010,1.517484000,0.1286
246.253.132.241,<->,119.231.234.34,3,298,0,0,3,298,1.515513000,0.0166
143.79.176.194,<->,136.25.188.236,0,0,3,693,3,693,1.513193000,0.1365
215.158.239.56,<->,199.14.155.81,3,1700,0,0,3,1700,1.512781000,0.3127
80.27.153.164,<->,74.182.187.210,3,1175,0,0,3,1175,1.512749000,0.2356
136.128.35.206,<->,8.176.8.87,0,0,3,472,3,472,1.511046000,0.0310
221.102.56.69,<->,98.128.231.37,0,0,3,882,3,882,1.509343000,0.2548
196.89.228.87,<->,136.25.188.255,0,0,3,1460,3,1460,1.502610000,0.2669
195.126.170.15,<->,136.25.188.45,0,0,3,1667,3,1667,1.502523000,0.1858
215.158.239.97,<->,196.92.132.96,3,431,0,0,3,431,1.500099000,0.1000
220.39.233.187,<->,133.178.226.37,0,0,3,2975,3,2975,1.497161000,0.3169
215.158.239.97,<->,195.81.3.132,3,1659,0,0,3,1659,1.496946000,0.3105
221.102.56.46,<->,109.0.228.33,0,0,3,974,3,974,1.491255000,0.0388
231.140.220.234,<->,136.25.188.178,0,0,3,1661,3,1661,1.490159000,0.2305
215.158.239.79,<->,199.50.121.111,3,1658,0,0,3,1658,1.490153000,0.3848
136.192.242.76,<->,8.182.251.218,0,0,3,400,3,400,1.489871000,0.3173
199.122.248.143,<->,136.25.188.222,0,0,3,1065,3,1065,1.489575000,0.3013
195.71.67.80,<->,136.25.188.209,0,0,3,320,3,320,1.489454000,0.4080
215.158.238.110,<->,100.224.166.163,3,1518,0,0,3,1518,1.488340000,0.4321
247.136.205.104,<->,136.152.86.129,3,1342,0,0,3,1342,1.488172000,0.1670
207.92.234.133,<->,8.182.253.169,0,0,3,1178,3,1178,1.488043000,0.3722
215.158.239.95,<->,207.60.47.4,3,1662,0,0,3,1662,1.485010000,0.3800
215.158.239.77,<->,204.227.193.143,3,1705,0,0,3,1705,1.484775000,0.1780
50.56.250.249,<->,8.52.154.216,0,0,3,1645,3,1645,1.483449000,0.1610
204.187.230.47,<->,136.25.188.225,0,0,3,1681,3,1681,1.479693000,0.4000
119.111.182.129,<->,101.224.206.46,0,0,3,615,3,615,1.478085000,0.2072
215.158.239.87,<->,199.20.30.2,3,1690,0,0,3,1690,1.476855000,0.2792
53.196.208.123,<->,8.228.213.135,0,0,3,310,3,310,1.475695000,0.3195
111.199.225.0,<->,0.195.210.44,0,0,3,383,3,383,1.474788000,0.1459
143.79.149.193,<->,136.25.188.210,0,0,3,1055,3,1055,1.471520000,0.2902
246.254.97.109,<->,117.194.179.115,3,2895,0,0,3,2895,1.469872000,0.1292
215.158.239.85,<->,204.0.178.84,3,1676,0,0,3,1676,1.468887000,0.5297
195.5.16.250,<->,136.25.188.208,0,0,3,1077,3,1077,1.466782000,0.3522
143.79.216.80,<->,136.25.188.176,0,0,3,1402,3,1402,1.464283000,0.2997
136.25.188.46,<->,122.159.245.144,3,3815,0,0,3,3815,1.463855000,0.4766
133.178.226.60,<->,29.211.6.53,3,3751,0,0,3,3751,1.462438000,0.5203
215.158.239.92,<->,195.55.190.198,3,708,0,0,3,708,1.461578000,0.4357
215.158.239.93,<->,199.20.28.18,3,1675,0,0,3,1675,1.461366000,0.2296
215.158.239.79,<->,142.252.141.153,3,1064,0,0,3,1064,1.461365000,0.1644
136.25.189.33,<->,57.227.81.41,3,1791,0,0,3,1791,1.460062000,0.1997
129.236.114.39,<->,33.233.141.11,0,0,3,718,3,718,1.459994000,0.0002
136.25.188.223,<->,131.173.115.91,3,1855,0,0,3,1855,1.459346000,0.2476
129.95.133.231,<->,8.193.83.40,0,0,3,1208,3,1208,1.458623000,0.0433
142.229.179.113,<->,136.25.188.163,0,0,3,1675,3,1675,1.453800000,0.2331
215.158.238.104,<->,80.47.111.27,3,3895,0,0,3,3895,1.452360000,0.3476
153.245.144.109,<->,80.27.154.138,0,0,3,1107,3,1107,1.450848000,0.1730
135.243.190.251,<->,8.220.176.253,0,0,3,1192,3,1192,1.449725000,0.5301
195.55.213.173,<->,136.25.188.176,0,0,3,1263,3,1263,1.448571000,0.1569
142.247.202.219,<->,136.25.188.198,0,0,3,1674,3,1674,1.448363000,0.3261
136.25.188.192,<->,96.156.169.173,3,1551,0,0,3,1551,1.448254000,0.5493
142.252.66.180,<->,136.25.188.176,0,0,3,1674,3,1674,1.447417000,0.2098
215.158.239.67,<->,80.57.141.205,3,598,0,0,3,598,1.446379000,0.0794
17.12.130.178,<->,8.220.179.115,0,0,3,1395,3,1395,1.444100000,0.5050
143.10.30.30,<->,136.25.188.227,0,0,3,1671,3,1671,1.443289000,0.3775
215.158.140.167,<->,6.25.170.27,3,1183,0,0,3,1183,1.442711000,0.1771
142.206.27.11,<->,136.25.188.55,0,0,3,698,3,698,1.441251000,0.0128
195.5.151.25,<->,136.25.188.252,0,0,3,1491,3,1491,1.441118000,0.1377
60.100.46.134,<->,8.252.221.236,0,0,3,1649,3,1649,1.439076000,0.3684
98.156.229.198,<->,8.183.25.25,0,0,3,864,3,864,1.438230000,0.0939
144.83.115.202,<->,98.236.251.68,0,0,3,317,3,317,1.438136000,0.1209
109.127.101.19,<->,8.176.8.206,0,0,3,2711,3,2711,1.436690000,0.3394
99.162.77.146,<->,53.161.183.246,3,555,0,0,3,555,1.435614000,0.3389
215.158.239.94,<->,199.20.28.182,3,1856,0,0,3,1856,1.434400000,0.0501
136.25.189.53,<->,96.156.169.224,3,1710,0,0,3,1710,1.433953000,0.2931
215.158.239.96,<->,196.106.141.2,3,1677,0,0,3,1677,1.433619000,0.3392
142.236.202.155,<->,136.25.188.177,0,0,3,1106,3,1106,1.431611000,0.2038
215.158.140.165,<->,8.222.7.187,3,3089,0,0,3,3089,1.431591000,0.5541
195.6.239.139,<->,136.25.188.222,0,0,3,1674,3,1674,1.430753000,0.2260
215.158.239.92,<->,196.0.151.223,3,1786,0,0,3,1786,1.427483000,0.4010
215.158.30.219,<->,8.252.222.34,0,0,3,1782,3,1782,1.427446000,0.4328
132.249.141.207,<->,8.52.182.30,0,0,3,897,3,897,1.426516000,0.1577
207.60.106.93,<->,136.25.188.224,0,0,3,1176,3,1176,1.426333000,0.4563
195.6.133.76,<->,136.25.188.46,0,0,3,1675,3,1675,1.426252000,0.2052
215.158.140.87,<->,137.46.173.232,3,1051,0,0,3,1051,1.425710000,0.2506
215.158.239.51,<->,199.20.4.30,3,1703,0,0,3,1703,1.422089000,0.3132
215.158.238.142,<->,126.219.132.237,3,3943,0,0,3,3943,1.420740000,0.4739
140.78.204.46,<->,0.195.210.8,0,0,3,1061,3,1061,1.418465000,0.2419
142.229.12.248,<->,136.25.188.163,0,0,3,1705,3,1705,1.418098000,0.3286
133.54.43.44,<->,126.82.157.67,3,837,0,0,3,837,1.416110000,0.1675
223.120.87.179,<->,8.252.222.159,0,0,3,1682,3,1682,1.416099000,0.1602
97.203.33.81,<->,8.183.25.124,0,0,3,1129,3,1129,1.415370000,0.1140
144.83.112.139,<->,50.224.108.188,0,0,3,317,3,317,1.413514000,0.0459
136.18.231.246,<->,8.182.226.78,0,0,3,1541,3,1541,1.409487000,0.3085
142.228.165.122,<->,136.25.188.209,0,0,3,1227,3,1227,1.409465000,0.5049
194.233.57.116,<->,136.25.188.255,0,0,3,1678,3,1678,1.409410000,0.4408
131.45.239.182,<->,92.162.253.141,0,0,3,967,3,967,1.406440000,0.1206
136.25.189.202,<->,129.222.39.208,3,1868,0,0,3,1868,1.406090000,0.0955
215.158.239.58,<->,195.49.202.115,3,1681,0,0,3,1681,1.403812000,0.3698
61.111.29.59,<->,8.252.222.38,0,0,3,1615,3,1615,1.400676000,0.1922
231.142.43.110,<->,215.158.239.78,0,0,3,1801,3,1801,1.400267000,0.3481
50.51.215.141,<->,8.52.168.247,0,0,3,647,3,647,1.398390000,0.0935
139.163.26.146,<->,137.167.73.77,3,882,0,0,3,882,1.398290000,0.0483
139.163.16.203,<->,50.56.118.190,3,1664,0,0,3,1664,1.396246000,0.1799
233.97.213.17,<->,129.6.83.11,0,0,3,747,3,747,1.394962000,0.1791
207.57.68.206,<->,136.25.188.255,0,0,3,1848,3,1848,1.391012000,0.3299
207.61.130.166,<->,136.25.188.237,0,0,3,1656,3,1656,1.387792000,0.2097
215.158.239.49,<->,207.166.104.125,3,1054,0,0,3,1054,1.386023000,0.4593
136.25.188.229,<->,80.57.141.175,3,2766,0,0,3,2766,1.381689000,0.0788
136.25.189.15,<->,29.209.59.245,3,3943,0,0,3,3943,1.380557000,0.4451
139.33.175.144,<->,8.30.98.249,0,0,3,2888,3,2888,1.379475000,0.0729
215.158.239.85,<->,199.20.4.62,3,1672,0,0,3,1672,1.378887000,0.4795
91.250.161.24,<->,0.195.210.42,0,0,3,1136,3,1136,1.378246000,0.3946
133.178.227.247,<->,8.42.64.172,3,1375,0,0,3,1375,1.377321000,0.0399
232.31.72.55,<->,111.147.205.186,0,0,3,1224,3,1224,1.377303000,0.6157
216.184.1.109,<->,8.252.222.144,0,0,3,1870,3,1870,1.375636000,0.1238
215.158.239.56,<->,199.33.137.8,3,1657,0,0,3,1657,1.369750000,0.2548
215.158.239.56,<->,199.20.31.142,3,1570,0,0,3,1570,1.369142000,0.2000
96.58.68.79,<->,8.220.178.166,0,0,3,1679,3,1679,1.368436000,0.0229
136.25.188.213,<->,80.57.141.206,3,1542,0,0,3,1542,1.363957000,0.1479
195.127.234.229,<->,8.52.250.9,0,0,3,1447,3,1447,1.358382000,0.5298
197.106.84.211,<->,8.182.248.147,0,0,3,647,3,647,1.357230000,0.5609
215.158.239.95,<->,204.226.116.98,3,1045,0,0,3,1045,1.355535000,0.2662
8.55.195.24,<->,6.138.239.59,0,0,3,1135,3,1135,1.353815000,0.1621
207.58.116.86,<->,136.25.188.209,0,0,3,1694,3,1694,1.353158000,0.3137
215.158.239.51,<->,207.228.238.180,3,1120,0,0,3,1120,1.352528000,0.3597
215.158.140.205,<->,8.222.7.186,3,3200,0,0,3,3200,1.352238000,0.2422
89.204.235.110,<->,50.224.91.34,0,0,3,1486,3,1486,1.351259000,0.0504
215.158.140.87,<->,83.226.246.109,3,1242,0,0,3,1242,1.351080000,0.2061
8.52.180.162,<->,6.228.47.149,3,1376,0,0,3,1376,1.351065000,0.4159
215.158.238.241,<->,8.219.184.121,3,3977,0,0,3,3977,1.350406000,0.4094
199.14.202.207,<->,136.25.188.255,0,0,3,1669,3,1669,1.347909000,0.1907
111.20.172.118,<->,33.233.141.34,0,0,3,2596,3,2596,1.347293000,0.2311
126.113.19.141,<->,109.222.250.46,0,0,3,580,3,580,1.345161000,0.3511
197.113.64.188,<->,136.25.188.237,0,0,3,1124,3,1124,1.338004000,0.3505
143.135.7.4,<->,136.25.188.198,0,0,3,1676,3,1676,1.337528000,0.2780
220.28.104.193,<->,215.158.238.125,0,0,3,3257,3,3257,1.336911000,0.3592
50.49.114.191,<->,8.52.181.95,0,0,3,865,3,865,1.330014000,0.4483
142.244.204.243,<->,136.25.188.178,0,0,3,1670,3,1670,1.327363000,0.2849
245.227.234.55,<->,8.182.224.248,0,0,3,766,3,766,1.325594000,0.3161
207.58.248.0,<->,136.25.188.253,0,0,3,1670,3,1670,1.325216000,0.3161
215.158.239.84,<->,199.20.7.200,3,1710,0,0,3,1710,1.324346000,0.2479
207.21.2.14,<->,8.252.222.23,0,0,3,1672,3,1672,1.324296000,0.1752
215.158.239.95,<->,199.20.29.86,3,1684,0,0,3,1684,1.323916000,0.3085
215.158.239.56,<->,199.15.113.204,3,1657,0,0,3,1657,1.323728000,0.2082
207.56.100.244,<->,136.25.188.222,0,0,3,1665,3,1665,1.320564000,0.3307
143.132.177.31,<->,136.25.188.173,0,0,3,1703,3,1703,1.318904000,0.1912
195.125.44.203,<->,136.25.188.252,0,0,3,1031,3,1031,1.318397000,0.2163
215.158.140.185,<->,8.222.7.155,3,2968,0,0,3,2968,1.316337000,0.2325
204.58.127.65,<->,136.25.188.198,0,0,3,1705,3,1705,1.315129000,0.2126
215.158.61.189,<->,136.25.188.36,0,0,3,1455,3,1455,1.314929000,0.3518
143.129.49.132,<->,136.25.188.253,0,0,3,1676,3,1676,1.314434000,0.2059
142.208.195.1,<->,136.25.188.175,0,0,3,1057,3,1057,1.313714000,0.3188
195.69.146.135,<->,136.25.188.163,0,0,3,1665,3,1665,1.313649000,0.1715
135.253.11.54,<->,133.178.226.19,0,0,3,535,3,535,1.312306000,0.2912
143.129.165.227,<->,136.25.188.176,0,0,3,1669,3,1669,1.311016000,0.2102
215.158.238.144,<->,139.163.161.32,3,1517,0,0,3,1517,1.307529000,0.3184
142.248.167.39,<->,136.25.188.252,0,0,3,1665,3,1665,1.306296000,0.2129
215.158.239.56,<->,207.188.175.220,3,1868,0,0,3,1868,1.304902000,0.3498
215.158.239.58,<->,199.72.194.10,3,1657,0,0,3,1657,1.302905000,0.1974
17.125.125.157,<->,8.52.182.237,0,0,3,2759,3,2759,1.302655000,0.5920
139.36.120.118,<->,8.176.8.80,0,0,3,423,3,423,1.301738000,0.0190
215.158.239.92,<->,196.91.200.82,3,1717,0,0,3,1717,1.301096000,0.4398
215.158.239.79,<->,199.20.28.202,3,1820,0,0,3,1820,1.300867000,0.6900
139.193.141.139,<->,50.149.195.148,3,738,0,0,3,738,1.299360000,0.0588
136.18.143.186,<->,8.183.25.124,0,0,3,1343,3,1343,1.298058000,0.0434
215.158.239.85,<->,196.104.123.133,3,1676,0,0,3,1676,1.297918000,0.6900
194.232.225.22,<->,136.25.188.238,0,0,3,1037,3,1037,1.297408000,0.5327
215.158.239.78,<->,207.59.13.77,3,1675,0,0,3,1675,1.294487000,0.2777
195.42.100.56,<->,136.25.188.174,0,0,3,1028,3,1028,1.293251000,0.2841
199.73.39.223,<->,136.25.188.55,0,0,3,944,3,944,1.290563000,0.0530
136.25.189.53,<->,96.156.169.209,3,3238,0,0,3,3238,1.288134000,0.3663
124.41.84.151,<->,92.162.253.148,0,0,3,1239,3,1239,1.287095000,0.1321
246.253.132.235,<->,30.199.161.104,3,314,0,0,3,314,1.285687000,0.0440
215.158.239.84,<->,199.20.5.105,3,1679,0,0,3,1679,1.283863000,0.3992
199.51.122.249,<->,136.25.188.238,0,0,3,1262,3,1262,1.281273000,0.2402
215.158.239.76,<->,199.52.40.31,3,1670,0,0,3,1670,1.280669000,0.2166
90.240.204.138,<->,54.37.53.245,3,3522,0,0,3,3522,1.279542000,0.5439
221.101.9.15,<->,136.128.112.242,3,503,0,0,3,503,1.279105000,0.1205
215.158.30.218,<->,8.252.222.59,0,0,3,1326,3,1326,1.278789000,0.1941
200.19.78.155,<->,0.195.210.42,0,0,3,579,3,579,1.275974000,0.5803
111.14.241.152,<->,8.183.25.124,0,0,3,1209,3,1209,1.275898000,0.1635
143.128.61.200,<->,136.25.188.236,0,0,3,1700,3,1700,1.274330000,0.2186
138.90.73.184,<->,133.32.39.1,0,0,3,564,3,564,1.274124000,0.0603
136.25.188.33,<->,91.42.112.172,3,2637,0,0,3,2637,1.272066000,0.6808
207.239.68.181,<->,136.25.188.220,0,0,3,1058,3,1058,1.271675000,0.4358
248.225.27.2,<->,159.28.252.223,3,269,0,0,3,269,1.270354000,0.0000
133.178.227.57,<->,38.104.11.118,3,3306,0,0,3,3306,1.266523000,0.5521
215.158.238.132,<->,104.3.163.55,3,4087,0,0,3,4087,1.259660000,0.6499
215.158.239.93,<->,142.207.222.204,3,1847,0,0,3,1847,1.259384000,0.5406
215.158.239.70,<->,199.20.28.92,3,1749,0,0,3,1749,1.258699000,0.4994
195.15.145.21,<->,136.25.188.178,0,0,3,877,3,877,1.258691000,0.7194
8.183.25.25,<->,6.33.17.20,3,862,0,0,3,862,1.257514000,0.2722
133.54.43.75,<->,117.6.238.227,3,1644,0,0,3,1644,1.257319000,0.0051
132.168.197.211,<->,109.108.154.250,3,699,0,0,3,699,1.255229000,0.0560
143.42.211.228,<->,136.25.188.198,0,0,3,752,3,752,1.254752000,0.2190
92.162.253.44,<->,33.235.244.154,3,1855,0,0,3,1855,1.251412000,0.2113
136.25.188.174,<->,4.233.73.83,3,1823,0,0,3,1823,1.248170000,0.0105
142.228.131.170,<->,136.25.188.220,0,0,3,1672,3,1672,1.247560000,0.2159
136.25.188.238,<->,17.143.215.251,3,1987,0,0,3,1987,1.247482000,0.6839
8.182.136.169,<->,6.133.233.121,3,1098,0,0,3,1098,1.247067000,0.1237
53.243.12.192,<->,48.52.197.136,0,0,3,4351,3,4351,1.246737000,0.7079
215.158.238.135,<->,131.144.113.168,3,3783,0,0,3,3783,1.241419000,0.6565
215.110.27.80,<->,8.220.178.166,0,0,3,1511,3,1511,1.241354000,0.0935
89.155.243.15,<->,50.224.89.243,0,0,3,910,3,910,1.240159000,0.0806
230.60.6.184,<->,92.181.100.74,0,0,3,326,3,326,1.239945000,0.5936
142.223.153.139,<->,136.25.188.160,0,0,3,1071,3,1071,1.236891000,0.0326
215.158.238.73,<->,80.47.111.91,3,3847,0,0,3,3847,1.236267000,0.7074
143.53.114.13,<->,136.25.188.227,0,0,3,765,3,765,1.235381000,0.2043
109.222.206.118,<->,53.209.197.220,3,1673,0,0,3,1673,1.232128000,0.2603
136.138.112.219,<->,133.178.226.18,0,0,3,3671,3,3671,1.231089000,0.7002
215.158.239.1,<->,96.135.154.141,3,3734,0,0,3,3734,1.227359000,0.0002
215.158.238.139,<->,139.163.161.34,3,1517,0,0,3,1517,1.226988000,0.5023
192.67.163.217,<->,146.234.133.196,3,1930,0,0,3,1930,1.226216000,0.3914
142.236.234.77,<->,136.25.188.175,0,0,3,1655,3,1655,1.223909000,0.4005
192.64.131.210,<->,159.23.224.231,0,0,3,156,3,156,1.221786000,0.4021
215.158.239.58,<->,199.20.28.23,3,1688,0,0,3,1688,1.221097000,0.2201
215.158.239.96,<->,143.79.208.138,3,935,0,0,3,935,1.220698000,0.2229
215.158.239.76,<->,195.71.91.68,3,2403,0,0,3,2403,1.220097000,0.1859
138.79.143.196,<->,111.146.147.152,0,0,3,539,3,539,1.219245000,0.6186
215.158.239.49,<->,195.49.65.139,3,1842,0,0,3,1842,1.218915000,0.0001
204.187.230.96,<->,136.25.188.176,0,0,3,1697,3,1697,1.217806000,0.1900
141.118.203.106,<->,8.252.221.236,0,0,3,1426,3,1426,1.214615000,0.6966
142.206.31.176,<->,136.25.188.209,0,0,3,1668,3,1668,1.214431000,0.2245
101.70.127.229,<->,54.50.224.229,3,2217,0,0,3,2217,1.213826000,0.4285
142.255.40.123,<->,136.25.188.227,0,0,3,1053,3,1053,1.213247000,0.4401
136.25.188.47,<->,29.214.108.64,3,3911,0,0,3,3911,1.211613000,0.6959
129.104.156.61,<->,8.52.178.59,0,0,3,722,3,722,1.210763000,0.3492
196.112.115.171,<->,0.195.210.46,0,0,3,1439,3,1439,1.207432000,0.4099
215.158.239.99,<->,195.83.168.95,3,1014,0,0,3,1014,1.206309000,0.4588
142.228.58.200,<->,136.25.188.222,0,0,3,1080,3,1080,1.204832000,0.6196
197.113.99.161,<->,136.25.188.225,0,0,3,281,3,281,1.204494000,0.1836
215.158.239.70,<->,207.236.179.176,3,1114,0,0,3,1114,1.204253000,0.2240
215.158.239.58,<->,196.104.226.179,3,1162,0,0,3,1162,1.204100000,0.2015
143.89.245.183,<->,136.25.188.163,0,0,3,1664,3,1664,1.203721000,0.1574
215.158.239.49,<->,207.191.228.135,3,1668,0,0,3,1668,1.201756000,0.3446
215.158.239.48,<->,199.106.16.251,3,1300,0,0,3,1300,1.201454000,0.3492
207.191.158.193,<->,136.25.188.163,0,0,3,1675,3,1675,1.197951000,0.3325
147.58.211.46,<->,8.252.221.217,0,0,3,2427,3,2427,1.197830000,0.0000
215.158.61.191,<->,8.176.8.238,0,0,3,2596,3,2596,1.196232000,0.6670
215.158.239.49,<->,204.21.11.235,3,1674,0,0,3,1674,1.192939000,0.1929
133.178.226.3,<->,100.120.38.6,3,2247,0,0,3,2247,1.192652000,0.0002
215.158.49.22,<->,136.116.28.228,0,0,3,3525,3,3525,1.191995000,0.0084
249.101.227.124,<->,98.57.212.245,3,981,0,0,3,981,1.191200000,0.0991
215.158.239.77,<->,199.20.29.26,3,1672,0,0,3,1672,1.191045000,0.2797
215.158.239.56,<->,195.55.212.4,3,1053,0,0,3,1053,1.189719000,0.3962
215.158.239.87,<->,204.21.96.63,3,1027,0,0,3,1027,1.189689000,0.1676
215.158.239.97,<->,199.80.212.113,3,1179,0,0,3,1179,1.188865000,0.7456
207.58.113.81,<->,136.25.188.177,0,0,3,1132,3,1132,1.188811000,0.7504
215.158.239.97,<->,143.42.79.210,3,1612,0,0,3,1612,1.188704000,0.4179
207.60.199.109,<->,136.25.188.174,0,0,3,912,3,912,1.188030000,0.0459
220.28.73.211,<->,215.158.238.137,0,0,3,937,3,937,1.187400000,0.7058
215.158.239.87,<->,194.237.195.187,3,1658,0,0,3,1658,1.187232000,0.3671
136.139.59.106,<->,136.25.188.255,0,0,3,1619,3,1619,1.186439000,0.2229
207.62.18.101,<->,136.25.188.241,0,0,3,1697,3,1697,1.186003000,0.4901
207.236.196.98,<->,136.25.188.225,0,0,3,1081,3,1081,1.185884000,0.0049
221.102.56.69,<->,102.83.11.76,0,0,3,882,3,882,1.185460000,0.4369
215.158.239.48,<->,143.132.73.27,3,1633,0,0,3,1633,1.185136000,0.2892
100.94.152.199,<->,89.155.61.122,3,1269,0,0,3,1269,1.183642000,0.1451
69.128.138.177,<->,53.201.72.62,3,2154,0,0,3,2154,1.183615000,0.4374
95.245.224.255,<->,0.195.210.42,0,0,3,1332,3,1332,1.183447000,0.1463
133.178.226.90,<->,112.235.95.27,3,4263,0,0,3,4263,1.182735000,0.7884
17.204.222.243,<->,8.220.177.212,0,0,3,1117,3,1117,1.180254000,0.1796
207.172.233.228,<->,136.25.188.253,0,0,3,912,3,912,1.180162000,0.4202
195.55.30.239,<->,136.25.188.173,0,0,3,1151,3,1151,1.179521000,0.5569
142.229.35.114,<->,136.25.188.222,0,0,3,989,3,989,1.178423000,0.6268
215.158.239.97,<->,142.236.227.239,3,1243,0,0,3,1243,1.177474000,0.5180
215.158.239.78,<->,196.89.91.240,3,1350,0,0,3,1350,1.176823000,0.8084
215.158.239.92,<->,199.20.31.236,3,1670,0,0,3,1670,1.175762000,0.5086
50.224.80.67,<->,27.2.162.82,3,848,0,0,3,848,1.175336000,0.1560
215.158.239.92,<->,199.52.40.31,3,1704,0,0,3,1704,1.173061000,0.2208
199.82.180.205,<->,136.25.188.163,0,0,3,1665,3,1665,1.172887000,0.1962
215.158.239.58,<->,196.106.51.196,3,1660,0,0,3,1660,1.170480000,0.2996
195.126.153.13,<->,136.25.188.52,0,0,3,1056,3,1056,1.168363000,0.7777
215.158.239.95,<->,142.237.138.17,3,544,0,0,3,544,1.165669000,0.2228
215.158.239.85,<->,204.58.251.144,3,1579,0,0,3,1579,1.165237000,0.1744
143.53.82.167,<->,136.25.188.253,0,0,3,1170,3,1170,1.164315000,0.4750
215.158.239.50,<->,199.80.212.221,3,1677,0,0,3,1677,1.161950000,0.2117
215.158.239.56,<->,199.14.14.243,3,1649,0,0,3,1649,1.158242000,0.2653
17.255.114.134,<->,8.220.188.158,0,0,3,1083,3,1083,1.155357000,0.1126
215.158.239.48,<->,199.20.5.51,3,1975,0,0,3,1975,1.155339000,0.8137
215.158.239.56,<->,196.106.249.180,3,1698,0,0,3,1698,1.153778000,0.3698
142.190.18.27,<->,136.25.188.209,0,0,3,1658,3,1658,1.153312000,0.3139
215.158.239.57,<->,142.221.134.198,3,1465,0,0,3,1465,1.153282000,0.2352
136.25.189.41,<->,96.156.169.207,3,2339,0,0,3,2339,1.151400000,0.0371
195.7.77.1,<->,136.25.188.197,0,0,3,2300,3,2300,1.151385000,0.6550
200.174.198.138,<->,53.231.94.127,3,1846,0,0,3,1846,1.150917000,0.6233
207.60.111.65,<->,136.25.188.177,0,0,3,1404,3,1404,1.150443000,0.5372
202.33.102.175,<->,136.25.188.240,0,0,3,980,3,980,1.150313000,0.5259
207.56.138.208,<->,136.25.188.173,0,0,3,1639,3,1639,1.150020000,0.2588
133.178.227.2,<->,133.56.180.15,3,3887,0,0,3,3887,1.149891000,0.8003
215.158.239.56,<->,199.20.30.216,3,1017,0,0,3,1017,1.149241000,0.3807
194.237.11.0,<->,136.25.188.55,0,0,3,1227,3,1227,1.147075000,0.4464
142.255.20.192,<->,136.25.188.44,0,0,3,1227,3,1227,1.146469000,0.4982
215.158.239.95,<->,199.20.31.127,3,1686,0,0,3,1686,1.146043000,0.2996
231.142.242.193,<->,215.158.239.96,0,0,3,1697,3,1697,1.143329000,0.3444
215.158.239.49,<->,199.20.5.88,3,1705,0,0,3,1705,1.138939000,0.2704
215.158.239.95,<->,199.20.28.170,3,1677,0,0,3,1677,1.138460000,0.4296
215.158.239.40,<->,122.158.53.55,3,3018,0,0,3,3018,1.136940000,0.5853
136.25.189.15,<->,96.135.155.31,3,3927,0,0,3,3927,1.133719000,0.4899
215.158.239.56,<->,142.254.254.20,3,1656,0,0,3,1656,1.133484000,0.1249
58.60.45.79,<->,8.252.222.172,0,0,3,1626,3,1626,1.132693000,0.1771
215.158.238.33,<->,112.220.206.126,3,3911,0,0,3,3911,1.131520000,0.7758
199.111.103.209,<->,8.182.239.190,0,0,3,1219,3,1219,1.129391000,0.1527
207.60.161.220,<->,136.25.188.252,0,0,3,1008,3,1008,1.127334000,0.4575
142.247.209.45,<->,136.25.188.243,0,0,3,1385,3,1385,1.127261000,0.5229
196.247.115.39,<->,136.25.188.176,0,0,3,1211,3,1211,1.126220000,0.5247
203.114.88.175,<->,136.25.188.162,0,0,3,2343,3,2343,1.125935000,0.6801
136.25.189.59,<->,56.28.207.200,3,2911,0,0,3,2911,1.124785000,0.4606
195.13.251.5,<->,136.25.188.220,0,0,3,320,3,320,1.124755000,0.5019
144.232.207.109,<->,8.252.221.171,0,0,3,1926,3,1926,1.123862000,0.2569
215.158.239.95,<->,143.13.237.202,3,1041,0,0,3,1041,1.123781000,0.2181
196.233.198.226,<->,8.182.226.78,0,0,3,2014,3,2014,1.123425000,0.1705
142.253.114.3,<->,136.25.188.177,0,0,3,544,3,544,1.121968000,0.4014
144.86.149.46,<->,35.56.3.196,3,1668,0,0,3,1668,1.121360000,0.8093
215.158.238.82,<->,112.220.206.18,3,3559,0,0,3,3559,1.120277000,0.6202
215.158.238.252,<->,215.158.43.40,3,1866,0,0,3,1866,1.119888000,0.0798
207.60.43.197,<->,136.25.188.198,0,0,3,1048,3,1048,1.117978000,0.2840
221.196.123.29,<->,136.25.188.226,0,0,3,879,3,879,1.117105000,0.7297
133.178.226.224,<->,106.188.254.181,3,1766,0,0,3,1766,1.115727000,0.3828
215.158.239.87,<->,143.129.189.188,3,1669,0,0,3,1669,1.113158000,0.2087
215.158.239.97,<->,195.83.176.83,3,1678,0,0,3,1678,1.111702000,0.3685
215.158.239.56,<->,199.72.175.74,3,1131,0,0,3,1131,1.109033000,0.4162
137.44.173.220,<->,100.228.42.166,0,0,3,809,3,809,1.108673000,0.0654
142.236.96.13,<->,136.25.188.252,0,0,3,1675,3,1675,1.108365000,0.1887
215.158.239.56,<->,194.199.209.221,3,1083,0,0,3,1083,1.107352000,0.1665
220.28.114.28,<->,133.178.227.73,0,0,3,3851,3,3851,1.106685000,0.8379
109.222.233.60,<->,54.37.85.146,3,1064,0,0,3,1064,1.106222000,0.2323
195.70.195.205,<->,136.25.188.239,0,0,3,1195,3,1195,1.106192000,0.5500
143.20.132.182,<->,136.25.188.44,0,0,3,834,3,834,1.105253000,0.3592
215.158.239.92,<->,207.239.52.13,3,1061,0,0,3,1061,1.105180000,0.1906
196.89.219.234,<->,136.25.188.163,0,0,3,1663,3,1663,1.105072000,0.2128
101.238.103.86,<->,8.49.69.111,3,1532,0,0,3,1532,1.105040000,0.0822
98.230.219.13,<->,8.182.224.248,0,0,3,782,3,782,1.104945000,0.0610
215.158.61.182,<->,8.176.8.195,0,0,3,1831,3,1831,1.104628000,0.8060
215.158.239.94,<->,196.94.187.62,3,1663,0,0,3,1663,1.102629000,0.3699
196.89.182.152,<->,136.25.188.242,0,0,3,1104,3,1104,1.101364000,0.2814
215.158.239.51,<->,199.20.122.136,3,1029,0,0,3,1029,1.100948000,0.1673
215.158.239.87,<->,204.226.3.45,3,1626,0,0,3,1626,1.099131000,0.3115
215.158.140.229,<->,195.65.1.168,3,3479,0,0,3,3479,1.098432000,0.8477
139.163.5.140,<->,105.131.197.161,3,492,0,0,3,492,1.097306000,0.2739
215.158.239.66,<->,100.224.166.161,3,3037,0,0,3,3037,1.096691000,0.6839
215.158.239.77,<->,199.20.31.198,3,1068,0,0,3,1068,1.096613000,0.2791
199.80.188.86,<->,136.25.188.173,0,0,3,1669,3,1669,1.095398000,0.2150
138.4.84.225,<->,54.69.65.183,3,969,0,0,3,969,1.094797000,0.7025
215.158.239.57,<->,195.15.186.62,3,1670,0,0,3,1670,1.094204000,0.1648
196.247.119.116,<->,136.25.188.174,0,0,3,1227,3,1227,1.093600000,0.5077
142.240.62.162,<->,136.25.188.252,0,0,3,1676,3,1676,1.093370000,0.2580
215.158.238.135,<->,80.47.111.87,3,1512,0,0,3,1512,1.088735000,0.5296
143.68.157.101,<->,136.25.188.238,0,0,3,1053,3,1053,1.087777000,0.4145
136.25.188.255,<->,67.0.40.34,3,1867,0,0,3,1867,1.087699000,0.5653
199.98.18.235,<->,8.252.222.176,0,0,3,998,3,998,1.087652000,0.3863
80.28.254.2,<->,8.52.243.38,0,0,3,1154,3,1154,1.084674000,0.0362
195.14.76.224,<->,136.25.188.208,0,0,3,968,3,968,1.083984000,0.1708
215.158.238.120,<->,131.144.113.193,3,3879,0,0,3,3879,1.082793000,0.7588
143.53.129.99,<->,136.25.188.54,0,0,3,1369,3,1369,1.082397000,0.8332
143.20.132.182,<->,136.25.188.196,0,0,3,834,3,834,1.081388000,0.3109
221.102.121.97,<->,98.230.207.210,3,1331,0,0,3,1331,1.080459000,0.1006
215.158.239.76,<->,199.20.5.88,3,1675,0,0,3,1675,1.076951000,0.2814
132.119.136.62,<->,8.31.37.175,0,0,3,1144,3,1144,1.076889000,0.0586
143.52.27.249,<->,136.25.188.222,0,0,3,1674,3,1674,1.075895000,0.2196
136.25.188.162,<->,91.57.173.38,3,3943,0,0,3,3943,1.075389000,0.5781
207.92.48.95,<->,8.182.248.147,0,0,3,647,3,647,1.074574000,0.3358
136.25.189.41,<->,96.156.169.205,3,919,0,0,3,919,1.073393000,0.3907
132.168.198.53,<->,53.149.113.147,3,953,0,0,3,953,1.070939000,0.1166
142.209.125.133,<->,136.25.188.222,0,0,3,1725,3,1725,1.070799000,0.2808
215.158.239.58,<->,207.61.34.5,3,1056,0,0,3,1056,1.070772000,0.8365
215.158.239.78,<->,196.108.19.79,3,2066,0,0,3,2066,1.069033000,0.0003
8.252.223.153,<->,8.219.185.43,3,3609,0,0,3,3609,1.068204000,0.7897
142.208.172.186,<->,136.25.188.253,0,0,3,1677,3,1677,1.067994000,0.2109
215.158.239.82,<->,80.57.141.206,3,1414,0,0,3,1414,1.067820000,0.1032
133.178.226.95,<->,0.195.253.228,3,3477,0,0,3,3477,1.067499000,0.5588
215.158.239.77,<->,143.129.23.71,3,1179,0,0,3,1179,1.065590000,0.2973
215.158.239.77,<->,143.129.21.247,3,1557,0,0,3,1557,1.065502000,0.2187
133.178.226.60,<->,57.210.107.27,3,3751,0,0,3,3751,1.064772000,0.7932
199.70.36.204,<->,136.25.188.52,0,0,3,1086,3,1086,1.064495000,0.2749
221.102.56.69,<->,98.128.75.116,0,0,3,882,3,882,1.063243000,0.5704
207.173.234.116,<->,136.25.188.198,0,0,3,1699,3,1699,1.063160000,0.2096
142.228.58.200,<->,136.25.188.198,0,0,3,1080,3,1080,1.062987000,0.8406
215.158.239.85,<->,195.126.100.110,3,1221,0,0,3,1221,1.062715000,0.6281
215.158.239.46,<->,100.224.202.179,3,1727,0,0,3,1727,1.061706000,0.7317
220.50.242.215,<->,136.25.189.195,0,0,3,1819,3,1819,1.060840000,0.0252
215.158.239.94,<->,199.20.29.173,3,1663,0,0,3,1663,1.060216000,0.3196
196.88.183.93,<->,136.25.188.220,0,0,3,1195,3,1195,1.057377000,0.5152
133.32.39.9,<->,29.209.14.231,3,852,0,0,3,852,1.057000000,0.7510
195.13.141.187,<->,136.25.188.242,0,0,3,285,3,285,1.056241000,0.0505
195.70.152.61,<->,136.25.188.220,0,0,3,1268,3,1268,1.055940000,0.6120
215.158.239.76,<->,199.20.4.7,3,1227,0,0,3,1227,1.054169000,0.5295
220.28.108.254,<->,136.25.189.94,0,0,3,611,3,611,1.052392000,0.0608
136.25.189.14,<->,29.211.228.251,3,3847,0,0,3,3847,1.051985000,0.3957
142.249.245.193,<->,136.25.188.209,0,0,3,1211,3,1211,1.050597000,0.4796
203.116.25.29,<->,136.25.188.223,0,0,3,1320,3,1320,1.050548000,0.3303
195.55.63.35,<->,136.25.188.174,0,0,3,1005,3,1005,1.050239000,0.0919
215.158.238.106,<->,126.219.132.251,3,4055,0,0,3,4055,1.049419000,0.6485
207.236.204.71,<->,136.25.188.163,0,0,3,1672,3,1672,1.048454000,0.1846
215.158.239.49,<->,207.228.92.10,3,1705,0,0,3,1705,1.046432000,0.2806
136.25.189.80,<->,29.212.180.200,3,3863,0,0,3,3863,1.045561000,0.7124
136.25.188.241,<->,26.253.31.168,3,1231,0,0,3,1231,1.045248000,0.1764
118.169.95.80,<->,92.27.234.215,0,0,3,285,3,285,1.044551000,0.3075
215.158.239.124,<->,111.151.237.102,3,2374,0,0,3,2374,1.044219000,0.9215
97.53.94.59,<->,8.182.239.190,0,0,3,1020,3,1020,1.042200000,0.1480
215.158.239.87,<->,195.13.208.34,3,1699,0,0,3,1699,1.040148000,0.1727
215.158.239.79,<->,199.20.4.65,3,1195,0,0,3,1195,1.038781000,0.5796
136.25.189.0,<->,126.219.191.52,3,3863,0,0,3,3863,1.038193000,0.7039
215.158.239.49,<->,194.251.138.47,3,1195,0,0,3,1195,1.036747000,0.3545
142.166.208.248,<->,136.25.188.253,0,0,3,1670,3,1670,1.034953000,0.2320
215.158.140.241,<->,18.202.90.175,3,3285,0,0,3,3285,1.034166000,0.6673
214.237.183.201,<->,0.195.210.42,0,0,3,998,3,998,1.033473000,0.4280
247.127.88.19,<->,221.102.108.186,0,0,3,1920,3,1920,1.031193000,0.2631
220.20.200.131,<->,121.105.194.40,3,1031,0,0,3,1031,1.029023000,0.6174
246.253.253.215,<->,195.0.105.61,3,291,0,0,3,291,1.028669000,0.9600
215.158.238.141,<->,131.1.195.244,3,4231,0,0,3,4231,1.028249000,0.7644
215.158.238.75,<->,8.188.227.11,3,3959,0,0,3,3959,1.026781000,0.5866
215.158.61.238,<->,8.252.221.166,0,0,3,1191,3,1191,1.024257000,0.7018
231.143.102.160,<->,136.25.188.243,0,0,3,1204,3,1204,1.023925000,0.6812
142.223.147.36,<->,136.25.188.176,0,0,3,1049,3,1049,1.021853000,0.8379
215.158.239.50,<->,199.121.172.138,3,765,0,0,3,765,1.020448000,0.1998
144.87.235.222,<->,109.127.101.16,3,1273,0,0,3,1273,1.019643000,0.1401
215.158.239.92,<->,199.20.6.26,3,1669,0,0,3,1669,1.018427000,0.2996
215.158.140.229,<->,131.22.233.146,3,3317,0,0,3,3317,1.017531000,0.8341
143.42.29.66,<->,136.25.188.252,0,0,3,1047,3,1047,1.015639000,0.0697
8.52.235.143,<->,4.7.144.163,3,1104,0,0,3,1104,1.014576000,0.6164
194.253.228.176,<->,8.252.222.187,0,0,3,1027,3,1027,1.013255000,0.7792
215.158.239.49,<->,207.228.134.130,3,1628,0,0,3,1628,1.012618000,0.2399
90.240.3.223,<->,54.37.192.99,3,336,0,0,3,336,1.012240000,0.7398
136.25.189.43,<->,100.216.78.145,3,2547,0,0,3,2547,1.009121000,0.9306
246.254.97.229,<->,139.33.175.151,3,2904,0,0,3,2904,1.007639000,0.0337
142.255.40.201,<->,136.25.188.173,0,0,3,1370,3,1370,1.007499000,0.1929
199.38.27.249,<->,136.25.188.254,0,0,3,1675,3,1675,1.007462000,0.4032
207.57.195.68,<->,136.25.188.54,0,0,3,1050,3,1050,1.006256000,0.4479
207.63.164.43,<->,136.25.188.52,0,0,3,1099,3,1099,1.004150000,0.6352
215.158.140.19,<->,215.158.61.242,3,1674,0,0,3,1674,1.002142000,0.0428
101.126.191.157,<->,8.20.81.14,3,1188,0,0,3,1188,1.001523000,0.1795
215.158.238.111,<->,98.219.126.175,3,1807,0,0,3,1807,1.001212000,0.4661
215.158.239.78,<->,196.94.129.219,3,1338,0,0,3,1338,1.000394000,0.2597
133.178.226.7,<->,96.155.60.192,3,592,0,0,3,592,1.000053000,0.4487
133.178.226.112,<->,91.57.162.46,3,1567,0,0,3,1567,0.999407000,0.0528
215.158.239.49,<->,199.20.28.2,3,1672,0,0,3,1672,0.999273000,0.3852
215.158.239.56,<->,199.79.72.116,3,1707,0,0,3,1707,0.999005000,0.2695
215.158.239.97,<->,199.20.28.90,3,1196,0,0,3,1196,0.998622000,0.7296
215.158.239.96,<->,199.14.8.64,3,1195,0,0,3,1195,0.997919000,0.4336
204.200.43.159,<->,136.25.188.225,0,0,3,1054,3,1054,0.995297000,0.1558
199.98.29.192,<->,8.252.222.223,0,0,3,1664,3,1664,0.994230000,0.2646
212.70.59.185,<->,136.25.188.178,0,0,3,1662,3,1662,0.993184000,0.0817
215.158.239.92,<->,196.91.244.101,3,1679,0,0,3,1679,0.992745000,0.3598
215.158.239.78,<->,195.42.88.33,3,1450,0,0,3,1450,0.992359000,0.3281
220.28.115.46,<->,215.158.238.234,0,0,3,1916,3,1916,0.991543000,0.3357
133.178.227.19,<->,29.211.122.148,3,3254,0,0,3,3254,0.991338000,0.6326
136.25.188.175,<->,27.178.41.27,3,3863,0,0,3,3863,0.990677000,0.9224
215.158.238.146,<->,0.195.253.228,3,2520,0,0,3,2520,0.989040000,0.0001
144.87.238.91,<->,8.182.226.78,0,0,3,2978,3,2978,0.987940000,0.1715
89.90.113.239,<->,82.231.227.44,0,0,3,1131,3,1131,0.987866000,0.0638
133.178.226.18,<->,8.255.92.228,3,3799,0,0,3,3799,0.987473000,0.6672
200.175.136.51,<->,53.214.124.109,3,1981,0,0,3,1981,0.987021000,0.8178
54.59.25.47,<->,48.53.104.85,0,0,3,2159,3,2159,0.985883000,0.6720
204.63.11.80,<->,136.25.188.176,0,0,3,1665,3,1665,0.985646000,0.2299
206.103.215.203,<->,136.25.189.82,0,0,3,1791,3,1791,0.981478000,0.1949
252.64.251.36,<->,80.27.157.212,0,0,3,916,3,916,0.981052000,0.1707
239.66.184.165,<->,100.92.208.90,0,0,3,758,3,758,0.981024000,0.3294
202.33.114.188,<->,136.25.188.220,0,0,3,1036,3,1036,0.980400000,0.2139
215.158.239.49,<->,207.114.241.57,3,1627,0,0,3,1627,0.979600000,0.2797
212.70.217.81,<->,133.178.226.38,0,0,3,3879,3,3879,0.979415000,0.7194
136.25.189.88,<->,133.224.119.35,3,2639,0,0,3,2639,0.979273000,0.6920
142.240.56.53,<->,136.25.188.46,0,0,3,1675,3,1675,0.977477000,0.2760
159.178.74.181,<->,8.52.189.207,0,0,3,1038,3,1038,0.976793000,0.1193
196.205.207.94,<->,136.25.188.46,0,0,3,1195,3,1195,0.974788000,0.5588
215.158.239.48,<->,207.61.241.24,3,1675,0,0,3,1675,0.974349000,0.2183
215.158.239.86,<->,199.20.28.177,3,1054,0,0,3,1054,0.974290000,0.5690
207.236.166.199,<->,136.25.188.177,0,0,3,1067,3,1067,0.974257000,0.4908
215.158.238.82,<->,106.188.251.218,3,3771,0,0,3,3771,0.974159000,0.7302
195.40.146.119,<->,136.25.188.220,0,0,3,1039,3,1039,0.973570000,0.2520
199.55.44.192,<->,8.182.243.141,0,0,3,744,3,744,0.972582000,0.0023
149.238.84.58,<->,0.195.210.42,0,0,3,801,3,801,0.971334000,0.1814
136.25.189.33,<->,8.255.92.169,3,4071,0,0,3,4071,0.970787000,0.8085
199.121.38.130,<->,136.25.188.254,0,0,3,1347,3,1347,0.969749000,0.5445
215.158.238.186,<->,215.158.43.40,3,976,0,0,3,976,0.969580000,0.9612
215.158.239.79,<->,199.20.29.22,3,1673,0,0,3,1673,0.969376000,0.2901
136.25.188.175,<->,35.77.19.118,3,1599,0,0,3,1599,0.968504000,0.6061
8.252.223.115,<->,8.240.116.229,3,3259,0,0,3,3259,0.968495000,1.0117
159.36.243.10,<->,8.52.187.224,0,0,3,1109,3,1109,0.964430000,0.1476
204.226.28.18,<->,136.25.188.177,0,0,3,1693,3,1693,0.963058000,0.1877
215.158.239.87,<->,204.61.158.214,3,1679,0,0,3,1679,0.962669000,0.1670
97.198.121.32,<->,80.27.154.150,3,723,0,0,3,723,0.961930000,0.0001
142.166.243.214,<->,136.25.188.252,0,0,3,1665,3,1665,0.961138000,0.2157
195.126.59.142,<->,136.25.188.253,0,0,3,1671,3,1671,0.959251000,0.1880
203.114.18.211,<->,0.195.210.44,0,0,3,316,3,316,0.958685000,0.1900
215.158.239.92,<->,199.20.30.149,3,1675,0,0,3,1675,0.958238000,0.6797
133.244.28.233,<->,124.55.36.171,3,480,0,0,3,480,0.957615000,0.3972
215.158.239.56,<->,199.20.28.58,3,1681,0,0,3,1681,0.956796000,0.5191
136.25.189.82,<->,69.132.46.139,3,3591,0,0,3,3591,0.956081000,0.8814
218.111.226.62,<->,8.220.176.253,0,0,3,1176,3,1176,0.955088000,0.1558
120.154.99.219,<->,8.176.8.48,0,0,3,2340,3,2340,0.953954000,0.8891
136.25.188.51,<->,111.52.91.227,3,2176,0,0,3,2176,0.953520000,0.8972
142.227.56.211,<->,136.25.188.176,0,0,3,1635,3,1635,0.951434000,0.7605
215.158.238.251,<->,33.209.217.37,3,3452,0,0,3,3452,0.951416000,0.8858
215.158.239.56,<->,142.221.50.164,3,1673,0,0,3,1673,0.951063000,0.3155
66.60.3.88,<->,0.195.210.42,0,0,3,2681,3,2681,0.950425000,0.4493
192.226.44.81,<->,136.25.188.29,0,0,3,1954,3,1954,0.948342000,0.9262
207.62.177.82,<->,136.25.188.46,0,0,3,1101,3,1101,0.947732000,0.3740
215.158.238.67,<->,131.144.113.148,3,4055,0,0,3,4055,0.947106000,0.6656
215.158.239.58,<->,196.88.100.102,3,1666,0,0,3,1666,0.946928000,0.2285
231.136.198.109,<->,136.25.188.196,0,0,3,686,3,686,0.946699000,0.0439
133.178.227.208,<->,8.191.14.216,3,1151,0,0,3,1151,0.945579000,0.5935
142.167.142.0,<->,136.25.188.238,0,0,3,1676,3,1676,0.944033000,0.4192
112.145.110.132,<->,50.224.89.243,0,0,3,3116,3,3116,0.943941000,0.3800
215.158.238.32,<->,136.139.59.124,3,1528,0,0,3,1528,0.942288000,0.7450
98.128.137.56,<->,8.52.171.120,0,0,3,2531,3,2531,0.941838000,0.2682
215.158.239.86,<->,196.88.109.62,3,1299,0,0,3,1299,0.941482000,0.2424
215.158.239.41,<->,8.191.15.9,3,460,0,0,3,460,0.940979000,0.7758
199.83.49.97,<->,136.25.188.255,0,0,3,1040,3,1040,0.940434000,0.9419
215.158.239.49,<->,126.219.191.92,3,3959,0,0,3,3959,0.940378000,0.3321
215.158.140.231,<->,113.23.14.200,3,3290,0,0,3,3290,0.940124000,1.0175
215.158.58.252,<->,99.74.27.36,0,0,3,3320,3,3320,0.939852000,0.0000
212.70.3.113,<->,136.25.188.46,0,0,3,1195,3,1195,0.938809000,0.2598
215.158.239.95,<->,196.104.169.239,3,1178,0,0,3,1178,0.938040000,0.4196
215.158.239.99,<->,199.82.69.229,3,765,0,0,3,765,0.937637000,0.5425
215.158.239.70,<->,199.20.31.215,3,1211,0,0,3,1211,0.936825000,0.8608
215.158.61.191,<->,8.176.8.179,0,0,3,2567,3,2567,0.936534000,0.9374
207.63.93.14,<->,136.25.188.253,0,0,3,1227,3,1227,0.936482000,0.6017
195.14.126.58,<->,136.25.188.253,0,0,3,1117,3,1117,0.935966000,0.2300
158.186.77.27,<->,89.183.104.171,0,0,3,638,3,638,0.934386000,0.6775
215.158.239.83,<->,80.57.141.227,3,598,0,0,3,598,0.934280000,0.0784
136.25.189.83,<->,96.156.169.244,3,2831,0,0,3,2831,0.934043000,1.0438
133.178.227.29,<->,133.56.180.78,3,1623,0,0,3,1623,0.932851000,1.0176
207.63.43.133,<->,136.25.188.255,0,0,3,1026,3,1026,0.932800000,0.6379
196.89.226.191,<->,136.25.188.196,0,0,3,1675,3,1675,0.932696000,0.6650
204.190.211.116,<->,136.25.188.175,0,0,3,1211,3,1211,0.930853000,0.8102
111.199.236.40,<->,0.195.210.44,0,0,3,439,3,439,0.929518000,0.1770
194.232.246.152,<->,136.25.188.243,0,0,3,1211,3,1211,0.929238000,0.3425
58.242.187.145,<->,8.252.221.199,0,0,3,1037,3,1037,0.926525000,1.0136
136.25.189.32,<->,120.154.71.20,3,3799,0,0,3,3799,0.925312000,0.7659
215.158.239.49,<->,199.20.30.95,3,1658,0,0,3,1658,0.924436000,0.3908
215.158.239.96,<->,194.251.68.138,3,1703,0,0,3,1703,0.924199000,0.1610
101.70.121.9,<->,53.188.60.137,3,1353,0,0,3,1353,0.917293000,0.2033
136.25.189.46,<->,96.156.169.253,3,2815,0,0,3,2815,0.916925000,0.9869
142.223.185.89,<->,136.25.188.222,0,0,3,1195,3,1195,0.916238000,0.5719
215.158.239.79,<->,196.107.122.156,3,1030,0,0,3,1030,0.915216000,0.5978
99.162.78.220,<->,53.164.73.93,3,1076,0,0,3,1076,0.914638000,1.0333
215.158.239.84,<->,207.236.255.124,3,1674,0,0,3,1674,0.914202000,0.1913
215.158.239.77,<->,142.221.50.164,3,1675,0,0,3,1675,0.912971000,0.2977
136.25.189.57,<->,126.219.194.54,3,4207,0,0,3,4207,0.911160000,0.6267
215.158.239.87,<->,195.54.47.3,3,1044,0,0,3,1044,0.910826000,0.5157
94.193.162.63,<->,8.252.222.48,0,0,3,1637,3,1637,0.910309000,0.1666
199.121.243.169,<->,136.25.188.220,0,0,3,1386,3,1386,0.909884000,0.2780
129.225.134.223,<->,129.225.132.84,0,0,3,2101,3,2101,0.908519000,0.0637
215.158.239.48,<->,142.236.196.209,3,1163,0,0,3,1163,0.908362000,0.3745
201.79.210.61,<->,136.25.188.176,0,0,3,1441,3,1441,0.908272000,0.7116
142.223.171.101,<->,136.25.188.227,0,0,3,1672,3,1672,0.905323000,0.1952
143.135.226.84,<->,136.25.188.236,0,0,3,1224,3,1224,0.904702000,0.5610
215.158.239.93,<->,199.122.173.231,3,1165,0,0,3,1165,0.904040000,0.9090
192.205.47.11,<->,133.178.226.198,0,0,3,3144,3,3144,0.904026000,1.0359
215.158.238.135,<->,131.144.114.210,3,3767,0,0,3,3767,0.903192000,0.9250
215.158.140.74,<->,114.75.170.84,3,1598,0,0,3,1598,0.901989000,0.5951
215.158.239.42,<->,131.95.192.249,3,4299,0,0,3,4299,0.901588000,1.0742
212.249.34.44,<->,196.148.165.183,0,0,3,1174,3,1174,0.901322000,0.1475
199.51.211.251,<->,136.25.188.55,0,0,3,2343,3,2343,0.898410000,0.9618
215.158.61.226,<->,8.252.222.217,0,0,3,2511,3,2511,0.898377000,0.0643
231.140.164.121,<->,215.158.239.95,0,0,3,1681,3,1681,0.897627000,0.2194
142.252.215.125,<->,136.25.188.177,0,0,3,1059,3,1059,0.896686000,0.5993
204.63.29.181,<->,136.25.188.222,0,0,3,1756,3,1756,0.896213000,0.5410
133.178.226.28,<->,126.219.194.160,3,3015,0,0,3,3015,0.894913000,0.7853
215.158.239.49,<->,207.236.7.89,3,1677,0,0,3,1677,0.893866000,0.2370
215.158.239.77,<->,207.188.56.160,3,1354,0,0,3,1354,0.892429000,0.9114
215.158.239.56,<->,142.244.89.142,3,1179,0,0,3,1179,0.891811000,0.3358
143.52.101.113,<->,136.25.188.198,0,0,3,1698,3,1698,0.891226000,0.4842
207.59.28.235,<->,136.25.188.52,0,0,3,1813,3,1813,0.890815000,0.8583
215.158.140.93,<->,126.219.246.239,3,3264,0,0,3,3264,0.890582000,0.6964
215.158.239.58,<->,196.91.159.141,3,2011,0,0,3,2011,0.889502000,0.9765
215.158.238.104,<->,120.154.221.231,3,3879,0,0,3,3879,0.888854000,1.0946
192.204.123.61,<->,136.25.189.90,0,0,3,3943,3,3943,0.888665000,1.0560
195.12.112.179,<->,136.25.188.238,0,0,3,801,3,801,0.888482000,0.6334
204.200.34.7,<->,136.25.188.177,0,0,3,1631,3,1631,0.887203000,0.1323
224.93.235.38,<->,80.27.157.12,0,0,3,4035,3,4035,0.886076000,1.0070
215.158.239.56,<->,194.250.223.134,3,1660,0,0,3,1660,0.884878000,0.1695
143.10.147.55,<->,136.25.188.54,0,0,3,1673,3,1673,0.882620000,0.2161
215.158.239.49,<->,199.20.7.119,3,1680,0,0,3,1680,0.881507000,0.4892
204.200.43.159,<->,136.25.188.236,0,0,3,1055,3,1055,0.881346000,0.2878
215.158.239.84,<->,143.135.202.149,3,1675,0,0,3,1675,0.878435000,0.1837
215.158.239.76,<->,195.13.248.126,3,1338,0,0,3,1338,0.877342000,0.4285
204.61.132.176,<->,136.25.188.198,0,0,3,985,3,985,0.877316000,0.5456
205.127.108.113,<->,33.233.141.35,0,0,3,815,3,815,0.877040000,0.6288
136.25.188.211,<->,29.211.6.61,3,3751,0,0,3,3751,0.873370000,1.0870
215.158.239.56,<->,199.20.7.119,3,1142,0,0,3,1142,0.873353000,0.4794
246.253.217.173,<->,143.76.143.45,3,703,0,0,3,703,0.871912000,0.1569
249.115.166.202,<->,8.52.189.207,0,0,3,1146,3,1146,0.871407000,0.1113
142.236.244.148,<->,136.25.188.198,0,0,3,1659,3,1659,0.871231000,0.5807
136.25.189.86,<->,98.219.126.175,3,593,0,0,3,593,0.870892000,0.5053
215.158.239.84,<->,199.106.51.143,3,1625,0,0,3,1625,0.870774000,0.4002
249.101.194.241,<->,53.244.240.5,3,792,0,0,3,792,0.869431000,0.4690
137.44.245.179,<->,97.126.15.237,0,0,3,804,3,804,0.868264000,0.0017
136.25.189.47,<->,120.154.131.38,3,2585,0,0,3,2585,0.867021000,1.0092
139.36.120.118,<->,99.74.26.151,0,0,3,2999,3,2999,0.865552000,0.7036
132.249.70.127,<->,27.155.137.55,3,1868,0,0,3,1868,0.865106000,0.3774
109.127.101.16,<->,99.73.230.108,0,0,3,1401,3,1401,0.864309000,0.0849
136.25.188.55,<->,8.42.43.90,3,3943,0,0,3,3943,0.862882000,0.9470
215.158.239.56,<->,196.94.161.188,3,1669,0,0,3,1669,0.861953000,1.1016
195.41.136.79,<->,136.25.188.45,0,0,3,1237,3,1237,0.861702000,1.0822
215.158.239.95,<->,199.20.29.220,3,1286,0,0,3,1286,0.860940000,0.4201
142.191.125.176,<->,136.25.188.54,0,0,3,1196,3,1196,0.860239000,0.5862
215.158.239.99,<->,194.199.223.77,3,1088,0,0,3,1088,0.859824000,0.1668
220.55.88.152,<->,106.4.62.248,3,709,0,0,3,709,0.858402000,0.0032
215.158.238.82,<->,104.3.161.84,3,3975,0,0,3,3975,0.856401000,0.8880
215.158.140.204,<->,6.15.196.155,3,2851,0,0,3,2851,0.855590000,0.8683
133.178.226.180,<->,111.150.206.27,3,3007,0,0,3,3007,0.853839000,1.0473
204.248.216.149,<->,0.195.210.46,0,0,3,1159,3,1159,0.853700000,0.0259
109.222.216.36,<->,53.214.88.203,3,1407,0,0,3,1407,0.852171000,0.2374
195.13.159.99,<->,136.25.188.242,0,0,3,993,3,993,0.849637000,0.0673
143.132.88.112,<->,136.25.188.227,0,0,3,1679,3,1679,0.849081000,0.2036
215.158.238.98,<->,131.36.198.59,3,4330,0,0,3,4330,0.848331000,1.0349
204.200.50.182,<->,136.25.188.242,0,0,3,787,3,787,0.848283000,0.6726
215.158.239.48,<->,204.0.234.66,3,1768,0,0,3,1768,0.846668000,0.4401
136.25.189.17,<->,133.146.0.244,3,3847,0,0,3,3847,0.846433000,1.0143
215.158.239.56,<->,196.91.153.250,3,1707,0,0,3,1707,0.846197000,0.3398
215.158.61.145,<->,136.25.188.43,0,0,3,3104,3,3104,0.846191000,1.0536
207.60.166.80,<->,136.25.188.224,0,0,3,1197,3,1197,0.845303000,0.4505
215.158.239.49,<->,195.41.163.2,3,1170,0,0,3,1170,0.844668000,0.2179
159.137.249.250,<->,104.208.190.89,3,1496,0,0,3,1496,0.843759000,0.3925
215.158.239.68,<->,199.15.213.31,3,748,0,0,3,748,0.842940000,0.7283
215.158.239.125,<->,100.224.141.71,3,986,0,0,3,986,0.842908000,0.1796
142.223.188.46,<->,136.25.188.220,0,0,3,1211,3,1211,0.842484000,1.0665
215.202.174.56,<->,136.25.189.59,0,0,3,1780,3,1780,0.842476000,0.4699
159.137.254.96,<->,106.17.43.150,3,1185,0,0,3,1185,0.841327000,0.6072
252.253.8.169,<->,0.195.210.46,0,0,3,687,3,687,0.839841000,0.0009
133.244.28.235,<->,118.45.61.37,3,405,0,0,3,405,0.838992000,0.6997
136.25.188.175,<->,57.160.181.198,3,4133,0,0,3,4133,0.837560000,1.0297
204.185.190.247,<->,136.25.188.225,0,0,3,1338,3,1338,0.836676000,1.1603
133.178.226.67,<->,98.219.126.175,3,2215,0,0,3,2215,0.835375000,0.4319
143.20.162.20,<->,136.25.188.53,0,0,3,2557,3,2557,0.835318000,0.2818
199.82.178.179,<->,136.25.188.176,0,0,3,1674,3,1674,0.834958000,0.1893
143.42.217.215,<->,136.25.188.222,0,0,3,1051,3,1051,0.833479000,0.3158
199.68.160.136,<->,136.25.188.209,0,0,3,712,3,712,0.833001000,0.1939
207.63.5.97,<->,136.25.188.163,0,0,3,1114,3,1114,0.832825000,0.4743
136.25.189.1,<->,80.56.79.51,3,2767,0,0,3,2767,0.832523000,0.7491
158.192.3.233,<->,136.25.188.44,0,0,3,3783,3,3783,0.832341000,0.9941
136.25.189.1,<->,96.156.169.235,3,1639,0,0,3,1639,0.832107000,0.8603
220.39.233.171,<->,136.25.188.226,0,0,3,4055,3,4055,0.830618000,1.1292
143.53.4.153,<->,136.25.188.255,0,0,3,1679,3,1679,0.829291000,0.2804
137.45.170.79,<->,8.220.234.165,0,0,3,1071,3,1071,0.828951000,0.8792
194.233.59.201,<->,136.25.188.163,0,0,3,1705,3,1705,0.827279000,0.9599
133.178.227.16,<->,69.150.169.246,3,3159,0,0,3,3159,0.825734000,0.9938
195.69.235.236,<->,136.25.188.178,0,0,3,1385,3,1385,0.824275000,1.0155
215.158.58.169,<->,6.73.247.85,0,0,3,2844,3,2844,0.824128000,0.7795
251.24.170.13,<->,8.182.248.147,0,0,3,647,3,647,0.823274000,0.7326
215.158.238.148,<->,114.25.48.32,3,3783,0,0,3,3783,0.822939000,0.8477
207.239.224.78,<->,136.25.188.255,0,0,3,1209,3,1209,0.822914000,0.0813
215.158.239.99,<->,199.20.29.150,3,1211,0,0,3,1211,0.822701000,0.5306
215.158.239.92,<->,8.33.226.52,3,3831,0,0,3,3831,0.820117000,1.1399
231.141.2.36,<->,215.158.239.96,0,0,3,1675,3,1675,0.820113000,0.2380
144.83.112.137,<->,133.54.17.198,0,0,3,317,3,317,0.819822000,0.1235
215.158.61.209,<->,99.74.27.190,0,0,3,1622,3,1622,0.819385000,0.1200
215.158.239.59,<->,204.227.243.73,3,748,0,0,3,748,0.817317000,0.2210
215.158.239.56,<->,199.20.31.84,3,1681,0,0,3,1681,0.816727000,0.8612
215.158.239.58,<->,199.20.30.18,3,1629,0,0,3,1629,0.815581000,0.3396
215.158.238.132,<->,8.190.216.249,3,3927,0,0,3,3927,0.814993000,0.9005
215.158.238.239,<->,149.250.116.47,3,1448,0,0,3,1448,0.812437000,0.1881
215.158.239.77,<->,199.72.84.48,3,3335,0,0,3,3335,0.811095000,0.3786
80.42.131.23,<->,8.150.48.252,3,1933,0,0,3,1933,0.809780000,0.2837
215.158.58.252,<->,6.73.247.85,0,0,3,3022,3,3022,0.808660000,0.6581
136.25.188.220,<->,41.153.59.35,3,1164,0,0,3,1164,0.807543000,0.7339
220.28.65.9,<->,215.158.239.83,0,0,3,3044,3,3044,0.807259000,1.0448
215.158.238.148,<->,104.3.161.71,3,3735,0,0,3,3735,0.805607000,1.0455
215.158.61.189,<->,8.176.8.205,0,0,3,2152,3,2152,0.804984000,0.6830
215.158.239.96,<->,199.20.5.87,3,1046,0,0,3,1046,0.804376000,0.3499
194.234.166.133,<->,136.25.188.54,0,0,3,1192,3,1192,0.803996000,0.7702
204.200.49.26,<->,136.25.188.173,0,0,3,1179,3,1179,0.801890000,0.3384
215.158.239.99,<->,195.42.202.249,3,1170,0,0,3,1170,0.801157000,0.2304
136.25.188.252,<->,57.210.107.8,3,1571,0,0,3,1571,0.800327000,0.5885
215.158.239.87,<->,204.0.223.83,3,433,0,0,3,433,0.797628000,1.0600
215.158.239.97,<->,195.42.202.249,3,1170,0,0,3,1170,0.797175000,0.2814
216.184.2.185,<->,136.25.189.57,0,0,3,3783,3,3783,0.797149000,0.9960
231.140.127.145,<->,215.158.239.49,0,0,3,1058,3,1058,0.796119000,0.5380
111.199.224.133,<->,0.195.210.44,0,0,3,444,3,444,0.796107000,0.0031
204.185.186.248,<->,136.25.188.252,0,0,3,1170,3,1170,0.796106000,0.2095
197.113.64.150,<->,136.25.188.52,0,0,3,1683,3,1683,0.795955000,0.3690
143.10.219.32,<->,136.25.188.176,0,0,3,1652,3,1652,0.795934000,0.2019
100.234.12.141,<->,97.183.194.231,0,0,3,355,3,355,0.794288000,0.0001
192.224.146.35,<->,133.178.227.245,0,0,3,2264,3,2264,0.794235000,0.8523
215.158.238.123,<->,112.235.95.6,3,3959,0,0,3,3959,0.794064000,0.9678
215.158.239.93,<->,204.58.17.171,3,1179,0,0,3,1179,0.793993000,0.5085
215.158.30.240,<->,8.252.222.59,0,0,3,1542,3,1542,0.793002000,0.1216
202.33.106.132,<->,136.25.188.252,0,0,3,1586,3,1586,0.792640000,0.3075
195.55.188.47,<->,136.25.188.46,0,0,3,3176,3,3176,0.790518000,0.8055
215.158.239.57,<->,207.239.53.40,3,520,0,0,3,520,0.790043000,0.4777
195.55.70.223,<->,136.25.188.174,0,0,3,1674,3,1674,0.788942000,0.7269
6.145.164.225,<->,0.195.210.44,0,0,3,383,3,383,0.785356000,0.3081
220.20.200.133,<->,121.105.194.40,3,1026,0,0,3,1026,0.785110000,0.2726
215.158.239.85,<->,195.14.38.36,3,1227,0,0,3,1227,0.785027000,0.4580
48.106.42.75,<->,8.9.165.171,0,0,3,957,3,957,0.784886000,1.0585
215.158.3.108,<->,102.51.130.116,0,0,3,1461,3,1461,0.784651000,0.5837
220.28.85.14,<->,133.178.227.30,0,0,3,1559,3,1559,0.782041000,1.1668
215.158.239.93,<->,207.239.139.25,3,1197,0,0,3,1197,0.781660000,0.6131
215.158.140.75,<->,18.202.90.252,3,3319,0,0,3,3319,0.781440000,1.1871
215.158.238.196,<->,131.22.233.146,3,3181,0,0,3,3181,0.780969000,1.1225
215.158.61.193,<->,8.176.8.104,0,0,3,3231,3,3231,0.780576000,0.9871
215.158.239.84,<->,207.16.217.102,3,1672,0,0,3,1672,0.780007000,0.2037
195.14.102.199,<->,136.25.188.255,0,0,3,1668,3,1668,0.779585000,0.2069
113.246.46.133,<->,92.27.219.165,0,0,3,1260,3,1260,0.779347000,0.9727
215.158.239.113,<->,129.222.39.190,3,383,0,0,3,383,0.779035000,1.0300
136.25.188.166,<->,100.224.202.178,3,1518,0,0,3,1518,0.777734000,0.6020
215.158.238.190,<->,122.159.123.19,3,3355,0,0,3,3355,0.774782000,1.0521
215.158.238.97,<->,142.234.196.161,3,3911,0,0,3,3911,0.773736000,0.7485
215.158.238.188,<->,131.1.195.22,3,3413,0,0,3,3413,0.773020000,0.9663
197.107.201.140,<->,136.25.188.225,0,0,3,1189,3,1189,0.772900000,0.3236
133.178.226.37,<->,131.144.114.210,3,4087,0,0,3,4087,0.771659000,1.0325
204.58.72.225,<->,136.25.188.54,0,0,3,1046,3,1046,0.771137000,0.2428
215.158.239.70,<->,195.42.202.249,3,1170,0,0,3,1170,0.770266000,0.2868
8.220.190.86,<->,6.101.47.183,3,947,0,0,3,947,0.770142000,0.1063
220.28.115.46,<->,133.178.226.43,0,0,3,1113,3,1113,0.770041000,0.9070
136.25.189.13,<->,120.154.71.7,3,3735,0,0,3,3735,0.769294000,1.0126
215.158.239.56,<->,199.20.28.194,3,1211,0,0,3,1211,0.768427000,0.8202
97.168.64.3,<->,91.40.109.42,3,2079,0,0,3,2079,0.767706000,0.2234
215.158.239.87,<->,199.81.22.225,3,866,0,0,3,866,0.767209000,0.7829
215.158.238.99,<->,27.178.41.9,3,3927,0,0,3,3927,0.766552000,0.9306
215.158.238.200,<->,215.158.33.123,3,3369,0,0,3,3369,0.766541000,0.0163
136.25.189.1,<->,133.56.180.50,3,3863,0,0,3,3863,0.766040000,0.7147
136.25.189.0,<->,133.146.0.252,3,3735,0,0,3,3735,0.765656000,0.7725
196.148.167.157,<->,120.154.64.187,3,1345,0,0,3,1345,0.765391000,0.9873
204.200.48.192,<->,136.25.188.54,0,0,3,461,3,461,0.764096000,0.0000
133.178.227.57,<->,8.192.205.0,3,3259,0,0,3,3259,0.763894000,1.1932
50.49.172.140,<->,8.220.202.151,0,0,3,1774,3,1774,0.763782000,0.2344
215.158.238.129,<->,139.163.161.50,3,1518,0,0,3,1518,0.762506000,0.3241
215.158.238.146,<->,0.195.237.14,3,2913,0,0,3,2913,0.762256000,0.3160
133.178.227.14,<->,8.219.184.110,3,3536,0,0,3,3536,0.758441000,1.1432
215.158.140.241,<->,193.39.68.239,3,3281,0,0,3,3281,0.758067000,0.5918
215.158.140.231,<->,131.144.116.10,3,3261,0,0,3,3261,0.756547000,1.0963
215.158.6.212,<->,8.252.223.130,0,0,3,3371,3,3371,0.754245000,0.6127
197.113.99.30,<->,136.25.188.46,0,0,3,1066,3,1066,0.754144000,0.9707
215.158.239.76,<->,207.60.124.52,3,1664,0,0,3,1664,0.753980000,0.6553
58.40.229.187,<->,0.195.210.42,0,0,3,387,3,387,0.751390000,0.7246
215.158.239.48,<->,194.237.127.175,3,1725,0,0,3,1725,0.750723000,0.2055
215.158.238.33,<->,76.100.108.201,3,1747,0,0,3,1747,0.748714000,1.1702
215.158.239.57,<->,195.15.42.68,3,1338,0,0,3,1338,0.746367000,0.6894
136.25.189.15,<->,106.188.253.229,3,3975,0,0,3,3975,0.744740000,1.0300
215.158.238.135,<->,131.144.114.208,3,3767,0,0,3,3767,0.744523000,0.9610
215.158.239.99,<->,199.20.30.215,3,1179,0,0,3,1179,0.742456000,0.5293
99.187.125.121,<->,8.20.87.34,0,0,3,2556,3,2556,0.741171000,1.1356
141.172.220.242,<->,8.252.222.23,0,0,3,351,3,351,0.740403000,0.8337
215.158.239.49,<->,120.154.131.23,3,3671,0,0,3,3671,0.739983000,1.1951
139.163.161.50,<->,136.25.188.234,0,0,3,3217,3,3217,0.738630000,0.0010
206.199.123.151,<->,139.163.5.140,0,0,3,579,3,579,0.737943000,0.1640
220.28.65.9,<->,133.178.227.30,0,0,3,627,3,627,0.737942000,0.0569
215.158.239.71,<->,122.159.245.45,3,3719,0,0,3,3719,0.737875000,1.1555
215.158.239.48,<->,207.16.217.102,3,1672,0,0,3,1672,0.737468000,0.2277
142.249.52.212,<->,136.25.188.236,0,0,3,1224,3,1224,0.733644000,0.4887
215.158.239.79,<->,106.188.253.230,3,2624,0,0,3,2624,0.732699000,1.2513
215.158.239.68,<->,196.109.111.47,3,1386,0,0,3,1386,0.732099000,0.3598
215.158.239.51,<->,199.121.38.183,3,1195,0,0,3,1195,0.731038000,0.6402
54.36.85.60,<->,48.53.125.245,0,0,3,2546,3,2546,0.730977000,0.8646
252.98.139.114,<->,27.11.66.245,3,1906,0,0,3,1906,0.730771000,0.2509
215.158.239.92,<->,199.20.127.207,3,1681,0,0,3,1681,0.730393000,0.1600
122.214.20.70,<->,89.183.104.189,0,0,3,804,3,804,0.728000000,0.9340
215.158.238.115,<->,131.144.114.208,3,3623,0,0,3,3623,0.727589000,1.2494
192.66.145.148,<->,8.45.168.98,3,1958,0,0,3,1958,0.727554000,0.1229
204.200.32.239,<->,136.25.188.54,0,0,3,1015,3,1015,0.727242000,0.1297
142.249.254.11,<->,136.25.188.196,0,0,3,573,3,573,0.726140000,0.3575
136.25.189.27,<->,96.156.169.238,3,2847,0,0,3,2847,0.725820000,0.7782
133.178.227.51,<->,56.1.237.37,3,3368,0,0,3,3368,0.725361000,0.6955
133.178.227.16,<->,106.188.228.1,3,3250,0,0,3,3250,0.725166000,1.2597
231.140.133.104,<->,215.158.239.84,0,0,3,1042,3,1042,0.724237000,0.2924
195.124.195.23,<->,136.25.188.227,0,0,3,1682,3,1682,0.723706000,0.4553
133.178.226.38,<->,91.57.162.225,3,3591,0,0,3,3591,0.723358000,1.0289
204.63.29.181,<->,136.25.188.220,0,0,3,1121,3,1121,0.722111000,0.5129
206.103.215.215,<->,136.25.189.32,0,0,3,1663,3,1663,0.721044000,0.1947
136.25.189.18,<->,8.215.68.83,3,3895,0,0,3,3895,0.720206000,0.6930
207.173.31.171,<->,136.25.188.160,0,0,3,1152,3,1152,0.716391000,0.8302
136.25.188.197,<->,131.36.198.33,3,4242,0,0,3,4242,0.716183000,1.1439
156.161.212.226,<->,8.252.222.175,0,0,3,1563,3,1563,0.715910000,0.5444
129.252.19.149,<->,8.182.244.237,0,0,3,920,3,920,0.715748000,0.2115
215.158.61.195,<->,8.176.8.205,0,0,3,3473,3,3473,0.714946000,1.1528
132.24.63.111,<->,100.228.42.185,0,0,3,2119,3,2119,0.714824000,1.0556
215.158.239.35,<->,29.212.195.102,3,1585,0,0,3,1585,0.714393000,0.5206
129.92.115.211,<->,54.61.210.137,3,2711,0,0,3,2711,0.713941000,1.0167
215.158.239.58,<->,199.20.29.215,3,1195,0,0,3,1195,0.712748000,1.2604
215.158.238.82,<->,142.234.196.182,3,3943,0,0,3,3943,0.712653000,1.0216
195.54.101.116,<->,136.25.188.255,0,0,3,1666,3,1666,0.712440000,0.1656
136.25.188.223,<->,8.255.92.219,3,3927,0,0,3,3927,0.710539000,0.8408
195.43.241.6,<->,136.25.188.226,0,0,3,1386,3,1386,0.709971000,0.2760
207.58.218.25,<->,136.25.188.225,0,0,3,1845,3,1845,0.709908000,0.3263
215.158.61.220,<->,8.252.222.66,0,0,3,1448,3,1448,0.709800000,0.6562
246.108.106.178,<->,111.147.80.111,0,0,3,2881,3,2881,0.709655000,0.7809
195.124.240.74,<->,136.25.188.198,0,0,3,1077,3,1077,0.709502000,1.0718
136.25.188.208,<->,57.160.181.245,3,3911,0,0,3,3911,0.709304000,1.2112
249.229.129.171,<->,215.158.140.87,0,0,3,1792,3,1792,0.708958000,0.1808
221.102.56.69,<->,192.65.35.88,0,0,3,882,3,882,0.708477000,0.4148
133.178.227.27,<->,8.221.197.108,3,3180,0,0,3,3180,0.707885000,1.2038
136.25.189.1,<->,114.25.48.63,3,3607,0,0,3,3607,0.707844000,0.7001
194.237.176.132,<->,8.52.229.28,0,0,3,2320,3,2320,0.707518000,1.0338
215.158.239.93,<->,195.7.203.27,3,1386,0,0,3,1386,0.707411000,0.5661
215.158.239.87,<->,195.5.208.153,3,904,0,0,3,904,0.707345000,0.9072
215.158.239.95,<->,199.20.30.109,3,803,0,0,3,803,0.706350000,0.7396
215.158.238.66,<->,106.188.183.217,3,407,0,0,3,407,0.706305000,1.2335
215.158.238.74,<->,106.188.251.194,3,3797,0,0,3,3797,0.705928000,1.2938
136.128.35.207,<->,8.176.8.87,0,0,3,472,3,472,0.705228000,0.0552
218.56.156.55,<->,215.158.140.172,0,0,3,1307,3,1307,0.704820000,0.0228
215.158.61.202,<->,8.176.8.104,0,0,3,2070,3,2070,0.704782000,0.9504
215.158.140.241,<->,131.144.116.37,3,3329,0,0,3,3329,0.704699000,1.0577
101.224.182.5,<->,6.73.247.62,0,0,3,3959,3,3959,0.704632000,0.0246
199.39.215.192,<->,136.25.188.163,0,0,3,1673,3,1673,0.701801000,0.2207
215.158.238.198,<->,131.219.110.169,3,3231,0,0,3,3231,0.700750000,1.1302
136.25.189.2,<->,96.156.169.246,3,3039,0,0,3,3039,0.700549000,1.1830
215.158.238.236,<->,8.222.213.18,3,3229,0,0,3,3229,0.700204000,0.9237
143.129.206.171,<->,136.25.188.222,0,0,3,1689,3,1689,0.699895000,0.2421
255.133.225.112,<->,255.133.225.23,0,0,3,406,3,406,0.699383000,0.9546
220.20.200.22,<->,112.219.43.107,3,3563,0,0,3,3563,0.697687000,0.0005
252.36.227.210,<->,80.38.22.80,0,0,3,1519,3,1519,0.697238000,0.7923
215.158.61.193,<->,8.176.8.183,0,0,3,3337,3,3337,0.696342000,1.1460
215.158.239.222,<->,215.158.61.182,3,3069,0,0,3,3069,0.695624000,0.6761
199.80.3.28,<->,136.25.188.224,0,0,3,1200,3,1200,0.694196000,1.1160
215.158.239.99,<->,199.20.30.106,3,852,0,0,3,852,0.692898000,0.6175
197.125.126.182,<->,133.178.226.37,0,0,3,3751,3,3751,0.692521000,0.9595
199.70.176.137,<->,136.25.188.54,0,0,3,2295,3,2295,0.691001000,1.2033
215.158.239.79,<->,142.236.94.74,3,1402,0,0,3,1402,0.690357000,0.2542
143.132.219.180,<->,136.25.188.255,0,0,3,1680,3,1680,0.690324000,0.4461
215.158.239.56,<->,207.228.178.11,3,1664,0,0,3,1664,0.689852000,0.3391
144.93.20.73,<->,109.222.231.140,0,0,3,634,3,634,0.689691000,0.1810
215.158.239.205,<->,139.117.36.103,3,1197,0,0,3,1197,0.689631000,0.1003
223.115.228.192,<->,8.252.222.160,0,0,3,1679,3,1679,0.689331000,0.6048
133.178.226.90,<->,120.20.132.54,3,3895,0,0,3,3895,0.688499000,0.9641
215.158.238.123,<->,8.252.210.250,3,3927,0,0,3,3927,0.687955000,0.9639
146.249.227.135,<->,8.252.221.199,0,0,3,915,3,915,0.687948000,0.3251
136.25.189.77,<->,96.156.169.233,3,3263,0,0,3,3263,0.687679000,0.9629
215.158.140.17,<->,80.57.208.180,3,2721,0,0,3,2721,0.687179000,0.3862
215.158.239.30,<->,8.252.253.225,3,1694,0,0,3,1694,0.687097000,1.1209
215.158.239.56,<->,199.20.6.46,3,1681,0,0,3,1681,0.686618000,0.3001
144.87.238.89,<->,8.182.227.5,0,0,3,949,3,949,0.686132000,0.1250
215.158.238.120,<->,69.150.169.181,3,3735,0,0,3,3735,0.685885000,0.8956
215.158.61.202,<->,8.176.8.182,0,0,3,2460,3,2460,0.685268000,0.2293
215.158.239.68,<->,143.44.139.212,3,1746,0,0,3,1746,0.684772000,0.4741
215.158.239.49,<->,199.73.44.127,3,1660,0,0,3,1660,0.684126000,0.3168
158.85.50.137,<->,133.178.227.16,0,0,3,3372,3,3372,0.683887000,0.9597
215.158.239.70,<->,204.226.48.226,3,1672,0,0,3,1672,0.683650000,0.1625
142.206.141.203,<->,136.25.188.236,0,0,3,577,3,577,0.682161000,0.3617
215.158.238.45,<->,80.57.141.94,3,1631,0,0,3,1631,0.681667000,0.0530
149.133.163.104,<->,89.183.110.72,0,0,3,4157,3,4157,0.681288000,0.0000
204.187.78.195,<->,136.25.188.222,0,0,3,1227,3,1227,0.680898000,0.8299
215.158.239.100,<->,215.158.61.193,3,2710,0,0,3,2710,0.680398000,0.6269
17.59.146.123,<->,8.52.154.255,0,0,3,521,3,521,0.679637000,0.0950
130.77.154.37,<->,0.195.210.42,0,0,3,815,3,815,0.678872000,0.2297
92.168.217.245,<->,50.136.187.180,3,1041,0,0,3,1041,0.678434000,1.2745
215.158.61.202,<->,8.176.8.204,0,0,3,2895,3,2895,0.677997000,0.4680
103.14.185.79,<->,35.56.100.182,0,0,3,1380,3,1380,0.674880000,0.6928
215.158.239.94,<->,199.20.30.166,3,959,0,0,3,959,0.673181000,0.3597
215.158.239.84,<->,195.43.0.104,3,1062,0,0,3,1062,0.672124000,0.4151
195.7.228.211,<->,136.25.188.196,0,0,3,1674,3,1674,0.671446000,0.2146
204.187.27.239,<->,136.25.188.178,0,0,3,1704,3,1704,0.671002000,0.2699
215.158.239.51,<->,204.56.138.100,3,1195,0,0,3,1195,0.670130000,0.4564
215.158.239.99,<->,199.20.4.163,3,1708,0,0,3,1708,0.668514000,0.2205
215.158.3.139,<->,8.176.8.206,0,0,3,1623,3,1623,0.667961000,0.4792
215.158.239.84,<->,207.188.4.192,3,1703,0,0,3,1703,0.667304000,0.3997
215.158.61.183,<->,8.176.8.248,0,0,3,1287,3,1287,0.666418000,1.3167
139.193.141.194,<->,113.144.87.156,3,997,0,0,3,997,0.665130000,0.1700
215.158.239.37,<->,96.135.154.147,3,3484,0,0,3,3484,0.663905000,0.1739
136.25.189.77,<->,80.56.79.5,3,4164,0,0,3,4164,0.662998000,0.8271
215.158.238.104,<->,143.45.0.148,3,3199,0,0,3,3199,0.661484000,0.8969
215.158.238.198,<->,114.94.161.247,3,3384,0,0,3,3384,0.658700000,1.2741
207.22.234.156,<->,0.195.210.46,0,0,3,1391,3,1391,0.657971000,1.1377
210.221.107.50,<->,8.37.103.65,3,891,0,0,3,891,0.657932000,0.8277
133.54.26.17,<->,117.130.224.251,3,178,0,0,3,178,0.657870000,0.4595
199.70.97.127,<->,136.25.188.163,0,0,3,1064,3,1064,0.657759000,0.5150
136.25.189.88,<->,29.211.93.22,3,3927,0,0,3,3927,0.656412000,1.0508
127.168.165.134,<->,8.176.8.225,0,0,3,868,3,868,0.655565000,1.2992
207.61.88.169,<->,136.25.188.252,0,0,3,1660,3,1660,0.655326000,0.2465
215.158.239.49,<->,195.126.167.168,3,1196,0,0,3,1196,0.654892000,0.5020
136.25.188.221,<->,122.159.245.172,3,4055,0,0,3,4055,0.653573000,0.8994
94.194.209.218,<->,8.252.222.49,0,0,3,1173,3,1173,0.653561000,0.5523
199.73.130.216,<->,136.25.188.241,0,0,3,496,3,496,0.653377000,1.1582
215.158.238.106,<->,42.226.3.105,3,3895,0,0,3,3895,0.653031000,0.6927
133.178.226.77,<->,69.132.194.104,3,4087,0,0,3,4087,0.652530000,0.9317
195.4.4.228,<->,136.25.188.226,0,0,3,1663,3,1663,0.651527000,0.2039
199.51.177.82,<->,136.25.188.52,0,0,3,1115,3,1115,0.650980000,0.9093
215.158.140.241,<->,8.219.185.21,3,3900,0,0,3,3900,0.650831000,0.8112
142.247.242.34,<->,136.25.188.53,0,0,3,331,3,331,0.650343000,0.7706
192.64.244.21,<->,8.45.175.31,3,2013,0,0,3,2013,0.649643000,0.1701
135.254.169.163,<->,50.224.108.129,0,0,3,355,3,355,0.648456000,0.2547
145.186.84.51,<->,54.37.245.208,3,2203,0,0,3,2203,0.647565000,0.5869
199.69.141.133,<->,136.25.188.176,0,0,3,1056,3,1056,0.647342000,0.2669
136.25.188.52,<->,64.108.32.174,3,575,0,0,3,575,0.647070000,0.5338
215.158.6.223,<->,8.252.223.131,0,0,3,3345,3,3345,0.646441000,0.5796
142.182.132.200,<->,136.25.188.252,0,0,3,1045,3,1045,0.645385000,0.3238
215.158.58.222,<->,99.74.27.25,0,0,3,1156,3,1156,0.645310000,0.3160
215.158.238.65,<->,112.220.206.117,3,2749,0,0,3,2749,0.642314000,1.1844
215.158.238.94,<->,131.1.195.249,3,4162,0,0,3,4162,0.642133000,0.6229
199.39.149.173,<->,136.25.188.226,0,0,3,1741,3,1741,0.640938000,0.4811
136.25.189.15,<->,29.211.93.23,3,3831,0,0,3,3831,0.640141000,1.0597
106.168.191.70,<->,100.94.173.42,0,0,3,492,3,492,0.639766000,1.1285
133.178.227.27,<->,8.192.205.72,3,3241,0,0,3,3241,0.639205000,0.8058
143.43.127.33,<->,136.25.188.208,0,0,3,689,3,689,0.638796000,0.4760
215.158.238.250,<->,33.221.186.163,3,3362,0,0,3,3362,0.638726000,1.3196
136.25.188.175,<->,29.214.64.189,3,3959,0,0,3,3959,0.638291000,0.9700
215.158.238.188,<->,122.158.245.43,3,3647,0,0,3,3647,0.637843000,1.1729
215.158.238.67,<->,8.188.227.41,3,3831,0,0,3,3831,0.637795000,0.7932
231.142.170.225,<->,215.158.239.95,0,0,3,544,3,544,0.636027000,0.5312
215.158.239.51,<->,199.20.4.184,3,1685,0,0,3,1685,0.635599000,0.2793
136.25.188.177,<->,65.63.242.219,3,1059,0,0,3,1059,0.635533000,0.8498
246.254.97.230,<->,111.151.239.173,3,1028,0,0,3,1028,0.634218000,0.0690
136.25.189.33,<->,98.28.95.85,3,3655,0,0,3,3655,0.633655000,0.6589
109.119.141.179,<->,92.162.253.91,0,0,3,1452,3,1452,0.633610000,0.0611
215.158.239.97,<->,199.20.30.196,3,295,0,0,3,295,0.633384000,1.2502
215.158.238.199,<->,8.219.186.172,3,1842,0,0,3,1842,0.633274000,1.2738
194.233.11.39,<->,136.25.188.253,0,0,3,1680,3,1680,0.632436000,0.2128
159.112.18.124,<->,0.195.210.46,0,0,3,2061,3,2061,0.632308000,0.2921
194.232.97.10,<->,136.25.188.254,0,0,3,752,3,752,0.632186000,0.3872
215.158.239.70,<->,8.215.68.72,3,3959,0,0,3,3959,0.631431000,0.9401
215.158.239.97,<->,196.108.16.150,3,1708,0,0,3,1708,0.631132000,0.3496
133.178.227.19,<->,133.56.180.42,3,3900,0,0,3,3900,0.630767000,0.9650
215.158.238.97,<->,126.219.132.237,3,3975,0,0,3,3975,0.630755000,0.9480
136.25.188.160,<->,111.151.70.36,3,3703,0,0,3,3703,0.630669000,1.3576
221.102.122.193,<->,111.15.220.197,3,3230,0,0,3,3230,0.629939000,0.8724
136.25.189.83,<->,106.188.253.181,3,2773,0,0,3,2773,0.629655000,0.9752
215.158.238.133,<->,113.23.104.246,3,1699,0,0,3,1699,0.629555000,0.9154
215.158.238.198,<->,149.250.115.73,3,3238,0,0,3,3238,0.629020000,1.2633
215.158.239.56,<->,199.20.30.25,3,599,0,0,3,599,0.626819000,0.4401
220.28.108.254,<->,215.158.239.47,0,0,3,627,3,627,0.626207000,0.0703
17.0.7.92,<->,8.220.190.86,0,0,3,1780,3,1780,0.625213000,0.0257
212.70.75.122,<->,133.178.226.19,0,0,3,3943,3,3943,0.624850000,0.8477
215.158.140.92,<->,8.53.216.223,3,3241,0,0,3,3241,0.624011000,0.9080
192.64.247.113,<->,8.45.162.111,3,1243,0,0,3,1243,0.621417000,0.2769
215.158.239.87,<->,199.33.220.112,3,261,0,0,3,261,0.621342000,1.3415
204.184.11.236,<->,136.25.188.239,0,0,3,1681,3,1681,0.621055000,0.2399
136.25.188.224,<->,111.31.101.206,3,906,0,0,3,906,0.620931000,0.0045
215.158.239.63,<->,106.188.183.100,3,1407,0,0,3,1407,0.620147000,0.0012
108.41.82.75,<->,8.220.190.86,0,0,3,1834,3,1834,0.619989000,1.3108
98.101.92.196,<->,8.183.25.25,0,0,3,864,3,864,0.619915000,0.0380
204.3.154.98,<->,136.25.188.177,0,0,3,1690,3,1690,0.618316000,0.2496
215.158.239.48,<->,207.213.143.199,3,1052,0,0,3,1052,0.618239000,0.4387
111.150.186.220,<->,8.252.222.205,0,0,3,3783,3,3783,0.617975000,1.0190
111.20.171.168,<->,33.233.141.88,0,0,3,2774,3,2774,0.617359000,0.5819
215.158.140.229,<->,197.133.131.168,3,3324,0,0,3,3324,0.615957000,0.9774
136.25.189.14,<->,114.150.180.156,3,1780,0,0,3,1780,0.615622000,0.1676
215.158.239.33,<->,8.191.6.84,3,533,0,0,3,533,0.614636000,1.2867
205.127.108.113,<->,33.233.141.64,0,0,3,1004,3,1004,0.614491000,1.3630
8.182.244.237,<->,6.242.29.210,3,1533,0,0,3,1533,0.614464000,1.3809
204.184.201.54,<->,136.25.188.209,0,0,3,1679,3,1679,0.614459000,0.6206
136.25.188.172,<->,69.150.168.9,3,4103,0,0,3,4103,0.614182000,0.7769
215.158.238.73,<->,122.159.245.165,3,3367,0,0,3,3367,0.613645000,0.8233
215.158.238.190,<->,131.144.116.39,3,3189,0,0,3,3189,0.613247000,0.8462
133.178.227.2,<->,133.56.180.50,3,1559,0,0,3,1559,0.612257000,0.9305
142.252.185.121,<->,136.25.188.46,0,0,3,1539,3,1539,0.612094000,0.2129
215.158.239.167,<->,105.119.200.175,3,1540,0,0,3,1540,0.612090000,0.3765
139.246.60.46,<->,8.250.152.93,0,0,3,1555,3,1555,0.611033000,0.9844
204.185.30.5,<->,136.25.188.253,0,0,3,1083,3,1083,0.611009000,1.1400
202.33.252.215,<->,136.25.188.252,0,0,3,303,3,303,0.610811000,1.0800
204.62.76.78,<->,136.25.188.163,0,0,3,1680,3,1680,0.610560000,0.5398
136.25.188.224,<->,131.144.114.210,3,3735,0,0,3,3735,0.609037000,1.0862
136.25.189.58,<->,96.156.169.162,3,3455,0,0,3,3455,0.608424000,1.2680
133.178.226.18,<->,126.219.194.143,3,3799,0,0,3,3799,0.608412000,0.9862
136.25.189.17,<->,6.29.108.87,3,1791,0,0,3,1791,0.608159000,0.0660
205.127.108.114,<->,33.233.141.3,0,0,3,1098,3,1098,0.607882000,0.2418
215.158.61.191,<->,8.176.8.205,0,0,3,2583,3,2583,0.607742000,1.3582
6.145.170.85,<->,0.195.210.44,0,0,3,339,3,339,0.607679000,0.0078
252.92.25.124,<->,0.195.210.46,0,0,3,3133,3,3133,0.607388000,1.1075
215.158.238.221,<->,126.219.191.11,3,3180,0,0,3,3180,0.606544000,1.0601
215.158.239.68,<->,204.3.30.210,3,1692,0,0,3,1692,0.605772000,0.2912
197.196.67.132,<->,0.195.210.46,0,0,3,3351,3,3351,0.605191000,1.2538
144.87.238.91,<->,8.182.224.87,0,0,3,3270,3,3270,0.604128000,0.6196
136.25.189.12,<->,116.106.46.73,3,3687,0,0,3,3687,0.603952000,1.0216
246.254.97.112,<->,132.128.61.12,3,2061,0,0,3,2061,0.603736000,0.1751
215.158.239.57,<->,89.80.251.11,3,3927,0,0,3,3927,0.601975000,0.8609
142.249.228.40,<->,136.25.188.198,0,0,3,573,3,573,0.601632000,0.4211
194.237.63.180,<->,136.25.188.252,0,0,3,942,3,942,0.601463000,0.0143
97.126.24.188,<->,54.36.93.106,3,327,0,0,3,327,0.601424000,0.5771
215.158.239.59,<->,118.20.100.89,3,3847,0,0,3,3847,0.601078000,1.3703
215.158.238.140,<->,131.1.195.223,3,4338,0,0,3,4338,0.600214000,1.2693
136.25.188.173,<->,50.49.94.154,3,1656,0,0,3,1656,0.598893000,0.1155
215.158.239.92,<->,199.20.127.112,3,1163,0,0,3,1163,0.597055000,0.4175
215.158.239.56,<->,199.76.91.225,3,1676,0,0,3,1676,0.596652000,0.3398
136.25.189.80,<->,29.211.93.6,3,3783,0,0,3,3783,0.596259000,0.5998
215.158.239.70,<->,194.237.30.74,3,1805,0,0,3,1805,0.595895000,0.2546
97.126.113.29,<->,0.195.202.28,3,2798,0,0,3,2798,0.595574000,0.8126
91.56.78.100,<->,8.220.238.6,0,0,3,851,3,851,0.595454000,0.1048
136.25.188.193,<->,98.219.126.140,3,3403,0,0,3,3403,0.595238000,1.3926
215.158.238.81,<->,131.1.253.250,3,3895,0,0,3,3895,0.595069000,1.3320
143.79.117.250,<->,136.25.188.255,0,0,3,1405,3,1405,0.594945000,0.4771
215.158.239.96,<->,196.92.118.173,3,1148,0,0,3,1148,0.594888000,1.2708
136.25.189.14,<->,126.219.194.74,3,3783,0,0,3,3783,0.594804000,0.8209
192.65.97.145,<->,8.45.175.31,3,261,0,0,3,261,0.593554000,0.7760
215.158.239.92,<->,196.90.121.195,3,1061,0,0,3,1061,0.593313000,1.2998
133.178.227.79,<->,8.50.170.212,3,3325,0,0,3,3325,0.593027000,1.2133
149.250.115.13,<->,136.25.188.45,0,0,3,4071,3,4071,0.592402000,0.8823
220.20.200.127,<->,144.83.60.153,3,760,0,0,3,760,0.591467000,0.1052
80.27.155.20,<->,66.245.119.19,3,1651,0,0,3,1651,0.591396000,0.2743
229.45.131.225,<->,193.24.114.87,3,980,0,0,3,980,0.591364000,0.0001
204.200.58.249,<->,136.25.188.238,0,0,3,1651,3,1651,0.590018000,0.1281
202.178.8.203,<->,98.190.109.178,0,0,3,1117,3,1117,0.589740000,0.6085
215.158.239.113,<->,129.222.39.153,3,1399,0,0,3,1399,0.589672000,1.0222
215.158.61.183,<->,136.25.189.195,0,0,3,1974,3,1974,0.589113000,0.1907
197.107.200.103,<->,136.25.188.253,0,0,3,1217,3,1217,0.588840000,0.8448
142.208.125.122,<->,136.25.188.254,0,0,3,1672,3,1672,0.587230000,0.2274
192.205.36.152,<->,136.25.188.235,0,0,3,2151,3,2151,0.586475000,1.1192
195.71.188.138,<->,136.25.188.163,0,0,3,1195,3,1195,0.586169000,0.4591
220.50.215.68,<->,50.224.80.75,0,0,3,636,3,636,0.585645000,0.6914
215.158.238.105,<->,131.144.114.216,3,3911,0,0,3,3911,0.584943000,1.1923
215.158.238.241,<->,69.150.168.9,3,3356,0,0,3,3356,0.584809000,1.1582
143.10.227.173,<->,136.25.188.175,0,0,3,1311,3,1311,0.584239000,0.2243
136.25.189.63,<->,96.156.169.224,3,1703,0,0,3,1703,0.583419000,0.8251
246.253.253.170,<->,0.195.197.23,3,989,0,0,3,989,0.582972000,0.2739
221.102.143.189,<->,192.67.184.152,0,0,3,423,3,423,0.582074000,0.7709
136.25.189.14,<->,56.28.207.202,3,4119,0,0,3,4119,0.581895000,0.3315
231.141.23.189,<->,215.158.239.97,0,0,3,1664,3,1664,0.581744000,0.2400
220.28.73.211,<->,215.158.238.19,0,0,3,2596,3,2596,0.581222000,0.0950
215.158.238.133,<->,104.3.163.89,3,3879,0,0,3,3879,0.581161000,1.1905
132.20.222.234,<->,129.224.112.221,0,0,3,315,3,315,0.581130000,1.2825
207.239.31.248,<->,136.25.188.227,0,0,3,1752,3,1752,0.580958000,0.3144
220.20.200.127,<->,35.107.149.134,3,3452,0,0,3,3452,0.580789000,0.0195
136.25.188.44,<->,106.188.236.151,3,3959,0,0,3,3959,0.580328000,0.9148
80.41.248.41,<->,8.35.106.58,3,1713,0,0,3,1713,0.580216000,0.3170
220.28.73.211,<->,136.25.188.235,0,0,3,2748,3,2748,0.579904000,0.9453
215.158.238.81,<->,113.23.104.246,3,1715,0,0,3,1715,0.579265000,1.2880
215.158.239.95,<->,199.20.28.173,3,1211,0,0,3,1211,0.575905000,0.9793
215.158.61.183,<->,8.176.8.199,0,0,3,2546,3,2546,0.573980000,1.0286
246.253.217.173,<->,197.33.123.67,3,555,0,0,3,555,0.573865000,0.2154
136.25.188.172,<->,112.220.206.106,3,3671,0,0,3,3671,0.572876000,0.5704
215.158.239.76,<->,195.40.179.152,3,1672,0,0,3,1672,0.572780000,0.2747
215.158.140.207,<->,136.193.48.243,3,1629,0,0,3,1629,0.572714000,0.2834
136.25.188.175,<->,131.144.113.212,3,3687,0,0,3,3687,0.572632000,0.7216
144.87.238.89,<->,8.182.243.208,0,0,3,894,3,894,0.571901000,0.3749
142.240.217.193,<->,136.25.188.241,0,0,3,1501,3,1501,0.571526000,0.3449
215.158.239.56,<->,199.20.31.127,3,1656,0,0,3,1656,0.569945000,0.1976
136.25.189.15,<->,131.144.115.254,3,3943,0,0,3,3943,0.567895000,0.9328
197.113.64.196,<->,136.25.188.176,0,0,3,1686,3,1686,0.566149000,0.6176
139.249.90.146,<->,100.120.38.6,3,1795,0,0,3,1795,0.565674000,1.1450
215.158.61.182,<->,8.176.8.251,0,0,3,2246,3,2246,0.564953000,1.2775
136.25.188.255,<->,126.219.132.205,3,3671,0,0,3,3671,0.564743000,0.8100
215.158.239.85,<->,194.237.190.159,3,1195,0,0,3,1195,0.563812000,0.9129
143.89.173.236,<->,136.25.188.255,0,0,3,1673,3,1673,0.562797000,0.4341
215.158.239.69,<->,199.20.31.43,3,1864,0,0,3,1864,0.562791000,0.3600
220.39.233.203,<->,215.158.238.82,0,0,3,3911,3,3911,0.562387000,0.6084
199.52.92.223,<->,136.25.188.255,0,0,3,1705,3,1705,0.562158000,0.2400
36.123.55.193,<->,8.20.87.7,0,0,3,561,3,561,0.561710000,0.3074
197.113.64.162,<->,136.25.188.175,0,0,3,1243,3,1243,0.561701000,1.2093
139.160.226.203,<->,136.25.189.12,0,0,3,3943,3,3943,0.561691000,0.7158
215.158.238.80,<->,8.190.216.212,3,4071,0,0,3,4071,0.561639000,1.1391
220.39.233.180,<->,136.25.188.197,0,0,3,3655,3,3655,0.561573000,1.2829
204.226.28.18,<->,136.25.188.253,0,0,3,1195,3,1195,0.561046000,0.3923
215.158.239.92,<->,143.20.210.71,3,626,0,0,3,626,0.559723000,0.4459
133.178.226.29,<->,112.235.95.73,3,3943,0,0,3,3943,0.558044000,1.4339
215.158.238.96,<->,99.192.168.162,3,3742,0,0,3,3742,0.557577000,0.8583
215.158.238.100,<->,100.224.166.122,3,2359,0,0,3,2359,0.556692000,1.2597
136.25.189.21,<->,96.156.169.207,3,3538,0,0,3,3538,0.556676000,0.6466
215.158.239.50,<->,199.20.5.232,3,1322,0,0,3,1322,0.556293000,0.1196
192.204.170.198,<->,136.25.188.47,0,0,3,3991,3,3991,0.556142000,1.0422
207.56.101.49,<->,136.25.188.225,0,0,3,1141,3,1141,0.555383000,0.3824
136.25.189.16,<->,106.188.253.155,3,3767,0,0,3,3767,0.554026000,0.5961
6.145.171.103,<->,0.195.210.44,0,0,3,487,3,487,0.554014000,0.0640
220.39.233.24,<->,215.158.140.76,0,0,3,3406,3,3406,0.553632000,0.9234
215.158.140.60,<->,193.39.68.230,3,3543,0,0,3,3543,0.552861000,0.9770
215.158.238.135,<->,126.219.190.163,3,3159,0,0,3,3159,0.552701000,1.3110
215.158.239.68,<->,199.20.29.20,3,1682,0,0,3,1682,0.552529000,0.8599
133.178.226.28,<->,131.36.198.59,3,4298,0,0,3,4298,0.552299000,0.9890
215.158.239.51,<->,199.106.133.246,3,1179,0,0,3,1179,0.551133000,0.9395
136.25.188.226,<->,65.27.228.213,3,3831,0,0,3,3831,0.550397000,1.1999
215.158.238.190,<->,126.219.101.159,3,3355,0,0,3,3355,0.550199000,1.3039
215.158.239.79,<->,199.20.31.209,3,1677,0,0,3,1677,0.550077000,0.2596
136.25.188.45,<->,126.219.247.24,3,3815,0,0,3,3815,0.548383000,0.8576
215.158.238.148,<->,104.3.168.203,3,4007,0,0,3,4007,0.548256000,1.0786
207.190.127.169,<->,136.25.188.174,0,0,3,1370,3,1370,0.546579000,0.2173
136.25.188.221,<->,104.3.163.5,3,3767,0,0,3,3767,0.546312000,1.3642
136.25.188.227,<->,57.210.107.16,3,3895,0,0,3,3895,0.544836000,0.7628
196.89.49.194,<->,136.25.188.254,0,0,3,1195,3,1195,0.542617000,0.5230
215.158.61.202,<->,8.176.8.186,0,0,3,2151,3,2151,0.542435000,1.1535
215.158.238.251,<->,8.222.213.21,3,3304,0,0,3,3304,0.541149000,0.5647
220.28.114.28,<->,133.178.227.61,0,0,3,1178,3,1178,0.540446000,1.3462
215.158.239.71,<->,80.56.79.104,3,4082,0,0,3,4082,0.540170000,1.2206
215.158.239.96,<->,207.60.42.217,3,1672,0,0,3,1672,0.539838000,0.4490
215.158.239.99,<->,195.81.49.78,3,1083,0,0,3,1083,0.538711000,0.6491
69.128.84.108,<->,53.201.139.195,3,1471,0,0,3,1471,0.538152000,0.9764
232.31.155.18,<->,97.198.118.56,0,0,3,1350,3,1350,0.537167000,0.2946
199.73.64.238,<->,136.25.188.174,0,0,3,1749,3,1749,0.536692000,0.2118
215.158.239.93,<->,194.199.194.70,3,1226,0,0,3,1226,0.536397000,0.1682
8.252.222.150,<->,4.122.101.62,3,1194,0,0,3,1194,0.535743000,0.3869
215.201.235.99,<->,8.183.24.179,0,0,3,2384,3,2384,0.534749000,0.8398
220.28.104.193,<->,136.25.189.36,0,0,3,1059,3,1059,0.534497000,1.3325
80.27.153.42,<->,79.61.207.242,3,1133,0,0,3,1133,0.534076000,0.1719
111.147.75.105,<->,53.251.227.246,3,1651,0,0,3,1651,0.533959000,0.3595
199.14.204.198,<->,136.25.188.198,0,0,3,1049,3,1049,0.533930000,0.3230
136.25.188.44,<->,8.222.212.20,3,3959,0,0,3,3959,0.533449000,0.4085
54.37.5.99,<->,48.53.38.95,0,0,3,1392,3,1392,0.533443000,0.6117
133.178.227.19,<->,89.86.110.235,3,3583,0,0,3,3583,0.532859000,1.1567
136.25.189.57,<->,126.219.194.27,3,3799,0,0,3,3799,0.532483000,0.8271
192.227.190.234,<->,136.25.188.174,0,0,3,1895,3,1895,0.531028000,1.3943
220.20.200.117,<->,131.45.239.178,3,1692,0,0,3,1692,0.530984000,0.1339
133.178.226.29,<->,131.144.113.213,3,3799,0,0,3,3799,0.530540000,1.1278
136.25.188.236,<->,56.161.218.40,3,3879,0,0,3,3879,0.528943000,1.1331
215.158.239.96,<->,207.63.16.107,3,1054,0,0,3,1054,0.528768000,0.2612
197.60.144.196,<->,8.20.87.187,0,0,3,1240,3,1240,0.528328000,0.2055
207.239.156.159,<->,136.25.188.175,0,0,3,1747,3,1747,0.528296000,0.4429
133.178.226.90,<->,126.219.247.1,3,3591,0,0,3,3591,0.528252000,0.8869
144.83.112.139,<->,133.54.17.198,0,0,3,353,3,353,0.528184000,0.0873
136.25.188.211,<->,33.209.217.201,3,4065,0,0,3,4065,0.527431000,1.3354
133.107.27.12,<->,35.56.98.241,0,0,3,170,3,170,0.527231000,1.4419
133.178.226.77,<->,106.188.236.172,3,3863,0,0,3,3863,0.527099000,0.6878
204.2.222.151,<->,136.25.188.209,0,0,3,320,3,320,0.527091000,0.9400
215.158.238.75,<->,122.159.245.162,3,4039,0,0,3,4039,0.527052000,0.9884
132.152.154.122,<->,8.52.154.216,0,0,3,1512,3,1512,0.526532000,0.0850
136.25.189.13,<->,118.20.100.66,3,3879,0,0,3,3879,0.526219000,1.4433
215.158.239.58,<->,199.20.31.233,3,1055,0,0,3,1055,0.526018000,0.2490
204.200.45.224,<->,136.25.188.253,0,0,3,691,3,691,0.525372000,0.4280
215.158.238.83,<->,57.210.107.42,3,3815,0,0,3,3815,0.525331000,0.9837
204.3.189.5,<->,136.25.188.222,0,0,3,1756,3,1756,0.524835000,0.3947
148.21.212.169,<->,136.25.189.88,0,0,3,3895,3,3895,0.524783000,1.4669
215.158.239.56,<->,207.62.181.205,3,1923,0,0,3,1923,0.524358000,1.1750
195.5.173.153,<->,136.25.188.199,0,0,3,1386,3,1386,0.523659000,0.2159
199.71.56.109,<->,136.25.188.44,0,0,3,1629,3,1629,0.523630000,0.2371
136.25.189.58,<->,96.156.169.223,3,2943,0,0,3,2943,0.523345000,1.0891
207.172.14.128,<->,136.25.188.236,0,0,3,1681,3,1681,0.523137000,0.9399
215.158.239.93,<->,199.20.28.170,3,1659,0,0,3,1659,0.521554000,0.4390
136.25.188.176,<->,57.210.107.25,3,3607,0,0,3,3607,0.521489000,0.9753
149.250.115.4,<->,133.178.226.38,0,0,3,3991,3,3991,0.519622000,1.3182
215.158.140.231,<->,8.222.213.28,3,3367,0,0,3,3367,0.519611000,0.8186
159.137.139.85,<->,133.178.227.14,0,0,3,3171,3,3171,0.519400000,0.6131
197.113.99.242,<->,136.25.188.243,0,0,3,1191,3,1191,0.519320000,1.2395
111.147.200.49,<->,89.207.30.173,3,2670,0,0,3,2670,0.519015000,1.4464
158.192.3.223,<->,133.178.226.31,0,0,3,3975,3,3975,0.518851000,1.4406
140.218.109.12,<->,136.25.188.178,0,0,3,4039,3,4039,0.518473000,1.2663
232.31.155.17,<->,97.198.118.56,0,0,3,1371,3,1371,0.517232000,0.3149
142.208.49.216,<->,136.25.188.255,0,0,3,1553,3,1553,0.516575000,0.1927
199.33.126.138,<->,136.25.188.175,0,0,3,1395,3,1395,0.516559000,0.6707
222.254.247.163,<->,210.220.219.181,0,0,3,1431,3,1431,0.514917000,1.4459
136.25.189.77,<->,61.35.70.234,3,3687,0,0,3,3687,0.513777000,0.6238
133.178.226.80,<->,8.191.14.26,3,3187,0,0,3,3187,0.512600000,1.4418
207.231.197.31,<->,8.252.222.178,0,0,3,303,3,303,0.511438000,1.3049
133.178.227.249,<->,8.35.106.108,3,3247,0,0,3,3247,0.509596000,0.6817
73.14.193.173,<->,8.252.222.161,0,0,3,892,3,892,0.509254000,0.4703
136.139.59.119,<->,133.178.226.37,0,0,3,3831,3,3831,0.509064000,0.5615
136.25.188.49,<->,80.57.141.130,3,1342,0,0,3,1342,0.508668000,0.0612
132.216.20.155,<->,101.124.203.11,0,0,3,1090,3,1090,0.507586000,0.0000
148.190.126.34,<->,133.178.227.57,0,0,3,3839,3,3839,0.506196000,0.9942
57.144.20.230,<->,0.195.210.42,0,0,3,1203,3,1203,0.505715000,0.1300
215.158.238.66,<->,131.1.195.221,3,2893,0,0,3,2893,0.504629000,1.2550
215.158.61.183,<->,8.176.8.189,0,0,3,3092,3,3092,0.504275000,1.3031
143.227.108.20,<->,136.25.188.242,0,0,3,3719,3,3719,0.504262000,0.9819
215.158.239.95,<->,195.127.163.56,3,1664,0,0,3,1664,0.504211000,0.1910
121.41.16.213,<->,92.27.219.194,0,0,3,947,3,947,0.504148000,1.0020
199.38.118.82,<->,136.25.188.209,0,0,3,1288,3,1288,0.502663000,1.1233
108.0.230.240,<->,92.27.219.165,0,0,3,2177,3,2177,0.502366000,1.1094
136.25.188.221,<->,131.144.113.188,3,4007,0,0,3,4007,0.502180000,1.1086
215.158.238.217,<->,98.219.126.175,3,1568,0,0,3,1568,0.500474000,1.0295
215.158.239.78,<->,29.209.59.173,3,3799,0,0,3,3799,0.499263000,0.8182
199.84.182.44,<->,0.195.210.46,0,0,3,1204,3,1204,0.498719000,0.2576
133.178.227.76,<->,113.23.117.46,3,3352,0,0,3,3352,0.498035000,0.8879
133.178.227.79,<->,113.23.101.169,3,3540,0,0,3,3540,0.496831000,1.3296
195.13.248.58,<->,136.25.188.252,0,0,3,1144,3,1144,0.495982000,0.2773
215.158.239.92,<->,133.224.119.41,3,3751,0,0,3,3751,0.495126000,1.3521
133.178.226.173,<->,133.146.0.36,3,2515,0,0,3,2515,0.494638000,1.1354
133.178.227.27,<->,111.150.187.176,3,3687,0,0,3,3687,0.494627000,1.4816
215.158.239.84,<->,204.226.12.195,3,1273,0,0,3,1273,0.494584000,0.3595
133.178.227.2,<->,8.192.205.0,3,3230,0,0,3,3230,0.493796000,1.4272
215.158.61.192,<->,8.252.222.248,0,0,3,1988,3,1988,0.493127000,1.0583
143.68.179.58,<->,136.25.188.196,0,0,3,1662,3,1662,0.491286000,0.2192
136.25.189.77,<->,114.25.48.20,3,3927,0,0,3,3927,0.491211000,1.0607
133.178.226.43,<->,8.222.48.162,3,1853,0,0,3,1853,0.490658000,0.0014
221.102.56.46,<->,192.67.169.78,0,0,3,1422,3,1422,0.489979000,0.0385
136.119.203.229,<->,136.25.188.29,0,0,3,488,3,488,0.489824000,0.0245
215.158.238.41,<->,100.224.166.115,3,1378,0,0,3,1378,0.488684000,1.1289
215.158.238.221,<->,106.188.251.34,3,3321,0,0,3,3321,0.488365000,1.3903
136.25.188.250,<->,100.224.202.146,3,1518,0,0,3,1518,0.485689000,0.5714
143.76.107.239,<->,136.25.188.238,0,0,3,1057,3,1057,0.485575000,0.6151
215.158.239.67,<->,0.195.253.228,3,3831,0,0,3,3831,0.485511000,0.1710
215.158.238.94,<->,192.204.170.197,3,3911,0,0,3,3911,0.485274000,1.0439
132.249.70.11,<->,53.86.225.211,3,2614,0,0,3,2614,0.483078000,0.6323
132.249.70.11,<->,53.208.241.220,3,1831,0,0,3,1831,0.482987000,0.5650
192.229.42.165,<->,133.178.227.138,0,0,3,2523,3,2523,0.481625000,0.1750
215.158.239.94,<->,207.57.169.119,3,1683,0,0,3,1683,0.481339000,0.2972
215.158.238.132,<->,126.219.194.134,3,3687,0,0,3,3687,0.480748000,0.6401
136.25.189.2,<->,106.188.253.129,3,3975,0,0,3,3975,0.479494000,0.9142
215.158.238.153,<->,0.195.237.14,3,3262,0,0,3,3262,0.478969000,1.3619
204.60.9.111,<->,136.25.188.226,0,0,3,351,3,351,0.477227000,0.0001
197.125.126.214,<->,136.25.189.78,0,0,3,4007,3,4007,0.477164000,1.4826
215.158.239.77,<->,199.20.30.212,3,1726,0,0,3,1726,0.477039000,0.3390
142.228.48.50,<->,136.25.188.252,0,0,3,1677,3,1677,0.476826000,0.2127
220.28.73.211,<->,215.158.238.203,0,0,3,1558,3,1558,0.476615000,1.4724
109.222.253.222,<->,53.234.241.192,3,854,0,0,3,854,0.476367000,0.7243
136.25.189.83,<->,29.214.73.136,3,4071,0,0,3,4071,0.476338000,1.5021
204.200.39.123,<->,136.25.188.252,0,0,3,752,3,752,0.475498000,0.1364
136.25.189.33,<->,8.215.68.54,3,1575,0,0,3,1575,0.474884000,0.5191
215.158.238.221,<->,68.231.10.150,3,3319,0,0,3,3319,0.474334000,1.3652
197.113.99.89,<->,136.25.188.237,0,0,3,303,3,303,0.474183000,1.2794
133.178.226.61,<->,126.219.132.237,3,3959,0,0,3,3959,0.473818000,0.6765
215.158.238.80,<->,197.125.126.249,3,3815,0,0,3,3815,0.472149000,1.1725
76.101.228.85,<->,8.252.222.38,0,0,3,319,3,319,0.471263000,0.2659
194.237.78.125,<->,136.25.188.174,0,0,3,1170,3,1170,0.471056000,0.2259
215.158.239.31,<->,122.29.158.171,3,1604,0,0,3,1604,0.471007000,1.1750
215.158.239.84,<->,204.0.168.219,3,303,0,0,3,303,0.470974000,0.5328
97.203.33.78,<->,8.183.24.211,0,0,3,1843,3,1843,0.470606000,1.4456
204.200.53.231,<->,136.25.188.255,0,0,3,1211,3,1211,0.470334000,0.3105
139.36.120.80,<->,8.176.8.247,0,0,3,3064,3,3064,0.470170000,0.0034
215.158.238.96,<->,8.191.15.32,3,3591,0,0,3,3591,0.469106000,1.1047
136.25.189.13,<->,133.224.119.35,3,2895,0,0,3,2895,0.469045000,1.0785
220.20.200.83,<->,149.19.161.148,3,3626,0,0,3,3626,0.467954000,0.1031
136.25.188.230,<->,100.224.202.146,3,1518,0,0,3,1518,0.467579000,0.9583
215.158.239.86,<->,126.219.191.27,3,4023,0,0,3,4023,0.467458000,1.4122
215.158.239.68,<->,199.20.29.73,3,1713,0,0,3,1713,0.466695000,0.2791
220.39.233.203,<->,215.158.238.72,0,0,3,3927,3,3927,0.466075000,0.9802
192.205.47.22,<->,133.178.226.198,0,0,3,2824,3,2824,0.465609000,1.1008
215.158.239.56,<->,142.228.91.8,3,1080,0,0,3,1080,0.465512000,0.7847
111.147.102.192,<->,54.69.66.169,3,245,0,0,3,245,0.465124000,0.2227
133.178.226.31,<->,126.219.247.8,3,3927,0,0,3,3927,0.464633000,0.3107
143.89.139.130,<->,136.25.188.222,0,0,3,1699,3,1699,0.464341000,0.2038
142.227.195.244,<->,136.25.188.46,0,0,3,350,3,350,0.463889000,0.0073
221.102.56.46,<->,109.3.156.160,0,0,3,1238,3,1238,0.463873000,0.1367
247.136.165.38,<->,199.98.194.147,3,159,0,0,3,159,0.460345000,1.2422
213.21.35.45,<->,8.220.190.86,0,0,3,2219,3,2219,0.460181000,1.1664
215.158.239.79,<->,195.83.118.249,3,1031,0,0,3,1031,0.458883000,0.7497
133.178.226.28,<->,131.1.195.250,3,2869,0,0,3,2869,0.458203000,1.1622
132.133.159.10,<->,8.182.224.203,0,0,3,904,3,904,0.457132000,0.0218
215.158.239.102,<->,131.78.56.2,3,1214,0,0,3,1214,0.455406000,0.2122
205.127.108.114,<->,111.20.168.155,0,0,3,886,3,886,0.454978000,0.9634
199.121.19.55,<->,136.25.188.196,0,0,3,1591,3,1591,0.454303000,0.3063
215.158.239.63,<->,159.215.65.150,3,2119,0,0,3,2119,0.453717000,0.8021
136.25.188.172,<->,65.27.220.219,3,3911,0,0,3,3911,0.453449000,1.5260
133.178.226.31,<->,113.23.20.105,3,4103,0,0,3,4103,0.453366000,1.3914
136.25.188.173,<->,133.103.34.36,3,765,0,0,3,765,0.452954000,0.0257
139.36.119.79,<->,136.25.189.209,0,0,3,1328,3,1328,0.452924000,0.3580
97.11.164.237,<->,53.214.115.253,3,1170,0,0,3,1170,0.452111000,0.3593
215.158.239.96,<->,199.15.164.233,3,1667,0,0,3,1667,0.451986000,0.2398
136.25.188.175,<->,8.42.43.23,3,3847,0,0,3,3847,0.451216000,1.4765
129.16.253.232,<->,91.251.118.203,0,0,3,1168,3,1168,0.451163000,0.0530
133.178.226.90,<->,131.144.113.160,3,3767,0,0,3,3767,0.449837000,0.8692
215.158.140.76,<->,29.214.211.22,3,3194,0,0,3,3194,0.449780000,1.5241
215.158.61.145,<->,136.25.189.210,0,0,3,2225,3,2225,0.449324000,1.5265
207.200.202.92,<->,8.252.222.242,0,0,3,351,3,351,0.446435000,1.3257
136.25.189.77,<->,120.155.8.89,3,3799,0,0,3,3799,0.446353000,1.0516
220.2.207.125,<->,8.220.184.183,0,0,3,1015,3,1015,0.446233000,0.0396
111.146.147.199,<->,53.200.100.108,3,1087,0,0,3,1087,0.445601000,0.2698
215.158.239.84,<->,196.0.204.198,3,1064,0,0,3,1064,0.445485000,0.4191
215.158.238.67,<->,119.196.23.42,3,3751,0,0,3,3751,0.445459000,0.9904
215.158.238.243,<->,131.144.116.219,3,3235,0,0,3,3235,0.445432000,0.7790
212.241.174.245,<->,80.27.152.229,0,0,3,2451,3,2451,0.445413000,1.1064
97.215.89.190,<->,80.42.177.25,0,0,3,3367,3,3367,0.444355000,1.4979
215.158.239.93,<->,207.63.122.56,3,788,0,0,3,788,0.444336000,0.2406
132.180.38.22,<->,8.220.202.4,0,0,3,537,3,537,0.443733000,0.1715
133.178.226.72,<->,133.56.180.18,3,1623,0,0,3,1623,0.441848000,1.0320
136.25.189.18,<->,29.212.180.201,3,3927,0,0,3,3927,0.439950000,1.0764
215.158.238.148,<->,27.178.41.49,3,4007,0,0,3,4007,0.439604000,1.2996
141.236.159.26,<->,80.27.154.150,0,0,3,1086,3,1086,0.439377000,0.0004
142.190.151.24,<->,136.25.188.177,0,0,3,1067,3,1067,0.439215000,0.5633
133.178.226.90,<->,96.155.60.194,3,596,0,0,3,596,0.439045000,0.4634
218.147.52.201,<->,8.176.40.207,0,0,3,959,3,959,0.438672000,0.0442
136.25.189.77,<->,96.156.169.235,3,2975,0,0,3,2975,0.438289000,0.5809
149.163.134.234,<->,133.178.227.76,0,0,3,3234,3,3234,0.437675000,1.3362
143.68.139.82,<->,136.25.188.54,0,0,3,1664,3,1664,0.437368000,0.2137
140.218.109.36,<->,133.178.226.19,0,0,3,3991,3,3991,0.437203000,0.7734
136.25.188.254,<->,104.3.163.5,3,3719,0,0,3,3719,0.436127000,1.3201
215.158.239.92,<->,199.20.31.54,3,350,0,0,3,350,0.436030000,0.0200
247.136.153.191,<->,22.249.49.193,3,4512,0,0,3,4512,0.435358000,1.1854
142.206.47.119,<->,136.25.188.163,0,0,3,1112,3,1112,0.435054000,0.6855
136.25.188.34,<->,100.224.141.62,3,1887,0,0,3,1887,0.434759000,0.9624
215.158.239.70,<->,199.52.40.31,3,1704,0,0,3,1704,0.431699000,0.2692
215.158.239.69,<->,199.20.30.174,3,303,0,0,3,303,0.431679000,1.3604
215.158.239.84,<->,199.20.5.25,3,1211,0,0,3,1211,0.430555000,0.4795
89.183.104.226,<->,33.57.78.122,3,154,0,0,3,154,0.430450000,0.3139
149.250.115.24,<->,136.25.188.197,0,0,3,3799,3,3799,0.429476000,1.3999
136.25.189.15,<->,29.211.93.5,3,3639,0,0,3,3639,0.429271000,0.9036
215.158.239.86,<->,196.106.235.223,3,1332,0,0,3,1332,0.429219000,0.1201
136.25.188.192,<->,56.51.205.162,3,2495,0,0,3,2495,0.428445000,0.5982
215.158.239.35,<->,29.211.5.208,3,2029,0,0,3,2029,0.427982000,0.8359
215.158.140.175,<->,8.222.7.182,3,3387,0,0,3,3387,0.425301000,1.4582
140.173.227.55,<->,136.25.188.47,0,0,3,3911,3,3911,0.424823000,0.9090
207.172.4.27,<->,136.25.188.224,0,0,3,1681,3,1681,0.424593000,0.2392
133.178.226.19,<->,27.178.41.41,3,3911,0,0,3,3911,0.424312000,1.3010
246.253.212.143,<->,207.177.131.98,3,714,0,0,3,714,0.423870000,0.2961
56.8.21.164,<->,8.182.141.52,0,0,3,684,3,684,0.423510000,0.2261
215.158.61.242,<->,136.25.188.29,0,0,3,2321,3,2321,0.423279000,1.5263
136.25.189.15,<->,131.2.102.25,3,2783,0,0,3,2783,0.422923000,0.7369
220.28.104.193,<->,215.158.140.225,0,0,3,729,3,729,0.422836000,0.5802
210.229.230.20,<->,132.212.130.128,3,292,0,0,3,292,0.422460000,1.0500
221.102.56.46,<->,6.75.141.235,0,0,3,795,3,795,0.421702000,0.0400
215.158.239.94,<->,29.212.198.190,3,3591,0,0,3,3591,0.420773000,0.7395
136.25.189.31,<->,33.209.219.75,3,2167,0,0,3,2167,0.420453000,1.4199
80.27.157.15,<->,69.175.101.3,3,802,0,0,3,802,0.420211000,0.1996
222.65.22.201,<->,8.49.69.111,3,1714,0,0,3,1714,0.419992000,0.0424
89.164.4.169,<->,8.52.187.70,0,0,3,1643,3,1643,0.419986000,0.2282
215.158.238.135,<->,106.188.183.85,3,1693,0,0,3,1693,0.419514000,0.7215
215.158.239.57,<->,195.70.6.245,3,1051,0,0,3,1051,0.418134000,0.2534
133.178.227.41,<->,106.188.251.54,3,3194,0,0,3,3194,0.416883000,0.8008
215.158.238.198,<->,33.209.219.37,3,3943,0,0,3,3943,0.416691000,1.5775
215.158.238.251,<->,131.144.116.5,3,3201,0,0,3,3201,0.415880000,1.5541
215.158.61.202,<->,8.176.8.241,0,0,3,2695,3,2695,0.415341000,1.4229
215.158.61.242,<->,8.176.8.207,0,0,3,2468,3,2468,0.415059000,1.0213
215.158.239.37,<->,96.135.154.158,3,3084,0,0,3,3084,0.414944000,0.0003
136.25.188.176,<->,29.214.108.83,3,4335,0,0,3,4335,0.414061000,1.5323
144.93.132.234,<->,53.230.38.178,3,2639,0,0,3,2639,0.413064000,0.6015
136.25.189.1,<->,29.212.199.236,3,4135,0,0,3,4135,0.413033000,1.5231
215.158.238.115,<->,122.159.245.164,3,4071,0,0,3,4071,0.411633000,1.4674
98.236.90.167,<->,8.37.194.3,3,3066,0,0,3,3066,0.410442000,0.2471
136.25.188.237,<->,29.214.64.198,3,3863,0,0,3,3863,0.410376000,1.2365
215.158.238.65,<->,136.138.112.201,3,3879,0,0,3,3879,0.409976000,0.9293
203.212.38.184,<->,139.163.96.101,0,0,3,801,3,801,0.409165000,1.2673
215.158.238.143,<->,65.27.220.208,3,3895,0,0,3,3895,0.408911000,1.5540
215.158.239.97,<->,199.20.30.155,3,1402,0,0,3,1402,0.408683000,0.2794
133.178.226.90,<->,114.25.48.54,3,4055,0,0,3,4055,0.408570000,1.4147
58.202.65.113,<->,8.252.221.238,0,0,3,946,3,946,0.408129000,0.0333
143.128.55.116,<->,136.25.188.252,0,0,3,642,3,642,0.407892000,1.2742
205.127.108.115,<->,33.233.141.72,0,0,3,305,3,305,0.407798000,0.4952
215.158.238.92,<->,136.139.59.107,3,3623,0,0,3,3623,0.406712000,1.4563
96.143.113.148,<->,8.52.222.23,0,0,3,1503,3,1503,0.406559000,0.0867
92.168.217.253,<->,50.136.172.227,3,933,0,0,3,933,0.405917000,0.2591
223.136.135.149,<->,92.27.219.222,0,0,3,768,3,768,0.405801000,1.2160
215.158.140.231,<->,106.188.228.59,3,3414,0,0,3,3414,0.405323000,1.4195
142.206.175.56,<->,136.25.188.178,0,0,3,1195,3,1195,0.404964000,0.4770
215.158.239.84,<->,8.215.68.90,3,3959,0,0,3,3959,0.404944000,1.3499
136.25.188.220,<->,111.151.70.41,3,3847,0,0,3,3847,0.404935000,1.4608
215.158.140.221,<->,8.222.7.186,3,3055,0,0,3,3055,0.404205000,1.5684
204.21.1.112,<->,136.25.188.160,0,0,3,1264,3,1264,0.403285000,0.2365
136.181.46.200,<->,53.240.9.138,3,1311,0,0,3,1311,0.402505000,0.1477
136.25.189.18,<->,56.161.218.61,3,3687,0,0,3,3687,0.401367000,1.2860
136.25.189.57,<->,126.219.194.19,3,3751,0,0,3,3751,0.400949000,0.5160
192.227.190.11,<->,133.178.226.70,0,0,3,3714,3,3714,0.400829000,1.5384
215.158.238.221,<->,29.214.109.128,3,3471,0,0,3,3471,0.400525000,0.9685
133.178.226.21,<->,8.222.48.131,3,2167,0,0,3,2167,0.400348000,0.0012
213.38.133.55,<->,8.55.230.253,3,291,0,0,3,291,0.399412000,1.3994
215.158.238.133,<->,65.27.228.202,3,3719,0,0,3,3719,0.398944000,1.3727
136.25.188.224,<->,69.150.169.151,3,3895,0,0,3,3895,0.398419000,1.2933
207.173.190.202,<->,136.25.188.45,0,0,3,1147,3,1147,0.398009000,1.5606
215.158.239.97,<->,196.92.146.126,3,1115,0,0,3,1115,0.396992000,1.1597
215.158.238.83,<->,131.144.114.230,3,3799,0,0,3,3799,0.395947000,1.5598
215.158.239.92,<->,207.62.34.168,3,1720,0,0,3,1720,0.395821000,1.5768
129.254.96.10,<->,80.38.33.214,0,0,3,1718,3,1718,0.394613000,0.0759
233.97.214.65,<->,129.6.83.0,0,0,3,1409,3,1409,0.394575000,0.1131
142.209.68.4,<->,136.25.188.238,0,0,3,1605,3,1605,0.393578000,1.1708
231.141.47.67,<->,215.158.239.70,0,0,3,1195,3,1195,0.393222000,1.2482
158.192.3.236,<->,136.25.188.242,0,0,3,3911,3,3911,0.393058000,1.3390
142.234.196.200,<->,133.178.226.7,0,0,3,3799,3,3799,0.392214000,1.0726
133.178.226.29,<->,99.192.168.180,3,3626,0,0,3,3626,0.392014000,1.5782
204.200.33.155,<->,136.25.188.55,0,0,3,713,3,713,0.390876000,0.0047
215.158.238.66,<->,126.219.194.170,3,3160,0,0,3,3160,0.390528000,1.4889
231.140.4.123,<->,215.158.239.49,0,0,3,1195,3,1195,0.389117000,0.7569
136.25.188.45,<->,106.188.236.136,3,3783,0,0,3,3783,0.389104000,1.0367
215.158.239.49,<->,195.83.109.240,3,1730,0,0,3,1730,0.387743000,0.3902
215.158.239.204,<->,133.102.42.226,3,4494,0,0,3,4494,0.387077000,1.2826
207.190.79.213,<->,136.25.188.198,0,0,3,1195,3,1195,0.387057000,0.5724
194.237.22.26,<->,136.25.188.176,0,0,3,1057,3,1057,0.386591000,0.4030
215.158.239.77,<->,207.166.149.157,3,1709,0,0,3,1709,0.386306000,1.0989
136.25.189.33,<->,96.156.169.194,3,3991,0,0,3,3991,0.386264000,1.2783
215.158.239.5,<->,118.20.114.86,3,4400,0,0,3,4400,0.385948000,1.5205
93.181.154.76,<->,92.27.219.217,0,0,3,154,3,154,0.385254000,0.2588
133.178.226.199,<->,8.47.189.8,3,2999,0,0,3,2999,0.383891000,1.0802
136.25.189.2,<->,96.156.169.192,3,4151,0,0,3,4151,0.383783000,0.5149
215.158.239.59,<->,29.212.180.235,3,3639,0,0,3,3639,0.383034000,1.2633
215.158.239.85,<->,120.154.131.46,3,3869,0,0,3,3869,0.382649000,0.6953
67.174.85.223,<->,8.252.222.135,0,0,3,1137,3,1137,0.382055000,0.4041
195.14.125.23,<->,136.25.188.46,0,0,3,1552,3,1552,0.381252000,0.3615
99.124.196.93,<->,8.52.246.196,0,0,3,1244,3,1244,0.379744000,0.0966
146.249.226.232,<->,8.252.222.151,0,0,3,1231,3,1231,0.379629000,0.5914
207.236.166.125,<->,136.25.188.198,0,0,3,558,3,558,0.379284000,0.5136
133.178.226.77,<->,122.158.245.103,3,3655,0,0,3,3655,0.378406000,1.2851
215.158.239.99,<->,199.50.4.111,3,946,0,0,3,946,0.378155000,1.5762
136.25.189.57,<->,29.214.73.171,3,3879,0,0,3,3879,0.378063000,1.1669
192.67.163.192,<->,145.95.195.20,3,887,0,0,3,887,0.377952000,1.1224
215.158.239.79,<->,29.211.228.250,3,2640,0,0,3,2640,0.377630000,0.6670
207.61.147.23,<->,136.25.188.226,0,0,3,1506,3,1506,0.377271000,0.0301
215.158.238.236,<->,126.219.246.252,3,3367,0,0,3,3367,0.376012000,1.0346
215.158.239.71,<->,80.56.79.22,3,3911,0,0,3,3911,0.374542000,0.5666
143.10.126.95,<->,136.25.188.225,0,0,3,1154,3,1154,0.373906000,0.5068
215.158.61.191,<->,8.176.8.191,0,0,3,1015,3,1015,0.373496000,1.3964
133.178.227.24,<->,18.202.90.200,3,3354,0,0,3,3354,0.373407000,1.0821
142.191.168.149,<->,136.25.188.199,0,0,3,1890,3,1890,0.372638000,0.0918
132.128.61.37,<->,109.1.26.128,0,0,3,1428,3,1428,0.371959000,0.1273
143.132.101.223,<->,136.25.188.178,0,0,3,1195,3,1195,0.371865000,1.4201
200.175.128.46,<->,53.161.71.169,3,514,0,0,3,514,0.371633000,1.4370
133.178.226.41,<->,98.219.126.140,3,2920,0,0,3,2920,0.371271000,0.5989
133.178.226.97,<->,8.191.7.183,3,1343,0,0,3,1343,0.370630000,0.1783
204.187.86.162,<->,136.25.188.252,0,0,3,1678,3,1678,0.370175000,1.4699
148.55.210.229,<->,133.178.226.7,0,0,3,3863,3,3863,0.370159000,0.7149
192.229.42.210,<->,133.178.227.249,0,0,3,3387,3,3387,0.370038000,1.3467
195.5.246.138,<->,136.25.188.238,0,0,3,1197,3,1197,0.369588000,0.7596
101.70.126.82,<->,53.196.115.48,3,594,0,0,3,594,0.369493000,1.0137
207.86.9.133,<->,136.25.188.209,0,0,3,1080,3,1080,0.369032000,0.2819
220.39.233.170,<->,215.158.238.96,0,0,3,4087,3,4087,0.368955000,0.5978
215.158.239.93,<->,142.248.56.234,3,1666,0,0,3,1666,0.368729000,0.2133
142.206.65.185,<->,136.25.188.198,0,0,3,1128,3,1128,0.367706000,1.2889
215.158.239.115,<->,215.158.61.182,3,2684,0,0,3,2684,0.367128000,1.0856
220.20.200.128,<->,121.105.194.190,3,1536,0,0,3,1536,0.366003000,0.1044
199.54.1.74,<->,8.252.222.141,0,0,3,1674,3,1674,0.365776000,0.1575
215.158.238.72,<->,197.125.126.181,3,3911,0,0,3,3911,0.365487000,0.9304
136.25.189.77,<->,56.161.218.36,3,4023,0,0,3,4023,0.365475000,0.9370
139.163.96.103,<->,104.240.21.99,3,1079,0,0,3,1079,0.365353000,1.2282
133.178.227.40,<->,131.22.233.139,3,3194,0,0,3,3194,0.365288000,1.0943
231.143.125.51,<->,136.25.188.226,0,0,3,1057,3,1057,0.364463000,0.5199
231.140.112.48,<->,215.158.239.95,0,0,3,1630,3,1630,0.363641000,0.2163
8.182.237.144,<->,6.21.254.23,3,637,0,0,3,637,0.362933000,0.0963
136.25.188.224,<->,69.150.168.134,3,3735,0,0,3,3735,0.362877000,1.2744
215.158.239.85,<->,29.213.219.104,3,4045,0,0,3,4045,0.361479000,1.1593
200.174.192.92,<->,53.68.248.17,3,599,0,0,3,599,0.361425000,1.4302
215.158.239.56,<->,195.70.4.190,3,913,0,0,3,913,0.361194000,0.0211
136.25.188.251,<->,100.224.202.171,3,1775,0,0,3,1775,0.359381000,1.2657
215.158.238.99,<->,65.27.220.218,3,3575,0,0,3,3575,0.357210000,1.5418
159.137.139.0,<->,133.178.227.16,0,0,3,4055,3,4055,0.357041000,1.1815
136.25.188.198,<->,33.209.217.239,3,4240,0,0,3,4240,0.356972000,1.1932
38.87.119.68,<->,0.195.210.42,0,0,3,475,3,475,0.356836000,1.4086
215.158.239.31,<->,215.158.127.150,3,1706,0,0,3,1706,0.356571000,1.3863
215.158.238.241,<->,131.144.115.155,3,3260,0,0,3,3260,0.356432000,1.5543
136.25.188.211,<->,120.154.221.214,3,3831,0,0,3,3831,0.355922000,0.8498
208.24.194.54,<->,8.43.155.247,0,0,3,678,3,678,0.355673000,0.3990
214.237.183.200,<->,8.220.238.62,0,0,3,1671,3,1671,0.355333000,0.5797
136.25.189.38,<->,96.156.169.219,3,2408,0,0,3,2408,0.354939000,1.1140
195.71.140.171,<->,136.25.188.255,0,0,3,1688,3,1688,0.354509000,0.1708
220.28.115.46,<->,136.25.188.194,0,0,3,2890,3,2890,0.354308000,1.5805
136.25.189.14,<->,29.213.219.69,3,4222,0,0,3,4222,0.353809000,1.5412
136.25.188.226,<->,112.220.206.107,3,608,0,0,3,608,0.353796000,1.6170
215.158.238.47,<->,111.150.186.204,3,4055,0,0,3,4055,0.353689000,1.6287
94.192.165.151,<->,8.252.222.149,0,0,3,1737,3,1737,0.353548000,0.1881
136.25.188.237,<->,104.154.137.213,3,3895,0,0,3,3895,0.353546000,1.5606
215.158.238.176,<->,8.192.205.86,3,4087,0,0,3,4087,0.353451000,1.5815
220.20.200.26,<->,193.32.107.107,3,3222,0,0,3,3222,0.353091000,1.0629
133.178.227.14,<->,89.86.110.235,3,3251,0,0,3,3251,0.352173000,1.3096
8.182.224.87,<->,6.20.24.119,3,1342,0,0,3,1342,0.351889000,0.7427
204.185.84.230,<->,136.25.188.252,0,0,3,1680,3,1680,0.351791000,0.3900
136.25.188.230,<->,80.57.141.206,3,518,0,0,3,518,0.351697000,0.0552
215.158.140.231,<->,104.3.168.55,3,3471,0,0,3,3471,0.351239000,0.9245
53.69.57.132,<->,48.52.86.232,0,0,3,1533,3,1533,0.350725000,0.9568
142.209.126.75,<->,136.25.188.254,0,0,3,1500,3,1500,0.350394000,0.7721
215.158.238.96,<->,131.2.115.236,3,2655,0,0,3,2655,0.350165000,1.2064
133.178.226.18,<->,113.23.104.223,3,3703,0,0,3,3703,0.349666000,1.4052
136.25.189.14,<->,118.20.100.87,3,4119,0,0,3,4119,0.349038000,1.3595
143.13.230.223,<->,136.25.188.253,0,0,3,1677,3,1677,0.348249000,0.2418
195.126.60.183,<->,136.25.188.54,0,0,3,1681,3,1681,0.348210000,0.2298
204.200.36.160,<->,136.25.188.225,0,0,3,1057,3,1057,0.346304000,0.2812
197.125.117.130,<->,133.178.227.79,0,0,3,3192,3,3192,0.345480000,0.9734
215.158.239.33,<->,215.158.127.149,3,1810,0,0,3,1810,0.343885000,1.1337
215.158.238.40,<->,145.158.254.254,3,2274,0,0,3,2274,0.343073000,1.1639
215.158.140.241,<->,29.214.108.248,3,3213,0,0,3,3213,0.342687000,1.0841
133.178.226.71,<->,8.53.216.225,3,3244,0,0,3,3244,0.342483000,0.9222
215.158.239.76,<->,199.106.98.229,3,1173,0,0,3,1173,0.342477000,0.5795
215.158.140.83,<->,8.40.51.98,3,3431,0,0,3,3431,0.342119000,1.2845
207.162.188.43,<->,8.182.226.78,0,0,3,1513,3,1513,0.342086000,0.3593
114.41.29.88,<->,99.74.26.152,0,0,3,1400,3,1400,0.341776000,0.2823
215.158.238.123,<->,69.31.238.195,3,4007,0,0,3,4007,0.341327000,1.1115
215.158.140.75,<->,106.188.228.55,3,3191,0,0,3,3191,0.340548000,0.5039
216.184.1.125,<->,136.25.188.247,0,0,3,902,3,902,0.340546000,0.1397
136.25.188.161,<->,104.3.163.54,3,4039,0,0,3,4039,0.340005000,1.4991
215.158.239.48,<->,196.105.62.165,3,1544,0,0,3,1544,0.339772000,1.5116
143.23.240.237,<->,136.25.188.222,0,0,3,801,3,801,0.339635000,0.2688
215.158.239.94,<->,98.28.95.88,3,4087,0,0,3,4087,0.339380000,1.5668
195.15.42.188,<->,136.25.188.253,0,0,3,1042,3,1042,0.339117000,0.2637
215.158.239.56,<->,207.114.162.108,3,2727,0,0,3,2727,0.338755000,0.1707
212.100.244.206,<->,8.52.185.88,0,0,3,799,3,799,0.338656000,0.0470
133.178.227.41,<->,131.22.233.144,3,3400,0,0,3,3400,0.338621000,1.5785
215.158.238.148,<->,113.23.20.251,3,4007,0,0,3,4007,0.338176000,1.5115
215.158.238.115,<->,119.196.23.52,3,3783,0,0,3,3783,0.338004000,1.4984
133.178.226.80,<->,126.219.247.87,3,3959,0,0,3,3959,0.337737000,0.7362
215.158.239.86,<->,196.90.73.223,3,1376,0,0,3,1376,0.337561000,1.5601
133.54.21.231,<->,0.37.116.157,3,426,0,0,3,426,0.337376000,1.1996
220.28.108.254,<->,136.25.189.42,0,0,3,627,3,627,0.336690000,0.0729
215.158.239.79,<->,199.20.31.127,3,303,0,0,3,303,0.336433000,1.3799
96.232.239.40,<->,92.27.219.36,0,0,3,154,3,154,0.334921000,0.8172
136.25.188.197,<->,29.214.108.91,3,3927,0,0,3,3927,0.334118000,1.4690
215.158.238.190,<->,126.219.246.238,3,4183,0,0,3,4183,0.334087000,1.2339
215.158.238.196,<->,106.188.228.58,3,3239,0,0,3,3239,0.333677000,1.3772
144.87.238.89,<->,8.182.243.35,0,0,3,858,3,858,0.333458000,0.1766
148.55.210.208,<->,133.178.226.18,0,0,3,3943,3,3943,0.332850000,1.4284
136.25.188.172,<->,27.178.41.56,3,3911,0,0,3,3911,0.331993000,0.7955
247.136.222.54,<->,221.102.143.189,3,423,0,0,3,423,0.331920000,1.0780
215.158.239.99,<->,199.20.28.97,3,1874,0,0,3,1874,0.331030000,0.0499
197.113.99.69,<->,136.25.188.55,0,0,3,1679,3,1679,0.329880000,0.5505
136.25.188.253,<->,41.140.18.236,3,1630,0,0,3,1630,0.329352000,0.0365
199.121.63.52,<->,136.25.188.220,0,0,3,1942,3,1942,0.328680000,1.1365
215.158.239.76,<->,199.20.22.69,3,2343,0,0,3,2343,0.328641000,1.5050
215.158.239.49,<->,196.105.62.165,3,1496,0,0,3,1496,0.328467000,0.7988
136.25.188.255,<->,111.151.239.44,3,3959,0,0,3,3959,0.328218000,1.5128
215.158.238.236,<->,29.211.122.151,3,3928,0,0,3,3928,0.327122000,1.0626
197.113.99.231,<->,136.25.188.163,0,0,3,1677,3,1677,0.326859000,1.3998
215.158.239.96,<->,199.20.4.209,3,1658,0,0,3,1658,0.325643000,0.7095
136.128.35.207,<->,133.178.226.191,0,0,3,486,3,486,0.324168000,0.0288
215.158.238.190,<->,148.190.126.56,3,3464,0,0,3,3464,0.323730000,1.4875
136.25.188.44,<->,8.42.43.51,3,3943,0,0,3,3943,0.323240000,0.6953
207.60.189.167,<->,136.25.188.209,0,0,3,1195,3,1195,0.322564000,0.4711
215.158.239.78,<->,6.15.207.74,3,3607,0,0,3,3607,0.322421000,0.7996
102.15.50.166,<->,8.52.178.59,0,0,3,722,3,722,0.322034000,0.1247
215.158.238.74,<->,112.220.206.22,3,3399,0,0,3,3399,0.321920000,1.0043
215.158.140.92,<->,61.72.108.192,3,3889,0,0,3,3889,0.321387000,1.0894
215.158.238.122,<->,143.20.121.168,3,3911,0,0,3,3911,0.321177000,1.1760
215.158.238.73,<->,197.125.126.183,3,3943,0,0,3,3943,0.321143000,1.6753
215.158.140.92,<->,33.209.219.12,3,3589,0,0,3,3589,0.320946000,0.8325
215.158.238.75,<->,29.213.218.185,3,1583,0,0,3,1583,0.320825000,0.3922
215.158.239.92,<->,96.156.169.193,3,4039,0,0,3,4039,0.320532000,1.4301
215.158.239.84,<->,199.20.29.159,3,1290,0,0,3,1290,0.320339000,0.5096
215.158.239.45,<->,111.52.91.236,3,1461,0,0,3,1461,0.319860000,0.0010
200.174.28.185,<->,53.161.98.43,3,1525,0,0,3,1525,0.319552000,0.6672
159.237.239.226,<->,17.61.177.228,3,2242,0,0,3,2242,0.319413000,0.2022
136.25.189.59,<->,125.216.43.7,3,2783,0,0,3,2783,0.319054000,0.8909
199.82.159.149,<->,136.25.188.163,0,0,3,320,3,320,0.318983000,1.0060
210.158.44.0,<->,111.151.238.96,3,4123,0,0,3,4123,0.318372000,0.0191
215.158.238.134,<->,113.23.20.105,3,3879,0,0,3,3879,0.318275000,1.1299
204.62.84.238,<->,136.25.188.198,0,0,3,1696,3,1696,0.317886000,1.6201
136.25.189.80,<->,29.211.5.251,3,3959,0,0,3,3959,0.317529000,0.6768
215.158.239.96,<->,199.20.29.122,3,1386,0,0,3,1386,0.317161000,0.3596
136.18.5.209,<->,8.182.227.209,0,0,3,2034,3,2034,0.316841000,0.8188
203.48.63.129,<->,0.195.210.46,0,0,3,2092,3,2092,0.316563000,0.4882
136.25.188.240,<->,89.153.100.167,3,1624,0,0,3,1624,0.316214000,0.2600
215.158.239.96,<->,195.55.120.128,3,1211,0,0,3,1211,0.316134000,0.5091
199.120.37.42,<->,136.25.188.241,0,0,3,1677,3,1677,0.315782000,0.5181
215.158.238.141,<->,57.210.107.42,3,3879,0,0,3,3879,0.315312000,1.4508
200.175.111.169,<->,53.68.106.76,3,1767,0,0,3,1767,0.315109000,0.8587
215.158.238.212,<->,215.158.43.1,3,976,0,0,3,976,0.315081000,0.9808
216.144.221.244,<->,215.158.140.193,0,0,3,1191,3,1191,0.314812000,1.2652
149.17.149.6,<->,89.153.90.223,0,0,3,228,3,228,0.313897000,0.9982
139.163.96.101,<->,38.90.74.141,3,801,0,0,3,801,0.313092000,1.2911
216.184.2.232,<->,215.158.239.70,0,0,3,3623,3,3623,0.311807000,1.0247
215.158.238.74,<->,8.188.227.11,3,3975,0,0,3,3975,0.311703000,0.7876
215.158.238.135,<->,69.150.169.181,3,3799,0,0,3,3799,0.310036000,1.6301
215.158.239.79,<->,199.20.28.164,3,1681,0,0,3,1681,0.310036000,0.3596
215.158.238.133,<->,136.139.59.124,3,1667,0,0,3,1667,0.309785000,1.0450
195.12.243.37,<->,136.25.188.252,0,0,3,994,3,994,0.308390000,0.3456
215.158.238.113,<->,119.196.23.54,3,3591,0,0,3,3591,0.308384000,0.6062
215.158.238.132,<->,33.209.217.212,3,4327,0,0,3,4327,0.308078000,1.4250
215.158.127.47,<->,8.176.8.83,0,0,3,2404,3,2404,0.307309000,1.3476
215.158.239.68,<->,196.89.22.204,3,1195,0,0,3,1195,0.306993000,0.6147
212.70.217.70,<->,133.178.226.28,0,0,3,3623,3,3623,0.306520000,1.1605
207.60.128.142,<->,136.25.188.45,0,0,3,1674,3,1674,0.305968000,0.3143
215.158.239.78,<->,207.228.203.207,3,1078,0,0,3,1078,0.305885000,0.9453
136.25.189.34,<->,96.156.169.160,3,3055,0,0,3,3055,0.305790000,0.8438
133.178.227.16,<->,29.211.6.201,3,3327,0,0,3,3327,0.305264000,1.6514
136.25.189.29,<->,29.213.219.87,3,4268,0,0,3,4268,0.304983000,1.3544
54.36.26.19,<->,48.55.77.23,0,0,3,1212,3,1212,0.304363000,1.6575
197.113.99.237,<->,136.25.188.226,0,0,3,1736,3,1736,0.303858000,1.2601
204.187.243.126,<->,136.25.188.224,0,0,3,1681,3,1681,0.303759000,0.8799
215.158.239.50,<->,29.212.198.169,3,3927,0,0,3,3927,0.302871000,1.5579
215.158.238.141,<->,131.144.114.208,3,3943,0,0,3,3943,0.302516000,1.4882
204.63.66.52,<->,136.25.188.220,0,0,3,1652,3,1652,0.301903000,0.2536
215.158.238.132,<->,113.23.104.215,3,3479,0,0,3,3479,0.301475000,1.4430
215.158.239.92,<->,199.20.31.201,3,536,0,0,3,536,0.301217000,0.2709
136.25.189.32,<->,29.212.199.58,3,3799,0,0,3,3799,0.300699000,1.3323
215.158.132.36,<->,133.32.39.1,0,0,3,330,3,330,0.300586000,0.0379
215.158.239.87,<->,207.213.17.12,3,1402,0,0,3,1402,0.300396000,0.4602
117.153.13.77,<->,100.92.178.214,0,0,3,274,3,274,0.299757000,0.7350
138.127.205.200,<->,109.222.255.204,0,0,3,2033,3,2033,0.299730000,0.2902
136.25.188.162,<->,116.106.61.237,3,3671,0,0,3,3671,0.299556000,1.5328
206.198.8.43,<->,92.27.219.237,0,0,3,456,3,456,0.299521000,1.2484
215.158.238.119,<->,100.224.166.122,3,2232,0,0,3,2232,0.299486000,1.1158
215.158.239.76,<->,194.232.207.62,3,1062,0,0,3,1062,0.299346000,0.1891
253.66.34.47,<->,8.52.171.120,0,0,3,767,3,767,0.298812000,0.0665
133.178.227.24,<->,104.3.168.53,3,3308,0,0,3,3308,0.298797000,0.9708
215.158.239.77,<->,199.20.29.218,3,1030,0,0,3,1030,0.298247000,0.2695
133.178.226.90,<->,65.27.228.196,3,3879,0,0,3,3879,0.298144000,1.4406
133.178.227.55,<->,133.56.180.28,3,1376,0,0,3,1376,0.298115000,1.1382
215.158.140.93,<->,89.86.110.196,3,3892,0,0,3,3892,0.297732000,1.3764
80.27.159.28,<->,74.87.133.36,3,2727,0,0,3,2727,0.297066000,0.9542
215.158.239.84,<->,199.50.72.119,3,1170,0,0,3,1170,0.296995000,0.2544
136.25.189.77,<->,96.156.169.150,3,4007,0,0,3,4007,0.296072000,0.9600
215.158.140.60,<->,215.158.6.203,3,3304,0,0,3,3304,0.295087000,1.3491
136.25.189.80,<->,29.212.198.200,3,3639,0,0,3,3639,0.294937000,0.9167
215.158.239.223,<->,215.158.61.243,3,3149,0,0,3,3149,0.294911000,1.2133
8.252.222.134,<->,4.120.148.132,3,1082,0,0,3,1082,0.294809000,0.3346
132.213.199.19,<->,8.52.154.27,0,0,3,626,3,626,0.294670000,0.0879
136.25.188.222,<->,113.23.104.220,3,2632,0,0,3,2632,0.293978000,0.9104
215.158.140.75,<->,113.23.66.41,3,3317,0,0,3,3317,0.293870000,0.8967
142.167.138.160,<->,136.25.188.255,0,0,3,1661,3,1661,0.292599000,0.5315
215.158.140.229,<->,131.144.114.235,3,3358,0,0,3,3358,0.292576000,0.7004
136.25.189.82,<->,126.219.194.60,3,3985,0,0,3,3985,0.292044000,0.5012
215.158.140.229,<->,29.211.6.183,3,3272,0,0,3,3272,0.291720000,1.2208
133.178.226.67,<->,100.216.78.145,3,1674,0,0,3,1674,0.290897000,1.4784
133.178.227.79,<->,113.23.14.219,3,3137,0,0,3,3137,0.289451000,1.2122
215.158.61.191,<->,8.176.8.102,0,0,3,2506,3,2506,0.288917000,1.5080
136.25.189.30,<->,8.33.226.56,3,3703,0,0,3,3703,0.288431000,1.5182
215.158.238.83,<->,8.42.43.89,3,3767,0,0,3,3767,0.288260000,0.4606
192.228.25.251,<->,133.178.226.213,0,0,3,3987,3,3987,0.288013000,1.5017
50.224.110.86,<->,39.188.171.31,3,792,0,0,3,792,0.287180000,1.1624
215.158.239.58,<->,199.20.31.178,3,1682,0,0,3,1682,0.286443000,0.6995
215.158.238.133,<->,122.158.49.131,3,3071,0,0,3,3071,0.286442000,1.6206
246.253.253.5,<->,53.69.91.156,3,1833,0,0,3,1833,0.285935000,0.3116
195.54.103.253,<->,136.25.188.238,0,0,3,1042,3,1042,0.285474000,0.1734
133.178.227.14,<->,106.188.251.57,3,3288,0,0,3,3288,0.285382000,1.5924
215.158.238.80,<->,119.196.23.9,3,3991,0,0,3,3991,0.285305000,1.3803
215.158.238.134,<->,113.23.20.233,3,3799,0,0,3,3799,0.285071000,0.6401
118.234.178.113,<->,89.183.104.227,0,0,3,4122,3,4122,0.284636000,1.5745
215.158.238.80,<->,65.27.220.202,3,3895,0,0,3,3895,0.284599000,1.0465
69.103.121.183,<->,8.252.222.28,0,0,3,880,3,880,0.283801000,0.2031
215.158.238.83,<->,131.2.115.254,3,3863,0,0,3,3863,0.283670000,1.7073
136.139.59.124,<->,136.25.188.211,0,0,3,1688,3,1688,0.283599000,0.7660
215.158.239.76,<->,207.213.128.20,3,1170,0,0,3,1170,0.282707000,0.2110
215.158.238.82,<->,131.144.113.216,3,3719,0,0,3,3719,0.282553000,0.9322
35.56.96.200,<->,35.55.57.164,3,365,0,0,3,365,0.282168000,1.1149
143.13.230.223,<->,136.25.188.160,0,0,3,1675,3,1675,0.281499000,0.2417
195.12.18.255,<->,136.25.188.196,0,0,3,692,3,692,0.281426000,0.0071
144.92.40.72,<->,106.5.208.194,3,684,0,0,3,684,0.281376000,1.3403
215.158.238.75,<->,8.179.43.65,3,3943,0,0,3,3943,0.280711000,1.3206
195.41.132.186,<->,136.25.188.252,0,0,3,1092,3,1092,0.279960000,0.3050
133.178.226.90,<->,80.47.228.215,3,4071,0,0,3,4071,0.279656000,1.0897
215.158.239.18,<->,8.241.236.231,3,1835,0,0,3,1835,0.278394000,1.3834
133.178.226.197,<->,80.47.33.42,3,2022,0,0,3,2022,0.277527000,1.1174
210.158.44.246,<->,121.79.36.182,3,1949,0,0,3,1949,0.277205000,0.2238
215.158.239.195,<->,98.28.95.171,3,1322,0,0,3,1322,0.276968000,0.0727
68.72.133.189,<->,8.252.221.223,0,0,3,929,3,929,0.276551000,0.0266
136.25.188.227,<->,8.255.92.246,3,4071,0,0,3,4071,0.276536000,1.3763
133.178.227.79,<->,106.188.253.64,3,3340,0,0,3,3340,0.276312000,1.5577
133.178.227.24,<->,8.222.2.38,3,3324,0,0,3,3324,0.276115000,1.5377
230.78.131.242,<->,8.9.165.191,0,0,3,948,3,948,0.276090000,1.6961
215.158.238.33,<->,192.204.170.200,3,3911,0,0,3,3911,0.275632000,1.1340
141.61.66.157,<->,80.27.155.70,0,0,3,1318,3,1318,0.275468000,0.4105
249.101.107.180,<->,53.213.93.115,3,2491,0,0,3,2491,0.273731000,0.1135
136.25.189.59,<->,56.28.207.192,3,2911,0,0,3,2911,0.273540000,0.9806
136.139.59.127,<->,136.25.188.226,0,0,3,3719,3,3719,0.273010000,1.4972
215.158.239.69,<->,196.107.149.137,3,1861,0,0,3,1861,0.272464000,0.4599
133.178.227.24,<->,8.240.116.196,3,3287,0,0,3,3287,0.272438000,0.8380
136.25.189.34,<->,29.212.199.2,3,3831,0,0,3,3831,0.271990000,1.4983
53.148.20.156,<->,48.53.94.227,0,0,3,988,3,988,0.271464000,0.5828
215.158.238.123,<->,99.192.168.162,3,3936,0,0,3,3936,0.270980000,1.1260
136.25.188.208,<->,131.1.195.250,3,4178,0,0,3,4178,0.270307000,0.5933
215.158.239.58,<->,199.106.249.74,3,1686,0,0,3,1686,0.270073000,0.2597
199.120.37.42,<->,136.25.188.163,0,0,3,1677,3,1677,0.268742000,0.4985
142.206.47.119,<->,136.25.188.198,0,0,3,1112,3,1112,0.268687000,0.6389
215.158.239.56,<->,196.109.216.251,3,1690,0,0,3,1690,0.268328000,0.2793
133.178.227.16,<->,29.211.165.103,3,3466,0,0,3,3466,0.268256000,1.6074
199.68.77.60,<->,136.25.188.242,0,0,3,315,3,315,0.267961000,0.5755
215.158.239.57,<->,207.213.14.202,3,1656,0,0,3,1656,0.267624000,0.3196
142.247.218.79,<->,136.25.188.175,0,0,3,1263,3,1263,0.267402000,0.7457
215.158.239.113,<->,129.222.39.232,3,383,0,0,3,383,0.267394000,1.0237
205.224.85.211,<->,92.27.8.30,0,0,3,1702,3,1702,0.266905000,0.3029
215.158.239.86,<->,113.23.14.217,3,3783,0,0,3,3783,0.266155000,1.3405
92.168.217.229,<->,50.136.175.234,3,948,0,0,3,948,0.266098000,0.8276
36.116.252.253,<->,8.252.221.230,0,0,3,1263,3,1263,0.266039000,1.5581
221.102.56.46,<->,192.64.112.18,0,0,3,889,3,889,0.263832000,0.0667
199.111.153.254,<->,8.182.241.177,0,0,3,1653,3,1653,0.263794000,0.0049
215.158.238.94,<->,33.209.217.202,3,4121,0,0,3,4121,0.263732000,0.6388
136.25.188.163,<->,131.144.113.189,3,3687,0,0,3,3687,0.263350000,1.4352
215.158.238.67,<->,148.55.210.228,3,3767,0,0,3,3767,0.262950000,1.3867
215.158.238.134,<->,131.36.198.41,3,3735,0,0,3,3735,0.262432000,1.4230
133.178.227.24,<->,69.150.169.162,3,3927,0,0,3,3927,0.262357000,1.2997
136.25.188.45,<->,80.47.111.74,3,3495,0,0,3,3495,0.262268000,0.9288
215.158.239.96,<->,195.7.49.169,3,1061,0,0,3,1061,0.262115000,0.3107
215.158.239.92,<->,204.227.215.7,3,1036,0,0,3,1036,0.261754000,0.3770
215.158.239.76,<->,199.20.30.80,3,2786,0,0,3,2786,0.261294000,1.4414
53.231.66.3,<->,48.54.81.68,0,0,3,4428,3,4428,0.261231000,1.2826
220.20.200.107,<->,132.216.159.4,3,2610,0,0,3,2610,0.260750000,0.0061
215.158.239.56,<->,199.20.31.123,3,1211,0,0,3,1211,0.260512000,0.8594
215.158.238.67,<->,27.178.41.9,3,3879,0,0,3,3879,0.260217000,1.0471
192.64.220.167,<->,149.132.192.46,3,224,0,0,3,224,0.259640000,0.3419
215.158.238.217,<->,215.158.58.203,3,1895,0,0,3,1895,0.259246000,0.0055
113.5.147.22,<->,111.147.92.14,0,0,3,1748,3,1748,0.258927000,1.0168
215.158.239.41,<->,131.95.192.196,3,2874,0,0,3,2874,0.258556000,1.3852
220.28.85.14,<->,136.25.188.171,0,0,3,1969,3,1969,0.258398000,0.8452
221.102.56.46,<->,192.67.185.2,0,0,3,1654,3,1654,0.257606000,0.0381
215.158.238.196,<->,8.50.170.174,3,3332,0,0,3,3332,0.257567000,1.6493
215.158.239.49,<->,196.104.222.88,3,1680,0,0,3,1680,0.257335000,0.4192
207.59.39.216,<->,136.25.188.241,0,0,3,1660,3,1660,0.256224000,0.3142
215.158.61.243,<->,8.176.8.179,0,0,3,3397,3,3397,0.255902000,0.4355
142.43.185.21,<->,8.20.87.206,0,0,3,1338,3,1338,0.255794000,0.8834
215.158.239.101,<->,215.158.42.215,3,1596,0,0,3,1596,0.254096000,0.4216
145.116.223.7,<->,133.178.226.220,0,0,3,1471,3,1471,0.253438000,1.6865
149.250.115.59,<->,136.25.188.178,0,0,3,3527,3,3527,0.253427000,0.7902
8.182.226.78,<->,6.20.41.44,3,1463,0,0,3,1463,0.253287000,1.2625
136.25.189.46,<->,126.219.194.60,3,4167,0,0,3,4167,0.252947000,0.3740
113.22.2.222,<->,100.228.42.100,0,0,3,816,3,816,0.251961000,0.1914
215.158.238.64,<->,122.158.51.86,3,3767,0,0,3,3767,0.251509000,0.8172
91.251.106.110,<->,8.45.162.111,3,2270,0,0,3,2270,0.251058000,0.2965
215.158.238.190,<->,114.94.161.244,3,3455,0,0,3,3455,0.250690000,1.1384
220.39.233.203,<->,136.25.188.221,0,0,3,3799,3,3799,0.250501000,0.5412
215.158.239.97,<->,207.166.149.157,3,1709,0,0,3,1709,0.249531000,1.0387
133.178.227.57,<->,133.56.180.50,3,1559,0,0,3,1559,0.249462000,1.0509
215.158.239.50,<->,29.211.228.235,3,4072,0,0,3,4072,0.249142000,1.7411
215.158.239.56,<->,207.236.248.0,3,1115,0,0,3,1115,0.249014000,0.4536
215.158.239.49,<->,196.88.18.102,3,1696,0,0,3,1696,0.248509000,0.3171
215.158.239.92,<->,199.20.5.74,3,303,0,0,3,303,0.248311000,1.0799
215.158.239.113,<->,215.158.61.36,3,1539,0,0,3,1539,0.248140000,0.0466
215.158.239.96,<->,199.20.28.140,3,1685,0,0,3,1685,0.248117000,0.3195
215.158.239.93,<->,212.70.75.122,3,3783,0,0,3,3783,0.247614000,1.5714
215.158.238.64,<->,131.2.115.228,3,3927,0,0,3,3927,0.246669000,1.2591
215.158.238.95,<->,136.139.59.119,3,3511,0,0,3,3511,0.246428000,0.7070
136.25.188.210,<->,131.144.114.229,3,3767,0,0,3,3767,0.245850000,1.7389
215.158.239.69,<->,56.161.218.52,3,4055,0,0,3,4055,0.245491000,1.1518
215.158.239.51,<->,207.188.186.39,3,303,0,0,3,303,0.245024000,0.2831
215.158.238.64,<->,69.150.169.42,3,3703,0,0,3,3703,0.244993000,1.1826
220.28.85.14,<->,133.178.226.23,0,0,3,1434,3,1434,0.244978000,1.7036
247.136.211.104,<->,64.214.57.24,3,747,0,0,3,747,0.244685000,1.0599
199.70.97.127,<->,136.25.188.162,0,0,3,1064,3,1064,0.244675000,0.4073
215.158.239.231,<->,111.151.237.68,3,1717,0,0,3,1717,0.244347000,1.7363
136.25.188.254,<->,104.3.168.216,3,3895,0,0,3,3895,0.244100000,1.6045
136.25.189.0,<->,120.154.131.37,3,3911,0,0,3,3911,0.243767000,1.3360
136.25.189.88,<->,80.56.79.33,3,3543,0,0,3,3543,0.243180000,1.0507
133.178.226.77,<->,33.209.217.221,3,4275,0,0,3,4275,0.242619000,1.4500
215.158.239.70,<->,72.23.6.0,3,4071,0,0,3,4071,0.242446000,1.4011
215.158.239.48,<->,199.20.30.101,3,1052,0,0,3,1052,0.241180000,0.5200
136.25.188.227,<->,131.36.198.50,3,3799,0,0,3,3799,0.240420000,1.5002
105.201.188.253,<->,102.50.97.98,0,0,3,294,3,294,0.240361000,0.9821
207.173.95.133,<->,136.25.188.253,0,0,3,1231,3,1231,0.240151000,0.7798
136.25.189.14,<->,89.80.251.9,3,3751,0,0,3,3751,0.239621000,1.4653
215.158.238.104,<->,113.23.20.126,3,3815,0,0,3,3815,0.239094000,1.2510
143.20.121.150,<->,133.178.226.30,0,0,3,3895,3,3895,0.238317000,1.0921
215.158.239.57,<->,192.204.123.40,3,3927,0,0,3,3927,0.238102000,1.2525
139.246.60.47,<->,8.43.211.17,0,0,3,1175,3,1175,0.237968000,0.1561
196.88.217.33,<->,136.25.188.252,0,0,3,1087,3,1087,0.237688000,0.2972
196.247.79.182,<->,136.25.188.196,0,0,3,1682,3,1682,0.237603000,0.2572
215.158.239.50,<->,199.20.28.111,3,1683,0,0,3,1683,0.237382000,0.3203
93.181.154.108,<->,92.27.219.145,0,0,3,150,3,150,0.237117000,0.7142
255.17.29.137,<->,8.220.205.146,0,0,3,828,3,828,0.236718000,0.2048
215.158.239.95,<->,196.1.8.118,3,1870,0,0,3,1870,0.236261000,0.1000
215.158.239.117,<->,127.246.120.125,3,1967,0,0,3,1967,0.235952000,0.2271
111.146.144.234,<->,53.68.162.248,3,2299,0,0,3,2299,0.235363000,1.0419
111.151.237.32,<->,97.183.197.231,0,0,3,1335,3,1335,0.235130000,0.0001
143.10.82.126,<->,136.25.188.175,0,0,3,1344,3,1344,0.235082000,0.2994
215.158.140.92,<->,193.39.68.244,3,3159,0,0,3,3159,0.234965000,0.8233
139.160.226.234,<->,136.25.188.161,0,0,3,3895,3,3895,0.234801000,1.6173
215.158.239.56,<->,199.20.31.224,3,1117,0,0,3,1117,0.234101000,1.3996
215.158.239.87,<->,120.154.131.7,3,4276,0,0,3,4276,0.234048000,0.9595
215.158.239.19,<->,91.57.162.183,3,1840,0,0,3,1840,0.233844000,1.1815
221.102.143.189,<->,80.41.2.180,0,0,3,423,3,423,0.232893000,1.4380
75.214.238.0,<->,8.252.221.223,0,0,3,955,3,955,0.230935000,0.2212
215.158.239.87,<->,29.214.73.167,3,3751,0,0,3,3751,0.230817000,1.4724
114.174.92.82,<->,80.42.131.57,0,0,3,319,3,319,0.230022000,0.8889
215.158.239.51,<->,207.63.21.191,3,1667,0,0,3,1667,0.229968000,0.2395
98.101.95.18,<->,8.182.224.248,0,0,3,1943,3,1943,0.229493000,1.2058
215.158.239.85,<->,199.20.28.227,3,1091,0,0,3,1091,0.228650000,0.7701
101.70.115.232,<->,53.161.31.120,3,1595,0,0,3,1595,0.228415000,0.0980
136.25.189.44,<->,8.215.68.58,3,4071,0,0,3,4071,0.226668000,1.2227
215.158.239.76,<->,194.232.71.226,3,2279,0,0,3,2279,0.226529000,1.7680
97.126.18.95,<->,56.114.235.120,3,2840,0,0,3,2840,0.226207000,0.3787
207.62.119.39,<->,136.25.188.227,0,0,3,495,3,495,0.225912000,1.1621
133.178.227.27,<->,18.202.90.200,3,3227,0,0,3,3227,0.225893000,1.5706
133.178.226.83,<->,96.155.60.201,3,1725,0,0,3,1725,0.225828000,1.7074
215.158.239.70,<->,196.88.29.131,3,1697,0,0,3,1697,0.222327000,0.2216
216.184.1.90,<->,136.25.188.201,0,0,3,1310,3,1310,0.222129000,0.5256
215.158.140.231,<->,29.214.109.175,3,3249,0,0,3,3249,0.221835000,1.2811
199.51.211.251,<->,136.25.188.252,0,0,3,2311,3,2311,0.221177000,1.3837
215.158.238.153,<->,139.163.161.62,3,1753,0,0,3,1753,0.219984000,0.3246
215.158.239.96,<->,199.76.52.36,3,1616,0,0,3,1616,0.219763000,0.7403
133.178.226.38,<->,122.158.51.62,3,3687,0,0,3,3687,0.219106000,1.3927
215.158.238.75,<->,119.196.23.42,3,3623,0,0,3,3623,0.218974000,1.5786
29.214.108.201,<->,8.252.223.130,0,0,3,3200,3,3200,0.218941000,1.5206
215.158.239.84,<->,196.1.59.55,3,1154,0,0,3,1154,0.218339000,0.8295
215.158.238.106,<->,119.196.23.3,3,3815,0,0,3,3815,0.218295000,1.2620
215.158.238.83,<->,122.159.245.168,3,3847,0,0,3,3847,0.217746000,1.0180
215.158.239.76,<->,199.14.131.242,3,1100,0,0,3,1100,0.217252000,0.2331
215.158.238.241,<->,8.221.197.68,3,3572,0,0,3,3572,0.216971000,0.8428
215.158.238.82,<->,104.3.163.83,3,3815,0,0,3,3815,0.216127000,0.5935
215.158.239.217,<->,215.158.61.191,3,3493,0,0,3,3493,0.215966000,1.0396
215.158.239.97,<->,199.20.29.174,3,530,0,0,3,530,0.215768000,0.0200
139.163.161.148,<->,133.178.227.247,0,0,3,1224,3,1224,0.215541000,0.0425
192.204.170.200,<->,136.25.188.178,0,0,3,4071,3,4071,0.215083000,1.7805
109.222.214.21,<->,54.52.53.28,3,2085,0,0,3,2085,0.214925000,1.0318
215.158.239.5,<->,8.255.92.134,3,3133,0,0,3,3133,0.214443000,1.3129
215.158.140.24,<->,56.112.84.79,3,829,0,0,3,829,0.214246000,1.4144
215.158.238.251,<->,113.23.56.89,3,3225,0,0,3,3225,0.213947000,1.4708
215.158.238.177,<->,8.190.217.52,3,3148,0,0,3,3148,0.213897000,1.4655
136.25.188.255,<->,126.219.194.161,3,4319,0,0,3,4319,0.213868000,1.3640
145.116.209.4,<->,136.25.188.167,0,0,3,1047,3,1047,0.213282000,0.0236
215.158.140.229,<->,192.171.32.183,3,3336,0,0,3,3336,0.212646000,0.7876
221.102.143.189,<->,192.65.236.21,0,0,3,423,3,423,0.211912000,1.4660
139.163.5.140,<->,121.166.170.76,3,540,0,0,3,540,0.211711000,0.1620
215.158.239.35,<->,122.158.53.52,3,1382,0,0,3,1382,0.211518000,1.5707
204.56.130.90,<->,136.25.188.237,0,0,3,1117,3,1117,0.210930000,1.3600
215.158.140.60,<->,106.188.253.138,3,3234,0,0,3,3234,0.209939000,0.9629
206.243.231.162,<->,111.146.255.212,0,0,3,1985,3,1985,0.209765000,0.1652
215.158.140.229,<->,8.240.116.246,3,3284,0,0,3,3284,0.209709000,1.7533
215.33.49.54,<->,8.52.187.0,0,0,3,1842,3,1842,0.209371000,0.1373
207.60.130.22,<->,136.25.188.174,0,0,3,1652,3,1652,0.209329000,0.2551
139.163.163.252,<->,133.178.227.2,0,0,3,3555,3,3555,0.209271000,1.2579
136.25.188.52,<->,113.23.104.215,3,1683,0,0,3,1683,0.209079000,0.2816
133.178.226.101,<->,80.47.185.14,3,1224,0,0,3,1224,0.208667000,0.4875
215.158.239.49,<->,199.79.142.2,3,1681,0,0,3,1681,0.208653000,0.2905
133.178.227.40,<->,113.23.66.34,3,3299,0,0,3,3299,0.208624000,1.2495
215.158.239.84,<->,194.199.218.18,3,320,0,0,3,320,0.208530000,0.3898
215.158.238.201,<->,100.216.78.145,3,611,0,0,3,611,0.208296000,0.0482
215.158.140.83,<->,126.219.101.174,3,3344,0,0,3,3344,0.207872000,0.9997
215.158.238.73,<->,112.220.206.107,3,3847,0,0,3,3847,0.206676000,1.0694
215.158.239.96,<->,199.20.29.106,3,1170,0,0,3,1170,0.206469000,0.3107
215.158.239.7,<->,158.166.175.232,3,1827,0,0,3,1827,0.205706000,1.4327
215.158.239.99,<->,143.135.48.154,3,696,0,0,3,696,0.205500000,0.0134
215.158.239.94,<->,195.14.206.212,3,1667,0,0,3,1667,0.205464000,0.2183
220.39.233.170,<->,215.158.238.113,0,0,3,3943,3,3943,0.205255000,1.5045
136.25.188.179,<->,113.23.20.105,3,3911,0,0,3,3911,0.205183000,1.2920
136.25.188.247,<->,100.224.202.178,3,1518,0,0,3,1518,0.204905000,0.8294
129.1.68.239,<->,112.208.20.240,3,698,0,0,3,698,0.204905000,0.3981
223.141.52.98,<->,111.147.69.106,0,0,3,188,3,188,0.203807000,1.7727
215.158.238.190,<->,18.202.90.231,3,3296,0,0,3,3296,0.203648000,1.5816
215.158.239.49,<->,8.50.171.159,3,4087,0,0,3,4087,0.203299000,1.3472
196.206.131.132,<->,136.25.188.243,0,0,3,1756,3,1756,0.203013000,0.0626
192.204.123.20,<->,136.25.189.0,0,0,3,3607,3,3607,0.202356000,1.7441
194.253.243.34,<->,8.252.222.208,0,0,3,315,3,315,0.201866000,1.4036
215.158.238.188,<->,33.221.186.171,3,3271,0,0,3,3271,0.201214000,1.0930
215.158.238.83,<->,80.47.111.65,3,3703,0,0,3,3703,0.201044000,0.3381
215.158.238.236,<->,8.219.185.50,3,3303,0,0,3,3303,0.200788000,1.7280
145.166.2.99,<->,8.182.226.194,0,0,3,1562,3,1562,0.200308000,1.1171
221.102.56.46,<->,98.129.24.188,0,0,3,1622,3,1622,0.200199000,0.0367
48.17.38.203,<->,8.252.222.205,0,0,3,998,3,998,0.199921000,0.9225
215.158.239.79,<->,195.7.20.231,3,1720,0,0,3,1720,0.199100000,1.5869
215.158.239.96,<->,199.20.7.146,3,591,0,0,3,591,0.199099000,0.3984
133.178.227.27,<->,133.56.180.21,3,3949,0,0,3,3949,0.198302000,0.8841
136.25.189.15,<->,29.212.199.45,3,4263,0,0,3,4263,0.198247000,1.0230
215.158.239.92,<->,194.232.182.203,3,1911,0,0,3,1911,0.198198000,1.5821
136.25.188.211,<->,131.2.115.252,3,2751,0,0,3,2751,0.197991000,0.7739
215.158.239.33,<->,149.96.53.40,3,1832,0,0,3,1832,0.197190000,0.6805
207.58.236.23,<->,136.25.188.255,0,0,3,635,3,635,0.197133000,1.2740
136.25.189.34,<->,56.28.207.201,3,2943,0,0,3,2943,0.195830000,0.8681
136.25.188.252,<->,27.178.41.9,3,3895,0,0,3,3895,0.195363000,0.6810
144.87.238.20,<->,144.87.235.144,0,0,3,663,3,663,0.195037000,0.2382
142.207.121.123,<->,136.25.188.175,0,0,3,614,3,614,0.195019000,0.8340
195.41.197.10,<->,136.25.188.226,0,0,3,1211,3,1211,0.194998000,0.6347
133.178.227.79,<->,8.219.185.50,3,3431,0,0,3,3431,0.194688000,1.2769
221.102.56.69,<->,192.65.85.199,0,0,3,882,3,882,0.193987000,1.6147
215.158.239.109,<->,215.158.61.182,3,2796,0,0,3,2796,0.193796000,1.6916
215.158.239.58,<->,142.220.110.154,3,1707,0,0,3,1707,0.193239000,0.2362
199.39.215.192,<->,136.25.188.209,0,0,3,1670,3,1670,0.192742000,0.2202
139.59.41.197,<->,8.182.226.78,0,0,3,3928,3,3928,0.192623000,0.5801
215.158.239.85,<->,199.52.42.146,3,1077,0,0,3,1077,0.192372000,0.6206
100.161.107.233,<->,99.75.195.84,0,0,3,2650,3,2650,0.192143000,0.2595
215.158.239.85,<->,142.254.70.49,3,1195,0,0,3,1195,0.191801000,1.1617
207.62.95.124,<->,136.25.188.220,0,0,3,1178,3,1178,0.191636000,0.5760
215.158.238.196,<->,104.3.168.52,3,3391,0,0,3,3391,0.190590000,1.5441
94.192.15.227,<->,8.252.222.44,0,0,3,320,3,320,0.190124000,0.7448
136.25.188.174,<->,131.1.232.163,3,2927,0,0,3,2927,0.189340000,1.2940
215.158.239.8,<->,68.231.18.93,3,3633,0,0,3,3633,0.188938000,0.1426
133.178.227.70,<->,126.219.132.168,3,3284,0,0,3,3284,0.188601000,1.0073
215.158.238.120,<->,112.220.206.117,3,3783,0,0,3,3783,0.188469000,1.6137
215.158.239.79,<->,194.251.143.80,3,1666,0,0,3,1666,0.188091000,0.2000
133.178.227.19,<->,131.144.116.194,3,3291,0,0,3,3291,0.188032000,1.1403
215.158.238.198,<->,106.188.253.27,3,3301,0,0,3,3301,0.188026000,1.4056
215.158.238.83,<->,113.23.104.247,3,3559,0,0,3,3559,0.187876000,1.4955
149.250.115.13,<->,136.25.188.252,0,0,3,3703,3,3703,0.187811000,0.6603
195.71.143.115,<->,136.25.188.44,0,0,3,1055,3,1055,0.187706000,0.2233
215.158.239.95,<->,207.213.60.85,3,904,0,0,3,904,0.187699000,0.0001
197.107.12.45,<->,136.25.188.173,0,0,3,1220,3,1220,0.186744000,0.0020
215.158.61.189,<->,8.176.8.218,0,0,3,1991,3,1991,0.186364000,1.3150
215.158.239.85,<->,142.182.131.253,3,1675,0,0,3,1675,0.186308000,0.2200
215.158.140.14,<->,215.158.61.145,3,874,0,0,3,874,0.186221000,1.4622
204.200.49.111,<->,136.25.188.196,0,0,3,1370,3,1370,0.186147000,0.1802
195.15.160.132,<->,136.25.188.46,0,0,3,1082,3,1082,0.184780000,0.3431
149.163.129.242,<->,136.25.189.45,0,0,3,3975,3,3975,0.184511000,1.2933
133.178.227.16,<->,131.144.114.243,3,3403,0,0,3,3403,0.184449000,0.6728
142.220.56.95,<->,136.25.188.220,0,0,3,1195,3,1195,0.184050000,0.7919
199.51.129.216,<->,136.25.188.163,0,0,3,1234,3,1234,0.183056000,1.1514
8.176.8.25,<->,8.35.106.194,3,812,0,0,3,812,0.182138000,1.5944
136.25.188.47,<->,29.214.64.198,3,3767,0,0,3,3767,0.181197000,1.4418
136.25.188.224,<->,131.144.113.195,3,3783,0,0,3,3783,0.179758000,0.8304
215.158.238.238,<->,192.226.161.159,3,3267,0,0,3,3267,0.179564000,1.5341
133.178.226.49,<->,116.106.35.196,3,1636,0,0,3,1636,0.179297000,0.1742
215.158.140.195,<->,126.132.18.200,3,1780,0,0,3,1780,0.179091000,0.7119
204.60.102.195,<->,136.25.188.209,0,0,3,1059,3,1059,0.178064000,0.4576
110.2.24.238,<->,80.41.14.90,0,0,3,602,3,602,0.178015000,0.1854
196.113.250.60,<->,0.195.210.43,0,0,3,1657,3,1657,0.177738000,0.4534
247.136.212.186,<->,92.16.228.173,3,4512,0,0,3,4512,0.177598000,1.3459
136.25.189.57,<->,96.156.169.235,3,4087,0,0,3,4087,0.177597000,1.3885
133.178.226.31,<->,8.179.43.91,3,4007,0,0,3,4007,0.177531000,1.2037
136.25.188.199,<->,8.222.212.23,3,3911,0,0,3,3911,0.176678000,1.2903
98.128.241.87,<->,8.45.162.111,3,2121,0,0,3,2121,0.176318000,0.2211
215.158.239.84,<->,204.227.240.179,3,1005,0,0,3,1005,0.175094000,1.2508
133.178.226.77,<->,122.159.245.149,3,3943,0,0,3,3943,0.175017000,1.7039
136.25.189.0,<->,116.106.46.120,3,3787,0,0,3,3787,0.173941000,1.3459
221.102.143.189,<->,109.3.189.142,0,0,3,423,3,423,0.173105000,1.4060
246.253.145.192,<->,69.132.3.185,3,1879,0,0,3,1879,0.172173000,0.8029
199.120.243.214,<->,136.25.188.177,0,0,3,1195,3,1195,0.172049000,1.2847
215.158.238.190,<->,38.104.11.126,3,3199,0,0,3,3199,0.171680000,1.1252
133.178.227.19,<->,131.22.233.155,3,3249,0,0,3,3249,0.171167000,1.1050
215.158.238.73,<->,33.209.217.230,3,4364,0,0,3,4364,0.171159000,0.6126
136.25.189.80,<->,29.209.59.217,3,3863,0,0,3,3863,0.170742000,1.5909
136.25.188.211,<->,56.161.218.39,3,3847,0,0,3,3847,0.169963000,1.5598
133.178.227.40,<->,133.56.180.89,3,2879,0,0,3,2879,0.169697000,1.2559
215.158.238.149,<->,114.25.48.61,3,3639,0,0,3,3639,0.169481000,1.4678
220.20.200.137,<->,124.46.191.127,3,2499,0,0,3,2499,0.169190000,0.0385
199.68.238.123,<->,136.25.188.237,0,0,3,1301,3,1301,0.168923000,0.5310
204.154.176.209,<->,8.52.172.21,0,0,3,613,3,613,0.168053000,0.4032
111.181.100.149,<->,56.114.235.120,3,1588,0,0,3,1588,0.167315000,0.0646
136.25.188.160,<->,8.222.212.22,3,3895,0,0,3,3895,0.165811000,1.6737
215.158.239.93,<->,114.25.48.22,3,3863,0,0,3,3863,0.165314000,0.9829
199.38.214.113,<->,136.25.188.227,0,0,3,1126,3,1126,0.165280000,0.3448
229.96.182.37,<->,8.181.37.222,3,1782,0,0,3,1782,0.164932000,0.0087
136.25.189.1,<->,61.35.70.244,3,2623,0,0,3,2623,0.164496000,1.6224
137.179.183.36,<->,53.149.207.79,3,2676,0,0,3,2676,0.164384000,1.2546
136.25.188.237,<->,131.1.232.85,3,3943,0,0,3,3943,0.164347000,1.7934
136.25.189.34,<->,33.209.219.107,3,991,0,0,3,991,0.163582000,0.9718
136.25.189.80,<->,133.146.0.182,3,2511,0,0,3,2511,0.162875000,1.5796
215.158.140.83,<->,48.129.132.249,3,3449,0,0,3,3449,0.162395000,1.8132
215.158.239.93,<->,207.236.228.141,3,1177,0,0,3,1177,0.161313000,0.4183
216.184.2.194,<->,136.25.189.57,0,0,3,3719,3,3719,0.160761000,1.0620
220.39.233.203,<->,215.158.238.33,0,0,3,3895,3,3895,0.160265000,0.7332
215.158.61.145,<->,8.176.8.194,0,0,3,1663,3,1663,0.160146000,1.0161
133.178.227.19,<->,131.1.194.205,3,3620,0,0,3,3620,0.159896000,0.6292
136.25.189.78,<->,96.156.169.255,3,2751,0,0,3,2751,0.159157000,0.8435
215.158.140.92,<->,104.3.168.150,3,3155,0,0,3,3155,0.158511000,1.1205
215.158.140.206,<->,8.222.7.155,3,2879,0,0,3,2879,0.158490000,1.8218
207.61.3.109,<->,136.25.188.225,0,0,3,1679,3,1679,0.158260000,0.3625
195.5.213.210,<->,136.25.188.254,0,0,3,1697,3,1697,0.158024000,0.2107
158.85.50.66,<->,133.178.227.1,0,0,3,3395,3,3395,0.157927000,1.7765
145.180.135.157,<->,136.25.188.36,0,0,3,1637,3,1637,0.157832000,1.6954
239.227.73.148,<->,221.102.56.69,3,882,0,0,3,882,0.157607000,0.5354
195.43.56.179,<->,136.25.188.54,0,0,3,1577,3,1577,0.155611000,1.0592
133.178.227.79,<->,8.53.216.61,3,4023,0,0,3,4023,0.155135000,1.0700
221.102.56.69,<->,80.41.225.188,0,0,3,882,3,882,0.155010000,0.1037
215.158.239.78,<->,207.115.97.255,3,1190,0,0,3,1190,0.154995000,0.9643
215.158.239.86,<->,204.226.34.31,3,1702,0,0,3,1702,0.154681000,0.1763
136.25.189.32,<->,113.23.66.228,3,3687,0,0,3,3687,0.154600000,1.6027
215.158.238.61,<->,98.219.126.175,3,2120,0,0,3,2120,0.154499000,1.2531
136.25.189.95,<->,98.219.126.175,3,2708,0,0,3,2708,0.154149000,0.3594
129.224.112.252,<->,97.242.126.203,3,318,0,0,3,318,0.153879000,0.9369
215.158.238.209,<->,89.86.110.166,3,3863,0,0,3,3863,0.153605000,1.4894
220.28.73.211,<->,215.158.238.247,0,0,3,644,3,644,0.152483000,1.2483
133.178.227.16,<->,113.23.14.231,3,3306,0,0,3,3306,0.151965000,1.4407
210.95.218.224,<->,8.220.178.166,0,0,3,888,3,888,0.151583000,0.0880
142.223.165.143,<->,136.25.188.176,0,0,3,757,3,757,0.151088000,0.2431
143.132.56.155,<->,136.25.188.55,0,0,3,1568,3,1568,0.150965000,0.2361
215.158.239.92,<->,199.20.4.228,3,987,0,0,3,987,0.150878000,0.9195
143.45.0.151,<->,133.178.226.61,0,0,3,4087,3,4087,0.150731000,1.5960
204.61.161.93,<->,136.25.188.163,0,0,3,1163,3,1163,0.150080000,0.9681
215.158.239.77,<->,106.188.253.173,3,4109,0,0,3,4109,0.148878000,1.7289
97.190.201.137,<->,8.37.220.169,3,2376,0,0,3,2376,0.148304000,0.0559
133.178.226.31,<->,119.196.23.21,3,3607,0,0,3,3607,0.147825000,0.3919
136.25.188.173,<->,57.160.181.249,3,3895,0,0,3,3895,0.147724000,1.5972
215.158.238.67,<->,91.57.173.63,3,3927,0,0,3,3927,0.147491000,0.6965
136.25.188.253,<->,8.255.92.246,3,3671,0,0,3,3671,0.147078000,1.5085
142.240.56.26,<->,136.25.188.255,0,0,3,2026,3,2026,0.146985000,1.5630
215.158.239.68,<->,204.226.53.66,3,1629,0,0,3,1629,0.146647000,0.1725
142.244.7.242,<->,136.25.188.173,0,0,3,1674,3,1674,0.146529000,0.4189
215.158.239.79,<->,196.109.184.155,3,1677,0,0,3,1677,0.145368000,0.4892
215.158.239.95,<->,195.5.192.89,3,694,0,0,3,694,0.145244000,0.8175
215.158.61.189,<->,8.176.8.191,0,0,3,1287,3,1287,0.144443000,1.8292
215.158.238.149,<->,119.196.23.9,3,3911,0,0,3,3911,0.144385000,1.6399
142.249.37.52,<->,136.25.188.177,0,0,3,1664,3,1664,0.144169000,0.2304
199.73.201.218,<->,136.25.188.55,0,0,3,1684,3,1684,0.142794000,1.2584
54.36.13.173,<->,48.55.54.73,0,0,3,3602,3,3602,0.142746000,0.6579
139.8.186.147,<->,133.178.227.2,0,0,3,3355,3,3355,0.141909000,1.0738
136.25.188.236,<->,8.188.227.20,3,2591,0,0,3,2591,0.141766000,1.7279
139.114.215.223,<->,89.139.242.246,0,0,3,393,3,393,0.141174000,0.0548
195.55.20.234,<->,136.25.188.255,0,0,3,1663,3,1663,0.140660000,0.5259
195.14.28.254,<->,136.25.188.253,0,0,3,1227,3,1227,0.140560000,0.4536
215.158.238.132,<->,118.20.114.80,3,3879,0,0,3,3879,0.139597000,1.8086
133.178.227.2,<->,131.144.112.235,3,3294,0,0,3,3294,0.139540000,0.6947
215.158.239.57,<->,8.215.68.89,3,4071,0,0,3,4071,0.138561000,0.3191
215.158.238.113,<->,143.45.0.136,3,3911,0,0,3,3911,0.138111000,1.4769
133.178.227.2,<->,106.188.252.234,3,3191,0,0,3,3191,0.137709000,1.3413
215.158.239.40,<->,29.211.5.164,3,212,0,0,3,212,0.137606000,0.9465
249.115.166.204,<->,8.220.176.253,0,0,3,1401,3,1401,0.137102000,0.5442
136.25.188.176,<->,29.214.64.198,3,3975,0,0,3,3975,0.136888000,1.4733
136.25.188.52,<->,8.252.210.250,3,3687,0,0,3,3687,0.136790000,1.2652
54.37.211.103,<->,48.53.162.29,0,0,3,336,3,336,0.136735000,0.7339
130.77.154.37,<->,0.195.210.8,0,0,3,1732,3,1732,0.136016000,0.1938
215.158.61.189,<->,8.176.8.186,0,0,3,2598,3,2598,0.135876000,0.6804
92.168.217.253,<->,50.136.128.47,3,939,0,0,3,939,0.135826000,1.5549
215.158.238.251,<->,76.100.141.56,3,3284,0,0,3,3284,0.135109000,1.0596
215.158.238.141,<->,80.47.111.74,3,3655,0,0,3,3655,0.134590000,1.8093
215.158.239.57,<->,133.146.0.75,3,4135,0,0,3,4135,0.134232000,1.4717
133.178.227.79,<->,33.209.219.25,3,3879,0,0,3,3879,0.134197000,1.4516
215.158.238.73,<->,131.1.253.235,3,4051,0,0,3,4051,0.134030000,1.2291
133.178.227.16,<->,126.219.102.41,3,3343,0,0,3,3343,0.133643000,0.5326
136.25.189.0,<->,29.211.228.214,3,3927,0,0,3,3927,0.132769000,1.6479
133.178.226.37,<->,96.155.60.193,3,566,0,0,3,566,0.130430000,0.2326
204.184.177.16,<->,136.25.188.174,0,0,3,1680,3,1680,0.130028000,0.1500
195.43.156.127,<->,136.25.188.209,0,0,3,565,3,565,0.129656000,1.4229
245.161.124.43,<->,8.252.222.211,0,0,3,351,3,351,0.129167000,0.3635
215.158.239.79,<->,195.54.43.47,3,1154,0,0,3,1154,0.129013000,0.1809
215.158.239.51,<->,195.49.91.63,3,350,0,0,3,350,0.128801000,0.1208
8.182.226.78,<->,6.242.53.9,3,957,0,0,3,957,0.128801000,0.1698
143.95.86.26,<->,136.25.188.174,0,0,3,1659,3,1659,0.128337000,0.1436
215.158.239.70,<->,199.20.30.11,3,303,0,0,3,303,0.128125000,0.3295
215.158.239.210,<->,215.158.44.5,3,775,0,0,3,775,0.127988000,0.0006
215.158.238.32,<->,112.235.95.7,3,2799,0,0,3,2799,0.127785000,1.6333
204.1.235.138,<->,136.25.188.160,0,0,3,1856,3,1856,0.127454000,0.9021
215.158.238.135,<->,113.23.104.212,3,3703,0,0,3,3703,0.127303000,0.6252
204.58.176.221,<->,136.25.188.198,0,0,3,1941,3,1941,0.126310000,0.1259
36.123.54.244,<->,8.20.87.32,0,0,3,361,3,361,0.126289000,0.4910
207.61.111.165,<->,136.25.188.252,0,0,3,1137,3,1137,0.126027000,0.9317
235.42.34.23,<->,136.25.188.254,0,0,3,3815,3,3815,0.125691000,1.4749
215.158.239.87,<->,29.213.219.92,3,4227,0,0,3,4227,0.125238000,1.2263
199.14.5.196,<->,136.25.188.220,0,0,3,1227,3,1227,0.124580000,0.4544
197.113.99.17,<->,136.25.188.253,0,0,3,1170,3,1170,0.124530000,1.1492
133.178.226.90,<->,104.3.168.203,3,3991,0,0,3,3991,0.124219000,0.7685
215.158.140.241,<->,197.125.117.129,3,3227,0,0,3,3227,0.124106000,1.5184
136.25.188.162,<->,8.222.212.57,3,3847,0,0,3,3847,0.123983000,1.3394
199.120.132.194,<->,136.25.188.209,0,0,3,320,3,320,0.123933000,0.8561
215.158.239.84,<->,199.20.29.28,3,1681,0,0,3,1681,0.123615000,0.5493
215.158.61.183,<->,136.25.189.196,0,0,3,3066,3,3066,0.122795000,1.3740
205.127.108.113,<->,33.233.141.5,0,0,3,1383,3,1383,0.122715000,1.2432
207.87.175.71,<->,8.182.237.144,0,0,3,729,3,729,0.122665000,0.3304
195.40.28.13,<->,136.25.188.226,0,0,3,1260,3,1260,0.121002000,0.4824
215.158.239.87,<->,196.0.241.50,3,1087,0,0,3,1087,0.120912000,0.8696
133.178.227.16,<->,106.188.245.195,3,3243,0,0,3,3243,0.120470000,0.8378
215.158.239.79,<->,199.14.9.124,3,1738,0,0,3,1738,0.120417000,0.3134
136.25.188.175,<->,126.219.194.142,3,4261,0,0,3,4261,0.120277000,1.0389
136.25.188.177,<->,100.224.202.151,3,470,0,0,3,470,0.119647000,0.3825
133.178.226.29,<->,131.1.232.151,3,2847,0,0,3,2847,0.119638000,0.9580
133.178.227.16,<->,8.53.216.133,3,3575,0,0,3,3575,0.119314000,1.2484
142.206.167.252,<->,136.25.188.46,0,0,3,2214,3,2214,0.119191000,0.9717
215.158.239.96,<->,120.154.71.36,3,3767,0,0,3,3767,0.118371000,1.3195
215.158.239.50,<->,199.20.31.86,3,1189,0,0,3,1189,0.118033000,0.9895
218.4.168.32,<->,8.49.69.216,3,2008,0,0,3,2008,0.117789000,0.2836
215.158.239.78,<->,195.49.155.114,3,1059,0,0,3,1059,0.117493000,1.8497
142.220.162.102,<->,136.25.188.238,0,0,3,1674,3,1674,0.116740000,0.2121
133.178.226.37,<->,122.158.245.155,3,3735,0,0,3,3735,0.116520000,1.7715
215.158.140.241,<->,131.1.195.58,3,3321,0,0,3,3321,0.116386000,1.4303
215.158.239.95,<->,195.83.116.23,3,1683,0,0,3,1683,0.116109000,0.3089
215.158.239.49,<->,195.55.148.74,3,1143,0,0,3,1143,0.115748000,0.6992
142.182.58.160,<->,136.25.188.178,0,0,3,490,3,490,0.115586000,0.4945
215.158.239.78,<->,199.20.29.21,3,1256,0,0,3,1256,0.115399000,0.9686
142.248.13.235,<->,136.25.188.196,0,0,3,323,3,323,0.115175000,0.4735
215.158.61.225,<->,8.252.222.24,0,0,3,2269,3,2269,0.112633000,0.0758
215.158.238.135,<->,104.3.168.215,3,2447,0,0,3,2447,0.112391000,1.6488
215.158.61.195,<->,8.176.8.225,0,0,3,1715,3,1715,0.112104000,1.3762
98.230.213.115,<->,8.182.244.237,0,0,3,1331,3,1331,0.111628000,0.0574
215.158.238.126,<->,100.216.78.145,3,2238,0,0,3,2238,0.110808000,1.3742
143.135.8.141,<->,136.25.188.196,0,0,3,1669,3,1669,0.110715000,0.2411
137.129.42.9,<->,53.200.236.124,3,1687,0,0,3,1687,0.110680000,0.7284
215.158.238.196,<->,106.188.253.38,3,3426,0,0,3,3426,0.109792000,1.6407
199.68.218.153,<->,136.25.188.55,0,0,3,1658,3,1658,0.109547000,1.0612
215.158.239.84,<->,204.226.51.219,3,1678,0,0,3,1678,0.109273000,0.1610
215.158.140.78,<->,215.158.2.230,3,1815,0,0,3,1815,0.109200000,1.1557
133.178.226.38,<->,122.159.245.156,3,3751,0,0,3,3751,0.108703000,1.0339
145.19.6.243,<->,97.68.17.69,3,445,0,0,3,445,0.107931000,1.2943
133.178.226.31,<->,111.151.239.91,3,3911,0,0,3,3911,0.107854000,1.8023
215.158.239.96,<->,143.20.71.191,3,297,0,0,3,297,0.107500000,0.0027
136.25.189.82,<->,106.188.253.233,3,3943,0,0,3,3943,0.107161000,1.4819
215.158.239.50,<->,199.33.239.39,3,978,0,0,3,978,0.107069000,0.0247
136.25.188.210,<->,29.211.6.19,3,2719,0,0,3,2719,0.107063000,0.8800
133.178.227.40,<->,133.56.180.39,3,4052,0,0,3,4052,0.106656000,1.0964
133.178.227.79,<->,8.190.216.195,3,3227,0,0,3,3227,0.105699000,1.6842
215.158.140.87,<->,111.15.121.170,3,1807,0,0,3,1807,0.105401000,0.1117
136.25.189.77,<->,29.214.108.227,3,3879,0,0,3,3879,0.105120000,1.0834
220.39.233.197,<->,215.158.238.114,0,0,3,3927,3,3927,0.103779000,0.6117
215.158.239.92,<->,199.51.234.58,3,1181,0,0,3,1181,0.103639000,0.9629
215.158.140.231,<->,131.144.116.23,3,3217,0,0,3,3217,0.103431000,1.1893
195.13.68.8,<->,136.25.188.253,0,0,3,616,3,616,0.102605000,0.4467
133.178.226.7,<->,104.3.163.39,3,3959,0,0,3,3959,0.101988000,1.1165
207.58.174.87,<->,136.25.188.254,0,0,3,1052,3,1052,0.101686000,0.4104
215.158.30.252,<->,8.252.222.34,0,0,3,1889,3,1889,0.101640000,0.1770
215.158.239.86,<->,192.204.123.60,3,3863,0,0,3,3863,0.101627000,1.8724
133.178.226.30,<->,106.188.251.218,3,3052,0,0,3,3052,0.101590000,0.4662
82.237.235.84,<->,56.114.235.120,3,1508,0,0,3,1508,0.101454000,0.1178
204.200.35.117,<->,136.25.188.176,0,0,3,1518,3,1518,0.099405000,1.5565
215.158.140.60,<->,8.219.184.92,3,3339,0,0,3,3339,0.098959000,1.6452
215.158.238.190,<->,29.214.108.217,3,3139,0,0,3,3139,0.098782000,1.6226
215.158.238.92,<->,104.3.161.26,3,4055,0,0,3,4055,0.098686000,1.7181
215.158.238.250,<->,120.154.179.20,3,3159,0,0,3,3159,0.098543000,1.2589
215.158.239.209,<->,145.234.121.48,3,1395,0,0,3,1395,0.098173000,1.1209
215.158.61.242,<->,8.176.8.186,0,0,3,3231,3,3231,0.098142000,1.8367
136.25.189.222,<->,8.235.71.12,3,1863,0,0,3,1863,0.098046000,0.0836
136.25.189.82,<->,126.219.194.73,3,3057,0,0,3,3057,0.097306000,1.7301
229.96.182.37,<->,8.49.190.133,3,540,0,0,3,540,0.096162000,0.0072
139.163.161.48,<->,136.25.188.249,0,0,3,1119,3,1119,0.096043000,0.0004
215.158.239.50,<->,131.2.102.23,3,3815,0,0,3,3815,0.095897000,1.8895
53.181.160.213,<->,8.228.215.154,0,0,3,341,3,341,0.095892000,0.1158
220.28.115.46,<->,215.158.140.81,0,0,3,1122,3,1122,0.095592000,1.1167
192.204.170.214,<->,133.178.226.7,0,0,3,3879,3,3879,0.095271000,1.2292
108.130.85.45,<->,100.228.42.187,0,0,3,1979,3,1979,0.094740000,0.0009
215.158.239.49,<->,204.226.90.203,3,1057,0,0,3,1057,0.093683000,0.1705
109.222.238.4,<->,53.195.188.160,3,1569,0,0,3,1569,0.092651000,1.1012
215.158.239.85,<->,194.251.73.190,3,1027,0,0,3,1027,0.091814000,0.6628
192.229.43.48,<->,133.178.227.242,0,0,3,2799,3,2799,0.090646000,0.3181
207.58.249.49,<->,136.25.188.241,0,0,3,1673,3,1673,0.089619000,0.4266
215.158.239.78,<->,98.28.95.84,3,3559,0,0,3,3559,0.089556000,1.6843
215.158.61.203,<->,8.176.8.189,0,0,3,2239,3,2239,0.088912000,1.1966
215.158.140.83,<->,126.219.132.66,3,3235,0,0,3,3235,0.088532000,1.3255
215.158.140.241,<->,8.53.216.69,3,3293,0,0,3,3293,0.088485000,1.5472
215.158.140.93,<->,8.240.116.171,3,3296,0,0,3,3296,0.088425000,0.4414
252.36.55.128,<->,8.182.248.147,0,0,3,894,3,894,0.088310000,0.6630
215.158.238.75,<->,131.2.115.231,3,4023,0,0,3,4023,0.088290000,1.3959
136.25.188.45,<->,104.3.168.216,3,3671,0,0,3,3671,0.088282000,1.1963
215.158.61.145,<->,8.176.8.242,0,0,3,1454,3,1454,0.087465000,0.8809
215.158.238.45,<->,112.235.95.75,3,3719,0,0,3,3719,0.087462000,1.8928
126.198.96.199,<->,50.224.100.195,0,0,3,658,3,658,0.086426000,1.1290
136.25.189.59,<->,29.211.228.215,3,3655,0,0,3,3655,0.083952000,0.6215
149.163.129.230,<->,136.25.189.82,0,0,3,3991,3,3991,0.083944000,0.5599
133.178.226.14,<->,111.150.186.207,3,2461,0,0,3,2461,0.083051000,0.2409
215.158.238.83,<->,131.1.253.234,3,4134,0,0,3,4134,0.082879000,0.9677
215.158.239.123,<->,215.158.61.243,3,2565,0,0,3,2565,0.081601000,1.0017
215.158.239.68,<->,199.20.28.139,3,1096,0,0,3,1096,0.081103000,0.6389
221.102.56.69,<->,109.1.51.9,0,0,3,882,3,882,0.080985000,0.5160
136.25.188.175,<->,56.161.218.20,3,3863,0,0,3,3863,0.080982000,0.9273
215.158.239.50,<->,29.214.73.149,3,3991,0,0,3,3991,0.080330000,1.7077
204.184.149.238,<->,136.25.188.243,0,0,3,1806,3,1806,0.079753000,0.6796
136.25.188.211,<->,8.222.212.22,3,3719,0,0,3,3719,0.077534000,1.2429
136.181.52.165,<->,8.192.161.247,3,1513,0,0,3,1513,0.076550000,0.2581
195.65.1.185,<->,133.178.227.24,0,0,3,4087,3,4087,0.075181000,1.2723
136.25.189.59,<->,96.156.169.169,3,4275,0,0,3,4275,0.074306000,1.8643
143.42.47.211,<->,136.25.188.253,0,0,3,1527,3,1527,0.074214000,0.1168
215.158.239.99,<->,142.166.122.161,3,2067,0,0,3,2067,0.074187000,0.1851
246.45.208.21,<->,58.62.42.67,3,1539,0,0,3,1539,0.073981000,0.4903
100.93.185.72,<->,8.55.239.156,3,1939,0,0,3,1939,0.073019000,0.1688
136.25.188.49,<->,80.57.141.206,3,1889,0,0,3,1889,0.073013000,0.1853
111.20.172.118,<->,33.233.141.232,0,0,3,1569,3,1569,0.072996000,0.0001
220.83.118.213,<->,106.5.208.193,3,723,0,0,3,723,0.071361000,1.4442
195.13.225.220,<->,136.25.188.209,0,0,3,1052,3,1052,0.071145000,0.2112
220.28.73.211,<->,133.178.226.72,0,0,3,2814,3,2814,0.070342000,1.8964
133.178.227.76,<->,106.188.228.2,3,3379,0,0,3,3379,0.070055000,0.7532
142.206.82.96,<->,136.25.188.222,0,0,3,1702,3,1702,0.069954000,0.2689
133.178.227.41,<->,133.56.180.57,3,1559,0,0,3,1559,0.069651000,1.0455
215.158.239.95,<->,195.13.238.8,3,1743,0,0,3,1743,0.069629000,0.2185
215.158.239.57,<->,143.79.204.203,3,1679,0,0,3,1679,0.069598000,0.2392
231.142.29.215,<->,215.158.239.78,0,0,3,1719,3,1719,0.069581000,0.4015
192.64.101.33,<->,8.55.224.156,3,261,0,0,3,261,0.069083000,1.4380
215.158.239.32,<->,215.158.127.169,3,699,0,0,3,699,0.068559000,0.7381
200.174.209.92,<->,53.201.72.62,3,2154,0,0,3,2154,0.068122000,0.5926
215.158.239.56,<->,207.60.115.196,3,1674,0,0,3,1674,0.067975000,0.8371
99.75.190.89,<->,8.55.237.110,3,854,0,0,3,854,0.066446000,0.0579
235.253.220.244,<->,136.25.189.80,0,0,3,3895,3,3895,0.066435000,1.6837
133.178.227.57,<->,133.56.180.89,3,4023,0,0,3,4023,0.066166000,0.4599
215.158.239.85,<->,207.59.12.230,3,1058,0,0,3,1058,0.066015000,0.0360
215.158.238.221,<->,130.165.253.35,3,3574,0,0,3,3574,0.065770000,1.8645
136.25.188.255,<->,122.158.245.86,3,4087,0,0,3,4087,0.065285000,1.8141
17.193.242.92,<->,8.220.188.138,0,0,3,704,3,704,0.064900000,1.7145
89.86.110.126,<->,8.252.223.120,0,0,3,3449,3,3449,0.064571000,0.6218
220.39.233.217,<->,215.158.238.106,0,0,3,4023,3,4023,0.064458000,0.8836
159.137.139.2,<->,133.178.227.1,0,0,3,3975,3,3975,0.064432000,1.3395
136.25.188.243,<->,131.144.114.229,3,3655,0,0,3,3655,0.063757000,1.7272
207.236.79.134,<->,136.25.188.255,0,0,3,1195,3,1195,0.063737000,1.4793
133.178.227.41,<->,8.190.216.223,3,3959,0,0,3,3959,0.063533000,0.7654
215.158.127.107,<->,8.252.223.153,0,0,3,3836,3,3836,0.063351000,0.8131
136.25.189.83,<->,120.154.131.22,3,4307,0,0,3,4307,0.063252000,0.8287
136.25.189.57,<->,126.219.191.5,3,3655,0,0,3,3655,0.063051000,0.5531
215.158.239.99,<->,199.20.29.93,3,1705,0,0,3,1705,0.062247000,0.3688
215.158.239.34,<->,122.158.246.201,3,4419,0,0,3,4419,0.062115000,0.7131
195.68.244.170,<->,136.25.188.54,0,0,3,1681,3,1681,0.061877000,0.4399
143.13.202.241,<->,136.25.188.175,0,0,3,1672,3,1672,0.061818000,0.1920
215.158.239.6,<->,126.219.102.169,3,1568,0,0,3,1568,0.061689000,1.3355
215.158.140.60,<->,128.194.247.55,3,3342,0,0,3,3342,0.061586000,1.5128
209.18.32.202,<->,8.220.178.246,0,0,3,968,3,968,0.061502000,1.1590
221.102.143.189,<->,98.129.57.240,0,0,3,4374,3,4374,0.061486000,1.4380
204.184.148.88,<->,136.25.188.196,0,0,3,1657,3,1657,0.061417000,0.4498
215.158.238.67,<->,112.220.206.116,3,3591,0,0,3,3591,0.061208000,1.2150
136.25.188.227,<->,72.52.200.51,3,471,0,0,3,471,0.060978000,0.8539
139.36.120.125,<->,99.74.26.190,0,0,3,1479,3,1479,0.060952000,1.6410
133.178.227.19,<->,8.50.170.249,3,3344,0,0,3,3344,0.060922000,1.3014
159.57.90.65,<->,132.49.145.62,0,0,3,982,3,982,0.060668000,0.0001
215.158.239.70,<->,142.236.228.100,3,1655,0,0,3,1655,0.060364000,0.2205
136.25.189.23,<->,96.156.169.178,3,1095,0,0,3,1095,0.059950000,0.8311
215.158.238.67,<->,65.27.228.202,3,3703,0,0,3,3703,0.059797000,1.4551
215.158.239.96,<->,199.20.30.204,3,1701,0,0,3,1701,0.059666000,0.2597
215.158.238.188,<->,29.214.109.153,3,3303,0,0,3,3303,0.059557000,1.1103
93.181.154.49,<->,89.183.104.191,0,0,3,154,3,154,0.059372000,0.4038
199.80.29.19,<->,136.25.188.176,0,0,3,303,3,303,0.058737000,0.2754
17.23.199.45,<->,8.220.239.104,0,0,3,1843,3,1843,0.058273000,1.0032
136.25.189.33,<->,96.156.169.200,3,4215,0,0,3,4215,0.058089000,1.0004
215.158.238.97,<->,120.154.221.233,3,3799,0,0,3,3799,0.057728000,1.0475
204.187.39.175,<->,136.25.188.241,0,0,3,1679,3,1679,0.056392000,0.1885
215.158.140.83,<->,8.190.216.249,3,3175,0,0,3,3175,0.056276000,1.7368
97.27.254.35,<->,8.52.249.97,0,0,3,3604,3,3604,0.056208000,1.9154
215.158.239.101,<->,129.222.36.34,3,1631,0,0,3,1631,0.056102000,1.0286
111.146.173.53,<->,54.59.1.108,3,2296,0,0,3,2296,0.055793000,1.6114
69.103.121.183,<->,8.252.222.62,0,0,3,772,3,772,0.054149000,0.1600
204.184.251.51,<->,136.25.188.220,0,0,3,1503,3,1503,0.052421000,1.8995
215.158.238.81,<->,131.144.113.183,3,3831,0,0,3,3831,0.052413000,1.3502
205.104.181.26,<->,100.93.115.150,0,0,3,1142,3,1142,0.052049000,0.3302
215.158.239.28,<->,122.158.246.233,3,342,0,0,3,342,0.051933000,1.8596
195.12.156.38,<->,136.25.188.225,0,0,3,1284,3,1284,0.051092000,0.3757
195.70.17.125,<->,136.25.188.45,0,0,3,694,3,694,0.050939000,0.9818
195.5.10.118,<->,136.25.188.55,0,0,3,896,3,896,0.050890000,0.0020
215.158.140.228,<->,97.125.210.250,3,1259,0,0,3,1259,0.050779000,0.0708
220.26.140.14,<->,133.178.227.108,0,0,3,1078,3,1078,0.050344000,1.4974
197.113.99.189,<->,136.25.188.253,0,0,3,1629,3,1629,0.050064000,0.7697
215.158.239.50,<->,29.212.199.252,3,3927,0,0,3,3927,0.049965000,0.6213
133.135.201.113,<->,129.6.83.6,0,0,3,1311,3,1311,0.049239000,0.2584
215.158.61.193,<->,8.176.8.199,0,0,3,2524,3,2524,0.048493000,0.7181
136.25.188.225,<->,84.250.180.126,3,1079,0,0,3,1079,0.048095000,0.0203
124.41.84.151,<->,92.162.253.131,0,0,3,852,3,852,0.047576000,0.1306
215.158.239.17,<->,96.135.154.110,3,3155,0,0,3,3155,0.047544000,1.4228
136.25.188.239,<->,57.160.181.180,3,3975,0,0,3,3975,0.047346000,1.1873
136.25.188.162,<->,50.57.174.13,3,1191,0,0,3,1191,0.047340000,1.3809
231.140.25.119,<->,136.25.188.255,0,0,3,1592,3,1592,0.047216000,0.7337
215.158.61.189,<->,8.176.8.192,0,0,3,1831,3,1831,0.046609000,0.5434
146.249.226.8,<->,8.252.222.135,0,0,3,415,3,415,0.046149000,0.0079
111.14.238.97,<->,8.182.226.42,0,0,3,756,3,756,0.045822000,0.1139
106.168.190.215,<->,80.40.1.196,0,0,3,1278,3,1278,0.045669000,0.4317
133.178.226.19,<->,106.188.236.180,3,4023,0,0,3,4023,0.045523000,0.8394
215.158.238.33,<->,212.70.75.152,3,3847,0,0,3,3847,0.045365000,1.6568
199.53.132.106,<->,136.25.188.252,0,0,3,1048,3,1048,0.044970000,0.2826
215.158.238.198,<->,106.188.251.56,3,3379,0,0,3,3379,0.044958000,1.8293
149.250.115.24,<->,136.25.188.255,0,0,3,4007,3,4007,0.044278000,0.7283
215.158.238.241,<->,106.188.252.212,3,3250,0,0,3,3250,0.042982000,0.6760
215.158.239.50,<->,196.90.95.190,3,1579,0,0,3,1579,0.042633000,0.4998
111.40.65.206,<->,50.224.121.236,0,0,3,210,3,210,0.042485000,0.2715
124.55.166.157,<->,80.41.39.76,0,0,3,4512,3,4512,0.040846000,1.8404
149.229.108.170,<->,0.195.210.33,0,0,3,922,3,922,0.040829000,0.1316
204.186.184.137,<->,136.25.188.197,0,0,3,1628,3,1628,0.039667000,0.2609
136.25.188.237,<->,99.192.168.153,3,3815,0,0,3,3815,0.039628000,0.9772
215.158.239.93,<->,196.107.122.156,3,1030,0,0,3,1030,0.038915000,0.2188
215.158.239.68,<->,199.20.30.40,3,1668,0,0,3,1668,0.038816000,0.5913
215.158.239.93,<->,29.209.59.214,3,3719,0,0,3,3719,0.038047000,1.7450
215.158.238.132,<->,131.1.195.223,3,4119,0,0,3,4119,0.037856000,1.9583
220.20.200.70,<->,133.248.86.103,3,1756,0,0,3,1756,0.037497000,0.0820
207.236.1.46,<->,136.25.188.177,0,0,3,1086,3,1086,0.036963000,0.1843
109.222.230.140,<->,109.57.161.32,3,620,0,0,3,620,0.036779000,1.8146
215.158.238.123,<->,131.1.253.210,3,3912,0,0,3,3912,0.036397000,1.5879
133.178.227.41,<->,131.144.112.235,3,3372,0,0,3,3372,0.036064000,1.3888
129.78.112.201,<->,102.45.210.141,3,649,0,0,3,649,0.035926000,0.8391
136.25.189.59,<->,72.23.194.229,3,4295,0,0,3,4295,0.034859000,1.7935
142.209.155.50,<->,136.25.188.198,0,0,3,1272,3,1272,0.034832000,1.5822
69.128.79.174,<->,53.68.31.204,3,1341,0,0,3,1341,0.034045000,0.2778
195.55.31.40,<->,136.25.188.173,0,0,3,1673,3,1673,0.033883000,0.0584
215.158.239.56,<->,195.49.84.18,3,1022,0,0,3,1022,0.033025000,0.6491
215.158.239.79,<->,199.20.30.190,3,1370,0,0,3,1370,0.032054000,1.2394
195.127.57.50,<->,136.25.188.162,0,0,3,1157,3,1157,0.031996000,0.6236
215.158.238.72,<->,122.159.245.165,3,3863,0,0,3,3863,0.031986000,1.0455
136.25.189.38,<->,96.156.169.210,3,1759,0,0,3,1759,0.031510000,0.9271
195.5.251.54,<->,136.25.188.255,0,0,3,1806,3,1806,0.031355000,1.6613
215.158.239.70,<->,199.20.4.230,3,1211,0,0,3,1211,0.031210000,0.5309
136.25.189.59,<->,68.124.221.157,3,2863,0,0,3,2863,0.031159000,1.6994
215.158.140.207,<->,6.228.239.25,3,1738,0,0,3,1738,0.031124000,0.2730
136.25.188.220,<->,48.25.220.86,3,894,0,0,3,894,0.030916000,0.0069
215.158.239.96,<->,195.126.189.33,3,1252,0,0,3,1252,0.030558000,0.0181
195.55.122.117,<->,136.25.188.46,0,0,3,765,3,765,0.030513000,0.3414
207.236.47.30,<->,136.25.188.236,0,0,3,1709,3,1709,0.029621000,0.5837
136.25.189.12,<->,29.212.199.220,3,3927,0,0,3,3927,0.029411000,1.5751
215.158.239.78,<->,194.251.84.58,3,1044,0,0,3,1044,0.029394000,0.7327
92.27.219.221,<->,29.158.128.133,3,4110,0,0,3,4110,0.028437000,0.8845
133.178.227.57,<->,8.191.7.76,3,3250,0,0,3,3250,0.026612000,1.7686
195.124.115.131,<->,136.25.188.44,0,0,3,951,3,951,0.026224000,1.5197
215.158.239.95,<->,199.20.29.150,3,1063,0,0,3,1063,0.026219000,0.0598
17.228.210.76,<->,8.220.190.86,0,0,3,1588,3,1588,0.026045000,0.4380
204.63.194.7,<->,136.25.188.255,0,0,3,977,3,977,0.025949000,0.4691
136.25.189.18,<->,29.211.228.176,3,2991,0,0,3,2991,0.025614000,0.4573
215.158.238.220,<->,111.150.187.125,3,3543,0,0,3,3543,0.025103000,0.9828
136.25.188.217,<->,100.224.202.157,3,1518,0,0,3,1518,0.025069000,0.8920
215.158.238.143,<->,8.42.43.43,3,4071,0,0,3,4071,0.024641000,0.6345
204.56.10.171,<->,136.25.188.209,0,0,3,1057,3,1057,0.023364000,0.2622
215.158.239.93,<->,106.188.253.166,3,3823,0,0,3,3823,0.022401000,1.7136
54.36.97.247,<->,6.95.7.197,0,0,3,1884,3,1884,0.022337000,0.2527
136.25.189.17,<->,96.156.169.220,3,4023,0,0,3,4023,0.021567000,0.6913
215.158.238.73,<->,65.27.228.201,3,3895,0,0,3,3895,0.020640000,1.4684
215.158.239.93,<->,199.20.30.46,3,580,0,0,3,580,0.019175000,1.0996
136.25.188.160,<->,132.123.119.101,3,1159,0,0,3,1159,0.018840000,0.2803
136.25.188.253,<->,99.192.168.187,3,3572,0,0,3,3572,0.017924000,1.2567
136.25.188.45,<->,122.159.245.165,3,3719,0,0,3,3719,0.017491000,1.6635
220.28.85.14,<->,136.25.189.24,0,0,3,592,3,592,0.017155000,0.0971
215.158.61.145,<->,8.176.8.215,0,0,3,2667,3,2667,0.017153000,1.5621
220.28.115.46,<->,133.178.227.61,0,0,3,971,3,971,0.016539000,1.9301
215.158.239.76,<->,199.20.30.133,3,395,0,0,3,395,0.016011000,1.1303
197.125.126.181,<->,136.25.188.224,0,0,3,3815,3,3815,0.016003000,1.8082
136.25.189.13,<->,56.28.207.200,3,4279,0,0,3,4279,0.015813000,1.6384
158.85.50.71,<->,133.178.227.1,0,0,3,3431,3,3431,0.014869000,1.4959
50.224.80.64,<->,50.118.122.183,3,1747,0,0,3,1747,0.014473000,1.3787
136.25.189.15,<->,126.219.190.168,3,1647,0,0,3,1647,0.014462000,0.3852
215.158.239.86,<->,195.42.52.167,3,1673,0,0,3,1673,0.014387000,0.3378
215.158.238.148,<->,131.1.253.250,3,2711,0,0,3,2711,0.014296000,1.6427
145.237.135.90,<->,137.21.23.210,0,0,3,174,3,174,0.014085000,1.0026
142.190.111.118,<->,136.25.188.255,0,0,3,1234,3,1234,0.014035000,0.5711
133.178.227.242,<->,120.154.187.198,3,1519,0,0,3,1519,0.013790000,0.0001
192.64.226.26,<->,139.241.56.117,3,4367,0,0,3,4367,0.013040000,0.4125
215.158.239.76,<->,199.20.31.88,3,1672,0,0,3,1672,0.012979000,1.7756
215.158.239.93,<->,8.222.98.137,3,2799,0,0,3,2799,0.011993000,1.0278
215.158.140.178,<->,8.222.7.184,3,2996,0,0,3,2996,0.011602000,1.9468
215.158.239.43,<->,29.214.74.225,3,4355,0,0,3,4355,0.011410000,1.0511
215.158.239.56,<->,199.20.28.64,3,944,0,0,3,944,0.011167000,0.1999
221.102.56.46,<->,192.64.90.213,0,0,3,3328,3,3328,0.010945000,0.0983
136.25.189.16,<->,8.50.171.213,3,3863,0,0,3,3863,0.010786000,1.5279
215.158.239.58,<->,196.93.184.165,3,1704,0,0,3,1704,0.010601000,0.4179
136.25.189.32,<->,126.219.49.10,3,3815,0,0,3,3815,0.010343000,1.1675
220.28.115.46,<->,215.158.238.192,0,0,3,2607,3,2607,0.009543000,1.9353
215.158.238.236,<->,8.240.116.231,3,3442,0,0,3,3442,0.009460000,1.9895
231.141.0.244,<->,215.158.239.92,0,0,3,1675,3,1675,0.009209000,0.9758
215.158.239.76,<->,192.224.21.49,3,3815,0,0,3,3815,0.009098000,1.0256
192.67.160.161,<->,117.196.96.71,3,763,0,0,3,763,0.008569000,0.6468
136.25.188.174,<->,41.166.167.52,3,1062,0,0,3,1062,0.008021000,0.0070
136.25.188.226,<->,8.191.15.68,3,3991,0,0,3,3991,0.007678000,1.3689
215.158.238.135,<->,8.241.236.25,3,1631,0,0,3,1631,0.007488000,0.2467
196.206.213.182,<->,136.25.188.220,0,0,3,1706,3,1706,0.007295000,0.2304
215.158.140.205,<->,8.222.7.168,3,2933,0,0,3,2933,0.007050000,1.9496
194.237.22.26,<->,136.25.188.163,0,0,3,1057,3,1057,0.006418000,0.2730
132.49.146.82,<->,54.58.153.140,3,1133,0,0,3,1133,0.006241000,0.2029
215.158.238.176,<->,8.219.185.40,3,3575,0,0,3,3575,0.005964000,1.1945
215.158.3.131,<->,8.176.8.67,0,0,3,879,3,879,0.005713000,0.6450
215.158.239.56,<->,207.239.59.147,3,1013,0,0,3,1013,0.005573000,1.3369
192.204.243.54,<->,133.178.227.251,0,0,3,2040,3,2040,0.004922000,1.7188
215.158.238.99,<->,48.129.133.30,3,4007,0,0,3,4007,0.004820000,1.3577
127.159.140.231,<->,98.232.172.244,0,0,3,2515,3,2515,0.004385000,0.1443
142.166.40.166,<->,136.25.188.199,0,0,3,1017,3,1017,0.003897000,0.0279
215.158.238.223,<->,8.240.116.197,3,3751,0,0,3,3751,0.002763000,1.5775
215.158.238.193,<->,98.219.126.140,3,3289,0,0,3,3289,0.002643000,1.3759
145.116.209.4,<->,136.25.188.203,0,0,3,2631,3,2631,0.002608000,0.0436
145.192.64.35,<->,8.52.183.20,0,0,3,1208,3,1208,0.002297000,0.1999
215.158.238.190,<->,8.252.253.226,3,3316,0,0,3,3316,0.002109000,1.2442
215.158.239.68,<->,199.73.48.129,3,1655,0,0,3,1655,0.001779000,0.6613
215.158.239.56,<->,199.20.28.175,3,670,0,0,3,670,0.001376000,1.5796
215.158.238.134,<->,29.211.6.45,3,3895,0,0,3,3895,0.000932000,1.9182
192.65.74.251,<->,8.45.144.116,3,2773,0,0,3,2773,0.000574000,1.7936
136.25.189.29,<->,106.188.253.129,3,3926,0,0,3,3926,0.000463000,1.0471
204.200.61.119,<->,136.25.188.163,0,0,2,188,2,188,1.999501000,0.0000
102.232.21.59,<->,8.49.69.216,2,1432,0,0,2,1432,1.999213000,0.0000
143.132.133.221,<->,136.25.188.45,0,0,2,188,2,188,1.995474000,0.0028
8.55.223.68,<->,6.228.54.9,0,0,2,1376,2,1376,1.994795000,0.0000
215.158.140.217,<->,53.231.66.14,2,508,0,0,2,508,1.991337000,0.0000
215.158.239.48,<->,196.90.192.14,2,188,0,0,2,188,1.985950000,0.0000
129.225.141.239,<->,129.225.132.96,0,0,2,1601,2,1601,1.980073000,0.0000
199.39.41.121,<->,136.25.188.209,0,0,2,188,2,188,1.979406000,0.0014
195.68.70.165,<->,136.25.188.236,0,0,2,960,2,960,1.973445000,0.0002
142.247.211.184,<->,136.25.188.196,0,0,2,392,2,392,1.971837000,0.0029
215.158.239.96,<->,207.61.23.119,2,925,0,0,2,925,1.968539000,0.0020
8.45.144.116,<->,6.228.25.12,0,0,2,1235,2,1235,1.967836000,0.0000
221.102.113.220,<->,100.241.191.26,2,656,0,0,2,656,1.966158000,0.0302
204.187.124.135,<->,136.25.188.199,0,0,2,188,2,188,1.965227000,0.0100
143.20.129.111,<->,136.25.188.253,0,0,2,188,2,188,1.963170000,0.0066
215.158.239.99,<->,196.89.246.79,2,188,0,0,2,188,1.962030000,0.0037
195.55.131.131,<->,136.25.188.238,0,0,2,188,2,188,1.961619000,0.0022
199.72.101.125,<->,136.25.188.174,0,0,2,188,2,188,1.960618000,0.0025
142.221.21.108,<->,136.25.188.44,0,0,2,956,2,956,1.959528000,0.0016
194.252.68.61,<->,0.195.210.33,0,0,2,188,2,188,1.958347000,0.0041
215.158.61.182,<->,8.176.8.102,0,0,2,493,2,493,1.957981000,0.0340
207.61.91.103,<->,136.25.188.255,0,0,2,1780,2,1780,1.957745000,0.0146
207.59.187.85,<->,136.25.188.222,0,0,2,1122,2,1122,1.957269000,0.0000
221.102.56.46,<->,192.65.60.185,0,0,2,1716,2,1716,1.955536000,0.0028
122.223.116.201,<->,50.224.108.171,0,0,2,279,2,279,1.955523000,0.0153
204.200.63.83,<->,136.25.188.46,0,0,2,188,2,188,1.953332000,0.0000
215.158.239.69,<->,199.20.4.195,2,188,0,0,2,188,1.951265000,0.0000
215.158.239.97,<->,194.199.199.166,2,958,0,0,2,958,1.950563000,0.0000
139.47.239.28,<->,33.106.172.157,2,1607,0,0,2,1607,1.950272000,0.0250
215.158.61.192,<->,8.176.8.179,0,0,2,1507,2,1507,1.949341000,0.0000
215.158.239.79,<->,196.88.180.76,2,188,0,0,2,188,1.945783000,0.0025
202.33.86.90,<->,136.25.188.209,0,0,2,188,2,188,1.942495000,0.0000
215.158.239.99,<->,199.106.249.160,2,188,0,0,2,188,1.942465000,0.0000
142.236.24.52,<->,136.25.188.177,0,0,2,188,2,188,1.942462000,0.0039
159.112.9.198,<->,145.16.10.145,0,0,2,162,2,162,1.941537000,0.0556
204.200.44.104,<->,136.25.188.209,0,0,2,1194,2,1194,1.940732000,0.0123
142.249.34.121,<->,136.25.188.177,0,0,2,960,2,960,1.940577000,0.0026
204.167.236.244,<->,39.248.89.87,0,0,2,751,2,751,1.940080000,0.0399
215.158.239.85,<->,196.93.5.8,2,969,0,0,2,969,1.939612000,0.0198
53.231.92.232,<->,48.52.216.20,0,0,2,1562,2,1562,1.937028000,0.0001
221.102.56.69,<->,102.81.152.248,0,0,2,588,2,588,1.936066000,0.0100
199.122.43.226,<->,136.25.188.176,0,0,2,188,2,188,1.936018000,0.0021
142.227.19.141,<->,136.25.188.253,0,0,2,959,2,959,1.933587000,0.0020
139.163.26.146,<->,138.73.226.247,2,202,0,0,2,202,1.931900000,0.0030
194.254.226.57,<->,8.252.222.156,0,0,2,188,2,188,1.931791000,0.0000
195.13.254.149,<->,136.25.188.253,0,0,2,982,2,982,1.931636000,0.0021
221.102.143.189,<->,6.228.22.53,0,0,2,2512,2,2512,1.929970000,0.0121
132.216.159.4,<->,92.162.253.85,0,0,2,2261,2,2261,1.929087000,0.0051
215.158.238.218,<->,215.158.132.242,2,1552,0,0,2,1552,1.928261000,0.0001
194.233.25.163,<->,136.25.188.175,0,0,2,958,2,958,1.927972000,0.0000
215.158.239.69,<->,199.76.9.231,2,242,0,0,2,242,1.925920000,0.0070
207.172.164.74,<->,136.25.188.175,0,0,2,188,2,188,1.925303000,0.0399
142.240.226.24,<->,136.25.188.241,0,0,2,164,2,164,1.923843000,0.0022
215.158.239.48,<->,204.0.244.199,2,963,0,0,2,963,1.923576000,0.0098
207.59.238.132,<->,136.25.188.52,0,0,2,188,2,188,1.922993000,0.0025
215.158.61.203,<->,136.25.188.38,0,0,2,1606,2,1606,1.921398000,0.0000
195.71.130.122,<->,136.25.188.46,0,0,2,943,2,943,1.917224000,0.0028
195.54.108.162,<->,136.25.188.162,0,0,2,188,2,188,1.917180000,0.0025
196.88.7.49,<->,136.25.188.237,0,0,2,188,2,188,1.914993000,0.0007
231.140.235.239,<->,215.158.239.79,0,0,2,186,2,186,1.913358000,0.0097
215.158.239.99,<->,199.20.28.225,2,944,0,0,2,944,1.913195000,0.0093
215.158.239.93,<->,196.1.204.70,2,188,0,0,2,188,1.912081000,0.0100
136.18.9.161,<->,8.182.136.210,0,0,2,478,2,478,1.911052000,0.0840
142.248.19.64,<->,136.25.188.252,0,0,2,958,2,958,1.907805000,0.0026
92.162.252.153,<->,33.148.8.234,2,414,0,0,2,414,1.907755000,0.0003
199.80.3.58,<->,136.25.188.253,0,0,2,188,2,188,1.907542000,0.0029
139.254.213.90,<->,8.5.207.243,2,1058,0,0,2,1058,1.907518000,0.0000
215.158.239.93,<->,207.62.71.76,2,936,0,0,2,936,1.907497000,0.0037
215.158.239.49,<->,199.20.5.167,2,965,0,0,2,965,1.906590000,0.0000
194.234.203.239,<->,136.25.188.236,0,0,2,188,2,188,1.906432000,0.0025
231.136.241.241,<->,136.25.188.241,0,0,2,188,2,188,1.905051000,0.0201
195.124.253.80,<->,136.25.188.209,0,0,2,188,2,188,1.905050000,0.0000
195.13.153.197,<->,136.25.188.242,0,0,2,188,2,188,1.903758000,0.0017
145.242.126.105,<->,98.197.185.18,2,251,0,0,2,251,1.903658000,0.0914
204.61.83.193,<->,136.25.188.44,0,0,2,188,2,188,1.903370000,0.0054
143.89.180.115,<->,136.25.188.241,0,0,2,735,2,735,1.902857000,0.0944
143.53.255.61,<->,136.25.188.225,0,0,2,188,2,188,1.902247000,0.0029
245.207.109.146,<->,221.102.103.73,0,0,2,520,2,520,1.902194000,0.0173
195.15.170.142,<->,136.25.188.241,0,0,2,188,2,188,1.902124000,0.0022
199.83.55.4,<->,136.25.188.209,0,0,2,188,2,188,1.901349000,0.0063
143.12.234.77,<->,136.25.188.174,0,0,2,188,2,188,1.900180000,0.0108
143.42.155.215,<->,136.25.188.222,0,0,2,426,2,426,1.896040000,0.0027
215.158.239.68,<->,196.91.35.67,2,188,0,0,2,188,1.895986000,0.0395
207.61.46.18,<->,136.25.188.177,0,0,2,989,2,989,1.895526000,0.0026
207.20.191.116,<->,8.252.222.208,0,0,2,188,2,188,1.894816000,0.0026
204.184.217.171,<->,136.25.188.198,0,0,2,188,2,188,1.894058000,0.0103
215.158.239.87,<->,199.71.157.70,2,946,0,0,2,946,1.892989000,0.0022
136.25.189.43,<->,98.219.126.140,2,757,0,0,2,757,1.891142000,0.0929
231.255.222.140,<->,109.1.57.207,0,0,2,983,2,983,1.890572000,0.0001
199.72.22.79,<->,136.25.188.198,0,0,2,388,2,388,1.888848000,0.0042
125.223.119.32,<->,100.228.42.100,0,0,2,1130,2,1130,1.887866000,0.0975
215.158.239.68,<->,199.20.5.132,2,188,0,0,2,188,1.887118000,0.0400
215.158.239.58,<->,204.226.100.19,2,920,0,0,2,920,1.887057000,0.0003
215.158.238.93,<->,99.192.168.160,2,434,0,0,2,434,1.886771000,0.0601
145.208.160.99,<->,50.145.93.227,2,850,0,0,2,850,1.885080000,0.0000
128.91.191.123,<->,80.40.13.234,0,0,2,774,2,774,1.882637000,0.0001
215.201.26.177,<->,8.182.226.78,0,0,2,1122,2,1122,1.881191000,0.0156
215.158.239.101,<->,129.222.36.66,2,1479,0,0,2,1479,1.881176000,0.0988
202.33.44.121,<->,136.25.188.178,0,0,2,188,2,188,1.880310000,0.0010
195.5.131.126,<->,136.25.188.160,0,0,2,188,2,188,1.879502000,0.0017
195.41.195.238,<->,136.25.188.238,0,0,2,188,2,188,1.878956000,0.0020
215.158.239.78,<->,199.20.4.42,2,963,0,0,2,963,1.877908000,0.0689
207.61.72.59,<->,136.25.188.242,0,0,2,188,2,188,1.877215000,0.0000
247.136.159.39,<->,136.152.91.130,2,866,0,0,2,866,1.876882000,0.0395
139.241.64.237,<->,136.25.188.195,0,0,2,1785,2,1785,1.875574000,0.0002
136.25.188.177,<->,92.48.92.132,2,466,0,0,2,466,1.875146000,0.1212
204.200.39.243,<->,136.25.188.255,0,0,2,188,2,188,1.874873000,0.0000
215.158.239.86,<->,143.132.101.154,2,188,0,0,2,188,1.873343000,0.0021
199.69.152.14,<->,136.25.188.222,0,0,2,349,2,349,1.870481000,0.0014
215.158.61.191,<->,8.176.8.176,0,0,2,1541,2,1541,1.868408000,0.0618
194.234.206.158,<->,136.25.188.209,0,0,2,953,2,953,1.867091000,0.0017
223.176.113.234,<->,8.252.222.36,0,0,2,188,2,188,1.863707000,0.0000
144.83.60.153,<->,92.162.253.28,0,0,2,1072,2,1072,1.861230000,0.0000
212.164.143.230,<->,100.120.38.110,2,1376,0,0,2,1376,1.860797000,0.0000
199.39.76.4,<->,136.25.188.196,0,0,2,188,2,188,1.860480000,0.0021
215.158.239.69,<->,126.219.194.6,2,2800,0,0,2,2800,1.859733000,0.0989
215.158.239.76,<->,199.20.28.202,2,938,0,0,2,938,1.859598000,0.0098
26.223.52.82,<->,8.220.190.86,0,0,2,834,2,834,1.856883000,0.0022
199.68.126.171,<->,136.25.188.55,0,0,2,610,2,610,1.856811000,0.0203
132.49.149.137,<->,53.231.66.33,2,737,0,0,2,737,1.855939000,0.0036
215.158.239.84,<->,195.49.251.245,2,188,0,0,2,188,1.855488000,0.0198
59.146.207.87,<->,50.224.89.243,0,0,2,853,2,853,1.854523000,0.0016
215.158.239.56,<->,199.20.28.63,2,1456,0,0,2,1456,1.854494000,0.0711
109.126.217.233,<->,8.52.222.23,0,0,2,656,2,656,1.853675000,0.0617
207.58.104.155,<->,136.25.188.236,0,0,2,947,2,947,1.853565000,0.0021
204.63.54.230,<->,136.25.188.196,0,0,2,951,2,951,1.852324000,0.0400
215.158.238.115,<->,56.161.218.21,2,2762,0,0,2,2762,1.852220000,0.0754
233.97.214.206,<->,129.6.83.6,0,0,2,529,2,529,1.851459000,0.1108
17.61.232.100,<->,8.220.202.4,0,0,2,356,2,356,1.850370000,0.0685
221.102.143.189,<->,109.1.3.195,0,0,2,2188,2,2188,1.850356000,0.0839
215.158.239.78,<->,196.109.175.222,2,971,0,0,2,971,1.850261000,0.0000
195.14.69.238,<->,136.25.188.226,0,0,2,188,2,188,1.845976000,0.0026
142.244.200.60,<->,136.25.188.46,0,0,2,920,2,920,1.845597000,0.0022
143.132.139.161,<->,136.25.188.252,0,0,2,188,2,188,1.844662000,0.0020
195.13.209.157,<->,136.25.188.254,0,0,2,956,2,956,1.844554000,0.0038
215.158.238.233,<->,215.158.33.113,2,642,0,0,2,642,1.843859000,0.0002
223.176.113.234,<->,8.252.222.141,0,0,2,188,2,188,1.843134000,0.0000
215.158.239.77,<->,207.228.117.16,2,188,0,0,2,188,1.842890000,0.0000
145.26.83.1,<->,8.220.202.4,0,0,2,417,2,417,1.842660000,0.0858
152.139.166.235,<->,80.27.157.236,0,0,2,218,2,218,1.841467000,0.0053
196.88.201.14,<->,136.25.188.54,0,0,2,950,2,950,1.840950000,0.0033
204.60.160.33,<->,136.25.188.199,0,0,2,220,2,220,1.840664000,0.0176
215.158.239.69,<->,207.61.248.74,2,800,0,0,2,800,1.839392000,0.0290
204.200.63.204,<->,136.25.188.177,0,0,2,387,2,387,1.836206000,0.1215
159.112.9.198,<->,56.121.50.130,0,0,2,162,2,162,1.836146000,0.1085
142.228.215.107,<->,136.25.188.53,0,0,2,948,2,948,1.835198000,0.0023
136.25.189.94,<->,96.156.169.226,2,1895,0,0,2,1895,1.834014000,0.0001
215.158.239.84,<->,199.20.28.204,2,959,0,0,2,959,1.833706000,0.0000
215.158.239.87,<->,143.42.43.107,2,223,0,0,2,223,1.832893000,0.0022
129.225.132.71,<->,129.225.131.47,2,1122,0,0,2,1122,1.832834000,0.0000
143.148.100.254,<->,0.195.210.46,0,0,2,188,2,188,1.831619000,0.0089
119.219.154.242,<->,92.168.217.245,0,0,2,632,2,632,1.831548000,0.1563
231.143.89.81,<->,136.25.188.54,0,0,2,188,2,188,1.831345000,0.0000
212.164.132.228,<->,133.30.255.42,2,808,0,0,2,808,1.829410000,0.0000
143.44.28.196,<->,136.25.188.199,0,0,2,188,2,188,1.827851000,0.0039
129.236.114.39,<->,101.224.89.253,0,0,2,1509,2,1509,1.826748000,0.0001
215.158.239.86,<->,196.1.105.243,2,188,0,0,2,188,1.826698000,0.0199
199.82.242.44,<->,136.25.188.242,0,0,2,188,2,188,1.826400000,0.0000
207.6.93.204,<->,8.220.178.73,0,0,2,504,2,504,1.826370000,0.0161
195.13.12.243,<->,136.25.188.175,0,0,2,390,2,390,1.826217000,0.0025
204.61.231.227,<->,136.25.188.55,0,0,2,758,2,758,1.824086000,0.1674
111.147.236.79,<->,50.145.81.54,2,150,0,0,2,150,1.823039000,0.0182
129.236.114.39,<->,101.224.89.153,0,0,2,1271,2,1271,1.822342000,0.0001
17.24.139.9,<->,8.220.188.50,0,0,2,463,2,463,1.822215000,0.0365
136.25.188.199,<->,61.34.33.254,2,188,0,0,2,188,1.822074000,0.0003
215.158.239.50,<->,199.20.7.43,2,949,0,0,2,949,1.817791000,0.0783
215.158.140.230,<->,132.220.8.201,2,351,0,0,2,351,1.816363000,0.0350
109.1.43.8,<->,8.55.195.24,2,842,0,0,2,842,1.816072000,0.0405
195.124.81.254,<->,136.25.188.174,0,0,2,1016,2,1016,1.815960000,0.0398
215.158.239.59,<->,196.108.254.251,2,188,0,0,2,188,1.815709000,0.0000
215.158.239.49,<->,143.91.233.92,2,963,0,0,2,963,1.813777000,0.0000
204.62.152.26,<->,136.25.188.253,0,0,2,188,2,188,1.813268000,0.0000
26.223.52.82,<->,8.220.200.124,0,0,2,656,2,656,1.812719000,0.0355
97.168.79.200,<->,0.195.216.193,2,164,0,0,2,164,1.811839000,0.0000
136.25.189.59,<->,96.156.169.212,2,2858,0,0,2,2858,1.810244000,0.1848
207.58.224.220,<->,136.25.188.241,0,0,2,527,2,527,1.808791000,0.0855
142.190.67.102,<->,136.25.188.196,0,0,2,680,2,680,1.807624000,0.1817
220.28.73.211,<->,215.158.238.234,0,0,2,823,2,823,1.807524000,0.1899
221.102.143.189,<->,192.65.66.76,0,0,2,2188,2,2188,1.807438000,0.0356
204.200.40.15,<->,136.25.188.163,0,0,2,430,2,430,1.807204000,0.1836
139.163.120.42,<->,125.204.20.202,2,792,0,0,2,792,1.805717000,0.1237
246.254.97.109,<->,54.59.253.241,2,174,0,0,2,174,1.805316000,0.0014
199.51.135.40,<->,136.25.188.241,0,0,2,954,2,954,1.805242000,0.0029
192.204.123.22,<->,136.25.189.29,0,0,2,2618,2,2618,1.803456000,0.1873
133.178.227.16,<->,133.56.180.58,2,1410,0,0,2,1410,1.802593000,0.1814
136.25.189.196,<->,111.42.25.254,2,654,0,0,2,654,1.802264000,0.0366
221.102.56.69,<->,129.1.92.242,0,0,2,588,2,588,1.801813000,0.0036
97.11.180.6,<->,54.39.188.198,2,542,0,0,2,542,1.801645000,0.1620
92.27.219.185,<->,42.204.31.48,2,1650,0,0,2,1650,1.800551000,0.0045
249.101.225.116,<->,105.122.151.32,2,612,0,0,2,612,1.800270000,0.1577
54.38.47.227,<->,48.54.241.97,0,0,2,1888,2,1888,1.798758000,0.0014
111.146.235.136,<->,100.218.108.151,2,1585,0,0,2,1585,1.796681000,0.0317
100.93.217.200,<->,0.195.202.28,2,713,0,0,2,713,1.795596000,0.0000
137.47.232.19,<->,8.220.176.253,0,0,2,560,2,560,1.795124000,0.0055
204.186.197.47,<->,136.25.188.177,0,0,2,188,2,188,1.793222000,0.0097
136.250.252.100,<->,8.220.204.62,0,0,2,599,2,599,1.792170000,0.0318
136.25.189.6,<->,56.28.207.205,2,2051,0,0,2,2051,1.791073000,0.0002
106.0.126.211,<->,89.183.104.163,0,0,2,1887,2,1887,1.788938000,0.0075
136.25.189.53,<->,96.156.169.208,2,306,0,0,2,306,1.787207000,0.0005
199.52.87.66,<->,136.25.188.198,0,0,2,188,2,188,1.787103000,0.0039
231.136.241.241,<->,136.25.188.236,0,0,2,188,2,188,1.786985000,0.0193
127.255.90.88,<->,92.162.253.37,0,0,2,962,2,962,1.786386000,0.0000
204.3.142.141,<->,136.25.188.241,0,0,2,188,2,188,1.786205000,0.0029
195.55.112.191,<->,136.25.188.241,0,0,2,188,2,188,1.785783000,0.0020
215.158.239.22,<->,215.158.127.145,2,1875,0,0,2,1875,1.785575000,0.0001
215.158.239.93,<->,199.20.28.127,2,1204,0,0,2,1204,1.784684000,0.0519
221.102.143.189,<->,218.4.187.23,0,0,2,854,2,854,1.784568000,0.0704
159.137.162.213,<->,105.81.55.121,2,676,0,0,2,676,1.784565000,0.0039
195.54.83.223,<->,136.25.188.175,0,0,2,937,2,937,1.784254000,0.0031
139.163.96.101,<->,136.98.131.10,2,353,0,0,2,353,1.783283000,0.0059
215.158.239.99,<->,199.20.4.130,2,1804,0,0,2,1804,1.783030000,0.0501
136.25.188.226,<->,41.154.159.9,2,656,0,0,2,656,1.782607000,0.0201
143.42.198.52,<->,136.25.188.177,0,0,2,188,2,188,1.782319000,0.0013
215.158.238.133,<->,91.57.173.25,2,2858,0,0,2,2858,1.781447000,0.1746
215.158.239.92,<->,199.20.30.64,2,188,0,0,2,188,1.781086000,0.0101
142.220.118.197,<->,136.25.188.177,0,0,2,546,2,546,1.780671000,0.2145
195.124.102.68,<->,136.25.188.252,0,0,2,188,2,188,1.775601000,0.0119
6.145.165.231,<->,0.195.210.44,0,0,2,266,2,266,1.775558000,0.0000
133.178.227.247,<->,8.61.93.38,2,1290,0,0,2,1290,1.771663000,0.0000
195.40.127.204,<->,136.25.188.163,0,0,2,774,2,774,1.770356000,0.2190
195.43.55.231,<->,136.25.188.177,0,0,2,979,2,979,1.769988000,0.0034
215.158.238.135,<->,91.57.173.44,2,2586,0,0,2,2586,1.769008000,0.1829
54.37.229.45,<->,48.55.80.159,0,0,2,234,2,234,1.768589000,0.0747
202.33.49.188,<->,136.25.188.225,0,0,2,188,2,188,1.767345000,0.0071
215.158.238.250,<->,126.219.191.4,2,2189,0,0,2,2189,1.766467000,0.2147
199.70.222.17,<->,136.25.188.253,0,0,2,961,2,961,1.766356000,0.0020
195.71.161.9,<->,136.25.188.252,0,0,2,945,2,945,1.765768000,0.0381
146.193.46.105,<->,8.252.222.158,0,0,2,188,2,188,1.763923000,0.0000
137.231.34.73,<->,89.183.104.181,0,0,2,1584,2,1584,1.763839000,0.1205
220.55.112.205,<->,17.200.29.20,2,1078,0,0,2,1078,1.763718000,0.0005
215.158.239.35,<->,8.222.7.187,2,2234,0,0,2,2234,1.763061000,0.1956
195.71.168.154,<->,136.25.188.237,0,0,2,608,2,608,1.762508000,0.0431
193.81.55.138,<->,92.162.253.7,0,0,2,1751,2,1751,1.761453000,0.1960
215.158.239.48,<->,195.49.62.93,2,960,0,0,2,960,1.760987000,0.1099
215.158.239.85,<->,199.69.65.114,2,188,0,0,2,188,1.757747000,0.0027
143.87.150.3,<->,136.25.188.178,0,0,2,656,2,656,1.756997000,0.2172
204.184.166.251,<->,136.25.188.177,0,0,2,951,2,951,1.756130000,0.0199
195.71.83.109,<->,136.25.188.198,0,0,2,188,2,188,1.755642000,0.0035
215.158.239.87,<->,199.72.93.129,2,774,0,0,2,774,1.755230000,0.1781
204.200.54.97,<->,136.25.188.198,0,0,2,430,2,430,1.755197000,0.1663
8.55.211.213,<->,6.72.19.178,0,0,2,588,2,588,1.754221000,0.0123
97.39.76.162,<->,8.52.134.194,0,0,2,454,2,454,1.753621000,0.0650
215.158.239.48,<->,199.20.28.12,2,188,0,0,2,188,1.751207000,0.0000
142.253.91.82,<->,136.25.188.254,0,0,2,188,2,188,1.751040000,0.0020
194.233.118.36,<->,136.25.188.177,0,0,2,948,2,948,1.750245000,0.0180
102.83.194.212,<->,8.55.224.156,2,1670,0,0,2,1670,1.749258000,0.1483
143.94.165.210,<->,136.25.188.252,0,0,2,188,2,188,1.746643000,0.0023
215.158.239.48,<->,199.20.29.23,2,188,0,0,2,188,1.746304000,0.0000
142.240.211.219,<->,136.25.188.176,0,0,2,188,2,188,1.744934000,0.0000
144.93.22.181,<->,99.74.51.61,0,0,2,743,2,743,1.744632000,0.0000
206.153.192.204,<->,133.32.1.140,0,0,2,1902,2,1902,1.744215000,0.1593
204.187.233.12,<->,136.25.188.175,0,0,2,963,2,963,1.743322000,0.0219
215.158.239.87,<->,207.239.58.57,2,1071,0,0,2,1071,1.742315000,0.0117
215.158.239.86,<->,196.91.49.85,2,1066,0,0,2,1066,1.739754000,0.1394
215.158.140.95,<->,98.219.126.140,2,880,0,0,2,880,1.739454000,0.0000
133.178.227.253,<->,120.155.223.156,2,1652,0,0,2,1652,1.739151000,0.2349
215.158.239.68,<->,196.107.156.179,2,774,0,0,2,774,1.739115000,0.2493
111.14.33.189,<->,92.162.253.158,0,0,2,2008,2,2008,1.738178000,0.0498
220.28.115.46,<->,133.178.226.0,0,0,2,1058,2,1058,1.737801000,0.1752
210.44.4.36,<->,8.220.204.234,0,0,2,500,2,500,1.737127000,0.0014
215.158.140.87,<->,159.36.239.240,2,680,0,0,2,680,1.736426000,0.0760
142.223.255.173,<->,136.25.188.174,0,0,2,956,2,956,1.736375000,0.0024
136.62.175.106,<->,8.35.106.46,2,789,0,0,2,789,1.734289000,0.0440
139.9.194.133,<->,136.25.188.176,0,0,2,295,2,295,1.734080000,0.0000
133.178.226.14,<->,8.222.212.40,2,1434,0,0,2,1434,1.733011000,0.0744
192.65.176.17,<->,8.45.172.15,2,1134,0,0,2,1134,1.732483000,0.2570
247.136.248.229,<->,14.30.152.10,2,1118,0,0,2,1118,1.731595000,0.1461
215.158.239.49,<->,196.88.16.105,2,936,0,0,2,936,1.730625000,0.0032
215.158.239.76,<->,194.199.210.94,2,188,0,0,2,188,1.730212000,0.0000
221.196.123.141,<->,138.98.230.215,0,0,2,555,2,555,1.728674000,0.1988
215.158.239.48,<->,196.89.228.182,2,188,0,0,2,188,1.728188000,0.0017
108.134.117.90,<->,30.58.134.103,2,1922,0,0,2,1922,1.726024000,0.0014
215.158.61.202,<->,136.25.188.34,0,0,2,1395,2,1395,1.725476000,0.1016
215.158.239.95,<->,196.92.93.79,2,188,0,0,2,188,1.724519000,0.0199
203.215.162.183,<->,124.42.185.84,2,699,0,0,2,699,1.723631000,0.1535
204.200.36.66,<->,136.25.188.52,0,0,2,976,2,976,1.723612000,0.0001
129.225.135.32,<->,129.225.132.72,0,0,2,1601,2,1601,1.722865000,0.0000
142.248.57.243,<->,136.25.188.196,0,0,2,188,2,188,1.722236000,0.0042
8.52.223.85,<->,8.3.132.65,2,621,0,0,2,621,1.721762000,0.0100
133.178.227.208,<->,8.50.169.192,2,434,0,0,2,434,1.721158000,0.0003
197.113.99.238,<->,136.25.188.176,0,0,2,188,2,188,1.718428000,0.0090
220.185.228.201,<->,89.183.104.148,0,0,2,246,2,246,1.718374000,0.0658
142.207.162.203,<->,136.25.188.197,0,0,2,219,2,219,1.718177000,0.0133
143.89.225.230,<->,136.25.188.238,0,0,2,188,2,188,1.717607000,0.0028
215.158.239.95,<->,204.61.35.173,2,950,0,0,2,950,1.717502000,0.0021
220.28.104.193,<->,133.178.227.21,0,0,2,1219,2,1219,1.717230000,0.1178
196.206.223.55,<->,136.25.188.163,0,0,2,774,2,774,1.715677000,0.2595
222.65.16.220,<->,132.216.20.184,2,302,0,0,2,302,1.715650000,0.0731
215.158.239.78,<->,194.199.217.220,2,960,0,0,2,960,1.715511000,0.0000
207.57.241.1,<->,136.25.188.54,0,0,2,188,2,188,1.715380000,0.0039
109.222.12.64,<->,8.182.139.168,0,0,2,656,2,656,1.714932000,0.0512
215.158.239.78,<->,194.251.142.248,2,464,0,0,2,464,1.714184000,0.1907
199.82.220.118,<->,136.25.188.252,0,0,2,188,2,188,1.711748000,0.0030
199.82.58.186,<->,136.25.188.252,0,0,2,603,2,603,1.710647000,0.1202
136.25.189.202,<->,129.222.39.114,2,1154,0,0,2,1154,1.709854000,0.0257
125.194.72.26,<->,109.1.58.226,0,0,2,248,2,248,1.708717000,0.1564
215.158.140.184,<->,8.222.7.182,2,2006,0,0,2,2006,1.708549000,0.2913
129.224.112.252,<->,97.242.126.196,2,210,0,0,2,210,1.706455000,0.0067
118.114.202.17,<->,92.168.217.130,0,0,2,1082,2,1082,1.706268000,0.0058
100.252.218.26,<->,100.228.42.160,0,0,2,638,2,638,1.705922000,0.0000
199.55.76.187,<->,8.183.25.124,0,0,2,432,2,432,1.705835000,0.1649
133.178.226.31,<->,8.255.92.203,2,2538,0,0,2,2538,1.704059000,0.2766
125.223.103.24,<->,100.228.42.100,0,0,2,1370,2,1370,1.702920000,0.0993
215.158.239.96,<->,194.237.111.30,2,483,0,0,2,483,1.702554000,0.1823
231.140.159.96,<->,136.25.188.252,0,0,2,188,2,188,1.699650000,0.0020
137.101.225.248,<->,100.228.42.77,0,0,2,526,2,526,1.697248000,0.0002
195.71.94.186,<->,136.25.188.253,0,0,2,188,2,188,1.695989000,0.0022
215.158.239.56,<->,196.107.74.19,2,1644,0,0,2,1644,1.695946000,0.2499
114.76.122.237,<->,101.123.192.247,0,0,2,335,2,335,1.695601000,0.0000
215.158.239.97,<->,194.251.115.79,2,188,0,0,2,188,1.695526000,0.0003
215.158.234.168,<->,133.178.227.255,0,0,2,1190,2,1190,1.693022000,0.0012
136.181.53.206,<->,0.195.216.195,2,186,0,0,2,186,1.692731000,0.0142
210.220.219.181,<->,91.42.219.84,2,1515,0,0,2,1515,1.692704000,0.0465
48.17.51.91,<->,8.252.222.60,0,0,2,543,2,543,1.691708000,0.1738
143.10.40.48,<->,136.25.188.241,0,0,2,188,2,188,1.691606000,0.0027
215.158.239.76,<->,196.89.113.76,2,391,0,0,2,391,1.689991000,0.1937
93.181.153.151,<->,89.183.104.181,0,0,2,2279,2,2279,1.689719000,0.1006
215.158.238.70,<->,0.195.237.14,2,1798,0,0,2,1798,1.689340000,0.0346
204.123.43.210,<->,8.252.222.134,0,0,2,366,2,366,1.688532000,0.1606
204.187.17.69,<->,136.25.188.222,0,0,2,952,2,952,1.688371000,0.0000
142.241.15.104,<->,136.25.188.226,0,0,2,188,2,188,1.687998000,0.0022
136.25.189.30,<->,96.156.169.49,2,2682,0,0,2,2682,1.685227000,0.2547
199.73.77.249,<->,136.25.188.242,0,0,2,1083,2,1083,1.684151000,0.2582
142.255.40.85,<->,136.25.188.52,0,0,2,321,2,321,1.682625000,0.1445
199.83.48.197,<->,136.25.188.45,0,0,2,188,2,188,1.681382000,0.0016
215.158.239.48,<->,199.20.30.169,2,188,0,0,2,188,1.680507000,0.0001
215.158.238.45,<->,114.150.180.159,2,1605,0,0,2,1605,1.680347000,0.2209
215.158.239.24,<->,96.135.154.156,2,1494,0,0,2,1494,1.680033000,0.0001
215.158.239.68,<->,204.227.216.39,2,188,0,0,2,188,1.679803000,0.0000
136.181.43.173,<->,8.45.162.111,2,1005,0,0,2,1005,1.678095000,0.0660
215.158.239.125,<->,215.158.61.195,2,2062,0,0,2,2062,1.677719000,0.1607
129.225.141.239,<->,129.225.132.80,0,0,2,1601,2,1601,1.677608000,0.0000
215.158.239.69,<->,199.20.31.73,2,188,0,0,2,188,1.677011000,0.0041
196.89.66.253,<->,136.25.188.196,0,0,2,1321,2,1321,1.676865000,0.3085
133.178.227.27,<->,133.56.180.22,2,2604,0,0,2,2604,1.676215000,0.0805
199.120.153.238,<->,136.25.188.52,0,0,2,607,2,607,1.675979000,0.0134
215.158.239.76,<->,204.1.227.143,2,164,0,0,2,164,1.674240000,0.0034
143.132.37.51,<->,136.25.188.177,0,0,2,391,2,391,1.673544000,0.0022
146.149.67.47,<->,8.252.221.199,0,0,2,656,2,656,1.670433000,0.1298
192.67.130.147,<->,8.45.162.111,2,596,0,0,2,596,1.669963000,0.1147
215.158.140.171,<->,8.176.10.255,2,1928,0,0,2,1928,1.668553000,0.0115
17.136.211.157,<->,8.220.200.124,0,0,2,424,2,424,1.668300000,0.0738
215.158.239.69,<->,199.20.28.108,2,1078,0,0,2,1078,1.667901000,0.1896
53.201.77.67,<->,48.54.100.170,0,0,2,1850,2,1850,1.667728000,0.0027
215.201.227.68,<->,8.182.229.180,0,0,2,442,2,442,1.666526000,0.0033
159.137.162.213,<->,119.209.91.134,2,676,0,0,2,676,1.665249000,0.2487
79.20.57.135,<->,8.252.222.31,0,0,2,188,2,188,1.665055000,0.0001
215.158.239.56,<->,196.95.87.139,2,188,0,0,2,188,1.663137000,0.0100
215.158.239.97,<->,199.20.31.132,2,981,0,0,2,981,1.662250000,0.0400
8.228.216.50,<->,0.195.216.193,2,970,0,0,2,970,1.657861000,0.2376
215.158.239.93,<->,207.236.241.66,2,248,0,0,2,248,1.657405000,0.0061
207.61.159.55,<->,136.25.188.198,0,0,2,387,2,387,1.655027000,0.0020
215.158.239.110,<->,111.151.237.143,2,1954,0,0,2,1954,1.654954000,0.0001
207.236.166.125,<->,136.25.188.173,0,0,2,558,2,558,1.653924000,0.1310
139.193.141.139,<->,102.248.56.155,2,638,0,0,2,638,1.653859000,0.0469
215.158.140.93,<->,158.85.50.154,2,2662,0,0,2,2662,1.653199000,0.3390
207.60.43.197,<->,136.25.188.54,0,0,2,774,2,774,1.652557000,0.2688
142.166.245.108,<->,136.25.188.222,0,0,2,188,2,188,1.650063000,0.0020
127.230.110.178,<->,102.51.94.244,0,0,2,355,2,355,1.649679000,0.2574
142.252.87.59,<->,136.25.188.222,0,0,2,430,2,430,1.648816000,0.3461
195.127.208.96,<->,136.25.188.220,0,0,2,188,2,188,1.648392000,0.0010
195.7.235.96,<->,136.25.188.227,0,0,2,957,2,957,1.647901000,0.0022
255.17.29.128,<->,8.220.205.146,0,0,2,473,2,473,1.647281000,0.0731
215.158.239.49,<->,199.20.7.135,2,987,0,0,2,987,1.645088000,0.0000
210.220.218.130,<->,53.240.183.129,2,310,0,0,2,310,1.644095000,0.2191
196.246.164.42,<->,136.25.188.241,0,0,2,188,2,188,1.644055000,0.0400
215.110.27.82,<->,8.220.189.234,0,0,2,755,2,755,1.643529000,0.0655
202.162.40.142,<->,8.252.222.49,0,0,2,188,2,188,1.643410000,0.0027
159.137.162.213,<->,117.42.71.27,2,676,0,0,2,676,1.642354000,0.2803
142.255.42.89,<->,136.25.188.196,0,0,2,188,2,188,1.642134000,0.0018
246.253.235.153,<->,112.11.94.153,2,590,0,0,2,590,1.640212000,0.2129
215.158.239.95,<->,194.237.140.129,2,604,0,0,2,604,1.640201000,0.0081
199.122.47.65,<->,136.25.188.163,0,0,2,1690,2,1690,1.639717000,0.1971
215.158.239.58,<->,199.20.7.107,2,945,0,0,2,945,1.639630000,0.0000
195.5.131.126,<->,136.25.188.53,0,0,2,188,2,188,1.638527000,0.0017
133.178.227.2,<->,111.150.187.233,2,2083,0,0,2,2083,1.638509000,0.1565
204.0.163.55,<->,136.25.188.255,0,0,2,613,2,613,1.638055000,0.0101
53.68.24.5,<->,48.54.74.255,0,0,2,1936,2,1936,1.637281000,0.0014
133.54.43.16,<->,33.248.16.128,2,632,0,0,2,632,1.636639000,0.0003
204.200.46.104,<->,136.25.188.177,0,0,2,656,2,656,1.636238000,0.1519
232.88.132.205,<->,8.220.176.253,0,0,2,802,2,802,1.635903000,0.1925
215.158.239.85,<->,199.20.4.87,2,952,0,0,2,952,1.635578000,0.0000
215.158.140.76,<->,33.221.186.163,2,2412,0,0,2,2412,1.634246000,0.3620
197.107.73.204,<->,136.25.188.220,0,0,2,188,2,188,1.634101000,0.0022
207.57.222.125,<->,136.25.188.253,0,0,2,188,2,188,1.633820000,0.0032
215.158.239.95,<->,143.129.191.182,2,944,0,0,2,944,1.633245000,0.0021
199.81.208.250,<->,136.25.188.209,0,0,2,764,2,764,1.631766000,0.2116
199.73.33.38,<->,136.25.188.162,0,0,2,956,2,956,1.630673000,0.0018
243.117.116.114,<->,144.86.144.224,0,0,2,1917,2,1917,1.627603000,0.3532
215.158.61.183,<->,8.176.8.97,0,0,2,493,2,493,1.625774000,0.1038
142.182.63.31,<->,136.25.188.211,0,0,2,381,2,381,1.625273000,0.0167
203.48.153.21,<->,8.220.238.62,0,0,2,656,2,656,1.623248000,0.1783
204.21.73.238,<->,136.25.188.163,0,0,2,188,2,188,1.622630000,0.0017
80.53.58.243,<->,8.52.222.23,0,0,2,406,2,406,1.621840000,0.0704
231.142.37.135,<->,136.25.188.178,0,0,2,800,2,800,1.621724000,0.0029
207.56.170.177,<->,136.25.188.255,0,0,2,188,2,188,1.619897000,0.0025
249.101.117.219,<->,97.110.90.37,2,198,0,0,2,198,1.619389000,0.0377
215.158.140.76,<->,126.219.190.246,2,2190,0,0,2,2190,1.619363000,0.3487
215.158.140.60,<->,106.188.245.195,2,2400,0,0,2,2400,1.618932000,0.2044
127.255.84.41,<->,92.162.253.10,0,0,2,1151,2,1151,1.618317000,0.3698
143.129.206.106,<->,136.25.188.239,0,0,2,188,2,188,1.617699000,0.0027
215.158.239.96,<->,142.166.51.22,2,550,0,0,2,550,1.617042000,0.3013
136.25.188.175,<->,112.220.206.63,2,2538,0,0,2,2538,1.616639000,0.1746
97.193.129.30,<->,8.182.253.233,0,0,2,930,2,930,1.616344000,0.2696
218.111.161.49,<->,8.220.186.82,0,0,2,432,2,432,1.616233000,0.0681
199.32.113.255,<->,136.25.188.198,0,0,2,188,2,188,1.614820000,0.0028
204.58.165.79,<->,136.25.188.196,0,0,2,188,2,188,1.613987000,0.0047
132.254.240.246,<->,8.182.245.152,0,0,2,854,2,854,1.613139000,0.3503
195.54.86.255,<->,136.25.188.220,0,0,2,948,2,948,1.611688000,0.0021
197.113.99.244,<->,136.25.188.243,0,0,2,774,2,774,1.611284000,0.3400
215.158.238.236,<->,145.48.251.0,2,2106,0,0,2,2106,1.610217000,0.1400
231.142.103.128,<->,136.25.188.44,0,0,2,188,2,188,1.610161000,0.0020
142.220.219.246,<->,136.25.188.53,0,0,2,680,2,680,1.609998000,0.3302
199.39.128.219,<->,136.25.188.237,0,0,2,390,2,390,1.607748000,0.0020
215.158.239.92,<->,204.0.209.194,2,430,0,0,2,430,1.607104000,0.2998
142.190.159.28,<->,136.25.188.198,0,0,2,680,2,680,1.606857000,0.1817
142.240.36.44,<->,136.25.188.176,0,0,2,188,2,188,1.606758000,0.0019
204.1.145.195,<->,136.25.188.225,0,0,2,188,2,188,1.606716000,0.0200
215.158.239.11,<->,96.135.154.142,2,2744,0,0,2,2744,1.605644000,0.0001
92.175.127.21,<->,8.43.217.33,0,0,2,354,2,354,1.604647000,0.2070
220.20.200.102,<->,122.12.244.202,2,1742,0,0,2,1742,1.604390000,0.0000
197.113.99.232,<->,136.25.188.54,0,0,2,774,2,774,1.604379000,0.2700
195.6.249.196,<->,136.25.188.163,0,0,2,430,2,430,1.603912000,0.2377
142.182.63.31,<->,136.25.188.174,0,0,2,378,2,378,1.603851000,0.0045
232.31.124.106,<->,220.55.66.44,0,0,2,215,2,215,1.602283000,0.0000
215.158.239.58,<->,196.0.149.119,2,188,0,0,2,188,1.601587000,0.0114
136.25.189.59,<->,119.168.0.26,2,2218,0,0,2,2218,1.601239000,0.2757
215.158.140.74,<->,159.137.41.50,2,680,0,0,2,680,1.601205000,0.0496
215.158.140.161,<->,29.211.199.33,2,389,0,0,2,389,1.599968000,0.0002
143.134.33.39,<->,136.25.188.177,0,0,2,656,2,656,1.599931000,0.2037
142.207.160.227,<->,136.25.188.226,0,0,2,1470,2,1470,1.598541000,0.3115
215.158.239.58,<->,199.20.28.7,2,970,0,0,2,970,1.597493000,0.0000
143.95.233.162,<->,136.25.188.196,0,0,2,1522,2,1522,1.597232000,0.0013
142.220.108.2,<->,136.25.188.198,0,0,2,1068,2,1068,1.596869000,0.0155
111.146.151.20,<->,53.244.60.68,2,450,0,0,2,450,1.596444000,0.0018
204.200.58.228,<->,136.25.188.55,0,0,2,543,2,543,1.595597000,0.2481
212.249.34.46,<->,109.222.233.44,0,0,2,1643,2,1643,1.593916000,0.2310
221.101.8.226,<->,194.253.94.195,2,484,0,0,2,484,1.593688000,0.2975
136.18.239.217,<->,8.183.25.25,0,0,2,669,2,669,1.593031000,0.0490
215.158.239.57,<->,199.20.28.118,2,188,0,0,2,188,1.592238000,0.0000
144.78.108.130,<->,133.178.226.176,0,0,2,475,2,475,1.591677000,0.0720
130.2.106.238,<->,50.224.76.234,0,0,2,1736,2,1736,1.590047000,0.1549
218.111.223.222,<->,8.220.186.82,0,0,2,432,2,432,1.589951000,0.0794
202.33.236.140,<->,136.25.188.179,0,0,2,745,2,745,1.589751000,0.2400
194.232.107.196,<->,136.25.188.198,0,0,2,188,2,188,1.588381000,0.0016
98.10.80.228,<->,8.220.200.124,0,0,2,424,2,424,1.587874000,0.0390
136.14.231.45,<->,8.176.43.29,0,0,2,464,2,464,1.587338000,0.0685
215.158.239.43,<->,8.252.253.232,2,205,0,0,2,205,1.586677000,0.1361
207.172.10.45,<->,136.25.188.174,0,0,2,188,2,188,1.586448000,0.0099
129.138.248.177,<->,8.252.222.60,0,0,2,435,2,435,1.586080000,0.1591
96.190.6.207,<->,92.27.219.190,0,0,2,735,2,735,1.585914000,0.1223
199.68.141.31,<->,136.25.188.177,0,0,2,188,2,188,1.585527000,0.0020
195.14.91.226,<->,136.25.188.46,0,0,2,430,2,430,1.585426000,0.2518
196.251.66.231,<->,0.195.210.42,0,0,2,188,2,188,1.585237000,0.0008
97.233.114.122,<->,8.252.222.143,0,0,2,1651,2,1651,1.583888000,0.0516
159.137.162.213,<->,29.134.123.217,2,676,0,0,2,676,1.583069000,0.3019
220.28.65.9,<->,136.25.188.200,0,0,2,1155,2,1155,1.582675000,0.1364
215.158.239.58,<->,142.166.245.240,2,188,0,0,2,188,1.582504000,0.0032
197.107.44.87,<->,136.25.188.174,0,0,2,188,2,188,1.582489000,0.0000
133.178.226.14,<->,99.192.168.186,2,2409,0,0,2,2409,1.581265000,0.2366
197.107.44.87,<->,136.25.188.209,0,0,2,188,2,188,1.580492000,0.0000
136.25.188.254,<->,80.93.220.12,2,774,0,0,2,774,1.580392000,0.0451
142.220.219.246,<->,136.25.188.255,0,0,2,680,2,680,1.578441000,0.1836
197.113.99.128,<->,136.25.188.198,0,0,2,188,2,188,1.577982000,0.0000
137.47.36.43,<->,100.228.42.118,0,0,2,828,2,828,1.577269000,0.0416
132.249.70.169,<->,82.195.35.35,2,811,0,0,2,811,1.576754000,0.0609
143.132.167.177,<->,136.25.188.199,0,0,2,984,2,984,1.576575000,0.0018
204.21.157.87,<->,136.25.188.177,0,0,2,500,2,500,1.575645000,0.1921
215.158.239.76,<->,196.91.196.237,2,955,0,0,2,955,1.575569000,0.4210
221.102.143.189,<->,192.64.73.86,0,0,2,2188,2,2188,1.575253000,0.0334
135.255.67.82,<->,8.252.222.45,0,0,2,188,2,188,1.574955000,0.0002
114.76.113.17,<->,109.222.194.169,0,0,2,1021,2,1021,1.574501000,0.1482
215.158.239.44,<->,136.114.101.94,2,386,0,0,2,386,1.573498000,0.0010
159.223.99.45,<->,8.52.185.129,0,0,2,1312,2,1312,1.571911000,0.3464
207.60.188.82,<->,136.25.188.52,0,0,2,922,2,922,1.570819000,0.0017
231.136.201.225,<->,215.158.239.77,0,0,2,1315,2,1315,1.569723000,0.2126
128.94.114.51,<->,8.52.189.18,0,0,2,450,2,450,1.569366000,0.1294
139.163.161.48,<->,136.25.188.170,0,0,2,930,2,930,1.569064000,0.0007
8.252.223.120,<->,8.222.6.215,2,2143,0,0,2,2143,1.568661000,0.4126
215.158.239.97,<->,143.20.71.152,2,439,0,0,2,439,1.567670000,0.2018
225.41.137.39,<->,50.224.76.235,0,0,2,1448,2,1448,1.567499000,0.3116
212.100.244.206,<->,8.52.182.30,0,0,2,680,2,680,1.567068000,0.0386
215.158.239.49,<->,194.250.220.108,2,950,0,0,2,950,1.565789000,0.0000
215.158.239.76,<->,196.111.216.182,2,774,0,0,2,774,1.564843000,0.3997
231.142.111.219,<->,136.25.188.196,0,0,2,188,2,188,1.564632000,0.0023
231.142.68.126,<->,136.25.188.253,0,0,2,188,2,188,1.563908000,0.0020
139.193.141.139,<->,102.240.247.127,2,302,0,0,2,302,1.563344000,0.0071
215.158.140.167,<->,8.222.7.180,2,2015,0,0,2,2015,1.562828000,0.1813
215.158.239.68,<->,199.20.29.82,2,188,0,0,2,188,1.561879000,0.0101
215.158.239.79,<->,199.20.30.208,2,188,0,0,2,188,1.561568000,0.0000
215.158.239.95,<->,199.20.28.183,2,849,0,0,2,849,1.560813000,0.4387
215.158.239.78,<->,199.20.6.69,2,188,0,0,2,188,1.560248000,0.0000
139.163.26.146,<->,122.222.214.178,2,472,0,0,2,472,1.559756000,0.3519
8.182.226.78,<->,6.133.198.119,2,1075,0,0,2,1075,1.559729000,0.0535
215.158.239.78,<->,194.250.218.150,2,388,0,0,2,388,1.559624000,0.0000
215.158.239.50,<->,199.20.30.209,2,188,0,0,2,188,1.559545000,0.0600
215.158.239.95,<->,194.202.160.71,2,188,0,0,2,188,1.557989000,0.0500
215.158.239.85,<->,199.69.64.14,2,188,0,0,2,188,1.557515000,0.0028
101.70.119.41,<->,53.208.122.85,2,752,0,0,2,752,1.556959000,0.0003
204.2.251.130,<->,136.25.188.163,0,0,2,188,2,188,1.555472000,0.0025
142.191.151.172,<->,136.25.188.198,0,0,2,773,2,773,1.554771000,0.0024
109.3.128.220,<->,8.55.216.92,2,1232,0,0,2,1232,1.554137000,0.0340
8.52.173.195,<->,8.3.219.162,2,459,0,0,2,459,1.553882000,0.0739
199.38.230.175,<->,136.25.188.220,0,0,2,188,2,188,1.553844000,0.0039
92.32.4.127,<->,8.52.180.110,0,0,2,656,2,656,1.553375000,0.0371
215.158.239.92,<->,207.166.169.32,2,1076,0,0,2,1076,1.553271000,0.4156
207.59.90.13,<->,136.25.188.45,0,0,2,656,2,656,1.553257000,0.2986
136.25.188.104,<->,8.182.121.167,2,1393,0,0,2,1393,1.552989000,0.0000
143.43.102.227,<->,136.25.188.53,0,0,2,188,2,188,1.552817000,0.0028
210.220.219.153,<->,53.189.253.207,2,1058,0,0,2,1058,1.552622000,0.2956
231.140.2.184,<->,136.25.188.253,0,0,2,188,2,188,1.552397000,0.0028
116.124.63.20,<->,101.224.206.46,0,0,2,246,2,246,1.552153000,0.2370
231.143.112.142,<->,136.25.188.220,0,0,2,283,2,283,1.552139000,0.1936
215.158.239.95,<->,199.20.29.90,2,283,0,0,2,283,1.552124000,0.4394
215.158.239.48,<->,204.226.127.49,2,188,0,0,2,188,1.550968000,0.0002
159.13.137.179,<->,137.23.166.40,2,846,0,0,2,846,1.550760000,0.1659
215.158.61.183,<->,8.176.8.240,0,0,2,2051,2,2051,1.549656000,0.0701
8.176.8.218,<->,8.35.106.184,2,1498,0,0,2,1498,1.549154000,0.0001
245.161.124.43,<->,8.252.222.150,0,0,2,283,2,283,1.549071000,0.3664
215.158.239.79,<->,199.20.4.197,2,879,0,0,2,879,1.548805000,0.4379
132.250.195.43,<->,80.41.223.29,0,0,2,494,2,494,1.548702000,0.0970
215.158.140.230,<->,57.23.23.220,2,618,0,0,2,618,1.548490000,0.1008
215.158.61.145,<->,8.176.8.196,0,0,2,811,2,811,1.547768000,0.3980
195.124.73.231,<->,136.25.188.241,0,0,2,188,2,188,1.546811000,0.0812
142.167.120.221,<->,136.25.188.173,0,0,2,462,2,462,1.544977000,0.2555
100.228.42.114,<->,17.128.64.29,2,1678,0,0,2,1678,1.544916000,0.0010
215.158.238.148,<->,122.158.49.129,2,586,0,0,2,586,1.544611000,0.4282
215.158.239.50,<->,204.226.96.57,2,188,0,0,2,188,1.544330000,0.0020
194.232.165.130,<->,136.25.188.177,0,0,2,188,2,188,1.543600000,0.0037
215.158.239.18,<->,8.255.92.88,2,2403,0,0,2,2403,1.543158000,0.1487
111.150.74.61,<->,99.74.26.98,0,0,2,1216,2,1216,1.542177000,0.0000
203.215.162.177,<->,124.42.185.84,2,652,0,0,2,652,1.541001000,0.0955
143.23.190.146,<->,136.25.188.160,0,0,2,440,2,440,1.540710000,0.3918
139.161.104.7,<->,133.178.227.134,0,0,2,1094,2,1094,1.540265000,0.0005
142.236.92.247,<->,136.25.188.209,0,0,2,188,2,188,1.539379000,0.0015
142.227.218.120,<->,136.25.188.178,0,0,2,841,2,841,1.538702000,0.2301
133.178.226.7,<->,112.220.206.17,2,2618,0,0,2,2618,1.537906000,0.1664
245.161.124.43,<->,8.252.222.163,0,0,2,283,2,283,1.537873000,0.3791
215.158.239.51,<->,196.90.101.128,2,188,0,0,2,188,1.537379000,0.0000
133.178.226.90,<->,131.1.195.221,2,2795,0,0,2,2795,1.537220000,0.2553
145.192.66.138,<->,8.52.181.95,0,0,2,677,2,677,1.536684000,0.1343
224.129.13.57,<->,8.182.226.78,0,0,2,895,2,895,1.536257000,0.1365
199.69.182.51,<->,136.25.188.53,0,0,2,439,2,439,1.535802000,0.4289
133.178.226.20,<->,8.222.48.144,2,2442,0,0,2,2442,1.535264000,0.0075
142.206.79.4,<->,136.25.188.162,0,0,2,543,2,543,1.534980000,0.3210
133.178.226.77,<->,106.188.236.229,2,2506,0,0,2,2506,1.534656000,0.2452
136.25.189.196,<->,129.222.39.203,2,1010,0,0,2,1010,1.534318000,0.0231
215.158.238.143,<->,122.159.245.149,2,2554,0,0,2,2554,1.532600000,0.3845
215.158.239.86,<->,199.20.6.122,2,188,0,0,2,188,1.532496000,0.0199
196.200.78.52,<->,8.252.222.178,0,0,2,188,2,188,1.532391000,0.0001
224.234.193.175,<->,8.20.87.229,0,0,2,600,2,600,1.532195000,0.1857
111.146.197.80,<->,53.245.126.39,2,330,0,0,2,330,1.530634000,0.3674
215.158.239.50,<->,207.191.112.39,2,430,0,0,2,430,1.530225000,0.3695
159.137.162.213,<->,120.246.76.167,2,676,0,0,2,676,1.530221000,0.3190
207.59.232.88,<->,136.25.188.239,0,0,2,188,2,188,1.528057000,0.0029
17.114.65.102,<->,8.220.176.253,0,0,2,641,2,641,1.527650000,0.3204
133.244.31.121,<->,80.27.154.175,2,1319,0,0,2,1319,1.527264000,0.2250
221.196.123.180,<->,136.25.188.226,0,0,2,580,2,580,1.526598000,0.1428
143.72.126.147,<->,136.25.188.174,0,0,2,1392,2,1392,1.525804000,0.1943
133.178.226.37,<->,131.1.232.91,2,2506,0,0,2,2506,1.525489000,0.4002
98.156.187.247,<->,8.182.226.78,0,0,2,656,2,656,1.524850000,0.0271
136.25.189.32,<->,29.211.165.20,2,1490,0,0,2,1490,1.524118000,0.2971
143.184.79.238,<->,8.52.222.23,0,0,2,423,2,423,1.524102000,0.2537
196.88.102.214,<->,136.25.188.196,0,0,2,984,2,984,1.523911000,0.0075
142.208.234.171,<->,136.25.188.160,0,0,2,188,2,188,1.523502000,0.0022
215.158.238.64,<->,131.1.253.247,2,1679,0,0,2,1679,1.522355000,0.1828
82.248.207.148,<->,8.220.239.48,0,0,2,656,2,656,1.520950000,0.0368
215.158.238.148,<->,80.47.111.88,2,2554,0,0,2,2554,1.520783000,0.2448
215.158.61.202,<->,8.176.8.206,0,0,2,1322,2,1322,1.519484000,0.3023
133.178.226.224,<->,115.162.222.217,2,436,0,0,2,436,1.519227000,0.1437
196.88.31.189,<->,136.25.188.238,0,0,2,605,2,605,1.518076000,0.1047
199.14.252.25,<->,136.25.188.174,0,0,2,188,2,188,1.518013000,0.0044
133.178.227.24,<->,29.211.122.238,2,2570,0,0,2,2570,1.517853000,0.3958
215.158.239.79,<->,207.63.52.133,2,730,0,0,2,730,1.516778000,0.0039
196.88.212.196,<->,136.25.188.176,0,0,2,188,2,188,1.516617000,0.0022
207.59.36.194,<->,136.25.188.226,0,0,2,1692,2,1692,1.516071000,0.2711
195.4.8.199,<->,136.25.188.240,0,0,2,188,2,188,1.514573000,0.0016
207.190.91.156,<->,136.25.188.255,0,0,2,188,2,188,1.514154000,0.0039
221.102.56.69,<->,80.41.82.212,0,0,2,588,2,588,1.512948000,0.0147
143.129.44.86,<->,136.25.188.53,0,0,2,178,2,178,1.512424000,0.0016
204.185.138.81,<->,136.25.188.55,0,0,2,656,2,656,1.511120000,0.3400
204.200.33.245,<->,136.25.188.196,0,0,2,430,2,430,1.510853000,0.3905
107.11.233.148,<->,0.195.210.44,0,0,2,262,2,262,1.510724000,0.0502
199.33.121.209,<->,136.25.188.222,0,0,2,430,2,430,1.510241000,0.3939
207.63.43.133,<->,136.25.188.44,0,0,2,364,2,364,1.509915000,0.2912
204.3.28.135,<->,136.25.188.178,0,0,2,188,2,188,1.508517000,0.0023
199.83.79.32,<->,136.25.188.176,0,0,2,656,2,656,1.508178000,0.2936
215.158.239.96,<->,207.166.94.75,2,963,0,0,2,963,1.507499000,0.0000
215.158.239.86,<->,199.20.31.29,2,188,0,0,2,188,1.506911000,0.0200
220.251.223.94,<->,136.25.188.227,0,0,2,656,2,656,1.506300000,0.0422
197.113.64.171,<->,136.25.188.55,0,0,2,956,2,956,1.503145000,0.4900
215.158.239.87,<->,199.106.45.168,2,430,0,0,2,430,1.502956000,0.2697
215.158.239.70,<->,196.107.137.250,2,774,0,0,2,774,1.501652000,0.4800
56.114.235.120,<->,8.228.216.50,0,0,2,227,2,227,1.501425000,0.0496
215.158.239.56,<->,143.13.158.147,2,384,0,0,2,384,1.501306000,0.0022
53.189.54.77,<->,8.228.221.161,0,0,2,344,2,344,1.499764000,0.4859
215.158.239.49,<->,207.115.125.111,2,188,0,0,2,188,1.499625000,0.0601
144.93.22.181,<->,100.95.206.96,0,0,2,1586,2,1586,1.499264000,0.1931
195.41.26.226,<->,136.25.188.53,0,0,2,430,2,430,1.498637000,0.3402
207.236.200.105,<->,136.25.188.239,0,0,2,472,2,472,1.497512000,0.4203
204.3.43.12,<->,136.25.188.255,0,0,2,518,2,518,1.496992000,0.4551
215.158.239.70,<->,199.20.31.73,2,957,0,0,2,957,1.496888000,0.2796
199.69.47.77,<->,136.25.188.225,0,0,2,680,2,680,1.496681000,0.2349
194.234.181.28,<->,136.25.188.226,0,0,2,188,2,188,1.495703000,0.0251
215.158.238.64,<->,57.210.107.38,2,2538,0,0,2,2538,1.494913000,0.5006
98.101.70.120,<->,8.182.226.78,0,0,2,1610,2,1610,1.493373000,0.1280
143.135.128.30,<->,136.25.188.238,0,0,2,188,2,188,1.492973000,0.0040
199.8.51.240,<->,50.224.96.57,0,0,2,126,2,126,1.492967000,0.1696
215.158.239.50,<->,207.61.167.106,2,938,0,0,2,938,1.491238000,0.0019
215.158.239.70,<->,199.20.31.33,2,965,0,0,2,965,1.491174000,0.0200
221.102.56.69,<->,109.1.61.117,0,0,2,588,2,588,1.490999000,0.0053
159.137.162.213,<->,92.180.14.181,2,676,0,0,2,676,1.490885000,0.2703
133.178.227.41,<->,133.73.194.4,2,2688,0,0,2,2688,1.490457000,0.1697
195.13.253.215,<->,136.25.188.239,0,0,2,188,2,188,1.490442000,0.0000
215.158.140.230,<->,83.225.209.236,2,644,0,0,2,644,1.489307000,0.1657
194.237.38.227,<->,136.25.188.177,0,0,2,656,2,656,1.489275000,0.1931
199.69.174.156,<->,136.25.188.225,0,0,2,188,2,188,1.488312000,0.0155
8.252.222.51,<->,4.122.15.27,2,188,0,0,2,188,1.487984000,0.0000
129.236.114.39,<->,111.20.168.209,0,0,2,1169,2,1169,1.487503000,0.0001
99.124.166.199,<->,8.52.183.96,0,0,2,242,2,242,1.486589000,0.2786
215.158.238.176,<->,114.94.161.244,2,2139,0,0,2,2139,1.485971000,0.4059
215.158.239.96,<->,195.43.255.92,2,524,0,0,2,524,1.485942000,0.0064
231.142.111.219,<->,136.25.188.197,0,0,2,188,2,188,1.485075000,0.0023
199.82.249.196,<->,136.25.188.222,0,0,2,188,2,188,1.482948000,0.0039
133.178.226.90,<->,96.155.60.216,2,347,0,0,2,347,1.482749000,0.2667
207.236.206.13,<->,136.25.188.177,0,0,2,787,2,787,1.481278000,0.0032
215.158.239.78,<->,199.20.5.122,2,945,0,0,2,945,1.480916000,0.0763
246.108.106.71,<->,100.95.221.235,0,0,2,1442,2,1442,1.480807000,0.2807
215.158.239.4,<->,158.166.175.243,2,1601,0,0,2,1601,1.480793000,0.1537
215.158.239.17,<->,121.67.161.192,2,1037,0,0,2,1037,1.480549000,0.1944
196.88.23.127,<->,136.25.188.226,0,0,2,188,2,188,1.479312000,0.0000
196.88.102.214,<->,136.25.188.253,0,0,2,984,2,984,1.478896000,0.0036
199.121.73.3,<->,136.25.188.198,0,0,2,942,2,942,1.477504000,0.0039
142.255.136.94,<->,136.25.188.178,0,0,2,188,2,188,1.476523000,0.0022
146.148.96.104,<->,8.252.221.223,0,0,2,624,2,624,1.475849000,0.3831
199.52.224.192,<->,136.25.188.241,0,0,2,188,2,188,1.474796000,0.0023
207.190.98.134,<->,136.25.188.174,0,0,2,390,2,390,1.474762000,0.0034
194.233.169.234,<->,136.25.188.176,0,0,2,188,2,188,1.474668000,0.0000
195.40.190.30,<->,136.25.188.253,0,0,2,929,2,929,1.474444000,0.0022
136.25.188.53,<->,106.188.236.181,2,2506,0,0,2,2506,1.474101000,0.4618
100.115.92.206,<->,97.110.90.36,2,265,0,0,2,265,1.473721000,0.3840
215.158.239.50,<->,199.38.118.52,2,188,0,0,2,188,1.473353000,0.0026
204.185.255.78,<->,136.25.188.238,0,0,2,188,2,188,1.473109000,0.0105
159.190.87.59,<->,8.182.226.78,0,0,2,447,2,447,1.472468000,0.1820
193.122.170.40,<->,133.54.17.135,0,0,2,670,2,670,1.472002000,0.3167
195.40.232.172,<->,136.25.188.243,0,0,2,656,2,656,1.471940000,0.2577
215.158.238.82,<->,142.234.196.171,2,2522,0,0,2,2522,1.471701000,0.3102
132.216.20.78,<->,102.224.168.174,0,0,2,2934,2,2934,1.470234000,0.0419
215.158.239.113,<->,129.222.36.79,2,610,0,0,2,610,1.469931000,0.0223
80.27.155.31,<->,48.105.71.235,2,416,0,0,2,416,1.469732000,0.2562
48.131.159.6,<->,8.252.223.106,0,0,2,1258,2,1258,1.469478000,0.1777
159.137.162.213,<->,110.66.204.9,2,676,0,0,2,676,1.468714000,0.2698
195.68.49.166,<->,136.25.188.237,0,0,2,956,2,956,1.467502000,0.0200
195.7.129.174,<->,136.25.188.45,0,0,2,440,2,440,1.467036000,0.2057
199.50.64.61,<->,136.25.188.163,0,0,2,987,2,987,1.466050000,0.0034
222.4.209.41,<->,159.137.162.213,0,0,2,676,2,676,1.465838000,0.2701
133.178.227.57,<->,29.211.6.94,2,2762,0,0,2,2762,1.465701000,0.4027
136.25.188.172,<->,8.255.92.234,2,2714,0,0,2,2714,1.464594000,0.1360
199.71.235.42,<->,136.25.188.53,0,0,2,214,2,214,1.464478000,0.3023
145.200.63.211,<->,133.178.226.186,0,0,2,1050,2,1050,1.464063000,0.0007
215.158.238.142,<->,131.1.195.244,2,2783,0,0,2,2783,1.463827000,0.4879
92.27.219.219,<->,33.57.74.146,2,100,0,0,2,100,1.463803000,0.1675
204.61.36.1,<->,136.25.188.226,0,0,2,188,2,188,1.463431000,0.0024
195.5.152.124,<->,136.25.188.237,0,0,2,440,2,440,1.463163000,0.3386
215.158.239.96,<->,199.20.30.238,2,188,0,0,2,188,1.463033000,0.0040
136.25.188.245,<->,80.57.208.50,2,962,0,0,2,962,1.462330000,0.0004
215.158.239.77,<->,207.166.75.106,2,1074,0,0,2,1074,1.462269000,0.1828
215.158.239.96,<->,196.108.241.203,2,774,0,0,2,774,1.462098000,0.4805
196.18.58.20,<->,8.20.87.187,0,0,2,452,2,452,1.461011000,0.2174
199.50.155.121,<->,136.25.188.253,0,0,2,188,2,188,1.460450000,0.0022
195.126.187.28,<->,136.25.188.46,0,0,2,188,2,188,1.460251000,0.0038
215.158.239.56,<->,199.122.164.218,2,440,0,0,2,440,1.460207000,0.1674
215.158.61.183,<->,8.176.8.219,0,0,2,794,2,794,1.459134000,0.2121
97.126.118.62,<->,53.159.24.211,2,159,0,0,2,159,1.459093000,0.0644
215.158.238.83,<->,8.252.210.160,2,2634,0,0,2,2634,1.458016000,0.2996
215.158.140.231,<->,100.50.96.239,2,2337,0,0,2,2337,1.457674000,0.4595
251.24.86.2,<->,8.252.222.44,0,0,2,1686,2,1686,1.457668000,0.1947
215.158.238.148,<->,192.228.30.102,2,2442,0,0,2,2442,1.457472000,0.4101
8.183.25.124,<->,6.104.173.172,2,745,0,0,2,745,1.457297000,0.0428
215.158.238.83,<->,8.255.92.245,2,2458,0,0,2,2458,1.456711000,0.2784
215.158.238.96,<->,29.213.216.233,2,2250,0,0,2,2250,1.456608000,0.4929
215.158.239.55,<->,136.114.101.94,2,1466,0,0,2,1466,1.456474000,0.0117
95.246.167.198,<->,8.252.221.206,0,0,2,1282,2,1282,1.456324000,0.0335
220.20.200.33,<->,98.23.99.94,2,244,0,0,2,244,1.455868000,0.0012
215.158.140.173,<->,8.222.7.183,2,2139,0,0,2,2139,1.455629000,0.3741
215.158.239.84,<->,207.166.10.138,2,962,0,0,2,962,1.454151000,0.0387
112.208.20.190,<->,100.95.53.131,0,0,2,358,2,358,1.452913000,0.2234
139.163.28.207,<->,89.205.238.165,2,218,0,0,2,218,1.452485000,0.0624
215.158.239.95,<->,196.0.149.119,2,188,0,0,2,188,1.452387000,0.0000
215.158.238.88,<->,100.224.166.122,2,1012,0,0,2,1012,1.452267000,0.5363
215.158.239.49,<->,194.251.113.103,2,188,0,0,2,188,1.452130000,0.0007
205.127.108.113,<->,33.233.141.77,0,0,2,844,2,844,1.451966000,0.2678
139.160.227.45,<->,133.178.227.208,0,0,2,642,2,642,1.451689000,0.0001
215.158.239.95,<->,195.49.254.203,2,774,0,0,2,774,1.451491000,0.3302
202.33.255.254,<->,136.25.188.240,0,0,2,974,2,974,1.450950000,0.0189
196.89.233.128,<->,136.25.188.236,0,0,2,774,2,774,1.450143000,0.3102
215.158.140.60,<->,131.144.116.43,2,2617,0,0,2,2617,1.449956000,0.4148
221.102.56.69,<->,102.83.27.68,0,0,2,588,2,588,1.449633000,0.3723
192.226.161.60,<->,136.25.188.160,0,0,2,1634,2,1634,1.448265000,0.4306
215.158.239.56,<->,194.251.73.223,2,188,0,0,2,188,1.448127000,0.0000
109.222.241.51,<->,82.195.35.35,2,1157,0,0,2,1157,1.447958000,0.0628
204.186.201.218,<->,136.25.188.174,0,0,2,188,2,188,1.447924000,0.0098
192.65.64.48,<->,8.55.211.213,2,588,0,0,2,588,1.447361000,0.0024
136.25.189.15,<->,72.23.194.213,2,1394,0,0,2,1394,1.446984000,0.4915
142.241.137.131,<->,136.25.188.174,0,0,2,188,2,188,1.446210000,0.0056
126.219.197.186,<->,99.74.87.231,0,0,2,1581,2,1581,1.446175000,0.1973
194.237.34.9,<->,136.25.188.55,0,0,2,188,2,188,1.445742000,0.0044
221.102.56.69,<->,80.41.118.73,0,0,2,588,2,588,1.445567000,0.0543
215.158.239.69,<->,126.219.194.181,2,2650,0,0,2,2650,1.444869000,0.1267
136.25.189.30,<->,120.154.131.20,2,2801,0,0,2,2801,1.444352000,0.2442
195.40.102.168,<->,136.25.188.198,0,0,2,721,2,721,1.443256000,0.3036
136.25.189.1,<->,131.144.115.118,2,2458,0,0,2,2458,1.441973000,0.5310
142.206.47.119,<->,136.25.188.209,0,0,2,550,2,550,1.441521000,0.5521
215.158.61.242,<->,99.74.26.188,0,0,2,734,2,734,1.441400000,0.0592
136.25.188.175,<->,122.159.245.149,2,2362,0,0,2,2362,1.440913000,0.2864
17.61.227.235,<->,8.220.176.253,0,0,2,558,2,558,1.440019000,0.0524
199.72.63.9,<->,136.25.188.177,0,0,2,188,2,188,1.439540000,0.0020
199.121.73.3,<->,136.25.188.253,0,0,2,942,2,942,1.439230000,0.0039
215.158.239.87,<->,196.90.186.239,2,430,0,0,2,430,1.438949000,0.3598
8.52.179.237,<->,6.231.239.220,2,460,0,0,2,460,1.438602000,0.0079
145.116.223.6,<->,133.178.226.178,0,0,2,794,2,794,1.437024000,0.0000
215.158.239.87,<->,29.211.93.15,2,455,0,0,2,455,1.437021000,0.4656
142.190.238.181,<->,136.25.188.241,0,0,2,188,2,188,1.436592000,0.0020
148.224.137.67,<->,136.25.188.237,0,0,2,2730,2,2730,1.436505000,0.5087
231.140.199.133,<->,136.25.188.226,0,0,2,188,2,188,1.436140000,0.0023
204.60.124.72,<->,136.25.188.243,0,0,2,186,2,186,1.435606000,0.1201
215.158.239.56,<->,195.55.190.198,2,439,0,0,2,439,1.435205000,0.2136
194.233.219.172,<->,136.25.188.177,0,0,2,188,2,188,1.435014000,0.0000
204.200.37.4,<->,136.25.188.220,0,0,2,902,2,902,1.434529000,0.0036
199.38.214.113,<->,136.25.188.199,0,0,2,188,2,188,1.434121000,0.0071
142.227.52.147,<->,136.25.188.199,0,0,2,1530,2,1530,1.434119000,0.4146
204.154.15.251,<->,8.182.243.89,0,0,2,929,2,929,1.433658000,0.2063
199.73.33.102,<->,136.25.188.241,0,0,2,955,2,955,1.432014000,0.0027
136.25.188.199,<->,122.158.245.107,2,2650,0,0,2,2650,1.431958000,0.3490
136.25.188.220,<->,122.158.245.90,2,2554,0,0,2,2554,1.431364000,0.3565
138.37.223.61,<->,8.182.244.19,0,0,2,1076,2,1076,1.431305000,0.1221
215.158.238.241,<->,38.104.11.171,2,2291,0,0,2,2291,1.431145000,0.2236
142.190.113.150,<->,136.25.188.163,0,0,2,188,2,188,1.430347000,0.0040
108.47.155.125,<->,8.52.222.23,0,0,2,481,2,481,1.430304000,0.0596
207.60.137.185,<->,136.25.188.238,0,0,2,774,2,774,1.429854000,0.2318
215.158.239.95,<->,207.166.100.62,2,963,0,0,2,963,1.429735000,0.0402
136.25.189.12,<->,29.211.228.198,2,1634,0,0,2,1634,1.429478000,0.2001
215.158.239.57,<->,199.20.29.252,2,188,0,0,2,188,1.428702000,0.0528
133.178.227.76,<->,89.76.109.245,2,2206,0,0,2,2206,1.426983000,0.4369
215.158.140.75,<->,100.50.96.239,2,2355,0,0,2,2355,1.425989000,0.4777
133.40.211.1,<->,8.252.222.160,0,0,2,188,2,188,1.425852000,0.0004
17.24.139.9,<->,8.220.190.86,0,0,2,656,2,656,1.425821000,0.0446
215.158.239.92,<->,106.188.253.182,2,2554,0,0,2,2554,1.425794000,0.2089
207.239.173.59,<->,136.25.188.178,0,0,2,951,2,951,1.425210000,0.0030
247.136.236.145,<->,8.209.235.29,2,716,0,0,2,716,1.424651000,0.2032
133.178.226.19,<->,131.144.115.213,2,2522,0,0,2,2522,1.422918000,0.2738
139.160.226.165,<->,136.25.189.82,0,0,2,2570,2,2570,1.422894000,0.5575
221.102.56.69,<->,220.80.167.49,0,0,2,588,2,588,1.422639000,0.3162
204.185.249.28,<->,136.25.188.53,0,0,2,958,2,958,1.422060000,0.0392
215.158.239.51,<->,195.54.50.33,2,164,0,0,2,164,1.421153000,0.0022
247.136.212.254,<->,122.105.68.11,2,1312,0,0,2,1312,1.420900000,0.1757
215.158.239.78,<->,196.93.146.104,2,188,0,0,2,188,1.420664000,0.0000
215.158.239.99,<->,199.20.29.175,2,485,0,0,2,485,1.420493000,0.5176
142.241.29.174,<->,136.25.188.252,0,0,2,656,2,656,1.418229000,0.2296
220.28.114.28,<->,136.25.189.21,0,0,2,1511,2,1511,1.418151000,0.2800
139.163.163.252,<->,133.178.227.70,0,0,2,2277,2,2277,1.416921000,0.5529
207.173.126.140,<->,136.25.188.210,0,0,2,774,2,774,1.416894000,0.2399
122.193.57.250,<->,8.52.183.96,0,0,2,242,2,242,1.416804000,0.0096
215.158.140.178,<->,135.243.190.251,2,1309,0,0,2,1309,1.416698000,0.2759
215.158.239.51,<->,118.20.100.139,2,2506,0,0,2,2506,1.416635000,0.2603
142.248.4.138,<->,136.25.188.176,0,0,2,543,2,543,1.416437000,0.2930
136.25.188.221,<->,29.214.108.89,2,1298,0,0,2,1298,1.415144000,0.4742
215.158.140.232,<->,98.219.126.140,2,2901,0,0,2,2901,1.412700000,0.0000
215.158.239.78,<->,199.106.152.222,2,188,0,0,2,188,1.412552000,0.0191
17.143.241.23,<->,8.220.202.4,0,0,2,365,2,365,1.412115000,0.3927
215.158.239.58,<->,196.106.117.138,2,188,0,0,2,188,1.411999000,0.0099
136.25.188.177,<->,131.1.253.245,2,2873,0,0,2,2873,1.411968000,0.3576
199.68.157.24,<->,136.25.188.220,0,0,2,953,2,953,1.411881000,0.0042
215.158.239.99,<->,199.106.56.71,2,804,0,0,2,804,1.410340000,0.3492
195.42.29.225,<->,136.25.188.253,0,0,2,188,2,188,1.410181000,0.0025
215.158.239.57,<->,196.90.65.5,2,380,0,0,2,380,1.408643000,0.3798
197.113.99.160,<->,136.25.188.178,0,0,2,963,2,963,1.408243000,0.0000
215.158.239.97,<->,195.15.42.68,2,621,0,0,2,621,1.407610000,0.2631
207.172.128.52,<->,136.25.188.162,0,0,2,188,2,188,1.407607000,0.0096
143.68.190.19,<->,136.25.188.52,0,0,2,1432,2,1432,1.406973000,0.0147
142.207.18.52,<->,136.25.188.254,0,0,2,188,2,188,1.405392000,0.0023
215.158.238.135,<->,106.188.183.68,2,360,0,0,2,360,1.404920000,0.5394
215.158.238.67,<->,197.125.126.249,2,2682,0,0,2,2682,1.404649000,0.4714
215.158.239.94,<->,29.212.199.221,2,2586,0,0,2,2586,1.404301000,0.2424
53.214.117.149,<->,48.53.179.147,0,0,2,476,2,476,1.403820000,0.0084
223.114.90.164,<->,8.252.221.221,0,0,2,817,2,817,1.403688000,0.0072
145.252.117.167,<->,79.20.58.74,2,1210,0,0,2,1210,1.403056000,0.0001
220.51.255.205,<->,215.158.140.182,0,0,2,648,2,648,1.402266000,0.0251
136.25.188.45,<->,112.235.95.11,2,2506,0,0,2,2506,1.402051000,0.5538
215.158.238.190,<->,29.211.165.88,2,2164,0,0,2,2164,1.401981000,0.2395
215.158.30.165,<->,8.252.222.130,0,0,2,594,2,594,1.401591000,0.0005
243.49.81.35,<->,192.66.158.212,0,0,2,1038,2,1038,1.401335000,0.5599
193.31.225.146,<->,92.162.252.222,0,0,2,2468,2,2468,1.400756000,0.0001
215.158.239.58,<->,196.93.154.19,2,188,0,0,2,188,1.400021000,0.0494
132.216.20.76,<->,101.235.78.20,0,0,2,757,2,757,1.399182000,0.0001
215.158.238.83,<->,131.1.253.245,2,2730,0,0,2,2730,1.398802000,0.2999
204.3.22.53,<->,136.25.188.198,0,0,2,991,2,991,1.398710000,0.3358
136.25.189.47,<->,72.23.194.232,2,2490,0,0,2,2490,1.398551000,0.1204
215.158.239.56,<->,196.94.181.75,2,723,0,0,2,723,1.398261000,0.1102
195.40.102.168,<->,136.25.188.173,0,0,2,721,2,721,1.397319000,0.2763
215.158.239.113,<->,129.222.39.229,2,2076,0,0,2,2076,1.397232000,0.1527
215.158.140.92,<->,149.163.129.215,2,2202,0,0,2,2202,1.395540000,0.5392
139.193.141.139,<->,27.165.241.33,2,583,0,0,2,583,1.395450000,0.5589
199.54.200.215,<->,8.252.222.174,0,0,2,464,2,464,1.393913000,0.2467
114.204.207.137,<->,92.27.219.236,0,0,2,1613,2,1613,1.393624000,0.1916
215.158.239.76,<->,199.70.23.5,2,188,0,0,2,188,1.392769000,0.0026
197.113.99.160,<->,136.25.188.163,0,0,2,963,2,963,1.390686000,0.0000
215.158.239.56,<->,199.20.31.39,2,954,0,0,2,954,1.389863000,0.0000
210.158.44.59,<->,91.231.212.165,2,1488,0,0,2,1488,1.388384000,0.0272
58.51.34.135,<->,8.252.222.46,0,0,2,188,2,188,1.388197000,0.0150
195.14.128.76,<->,136.25.188.53,0,0,2,954,2,954,1.387838000,0.0157
215.158.239.87,<->,199.20.29.53,2,464,0,0,2,464,1.387818000,0.5397
197.113.99.143,<->,136.25.188.174,0,0,2,471,2,471,1.387356000,0.5307
111.199.225.115,<->,0.195.210.46,0,0,2,752,2,752,1.387321000,0.0857
80.41.4.166,<->,42.104.166.11,2,236,0,0,2,236,1.386105000,0.3967
143.132.54.239,<->,136.25.188.226,0,0,2,188,2,188,1.385894000,0.0037
207.236.179.85,<->,136.25.188.253,0,0,2,188,2,188,1.385800000,0.0019
105.141.215.3,<->,50.224.89.243,0,0,2,362,2,362,1.385492000,0.0000
136.25.188.178,<->,98.32.65.40,2,531,0,0,2,531,1.385383000,0.0929
201.209.26.37,<->,92.27.219.189,0,0,2,2236,2,2236,1.383433000,0.0081
215.158.140.92,<->,122.158.49.125,2,2097,0,0,2,2097,1.383141000,0.3743
199.82.56.235,<->,136.25.188.225,0,0,2,188,2,188,1.383068000,0.0071
215.158.238.92,<->,136.139.59.101,2,2442,0,0,2,2442,1.382733000,0.5846
204.143.31.64,<->,8.182.248.147,0,0,2,462,2,462,1.382456000,0.3072
143.95.193.99,<->,136.25.188.238,0,0,2,188,2,188,1.381190000,0.0022
133.244.28.233,<->,127.255.180.249,2,178,0,0,2,178,1.380226000,0.1160
215.158.238.135,<->,57.210.107.8,2,2538,0,0,2,2538,1.378836000,0.5700
215.158.239.96,<->,199.20.100.95,2,680,0,0,2,680,1.377535000,0.1570
215.158.239.32,<->,106.188.184.169,2,327,0,0,2,327,1.377279000,0.3511
231.140.2.184,<->,136.25.188.45,0,0,2,188,2,188,1.376918000,0.0028
215.158.239.78,<->,199.20.29.115,2,430,0,0,2,430,1.376649000,0.3897
133.178.226.85,<->,100.120.38.6,2,1626,0,0,2,1626,1.375430000,0.3802
204.184.43.115,<->,136.25.188.222,0,0,2,188,2,188,1.374476000,0.0200
215.158.239.77,<->,207.57.165.244,2,774,0,0,2,774,1.373881000,0.2740
192.204.170.244,<->,133.178.227.27,0,0,2,2088,2,2088,1.372342000,0.5444
136.25.188.163,<->,41.148.106.11,2,387,0,0,2,387,1.371107000,0.0000
93.181.154.89,<->,92.27.219.16,0,0,2,100,2,100,1.370330000,0.3851
215.158.239.99,<->,199.20.30.36,2,188,0,0,2,188,1.369966000,0.0001
215.158.239.85,<->,8.255.92.165,2,2538,0,0,2,2538,1.369524000,0.4576
97.126.114.227,<->,8.232.96.254,2,208,0,0,2,208,1.367987000,0.0306
215.158.61.202,<->,8.176.8.97,0,0,2,1056,2,1056,1.367659000,0.2412
207.51.228.54,<->,8.252.222.225,0,0,2,247,2,247,1.365536000,0.3699
158.85.47.94,<->,133.178.227.247,0,0,2,374,2,374,1.364718000,0.0000
136.129.70.177,<->,6.15.100.1,2,356,0,0,2,356,1.364025000,0.1351
136.25.189.34,<->,116.106.46.69,2,2766,0,0,2,2766,1.361163000,0.4869
68.78.3.146,<->,8.252.221.237,0,0,2,1396,2,1396,1.360507000,0.3488
199.55.212.93,<->,8.252.222.141,0,0,2,178,2,178,1.360365000,0.5189
215.158.239.209,<->,96.135.155.50,2,930,0,0,2,930,1.360174000,0.0007
199.15.219.0,<->,136.25.188.45,0,0,2,188,2,188,1.358698000,0.0040
204.58.165.79,<->,136.25.188.174,0,0,2,188,2,188,1.356093000,0.0034
194.237.47.251,<->,136.25.188.220,0,0,2,188,2,188,1.355978000,0.0022
142.229.35.165,<->,136.25.188.176,0,0,2,656,2,656,1.355327000,0.2069
239.66.46.155,<->,159.137.235.224,0,0,2,375,2,375,1.354304000,0.0029
159.137.162.213,<->,126.100.242.174,2,676,0,0,2,676,1.353136000,0.3335
215.158.239.59,<->,199.72.49.122,2,939,0,0,2,939,1.353082000,0.0022
109.222.198.50,<->,53.244.240.3,2,290,0,0,2,290,1.353013000,0.3329
199.83.57.122,<->,136.25.188.177,0,0,2,1057,2,1057,1.352721000,0.0185
128.1.13.147,<->,89.183.110.72,0,0,2,1612,2,1612,1.351556000,0.4928
210.209.251.214,<->,145.16.98.204,0,0,2,913,2,913,1.349775000,0.0003
101.70.112.204,<->,8.235.17.153,2,395,0,0,2,395,1.349552000,0.0778
136.25.189.77,<->,126.219.49.42,2,2554,0,0,2,2554,1.349455000,0.4227
132.208.234.82,<->,8.204.66.217,2,2166,0,0,2,2166,1.348115000,0.0813
215.158.140.76,<->,120.154.179.41,2,2449,0,0,2,2449,1.347809000,0.4406
140.165.140.201,<->,8.252.221.236,0,0,2,951,2,951,1.347513000,0.5504
215.158.238.115,<->,142.234.196.161,2,2682,0,0,2,2682,1.346988000,0.3406
207.236.236.149,<->,136.25.188.238,0,0,2,188,2,188,1.346604000,0.0026
215.158.239.79,<->,199.20.30.180,2,188,0,0,2,188,1.346526000,0.0000
136.25.189.202,<->,131.31.144.144,2,323,0,0,2,323,1.345611000,0.0086
144.85.170.246,<->,98.87.146.190,2,1838,0,0,2,1838,1.344238000,0.3001
215.158.239.92,<->,199.20.4.55,2,1143,0,0,2,1143,1.343929000,0.5274
8.49.69.216,<->,6.74.92.233,0,0,2,1770,2,1770,1.343653000,0.0727
221.102.56.69,<->,6.74.243.3,0,0,2,588,2,588,1.342843000,0.4775
199.122.164.167,<->,136.25.188.44,0,0,2,188,2,188,1.342633000,0.0020
207.190.79.1,<->,136.25.188.239,0,0,2,834,2,834,1.342346000,0.0770
215.158.239.29,<->,215.158.127.148,2,1693,0,0,2,1693,1.341967000,0.1848
136.138.112.209,<->,133.178.226.77,0,0,2,2442,2,2442,1.341185000,0.3642
54.37.38.33,<->,48.52.73.71,0,0,2,312,2,312,1.341184000,0.5139
204.187.20.114,<->,136.25.188.174,0,0,2,188,2,188,1.340403000,0.0197
207.60.87.201,<->,136.25.188.243,0,0,2,668,2,668,1.340102000,0.1064
197.113.99.96,<->,136.25.188.220,0,0,2,968,2,968,1.340075000,0.0000
215.158.33.177,<->,102.233.98.138,0,0,2,1120,2,1120,1.339755000,0.0330
98.230.220.243,<->,8.183.25.124,0,0,2,431,2,431,1.339635000,0.1976
195.4.206.58,<->,136.25.188.225,0,0,2,982,2,982,1.338150000,0.0032
204.63.63.37,<->,136.25.188.54,0,0,2,774,2,774,1.337263000,0.6402
111.199.230.0,<->,0.195.210.44,0,0,2,223,2,223,1.335892000,0.0002
133.54.26.241,<->,27.117.140.41,2,472,0,0,2,472,1.335853000,0.1951
245.227.234.71,<->,8.182.241.177,0,0,2,964,2,964,1.334921000,0.0631
198.230.46.183,<->,159.137.162.213,0,0,2,676,2,676,1.333543000,0.2811
133.178.226.38,<->,131.144.114.228,2,2730,0,0,2,2730,1.332847000,0.4189
215.158.239.49,<->,199.79.10.208,2,430,0,0,2,430,1.331918000,0.3590
215.158.238.72,<->,80.47.111.88,2,2442,0,0,2,2442,1.331748000,0.3916
215.158.238.141,<->,131.144.113.168,2,2714,0,0,2,2714,1.331597000,0.5676
199.14.239.58,<->,136.25.188.239,0,0,2,188,2,188,1.331451000,0.0042
199.38.234.35,<->,136.25.188.177,0,0,2,188,2,188,1.331326000,0.0001
215.158.239.84,<->,106.188.253.129,2,2442,0,0,2,2442,1.330413000,0.4135
138.127.205.200,<->,97.126.19.181,0,0,2,634,2,634,1.330207000,0.0511
215.158.239.96,<->,195.81.3.160,2,282,0,0,2,282,1.329603000,0.1903
215.158.239.69,<->,199.20.31.208,2,186,0,0,2,186,1.327879000,0.0021
215.158.239.69,<->,207.236.246.163,2,1073,0,0,2,1073,1.327320000,0.0181
247.136.132.111,<->,103.166.36.62,2,782,0,0,2,782,1.326612000,0.1186
215.158.239.84,<->,143.72.68.211,2,598,0,0,2,598,1.326248000,0.1926
159.137.162.213,<->,125.220.197.150,2,676,0,0,2,676,1.325332000,0.2525
139.163.34.3,<->,103.0.70.163,2,598,0,0,2,598,1.325136000,0.2333
89.155.187.194,<->,8.183.25.124,0,0,2,680,2,680,1.324919000,0.1785
246.253.253.170,<->,8.35.106.56,2,336,0,0,2,336,1.323627000,0.1559
215.158.239.48,<->,207.114.77.109,2,656,0,0,2,656,1.323460000,0.6196
136.25.189.78,<->,8.249.253.227,2,2666,0,0,2,2666,1.322609000,0.1549
215.158.239.92,<->,197.125.108.31,2,2618,0,0,2,2618,1.322535000,0.1196
215.158.239.70,<->,142.182.49.179,2,499,0,0,2,499,1.321459000,0.2439
195.13.65.235,<->,136.25.188.55,0,0,2,950,2,950,1.319918000,0.0000
199.68.132.109,<->,136.25.188.254,0,0,2,656,2,656,1.319817000,0.2240
97.190.205.25,<->,8.37.175.39,2,642,0,0,2,642,1.319195000,0.2293
196.246.129.115,<->,136.25.188.52,0,0,2,188,2,188,1.318963000,0.0000
247.136.165.203,<->,40.220.179.65,2,140,0,0,2,140,1.318686000,0.6294
215.158.239.99,<->,199.20.30.171,2,188,0,0,2,188,1.318496000,0.0000
133.178.227.244,<->,122.158.179.154,2,2562,0,0,2,2562,1.318119000,0.2330
136.25.189.77,<->,98.28.95.85,2,2410,0,0,2,2410,1.317483000,0.1268
98.101.7.51,<->,8.176.63.62,0,0,2,2103,2,2103,1.317302000,0.3588
207.239.153.240,<->,136.25.188.242,0,0,2,1692,2,1692,1.316947000,0.4559
144.88.76.220,<->,54.69.75.250,2,207,0,0,2,207,1.315300000,0.0004
207.61.68.151,<->,136.25.188.176,0,0,2,656,2,656,1.314558000,0.3124
139.160.226.234,<->,136.25.188.47,0,0,2,2634,2,2634,1.314094000,0.1322
142.252.164.112,<->,136.25.188.241,0,0,2,430,2,430,1.313852000,0.5626
215.158.239.87,<->,199.20.31.208,2,188,0,0,2,188,1.312865000,0.0395
215.158.61.242,<->,8.176.8.197,0,0,2,1858,2,1858,1.312860000,0.0034
136.25.188.254,<->,116.99.180.215,2,2570,0,0,2,2570,1.312838000,0.5562
199.50.55.20,<->,136.25.188.177,0,0,2,188,2,188,1.312104000,0.0009
220.28.114.28,<->,215.158.140.80,0,0,2,1163,2,1163,1.311687000,0.5369
143.42.65.253,<->,136.25.188.46,0,0,2,532,2,532,1.311502000,0.0078
43.54.162.40,<->,8.252.221.238,0,0,2,894,2,894,1.310405000,0.1719
139.148.27.43,<->,8.182.239.241,0,0,2,800,2,800,1.308722000,0.1477
140.218.109.14,<->,133.178.226.77,0,0,2,2410,2,2410,1.308652000,0.4630
196.112.115.9,<->,0.195.210.44,0,0,2,234,2,234,1.308262000,0.1591
199.69.29.140,<->,136.25.188.55,0,0,2,745,2,745,1.307930000,0.2446
215.158.61.195,<->,8.176.8.197,0,0,2,810,2,810,1.307838000,0.3005
215.158.239.87,<->,142.167.140.82,2,947,0,0,2,947,1.307566000,0.0034
192.64.195.196,<->,50.51.14.51,2,781,0,0,2,781,1.307251000,0.4614
8.182.244.196,<->,6.117.57.68,2,443,0,0,2,443,1.306468000,0.0786
231.142.16.195,<->,136.25.188.196,0,0,2,188,2,188,1.306420000,0.0022
215.158.239.71,<->,48.131.158.219,2,2698,0,0,2,2698,1.303287000,0.2232
60.101.122.126,<->,8.252.222.143,0,0,2,1594,2,1594,1.303239000,0.1551
48.131.158.213,<->,8.252.222.211,0,0,2,2730,2,2730,1.302270000,0.6437
195.5.23.72,<->,136.25.188.53,0,0,2,957,2,957,1.302039000,0.0015
192.204.170.235,<->,133.178.227.79,0,0,2,2384,2,2384,1.301640000,0.5653
202.33.52.234,<->,136.25.188.174,0,0,2,188,2,188,1.301249000,0.0000
139.161.104.0,<->,133.178.227.245,0,0,2,2106,2,2106,1.301102000,0.1951
136.25.189.196,<->,129.222.39.32,2,330,0,0,2,330,1.300684000,0.0244
125.223.127.183,<->,100.228.42.100,0,0,2,1434,2,1434,1.300684000,0.0982
196.247.172.69,<->,136.25.188.176,0,0,2,768,2,768,1.299329000,0.0401
204.200.42.4,<->,136.25.188.177,0,0,2,188,2,188,1.297615000,0.0000
252.171.236.72,<->,50.224.76.248,0,0,2,1395,2,1395,1.297501000,0.1858
215.158.239.99,<->,199.15.220.125,2,283,0,0,2,283,1.297273000,0.1742
215.158.140.74,<->,210.209.188.196,2,704,0,0,2,704,1.297164000,0.0464
204.187.74.11,<->,136.25.188.160,0,0,2,188,2,188,1.293754000,0.0000
215.158.239.78,<->,207.190.59.41,2,1204,0,0,2,1204,1.293473000,0.6096
142.228.238.253,<->,136.25.188.225,0,0,2,926,2,926,1.293043000,0.0051
152.40.47.154,<->,8.252.222.143,0,0,2,774,2,774,1.292724000,0.5875
215.158.239.96,<->,199.20.30.138,2,1587,0,0,2,1587,1.292230000,0.3305
136.25.189.57,<->,8.215.68.83,2,2474,0,0,2,2474,1.291228000,0.3439
215.158.239.48,<->,199.20.6.6,2,188,0,0,2,188,1.291039000,0.0048
195.41.80.183,<->,136.25.188.45,0,0,2,188,2,188,1.290559000,0.0001
202.33.125.147,<->,136.25.188.174,0,0,2,188,2,188,1.290043000,0.0000
215.158.238.212,<->,215.158.43.51,2,571,0,0,2,571,1.288833000,0.1917
17.39.170.244,<->,8.220.205.216,0,0,2,482,2,482,1.288636000,0.3406
213.38.237.76,<->,132.128.61.77,2,664,0,0,2,664,1.287558000,0.0482
215.158.238.66,<->,8.222.96.15,2,2666,0,0,2,2666,1.287307000,0.4330
195.5.158.232,<->,136.25.188.163,0,0,2,1530,2,1530,1.287050000,0.0493
215.158.239.55,<->,98.219.126.175,2,2388,0,0,2,2388,1.286580000,0.5594
247.99.126.230,<->,50.224.89.241,0,0,2,1241,2,1241,1.285966000,0.0006
139.59.41.196,<->,8.182.224.87,0,0,2,2702,2,2702,1.285504000,0.0352
143.42.29.66,<->,136.25.188.255,0,0,2,1064,2,1064,1.283092000,0.4429
196.204.45.134,<->,136.25.188.178,0,0,2,234,2,234,1.282823000,0.0000
210.158.20.243,<->,80.38.62.152,0,0,2,1683,2,1683,1.282633000,0.3755
142.244.196.118,<->,136.25.188.241,0,0,2,960,2,960,1.282298000,0.0022
142.240.201.149,<->,136.25.188.252,0,0,2,1594,2,1594,1.280200000,0.4162
220.60.81.134,<->,136.25.189.59,0,0,2,2570,2,2570,1.279109000,0.2823
215.158.2.115,<->,133.178.226.167,0,0,2,1378,2,1378,1.278766000,0.4767
106.5.211.79,<->,48.53.111.214,0,0,2,427,2,427,1.278403000,0.3336
136.25.188.225,<->,95.90.181.60,2,478,0,0,2,478,1.278333000,0.4029
204.62.175.71,<->,136.25.188.225,0,0,2,188,2,188,1.278212000,0.0000
133.178.226.38,<->,57.227.83.251,2,2506,0,0,2,2506,1.277495000,0.5708
94.192.158.3,<->,8.252.222.143,0,0,2,188,2,188,1.277305000,0.0000
199.38.206.172,<->,136.25.188.220,0,0,2,1019,2,1019,1.276531000,0.5334
204.200.60.4,<->,136.25.188.174,0,0,2,186,2,186,1.276045000,0.6680
136.25.189.62,<->,100.216.78.145,2,1804,0,0,2,1804,1.275861000,0.2868
146.149.83.187,<->,8.252.221.198,0,0,2,843,2,843,1.275798000,0.2465
136.25.189.89,<->,29.213.219.37,2,2554,0,0,2,2554,1.275409000,0.2422
199.82.203.26,<->,136.25.188.53,0,0,2,390,2,390,1.274676000,0.0012
196.89.168.66,<->,136.25.188.45,0,0,2,774,2,774,1.274475000,0.1923
142.253.240.20,<->,136.25.188.224,0,0,2,656,2,656,1.274083000,0.2238
195.13.214.197,<->,136.25.188.46,0,0,2,846,2,846,1.273635000,0.0891
38.132.114.46,<->,8.252.222.134,0,0,2,1929,2,1929,1.273613000,0.1899
65.26.112.57,<->,8.252.222.62,0,0,2,188,2,188,1.272750000,0.0000
215.158.239.84,<->,195.83.105.170,2,774,0,0,2,774,1.272601000,0.2753
215.158.239.79,<->,142.236.171.98,2,849,0,0,2,849,1.272361000,0.4471
144.83.112.140,<->,50.224.108.188,0,0,2,389,2,389,1.271586000,0.0996
224.9.40.222,<->,100.228.42.205,0,0,2,1930,2,1930,1.271172000,0.0000
215.158.239.49,<->,196.0.126.245,2,954,0,0,2,954,1.269835000,0.0184
133.178.226.77,<->,126.219.194.151,2,2410,0,0,2,2410,1.269581000,0.5514
215.158.239.87,<->,199.20.28.159,2,188,0,0,2,188,1.269074000,0.0080
249.229.106.63,<->,8.53.0.43,0,0,2,680,2,680,1.268876000,0.2516
84.205.227.38,<->,8.252.222.159,0,0,2,680,2,680,1.268866000,0.1472
194.238.211.78,<->,136.25.188.237,0,0,2,188,2,188,1.268544000,0.0042
249.101.238.146,<->,53.69.55.165,2,1962,0,0,2,1962,1.268462000,0.1485
199.121.37.174,<->,136.25.188.174,0,0,2,937,2,937,1.267893000,0.0039
76.179.15.94,<->,8.252.222.142,0,0,2,774,2,774,1.267196000,0.1882
159.137.139.75,<->,133.178.227.41,0,0,2,2201,2,2201,1.266913000,0.6574
247.127.93.99,<->,221.102.105.151,0,0,2,2020,2,2020,1.266612000,0.4627
215.158.239.97,<->,196.104.65.18,2,188,0,0,2,188,1.265978000,0.0000
231.140.125.106,<->,136.25.188.225,0,0,2,188,2,188,1.264570000,0.0042
215.158.239.77,<->,199.20.31.164,2,1085,0,0,2,1085,1.264501000,0.3000
215.158.239.48,<->,196.91.4.154,2,832,0,0,2,832,1.264346000,0.1601
215.158.140.83,<->,158.85.50.93,2,2305,0,0,2,2305,1.264031000,0.4953
192.64.41.116,<->,92.27.27.142,0,0,2,321,2,321,1.263351000,0.7093
159.137.162.213,<->,29.157.49.25,2,676,0,0,2,676,1.263095000,0.2974
215.158.239.35,<->,29.211.5.197,2,215,0,0,2,215,1.262981000,0.4066
220.28.114.28,<->,133.178.227.44,0,0,2,624,2,624,1.262363000,0.4587
215.158.238.190,<->,106.188.252.184,2,2218,0,0,2,2218,1.261501000,0.2828
196.148.174.227,<->,53.243.94.134,2,1448,0,0,2,1448,1.261499000,0.2112
133.178.227.6,<->,129.80.130.60,2,918,0,0,2,918,1.261285000,0.0001
231.143.91.67,<->,136.25.188.225,0,0,2,188,2,188,1.260831000,0.0200
215.158.238.194,<->,8.219.184.144,2,1685,0,0,2,1685,1.260729000,0.0000
143.13.154.154,<->,136.25.188.54,0,0,2,440,2,440,1.258670000,0.2065
231.142.55.106,<->,215.158.239.56,0,0,2,164,2,164,1.258349000,0.0665
220.28.108.254,<->,215.158.238.41,0,0,2,2048,2,2048,1.258183000,0.3065
215.158.239.92,<->,207.58.11.163,2,532,0,0,2,532,1.258120000,0.7406
136.117.39.66,<->,109.1.31.105,0,0,2,1326,2,1326,1.257875000,0.1260
224.100.216.216,<->,92.162.253.44,0,0,2,342,2,342,1.256920000,0.0454
142.248.216.13,<->,136.25.188.252,0,0,2,188,2,188,1.255469000,0.0032
140.71.207.94,<->,8.252.221.231,0,0,2,1008,2,1008,1.254949000,0.0329
89.155.218.186,<->,8.182.226.78,0,0,2,680,2,680,1.254791000,0.3648
215.158.239.84,<->,195.55.60.139,2,774,0,0,2,774,1.253558000,0.1818
215.158.238.66,<->,56.102.22.9,2,2378,0,0,2,2378,1.253212000,0.3876
111.20.172.119,<->,111.20.168.154,0,0,2,1560,2,1560,1.252077000,0.0000
197.113.99.253,<->,136.25.188.254,0,0,2,462,2,462,1.252001000,0.5674
142.208.46.74,<->,136.25.188.238,0,0,2,963,2,963,1.251202000,0.4918
195.13.14.209,<->,136.25.188.252,0,0,2,188,2,188,1.251181000,0.0020
204.60.25.85,<->,136.25.188.55,0,0,2,531,2,531,1.251116000,0.6003
97.126.4.255,<->,27.10.94.12,2,125,0,0,2,125,1.250999000,0.1619
143.12.34.117,<->,136.25.188.177,0,0,2,942,2,942,1.250548000,0.0259
197.113.99.253,<->,136.25.188.239,0,0,2,430,2,430,1.249973000,0.5965
215.158.239.79,<->,143.13.245.216,2,441,0,0,2,441,1.249964000,0.2594
215.158.239.49,<->,212.70.75.119,2,2586,0,0,2,2586,1.249081000,0.5502
159.137.162.213,<->,110.240.17.32,2,676,0,0,2,676,1.247967000,0.2323
195.13.137.6,<->,136.25.188.55,0,0,2,774,2,774,1.247777000,0.1986
215.158.238.247,<->,215.158.43.49,2,606,0,0,2,606,1.247492000,0.1704
142.207.248.149,<->,136.25.188.225,0,0,2,1186,2,1186,1.247069000,0.2725
136.25.189.45,<->,29.211.93.15,2,2266,0,0,2,2266,1.244712000,0.3881
215.158.238.132,<->,8.191.6.88,2,2458,0,0,2,2458,1.244586000,0.5251
215.158.239.58,<->,199.20.7.206,2,188,0,0,2,188,1.244021000,0.0038
207.62.182.244,<->,136.25.188.252,0,0,2,188,2,188,1.244010000,0.0001
199.69.16.44,<->,136.25.188.255,0,0,2,950,2,950,1.243891000,0.0039
159.137.162.213,<->,112.30.205.142,2,676,0,0,2,676,1.242322000,0.3584
143.135.8.163,<->,136.25.188.163,0,0,2,188,2,188,1.241893000,0.0041
139.193.141.132,<->,102.249.125.118,2,656,0,0,2,656,1.241850000,0.6339
158.181.11.40,<->,144.87.235.222,0,0,2,992,2,992,1.241504000,0.2489
215.158.238.45,<->,8.252.210.160,2,2602,0,0,2,2602,1.241351000,0.6743
194.237.97.184,<->,136.25.188.253,0,0,2,774,2,774,1.240769000,0.2238
204.200.162.182,<->,136.25.188.240,0,0,2,188,2,188,1.239933000,0.0041
207.62.106.96,<->,136.25.188.45,0,0,2,439,2,439,1.239046000,0.6314
92.168.217.191,<->,50.136.179.8,2,640,0,0,2,640,1.238958000,0.1470
142.228.58.200,<->,136.25.188.163,0,0,2,518,2,518,1.238527000,0.4166
8.252.223.162,<->,8.192.205.86,2,1994,0,0,2,1994,1.235601000,0.6527
207.236.27.135,<->,136.25.188.53,0,0,2,478,2,478,1.235495000,0.0025
136.25.189.6,<->,96.156.169.219,2,2323,0,0,2,2323,1.233448000,0.0001
215.158.239.28,<->,158.166.175.248,2,1699,0,0,2,1699,1.233357000,0.6624
143.135.247.111,<->,136.25.188.173,0,0,2,1679,2,1679,1.233098000,0.2243
207.21.26.26,<->,8.182.250.65,0,0,2,1233,2,1233,1.232987000,0.5441
142.236.202.155,<->,136.25.188.178,0,0,2,982,2,982,1.232487000,0.0001
50.16.84.105,<->,8.52.182.85,0,0,2,457,2,457,1.231998000,0.0559
215.158.239.54,<->,0.195.253.228,2,1458,0,0,2,1458,1.231586000,0.7302
215.158.239.95,<->,196.93.187.114,2,774,0,0,2,774,1.230927000,0.6773
195.4.120.73,<->,136.25.188.209,0,0,2,656,2,656,1.228957000,0.2847
231.142.229.46,<->,136.25.188.222,0,0,2,188,2,188,1.228643000,0.0062
215.158.61.202,<->,136.25.189.210,0,0,2,2811,2,2811,1.227982000,0.1541
195.6.62.22,<->,136.25.188.178,0,0,2,1540,2,1540,1.227175000,0.3974
192.171.32.183,<->,136.25.189.15,0,0,2,2282,2,2282,1.227069000,0.3637
142.247.209.45,<->,136.25.188.176,0,0,2,712,2,712,1.227066000,0.5371
215.158.239.93,<->,196.95.135.73,2,188,0,0,2,188,1.227014000,0.0000
207.60.55.165,<->,136.25.188.163,0,0,2,188,2,188,1.226530000,0.0031
129.236.115.220,<->,111.20.168.122,0,0,2,2222,2,2222,1.226395000,0.6548
207.63.170.84,<->,136.25.188.227,0,0,2,656,2,656,1.225941000,0.2620
195.41.208.229,<->,136.25.188.255,0,0,2,188,2,188,1.225916000,0.0022
38.132.114.46,<->,8.252.222.60,0,0,2,688,2,688,1.225760000,0.1803
215.158.239.84,<->,199.39.88.51,2,843,0,0,2,843,1.225634000,0.3261
111.199.229.147,<->,0.195.210.42,0,0,2,1210,2,1210,1.225350000,0.6550
215.158.239.95,<->,199.20.31.153,2,803,0,0,2,803,1.224981000,0.4791
207.239.146.3,<->,136.25.188.53,0,0,2,953,2,953,1.224879000,0.0023
194.237.73.14,<->,136.25.188.44,0,0,2,188,2,188,1.224690000,0.0000
204.186.131.68,<->,136.25.188.243,0,0,2,1079,2,1079,1.224659000,0.1593
246.253.253.213,<->,199.9.96.56,2,1236,0,0,2,1236,1.224272000,0.4821
195.40.118.199,<->,136.25.188.226,0,0,2,1338,2,1338,1.223858000,0.5189
141.134.142.200,<->,133.178.227.79,0,0,2,2144,2,2144,1.223752000,0.6238
207.63.31.162,<->,136.25.188.173,0,0,2,656,2,656,1.222862000,0.2522
215.158.239.79,<->,196.92.199.220,2,186,0,0,2,186,1.222618000,0.3680
215.158.58.237,<->,6.73.247.89,0,0,2,1542,2,1542,1.222247000,0.0002
215.158.238.133,<->,111.150.186.166,2,2522,0,0,2,2522,1.221729000,0.5155
159.137.162.213,<->,82.150.50.215,2,676,0,0,2,676,1.220544000,0.0000
215.158.239.240,<->,192.228.30.185,2,539,0,0,2,539,1.219342000,0.0001
215.158.239.48,<->,142.167.211.243,2,188,0,0,2,188,1.219244000,0.0027
202.33.252.100,<->,136.25.188.179,0,0,2,188,2,188,1.218777000,0.0191
133.178.226.19,<->,65.27.228.181,2,2762,0,0,2,2762,1.217532000,0.4398
215.158.239.68,<->,143.13.248.253,2,928,0,0,2,928,1.216702000,0.2843
218.154.30.233,<->,8.52.189.207,0,0,2,2492,2,2492,1.216665000,0.3456
94.192.95.250,<->,8.252.221.204,0,0,2,1078,2,1078,1.216614000,0.1466
216.144.228.180,<->,215.158.140.179,0,0,2,644,2,644,1.215184000,0.1921
196.246.151.187,<->,136.25.188.173,0,0,2,774,2,774,1.215165000,0.5388
215.158.238.114,<->,113.23.20.93,2,2618,0,0,2,2618,1.215023000,0.5317
89.11.43.209,<->,80.40.33.172,0,0,2,618,2,618,1.213340000,0.0846
215.201.227.68,<->,8.182.233.43,0,0,2,433,2,433,1.213089000,0.0559
222.254.247.163,<->,210.220.219.182,0,0,2,922,2,922,1.212765000,0.5580
215.158.239.95,<->,204.2.151.175,2,188,0,0,2,188,1.212319000,0.0198
159.137.162.213,<->,117.56.163.126,2,676,0,0,2,676,1.209627000,0.2724
159.137.162.213,<->,117.11.138.106,2,676,0,0,2,676,1.209322000,0.2581
215.158.239.56,<->,196.93.232.240,2,188,0,0,2,188,1.208178000,0.0100
192.76.122.50,<->,89.183.104.179,0,0,2,816,2,816,1.207928000,0.0000
195.41.237.25,<->,136.25.188.53,0,0,2,188,2,188,1.207139000,0.0035
111.199.237.23,<->,8.20.87.95,0,0,2,680,2,680,1.206812000,0.1131
143.134.48.251,<->,136.25.188.241,0,0,2,792,2,792,1.203572000,0.0040
215.158.239.78,<->,199.20.31.243,2,188,0,0,2,188,1.203561000,0.0100
221.102.56.69,<->,220.81.26.217,0,0,2,588,2,588,1.201512000,0.1800
143.42.24.199,<->,136.25.188.174,0,0,2,188,2,188,1.201456000,0.0028
197.125.117.137,<->,133.178.227.1,0,0,2,2335,2,2335,1.200767000,0.6844
194.245.232.156,<->,8.252.222.177,0,0,2,188,2,188,1.200167000,0.0001
220.28.114.28,<->,215.158.239.88,0,0,2,637,2,637,1.200133000,0.2807
194.237.103.36,<->,136.25.188.226,0,0,2,951,2,951,1.200114000,0.1960
215.158.239.105,<->,215.158.61.202,2,1594,0,0,2,1594,1.200100000,0.6374
215.158.239.77,<->,65.27.220.201,2,2554,0,0,2,2554,1.199003000,0.4226
200.174.31.245,<->,53.167.74.78,2,2421,0,0,2,2421,1.198614000,0.0015
231.142.214.253,<->,215.158.239.94,0,0,2,774,2,774,1.198398000,0.2249
94.197.44.79,<->,35.56.101.157,0,0,2,160,2,160,1.198369000,0.3685
215.158.238.198,<->,148.26.113.214,2,2247,0,0,2,2247,1.197543000,0.3040
143.194.134.147,<->,8.252.222.143,0,0,2,1498,2,1498,1.196534000,0.0001
204.2.207.30,<->,136.25.188.253,0,0,2,656,2,656,1.195433000,0.3168
215.158.239.51,<->,199.14.128.40,2,443,0,0,2,443,1.195121000,0.2067
156.135.2.78,<->,0.195.210.42,0,0,2,354,2,354,1.194998000,0.2345
197.113.64.243,<->,136.25.188.253,0,0,2,188,2,188,1.194908000,0.0210
215.158.239.216,<->,54.55.19.94,2,837,0,0,2,837,1.194642000,0.0501
221.102.108.186,<->,217.11.190.192,2,830,0,0,2,830,1.194489000,0.0239
143.44.128.90,<->,136.25.188.53,0,0,2,656,2,656,1.194089000,0.3004
215.158.238.72,<->,27.178.41.36,2,2554,0,0,2,2554,1.194015000,0.7972
99.75.228.206,<->,27.11.18.201,2,218,0,0,2,218,1.193634000,0.0000
215.158.239.94,<->,194.251.88.123,2,1665,0,0,2,1665,1.193625000,0.0655
199.83.33.28,<->,8.52.134.46,0,0,2,336,2,336,1.193549000,0.3016
199.69.62.62,<->,136.25.188.177,0,0,2,672,2,672,1.193490000,0.0057
200.174.214.186,<->,53.244.62.198,2,480,0,0,2,480,1.193215000,0.1581
94.192.158.3,<->,8.252.222.60,0,0,2,188,2,188,1.193047000,0.0000
215.158.239.95,<->,142.166.122.95,2,656,0,0,2,656,1.192443000,0.2074
199.68.67.230,<->,136.25.188.208,0,0,2,323,2,323,1.191259000,0.2184
112.217.151.120,<->,0.195.210.46,0,0,2,2440,2,2440,1.189698000,0.1414
102.50.198.152,<->,27.11.57.104,2,2992,0,0,2,2992,1.189687000,0.1620
215.158.239.94,<->,196.1.17.216,2,188,0,0,2,188,1.189460000,0.0000
142.252.121.142,<->,136.25.188.176,0,0,2,188,2,188,1.189402000,0.0034
50.178.7.140,<->,8.52.222.199,0,0,2,656,2,656,1.189340000,0.0270
204.58.167.215,<->,136.25.188.175,0,0,2,188,2,188,1.189260000,0.0039
91.51.152.82,<->,8.53.2.189,0,0,2,418,2,418,1.189186000,0.0039
215.158.239.57,<->,143.42.79.210,2,656,0,0,2,656,1.189122000,0.1820
215.158.238.104,<->,128.123.91.10,2,2602,0,0,2,2602,1.188238000,0.4990
199.82.203.26,<->,136.25.188.199,0,0,2,388,2,388,1.187906000,0.0012
136.25.189.88,<->,96.156.169.230,2,1490,0,0,2,1490,1.187699000,0.7158
215.158.239.86,<->,204.226.36.140,2,188,0,0,2,188,1.187527000,0.0000
142.255.45.106,<->,136.25.188.242,0,0,2,656,2,656,1.186093000,0.6785
195.4.91.61,<->,136.25.188.197,0,0,2,680,2,680,1.186058000,0.2766
215.158.239.35,<->,106.188.214.30,2,1553,0,0,2,1553,1.185187000,0.5838
215.158.238.134,<->,111.151.70.38,2,2378,0,0,2,2378,1.185112000,0.3507
215.158.239.105,<->,215.158.61.183,2,1162,0,0,2,1162,1.185009000,0.7005
204.60.95.212,<->,136.25.188.243,0,0,2,951,2,951,1.184187000,0.0826
215.158.61.207,<->,136.25.189.213,0,0,2,505,2,505,1.183124000,0.0354
204.21.74.155,<->,136.25.188.177,0,0,2,440,2,440,1.182896000,0.5818
204.184.0.138,<->,136.25.188.175,0,0,2,202,2,202,1.181357000,0.1404
207.236.118.137,<->,136.25.188.252,0,0,2,188,2,188,1.181109000,0.0023
136.25.188.225,<->,131.215.37.28,2,2442,0,0,2,2442,1.180913000,0.4263
136.25.188.163,<->,133.167.148.155,2,1182,0,0,2,1182,1.180766000,0.0573
201.77.155.3,<->,8.220.178.246,0,0,2,351,2,351,1.180418000,0.3256
215.158.239.69,<->,199.20.5.131,2,188,0,0,2,188,1.180150000,0.0189
215.158.239.76,<->,199.82.203.26,2,390,0,0,2,390,1.179531000,0.0012
145.7.22.231,<->,100.228.42.103,0,0,2,606,2,606,1.179209000,0.0002
220.20.200.37,<->,193.81.55.4,2,2665,0,0,2,2665,1.178229000,0.0000
192.227.190.25,<->,8.252.223.175,0,0,2,2331,2,2331,1.177249000,0.3987
129.78.114.121,<->,33.241.84.13,2,656,0,0,2,656,1.175447000,0.1620
143.79.22.132,<->,136.25.188.241,0,0,2,188,2,188,1.175044000,0.0011
215.158.140.60,<->,8.191.7.251,2,2055,0,0,2,2055,1.174139000,0.7973
136.25.189.202,<->,129.222.39.213,2,1330,0,0,2,1330,1.174003000,0.0212
204.3.28.135,<->,136.25.188.176,0,0,2,188,2,188,1.173375000,0.0023
215.158.238.73,<->,131.1.195.229,2,1345,0,0,2,1345,1.172417000,0.6138
129.236.114.39,<->,33.233.141.0,0,0,2,1364,2,1364,1.172364000,0.6757
204.187.246.61,<->,136.25.188.55,0,0,2,975,2,975,1.172153000,0.2902
199.15.18.41,<->,136.25.188.238,0,0,2,188,2,188,1.171902000,0.0020
99.162.77.146,<->,53.200.59.220,2,497,0,0,2,497,1.171514000,0.2927
144.87.238.89,<->,8.182.224.87,0,0,2,2312,2,2312,1.171245000,0.7113
196.148.174.227,<->,53.243.94.39,2,2234,0,0,2,2234,1.170728000,0.2080
194.237.250.247,<->,136.25.188.220,0,0,2,434,2,434,1.169898000,0.0018
43.52.245.73,<->,8.252.221.236,0,0,2,908,2,908,1.169873000,0.3079
215.158.140.83,<->,8.240.116.184,2,2152,0,0,2,2152,1.168712000,0.5363
215.158.238.104,<->,80.47.111.67,2,2490,0,0,2,2490,1.168109000,0.1313
143.129.220.197,<->,136.25.188.198,0,0,2,188,2,188,1.167982000,0.0016
97.193.135.46,<->,8.182.239.159,0,0,2,731,2,731,1.167594000,0.0685
231.141.29.212,<->,136.25.188.178,0,0,2,950,2,950,1.167384000,0.0016
215.158.239.56,<->,199.20.31.6,2,430,0,0,2,430,1.165371000,0.6097
149.250.115.38,<->,136.25.188.179,0,0,2,2554,2,2554,1.165058000,0.6903
255.133.192.196,<->,255.133.192.20,2,293,0,0,2,293,1.164930000,0.2028
199.72.228.2,<->,136.25.188.253,0,0,2,178,2,178,1.163409000,0.0032
215.158.239.96,<->,207.212.129.86,2,283,0,0,2,283,1.162800000,0.1640
215.158.239.86,<->,195.83.248.246,2,188,0,0,2,188,1.162593000,0.0099
100.218.114.30,<->,8.252.221.171,0,0,2,1690,2,1690,1.162285000,0.6636
139.111.66.186,<->,136.25.188.163,0,0,2,811,2,811,1.161864000,0.0651
69.128.115.205,<->,54.36.191.119,2,779,0,0,2,779,1.161827000,0.6922
129.95.133.231,<->,14.125.23.209,0,0,2,218,2,218,1.161447000,0.0519
215.158.238.105,<->,106.188.251.218,2,2598,0,0,2,2598,1.161276000,0.4415
129.138.248.137,<->,8.252.222.157,0,0,2,186,2,186,1.161045000,0.0054
159.137.162.213,<->,122.202.251.213,2,676,0,0,2,676,1.160965000,0.2834
195.43.145.245,<->,136.25.188.178,0,0,2,188,2,188,1.160251000,0.0023
199.15.34.64,<->,136.25.188.239,0,0,2,954,2,954,1.160090000,0.0020
215.158.238.141,<->,113.23.117.105,2,2058,0,0,2,2058,1.159899000,0.2564
199.53.131.207,<->,136.25.188.220,0,0,2,241,2,241,1.159467000,0.0025
136.25.189.77,<->,96.156.169.244,2,1466,0,0,2,1466,1.159273000,0.0430
215.158.239.48,<->,207.228.230.155,2,188,0,0,2,188,1.157463000,0.0010
215.158.239.85,<->,199.20.28.71,2,966,0,0,2,966,1.156733000,0.0000
199.73.182.207,<->,136.25.188.160,0,0,2,943,2,943,1.156728000,0.0020
215.158.238.109,<->,100.224.166.122,2,1012,0,0,2,1012,1.156392000,0.4476
231.136.201.240,<->,136.25.188.241,0,0,2,387,2,387,1.156262000,0.1946
215.158.238.106,<->,136.139.59.118,2,2618,0,0,2,2618,1.155132000,0.5950
215.158.140.206,<->,99.74.26.217,2,2002,0,0,2,2002,1.155059000,0.4227
129.236.114.39,<->,33.233.141.1,0,0,2,1534,2,1534,1.154703000,0.0000
215.158.61.243,<->,8.176.8.245,0,0,2,1907,2,1907,1.154181000,0.0175
139.163.7.204,<->,130.79.84.77,2,375,0,0,2,375,1.153975000,0.0000
215.158.239.48,<->,195.40.147.246,2,391,0,0,2,391,1.153953000,0.0034
202.33.126.121,<->,136.25.188.209,0,0,2,188,2,188,1.153565000,0.0009
215.158.140.75,<->,215.158.6.200,2,2615,0,0,2,2615,1.153446000,0.7887
194.253.94.99,<->,8.182.244.19,0,0,2,1094,2,1094,1.153079000,0.0516
215.158.239.92,<->,212.70.75.121,2,2554,0,0,2,2554,1.152871000,0.3684
215.158.239.56,<->,207.228.152.240,2,961,0,0,2,961,1.152683000,0.0000
241.193.151.100,<->,136.25.188.236,0,0,2,394,2,394,1.151297000,0.0000
215.158.239.79,<->,143.79.196.178,2,188,0,0,2,188,1.151261000,0.0039
215.158.238.250,<->,139.163.163.240,2,2309,0,0,2,2309,1.149240000,0.7041
231.142.16.195,<->,136.25.188.252,0,0,2,188,2,188,1.149236000,0.0021
142.229.136.46,<->,136.25.188.178,0,0,2,188,2,188,1.149130000,0.0029
215.158.238.251,<->,8.222.6.193,2,2204,0,0,2,2204,1.148955000,0.4440
136.25.188.195,<->,98.219.126.175,2,455,0,0,2,455,1.148879000,0.2567
215.201.174.182,<->,8.182.226.78,0,0,2,656,2,656,1.148800000,0.1761
111.199.228.197,<->,0.195.210.44,0,0,2,223,2,223,1.147641000,0.0001
136.139.59.103,<->,133.178.226.37,0,0,2,2586,2,2586,1.146892000,0.7678
215.158.239.16,<->,215.158.127.181,2,2263,0,0,2,2263,1.145777000,0.2579
215.158.239.84,<->,194.202.251.104,2,188,0,0,2,188,1.145416000,0.0204
132.18.67.30,<->,100.94.106.156,0,0,2,704,2,704,1.145117000,0.2708
66.47.82.31,<->,8.252.222.134,0,0,2,188,2,188,1.144763000,0.0006
215.158.239.48,<->,199.20.28.56,2,849,0,0,2,849,1.143920000,0.4696
215.158.239.58,<->,199.20.30.1,2,1681,0,0,2,1681,1.143445000,0.6795
215.158.238.47,<->,33.209.217.238,2,2632,0,0,2,2632,1.142499000,0.3162
215.158.239.97,<->,199.122.9.216,2,518,0,0,2,518,1.142245000,0.3400
215.158.239.86,<->,199.20.29.30,2,958,0,0,2,958,1.140697000,0.0000
215.158.239.85,<->,199.20.6.101,2,188,0,0,2,188,1.140466000,0.0090
215.158.239.43,<->,112.220.206.100,2,1548,0,0,2,1548,1.140040000,0.5304
133.178.226.77,<->,113.23.21.222,2,2458,0,0,2,2458,1.139424000,0.4233
215.158.239.49,<->,199.20.6.231,2,957,0,0,2,957,1.139387000,0.0000
215.158.239.113,<->,129.222.39.37,2,1682,0,0,2,1682,1.139281000,0.0276
136.25.189.80,<->,61.35.124.188,2,2538,0,0,2,2538,1.138974000,0.8078
133.178.227.27,<->,8.42.42.84,2,2291,0,0,2,2291,1.138770000,0.6352
136.25.189.34,<->,6.15.207.97,2,2506,0,0,2,2506,1.138749000,0.5563
215.158.238.99,<->,146.14.145.213,2,2554,0,0,2,2554,1.138732000,0.7741
215.158.239.77,<->,196.92.131.24,2,774,0,0,2,774,1.138577000,0.7600
215.158.239.58,<->,199.20.31.155,2,804,0,0,2,804,1.138374000,0.7177
143.43.127.33,<->,136.25.188.226,0,0,2,386,2,386,1.137705000,0.0020
204.62.115.169,<->,136.25.188.237,0,0,2,188,2,188,1.137664000,0.0000
195.70.7.128,<->,136.25.188.255,0,0,2,607,2,607,1.137535000,0.0058
215.158.239.224,<->,145.116.223.4,2,1122,0,0,2,1122,1.136344000,0.0000
100.95.37.92,<->,53.195.188.234,2,844,0,0,2,844,1.135591000,0.8291
215.158.61.195,<->,8.176.8.202,0,0,2,1487,2,1487,1.135133000,0.1831
199.82.179.248,<->,136.25.188.242,0,0,2,188,2,188,1.134987000,0.0062
204.56.12.188,<->,136.25.188.55,0,0,2,188,2,188,1.134986000,0.0023
195.43.33.186,<->,136.25.188.225,0,0,2,188,2,188,1.132702000,0.0032
199.50.60.196,<->,136.25.188.242,0,0,2,188,2,188,1.132466000,0.0032
159.137.162.213,<->,122.211.242.222,2,676,0,0,2,676,1.132281000,0.1084
215.158.239.87,<->,199.68.207.61,2,186,0,0,2,186,1.132220000,0.7170
92.168.217.222,<->,50.136.185.76,2,632,0,0,2,632,1.132058000,0.5955
196.240.242.55,<->,136.25.188.209,0,0,2,439,2,439,1.131459000,0.3129
133.178.227.24,<->,69.150.169.217,2,2159,0,0,2,2159,1.131238000,0.6376
225.120.209.61,<->,50.224.76.235,0,0,2,399,2,399,1.130921000,0.0195
215.158.239.49,<->,196.106.38.147,2,1705,0,0,2,1705,1.130616000,0.7027
207.60.142.207,<->,136.25.188.225,0,0,2,439,2,439,1.130528000,0.3989
215.158.238.92,<->,126.219.196.180,2,2362,0,0,2,2362,1.129013000,0.3445
122.245.191.228,<->,92.27.219.216,0,0,2,1982,2,1982,1.127175000,0.4192
80.41.13.153,<->,0.33.170.223,2,722,0,0,2,722,1.126884000,0.0001
215.158.239.76,<->,207.61.20.6,2,538,0,0,2,538,1.126865000,0.7301
133.178.227.76,<->,131.144.114.248,2,2183,0,0,2,2183,1.126291000,0.1738
111.2.157.67,<->,8.182.226.78,0,0,2,1730,2,1730,1.126009000,0.4100
215.158.140.233,<->,131.141.218.103,2,532,0,0,2,532,1.125710000,0.7209
215.158.239.78,<->,196.94.212.182,2,188,0,0,2,188,1.125658000,0.0001
221.196.122.208,<->,136.25.188.163,0,0,2,1332,2,1332,1.125547000,0.4792
136.25.189.1,<->,96.156.169.232,2,2586,0,0,2,2586,1.125256000,0.3479
215.158.238.73,<->,80.47.111.107,2,2698,0,0,2,2698,1.124905000,0.4907
215.158.238.221,<->,131.1.194.197,2,2334,0,0,2,2334,1.124523000,0.4184
136.25.189.29,<->,133.56.180.50,2,2618,0,0,2,2618,1.124267000,0.2898
109.222.220.176,<->,53.191.244.178,2,344,0,0,2,344,1.123964000,0.4975
95.246.65.143,<->,8.252.221.221,0,0,2,2218,2,2218,1.123622000,0.8061
136.25.189.15,<->,29.212.198.215,2,2442,0,0,2,2442,1.122685000,0.5629
136.25.189.80,<->,29.213.219.59,2,2650,0,0,2,2650,1.122240000,0.7533
133.178.227.76,<->,8.222.6.193,2,2262,0,0,2,2262,1.121906000,0.2834
102.232.21.245,<->,56.114.235.120,2,1303,0,0,2,1303,1.121290000,0.0602
195.14.65.48,<->,136.25.188.174,0,0,2,188,2,188,1.121082000,0.0054
148.23.229.53,<->,136.25.188.44,0,0,2,2714,2,2714,1.120826000,0.7238
8.252.223.175,<->,8.192.205.75,2,2188,0,0,2,2188,1.120197000,0.5900
92.27.219.143,<->,33.57.78.119,2,100,0,0,2,100,1.119673000,0.1563
136.25.188.252,<->,131.144.113.215,2,2682,0,0,2,2682,1.118841000,0.6103
207.173.96.90,<->,136.25.188.255,0,0,2,568,2,568,1.118009000,0.6620
195.70.147.69,<->,136.25.188.174,0,0,2,875,2,875,1.117752000,0.2844
17.41.129.123,<->,8.52.142.60,0,0,2,342,2,342,1.117196000,0.3357
215.158.238.121,<->,65.27.228.187,2,2698,0,0,2,2698,1.117175000,0.5747
195.70.207.164,<->,136.25.188.163,0,0,2,956,2,956,1.116376000,0.0519
133.178.227.40,<->,8.219.184.110,2,2346,0,0,2,2346,1.116082000,0.7908
192.204.170.214,<->,136.25.188.160,0,0,2,2650,2,2650,1.115906000,0.7563
133.178.227.14,<->,61.35.70.34,2,2293,0,0,2,2293,1.115816000,0.2548
194.233.86.79,<->,136.25.188.197,0,0,2,188,2,188,1.115218000,0.0200
97.34.178.244,<->,50.224.102.155,0,0,2,973,2,973,1.115035000,0.0286
215.158.239.94,<->,204.226.53.177,2,188,0,0,2,188,1.114562000,0.0002
220.20.200.58,<->,144.83.60.153,2,1287,0,0,2,1287,1.113760000,0.0000
204.187.83.233,<->,136.25.188.253,0,0,2,380,2,380,1.113225000,0.2614
199.32.195.137,<->,136.25.188.238,0,0,2,188,2,188,1.112660000,0.0017
98.67.154.211,<->,80.27.153.41,2,882,0,0,2,882,1.112377000,0.4876
149.170.238.93,<->,0.195.210.42,0,0,2,656,2,656,1.111539000,0.1515
136.25.189.82,<->,131.144.113.41,2,2602,0,0,2,2602,1.111086000,0.2898
142.190.183.209,<->,136.25.188.174,0,0,2,1097,2,1097,1.110121000,0.2123
142.249.242.45,<->,136.25.188.239,0,0,2,202,2,202,1.109753000,0.0061
197.161.240.141,<->,136.25.188.239,0,0,2,188,2,188,1.109686000,0.0000
133.178.227.242,<->,111.150.74.121,2,1470,0,0,2,1470,1.109664000,0.0772
215.158.239.71,<->,80.56.79.89,2,2759,0,0,2,2759,1.108464000,0.7914
192.227.190.20,<->,8.252.223.141,0,0,2,2650,2,2650,1.107870000,0.7860
133.178.226.49,<->,113.23.104.221,2,2554,0,0,2,2554,1.107781000,0.6026
204.186.230.242,<->,136.25.188.255,0,0,2,188,2,188,1.107419000,0.0200
207.59.41.142,<->,136.25.188.52,0,0,2,389,2,389,1.106932000,0.0024
215.158.239.56,<->,196.109.86.160,2,380,0,0,2,380,1.106841000,0.1007
215.158.239.48,<->,199.20.100.95,2,680,0,0,2,680,1.105815000,0.1565
129.187.1.212,<->,109.1.84.196,0,0,2,1271,2,1271,1.105316000,0.0976
215.158.239.79,<->,195.43.124.209,2,345,0,0,2,345,1.104864000,0.2064
136.25.189.13,<->,96.156.169.223,2,227,0,0,2,227,1.103944000,0.7192
215.158.239.92,<->,207.114.77.109,2,430,0,0,2,430,1.103196000,0.6597
215.158.140.75,<->,29.211.6.151,2,2179,0,0,2,2179,1.102163000,0.2879
199.32.227.43,<->,136.25.188.163,0,0,2,920,2,920,1.100724000,0.0044
143.23.214.138,<->,136.25.188.243,0,0,2,435,2,435,1.099924000,0.5671
133.178.226.19,<->,119.196.23.52,2,2362,0,0,2,2362,1.099138000,0.7758
215.158.239.56,<->,199.20.7.188,2,188,0,0,2,188,1.098241000,0.0000
80.42.168.235,<->,14.30.152.112,2,1054,0,0,2,1054,1.097773000,0.1067
215.158.238.86,<->,100.224.166.122,2,1012,0,0,2,1012,1.096434000,0.5803
215.158.239.49,<->,199.20.29.184,2,849,0,0,2,849,1.096341000,0.4295
133.178.227.12,<->,8.222.212.106,2,2635,0,0,2,2635,1.095629000,0.1185
142.209.111.137,<->,136.25.188.45,0,0,2,962,2,962,1.095309000,0.4684
215.158.239.84,<->,96.150.228.214,2,2570,0,0,2,2570,1.095043000,0.8218
102.51.92.163,<->,27.14.47.160,2,307,0,0,2,307,1.094253000,0.3981
144.83.60.153,<->,92.162.253.75,0,0,2,1709,2,1709,1.094177000,0.6282
136.25.189.59,<->,96.156.169.253,2,2874,0,0,2,2874,1.092789000,0.5507
145.13.160.155,<->,8.52.171.120,0,0,2,656,2,656,1.092616000,0.0238
215.158.239.49,<->,29.212.198.180,2,2426,0,0,2,2426,1.092084000,0.5424
215.158.238.198,<->,69.150.168.200,2,2163,0,0,2,2163,1.092040000,0.7265
66.47.82.31,<->,8.252.222.46,0,0,2,188,2,188,1.092021000,0.0000
132.18.67.31,<->,99.72.163.119,0,0,2,1753,2,1753,1.091717000,0.0388
200.179.137.220,<->,8.252.222.208,0,0,2,421,2,421,1.091049000,0.1473
215.158.239.59,<->,199.20.29.237,2,188,0,0,2,188,1.090232000,0.0000
215.158.239.0,<->,215.158.127.166,2,653,0,0,2,653,1.089726000,0.3709
215.158.239.94,<->,116.106.46.57,2,2663,0,0,2,2663,1.089644000,0.5729
215.158.238.59,<->,8.222.109.124,2,2906,0,0,2,2906,1.088922000,0.4760
207.193.32.90,<->,8.182.227.180,0,0,2,150,2,150,1.088852000,0.0000
202.33.125.70,<->,136.25.188.252,0,0,2,188,2,188,1.088599000,0.0000
144.86.150.215,<->,118.90.83.212,2,114,0,0,2,114,1.088582000,0.1044
204.186.224.4,<->,136.25.188.54,0,0,2,771,2,771,1.086598000,0.0001
215.158.239.56,<->,199.106.233.210,2,819,0,0,2,819,1.086475000,0.0799
204.62.94.45,<->,136.25.188.163,0,0,2,188,2,188,1.086338000,0.0080
215.158.238.82,<->,122.159.245.156,2,2698,0,0,2,2698,1.086297000,0.4484
136.25.188.224,<->,112.220.206.15,2,2538,0,0,2,2538,1.086243000,0.8962
202.33.46.188,<->,136.25.188.236,0,0,2,188,2,188,1.085835000,0.0001
222.254.228.206,<->,215.158.140.11,0,0,2,830,2,830,1.085804000,0.5386
215.158.238.120,<->,114.25.48.40,2,2458,0,0,2,2458,1.085538000,0.7716
145.13.160.155,<->,8.52.222.23,0,0,2,656,2,656,1.085517000,0.0252
207.236.28.188,<->,136.25.188.209,0,0,2,188,2,188,1.084716000,0.0017
144.93.201.3,<->,8.220.186.82,0,0,2,283,2,283,1.084526000,0.0730
207.117.213.69,<->,8.182.227.180,0,0,2,420,2,420,1.084466000,0.1839
215.158.239.94,<->,126.219.49.93,2,2666,0,0,2,2666,1.082871000,0.3560
215.158.239.56,<->,199.20.30.97,2,958,0,0,2,958,1.082263000,0.0198
133.178.227.14,<->,8.53.216.63,2,2554,0,0,2,2554,1.082026000,0.7677
215.158.239.95,<->,199.20.29.49,2,774,0,0,2,774,1.081762000,0.4701
210.194.224.134,<->,8.53.7.199,0,0,2,433,2,433,1.079908000,0.0574
101.70.127.229,<->,53.94.228.30,2,826,0,0,2,826,1.079813000,0.2424
141.86.31.72,<->,0.195.210.42,0,0,2,1884,2,1884,1.079076000,0.8763
216.184.2.48,<->,97.126.31.75,0,0,2,1858,2,1858,1.078707000,0.0004
133.178.227.76,<->,69.31.239.22,2,2183,0,0,2,2183,1.078524000,0.5076
199.70.59.102,<->,136.25.188.198,0,0,2,875,2,875,1.078241000,0.3284
215.158.239.50,<->,212.70.75.102,2,2554,0,0,2,2554,1.078107000,0.3621
136.25.188.163,<->,8.217.44.53,2,2570,0,0,2,2570,1.077277000,0.4806
215.158.239.50,<->,195.83.1.113,2,1530,0,0,2,1530,1.076031000,0.8001
204.61.10.56,<->,136.25.188.252,0,0,2,188,2,188,1.075599000,0.0019
195.5.10.118,<->,136.25.188.52,0,0,2,680,2,680,1.075073000,0.2023
213.221.90.194,<->,80.38.10.112,0,0,2,1973,2,1973,1.074277000,0.7574
215.158.239.95,<->,133.146.0.198,2,2586,0,0,2,2586,1.074157000,0.0484
143.52.171.63,<->,136.25.188.226,0,0,2,440,2,440,1.074147000,0.1952
215.158.239.77,<->,196.105.81.64,2,774,0,0,2,774,1.073994000,0.3696
215.158.238.134,<->,142.234.196.200,2,2554,0,0,2,2554,1.073774000,0.4005
136.25.188.160,<->,65.27.220.219,2,2730,0,0,2,2730,1.073769000,0.9116
215.158.239.201,<->,192.226.44.75,2,831,0,0,2,831,1.072800000,0.0818
136.25.188.47,<->,65.27.228.213,2,2426,0,0,2,2426,1.072368000,0.5489
215.158.239.57,<->,142.221.129.95,2,391,0,0,2,391,1.072039000,0.0013
133.178.226.31,<->,8.252.210.160,2,2714,0,0,2,2714,1.071649000,0.7680
136.25.188.179,<->,32.183.36.102,2,2618,0,0,2,2618,1.071203000,0.1889
35.17.219.171,<->,8.220.205.146,0,0,2,2220,2,2220,1.070719000,0.0702
142.244.99.151,<->,136.25.188.198,0,0,2,188,2,188,1.070504000,0.0023
215.158.140.93,<->,8.53.216.49,2,2199,0,0,2,2199,1.069847000,0.5603
215.158.239.105,<->,215.158.61.145,2,998,0,0,2,998,1.069839000,0.7070
215.158.61.202,<->,8.176.8.110,0,0,2,1990,2,1990,1.068994000,0.4197
158.193.237.178,<->,8.252.223.192,0,0,2,468,2,468,1.068013000,0.0000
215.158.239.76,<->,207.115.235.64,2,188,0,0,2,188,1.067605000,0.0000
136.25.189.17,<->,29.213.219.39,2,2458,0,0,2,2458,1.066703000,0.7743
215.158.238.198,<->,18.202.90.165,2,2442,0,0,2,2442,1.066129000,0.4641
199.38.228.57,<->,136.25.188.226,0,0,2,1693,2,1693,1.065619000,0.3306
215.158.239.92,<->,195.83.120.106,2,188,0,0,2,188,1.065342000,0.0000
80.27.102.65,<->,8.252.222.63,0,0,2,188,2,188,1.065195000,0.0011
195.5.37.247,<->,136.25.188.211,0,0,2,202,2,202,1.064823000,0.0041
215.158.61.189,<->,8.176.8.253,0,0,2,858,2,858,1.064377000,0.1596
221.102.103.73,<->,207.200.207.65,2,880,0,0,2,880,1.064228000,0.0579
210.220.219.151,<->,8.235.221.41,2,186,0,0,2,186,1.064181000,0.2209
195.68.154.205,<->,136.25.188.252,0,0,2,1204,2,1204,1.063530000,0.6599
215.158.239.78,<->,136.139.59.126,2,2586,0,0,2,2586,1.063519000,0.3580
136.25.188.197,<->,118.20.87.63,2,2602,0,0,2,2602,1.063408000,0.5196
215.158.239.74,<->,0.195.237.14,2,1816,0,0,2,1816,1.063404000,0.8960
92.181.155.55,<->,8.204.53.229,2,588,0,0,2,588,1.062983000,0.5896
115.119.97.98,<->,50.224.89.243,0,0,2,188,2,188,1.062967000,0.0099
215.158.238.45,<->,131.36.198.58,2,2666,0,0,2,2666,1.062010000,0.6698
142.244.64.54,<->,136.25.188.222,0,0,2,188,2,188,1.061764000,0.0019
215.158.239.94,<->,195.4.182.232,2,774,0,0,2,774,1.061641000,0.2581
207.239.101.2,<->,136.25.188.239,0,0,2,188,2,188,1.061388000,0.0747
145.79.67.241,<->,8.220.178.166,0,0,2,680,2,680,1.061324000,0.0616
215.158.239.96,<->,199.20.28.226,2,188,0,0,2,188,1.061275000,0.0001
197.113.99.140,<->,136.25.188.178,0,0,2,188,2,188,1.061044000,0.0400
215.158.239.76,<->,204.3.241.178,2,202,0,0,2,202,1.059432000,0.6699
133.178.226.80,<->,111.150.34.244,2,2586,0,0,2,2586,1.058219000,0.6172
133.178.227.19,<->,111.150.187.215,2,2650,0,0,2,2650,1.057663000,0.4292
215.158.239.56,<->,199.32.175.22,2,1720,0,0,2,1720,1.056820000,0.9227
210.220.219.182,<->,50.239.19.179,2,1066,0,0,2,1066,1.056698000,0.0000
197.113.99.146,<->,136.25.188.220,0,0,2,621,2,621,1.056635000,0.7599
220.39.233.181,<->,215.158.238.135,0,0,2,2506,2,2506,1.056542000,0.2158
136.25.188.223,<->,80.47.111.107,2,2266,0,0,2,2266,1.055514000,0.8846
100.115.92.199,<->,41.143.115.31,2,351,0,0,2,351,1.054813000,0.1200
215.158.238.105,<->,8.188.227.60,2,2394,0,0,2,2394,1.053480000,0.7179
136.25.189.32,<->,61.35.70.234,2,2554,0,0,2,2554,1.053251000,0.9377
215.158.239.99,<->,196.109.32.244,2,966,0,0,2,966,1.052475000,0.0000
136.25.189.42,<->,96.156.169.237,2,634,0,0,2,634,1.052330000,0.8301
220.28.85.14,<->,136.25.189.54,0,0,2,1771,2,1771,1.051790000,0.0000
142.249.87.206,<->,136.25.188.252,0,0,2,200,2,200,1.051413000,0.0038
136.25.188.162,<->,131.1.195.234,2,2522,0,0,2,2522,1.050922000,0.0691
192.170.241.167,<->,99.74.27.172,0,0,2,657,2,657,1.050490000,0.0355
143.35.68.6,<->,136.25.188.255,0,0,2,656,2,656,1.049432000,0.2326
215.158.239.77,<->,199.20.31.88,2,852,0,0,2,852,1.049361000,0.0096
215.158.239.58,<->,199.20.31.106,2,1028,0,0,2,1028,1.048909000,0.1402
197.113.99.101,<->,136.25.188.222,0,0,2,188,2,188,1.048788000,0.0299
195.125.11.138,<->,136.25.188.238,0,0,2,428,2,428,1.048563000,0.0018
215.158.238.135,<->,126.219.196.169,2,2346,0,0,2,2346,1.047131000,0.6626
133.178.226.90,<->,119.196.23.42,2,2426,0,0,2,2426,1.046887000,0.6718
215.158.140.241,<->,215.158.6.213,2,2717,0,0,2,2717,1.046144000,0.9138
215.158.238.107,<->,57.3.89.196,2,2314,0,0,2,2314,1.045861000,0.7214
215.158.238.113,<->,57.227.82.229,2,2666,0,0,2,2666,1.044863000,0.8230
158.192.3.232,<->,136.25.188.227,0,0,2,2618,2,2618,1.044355000,0.1253
195.54.52.61,<->,136.25.188.163,0,0,2,188,2,188,1.043649000,0.0022
215.158.239.86,<->,199.20.4.3,2,947,0,0,2,947,1.043582000,0.0097
215.158.238.64,<->,131.144.114.218,2,2570,0,0,2,2570,1.043573000,0.3141
204.58.165.79,<->,136.25.188.160,0,0,2,188,2,188,1.043003000,0.0022
215.158.61.243,<->,8.176.8.206,0,0,2,2060,2,2060,1.042417000,0.2602
215.158.61.182,<->,136.25.189.221,0,0,2,1266,2,1266,1.042266000,0.1118
207.61.157.223,<->,136.25.188.243,0,0,2,188,2,188,1.040621000,0.0025
136.25.188.166,<->,96.155.61.55,2,978,0,0,2,978,1.040329000,0.0003
204.56.128.71,<->,136.25.188.175,0,0,2,188,2,188,1.040319000,0.0022
207.93.182.223,<->,8.182.250.65,0,0,2,746,2,746,1.040271000,0.8813
215.158.239.77,<->,196.1.169.142,2,978,0,0,2,978,1.037468000,0.0408
215.158.238.118,<->,100.224.166.115,2,2768,0,0,2,2768,1.037075000,0.0000
231.142.98.50,<->,215.158.239.68,0,0,2,938,2,938,1.035400000,0.0014
203.215.2.29,<->,42.204.12.30,2,750,0,0,2,750,1.034644000,0.8703
143.135.13.170,<->,136.25.188.46,0,0,2,178,2,178,1.034441000,0.0029
207.59.3.222,<->,136.25.188.252,0,0,2,188,2,188,1.034373000,0.0022
231.143.93.88,<->,136.25.188.163,0,0,2,956,2,956,1.034211000,0.0395
215.158.239.34,<->,57.210.104.216,2,1559,0,0,2,1559,1.034042000,0.8425
143.155.227.54,<->,133.178.226.49,0,0,2,1184,2,1184,1.033745000,0.0001
136.25.188.161,<->,112.235.95.26,2,2586,0,0,2,2586,1.033685000,0.8728
215.158.239.76,<->,196.0.158.60,2,202,0,0,2,202,1.033661000,0.1613
215.158.140.60,<->,149.254.114.58,2,2315,0,0,2,2315,1.032702000,0.3590
224.93.235.39,<->,80.27.157.12,0,0,2,1431,2,1431,1.032678000,0.6232
143.68.90.47,<->,136.25.188.177,0,0,2,188,2,188,1.032315000,0.0035
207.58.89.106,<->,136.25.188.241,0,0,2,656,2,656,1.030302000,0.2428
207.191.136.103,<->,136.25.188.46,0,0,2,188,2,188,1.030116000,0.0022
149.163.129.213,<->,133.178.227.24,0,0,2,2152,2,2152,1.029149000,0.9286
156.165.37.95,<->,136.25.189.28,0,0,2,2362,2,2362,1.029027000,0.7551
215.158.238.92,<->,131.144.114.211,2,2538,0,0,2,2538,1.029005000,0.6924
215.158.140.229,<->,68.231.10.151,2,2342,0,0,2,2342,1.028950000,0.6491
215.158.239.86,<->,125.84.55.32,2,2714,0,0,2,2714,1.028929000,0.6027
215.158.61.145,<->,8.176.8.189,0,0,2,1265,2,1265,1.028860000,0.8041
193.51.144.28,<->,109.1.35.91,0,0,2,734,2,734,1.028393000,0.3235
136.25.188.226,<->,69.132.194.94,2,2394,0,0,2,2394,1.028298000,0.7756
142.207.78.16,<->,136.25.188.178,0,0,2,1418,2,1418,1.027239000,0.5047
215.158.140.231,<->,48.131.159.0,2,2490,0,0,2,2490,1.027181000,0.9082
195.71.179.70,<->,136.25.188.220,0,0,2,188,2,188,1.026585000,0.0052
143.95.254.8,<->,136.25.188.253,0,0,2,371,2,371,1.026272000,0.0034
204.2.22.159,<->,136.25.188.196,0,0,2,1649,2,1649,1.025740000,0.5448
215.158.239.215,<->,69.31.238.17,2,1192,0,0,2,1192,1.025065000,0.3042
215.158.238.96,<->,197.125.116.102,2,2586,0,0,2,2586,1.025023000,0.6589
215.158.239.96,<->,143.42.77.50,2,946,0,0,2,946,1.023892000,0.0024
196.103.220.143,<->,80.40.41.209,0,0,2,268,2,268,1.023414000,0.3014
142.206.20.244,<->,136.25.188.53,0,0,2,937,2,937,1.022330000,0.0025
136.25.189.80,<->,8.222.58.218,2,2426,0,0,2,2426,1.022163000,0.3854
215.158.140.241,<->,69.31.238.156,2,2712,0,0,2,2712,1.021892000,0.3246
138.37.223.61,<->,8.182.244.237,0,0,2,431,2,431,1.020149000,0.1537
140.158.19.100,<->,136.25.188.163,0,0,2,774,2,774,1.019913000,0.4370
215.158.239.75,<->,139.163.161.48,2,1426,0,0,2,1426,1.019392000,0.0002
204.187.32.184,<->,136.25.188.252,0,0,2,956,2,956,1.019363000,0.0173
92.175.125.222,<->,8.52.189.207,0,0,2,656,2,656,1.019032000,0.0785
99.252.99.88,<->,50.224.68.190,0,0,2,583,2,583,1.017503000,0.1079
215.158.238.33,<->,156.181.149.251,2,2698,0,0,2,2698,1.017495000,0.6489
142.206.79.97,<->,136.25.188.44,0,0,2,543,2,543,1.017183000,0.2830
204.60.154.66,<->,136.25.188.198,0,0,2,188,2,188,1.016359000,0.0213
136.25.188.220,<->,29.214.108.180,2,2860,0,0,2,2860,1.015949000,0.9089
136.25.189.59,<->,69.132.194.94,2,2618,0,0,2,2618,1.015947000,0.2746
136.25.188.53,<->,104.3.161.25,2,2538,0,0,2,2538,1.014841000,0.7218
215.158.239.6,<->,106.188.184.74,2,1518,0,0,2,1518,1.013936000,0.6151
133.178.226.71,<->,29.213.219.85,2,2426,0,0,2,2426,1.013542000,0.5621
197.113.99.176,<->,136.25.188.44,0,0,2,1113,2,1113,1.013356000,0.0410
207.173.127.99,<->,136.25.188.160,0,0,2,188,2,188,1.013177000,0.0099
215.158.239.76,<->,207.213.91.147,2,188,0,0,2,188,1.012240000,0.0099
204.60.25.85,<->,136.25.188.227,0,0,2,1301,2,1301,1.011686000,0.8912
136.25.189.33,<->,113.92.151.72,2,2777,0,0,2,2777,1.010890000,0.6623
132.18.67.28,<->,6.228.48.108,0,0,2,676,2,676,1.010508000,0.2368
194.232.162.50,<->,136.25.188.178,0,0,2,188,2,188,1.010248000,0.0022
199.111.50.105,<->,8.182.243.89,0,0,2,1059,2,1059,1.010182000,0.4938
196.240.255.160,<->,136.25.188.45,0,0,2,188,2,188,1.009457000,0.0025
195.4.79.229,<->,136.25.188.253,0,0,2,1204,2,1204,1.009258000,0.8076
215.158.239.249,<->,8.191.15.144,2,900,0,0,2,900,1.008913000,0.8653
56.8.55.61,<->,8.182.224.87,0,0,2,174,2,174,1.008687000,0.0002
97.126.8.42,<->,53.231.146.167,2,1771,0,0,2,1771,1.008483000,0.0001
101.195.32.10,<->,8.220.190.86,0,0,2,656,2,656,1.007710000,0.0314
202.33.35.129,<->,136.25.188.52,0,0,2,188,2,188,1.007374000,0.0010
133.178.227.70,<->,128.194.247.63,2,2094,0,0,2,2094,1.007254000,0.7881
215.158.61.145,<->,8.176.8.199,0,0,2,1766,2,1766,1.007181000,0.8975
220.39.233.120,<->,215.158.238.66,0,0,2,2202,2,2202,1.006573000,0.4684
133.178.227.57,<->,131.22.233.138,2,2207,0,0,2,2207,1.006022000,0.6045
143.134.13.218,<->,136.25.188.255,0,0,2,408,2,408,1.005175000,0.2301
142.240.181.149,<->,136.25.188.226,0,0,2,188,2,188,1.004486000,0.0017
199.68.67.230,<->,136.25.188.222,0,0,2,323,2,323,1.004396000,0.2133
204.187.125.191,<->,136.25.188.174,0,0,2,774,2,774,1.003894000,0.7999
202.33.243.69,<->,136.25.188.252,0,0,2,188,2,188,1.003195000,0.0198
215.158.239.77,<->,119.196.23.42,2,2746,0,0,2,2746,1.003073000,0.1755
136.25.188.237,<->,80.47.111.87,2,2522,0,0,2,2522,1.002648000,0.4472
215.158.238.133,<->,158.192.3.223,2,2554,0,0,2,2554,1.001901000,0.9699
142.182.132.200,<->,136.25.188.239,0,0,2,945,2,945,1.001739000,0.0018
215.158.239.95,<->,142.207.210.79,2,868,0,0,2,868,1.000091000,0.1900
215.158.239.7,<->,29.211.5.198,2,1548,0,0,2,1548,1.000005000,0.5380
215.158.238.68,<->,106.188.183.76,2,2579,0,0,2,2579,0.999813000,0.3184
215.158.238.113,<->,80.47.111.107,2,2474,0,0,2,2474,0.999642000,0.6813
215.158.239.60,<->,98.219.126.175,2,335,0,0,2,335,0.999088000,0.9448
139.254.215.30,<->,129.243.217.199,2,2394,0,0,2,2394,0.999087000,0.4701
136.25.189.33,<->,96.156.169.203,2,2881,0,0,2,2881,0.997880000,1.0003
92.162.252.161,<->,33.228.228.108,2,514,0,0,2,514,0.997311000,0.0000
215.158.239.48,<->,199.20.28.7,2,188,0,0,2,188,0.996747000,0.0000
199.73.47.28,<->,136.25.188.176,0,0,2,188,2,188,0.996160000,0.0025
215.158.140.241,<->,106.188.228.23,2,2145,0,0,2,2145,0.996100000,0.3545
204.185.53.33,<->,136.25.188.198,0,0,2,188,2,188,0.995842000,0.0001
215.158.238.96,<->,111.150.34.229,2,2618,0,0,2,2618,0.995255000,0.2125
199.82.216.129,<->,136.25.188.253,0,0,2,188,2,188,0.995143000,0.0022
136.25.188.34,<->,80.57.208.13,2,547,0,0,2,547,0.994861000,0.6425
215.158.238.221,<->,158.85.50.84,2,2250,0,0,2,2250,0.994833000,0.9811
50.224.80.64,<->,8.239.128.102,2,812,0,0,2,812,0.994729000,0.2450
215.158.238.106,<->,192.204.151.111,2,2602,0,0,2,2602,0.994458000,0.8808
215.158.239.50,<->,199.20.6.38,2,188,0,0,2,188,0.994118000,0.0000
215.158.239.33,<->,113.93.9.19,2,464,0,0,2,464,0.993860000,0.2249
220.20.200.80,<->,144.83.60.153,2,352,0,0,2,352,0.993640000,0.0295
215.158.238.100,<->,145.116.209.83,2,1012,0,0,2,1012,0.992262000,0.1116
215.158.239.111,<->,96.234.103.82,2,2068,0,0,2,2068,0.992207000,0.8441
202.33.35.129,<->,136.25.188.174,0,0,2,188,2,188,0.992180000,0.0010
215.158.238.190,<->,8.220.54.215,2,2133,0,0,2,2133,0.991638000,0.5829
195.13.248.147,<->,136.25.188.227,0,0,2,656,2,656,0.991075000,0.1914
159.137.162.213,<->,113.225.205.88,2,676,0,0,2,676,0.990718000,0.2498
136.25.188.32,<->,54.38.188.137,2,1871,0,0,2,1871,0.990714000,0.0001
133.178.226.30,<->,122.158.49.233,2,2618,0,0,2,2618,0.989156000,0.6069
136.25.188.55,<->,69.150.168.195,2,2426,0,0,2,2426,0.988850000,0.5990
134.224.209.54,<->,92.27.194.117,0,0,2,800,2,800,0.987575000,0.6212
215.158.239.86,<->,106.188.253.167,2,1668,0,0,2,1668,0.987366000,0.4445
215.158.239.56,<->,204.226.21.168,2,550,0,0,2,550,0.986048000,0.4785
137.39.55.81,<->,100.228.42.205,0,0,2,780,2,780,0.985450000,0.0006
215.158.61.242,<->,8.176.8.109,0,0,2,1841,2,1841,0.984708000,0.5107
204.187.204.48,<->,136.25.188.162,0,0,2,1008,2,1008,0.983563000,0.7385
215.158.238.243,<->,97.243.113.41,2,2221,0,0,2,2221,0.983377000,0.4618
215.158.238.81,<->,122.159.245.165,2,454,0,0,2,454,0.982915000,0.6482
142.167.93.109,<->,136.25.188.196,0,0,2,389,2,389,0.981721000,0.6419
192.224.21.43,<->,136.25.189.34,0,0,2,2490,2,2490,0.980582000,0.5481
133.172.83.44,<->,8.220.176.253,0,0,2,375,2,375,0.979865000,0.0000
136.25.188.163,<->,126.219.194.99,2,2791,0,0,2,2791,0.979860000,0.7804
195.126.184.184,<->,136.25.188.197,0,0,2,188,2,188,0.979575000,0.0023
215.158.140.76,<->,68.231.10.151,2,2084,0,0,2,2084,0.978413000,0.5191
133.178.226.77,<->,118.20.114.81,2,2570,0,0,2,2570,0.976375000,0.8815
76.179.170.213,<->,8.252.221.223,0,0,2,654,2,654,0.975870000,0.9984
215.158.239.93,<->,204.226.46.90,2,188,0,0,2,188,0.975806000,0.0008
215.158.238.0,<->,89.85.90.132,2,2163,0,0,2,2163,0.973738000,0.0000
215.158.239.69,<->,142.228.81.169,2,1322,0,0,2,1322,0.973323000,0.4645
204.200.50.182,<->,136.25.188.243,0,0,2,680,2,680,0.971856000,0.3905
145.161.90.199,<->,8.252.222.149,0,0,2,188,2,188,0.970787000,0.0000
133.178.227.16,<->,133.56.180.32,2,1522,0,0,2,1522,0.968270000,0.4739
215.158.238.132,<->,106.188.183.104,2,1564,0,0,2,1564,0.967684000,0.6915
199.82.220.187,<->,136.25.188.242,0,0,2,188,2,188,0.967137000,0.0019
204.61.36.1,<->,136.25.188.220,0,0,2,188,2,188,0.966647000,0.0025
215.158.238.104,<->,69.132.194.169,2,2410,0,0,2,2410,0.966473000,0.2560
69.128.138.24,<->,53.213.63.93,2,724,0,0,2,724,0.966247000,0.7359
215.158.239.86,<->,195.40.124.55,2,188,0,0,2,188,0.966074000,0.0022
133.178.226.38,<->,8.220.51.232,2,2506,0,0,2,2506,0.965971000,0.2943
43.52.205.20,<->,8.252.221.204,0,0,2,904,2,904,0.964545000,1.0309
215.158.238.73,<->,122.158.51.55,2,2682,0,0,2,2682,0.964536000,0.3298
137.44.172.3,<->,100.228.42.93,0,0,2,434,2,434,0.964023000,0.0243
221.102.143.189,<->,218.4.169.120,0,0,2,282,2,282,0.962854000,0.0046
142.190.236.212,<->,136.25.188.227,0,0,2,774,2,774,0.962497000,0.2760
220.38.84.230,<->,136.25.189.14,0,0,2,2570,2,2570,0.961798000,0.3179
215.158.238.83,<->,131.144.113.214,2,2458,0,0,2,2458,0.961572000,0.5186
149.96.171.17,<->,136.25.189.77,0,0,2,2602,2,2602,0.961296000,1.0283
215.158.239.58,<->,199.20.31.247,2,1028,0,0,2,1028,0.961110000,0.9898
136.25.189.57,<->,118.20.100.90,2,1570,0,0,2,1570,0.960740000,1.0118
133.178.226.18,<->,8.255.92.215,2,2538,0,0,2,2538,0.960613000,0.3114
215.158.239.77,<->,116.106.46.55,2,2483,0,0,2,2483,0.960511000,0.4072
133.178.226.18,<->,65.27.220.208,2,2346,0,0,2,2346,0.960216000,0.3707
57.17.145.133,<->,50.224.76.234,0,0,2,1205,2,1205,0.960171000,0.3148
215.158.238.64,<->,122.158.49.151,2,570,0,0,2,570,0.959999000,0.7965
133.178.226.7,<->,111.150.186.222,2,2490,0,0,2,2490,0.959414000,0.2372
195.125.15.45,<->,136.25.188.198,0,0,2,605,2,605,0.958376000,0.0007
133.178.227.135,<->,80.47.104.142,2,2182,0,0,2,2182,0.958139000,0.2895
202.33.56.85,<->,136.25.188.226,0,0,2,774,2,774,0.956529000,0.2799
142.203.238.99,<->,102.51.115.242,0,0,2,396,2,396,0.956392000,0.9738
204.130.125.5,<->,8.252.222.223,0,0,2,279,2,279,0.956154000,0.0251
207.190.47.234,<->,136.25.188.225,0,0,2,188,2,188,0.956090000,0.0198
133.178.227.2,<->,48.129.132.244,2,2346,0,0,2,2346,0.954764000,1.0301
215.158.239.94,<->,207.236.116.111,2,979,0,0,2,979,0.953885000,0.0023
215.158.239.79,<->,195.126.110.249,2,440,0,0,2,440,0.953777000,0.2910
139.249.88.87,<->,53.214.108.121,2,260,0,0,2,260,0.953770000,0.1599
239.66.218.254,<->,139.163.41.64,0,0,2,484,2,484,0.953603000,0.9375
231.143.10.120,<->,136.25.188.253,0,0,2,188,2,188,0.953071000,0.0000
215.158.239.121,<->,215.158.61.203,2,1527,0,0,2,1527,0.951278000,0.5219
136.25.189.28,<->,114.25.48.60,2,2442,0,0,2,2442,0.951204000,0.6115
136.25.188.44,<->,69.31.238.52,2,2698,0,0,2,2698,0.951179000,0.5987
195.55.150.21,<->,136.25.188.176,0,0,2,188,2,188,0.951000000,0.0024
215.158.239.30,<->,126.219.102.190,2,316,0,0,2,316,0.950739000,0.4174
215.158.239.85,<->,207.60.48.199,2,656,0,0,2,656,0.950141000,0.2711
133.32.39.42,<->,50.53.153.255,2,100,0,0,2,100,0.950082000,0.2502
116.169.20.76,<->,100.228.42.160,0,0,2,323,2,323,0.950005000,0.0001
207.191.203.53,<->,136.25.188.46,0,0,2,188,2,188,0.949510000,0.0037
148.244.145.59,<->,91.231.194.125,0,0,2,284,2,284,0.949442000,0.6549
136.25.188.226,<->,113.23.104.221,2,2506,0,0,2,2506,0.949285000,0.8591
199.73.206.67,<->,136.25.188.254,0,0,2,188,2,188,0.949082000,0.0017
215.158.140.228,<->,17.254.181.11,2,639,0,0,2,639,0.949032000,0.0272
215.158.238.154,<->,145.234.121.19,2,888,0,0,2,888,0.948770000,0.0008
204.187.51.129,<->,136.25.188.226,0,0,2,1054,2,1054,0.948643000,0.0602
204.186.243.62,<->,136.25.188.196,0,0,2,480,2,480,0.948587000,0.8005
195.4.91.153,<->,136.25.188.222,0,0,2,188,2,188,0.947582000,0.0157
195.7.218.163,<->,136.25.188.196,0,0,2,418,2,418,0.947476000,0.4705
148.21.212.180,<->,136.25.189.80,0,0,2,2634,2,2634,0.946845000,0.4922
215.158.140.229,<->,8.219.185.59,2,2746,0,0,2,2746,0.946471000,0.6079
215.158.239.48,<->,199.20.115.112,2,955,0,0,2,955,0.946278000,0.0000
215.158.239.58,<->,199.15.1.33,2,774,0,0,2,774,0.945996000,1.0375
215.158.239.70,<->,199.20.29.209,2,961,0,0,2,961,0.945317000,0.0097
215.158.238.241,<->,61.35.124.183,2,2257,0,0,2,2257,0.944288000,0.7695
215.158.239.79,<->,199.20.28.59,2,907,0,0,2,907,0.943740000,0.9006
137.47.48.124,<->,97.126.123.108,0,0,2,567,2,567,0.943712000,0.0015
194.253.94.223,<->,8.252.222.199,0,0,2,202,2,202,0.943183000,0.0013
105.86.192.220,<->,0.195.210.44,0,0,2,223,2,223,0.940297000,0.0022
215.158.239.6,<->,122.29.158.180,2,1648,0,0,2,1648,0.939741000,0.6874
215.158.239.28,<->,120.155.14.151,2,2913,0,0,2,2913,0.939460000,0.3596
156.165.37.92,<->,136.25.189.34,0,0,2,1554,2,1554,0.939173000,0.3034
204.200.39.80,<->,136.25.188.220,0,0,2,947,2,947,0.939148000,0.0000
215.158.35.200,<->,133.178.227.253,0,0,2,1800,2,1800,0.938968000,0.2314
246.253.253.106,<->,210.231.140.55,2,1834,0,0,2,1834,0.937369000,0.0737
142.244.203.132,<->,136.25.188.255,0,0,2,406,2,406,0.937137000,0.9747
215.158.238.50,<->,129.222.36.167,2,1694,0,0,2,1694,0.936941000,0.1808
215.158.239.239,<->,210.231.140.46,2,628,0,0,2,628,0.936344000,0.0001
60.101.122.126,<->,8.252.222.49,0,0,2,849,2,849,0.936135000,0.1717
148.146.91.26,<->,136.25.188.255,0,0,2,2538,2,2538,0.936034000,0.5840
145.116.223.93,<->,133.178.226.186,0,0,2,1146,2,1146,0.935760000,0.9273
215.158.239.58,<->,199.20.29.41,2,283,0,0,2,283,0.935632000,0.5996
94.195.120.159,<->,8.252.222.199,0,0,2,903,2,903,0.935213000,0.8553
136.139.59.117,<->,136.25.189.88,0,0,2,2730,2,2730,0.934514000,0.9579
136.25.189.45,<->,8.222.98.123,2,2810,0,0,2,2810,0.934018000,0.5193
215.158.238.65,<->,192.227.190.231,2,442,0,0,2,442,0.933281000,0.3116
204.1.252.23,<->,136.25.188.55,0,0,2,188,2,188,0.933213000,0.0023
140.20.120.150,<->,0.195.210.42,0,0,2,745,2,745,0.932450000,0.1725
43.52.153.114,<->,8.252.221.239,0,0,2,651,2,651,0.932270000,0.4681
133.178.226.7,<->,113.23.104.220,2,454,0,0,2,454,0.931551000,0.7057
54.37.192.99,<->,48.53.252.223,0,0,2,222,2,222,0.931377000,0.1681
197.189.26.143,<->,92.27.219.235,0,0,2,122,2,122,0.930748000,0.3822
215.158.239.95,<->,194.251.130.243,2,660,0,0,2,660,0.930434000,0.1795
89.254.119.99,<->,8.252.221.171,0,0,2,1293,2,1293,0.930220000,0.1549
215.158.239.229,<->,145.180.135.157,2,978,0,0,2,978,0.930130000,0.5703
97.126.119.92,<->,53.182.77.210,2,1094,0,0,2,1094,0.929513000,1.0486
215.158.239.93,<->,207.191.5.77,2,1075,0,0,2,1075,0.929443000,0.0999
215.158.140.241,<->,126.219.100.200,2,2288,0,0,2,2288,0.928995000,0.3151
136.25.188.242,<->,8.253.128.63,2,2586,0,0,2,2586,0.928993000,0.9213
215.158.239.92,<->,207.213.95.31,2,774,0,0,2,774,0.928941000,0.2645
215.158.238.216,<->,100.216.78.145,2,1662,0,0,2,1662,0.928778000,0.2308
143.13.124.187,<->,136.25.188.199,0,0,2,292,2,292,0.928300000,0.8894
231.140.71.101,<->,136.25.188.45,0,0,2,186,2,186,0.928144000,0.0135
107.111.108.197,<->,8.220.205.146,0,0,2,2714,2,2714,0.928098000,0.1745
215.158.239.69,<->,195.55.147.233,2,774,0,0,2,774,0.927666000,0.1559
107.27.244.59,<->,50.224.89.241,0,0,2,1181,2,1181,0.926698000,0.0056
143.201.216.203,<->,50.224.76.230,0,0,2,464,2,464,0.926484000,0.1844
142.240.226.24,<->,136.25.188.163,0,0,2,164,2,164,0.926302000,0.0022
142.207.19.147,<->,136.25.188.252,0,0,2,188,2,188,0.926266000,0.0021
54.36.63.44,<->,48.54.38.89,0,0,2,1105,2,1105,0.925195000,0.0000
215.158.239.78,<->,199.20.28.23,2,1702,0,0,2,1702,0.924591000,0.5698
159.137.162.213,<->,50.72.52.215,2,676,0,0,2,676,0.923788000,0.2559
215.158.239.93,<->,199.20.29.75,2,188,0,0,2,188,0.922496000,0.0101
215.158.239.49,<->,156.165.37.65,2,2586,0,0,2,2586,0.922224000,0.4130
133.178.227.2,<->,72.23.148.212,2,2810,0,0,2,2810,0.921687000,0.8242
109.222.246.249,<->,14.71.93.243,2,420,0,0,2,420,0.921551000,0.0952
94.194.105.141,<->,8.252.221.230,0,0,2,908,2,908,0.920954000,1.0329
215.158.239.113,<->,129.222.39.155,2,1601,0,0,2,1601,0.920864000,0.5715
215.158.238.241,<->,18.202.90.165,2,2240,0,0,2,2240,0.920754000,0.8523
48.17.51.75,<->,8.252.221.204,0,0,2,908,2,908,0.920622000,1.0467
136.25.189.14,<->,29.214.108.211,2,2714,0,0,2,2714,0.920501000,0.2652
215.158.239.97,<->,199.20.31.155,2,774,0,0,2,774,0.920434000,1.0171
133.178.227.39,<->,133.56.180.13,2,1082,0,0,2,1082,0.920299000,0.0850
197.113.99.143,<->,136.25.188.227,0,0,2,1226,2,1226,0.920098000,0.5466
231.142.234.72,<->,136.25.188.177,0,0,2,188,2,188,0.919729000,0.0020
143.129.188.152,<->,136.25.188.177,0,0,2,188,2,188,0.919619000,0.0027
133.178.226.19,<->,126.219.246.73,2,2586,0,0,2,2586,0.919233000,0.1847
109.222.222.94,<->,53.239.138.128,2,250,0,0,2,250,0.918512000,0.3850
159.137.162.213,<->,125.194.251.186,2,676,0,0,2,676,0.918102000,0.3196
199.121.6.22,<->,136.25.188.253,0,0,2,188,2,188,0.916831000,0.0022
136.25.189.32,<->,96.156.169.157,2,1506,0,0,2,1506,0.916240000,0.3932
215.158.140.229,<->,29.214.211.22,2,2140,0,0,2,2140,0.916096000,0.8939
215.158.238.141,<->,112.220.206.22,2,1360,0,0,2,1360,0.916010000,0.0001
136.25.189.12,<->,120.154.131.7,2,2791,0,0,2,2791,0.915040000,0.3238
215.158.239.69,<->,199.106.231.197,2,188,0,0,2,188,0.914656000,0.0000
129.5.109.106,<->,33.233.141.14,0,0,2,124,2,124,0.914591000,1.0016
215.158.239.78,<->,199.20.28.166,2,1024,0,0,2,1024,0.913789000,0.9599
215.158.239.5,<->,8.241.236.247,2,1564,0,0,2,1564,0.913315000,0.9152
98.67.155.63,<->,8.234.107.157,2,250,0,0,2,250,0.912135000,0.6541
199.12.122.204,<->,8.252.222.162,0,0,2,188,2,188,0.911809000,0.0000
207.39.214.65,<->,0.195.210.42,0,0,2,202,2,202,0.911716000,1.0201
216.144.221.96,<->,133.178.227.114,0,0,2,355,2,355,0.910396000,0.0164
204.184.88.31,<->,136.25.188.220,0,0,2,188,2,188,0.910166000,0.0096
136.25.189.83,<->,6.15.207.118,2,2538,0,0,2,2538,0.910074000,0.6746
215.158.239.57,<->,106.188.253.173,2,1466,0,0,2,1466,0.909176000,0.4446
215.158.238.106,<->,113.23.104.220,2,186,0,0,2,186,0.908730000,0.0075
207.101.155.58,<->,8.182.226.78,0,0,2,381,2,381,0.908483000,0.3290
136.25.188.47,<->,80.47.111.87,2,2458,0,0,2,2458,0.907928000,0.7872
60.101.83.31,<->,8.252.221.223,0,0,2,624,2,624,0.907855000,0.8925
215.158.239.49,<->,29.214.73.151,2,2570,0,0,2,2570,0.907841000,0.6128
215.158.238.123,<->,205.228.230.88,2,2682,0,0,2,2682,0.907760000,1.0465
207.57.93.217,<->,136.25.188.53,0,0,2,774,2,774,0.907711000,0.2152
143.89.244.135,<->,136.25.188.209,0,0,2,188,2,188,0.907453000,0.0035
215.158.239.112,<->,111.151.237.68,2,559,0,0,2,559,0.906737000,0.0001
215.158.238.75,<->,126.219.194.148,2,2650,0,0,2,2650,0.906098000,0.4799
204.200.58.95,<->,136.25.188.53,0,0,2,188,2,188,0.905881000,0.0000
207.236.26.254,<->,136.25.188.225,0,0,2,680,2,680,0.905155000,0.1803
111.199.230.116,<->,0.195.210.44,0,0,2,223,2,223,0.905068000,0.0081
142.236.26.46,<->,136.25.188.197,0,0,2,188,2,188,0.904845000,0.0074
136.25.188.162,<->,8.252.210.250,2,2586,0,0,2,2586,0.904408000,0.1211
195.14.131.241,<->,136.25.188.176,0,0,2,188,2,188,0.904274000,0.0039
136.25.188.45,<->,116.106.60.158,2,2426,0,0,2,2426,0.904190000,0.4564
194.253.81.124,<->,8.252.222.243,0,0,2,178,2,178,0.903279000,0.8430
92.27.219.233,<->,29.139.111.221,2,420,0,0,2,420,0.903233000,0.8713
136.25.188.179,<->,8.222.7.58,2,2618,0,0,2,2618,0.902925000,0.0474
215.158.239.81,<->,98.219.126.140,2,1292,0,0,2,1292,0.902615000,0.9833
195.70.121.111,<->,136.25.188.46,0,0,2,656,2,656,0.901953000,0.1633
215.158.239.57,<->,199.20.29.60,2,188,0,0,2,188,0.900431000,0.0099
231.143.10.120,<->,136.25.188.241,0,0,2,188,2,188,0.900413000,0.0399
231.140.129.63,<->,136.25.188.175,0,0,2,188,2,188,0.899596000,0.0015
215.158.239.94,<->,29.214.108.164,2,2570,0,0,2,2570,0.899572000,0.9650
215.158.239.79,<->,142.221.177.85,2,188,0,0,2,188,0.899543000,0.0000
215.158.239.50,<->,199.39.194.53,2,498,0,0,2,498,0.899363000,0.3016
69.103.120.52,<->,8.252.221.236,0,0,2,904,2,904,0.898685000,1.0177
142.208.98.90,<->,136.25.188.198,0,0,2,462,2,462,0.898230000,0.9163
215.158.239.84,<->,142.241.4.24,2,164,0,0,2,164,0.897671000,0.0042
215.158.238.81,<->,126.219.196.185,2,2346,0,0,2,2346,0.897665000,1.0206
74.143.144.234,<->,8.252.221.222,0,0,2,672,2,672,0.897523000,0.6757
215.158.239.57,<->,195.80.82.72,2,564,0,0,2,564,0.897318000,0.0004
212.164.132.228,<->,149.239.15.210,2,562,0,0,2,562,0.896884000,0.0020
106.168.191.163,<->,100.93.173.132,0,0,2,165,2,165,0.896282000,0.3194
195.13.88.26,<->,136.25.188.198,0,0,2,530,2,530,0.895342000,0.0022
196.245.48.251,<->,136.25.188.225,0,0,2,430,2,430,0.894889000,1.0799
144.85.170.248,<->,17.22.230.173,2,1240,0,0,2,1240,0.894703000,1.0499
215.158.238.221,<->,131.1.195.59,2,2277,0,0,2,2277,0.893880000,0.5232
207.58.64.35,<->,136.25.188.253,0,0,2,793,2,793,0.893601000,0.0024
133.178.227.247,<->,6.116.13.166,2,1078,0,0,2,1078,0.893592000,0.0000
215.158.239.85,<->,194.199.215.226,2,188,0,0,2,188,0.892831000,0.0005
136.25.189.29,<->,29.211.228.247,2,1666,0,0,2,1666,0.892326000,0.9241
91.248.126.109,<->,8.52.134.9,0,0,2,984,2,984,0.892223000,0.3709
202.33.40.76,<->,136.25.188.220,0,0,2,774,2,774,0.892184000,0.2120
215.158.239.50,<->,57.236.82.214,2,2426,0,0,2,2426,0.891459000,0.2916
215.158.239.86,<->,141.42.200.186,2,2586,0,0,2,2586,0.891139000,0.7335
215.158.239.50,<->,199.14.85.95,2,440,0,0,2,440,0.891120000,0.1646
129.224.112.252,<->,97.242.126.179,2,222,0,0,2,222,0.890597000,0.9566
215.158.238.177,<->,130.165.253.8,2,2331,0,0,2,2331,0.890387000,0.0682
210.220.219.153,<->,53.224.63.119,2,202,0,0,2,202,0.889953000,0.8085
215.158.239.102,<->,215.158.61.189,2,1753,0,0,2,1753,0.889767000,0.7661
215.158.239.70,<->,143.173.13.198,2,2586,0,0,2,2586,0.889670000,0.7876
159.137.162.213,<->,117.26.161.140,2,676,0,0,2,676,0.889615000,0.2686
195.14.248.228,<->,136.25.188.44,0,0,2,188,2,188,0.889219000,0.0026
200.174.210.241,<->,53.213.148.81,2,250,0,0,2,250,0.888975000,1.0560
215.158.238.47,<->,120.154.221.245,2,2538,0,0,2,2538,0.888244000,1.0779
195.71.87.219,<->,136.25.188.241,0,0,2,1498,2,1498,0.887839000,0.4901
215.158.238.251,<->,8.53.217.178,2,2165,0,0,2,2165,0.887509000,0.6822
215.158.239.87,<->,207.57.43.17,2,1058,0,0,2,1058,0.886982000,0.0002
215.158.239.50,<->,207.59.29.37,2,188,0,0,2,188,0.886846000,0.0034
136.25.188.254,<->,48.131.156.32,2,2650,0,0,2,2650,0.886145000,0.8598
195.14.151.159,<->,136.25.188.222,0,0,2,472,2,472,0.885503000,0.3942
215.158.140.231,<->,126.219.101.173,2,2230,0,0,2,2230,0.885451000,0.3514
143.72.73.116,<->,136.25.188.52,0,0,2,188,2,188,0.884020000,0.0042
159.42.43.78,<->,35.56.101.235,0,0,2,526,2,526,0.883725000,0.6532
215.158.61.189,<->,136.25.188.35,0,0,2,1562,2,1562,0.883657000,0.8637
133.178.227.4,<->,98.219.126.175,2,793,0,0,2,793,0.883499000,0.2073
94.185.224.29,<->,8.252.222.174,0,0,2,282,2,282,0.882325000,0.5224
197.81.94.173,<->,136.25.188.226,0,0,2,188,2,188,0.882012000,0.0010
215.158.239.7,<->,29.211.5.208,2,2898,0,0,2,2898,0.881832000,0.4236
215.158.238.135,<->,8.252.214.133,2,2234,0,0,2,2234,0.881040000,0.5053
207.239.204.235,<->,136.25.188.46,0,0,2,389,2,389,0.881008000,0.0019
215.158.238.134,<->,131.1.232.161,2,2714,0,0,2,2714,0.880424000,0.6946
195.14.253.74,<->,136.25.188.197,0,0,2,774,2,774,0.880266000,0.1970
133.178.227.40,<->,131.144.116.233,2,2185,0,0,2,2185,0.879641000,0.4620
215.158.140.75,<->,106.188.244.165,2,2158,0,0,2,2158,0.879524000,0.4711
215.158.239.84,<->,207.59.17.227,2,202,0,0,2,202,0.879444000,0.8510
100.228.42.61,<->,57.49.185.65,2,802,0,0,2,802,0.878732000,0.2196
195.70.121.111,<->,136.25.188.236,0,0,2,656,2,656,0.878462000,0.1444
136.109.109.253,<->,100.228.42.41,0,0,2,842,2,842,0.877653000,0.0002
139.161.104.168,<->,136.25.188.48,0,0,2,3001,2,3001,0.877435000,0.0001
215.158.239.59,<->,112.68.105.216,2,2634,0,0,2,2634,0.877381000,0.4748
142.227.59.72,<->,136.25.188.54,0,0,2,425,2,425,0.877008000,0.0039
215.158.238.107,<->,122.216.233.213,2,2490,0,0,2,2490,0.876581000,0.7610
75.214.216.204,<->,8.252.221.197,0,0,2,1845,2,1845,0.876483000,0.1618
133.178.226.30,<->,128.23.84.245,2,2458,0,0,2,2458,0.876284000,1.0469
215.158.238.82,<->,57.210.107.16,2,2186,0,0,2,2186,0.875869000,0.4629
215.158.238.81,<->,113.92.151.118,2,2263,0,0,2,2263,0.875262000,1.0154
143.134.36.86,<->,136.25.188.237,0,0,2,188,2,188,0.874962000,0.0002
215.158.239.56,<->,196.240.171.72,2,940,0,0,2,940,0.874813000,0.0184
195.4.114.173,<->,136.25.188.253,0,0,2,188,2,188,0.874537000,0.0025
215.158.140.92,<->,68.231.10.151,2,2269,0,0,2,2269,0.874328000,1.0682
144.78.84.179,<->,144.70.14.37,0,0,2,507,2,507,0.873356000,0.0000
193.39.70.11,<->,133.178.226.28,0,0,2,2378,2,2378,0.872933000,0.4893
114.182.24.196,<->,50.224.89.241,0,0,2,1312,2,1312,0.870991000,0.4459
215.158.239.77,<->,196.92.3.148,2,1594,0,0,2,1594,0.870985000,0.1596
215.201.190.253,<->,8.183.25.124,0,0,2,392,2,392,0.870602000,0.3306
215.158.239.76,<->,207.239.224.78,2,902,0,0,2,902,0.870561000,0.2077
140.8.232.203,<->,0.195.210.42,0,0,2,188,2,188,0.870524000,0.0001
215.158.239.92,<->,199.20.5.231,2,756,0,0,2,756,0.870280000,0.4606
58.202.119.87,<->,8.252.221.198,0,0,2,1318,2,1318,0.870176000,0.7402
136.25.188.44,<->,76.100.108.197,2,2714,0,0,2,2714,0.870149000,0.4435
136.25.189.45,<->,56.28.207.201,2,1682,0,0,2,1682,0.869710000,1.1198
215.158.239.56,<->,199.20.28.255,2,188,0,0,2,188,0.869627000,0.0000
143.76.172.61,<->,8.182.224.248,0,0,2,547,2,547,0.869383000,0.1564
195.43.4.73,<->,136.25.188.226,0,0,2,188,2,188,0.869265000,0.0028
215.158.238.6,<->,192.224.20.83,2,514,0,0,2,514,0.868505000,0.4559
197.113.64.252,<->,136.25.188.241,0,0,2,964,2,964,0.868419000,0.0200
215.158.239.86,<->,199.20.28.255,2,188,0,0,2,188,0.868282000,0.0000
248.225.29.121,<->,53.224.230.131,2,244,0,0,2,244,0.866811000,0.0021
215.158.239.50,<->,199.20.28.255,2,188,0,0,2,188,0.866292000,0.0000
215.158.238.135,<->,149.99.94.68,2,2378,0,0,2,2378,0.866273000,1.0275
97.178.252.77,<->,8.250.158.144,0,0,2,716,2,716,0.865775000,1.1120
136.25.189.11,<->,98.219.126.140,2,333,0,0,2,333,0.864207000,0.4494
220.20.200.113,<->,105.134.162.139,2,2624,0,0,2,2624,0.863824000,0.1901
99.187.125.121,<->,8.20.87.32,0,0,2,2078,2,2078,0.863269000,0.8568
215.158.61.202,<->,136.25.189.243,0,0,2,1353,2,1353,0.863039000,0.3046
195.55.83.63,<->,136.25.188.175,0,0,2,955,2,955,0.862862000,0.1740
215.158.239.97,<->,199.20.28.166,2,188,0,0,2,188,0.862645000,0.0200
207.58.99.223,<->,136.25.188.255,0,0,2,1677,2,1677,0.861639000,0.3485
133.178.227.16,<->,122.158.49.117,2,2714,0,0,2,2714,0.861519000,0.8919
199.72.100.251,<->,136.25.188.241,0,0,2,188,2,188,0.861187000,0.0020
231.142.35.166,<->,136.25.188.255,0,0,2,188,2,188,0.860823000,0.0039
207.62.165.29,<->,136.25.188.175,0,0,2,164,2,164,0.860177000,0.0137
215.158.239.78,<->,194.199.207.228,2,188,0,0,2,188,0.859539000,0.0002
136.25.188.40,<->,80.56.246.231,2,1246,0,0,2,1246,0.859070000,0.8983
231.142.139.22,<->,215.158.239.51,0,0,2,1693,2,1693,0.858832000,0.3179
215.158.238.186,<->,215.158.43.14,2,652,0,0,2,652,0.858218000,0.2393
196.148.124.252,<->,196.119.218.132,2,1335,0,0,2,1335,0.857739000,0.2990
246.253.253.169,<->,54.58.230.81,2,1827,0,0,2,1827,0.856451000,0.1304
215.158.140.60,<->,8.57.163.183,2,2368,0,0,2,2368,0.856262000,1.0388
207.61.68.151,<->,136.25.188.253,0,0,2,1826,2,1826,0.854126000,0.3928
197.161.251.39,<->,136.25.188.242,0,0,2,656,2,656,0.852637000,0.1302
8.52.189.207,<->,6.14.154.251,2,656,0,0,2,656,0.851756000,0.2331
215.158.140.231,<->,130.165.253.19,2,2483,0,0,2,2483,0.851368000,1.0785
142.249.90.133,<->,136.25.188.210,0,0,2,188,2,188,0.850862000,0.0019
121.252.29.18,<->,92.27.209.249,0,0,2,226,2,226,0.850290000,0.2821
215.158.239.94,<->,204.226.50.127,2,1649,0,0,2,1649,0.850060000,0.9897
220.38.84.245,<->,136.25.189.15,0,0,2,2634,2,2634,0.848812000,0.5116
215.158.239.48,<->,207.166.18.232,2,188,0,0,2,188,0.848518000,0.1190
215.158.239.48,<->,199.20.31.118,2,188,0,0,2,188,0.847866000,0.0105
215.158.239.48,<->,207.188.189.158,2,1204,0,0,2,1204,0.846618000,0.9698
215.158.239.84,<->,142.223.153.67,2,680,0,0,2,680,0.846420000,0.4596
231.255.222.136,<->,192.64.236.216,0,0,2,625,2,625,0.846297000,0.0000
215.158.239.92,<->,195.55.1.174,2,234,0,0,2,234,0.845687000,0.5263
215.158.238.74,<->,122.158.49.195,2,2394,0,0,2,2394,0.845213000,0.8257
145.237.135.90,<->,137.21.23.223,0,0,2,1070,2,1070,0.845131000,1.0035
199.38.97.99,<->,136.25.188.178,0,0,2,656,2,656,0.844692000,0.2885
193.14.166.13,<->,100.228.42.68,0,0,2,1002,2,1002,0.844673000,0.0938
136.25.188.208,<->,113.23.104.247,2,1547,0,0,2,1547,0.843485000,1.0119
215.158.140.231,<->,8.240.116.198,2,2226,0,0,2,2226,0.842891000,0.0500
195.41.218.87,<->,136.25.188.226,0,0,2,800,2,800,0.842694000,0.0000
146.249.227.119,<->,8.252.221.221,0,0,2,568,2,568,0.842628000,1.1192
207.188.205.95,<->,136.25.188.174,0,0,2,656,2,656,0.842615000,0.2880
142.206.24.42,<->,136.25.188.178,0,0,2,1530,2,1530,0.842472000,0.5344
17.2.12.81,<->,8.220.176.253,0,0,2,544,2,544,0.842226000,0.0017
204.131.36.178,<->,0.195.210.33,0,0,2,188,2,188,0.841779000,0.0001
215.158.238.107,<->,38.104.11.116,2,2410,0,0,2,2410,0.841595000,0.3329
133.178.226.202,<->,6.73.247.4,2,1425,0,0,2,1425,0.841557000,0.0451
207.173.241.126,<->,136.25.188.199,0,0,2,188,2,188,0.841152000,0.0000
48.129.133.22,<->,8.252.222.241,0,0,2,2602,2,2602,0.840731000,1.0190
133.178.227.76,<->,38.51.98.247,2,2089,0,0,2,2089,0.840329000,0.2144
68.73.42.160,<->,8.252.221.221,0,0,2,1306,2,1306,0.840154000,0.5300
215.158.239.57,<->,199.20.28.189,2,188,0,0,2,188,0.840081000,0.0310
142.253.191.143,<->,136.25.188.252,0,0,2,660,2,660,0.839943000,0.8995
195.124.146.164,<->,136.25.188.236,0,0,2,472,2,472,0.839896000,0.9399
215.158.238.58,<->,72.23.148.245,2,2634,0,0,2,2634,0.839816000,1.1414
199.121.85.206,<->,136.25.188.253,0,0,2,902,2,902,0.839809000,0.0027
133.178.226.18,<->,29.211.6.60,2,2650,0,0,2,2650,0.839337000,1.0000
247.118.176.109,<->,8.182.227.5,0,0,2,384,2,384,0.837974000,0.0620
215.158.239.110,<->,215.158.61.191,2,1662,0,0,2,1662,0.837965000,1.1404
207.58.233.27,<->,136.25.188.209,0,0,2,1684,2,1684,0.837736000,0.2293
197.113.99.18,<->,136.25.188.54,0,0,2,1085,2,1085,0.837434000,0.2303
215.158.6.215,<->,133.178.227.76,0,0,2,2257,2,2257,0.837331000,0.1161
215.158.238.66,<->,113.23.104.223,2,2586,0,0,2,2586,0.836635000,0.4950
215.158.238.133,<->,113.23.21.212,2,2586,0,0,2,2586,0.835333000,1.0974
195.70.145.112,<->,136.25.188.46,0,0,2,543,2,543,0.834959000,0.3058
204.3.7.235,<->,136.25.188.209,0,0,2,188,2,188,0.834840000,0.0022
123.129.29.201,<->,33.233.141.78,0,0,2,124,2,124,0.834535000,0.9997
215.158.239.94,<->,8.222.98.114,2,2586,0,0,2,2586,0.834030000,0.3500
144.71.47.61,<->,130.206.82.106,2,1128,0,0,2,1128,0.831820000,0.8645
215.158.239.87,<->,195.55.45.146,2,656,0,0,2,656,0.831812000,0.2155
215.158.238.236,<->,126.219.101.144,2,2151,0,0,2,2151,0.830505000,0.6696
215.158.239.7,<->,29.214.74.201,2,1573,0,0,2,1573,0.830489000,0.6720
39.189.53.64,<->,8.182.238.140,0,0,2,307,2,307,0.830176000,0.0455
198.206.82.208,<->,111.147.191.15,0,0,2,608,2,608,0.829824000,0.0000
136.25.189.13,<->,8.222.98.72,2,2458,0,0,2,2458,0.829763000,0.6128
192.226.161.99,<->,136.25.188.223,0,0,2,2474,2,2474,0.829636000,0.9955
133.178.226.18,<->,118.20.87.114,2,2602,0,0,2,2602,0.829497000,0.1143
133.178.226.70,<->,106.188.228.1,2,2191,0,0,2,2191,0.828247000,0.4681
192.64.211.88,<->,78.45.179.241,2,536,0,0,2,536,0.828034000,0.8719
215.158.239.49,<->,197.128.83.90,2,440,0,0,2,440,0.828002000,0.4232
111.146.207.124,<->,50.140.149.101,2,304,0,0,2,304,0.827936000,0.1665
133.178.227.2,<->,29.213.219.11,2,2810,0,0,2,2810,0.827803000,0.3358
215.158.140.75,<->,113.23.56.96,2,2223,0,0,2,2223,0.827455000,0.5368
199.32.191.131,<->,136.25.188.209,0,0,2,188,2,188,0.827065000,0.0084
136.25.188.224,<->,99.192.168.187,2,2593,0,0,2,2593,0.826677000,1.1426
231.142.212.15,<->,215.158.239.57,0,0,2,656,2,656,0.825607000,0.2190
89.155.2.203,<->,8.182.226.78,0,0,2,680,2,680,0.825222000,0.4607
215.158.239.92,<->,207.239.224.78,2,1166,0,0,2,1166,0.824291000,0.0049
109.222.222.94,<->,50.236.255.219,2,982,0,0,2,982,0.823833000,0.0809
136.25.188.209,<->,99.83.81.70,2,440,0,0,2,440,0.823475000,0.0415
215.158.238.49,<->,129.222.36.70,2,1577,0,0,2,1577,0.823208000,0.0686
215.158.239.68,<->,30.73.96.89,2,989,0,0,2,989,0.822969000,0.2186
215.158.239.96,<->,207.62.35.45,2,1274,0,0,2,1274,0.822969000,0.4852
17.214.234.252,<->,8.52.189.207,0,0,2,456,2,456,0.822918000,0.0332
195.15.142.186,<->,136.25.188.227,0,0,2,1689,2,1689,0.822706000,1.0351
213.38.254.205,<->,8.55.211.213,2,588,0,0,2,588,0.822703000,0.0165
97.80.226.250,<->,8.182.251.47,0,0,2,381,2,381,0.821341000,0.0627
136.25.189.83,<->,120.154.71.75,2,2602,0,0,2,2602,0.820458000,0.2903
232.31.229.85,<->,139.163.41.64,0,0,2,638,2,638,0.820316000,0.1841
157.127.235.73,<->,8.252.221.236,0,0,2,904,2,904,0.819931000,1.1015
215.158.140.229,<->,149.163.129.250,2,2091,0,0,2,2091,0.819477000,0.7058
136.25.188.243,<->,8.222.212.10,2,2586,0,0,2,2586,0.819270000,0.1041
215.158.239.68,<->,195.80.101.217,2,188,0,0,2,188,0.818475000,0.0000
145.118.59.20,<->,92.27.27.170,0,0,2,994,2,994,0.818420000,0.0492
133.178.227.24,<->,126.219.194.55,2,2237,0,0,2,2237,0.818334000,0.7653
136.18.96.155,<->,8.182.226.78,0,0,2,818,2,818,0.817930000,0.0523
192.171.32.145,<->,133.178.227.79,0,0,2,2132,2,2132,0.817664000,0.5960
204.60.25.85,<->,136.25.188.196,0,0,2,1172,2,1172,0.817574000,0.4296
215.158.239.33,<->,215.158.127.181,2,1552,0,0,2,1552,0.817483000,1.1723
94.110.153.201,<->,8.252.222.204,0,0,2,2282,2,2282,0.817424000,0.7381
193.51.144.28,<->,80.40.11.116,0,0,2,599,2,599,0.817363000,0.4172
215.158.238.223,<->,33.209.219.19,2,2132,0,0,2,2132,0.817001000,0.3528
145.76.225.248,<->,80.27.159.59,0,0,2,914,2,914,0.816962000,0.1477
215.158.239.58,<->,207.114.231.138,2,188,0,0,2,188,0.816727000,0.0098
215.158.238.223,<->,123.166.46.247,2,2185,0,0,2,2185,0.816437000,1.0481
215.158.238.81,<->,128.123.91.106,2,2554,0,0,2,2554,0.816340000,1.0959
215.158.238.189,<->,122.158.245.7,2,2435,0,0,2,2435,0.816245000,0.9539
231.142.100.123,<->,136.25.188.53,0,0,2,955,2,955,0.816147000,0.6611
149.86.40.45,<->,8.220.180.52,0,0,2,656,2,656,0.814596000,0.0880
215.158.239.7,<->,106.188.184.106,2,1844,0,0,2,1844,0.814447000,1.0251
136.181.47.203,<->,0.195.216.193,2,431,0,0,2,431,0.813792000,0.0703
139.163.163.176,<->,133.178.227.40,0,0,2,2301,2,2301,0.813514000,0.1816
204.185.182.150,<->,136.25.188.174,0,0,2,188,2,188,0.812930000,0.0000
136.25.188.162,<->,126.219.132.210,2,2810,0,0,2,2810,0.811911000,0.4256
220.39.233.154,<->,215.158.238.81,0,0,2,2570,2,2570,0.811425000,0.7883
215.158.239.51,<->,29.211.93.23,2,2522,0,0,2,2522,0.810357000,0.6640
133.172.187.23,<->,8.183.25.124,0,0,2,656,2,656,0.809871000,0.0320
145.76.231.17,<->,111.20.168.180,0,0,2,2222,2,2222,0.809811000,0.0468
215.158.239.96,<->,194.199.215.226,2,188,0,0,2,188,0.809532000,0.0000
215.158.238.64,<->,57.210.107.19,2,2378,0,0,2,2378,0.808888000,0.9328
133.178.227.16,<->,61.35.70.37,2,2210,0,0,2,2210,0.808705000,0.7576
207.58.86.149,<->,136.25.188.237,0,0,2,960,2,960,0.808657000,0.0019
215.158.239.56,<->,195.70.174.238,2,944,0,0,2,944,0.808317000,0.0019
195.13.183.230,<->,136.25.188.176,0,0,2,188,2,188,0.808215000,0.0016
215.158.238.148,<->,131.1.195.235,2,2832,0,0,2,2832,0.807911000,0.8493
215.158.238.97,<->,158.192.3.233,2,2794,0,0,2,2794,0.807785000,1.0249
159.137.162.213,<->,122.212.51.57,2,964,0,0,2,964,0.807529000,0.3276
133.178.226.7,<->,131.144.113.188,2,2682,0,0,2,2682,0.807342000,0.8998
220.28.85.14,<->,136.25.188.166,0,0,2,1173,2,1173,0.807093000,0.9127
97.126.28.102,<->,8.235.232.213,2,910,0,0,2,910,0.806946000,0.1549
136.25.188.255,<->,8.252.213.30,2,2538,0,0,2,2538,0.806627000,0.9844
199.51.26.249,<->,136.25.188.198,0,0,2,1700,2,1700,0.806559000,1.0629
221.102.53.122,<->,109.0.210.141,0,0,2,2825,2,2825,0.805850000,1.0882
136.25.189.0,<->,65.27.228.251,2,2586,0,0,2,2586,0.805769000,0.8649
232.31.110.202,<->,97.198.118.56,0,0,2,796,2,796,0.805730000,0.2047
215.158.239.48,<->,199.20.29.21,2,519,0,0,2,519,0.805272000,0.9632
204.56.11.64,<->,136.25.188.209,0,0,2,601,2,601,0.805151000,0.1118
232.31.43.150,<->,97.198.118.56,0,0,2,903,2,903,0.804405000,0.0152
133.178.226.37,<->,91.247.40.9,2,650,0,0,2,650,0.804276000,1.0387
215.158.238.21,<->,122.158.245.26,2,2858,0,0,2,2858,0.803490000,0.3537
133.178.226.224,<->,113.188.193.234,2,1444,0,0,2,1444,0.802883000,0.6291
207.92.35.41,<->,8.182.227.180,0,0,2,483,2,483,0.802725000,0.1874
136.25.189.82,<->,131.144.113.60,2,2458,0,0,2,2458,0.802631000,0.4688
139.160.226.167,<->,136.25.189.31,0,0,2,2682,2,2682,0.802200000,0.7852
142.229.81.165,<->,136.25.188.225,0,0,2,961,2,961,0.801503000,0.0027
215.158.238.95,<->,131.144.114.210,2,2682,0,0,2,2682,0.801278000,0.9982
215.158.239.68,<->,207.191.245.10,2,188,0,0,2,188,0.799647000,0.0010
215.158.239.28,<->,8.191.6.216,2,293,0,0,2,293,0.799307000,0.7308
215.158.239.95,<->,194.199.215.226,2,188,0,0,2,188,0.798517000,0.0000
215.158.238.92,<->,8.190.216.221,2,2874,0,0,2,2874,0.796942000,1.1502
215.158.239.59,<->,204.2.143.155,2,981,0,0,2,981,0.795795000,0.0000
215.158.238.254,<->,215.158.43.18,2,604,0,0,2,604,0.795183000,0.0800
212.164.143.229,<->,110.216.9.53,2,994,0,0,2,994,0.794810000,0.2298
215.158.238.64,<->,197.125.126.250,2,2650,0,0,2,2650,0.794660000,1.1049
136.25.188.149,<->,56.23.170.253,2,707,0,0,2,707,0.793553000,0.5489
215.158.61.145,<->,8.176.8.102,0,0,2,1080,2,1080,0.793526000,0.2632
215.158.239.78,<->,131.144.113.62,2,2602,0,0,2,2602,0.793399000,0.3109
215.158.238.135,<->,112.220.206.117,2,2426,0,0,2,2426,0.792587000,1.0445
142.221.144.87,<->,136.25.188.241,0,0,2,188,2,188,0.791614000,0.0043
207.56.101.49,<->,136.25.188.52,0,0,2,656,2,656,0.791243000,0.2232
136.25.188.197,<->,131.2.115.252,2,2602,0,0,2,2602,0.790917000,0.5602
215.158.238.106,<->,116.106.60.137,2,2794,0,0,2,2794,0.790675000,0.7516
215.158.238.106,<->,104.3.161.26,2,2682,0,0,2,2682,0.790460000,0.8234
215.158.239.33,<->,8.222.7.154,2,2224,0,0,2,2224,0.790304000,0.6030
159.137.162.213,<->,117.49.144.192,2,676,0,0,2,676,0.790236000,0.2391
133.178.226.29,<->,29.214.108.122,2,2554,0,0,2,2554,0.790083000,0.3572
198.190.133.255,<->,50.224.89.243,0,0,2,2170,2,2170,0.788588000,0.3092
207.58.86.149,<->,136.25.188.52,0,0,2,959,2,959,0.787867000,0.0022
204.200.56.185,<->,136.25.188.252,0,0,2,188,2,188,0.785990000,0.0000
207.60.55.106,<->,136.25.188.177,0,0,2,656,2,656,0.785854000,0.2064
136.25.189.28,<->,89.80.251.8,2,2602,0,0,2,2602,0.785122000,0.8856
247.136.135.179,<->,237.7.82.49,2,2657,0,0,2,2657,0.784822000,0.7573
215.158.140.229,<->,33.209.217.45,2,2404,0,0,2,2404,0.784662000,0.8466
199.15.159.48,<->,136.25.188.253,0,0,2,912,2,912,0.784086000,0.4796
215.158.239.57,<->,195.81.120.214,2,188,0,0,2,188,0.782764000,0.0100
194.237.34.104,<->,136.25.188.173,0,0,2,1577,2,1577,0.782250000,0.2341
136.25.188.53,<->,29.214.64.161,2,2474,0,0,2,2474,0.781830000,0.7751
239.66.104.49,<->,97.198.118.56,0,0,2,827,2,827,0.781527000,0.0189
205.127.108.115,<->,33.233.141.69,0,0,2,351,2,351,0.781205000,0.3636
215.158.239.42,<->,96.135.154.168,2,1639,0,0,2,1639,0.781113000,1.1730
215.158.239.48,<->,199.106.84.20,2,774,0,0,2,774,0.780967000,0.3703
133.178.227.14,<->,100.50.96.203,2,2522,0,0,2,2522,0.780029000,0.9238
142.206.45.88,<->,136.25.188.220,0,0,2,656,2,656,0.779864000,0.3684
17.41.75.11,<->,8.220.190.86,0,0,2,1055,2,1055,0.779638000,0.7337
215.158.140.60,<->,8.240.116.184,2,2532,0,0,2,2532,0.779577000,0.1570
215.158.239.79,<->,204.226.110.13,2,656,0,0,2,656,0.778678000,0.5912
215.158.238.99,<->,29.211.186.197,2,2586,0,0,2,2586,0.778572000,0.0041
142.166.50.219,<->,136.25.188.253,0,0,2,962,2,962,0.778422000,0.0013
156.135.162.22,<->,8.252.221.204,0,0,2,912,2,912,0.776636000,1.0121
215.158.239.77,<->,207.213.183.113,2,188,0,0,2,188,0.776608000,0.0001
215.158.239.76,<->,195.40.116.61,2,188,0,0,2,188,0.776585000,0.0042
215.158.239.70,<->,199.20.30.79,2,948,0,0,2,948,0.775562000,0.7192
133.178.226.19,<->,111.150.186.232,2,2634,0,0,2,2634,0.774044000,0.7185
136.25.188.255,<->,57.210.107.1,2,2506,0,0,2,2506,0.773843000,0.5071
124.126.184.193,<->,100.228.42.160,0,0,2,558,2,558,0.773653000,0.0001
195.127.214.45,<->,136.25.188.242,0,0,2,950,2,950,0.773092000,0.0019
215.158.239.93,<->,196.88.133.137,2,390,0,0,2,390,0.773079000,0.0020
215.158.238.135,<->,113.92.151.107,2,2735,0,0,2,2735,0.772670000,0.5756
200.174.215.121,<->,53.203.244.195,2,538,0,0,2,538,0.772567000,1.1648
195.14.101.133,<->,136.25.188.198,0,0,2,661,2,661,0.772539000,0.0552
204.2.225.153,<->,136.25.188.178,0,0,2,543,2,543,0.772417000,0.2488
215.158.238.210,<->,100.50.96.239,2,2458,0,0,2,2458,0.772267000,0.2558
215.158.140.60,<->,131.219.230.194,2,2345,0,0,2,2345,0.772117000,0.6446
215.158.239.76,<->,196.106.7.103,2,188,0,0,2,188,0.772034000,0.0302
202.33.250.52,<->,136.25.188.53,0,0,2,218,2,218,0.771861000,0.8599
215.158.239.113,<->,129.222.39.189,2,1283,0,0,2,1283,0.771169000,0.0252
243.117.36.147,<->,89.183.110.72,0,0,2,872,2,872,0.771150000,0.4108
215.158.239.34,<->,29.211.5.198,2,1272,0,0,2,1272,0.770721000,0.3523
215.158.61.243,<->,8.176.8.210,0,0,2,1069,2,1069,0.769844000,0.4217
140.196.150.244,<->,80.27.153.42,0,0,2,1121,2,1121,0.769494000,0.0429
136.25.188.210,<->,29.214.108.104,2,2586,0,0,2,2586,0.769403000,0.9199
204.2.22.159,<->,136.25.188.255,0,0,2,1648,2,1648,0.768793000,0.5630
97.198.117.226,<->,50.106.134.239,2,1898,0,0,2,1898,0.768192000,0.0681
215.158.239.49,<->,199.20.29.238,2,188,0,0,2,188,0.767694000,0.0096
215.202.174.52,<->,136.25.189.45,0,0,2,2586,2,2586,0.767350000,0.2633
215.158.238.104,<->,8.240.118.218,2,2778,0,0,2,2778,0.767265000,0.7194
195.14.149.126,<->,136.25.188.227,0,0,2,543,2,543,0.766652000,0.2368
215.158.239.1,<->,96.135.154.174,2,673,0,0,2,673,0.765962000,0.0001
215.158.239.56,<->,207.188.31.83,2,188,0,0,2,188,0.765828000,0.0095
17.43.39.87,<->,8.220.184.39,0,0,2,383,2,383,0.765819000,0.0428
139.241.64.230,<->,6.73.247.75,0,0,2,362,2,362,0.764731000,0.0008
143.76.142.162,<->,8.182.241.177,0,0,2,1087,2,1087,0.764682000,0.2614
136.25.189.37,<->,96.156.169.209,2,1122,0,0,2,1122,0.764378000,0.0001
215.158.238.115,<->,131.173.115.66,2,2650,0,0,2,2650,0.764069000,0.4927
194.237.32.134,<->,136.25.188.225,0,0,2,656,2,656,0.763992000,0.3507
215.158.239.30,<->,131.95.192.159,2,2913,0,0,2,2913,0.763779000,0.5022
215.158.238.99,<->,192.227.190.234,2,330,0,0,2,330,0.763145000,0.6397
215.158.238.177,<->,33.209.217.12,2,2490,0,0,2,2490,0.762345000,0.7683
136.25.188.175,<->,29.214.108.170,2,2927,0,0,2,2927,0.761908000,0.4164
215.158.239.92,<->,199.20.31.109,2,1731,0,0,2,1731,0.761701000,0.3997
136.25.188.254,<->,8.255.92.214,2,2538,0,0,2,2538,0.761682000,0.9499
133.178.226.19,<->,104.3.168.217,2,2714,0,0,2,2714,0.760287000,0.7121
215.158.239.76,<->,199.106.112.188,2,188,0,0,2,188,0.760260000,0.0001
215.158.238.92,<->,131.144.116.202,2,2570,0,0,2,2570,0.760190000,0.5018
235.42.34.23,<->,133.178.226.37,0,0,2,2602,2,2602,0.760148000,0.4819
215.158.238.95,<->,158.192.3.233,2,2554,0,0,2,2554,0.759035000,1.0651
215.158.238.188,<->,8.50.170.249,2,2273,0,0,2,2273,0.758700000,0.5481
207.61.73.235,<->,136.25.188.241,0,0,2,430,2,430,0.758606000,0.4554
221.102.143.189,<->,218.4.165.98,0,0,2,1734,2,1734,0.758269000,0.0701
200.174.219.227,<->,53.213.6.51,2,2296,0,0,2,2296,0.757479000,0.0000
215.158.239.117,<->,215.158.61.191,2,1226,0,0,2,1226,0.757178000,1.1000
199.82.89.20,<->,136.25.188.227,0,0,2,164,2,164,0.756569000,0.0037
207.11.121.137,<->,8.252.222.63,0,0,2,606,2,606,0.756367000,0.0601
215.158.238.111,<->,0.195.237.14,2,1249,0,0,2,1249,0.755761000,0.3799
215.158.238.66,<->,120.154.186.218,2,2474,0,0,2,2474,0.755271000,1.0831
215.158.140.92,<->,8.219.184.95,2,2535,0,0,2,2535,0.755021000,1.0196
197.113.99.232,<->,136.25.188.255,0,0,2,963,2,963,0.754207000,0.1099
215.158.239.48,<->,196.106.249.180,2,979,0,0,2,979,0.753698000,0.0095
246.253.253.107,<->,100.108.23.169,2,687,0,0,2,687,0.753682000,0.0467
215.158.238.97,<->,57.247.184.208,2,2410,0,0,2,2410,0.753659000,0.8214
195.124.234.45,<->,136.25.188.174,0,0,2,1098,2,1098,0.753619000,0.0001
215.158.238.95,<->,120.154.221.233,2,2602,0,0,2,2602,0.752033000,0.9530
136.25.188.46,<->,84.241.240.150,2,279,0,0,2,279,0.751821000,0.0004
207.61.62.32,<->,136.25.188.177,0,0,2,188,2,188,0.751473000,0.0025
215.158.140.229,<->,100.50.96.215,2,2207,0,0,2,2207,0.751043000,0.2118
215.158.238.133,<->,119.196.23.54,2,2682,0,0,2,2682,0.750032000,0.9122
207.190.200.196,<->,136.25.188.198,0,0,2,804,2,804,0.749598000,0.1932
215.158.239.95,<->,196.91.79.179,2,430,0,0,2,430,0.748936000,0.7199
220.20.200.96,<->,131.45.239.178,2,678,0,0,2,678,0.748698000,0.8277
199.50.155.29,<->,136.25.188.46,0,0,2,164,2,164,0.747723000,0.0029
215.158.238.33,<->,8.190.216.221,2,2730,0,0,2,2730,0.746822000,1.1305
215.158.238.250,<->,29.214.109.128,2,2183,0,0,2,2183,0.746155000,0.0722
215.158.239.87,<->,199.20.29.189,2,301,0,0,2,301,0.745551000,0.0000
17.5.13.62,<->,8.52.179.237,0,0,2,430,2,430,0.744322000,0.4147
200.10.139.145,<->,8.252.221.221,0,0,2,1092,2,1092,0.744139000,1.0946
215.158.239.84,<->,199.20.29.231,2,188,0,0,2,188,0.743712000,0.0108
207.60.59.191,<->,136.25.188.177,0,0,2,472,2,472,0.743111000,1.1253
143.132.244.132,<->,136.25.188.177,0,0,2,188,2,188,0.743079000,0.0022
204.60.76.43,<->,136.25.188.225,0,0,2,774,2,774,0.742334000,0.5265
204.60.26.225,<->,136.25.188.163,0,0,2,1724,2,1724,0.742219000,0.2878
133.178.227.40,<->,69.150.169.163,2,2159,0,0,2,2159,0.741620000,1.0994
195.13.5.21,<->,136.25.188.162,0,0,2,188,2,188,0.741430000,0.0020
109.1.21.151,<->,8.45.175.31,2,150,0,0,2,150,0.741424000,0.0607
136.25.188.254,<->,122.159.245.165,2,2362,0,0,2,2362,0.741129000,1.2102
136.25.189.80,<->,114.146.74.248,2,2618,0,0,2,2618,0.739510000,0.7961
123.129.29.205,<->,101.224.89.165,0,0,2,124,2,124,0.738962000,1.0000
136.25.189.2,<->,57.236.82.216,2,2538,0,0,2,2538,0.738672000,0.5369
215.158.238.92,<->,33.209.217.245,2,1698,0,0,2,1698,0.738411000,0.8298
215.158.239.95,<->,199.20.29.8,2,188,0,0,2,188,0.737586000,0.0000
133.178.227.16,<->,8.252.253.232,2,2410,0,0,2,2410,0.737501000,0.6331
199.51.154.75,<->,136.25.188.225,0,0,2,188,2,188,0.737266000,0.0020
194.233.78.49,<->,136.25.188.242,0,0,2,1530,2,1530,0.737204000,0.8999
194.237.189.237,<->,136.25.188.252,0,0,2,188,2,188,0.735245000,0.0019
218.4.171.168,<->,8.192.173.161,2,588,0,0,2,588,0.734030000,0.7432
207.225.99.227,<->,0.195.210.46,0,0,2,1461,2,1461,0.733306000,0.0005
215.158.140.76,<->,131.144.116.231,2,2296,0,0,2,2296,0.731953000,0.3579
142.221.197.84,<->,136.25.188.176,0,0,2,957,2,957,0.731356000,0.0021
203.215.176.177,<->,124.42.185.84,2,709,0,0,2,709,0.730859000,0.0914
136.25.189.2,<->,29.212.199.233,2,2554,0,0,2,2554,0.730335000,0.5683
142.208.56.155,<->,136.25.188.253,0,0,2,188,2,188,0.730207000,0.0029
249.101.202.218,<->,53.214.236.51,2,1453,0,0,2,1453,0.729675000,0.2942
136.25.188.243,<->,135.198.115.196,2,656,0,0,2,656,0.729494000,0.9147
215.158.239.48,<->,204.2.250.243,2,188,0,0,2,188,0.729362000,0.0019
215.158.239.48,<->,195.49.133.73,2,867,0,0,2,867,0.729117000,0.3401
123.129.29.205,<->,101.224.89.151,0,0,2,124,2,124,0.728829000,0.9992
133.178.227.108,<->,41.161.45.58,2,576,0,0,2,576,0.727934000,0.1685
136.25.188.226,<->,111.151.70.36,2,2586,0,0,2,2586,0.727891000,1.0022
199.38.75.183,<->,136.25.188.236,0,0,2,164,2,164,0.727829000,0.1816
142.249.202.133,<->,136.25.188.198,0,0,2,1693,2,1693,0.726887000,0.3063
196.89.28.2,<->,136.25.188.175,0,0,2,953,2,953,0.725979000,0.0022
136.25.188.179,<->,8.188.227.40,2,2666,0,0,2,2666,0.725701000,1.1171
195.5.187.59,<->,136.25.188.253,0,0,2,972,2,972,0.723184000,0.0026
220.28.115.46,<->,136.25.188.245,0,0,2,1538,2,1538,0.723165000,0.6996
195.40.165.103,<->,136.25.188.45,0,0,2,188,2,188,0.722910000,0.0028
138.35.86.96,<->,136.25.188.236,0,0,2,998,2,998,0.722850000,0.1660
136.25.189.81,<->,8.222.58.232,2,2602,0,0,2,2602,0.722724000,1.1306
215.158.238.114,<->,104.3.161.24,2,2602,0,0,2,2602,0.720949000,1.0827
221.102.114.234,<->,199.12.96.90,2,656,0,0,2,656,0.720519000,0.2140
198.226.166.140,<->,136.25.189.59,0,0,2,2682,2,2682,0.720509000,0.3103
133.178.227.2,<->,100.50.96.229,2,2189,0,0,2,2189,0.720263000,0.7081
136.25.189.0,<->,61.35.70.229,2,2682,0,0,2,2682,0.720062000,0.7535
215.158.239.207,<->,111.42.21.89,2,510,0,0,2,510,0.719076000,0.0311
204.200.55.40,<->,136.25.188.163,0,0,2,943,2,943,0.717967000,0.0000
215.158.239.78,<->,195.83.97.243,2,188,0,0,2,188,0.717966000,0.0000
215.158.239.84,<->,199.20.30.205,2,1101,0,0,2,1101,0.717052000,0.4789
142.227.103.149,<->,136.25.188.255,0,0,2,188,2,188,0.716611000,0.0022
133.178.226.29,<->,76.100.108.235,2,2746,0,0,2,2746,0.716590000,0.9742
215.158.239.97,<->,199.20.7.56,2,188,0,0,2,188,0.716269000,0.0000
199.14.203.15,<->,136.25.188.163,0,0,2,188,2,188,0.716003000,0.0026
207.62.89.133,<->,136.25.188.174,0,0,2,952,2,952,0.715918000,0.0021
215.158.197.71,<->,133.178.226.214,0,0,2,1730,2,1730,0.715069000,0.5907
133.178.226.222,<->,80.56.246.234,2,502,0,0,2,502,0.714598000,0.1693
199.15.139.90,<->,136.25.188.252,0,0,2,680,2,680,0.714255000,0.5398
112.208.147.230,<->,89.183.110.72,0,0,2,1600,2,1600,0.713991000,0.0006
136.25.188.178,<->,69.150.169.137,2,2570,0,0,2,2570,0.713850000,0.2845
215.158.239.76,<->,207.191.224.128,2,955,0,0,2,955,0.713847000,0.0037
136.25.189.33,<->,126.219.194.18,2,1284,0,0,2,1284,0.713268000,0.3559
142.254.98.22,<->,136.25.188.236,0,0,2,814,2,814,0.712721000,0.0024
215.158.239.84,<->,142.241.37.119,2,656,0,0,2,656,0.711497000,0.8055
215.158.239.40,<->,8.241.236.118,2,296,0,0,2,296,0.710620000,0.3357
210.229.230.21,<->,104.85.21.141,2,186,0,0,2,186,0.710574000,1.0453
142.252.114.229,<->,136.25.188.253,0,0,2,188,2,188,0.710398000,0.0045
215.158.61.191,<->,8.176.8.208,0,0,2,1138,2,1138,0.709639000,0.0002
142.227.97.183,<->,136.25.188.222,0,0,2,188,2,188,0.709374000,0.0017
215.158.140.92,<->,69.150.169.200,2,2758,0,0,2,2758,0.708650000,0.7253
215.158.239.86,<->,125.84.55.22,2,2570,0,0,2,2570,0.708247000,0.7011
144.85.169.244,<->,111.146.142.77,0,0,2,1400,2,1400,0.707735000,0.5519
194.234.241.111,<->,136.25.188.199,0,0,2,186,2,186,0.707297000,0.3772
192.226.161.43,<->,133.178.227.2,0,0,2,2138,2,2138,0.706868000,0.7687
215.158.239.87,<->,68.124.221.168,2,2570,0,0,2,2570,0.706357000,0.6882
133.178.227.62,<->,133.56.180.53,2,842,0,0,2,842,0.705487000,0.0003
205.210.174.212,<->,80.40.44.132,0,0,2,746,2,746,0.705393000,1.0276
231.140.169.145,<->,136.25.188.238,0,0,2,1321,2,1321,0.705219000,0.2027
91.60.173.42,<->,8.52.222.23,0,0,2,656,2,656,0.704952000,0.0432
197.113.99.81,<->,136.25.188.173,0,0,2,1086,2,1086,0.704170000,0.2722
215.158.239.56,<->,207.61.237.77,2,430,0,0,2,430,0.704074000,0.2416
149.163.129.150,<->,133.178.227.16,0,0,2,2410,2,2410,0.703978000,0.4026
143.20.116.126,<->,136.25.188.225,0,0,2,188,2,188,0.702175000,0.0020
143.20.116.126,<->,136.25.188.163,0,0,2,188,2,188,0.701755000,0.0019
195.13.224.150,<->,136.25.188.196,0,0,2,849,2,849,0.701210000,0.2613
142.191.1.22,<->,136.25.188.220,0,0,2,1687,2,1687,0.700709000,0.2731
215.158.239.56,<->,199.20.4.240,2,832,0,0,2,832,0.700259000,0.3401
197.113.99.238,<->,136.25.188.241,0,0,2,188,2,188,0.700110000,0.0099
215.158.239.77,<->,194.234.219.228,2,656,0,0,2,656,0.699561000,0.2797
203.215.2.153,<->,8.181.37.222,2,1769,0,0,2,1769,0.699547000,0.2094
64.102.10.13,<->,8.252.222.23,0,0,2,656,2,656,0.697403000,0.6598
195.124.107.127,<->,136.25.188.238,0,0,2,188,2,188,0.697219000,0.0100
215.158.239.124,<->,69.31.238.17,2,272,0,0,2,272,0.696727000,0.8739
111.147.129.118,<->,53.214.239.188,2,838,0,0,2,838,0.696708000,0.9054
142.227.61.239,<->,136.25.188.241,0,0,2,387,2,387,0.696650000,0.0029
199.39.87.91,<->,136.25.188.242,0,0,2,188,2,188,0.696191000,0.0020
215.158.238.209,<->,113.23.40.43,2,2265,0,0,2,2265,0.695893000,1.0679
215.158.239.58,<->,199.20.29.150,2,963,0,0,2,963,0.695684000,0.0800
133.135.214.225,<->,129.6.83.11,0,0,2,1374,2,1374,0.695050000,0.0552
215.158.239.87,<->,199.20.31.153,2,432,0,0,2,432,0.694822000,0.9508
123.129.29.201,<->,33.233.141.118,0,0,2,124,2,124,0.694782000,0.9996
111.20.168.186,<->,27.127.249.118,2,124,0,0,2,124,0.694628000,0.9993
142.248.23.11,<->,136.25.188.46,0,0,2,186,2,186,0.694474000,1.1705
220.28.85.14,<->,215.158.239.62,0,0,2,1503,2,1503,0.694290000,0.0000
215.158.238.120,<->,104.154.137.226,2,2618,0,0,2,2618,0.693269000,1.0936
215.158.238.99,<->,38.104.11.38,2,2426,0,0,2,2426,0.693174000,0.7623
133.178.226.177,<->,53.176.63.198,2,746,0,0,2,746,0.693110000,0.2345
136.25.188.198,<->,84.223.186.28,2,656,0,0,2,656,0.692361000,0.7583
215.158.239.56,<->,199.78.242.244,2,851,0,0,2,851,0.692147000,0.2401
159.23.224.231,<->,108.130.220.37,2,107,0,0,2,107,0.690956000,0.1873
215.158.61.182,<->,8.176.8.210,0,0,2,839,2,839,0.690860000,0.1977
223.120.123.230,<->,8.252.221.205,0,0,2,908,2,908,0.690583000,1.1136
215.158.239.58,<->,199.20.28.114,2,186,0,0,2,186,0.690494000,0.0004
215.158.238.120,<->,120.154.221.254,2,2506,0,0,2,2506,0.690297000,0.6562
142.166.245.108,<->,136.25.188.174,0,0,2,188,2,188,0.689450000,0.0022
215.158.239.78,<->,196.91.186.38,2,921,0,0,2,921,0.689234000,1.0798
221.102.56.69,<->,102.81.131.138,0,0,2,588,2,588,0.688498000,0.0794
220.28.115.46,<->,136.25.188.49,0,0,2,1882,2,1882,0.688305000,1.1664
133.178.227.26,<->,8.191.14.58,2,2600,0,0,2,2600,0.688073000,0.6491
220.28.114.28,<->,136.25.189.55,0,0,2,1977,2,1977,0.688007000,0.5686
215.158.239.51,<->,199.20.28.85,2,971,0,0,2,971,0.687763000,0.3493
136.25.189.81,<->,61.35.124.194,2,2714,0,0,2,2714,0.687189000,0.9900
142.227.67.136,<->,136.25.188.198,0,0,2,371,2,371,0.687022000,1.1161
100.228.42.94,<->,17.136.21.53,2,998,0,0,2,998,0.686728000,0.0002
136.25.188.196,<->,120.154.221.231,2,2602,0,0,2,2602,0.686043000,0.4719
109.222.251.106,<->,8.232.109.189,2,324,0,0,2,324,0.685698000,0.1170
98.16.139.251,<->,8.52.186.161,0,0,2,656,2,656,0.685013000,0.0298
144.83.112.140,<->,98.236.243.160,0,0,2,125,2,125,0.684226000,0.1716
91.231.221.147,<->,8.252.223.188,0,0,2,1034,2,1034,0.684083000,1.1072
133.178.226.38,<->,104.3.161.71,2,2426,0,0,2,2426,0.683649000,1.0739
215.158.239.42,<->,29.211.5.165,2,1595,0,0,2,1595,0.682178000,0.1618
221.102.143.189,<->,192.64.78.135,0,0,2,282,2,282,0.681812000,1.2000
207.239.182.114,<->,136.25.188.227,0,0,2,464,2,464,0.681455000,0.8311
215.158.239.85,<->,192.204.123.11,2,2330,0,0,2,2330,0.681331000,0.7106
133.54.43.41,<->,93.208.41.137,2,1518,0,0,2,1518,0.681152000,0.4028
97.193.1.108,<->,8.52.226.56,0,0,2,419,2,419,0.681129000,0.0955
215.158.238.113,<->,57.247.184.208,2,2554,0,0,2,2554,0.680774000,0.2629
204.61.24.8,<->,136.25.188.175,0,0,2,188,2,188,0.680540000,0.0030
210.209.251.211,<->,192.64.215.193,0,0,2,972,2,972,0.680492000,0.0051
123.129.29.204,<->,111.20.168.191,0,0,2,124,2,124,0.680315000,0.9992
129.92.117.123,<->,97.124.66.195,2,2015,0,0,2,2015,0.679550000,0.0008
215.158.239.58,<->,196.104.231.228,2,774,0,0,2,774,0.679319000,0.2889
204.200.38.141,<->,136.25.188.198,0,0,2,234,2,234,0.679121000,0.2524
215.158.239.92,<->,194.199.212.1,2,188,0,0,2,188,0.678662000,0.0000
106.168.190.66,<->,101.126.191.241,0,0,2,165,2,165,0.678370000,0.3141
109.222.197.2,<->,54.49.231.97,2,607,0,0,2,607,0.677391000,0.1472
204.200.61.70,<->,136.25.188.53,0,0,2,956,2,956,0.677056000,0.0000
192.228.30.41,<->,133.178.226.28,0,0,2,2186,2,2186,0.676949000,1.3067
215.158.239.92,<->,29.209.59.215,2,2586,0,0,2,2586,0.674998000,0.7742
89.204.65.12,<->,8.182.251.47,0,0,2,790,2,790,0.674944000,0.3384
215.158.239.59,<->,199.20.28.157,2,188,0,0,2,188,0.674892000,0.0001
98.128.107.99,<->,8.55.211.213,2,588,0,0,2,588,0.674476000,0.1158
205.171.233.183,<->,0.195.210.42,0,0,2,164,2,164,0.673638000,0.0000
215.158.239.96,<->,199.20.31.121,2,462,0,0,2,462,0.673320000,0.9993
215.158.239.76,<->,199.20.30.82,2,188,0,0,2,188,0.673039000,0.0198
17.70.136.237,<->,8.220.200.173,0,0,2,2022,2,2022,0.672582000,0.0010
215.158.239.192,<->,215.158.61.242,2,2050,0,0,2,2050,0.672254000,0.0004
199.70.30.146,<->,136.25.188.162,0,0,2,956,2,956,0.671700000,0.0021
8.182.244.237,<->,6.20.49.254,2,421,0,0,2,421,0.671140000,0.0852
139.60.197.151,<->,136.25.188.222,0,0,2,389,2,389,0.670159000,0.0452
215.158.238.81,<->,192.229.40.108,2,2554,0,0,2,2554,0.669477000,1.3069
133.178.227.14,<->,123.166.46.215,2,2255,0,0,2,2255,0.669202000,0.6603
215.158.140.162,<->,106.188.254.183,2,272,0,0,2,272,0.669150000,0.0002
108.47.147.137,<->,8.52.182.119,0,0,2,1337,2,1337,0.668896000,1.1677
195.13.4.108,<->,136.25.188.197,0,0,2,1075,2,1075,0.668689000,0.0959
207.57.197.191,<->,136.25.188.160,0,0,2,188,2,188,0.668443000,0.0083
133.178.227.245,<->,80.47.104.132,2,1938,0,0,2,1938,0.668392000,1.3164
204.187.57.196,<->,136.25.188.198,0,0,2,1096,2,1096,0.668166000,0.3247
142.228.94.214,<->,136.25.188.163,0,0,2,843,2,843,0.668076000,0.8339
86.135.118.11,<->,8.252.222.23,0,0,2,188,2,188,0.667839000,0.0060
50.145.71.12,<->,48.54.99.146,0,0,2,379,2,379,0.667659000,0.3047
215.158.239.224,<->,137.107.106.110,2,1586,0,0,2,1586,0.667448000,0.8209
207.59.91.167,<->,136.25.188.239,0,0,2,188,2,188,0.667408000,0.0042
133.178.226.28,<->,131.1.195.232,2,2836,0,0,2,2836,0.667333000,0.6701
215.158.238.243,<->,8.40.50.57,2,2490,0,0,2,2490,0.667296000,1.1771
215.158.238.135,<->,38.104.11.106,2,2330,0,0,2,2330,0.666943000,0.2771
136.25.188.52,<->,112.235.95.73,2,2554,0,0,2,2554,0.666384000,0.8282
143.134.70.126,<->,136.25.188.241,0,0,2,983,2,983,0.665762000,0.0014
136.25.189.27,<->,100.216.78.145,2,410,0,0,2,410,0.665143000,0.0001
215.158.239.35,<->,122.158.246.197,2,1461,0,0,2,1461,0.661745000,0.6088
136.25.189.80,<->,113.92.151.56,2,2762,0,0,2,2762,0.661584000,0.4902
133.178.227.108,<->,132.43.3.23,2,928,0,0,2,928,0.661402000,1.1141
207.58.193.117,<->,136.25.188.222,0,0,2,800,2,800,0.661239000,0.0182
221.102.56.51,<->,192.67.144.122,0,0,2,442,2,442,0.660869000,0.0339
207.66.72.41,<->,8.182.229.19,0,0,2,150,2,150,0.660584000,0.0012
6.145.149.52,<->,0.195.210.44,0,0,2,174,2,174,0.660239000,0.0623
215.158.239.50,<->,98.28.95.86,2,2698,0,0,2,2698,0.660130000,0.8773
215.158.239.68,<->,199.20.30.255,2,188,0,0,2,188,0.660043000,0.0316
195.55.18.245,<->,136.25.188.224,0,0,2,950,2,950,0.659815000,0.0016
143.135.193.209,<->,136.25.188.238,0,0,2,188,2,188,0.659160000,0.0039
215.158.239.224,<->,192.226.44.4,2,866,0,0,2,866,0.658648000,0.2498
247.136.143.107,<->,128.58.13.42,2,282,0,0,2,282,0.658641000,0.5619
215.158.238.97,<->,80.47.228.219,2,2586,0,0,2,2586,0.658291000,0.7692
136.25.189.2,<->,72.23.194.234,2,2634,0,0,2,2634,0.657877000,1.1293
143.76.137.81,<->,8.182.241.177,0,0,2,1140,2,1140,0.657569000,1.2241
215.158.239.92,<->,142.229.173.174,2,188,0,0,2,188,0.656045000,0.0031
215.158.239.49,<->,29.211.228.247,2,2618,0,0,2,2618,0.655576000,1.0985
99.167.13.129,<->,8.182.253.38,0,0,2,656,2,656,0.655539000,0.0828
192.64.209.42,<->,117.209.253.28,2,116,0,0,2,116,0.655229000,0.1441
136.25.189.32,<->,106.188.253.150,2,2883,0,0,2,2883,0.655202000,0.7364
246.253.153.54,<->,145.128.214.14,2,1601,0,0,2,1601,0.654546000,0.0724
133.178.226.19,<->,57.160.181.244,2,2650,0,0,2,2650,0.654153000,0.3222
101.87.213.152,<->,100.228.42.72,0,0,2,1274,2,1274,0.653668000,0.7313
215.158.239.76,<->,199.72.194.213,2,439,0,0,2,439,0.653503000,0.3952
142.236.163.250,<->,136.25.188.175,0,0,2,188,2,188,0.651947000,0.0020
215.158.238.96,<->,42.226.3.118,2,2698,0,0,2,2698,0.651859000,1.2077
215.158.239.7,<->,215.158.127.150,2,456,0,0,2,456,0.651644000,0.0831
221.102.56.69,<->,6.75.204.162,0,0,2,588,2,588,0.651436000,0.0000
207.61.46.123,<->,136.25.188.242,0,0,2,656,2,656,0.651376000,0.3802
136.25.189.29,<->,106.188.253.230,2,2864,0,0,2,2864,0.651175000,0.8167
136.25.188.167,<->,100.216.78.145,2,2557,0,0,2,2557,0.651118000,0.0780
215.158.239.93,<->,199.20.29.220,2,188,0,0,2,188,0.650571000,0.0000
197.125.118.214,<->,133.178.227.14,0,0,2,2778,2,2778,0.650493000,1.0918
69.103.229.5,<->,8.252.222.159,0,0,2,188,2,188,0.650377000,0.0006
199.73.44.127,<->,136.25.188.253,0,0,2,188,2,188,0.647399000,0.0045
143.88.15.41,<->,133.178.226.30,0,0,2,2122,2,2122,0.647150000,1.1956
215.158.239.50,<->,112.220.198.105,2,2506,0,0,2,2506,0.646304000,0.1968
215.158.239.78,<->,196.104.78.23,2,1713,0,0,2,1713,0.646130000,0.4602
139.193.141.139,<->,112.7.47.88,2,732,0,0,2,732,0.646009000,0.2094
136.25.189.59,<->,38.104.11.17,2,2794,0,0,2,2794,0.645643000,1.1393
195.6.38.82,<->,136.25.188.252,0,0,2,188,2,188,0.645554000,0.0033
142.207.100.195,<->,136.25.188.255,0,0,2,1685,2,1685,0.644798000,0.2121
215.158.239.92,<->,207.236.231.93,2,880,0,0,2,880,0.644336000,0.0730
139.248.200.186,<->,119.53.43.104,2,1198,0,0,2,1198,0.644135000,0.3239
136.25.188.162,<->,119.168.0.145,2,2698,0,0,2,2698,0.642364000,1.0588
137.69.83.248,<->,8.183.25.124,0,0,2,414,2,414,0.641567000,0.0730
215.158.239.78,<->,199.79.54.21,2,188,0,0,2,188,0.641404000,0.0000
215.158.239.85,<->,199.20.29.10,2,464,0,0,2,464,0.640940000,0.6592
136.25.189.16,<->,131.144.115.231,2,2666,0,0,2,2666,0.640914000,0.7589
133.54.43.61,<->,117.23.147.95,2,632,0,0,2,632,0.640839000,0.9199
92.27.27.189,<->,18.202.25.173,2,122,0,0,2,122,0.640220000,0.8132
139.60.197.151,<->,136.25.188.198,0,0,2,389,2,389,0.639980000,0.0446
136.25.188.224,<->,57.199.250.212,2,2698,0,0,2,2698,0.639116000,1.1459
133.178.226.30,<->,106.188.252.218,2,2330,0,0,2,2330,0.639053000,0.5211
144.86.147.98,<->,35.56.3.196,2,1128,0,0,2,1128,0.638317000,0.9993
215.158.238.221,<->,192.171.32.145,2,2314,0,0,2,2314,0.638308000,1.1601
192.64.209.247,<->,27.167.166.227,2,1562,0,0,2,1562,0.637422000,0.5003
199.33.59.225,<->,136.25.188.178,0,0,2,188,2,188,0.637125000,0.0039
215.158.239.79,<->,196.89.239.219,2,774,0,0,2,774,0.636302000,0.3200
215.158.239.69,<->,199.20.28.20,2,958,0,0,2,958,0.636199000,0.0000
215.158.239.96,<->,207.115.153.176,2,188,0,0,2,188,0.635755000,0.0000
215.158.238.111,<->,145.116.209.80,2,1012,0,0,2,1012,0.635329000,0.1133
215.158.239.95,<->,204.226.39.0,2,188,0,0,2,188,0.635294000,0.0018
215.158.238.80,<->,192.227.190.244,2,410,0,0,2,410,0.635227000,0.8757
215.158.239.93,<->,201.211.113.180,2,2522,0,0,2,2522,0.634907000,0.2270
133.178.227.79,<->,61.72.108.162,2,2602,0,0,2,2602,0.634842000,1.1958
8.253.128.41,<->,8.252.222.204,0,0,2,1618,2,1618,0.633178000,0.4788
215.158.238.81,<->,42.226.3.106,2,2698,0,0,2,2698,0.632661000,0.2924
133.8.10.9,<->,8.182.227.18,0,0,2,1318,2,1318,0.632449000,0.3410
75.157.196.137,<->,0.195.210.46,0,0,2,1370,2,1370,0.632238000,1.3352
136.25.189.78,<->,56.161.218.38,2,2842,0,0,2,2842,0.632025000,0.9875
199.82.242.44,<->,136.25.188.209,0,0,2,188,2,188,0.631632000,0.0029
149.163.129.231,<->,136.25.189.78,0,0,2,2426,2,2426,0.631353000,1.1454
142.244.226.230,<->,136.25.188.253,0,0,2,656,2,656,0.631282000,0.1996
136.25.188.45,<->,91.247.40.77,2,906,0,0,2,906,0.631174000,1.0747
215.158.239.56,<->,196.93.226.91,2,774,0,0,2,774,0.630912000,0.7797
212.70.75.121,<->,136.25.189.1,0,0,2,2666,2,2666,0.630848000,0.5684
156.150.64.253,<->,8.252.222.186,0,0,2,774,2,774,0.630446000,0.1624
230.156.223.131,<->,8.252.222.174,0,0,2,188,2,188,0.629904000,0.0000
215.158.238.221,<->,113.23.14.216,2,2120,0,0,2,2120,0.629790000,0.5515
195.42.102.7,<->,136.25.188.222,0,0,2,440,2,440,0.629727000,0.2172
133.178.226.70,<->,131.144.116.40,2,2586,0,0,2,2586,0.628639000,0.6419
231.143.159.131,<->,136.25.188.162,0,0,2,188,2,188,0.628345000,0.0000
142.190.17.168,<->,136.25.188.178,0,0,2,1428,2,1428,0.628206000,0.0125
207.172.46.151,<->,136.25.188.174,0,0,2,1204,2,1204,0.628070000,0.8795
203.120.5.84,<->,80.38.36.144,0,0,2,167,2,167,0.627837000,0.9424
207.162.138.220,<->,8.182.229.19,0,0,2,656,2,656,0.627278000,0.1684
101.64.89.82,<->,8.252.223.146,0,0,2,2198,2,2198,0.627243000,0.4619
247.118.160.190,<->,8.182.229.19,0,0,2,1650,2,1650,0.627199000,0.8856
215.158.238.54,<->,197.125.126.218,2,2794,0,0,2,2794,0.626987000,1.1019
215.158.238.148,<->,131.144.113.193,2,2570,0,0,2,2570,0.626847000,0.5583
207.60.199.109,<->,136.25.188.45,0,0,2,440,2,440,0.626735000,0.3405
215.158.239.93,<->,204.226.53.177,2,188,0,0,2,188,0.626673000,0.0002
215.158.239.70,<->,131.144.115.228,2,2570,0,0,2,2570,0.625447000,0.8563
207.58.193.117,<->,136.25.188.255,0,0,2,800,2,800,0.625196000,0.0030
246.253.253.208,<->,196.21.24.47,2,162,0,0,2,162,0.624980000,0.6601
199.69.133.234,<->,136.25.188.226,0,0,2,188,2,188,0.624499000,0.0027
215.158.238.133,<->,29.211.186.218,2,2554,0,0,2,2554,0.624231000,0.5701
242.12.5.146,<->,215.158.239.42,0,0,2,332,2,332,0.624109000,0.7422
136.25.188.252,<->,132.128.123.251,2,386,0,0,2,386,0.623786000,0.0000
129.16.253.232,<->,98.129.59.32,0,0,2,2030,2,2030,0.622814000,1.3681
195.13.134.170,<->,136.25.188.44,0,0,2,919,2,919,0.621761000,0.0029
195.14.45.24,<->,136.25.188.162,0,0,2,188,2,188,0.619975000,0.0022
215.158.238.83,<->,65.27.220.196,2,2346,0,0,2,2346,0.619903000,1.1901
215.158.239.93,<->,196.107.127.197,2,966,0,0,2,966,0.619859000,0.0000
215.158.239.99,<->,196.108.135.169,2,340,0,0,2,340,0.618736000,0.4718
215.158.239.99,<->,199.20.28.83,2,188,0,0,2,188,0.617590000,0.0000
195.55.141.42,<->,136.25.188.45,0,0,2,386,2,386,0.616867000,0.0021
132.244.73.42,<->,108.134.108.240,0,0,2,915,2,915,0.616616000,1.3618
204.187.169.9,<->,136.25.188.220,0,0,2,961,2,961,0.616126000,0.0000
215.158.238.95,<->,69.31.239.5,2,2522,0,0,2,2522,0.615948000,0.9304
215.158.239.86,<->,196.88.143.131,2,656,0,0,2,656,0.615746000,0.6443
203.114.24.27,<->,136.25.188.237,0,0,2,1530,2,1530,0.614982000,0.6394
112.17.120.20,<->,50.224.108.163,0,0,2,244,2,244,0.614794000,1.0053
215.158.239.97,<->,199.20.31.203,2,1078,0,0,2,1078,0.614528000,0.6002
133.178.227.2,<->,61.35.124.214,2,2176,0,0,2,2176,0.614236000,0.7658
53.161.123.40,<->,48.53.106.244,0,0,2,1848,2,1848,0.613901000,0.0015
215.158.61.193,<->,8.176.8.105,0,0,2,1566,2,1566,0.613103000,1.3163
207.236.203.114,<->,136.25.188.210,0,0,2,747,2,747,0.612157000,0.2632
215.158.238.132,<->,131.1.195.220,2,2799,0,0,2,2799,0.611958000,1.0709
91.248.126.109,<->,8.252.222.45,0,0,2,1541,2,1541,0.611382000,0.1618
215.158.238.133,<->,8.188.227.0,2,2522,0,0,2,2522,0.611363000,0.9652
215.158.238.76,<->,139.163.161.50,2,1010,0,0,2,1010,0.611008000,0.2159
136.25.189.80,<->,56.161.218.54,2,2442,0,0,2,2442,0.609482000,1.0799
215.158.238.59,<->,131.1.235.145,2,2924,0,0,2,2924,0.609412000,1.1170
136.25.189.202,<->,129.222.36.164,2,2183,0,0,2,2183,0.609340000,0.6316
215.158.239.99,<->,195.6.24.49,2,656,0,0,2,656,0.608932000,0.1678
111.48.212.5,<->,8.182.228.189,0,0,2,1658,2,1658,0.608892000,0.2232
196.88.178.136,<->,136.25.188.52,0,0,2,656,2,656,0.608810000,0.2339
136.25.188.211,<->,69.150.169.37,2,2378,0,0,2,2378,0.608706000,0.3916
215.158.238.133,<->,113.23.20.92,2,2426,0,0,2,2426,0.607673000,0.6679
215.158.238.45,<->,143.20.121.150,2,1458,0,0,2,1458,0.607138000,0.2487
142.190.119.195,<->,136.25.188.196,0,0,2,188,2,188,0.606850000,0.0035
136.25.188.253,<->,57.247.184.198,2,1282,0,0,2,1282,0.606451000,0.3330
207.40.4.22,<->,192.229.210.156,0,0,2,582,2,582,0.605570000,0.1939
215.158.239.96,<->,196.94.82.101,2,1594,0,0,2,1594,0.604832000,0.3191
80.52.60.162,<->,8.220.189.63,0,0,2,779,2,779,0.604650000,0.9374
215.158.239.84,<->,199.20.4.146,2,1056,0,0,2,1056,0.604042000,0.2104
197.113.99.218,<->,136.25.188.238,0,0,2,188,2,188,0.603896000,0.0000
215.202.174.57,<->,215.158.239.93,0,0,2,2458,2,2458,0.603420000,1.3193
215.158.238.221,<->,131.144.114.248,2,2177,0,0,2,2177,0.603161000,1.3069
215.158.238.251,<->,8.42.42.138,2,2184,0,0,2,2184,0.602996000,0.8883
242.43.134.86,<->,8.220.190.86,0,0,2,680,2,680,0.602817000,0.0321
136.25.189.14,<->,116.106.46.84,2,2426,0,0,2,2426,0.601617000,0.8383
97.126.26.80,<->,54.52.240.109,2,129,0,0,2,129,0.601584000,0.1111
215.158.140.241,<->,8.40.51.98,2,2083,0,0,2,2083,0.600846000,0.9345
207.172.246.243,<->,136.25.188.252,0,0,2,1075,2,1075,0.600643000,0.4301
252.98.139.93,<->,210.209.251.211,2,884,0,0,2,884,0.600494000,0.0455
215.158.239.92,<->,142.247.252.8,2,591,0,0,2,591,0.600439000,0.8049
215.158.239.86,<->,199.33.220.112,2,174,0,0,2,174,0.600343000,0.4701
195.124.8.54,<->,136.25.188.227,0,0,2,472,2,472,0.600054000,0.8587
199.48.57.141,<->,8.252.222.36,0,0,2,188,2,188,0.599903000,0.0000
215.158.238.135,<->,197.103.151.86,2,2634,0,0,2,2634,0.599835000,0.5518
215.158.140.241,<->,131.144.115.154,2,2237,0,0,2,2237,0.599695000,1.0240
159.137.162.213,<->,121.124.232.8,2,676,0,0,2,676,0.599593000,0.3520
133.178.226.70,<->,106.188.253.52,2,2158,0,0,2,2158,0.598976000,0.5525
199.68.69.64,<->,136.25.188.163,0,0,2,951,2,951,0.598760000,0.0027
133.178.226.29,<->,65.27.220.208,2,2378,0,0,2,2378,0.598142000,1.0321
210.226.165.92,<->,53.144.192.64,2,1752,0,0,2,1752,0.597352000,1.0116
215.158.140.93,<->,192.171.32.169,2,2127,0,0,2,2127,0.597303000,1.3340
143.13.155.13,<->,136.25.188.242,0,0,2,188,2,188,0.596816000,0.0030
215.158.239.84,<->,204.226.36.241,2,188,0,0,2,188,0.596501000,0.0002
207.101.241.219,<->,8.182.233.86,0,0,2,695,2,695,0.596075000,1.0804
138.20.59.183,<->,8.52.147.55,0,0,2,1347,2,1347,0.595976000,0.0002
215.158.238.136,<->,97.174.232.241,2,1011,0,0,2,1011,0.595897000,0.6457
215.158.239.70,<->,29.212.199.125,2,2522,0,0,2,2522,0.595892000,0.5305
215.158.239.79,<->,195.42.42.140,2,518,0,0,2,518,0.595850000,0.5583
215.158.238.67,<->,126.219.194.140,2,2426,0,0,2,2426,0.594857000,0.9310
98.12.254.195,<->,0.195.210.44,0,0,2,266,2,266,0.594315000,0.8593
215.158.238.82,<->,80.47.111.107,2,2330,0,0,2,2330,0.594135000,1.3503
111.147.91.47,<->,59.150.58.129,2,126,0,0,2,126,0.593781000,0.2279
231.141.11.141,<->,215.158.239.79,0,0,2,923,2,923,0.592954000,0.1779
215.201.227.68,<->,8.183.24.179,0,0,2,1203,2,1203,0.592933000,0.3572
215.158.140.171,<->,215.158.42.194,2,710,0,0,2,710,0.592161000,0.0001
215.158.239.234,<->,158.188.198.216,2,2038,0,0,2,2038,0.592120000,1.1631
145.118.57.252,<->,133.32.39.0,0,0,2,1091,2,1091,0.591761000,0.0003
138.126.75.74,<->,136.25.188.172,0,0,2,2618,2,2618,0.591351000,0.4469
136.25.189.32,<->,38.104.11.60,2,2682,0,0,2,2682,0.590577000,0.3669
215.158.239.50,<->,207.114.255.71,2,963,0,0,2,963,0.589901000,0.0000
215.158.238.45,<->,197.125.116.84,2,2442,0,0,2,2442,0.589899000,0.9153
136.25.189.77,<->,96.156.169.252,2,1181,0,0,2,1181,0.589752000,0.8221
215.158.239.48,<->,196.92.69.204,2,188,0,0,2,188,0.588772000,0.0000
207.172.74.193,<->,136.25.188.225,0,0,2,448,2,448,0.588493000,0.8399
215.158.238.250,<->,61.72.108.171,2,2027,0,0,2,2027,0.588285000,1.0459
215.158.239.92,<->,196.108.61.166,2,957,0,0,2,957,0.588050000,0.0000
215.158.239.6,<->,149.96.60.148,2,2787,0,0,2,2787,0.587813000,1.1659
90.240.218.98,<->,54.38.43.164,2,685,0,0,2,685,0.587600000,0.2663
136.25.189.1,<->,121.8.199.20,2,2538,0,0,2,2538,0.587463000,0.1691
215.158.239.6,<->,96.135.154.126,2,1372,0,0,2,1372,0.587429000,0.5818
215.158.239.56,<->,199.20.29.3,2,1190,0,0,2,1190,0.587170000,0.7401
133.178.226.29,<->,89.86.110.9,2,2506,0,0,2,2506,0.586534000,0.6911
215.158.140.17,<->,8.42.79.137,2,1094,0,0,2,1094,0.586229000,0.0200
196.88.178.136,<->,136.25.188.252,0,0,2,656,2,656,0.586037000,0.2183
204.61.153.82,<->,136.25.188.46,0,0,2,188,2,188,0.585558000,0.0034
143.42.53.127,<->,136.25.188.222,0,0,2,606,2,606,0.585322000,0.0308
199.71.118.127,<->,136.25.188.176,0,0,2,656,2,656,0.584984000,0.1945
204.63.3.52,<->,136.25.188.53,0,0,2,957,2,957,0.584430000,0.0198
17.26.173.37,<->,8.53.7.195,0,0,2,1760,2,1760,0.584340000,0.5548
136.25.189.14,<->,113.23.14.192,2,2554,0,0,2,2554,0.584288000,0.2832
215.158.239.99,<->,199.20.29.99,2,2256,0,0,2,2256,0.583669000,0.7800
136.25.188.197,<->,131.1.253.251,2,1442,0,0,2,1442,0.583561000,0.9032
136.25.189.0,<->,96.156.169.168,2,1570,0,0,2,1570,0.583406000,0.2921
98.238.48.43,<->,8.182.244.237,0,0,2,1712,2,1712,0.583377000,1.2169
215.158.239.79,<->,207.167.192.102,2,430,0,0,2,430,0.583235000,0.6496
212.70.75.25,<->,133.178.226.19,0,0,2,2202,2,2202,0.582732000,1.1156
215.158.239.86,<->,199.20.6.130,2,947,0,0,2,947,0.582547000,0.0000
215.158.239.56,<->,196.91.200.82,2,188,0,0,2,188,0.582436000,0.0094
133.54.17.104,<->,27.134.250.208,2,2686,0,0,2,2686,0.581985000,0.9110
80.41.244.231,<->,8.45.175.127,2,1338,0,0,2,1338,0.581829000,0.0537
136.25.188.243,<->,80.47.111.65,2,2586,0,0,2,2586,0.581819000,0.2503
215.158.239.94,<->,199.20.28.106,2,958,0,0,2,958,0.581255000,0.0500
215.158.238.107,<->,128.123.91.51,2,2410,0,0,2,2410,0.581153000,1.0949
196.247.213.16,<->,136.25.188.52,0,0,2,188,2,188,0.580729000,0.0105
8.252.221.198,<->,4.121.146.40,2,904,0,0,2,904,0.580452000,1.2922
136.25.188.45,<->,6.25.234.209,2,440,0,0,2,440,0.580129000,0.0411
136.214.10.22,<->,92.27.194.112,0,0,2,693,2,693,0.579254000,0.9580
136.25.188.210,<->,122.158.245.153,2,2618,0,0,2,2618,0.578778000,0.3756
80.27.157.212,<->,66.245.79.98,2,610,0,0,2,610,0.578391000,0.0000
215.158.239.86,<->,207.213.160.127,2,230,0,0,2,230,0.578371000,1.1590
247.236.195.202,<->,133.32.39.0,0,0,2,481,2,481,0.578106000,0.0520
133.178.226.7,<->,100.50.100.23,2,2707,0,0,2,2707,0.577597000,0.2092
197.125.110.181,<->,136.25.189.17,0,0,2,2426,2,2426,0.576685000,0.7392
136.25.188.47,<->,111.151.70.60,2,2602,0,0,2,2602,0.576673000,0.6150
215.158.239.86,<->,194.199.196.220,2,188,0,0,2,188,0.576651000,0.0003
194.253.248.68,<->,8.252.222.197,0,0,2,202,2,202,0.576312000,0.0073
133.178.226.30,<->,111.151.70.65,2,2538,0,0,2,2538,0.575803000,0.1543
139.193.141.139,<->,117.2.248.23,2,882,0,0,2,882,0.575700000,0.0184
109.222.237.131,<->,53.196.94.83,2,1326,0,0,2,1326,0.575141000,1.0130
215.158.239.94,<->,131.144.115.229,2,2714,0,0,2,2714,0.574923000,0.7180
123.153.228.199,<->,92.162.252.74,0,0,2,2126,2,2126,0.574772000,0.2081
142.190.17.168,<->,136.25.188.239,0,0,2,1428,2,1428,0.574723000,0.6041
136.25.188.237,<->,116.99.180.180,2,2522,0,0,2,2522,0.574673000,1.0281
192.228.25.179,<->,133.178.226.234,0,0,2,524,2,524,0.574401000,1.0010
195.41.226.218,<->,136.25.188.222,0,0,2,188,2,188,0.574182000,0.0021
215.158.239.93,<->,199.20.28.242,2,755,0,0,2,755,0.573807000,0.0000
136.25.188.45,<->,104.3.163.5,2,2474,0,0,2,2474,0.573662000,0.8826
215.158.239.58,<->,204.226.116.227,2,1512,0,0,2,1512,0.573564000,0.1925
136.25.189.57,<->,8.222.98.136,2,2874,0,0,2,2874,0.573469000,0.2841
215.158.238.75,<->,38.104.11.38,2,2570,0,0,2,2570,0.573136000,0.8113
215.158.239.48,<->,207.115.208.47,2,774,0,0,2,774,0.572783000,0.3492
199.33.65.22,<->,136.25.188.163,0,0,2,188,2,188,0.572283000,0.0030
207.239.46.135,<->,136.25.188.198,0,0,2,188,2,188,0.571929000,0.0020
215.158.239.84,<->,195.96.156.37,2,188,0,0,2,188,0.571507000,0.0002
199.121.8.9,<->,136.25.188.224,0,0,2,188,2,188,0.570744000,0.0035
139.193.141.139,<->,136.99.104.229,2,772,0,0,2,772,0.570741000,1.0002
133.178.227.16,<->,61.72.108.214,2,2155,0,0,2,2155,0.570431000,0.9408
133.178.226.179,<->,91.42.57.252,2,698,0,0,2,698,0.570168000,1.0023
75.214.229.4,<->,8.252.221.230,0,0,2,904,2,904,0.569838000,1.0460
133.178.226.30,<->,122.158.49.180,2,2506,0,0,2,2506,0.569233000,0.0129
143.128.180.187,<->,136.25.188.252,0,0,2,957,2,957,0.568837000,0.0022
8.182.228.191,<->,6.133.203.187,2,549,0,0,2,549,0.568783000,0.0715
215.158.238.115,<->,131.144.114.216,2,2442,0,0,2,2442,0.568560000,1.1161
139.250.219.6,<->,50.224.122.17,0,0,2,1128,2,1128,0.568469000,0.0379
143.10.172.12,<->,136.25.188.253,0,0,2,188,2,188,0.568050000,0.0039
143.53.71.132,<->,136.25.188.209,0,0,2,188,2,188,0.567878000,0.0040
215.158.239.94,<->,29.209.59.247,2,2650,0,0,2,2650,0.567744000,0.1654
197.113.99.185,<->,136.25.188.252,0,0,2,188,2,188,0.567639000,0.0201
215.158.238.134,<->,119.196.23.52,2,2714,0,0,2,2714,0.567390000,1.1153
215.158.61.209,<->,8.252.223.10,0,0,2,704,2,704,0.567241000,1.3690
215.158.238.82,<->,38.104.11.36,2,2586,0,0,2,2586,0.567169000,0.8645
215.158.239.79,<->,199.70.221.36,2,937,0,0,2,937,0.566913000,0.0022
199.68.64.226,<->,136.25.188.255,0,0,2,906,2,906,0.566598000,0.4156
220.20.200.30,<->,144.83.60.153,2,1124,0,0,2,1124,0.566136000,1.3302
215.158.239.78,<->,199.20.31.74,2,1072,0,0,2,1072,0.564996000,0.4076
142.249.86.142,<->,136.25.188.174,0,0,2,953,2,953,0.564842000,0.0000
215.158.239.93,<->,196.93.49.247,2,1070,0,0,2,1070,0.564591000,0.2833
136.25.188.198,<->,50.18.121.78,2,466,0,0,2,466,0.564576000,0.0451
133.178.226.202,<->,111.158.193.231,2,1434,0,0,2,1434,0.564416000,0.4736
215.158.238.45,<->,129.175.139.72,2,2530,0,0,2,2530,0.564265000,1.1360
54.38.66.136,<->,48.52.162.238,0,0,2,239,2,239,0.563419000,0.5569
204.184.220.17,<->,136.25.188.176,0,0,2,971,2,971,0.563004000,0.4416
215.158.239.56,<->,207.63.2.86,2,777,0,0,2,777,0.562837000,0.4625
215.158.239.94,<->,194.234.173.124,2,774,0,0,2,774,0.562823000,0.1903
215.158.239.79,<->,199.20.30.147,2,1186,0,0,2,1186,0.562139000,1.1100
136.25.188.56,<->,96.155.61.60,2,666,0,0,2,666,0.561619000,0.6187
215.158.239.16,<->,145.13.164.245,2,416,0,0,2,416,0.560648000,0.2392
215.158.239.58,<->,199.20.29.103,2,188,0,0,2,188,0.559524000,0.0200
136.25.189.80,<->,29.212.199.54,2,2474,0,0,2,2474,0.559404000,0.4400
156.165.37.86,<->,136.25.189.90,0,0,2,2458,2,2458,0.558821000,1.0196
195.71.51.137,<->,136.25.188.252,0,0,2,1321,2,1321,0.558541000,0.0929
204.187.33.146,<->,136.25.188.252,0,0,2,978,2,978,0.558323000,0.1402
215.158.238.97,<->,80.47.111.74,2,2330,0,0,2,2330,0.558221000,1.0383
250.108.93.107,<->,159.137.162.213,0,0,2,676,2,676,0.557781000,0.3337
133.178.227.24,<->,68.231.26.212,2,2316,0,0,2,2316,0.557690000,0.5727
149.224.19.220,<->,97.198.118.56,0,0,2,1156,2,1156,0.557385000,0.0151
207.62.38.16,<->,136.25.188.241,0,0,2,188,2,188,0.557345000,0.0017
194.237.250.31,<->,136.25.188.238,0,0,2,188,2,188,0.556965000,0.0039
142.209.157.97,<->,136.25.188.174,0,0,2,178,2,178,0.556938000,0.0067
246.254.97.230,<->,54.55.44.79,2,1033,0,0,2,1033,0.556758000,0.1472
129.243.217.199,<->,80.27.157.224,0,0,2,438,2,438,0.556677000,0.3945
195.55.188.47,<->,136.25.188.53,0,0,2,1009,2,1009,0.556467000,0.1732
222.103.127.218,<->,80.27.157.12,0,0,2,2290,2,2290,0.556270000,0.9783
196.102.141.221,<->,101.70.118.242,0,0,2,268,2,268,0.556194000,0.5804
207.74.57.14,<->,8.252.222.7,0,0,2,416,2,416,0.555576000,0.4794
133.178.227.16,<->,131.144.113.150,2,2131,0,0,2,2131,0.555555000,0.4045
101.67.160.97,<->,8.52.186.156,0,0,2,1114,2,1114,0.555388000,0.1115
215.158.239.76,<->,204.61.205.154,2,656,0,0,2,656,0.555277000,0.3801
215.158.238.66,<->,113.23.104.213,2,2538,0,0,2,2538,0.555220000,0.2871
133.178.227.2,<->,69.150.169.225,2,2227,0,0,2,2227,0.554348000,0.6289
223.115.93.132,<->,8.252.222.23,0,0,2,188,2,188,0.553704000,0.0006
136.25.188.46,<->,92.57.203.84,2,188,0,0,2,188,0.553461000,0.0000
143.132.56.155,<->,136.25.188.254,0,0,2,188,2,188,0.553250000,0.0023
215.158.239.6,<->,122.159.245.162,2,2992,0,0,2,2992,0.552966000,0.6624
215.158.140.92,<->,8.190.217.1,2,2682,0,0,2,2682,0.552790000,0.4381
197.106.106.211,<->,8.182.253.233,0,0,2,455,2,455,0.552394000,0.1385
136.25.189.76,<->,96.156.169.229,2,346,0,0,2,346,0.551546000,1.3242
215.158.239.17,<->,114.223.238.144,2,964,0,0,2,964,0.551476000,0.9634
215.158.61.243,<->,8.176.8.215,0,0,2,1993,2,1993,0.551401000,1.2033
133.178.227.27,<->,61.35.22.228,2,2201,0,0,2,2201,0.551069000,1.1911
142.254.64.146,<->,136.25.188.163,0,0,2,188,2,188,0.550853000,0.0103
215.158.239.79,<->,199.106.51.143,2,1649,0,0,2,1649,0.550460000,0.1599
148.184.76.108,<->,0.195.210.42,0,0,2,432,2,432,0.550421000,0.1800
215.158.239.71,<->,120.154.225.209,2,2746,0,0,2,2746,0.550251000,0.7560
215.158.238.177,<->,156.181.145.3,2,2250,0,0,2,2250,0.550197000,1.1136
194.232.126.2,<->,136.25.188.177,0,0,2,1432,2,1432,0.549284000,1.3455
215.158.239.50,<->,196.107.166.42,2,188,0,0,2,188,0.548928000,0.0000
101.235.79.81,<->,89.74.85.198,2,610,0,0,2,610,0.547958000,0.2356
215.158.238.18,<->,8.181.147.46,2,1080,0,0,2,1080,0.547652000,0.0000
215.158.238.80,<->,113.23.20.251,2,2698,0,0,2,2698,0.546033000,0.6489
215.158.239.58,<->,194.238.200.253,2,164,0,0,2,164,0.546018000,0.0022
144.87.238.89,<->,8.182.244.237,0,0,2,466,2,466,0.545240000,0.2285
129.225.132.224,<->,129.225.131.135,2,1661,0,0,2,1661,0.545178000,1.4117
196.240.181.129,<->,136.25.188.198,0,0,2,1530,2,1530,0.544985000,0.6744
129.175.139.238,<->,8.176.8.111,0,0,2,458,2,458,0.544714000,0.2408
215.158.238.73,<->,126.219.196.185,2,2218,0,0,2,2218,0.543875000,1.1049
249.229.108.126,<->,144.75.218.95,0,0,2,642,2,642,0.543414000,0.1117
215.158.239.6,<->,158.166.175.250,2,388,0,0,2,388,0.542029000,0.4516
232.31.192.216,<->,97.198.118.56,0,0,2,791,2,791,0.540687000,0.0107
196.87.86.103,<->,136.25.188.210,0,0,2,979,2,979,0.540069000,0.1599
215.158.239.76,<->,195.83.163.240,2,1702,0,0,2,1702,0.540009000,0.5396
215.158.238.148,<->,29.213.195.62,2,1250,0,0,2,1250,0.539761000,1.1035
149.178.34.139,<->,100.228.42.102,0,0,2,1626,2,1626,0.539650000,0.0917
143.10.74.23,<->,136.25.188.222,0,0,2,443,2,443,0.538058000,1.3511
215.158.239.93,<->,199.20.6.209,2,188,0,0,2,188,0.538040000,0.0000
136.25.189.38,<->,96.156.169.218,2,426,0,0,2,426,0.537745000,0.2391
231.142.18.113,<->,215.158.239.57,0,0,2,656,2,656,0.537702000,0.1920
220.20.200.24,<->,144.83.60.153,2,1083,0,0,2,1083,0.537655000,0.5921
215.158.239.93,<->,207.166.174.122,2,188,0,0,2,188,0.537366000,0.0000
239.66.164.120,<->,97.198.118.56,0,0,2,1041,2,1041,0.537274000,0.0477
199.32.189.22,<->,136.25.188.178,0,0,2,188,2,188,0.537155000,0.0106
199.123.182.73,<->,136.25.188.54,0,0,2,188,2,188,0.536800000,0.0001
215.158.238.81,<->,112.220.206.24,2,2442,0,0,2,2442,0.536739000,0.6053
232.31.192.220,<->,97.198.118.56,0,0,2,1033,2,1033,0.536344000,0.6149
215.158.239.84,<->,196.94.238.65,2,1698,0,0,2,1698,0.536335000,0.9387
215.158.239.59,<->,199.20.29.164,2,959,0,0,2,959,0.536047000,0.0000
221.102.56.69,<->,192.67.172.205,0,0,2,588,2,588,0.535945000,0.0170
97.198.118.56,<->,27.11.142.84,2,825,0,0,2,825,0.535781000,0.2292
133.178.226.90,<->,111.151.239.86,2,2682,0,0,2,2682,0.535742000,0.5185
136.25.188.174,<->,104.3.161.85,2,2634,0,0,2,2634,0.535483000,0.4657
204.61.45.73,<->,136.25.188.243,0,0,2,656,2,656,0.535372000,0.1806
204.58.57.119,<->,136.25.188.237,0,0,2,485,2,485,0.535305000,1.3512
215.158.140.83,<->,8.53.217.116,2,2129,0,0,2,2129,0.534791000,1.0158
220.60.81.132,<->,215.158.239.78,0,0,2,2522,2,2522,0.534779000,0.9433
215.158.239.96,<->,196.107.117.216,2,188,0,0,2,188,0.534716000,0.0107
138.126.75.90,<->,136.25.188.221,0,0,2,2522,2,2522,0.534292000,0.5857
232.31.196.176,<->,97.198.118.56,0,0,2,918,2,918,0.534183000,0.0223
246.253.168.231,<->,104.134.162.189,2,662,0,0,2,662,0.533858000,0.2358
196.148.133.194,<->,119.223.114.169,2,1965,0,0,2,1965,0.533258000,0.2945
136.25.189.81,<->,120.154.131.20,2,2537,0,0,2,2537,0.533184000,0.8953
220.28.73.211,<->,215.158.238.202,0,0,2,1514,2,1514,0.532433000,0.5651
215.158.239.57,<->,114.25.48.33,2,2618,0,0,2,2618,0.532320000,0.9578
207.60.253.45,<->,136.25.188.209,0,0,2,388,2,388,0.531733000,0.0021
207.61.238.85,<->,136.25.188.163,0,0,2,955,2,955,0.531355000,0.4554
110.65.202.237,<->,50.224.76.235,0,0,2,2566,2,2566,0.530939000,0.0278
136.25.188.163,<->,8.255.92.213,2,2730,0,0,2,2730,0.530933000,1.1848
192.64.228.240,<->,8.49.69.216,2,282,0,0,2,282,0.530366000,0.0002
215.158.239.93,<->,196.111.90.208,2,2092,0,0,2,2092,0.529834000,0.3201
215.158.238.104,<->,143.227.65.158,2,2538,0,0,2,2538,0.529416000,0.8625
195.13.150.93,<->,136.25.188.225,0,0,2,799,2,799,0.528824000,0.0024
133.8.10.152,<->,33.233.141.55,0,0,2,1468,2,1468,0.528760000,0.3028
136.25.189.82,<->,119.196.23.24,2,2634,0,0,2,2634,0.528026000,0.7721
136.25.188.178,<->,131.144.113.189,2,2442,0,0,2,2442,0.527762000,0.7658
133.178.227.16,<->,38.104.11.171,2,2762,0,0,2,2762,0.527027000,0.3379
215.158.239.59,<->,72.23.194.230,2,1570,0,0,2,1570,0.526783000,0.9644
199.72.33.151,<->,136.25.188.198,0,0,2,188,2,188,0.526433000,0.0034
196.245.77.91,<->,136.25.188.176,0,0,2,959,2,959,0.526180000,0.0100
133.178.226.28,<->,8.241.236.64,2,2218,0,0,2,2218,0.526034000,0.3692
239.66.21.86,<->,97.198.118.56,0,0,2,844,2,844,0.525671000,0.1741
215.158.239.92,<->,199.20.28.132,2,1284,0,0,2,1284,0.525595000,0.7586
215.158.238.72,<->,116.106.60.162,2,2538,0,0,2,2538,0.525592000,0.7666
232.31.148.10,<->,97.198.118.56,0,0,2,855,2,855,0.525581000,0.0187
204.187.39.175,<->,136.25.188.238,0,0,2,962,2,962,0.525139000,0.0000
215.158.239.70,<->,106.188.253.148,2,2754,0,0,2,2754,0.523819000,1.4062
215.158.239.58,<->,199.68.125.89,2,188,0,0,2,188,0.523567000,0.0037
215.158.239.92,<->,142.236.129.128,2,954,0,0,2,954,0.522918000,0.1796
136.25.189.39,<->,96.156.169.164,2,788,0,0,2,788,0.522626000,0.2800
207.172.246.75,<->,136.25.188.209,0,0,2,479,2,479,0.522490000,0.6000
215.158.239.85,<->,199.20.29.115,2,774,0,0,2,774,0.522466000,0.2885
215.158.239.17,<->,8.255.92.139,2,2279,0,0,2,2279,0.522381000,1.4112
215.158.238.98,<->,33.209.217.237,2,2661,0,0,2,2661,0.522289000,0.3197
136.25.189.18,<->,96.156.169.182,2,2570,0,0,2,2570,0.521534000,1.0062
215.158.238.90,<->,100.224.166.158,2,1011,0,0,2,1011,0.521439000,0.4688
199.38.118.206,<->,136.25.188.237,0,0,2,188,2,188,0.521298000,0.0039
159.223.99.55,<->,8.52.134.29,0,0,2,656,2,656,0.521224000,0.0423
215.158.239.6,<->,8.219.187.245,2,2289,0,0,2,2289,0.520793000,0.9243
133.178.227.1,<->,8.219.184.95,2,2146,0,0,2,2146,0.520787000,0.6306
215.158.239.87,<->,199.20.31.0,2,543,0,0,2,543,0.520647000,0.3506
215.158.239.49,<->,199.20.31.199,2,462,0,0,2,462,0.520094000,0.8793
159.137.162.213,<->,50.72.253.151,2,676,0,0,2,676,0.520086000,0.2202
192.229.216.117,<->,159.223.99.55,2,656,0,0,2,656,0.519949000,0.0385
136.25.189.29,<->,89.80.251.22,2,2362,0,0,2,2362,0.519925000,0.4351
130.6.43.35,<->,92.27.27.150,0,0,2,2792,2,2792,0.519507000,0.9075
215.158.238.66,<->,122.158.179.40,2,2490,0,0,2,2490,0.519249000,0.6762
136.25.188.198,<->,131.1.253.245,2,2820,0,0,2,2820,0.518798000,0.8851
220.39.202.203,<->,215.158.238.54,0,0,2,2810,2,2810,0.518280000,1.0533
133.178.227.19,<->,68.231.10.139,2,2682,0,0,2,2682,0.518164000,1.2188
136.25.189.2,<->,29.211.93.23,2,2554,0,0,2,2554,0.518065000,0.2668
215.158.239.56,<->,195.54.120.30,2,656,0,0,2,656,0.518004000,0.2323
221.102.143.189,<->,109.1.35.27,0,0,2,1635,2,1635,0.516735000,0.0750
215.158.239.79,<->,120.154.71.23,2,2682,0,0,2,2682,0.515895000,0.2718
215.158.239.85,<->,207.190.47.122,2,1086,0,0,2,1086,0.515872000,0.4973
133.178.227.250,<->,8.191.15.151,2,1522,0,0,2,1522,0.515680000,0.0416
220.28.73.211,<->,136.25.189.84,0,0,2,1272,2,1272,0.515404000,0.2465
231.142.18.113,<->,215.158.239.79,0,0,2,656,2,656,0.514164000,0.1685
215.158.239.56,<->,195.81.16.191,2,1594,0,0,2,1594,0.514128000,0.0993
142.249.41.31,<->,136.25.188.174,0,0,2,1616,2,1616,0.513944000,0.2780
142.220.22.18,<->,136.25.188.208,0,0,2,202,2,202,0.513237000,0.5325
215.158.239.84,<->,204.3.184.181,2,188,0,0,2,188,0.513105000,0.0039
215.158.238.133,<->,29.212.43.247,2,2378,0,0,2,2378,0.512984000,1.4252
204.200.63.254,<->,136.25.188.236,0,0,2,188,2,188,0.512739000,0.0064
142.248.146.243,<->,136.25.188.252,0,0,2,656,2,656,0.512317000,0.3342
215.158.239.70,<->,143.72.203.225,2,292,0,0,2,292,0.512202000,0.6721
215.158.238.67,<->,112.220.206.107,2,1441,0,0,2,1441,0.511983000,0.9807
133.178.226.37,<->,29.214.108.118,2,2730,0,0,2,2730,0.511901000,0.2409
215.158.239.84,<->,196.109.217.85,2,188,0,0,2,188,0.511233000,0.0599
215.158.140.76,<->,61.72.108.214,2,2123,0,0,2,2123,0.511124000,1.2142
215.158.239.76,<->,199.20.30.73,2,188,0,0,2,188,0.510794000,0.0001
235.253.220.218,<->,215.158.140.75,0,0,2,2317,2,2317,0.509934000,0.6013
207.63.14.182,<->,136.25.188.226,0,0,2,188,2,188,0.509407000,0.0029
136.25.188.34,<->,96.234.103.82,2,2100,0,0,2,2100,0.508831000,1.3947
194.234.232.255,<->,136.25.188.178,0,0,2,849,2,849,0.507255000,0.4716
54.36.178.66,<->,48.52.240.82,0,0,2,884,2,884,0.506044000,1.4745
199.69.16.7,<->,136.25.188.46,0,0,2,188,2,188,0.505249000,0.0037
199.39.246.95,<->,136.25.188.163,0,0,2,188,2,188,0.505240000,0.0030
199.121.168.2,<->,136.25.188.196,0,0,2,188,2,188,0.504943000,0.0037
215.158.140.231,<->,29.211.6.200,2,2424,0,0,2,2424,0.503561000,1.0230
215.158.238.196,<->,215.158.127.101,2,2208,0,0,2,2208,0.503377000,1.2858
207.190.226.56,<->,136.25.188.239,0,0,2,188,2,188,0.503340000,0.0017
195.40.59.37,<->,136.25.188.209,0,0,2,164,2,164,0.503311000,0.0024
149.96.171.91,<->,136.25.189.45,0,0,2,2554,2,2554,0.503021000,0.5613
215.158.239.196,<->,113.23.17.205,2,2416,0,0,2,2416,0.502512000,0.0002
195.124.60.10,<->,136.25.188.176,0,0,2,937,2,937,0.502248000,0.9895
144.71.43.13,<->,84.22.240.243,2,1382,0,0,2,1382,0.502194000,0.1625
199.32.227.43,<->,136.25.188.52,0,0,2,922,2,922,0.501416000,0.0027
196.247.213.16,<->,136.25.188.45,0,0,2,188,2,188,0.501185000,0.0315
215.158.238.83,<->,113.23.104.245,2,2394,0,0,2,2394,0.501118000,1.3880
215.158.140.60,<->,192.227.190.9,2,2163,0,0,2,2163,0.501050000,0.4552
235.200.13.198,<->,133.178.227.108,0,0,2,508,2,508,0.500912000,1.0702
220.38.84.245,<->,215.158.239.78,0,0,2,1458,2,1458,0.500821000,0.8393
204.61.34.127,<->,136.25.188.236,0,0,2,1034,2,1034,0.500770000,0.5282
199.121.168.2,<->,136.25.188.52,0,0,2,188,2,188,0.500426000,0.0021
249.85.37.11,<->,8.20.87.32,0,0,2,984,2,984,0.500368000,0.0000
200.175.105.196,<->,53.244.210.133,2,1319,0,0,2,1319,0.499014000,0.5366
48.19.239.25,<->,8.252.222.156,0,0,2,440,2,440,0.497578000,0.3505
215.158.239.34,<->,215.158.127.158,2,2411,0,0,2,2411,0.497236000,0.3131
136.25.188.45,<->,8.190.216.201,2,2698,0,0,2,2698,0.496984000,0.2645
215.158.239.99,<->,142.207.184.231,2,774,0,0,2,774,0.496656000,0.1643
205.127.108.113,<->,33.233.141.41,0,0,2,291,2,291,0.495958000,0.6297
215.158.239.56,<->,199.20.31.184,2,1072,0,0,2,1072,0.495783000,0.2440
215.158.239.92,<->,195.43.81.103,2,945,0,0,2,945,0.495412000,0.0000
215.158.239.56,<->,142.182.53.83,2,439,0,0,2,439,0.495201000,0.9463
199.51.165.49,<->,136.25.188.174,0,0,2,440,2,440,0.495131000,0.2379
136.25.188.52,<->,113.23.20.242,2,2570,0,0,2,2570,0.494916000,1.3935
133.178.226.70,<->,8.219.184.156,2,2508,0,0,2,2508,0.494884000,0.3840
136.25.188.162,<->,131.144.113.188,2,2586,0,0,2,2586,0.494009000,0.2537
133.178.227.1,<->,48.129.133.61,2,2458,0,0,2,2458,0.493763000,0.8726
215.158.239.87,<->,149.96.171.27,2,2250,0,0,2,2250,0.493458000,1.4221
118.37.87.250,<->,92.27.219.207,0,0,2,640,2,640,0.493218000,0.7239
109.222.217.220,<->,53.231.222.144,2,676,0,0,2,676,0.492861000,0.0000
136.25.188.254,<->,8.188.227.39,2,2474,0,0,2,2474,0.492714000,1.3039
215.158.239.70,<->,199.20.28.46,2,188,0,0,2,188,0.492185000,0.0360
215.158.238.221,<->,140.19.166.246,2,2634,0,0,2,2634,0.492044000,0.4264
148.26.113.100,<->,133.178.227.70,0,0,2,2111,2,2111,0.491681000,1.3455
136.25.188.162,<->,41.142.21.110,2,314,0,0,2,314,0.491104000,0.7412
195.55.52.115,<->,136.25.188.252,0,0,2,164,2,164,0.490600000,0.0000
215.158.238.141,<->,131.1.253.245,2,2657,0,0,2,2657,0.490537000,0.6547
215.158.238.148,<->,192.227.190.245,2,1522,0,0,2,1522,0.489828000,0.7657
249.85.61.6,<->,99.75.192.222,0,0,2,666,2,666,0.489713000,1.4668
56.8.135.115,<->,8.182.226.78,0,0,2,418,2,418,0.489672000,0.0319
53.160.44.69,<->,48.53.36.9,0,0,2,126,2,126,0.489660000,1.0582
136.25.188.236,<->,112.235.95.73,2,2618,0,0,2,2618,0.489518000,0.7635
192.227.190.232,<->,133.178.226.38,0,0,2,458,2,458,0.489128000,0.2565
215.158.238.134,<->,144.253.73.100,2,2697,0,0,2,2697,0.489006000,0.6919
215.158.239.85,<->,143.42.144.172,2,279,0,0,2,279,0.488856000,0.8534
98.230.219.5,<->,8.183.25.124,0,0,2,489,2,489,0.488817000,0.6187
215.158.238.33,<->,57.199.250.215,2,2586,0,0,2,2586,0.487786000,1.1218
127.168.165.134,<->,8.176.8.232,0,0,2,680,2,680,0.487546000,0.0960
197.113.99.67,<->,136.25.188.238,0,0,2,1669,2,1669,0.487482000,0.7595
141.199.76.231,<->,136.25.189.16,0,0,2,2442,2,2442,0.487455000,1.4201
215.158.140.60,<->,148.190.126.44,2,2162,0,0,2,2162,0.487266000,1.4743
136.25.188.55,<->,112.235.95.21,2,2362,0,0,2,2362,0.486858000,1.2697
218.4.168.98,<->,66.90.171.112,2,239,0,0,2,239,0.486771000,1.4066
35.55.212.12,<->,8.182.251.42,0,0,2,453,2,453,0.486632000,0.2961
106.30.133.175,<->,0.195.210.42,0,0,2,150,2,150,0.486327000,1.2080
60.101.123.202,<->,8.252.221.230,0,0,2,908,2,908,0.485791000,1.0343
215.158.238.47,<->,112.220.206.117,2,2394,0,0,2,2394,0.485710000,1.3401
215.158.238.148,<->,113.23.104.203,2,2570,0,0,2,2570,0.484391000,1.4437
139.163.96.101,<->,135.81.38.138,2,447,0,0,2,447,0.483865000,0.0002
196.148.131.155,<->,89.155.31.210,2,608,0,0,2,608,0.483306000,0.0179
215.158.238.75,<->,65.27.228.222,2,2378,0,0,2,2378,0.482548000,0.4763
156.165.37.109,<->,133.178.227.1,0,0,2,2762,2,2762,0.482459000,1.0314
215.158.61.242,<->,8.176.8.244,0,0,2,2282,2,2282,0.482113000,0.0001
215.158.238.148,<->,106.188.183.87,2,278,0,0,2,278,0.481977000,1.1735
215.158.239.95,<->,199.20.31.7,2,188,0,0,2,188,0.481812000,0.0596
197.113.64.188,<->,136.25.188.46,0,0,2,188,2,188,0.481097000,0.0080
215.158.238.65,<->,56.161.218.53,2,2442,0,0,2,2442,0.480974000,1.1420
215.158.140.93,<->,131.219.110.150,2,2611,0,0,2,2611,0.480397000,0.6876
221.102.56.69,<->,192.67.115.110,0,0,2,588,2,588,0.479935000,0.0077
95.246.109.87,<->,8.252.221.221,0,0,2,594,2,594,0.479930000,1.0824
215.158.140.92,<->,148.26.113.122,2,2286,0,0,2,2286,0.479084000,0.9500
136.25.188.45,<->,27.178.41.39,2,2634,0,0,2,2634,0.478664000,0.7097
215.158.238.80,<->,80.47.111.87,2,2442,0,0,2,2442,0.477260000,0.7176
136.25.188.243,<->,27.178.41.26,2,2490,0,0,2,2490,0.477130000,1.0469
136.25.188.48,<->,100.224.202.184,2,725,0,0,2,725,0.476305000,1.0678
215.158.239.56,<->,199.20.29.135,2,432,0,0,2,432,0.475945000,0.9998
215.158.238.141,<->,106.188.251.194,2,2653,0,0,2,2653,0.475848000,0.4255
136.25.189.32,<->,118.20.100.138,2,2778,0,0,2,2778,0.475571000,0.4579
159.137.162.213,<->,38.90.68.83,2,676,0,0,2,676,0.474983000,0.3634
215.158.239.56,<->,199.20.28.96,2,1079,0,0,2,1079,0.474324000,0.2100
197.125.126.184,<->,136.25.188.54,0,0,2,2586,2,2586,0.473823000,0.5934
132.60.127.206,<->,80.41.56.251,0,0,2,318,2,318,0.473162000,1.0737
111.147.123.1,<->,53.167.23.222,2,1418,0,0,2,1418,0.472903000,1.4134
215.158.239.70,<->,204.56.18.191,2,656,0,0,2,656,0.472891000,0.3350
195.14.252.131,<->,136.25.188.239,0,0,2,188,2,188,0.471978000,0.0022
97.182.34.181,<->,8.220.178.166,0,0,2,969,2,969,0.471518000,1.0021
136.25.188.172,<->,8.222.212.22,2,2394,0,0,2,2394,0.470731000,0.1450
133.178.227.16,<->,33.209.213.2,2,2195,0,0,2,2195,0.470461000,0.6137
111.147.87.240,<->,89.205.197.79,2,899,0,0,2,899,0.469982000,0.4975
215.158.239.45,<->,98.219.126.175,2,1151,0,0,2,1151,0.469418000,0.2153
215.158.140.204,<->,8.222.7.162,2,1258,0,0,2,1258,0.468720000,1.4934
215.158.238.93,<->,122.158.51.85,2,2426,0,0,2,2426,0.468450000,0.5958
200.174.199.230,<->,53.200.182.229,2,458,0,0,2,458,0.467696000,0.2935
215.158.239.95,<->,207.191.209.155,2,774,0,0,2,774,0.467367000,0.2182
215.158.239.76,<->,199.78.166.34,2,188,0,0,2,188,0.467081000,0.0000
142.252.3.127,<->,136.25.188.227,0,0,2,1718,2,1718,0.466825000,0.2660
246.253.217.179,<->,111.88.67.179,2,580,0,0,2,580,0.466796000,0.0530
136.25.189.14,<->,61.35.70.233,2,2714,0,0,2,2714,0.466129000,0.9969
215.158.239.85,<->,199.20.31.245,2,188,0,0,2,188,0.466010000,0.0101
204.58.140.60,<->,136.25.188.210,0,0,2,984,2,984,0.466002000,0.0044
195.7.21.17,<->,136.25.188.254,0,0,2,188,2,188,0.465883000,0.0023
247.136.217.118,<->,8.20.81.74,2,2322,0,0,2,2322,0.465311000,0.1040
215.158.239.41,<->,8.252.253.227,2,248,0,0,2,248,0.465238000,1.2119
215.158.239.49,<->,195.96.152.197,2,774,0,0,2,774,0.464707000,0.2180
215.158.238.114,<->,104.154.137.220,2,2826,0,0,2,2826,0.464533000,0.6963
100.224.23.128,<->,89.183.104.181,0,0,2,813,2,813,0.464348000,0.4428
136.25.188.254,<->,104.3.161.25,2,2602,0,0,2,2602,0.463796000,0.7050
215.158.239.76,<->,199.20.30.219,2,1383,0,0,2,1383,0.463723000,1.3226
136.25.188.236,<->,108.47.170.254,2,188,0,0,2,188,0.463436000,0.0000
194.205.112.171,<->,136.25.188.255,0,0,2,2714,2,2714,0.463266000,0.5804
220.39.233.40,<->,133.178.227.76,0,0,2,2167,2,2167,0.463188000,0.8973
199.33.30.127,<->,136.25.188.255,0,0,2,531,2,531,0.463114000,0.3077
100.112.36.136,<->,8.52.188.77,0,0,2,767,2,767,0.462990000,1.3751
136.25.189.15,<->,96.156.169.160,2,315,0,0,2,315,0.462877000,1.0990
139.172.184.28,<->,0.195.210.44,0,0,2,266,2,266,0.462677000,0.0781
197.113.99.231,<->,136.25.188.196,0,0,2,966,2,966,0.462670000,0.0390
143.76.170.0,<->,8.182.239.190,0,0,2,466,2,466,0.462668000,0.1787
142.236.7.253,<->,136.25.188.174,0,0,2,188,2,188,0.462554000,0.0000
215.158.239.49,<->,207.191.194.245,2,188,0,0,2,188,0.462385000,0.0024
143.79.26.120,<->,136.25.188.178,0,0,2,440,2,440,0.462238000,0.2213
215.158.238.223,<->,106.188.244.246,2,2116,0,0,2,2116,0.462065000,1.1203
136.25.188.55,<->,131.144.114.231,2,2586,0,0,2,2586,0.461953000,0.9748
136.25.188.242,<->,116.106.61.245,2,2714,0,0,2,2714,0.461592000,0.6116
136.139.59.124,<->,136.25.188.223,0,0,2,2490,2,2490,0.460965000,1.2538
221.102.56.69,<->,192.64.225.2,0,0,2,588,2,588,0.460703000,0.0639
243.117.82.36,<->,129.78.117.164,0,0,2,1518,2,1518,0.460661000,0.5103
133.244.28.235,<->,42.197.145.216,2,126,0,0,2,126,0.459981000,0.1117
93.181.154.50,<->,92.27.219.219,0,0,2,100,2,100,0.459831000,0.1669
136.25.188.52,<->,57.160.181.180,2,2554,0,0,2,2554,0.459774000,0.4704
246.253.157.31,<->,198.105.44.83,2,1684,0,0,2,1684,0.459453000,0.3779
194.253.195.60,<->,8.220.190.86,0,0,2,806,2,806,0.458768000,1.0856
220.28.115.46,<->,133.178.227.21,0,0,2,1392,2,1392,0.458716000,0.4810
215.158.238.135,<->,192.227.190.234,2,570,0,0,2,570,0.458572000,1.1173
133.178.226.60,<->,113.23.104.247,2,454,0,0,2,454,0.457492000,1.2063
242.22.195.14,<->,100.228.42.92,0,0,2,1138,2,1138,0.457345000,0.0004
120.83.30.208,<->,101.70.116.99,0,0,2,112,2,112,0.457257000,0.2137
142.191.1.22,<->,136.25.188.46,0,0,2,949,2,949,0.457127000,0.0019
133.178.226.77,<->,57.210.107.8,2,1378,0,0,2,1378,0.456820000,0.3277
215.158.238.47,<->,122.158.51.87,2,2554,0,0,2,2554,0.456405000,1.4774
215.158.238.236,<->,8.192.205.0,2,2093,0,0,2,2093,0.456024000,1.4409
215.158.238.81,<->,116.106.60.156,2,2474,0,0,2,2474,0.455984000,1.2050
97.126.124.195,<->,54.48.104.170,2,1184,0,0,2,1184,0.455885000,0.2951
204.200.56.84,<->,136.25.188.54,0,0,2,188,2,188,0.455829000,0.0063
231.142.65.52,<->,215.158.239.68,0,0,2,656,2,656,0.455582000,0.1567
215.158.239.50,<->,68.124.221.183,2,2570,0,0,2,2570,0.455476000,1.4985
215.158.239.92,<->,196.104.200.133,2,1018,0,0,2,1018,0.455386000,0.5506
215.158.239.92,<->,199.20.7.21,2,774,0,0,2,774,0.455375000,0.2886
215.158.239.70,<->,116.106.46.111,2,1515,0,0,2,1515,0.454625000,0.3680
215.158.238.120,<->,143.155.227.57,2,1338,0,0,2,1338,0.454288000,0.3520
215.158.239.86,<->,199.20.28.26,2,188,0,0,2,188,0.454282000,0.0000
220.28.114.28,<->,215.158.238.124,0,0,2,2571,2,2571,0.454255000,0.0000
215.158.238.135,<->,38.104.11.27,2,2426,0,0,2,2426,0.453991000,0.3587
215.158.61.182,<->,8.176.8.103,0,0,2,1722,2,1722,0.453793000,0.2252
215.158.238.134,<->,33.220.0.39,2,1162,0,0,2,1162,0.453361000,1.4082
220.28.114.25,<->,111.147.106.141,0,0,2,324,2,324,0.452875000,1.2461
136.25.188.237,<->,65.27.220.219,2,2442,0,0,2,2442,0.452726000,1.1527
194.253.89.181,<->,8.252.222.179,0,0,2,923,2,923,0.452621000,0.4098
215.158.238.209,<->,8.192.205.0,2,2076,0,0,2,2076,0.452599000,0.4839
215.158.239.85,<->,29.212.180.168,2,2570,0,0,2,2570,0.451621000,0.9935
133.178.226.30,<->,131.36.198.58,2,1665,0,0,2,1665,0.451204000,0.3678
136.25.188.172,<->,131.1.253.227,2,2634,0,0,2,2634,0.449075000,1.1558
215.158.238.223,<->,131.144.114.248,2,2762,0,0,2,2762,0.448850000,0.5219
136.25.189.12,<->,72.23.194.201,2,2570,0,0,2,2570,0.448024000,1.1333
95.247.133.246,<->,8.252.221.236,0,0,2,908,2,908,0.447781000,1.0551
8.49.69.216,<->,6.122.206.86,0,0,2,1130,2,1130,0.447196000,0.4601
215.158.238.99,<->,118.20.87.7,2,2426,0,0,2,2426,0.446451000,1.4641
129.225.134.223,<->,129.225.132.93,0,0,2,1122,2,1122,0.446310000,0.1403
215.158.238.143,<->,106.188.183.71,2,1380,0,0,2,1380,0.446233000,0.8528
142.240.138.78,<->,136.25.188.178,0,0,2,188,2,188,0.446133000,0.0137
144.232.206.169,<->,8.183.24.167,0,0,2,680,2,680,0.445655000,0.0936
100.115.92.194,<->,97.110.90.36,2,167,0,0,2,167,0.445127000,0.0957
192.227.190.233,<->,133.178.226.7,0,0,2,442,2,442,0.444499000,0.2073
215.158.239.70,<->,196.93.60.100,2,188,0,0,2,188,0.444391000,0.0200
215.158.239.193,<->,137.107.106.106,2,212,0,0,2,212,0.444272000,0.0000
207.61.128.138,<->,136.25.188.54,0,0,2,768,2,768,0.443709000,0.0023
54.92.36.247,<->,48.52.173.199,0,0,2,186,2,186,0.443310000,0.0003
195.15.4.117,<->,136.25.188.53,0,0,2,188,2,188,0.441712000,0.0022
101.224.89.146,<->,27.127.249.118,2,124,0,0,2,124,0.441510000,0.9998
215.158.239.96,<->,199.20.29.73,2,1732,0,0,2,1732,0.440514000,0.5685
215.158.238.83,<->,57.210.107.19,2,2458,0,0,2,2458,0.439796000,0.7795
143.128.55.116,<->,136.25.188.236,0,0,2,410,2,410,0.439541000,1.2454
215.158.238.132,<->,122.158.51.86,2,2442,0,0,2,2442,0.439404000,1.4088
35.55.85.31,<->,8.182.226.78,0,0,2,2498,2,2498,0.439335000,0.6004
215.158.239.77,<->,207.61.17.38,2,439,0,0,2,439,0.439108000,0.5869
215.158.140.184,<->,8.222.7.181,2,2090,0,0,2,2090,0.438785000,1.2483
215.158.238.241,<->,104.3.168.52,2,2650,0,0,2,2650,0.438723000,1.3647
204.61.83.116,<->,136.25.188.199,0,0,2,944,2,944,0.438641000,0.0024
215.158.238.73,<->,126.219.132.243,2,2778,0,0,2,2778,0.438467000,0.4535
215.158.239.70,<->,29.209.59.173,2,2730,0,0,2,2730,0.438025000,0.8183
215.158.239.58,<->,199.20.29.73,2,1732,0,0,2,1732,0.438020000,0.5384
159.178.67.213,<->,8.52.183.27,0,0,2,980,2,980,0.437304000,0.8435
215.158.238.219,<->,56.100.165.44,2,2081,0,0,2,2081,0.436882000,0.0023
215.158.239.56,<->,196.94.244.232,2,186,0,0,2,186,0.436752000,0.0010
215.158.239.93,<->,199.20.31.143,2,1754,0,0,2,1754,0.436490000,0.0001
142.166.44.184,<->,136.25.188.255,0,0,2,1728,2,1728,0.436195000,0.0460
136.25.188.220,<->,8.42.43.36,2,2698,0,0,2,2698,0.435961000,0.2369
247.127.89.61,<->,221.102.105.151,0,0,2,1664,2,1664,0.434145000,0.0856
199.70.73.92,<->,136.25.188.210,0,0,2,1434,2,1434,0.433448000,1.3579
215.158.239.77,<->,199.20.31.28,2,188,0,0,2,188,0.433437000,0.0000
215.158.238.64,<->,111.150.34.233,2,2682,0,0,2,2682,0.432906000,1.2294
215.158.61.195,<->,8.176.8.251,0,0,2,250,2,250,0.432673000,0.6797
216.184.2.177,<->,6.73.247.53,0,0,2,1122,2,1122,0.432187000,0.0001
136.25.189.1,<->,56.161.218.55,2,2730,0,0,2,2730,0.431303000,1.0939
111.20.172.118,<->,101.224.89.174,0,0,2,669,2,669,0.431006000,0.0000
136.25.189.1,<->,96.156.169.247,2,2954,0,0,2,2954,0.430936000,1.5483
215.158.238.243,<->,8.221.197.178,2,2259,0,0,2,2259,0.430846000,1.5139
133.178.226.31,<->,114.25.48.34,2,2602,0,0,2,2602,0.430791000,1.4631
136.25.189.46,<->,113.92.151.54,2,1234,0,0,2,1234,0.430517000,1.1281
210.220.218.45,<->,14.27.112.67,2,1814,0,0,2,1814,0.430451000,1.1489
220.83.56.195,<->,8.45.162.111,2,1528,0,0,2,1528,0.430207000,0.0646
100.95.89.103,<->,89.86.110.174,2,2960,0,0,2,2960,0.429518000,0.0001
215.158.238.220,<->,69.150.169.168,2,2111,0,0,2,2111,0.428308000,1.3940
199.72.82.90,<->,136.25.188.252,0,0,2,782,2,782,0.428056000,0.0021
142.244.125.239,<->,136.25.188.198,0,0,2,188,2,188,0.427880000,0.0022
204.184.56.37,<->,136.25.188.242,0,0,2,859,2,859,0.427871000,0.2400
195.13.205.78,<->,136.25.188.196,0,0,2,656,2,656,0.427645000,0.1598
136.25.188.175,<->,131.1.253.250,2,2701,0,0,2,2701,0.427633000,1.3048
215.158.239.48,<->,195.83.199.181,2,188,0,0,2,188,0.427439000,0.0109
215.158.239.30,<->,106.188.184.70,2,270,0,0,2,270,0.427385000,1.5695
215.158.239.71,<->,204.21.8.14,2,845,0,0,2,845,0.427325000,0.2112
136.25.189.18,<->,8.249.253.227,2,2506,0,0,2,2506,0.427242000,1.1991
204.200.164.92,<->,136.25.188.252,0,0,2,656,2,656,0.426829000,0.7515
246.253.134.204,<->,30.199.160.160,2,2487,0,0,2,2487,0.425658000,0.2793
231.143.121.182,<->,136.25.188.242,0,0,2,954,2,954,0.425529000,1.4601
196.88.17.105,<->,136.25.188.236,0,0,2,774,2,774,0.425262000,0.2179
215.158.239.97,<->,199.20.5.42,2,1066,0,0,2,1066,0.424870000,0.8295
69.103.57.90,<->,8.252.222.63,0,0,2,188,2,188,0.423905000,0.0000
215.158.239.77,<->,29.211.5.251,2,2666,0,0,2,2666,0.423256000,0.3733
215.158.140.241,<->,93.39.51.73,2,2087,0,0,2,2087,0.422572000,1.4856
136.25.188.221,<->,131.1.232.148,2,2570,0,0,2,2570,0.422462000,0.3750
195.68.106.161,<->,136.25.188.163,0,0,2,1204,2,1204,0.422398000,1.2400
207.173.107.121,<->,136.25.188.178,0,0,2,987,2,987,0.422315000,0.3640
192.176.58.4,<->,136.25.188.209,0,0,2,188,2,188,0.422194000,0.0011
210.220.219.181,<->,53.224.207.241,2,922,0,0,2,922,0.422167000,1.1144
205.127.108.114,<->,33.233.141.229,0,0,2,1078,2,1078,0.421928000,0.1997
215.158.239.58,<->,196.89.8.21,2,680,0,0,2,680,0.421901000,0.2462
220.50.215.94,<->,50.224.80.75,0,0,2,424,2,424,0.421485000,1.3432
199.69.114.237,<->,136.25.188.163,0,0,2,188,2,188,0.420830000,0.0038
133.178.226.38,<->,65.27.220.217,2,2666,0,0,2,2666,0.420709000,0.5840
143.155.228.1,<->,133.178.226.18,0,0,2,2394,2,2394,0.420657000,0.8551
197.125.126.184,<->,136.25.188.172,0,0,2,2778,2,2778,0.420650000,0.6013
204.62.176.229,<->,136.25.188.196,0,0,2,472,2,472,0.420174000,0.9574
229.45.129.61,<->,129.19.188.26,2,782,0,0,2,782,0.420028000,0.1272
215.158.239.32,<->,29.212.196.37,2,1708,0,0,2,1708,0.419671000,0.3321
199.80.212.72,<->,136.25.188.196,0,0,2,202,2,202,0.419230000,1.2228
53.201.28.135,<->,48.53.37.64,0,0,2,1222,2,1222,0.419143000,1.0364
215.158.238.134,<->,131.144.113.163,2,2570,0,0,2,2570,0.418703000,0.5645
142.236.50.26,<->,136.25.188.175,0,0,2,188,2,188,0.418041000,0.0019
136.139.59.124,<->,136.25.188.178,0,0,2,2378,2,2378,0.417612000,1.1044
215.158.238.82,<->,126.219.194.140,2,2538,0,0,2,2538,0.417056000,0.7143
111.20.171.168,<->,111.20.168.10,0,0,2,118,2,118,0.417039000,0.0848
215.158.239.78,<->,126.219.194.74,2,2801,0,0,2,2801,0.416951000,0.3214
136.25.188.209,<->,56.9.75.29,2,1653,0,0,2,1653,0.416910000,0.0862
215.158.239.84,<->,195.6.243.121,2,774,0,0,2,774,0.416877000,0.8976
53.161.180.137,<->,48.55.35.116,0,0,2,174,2,174,0.416456000,0.9996
207.92.37.152,<->,8.182.136.192,0,0,2,656,2,656,0.416125000,0.1516
156.165.37.73,<->,136.25.189.59,0,0,2,2506,2,2506,0.416104000,0.9931
215.158.238.92,<->,42.226.3.104,2,2538,0,0,2,2538,0.416044000,1.3293
136.25.188.238,<->,116.121.217.57,2,432,0,0,2,432,0.415880000,0.1687
215.158.239.99,<->,199.73.139.11,2,1077,0,0,2,1077,0.414815000,0.3006
133.178.227.27,<->,126.219.132.35,2,2168,0,0,2,2168,0.414724000,0.8138
142.249.104.17,<->,136.25.188.176,0,0,2,953,2,953,0.414486000,0.0026
204.200.41.38,<->,136.25.188.241,0,0,2,1303,2,1303,0.413944000,0.6114
129.5.109.106,<->,111.20.168.184,0,0,2,124,2,124,0.413585000,1.0020
159.137.162.213,<->,110.43.86.177,2,676,0,0,2,676,0.413429000,0.2298
199.53.111.156,<->,136.25.188.252,0,0,2,188,2,188,0.412807000,0.0042
215.158.239.71,<->,120.154.131.7,2,2442,0,0,2,2442,0.412692000,1.3352
148.224.137.73,<->,136.25.188.172,0,0,2,2698,2,2698,0.412643000,0.6457
215.158.239.48,<->,195.96.140.134,2,188,0,0,2,188,0.412011000,0.0010
215.158.238.107,<->,99.192.168.153,2,2700,0,0,2,2700,0.411831000,0.1030
215.158.238.47,<->,119.196.23.26,2,2746,0,0,2,2746,0.411265000,0.4357
204.56.252.49,<->,136.25.188.163,0,0,2,1122,2,1122,0.410941000,0.4115
215.158.239.33,<->,96.135.154.101,2,2350,0,0,2,2350,0.410917000,0.5438
215.158.239.70,<->,56.161.218.37,2,2730,0,0,2,2730,0.410416000,0.9776
215.158.238.104,<->,6.116.31.30,2,2586,0,0,2,2586,0.410185000,0.4075
215.158.239.33,<->,8.252.253.180,2,1580,0,0,2,1580,0.409899000,1.1311
136.25.189.33,<->,29.211.93.23,2,2714,0,0,2,2714,0.409660000,0.2279
215.158.239.58,<->,199.20.29.134,2,188,0,0,2,188,0.409009000,0.0000
123.129.29.205,<->,111.20.168.190,0,0,2,124,2,124,0.408078000,1.0024
214.237.183.201,<->,0.195.210.46,0,0,2,1720,2,1720,0.408061000,0.1477
204.60.97.95,<->,136.25.188.177,0,0,2,188,2,188,0.408040000,0.0200
215.158.239.92,<->,199.20.63.99,2,1946,0,0,2,1946,0.407883000,1.5399
143.12.65.89,<->,136.25.188.52,0,0,2,178,2,178,0.406983000,0.8340
195.40.236.53,<->,136.25.188.209,0,0,2,1786,2,1786,0.406395000,0.8069
215.158.140.93,<->,156.165.33.3,2,2229,0,0,2,2229,0.406194000,0.6418
142.220.26.164,<->,136.25.188.225,0,0,2,890,2,890,0.405470000,1.2008
220.20.200.29,<->,144.83.60.153,2,1519,0,0,2,1519,0.405441000,1.2271
239.66.110.113,<->,203.215.177.37,0,0,2,1260,2,1260,0.404802000,0.6794
218.147.52.203,<->,8.176.40.207,0,0,2,448,2,448,0.404040000,0.0410
200.174.214.9,<->,54.58.183.105,2,1351,0,0,2,1351,0.403950000,0.3530
111.181.122.247,<->,106.5.208.177,2,508,0,0,2,508,0.403550000,0.1096
195.70.242.180,<->,136.25.188.241,0,0,2,188,2,188,0.403519000,0.0023
146.200.165.115,<->,0.195.210.42,0,0,2,188,2,188,0.402949000,0.0000
215.158.239.99,<->,199.20.30.218,2,1007,0,0,2,1007,0.402873000,0.5798
192.67.186.56,<->,127.84.46.105,2,155,0,0,2,155,0.402426000,0.5287
136.25.188.254,<->,122.158.49.136,2,1810,0,0,2,1810,0.402369000,1.3647
215.158.238.250,<->,215.158.6.233,2,2397,0,0,2,2397,0.402238000,0.7969
199.39.215.192,<->,136.25.188.196,0,0,2,954,2,954,0.401915000,0.0022
192.227.190.59,<->,8.252.223.175,0,0,2,2858,2,2858,0.401839000,1.2389
196.207.60.156,<->,136.25.188.226,0,0,2,945,2,945,0.401024000,1.2577
215.158.239.95,<->,199.20.4.233,2,188,0,0,2,188,0.400794000,0.0000
143.134.93.106,<->,136.25.188.243,0,0,2,389,2,389,0.400199000,0.0022
136.25.188.246,<->,0.195.253.228,2,1403,0,0,2,1403,0.399414000,0.3051
136.25.189.80,<->,38.104.11.1,2,2762,0,0,2,2762,0.398783000,1.2729
215.158.238.81,<->,57.210.107.8,2,1442,0,0,2,1442,0.398596000,0.5295
136.25.189.80,<->,33.209.219.102,2,954,0,0,2,954,0.397963000,1.0572
136.25.189.14,<->,96.156.169.244,2,2874,0,0,2,2874,0.397396000,0.8086
92.27.219.32,<->,6.248.112.247,2,539,0,0,2,539,0.396720000,1.5308
207.191.183.130,<->,136.25.188.196,0,0,2,957,2,957,0.396705000,0.0016
220.28.115.46,<->,136.25.189.92,0,0,2,885,2,885,0.396699000,0.0905
141.118.203.106,<->,8.252.221.198,0,0,2,843,2,843,0.396521000,0.1866
159.254.111.194,<->,100.228.42.92,0,0,2,546,2,546,0.395890000,0.0566
246.253.198.51,<->,198.168.8.29,2,554,0,0,2,554,0.395615000,0.0005
136.25.188.227,<->,30.73.132.24,2,186,0,0,2,186,0.395208000,1.3200
194.238.242.251,<->,136.25.188.225,0,0,2,188,2,188,0.394436000,0.0018
133.178.226.29,<->,131.144.114.208,2,2426,0,0,2,2426,0.394319000,0.7398
123.143.177.61,<->,89.183.104.227,0,0,2,1236,2,1236,0.394181000,1.1347
136.25.188.197,<->,100.224.202.189,2,386,0,0,2,386,0.394002000,0.3308
133.8.10.152,<->,111.20.168.154,0,0,2,1046,2,1046,0.393481000,1.3615
136.25.189.34,<->,119.196.23.3,2,2618,0,0,2,2618,0.393456000,0.9862
204.139.17.54,<->,8.182.224.248,0,0,2,547,2,547,0.393259000,0.7074
199.33.64.236,<->,136.25.188.238,0,0,2,543,2,543,0.393172000,0.0648
215.158.239.56,<->,204.56.7.3,2,1718,0,0,2,1718,0.392885000,0.3863
199.32.132.206,<->,136.25.188.220,0,0,2,188,2,188,0.392483000,0.0131
215.158.239.48,<->,199.20.6.122,2,964,0,0,2,964,0.392278000,0.0098
215.158.239.57,<->,207.59.196.167,2,188,0,0,2,188,0.392241000,0.0022
142.229.196.25,<->,136.25.188.241,0,0,2,188,2,188,0.391966000,0.0039
136.25.188.53,<->,116.106.60.157,2,2490,0,0,2,2490,0.391653000,0.2780
204.200.32.141,<->,136.25.188.255,0,0,2,779,2,779,0.391357000,0.0000
215.158.239.94,<->,207.114.153.94,2,188,0,0,2,188,0.391127000,0.0056
215.158.239.95,<->,199.20.5.236,2,774,0,0,2,774,0.390541000,0.7179
17.12.130.178,<->,8.220.206.67,0,0,2,1064,2,1064,0.389903000,0.2551
133.178.226.178,<->,8.240.247.85,2,700,0,0,2,700,0.389865000,0.9153
215.158.239.94,<->,29.213.219.93,2,2762,0,0,2,2762,0.389634000,1.1395
215.158.239.49,<->,57.227.83.218,2,2490,0,0,2,2490,0.389520000,0.4881
215.158.238.120,<->,113.23.104.203,2,1211,0,0,2,1211,0.389350000,0.6921
136.25.189.80,<->,123.166.46.246,2,2234,0,0,2,2234,0.389349000,1.6093
215.158.239.84,<->,196.108.105.153,2,1698,0,0,2,1698,0.389098000,0.3500
215.158.238.106,<->,42.226.3.119,2,2602,0,0,2,2602,0.389022000,1.4066
215.158.239.70,<->,199.20.30.130,2,1714,0,0,2,1714,0.389001000,1.6081
199.82.70.213,<->,136.25.188.222,0,0,2,188,2,188,0.388352000,0.0022
142.191.110.27,<->,136.25.188.236,0,0,2,954,2,954,0.387736000,0.0007
215.158.239.93,<->,204.2.105.52,2,188,0,0,2,188,0.387391000,0.0044
139.36.120.125,<->,99.74.26.98,0,0,2,1738,2,1738,0.387239000,1.2487
144.83.60.153,<->,92.162.253.59,0,0,2,352,2,352,0.387023000,0.0285
199.55.245.48,<->,8.252.222.172,0,0,2,1260,2,1260,0.386473000,0.2200
215.158.239.59,<->,198.204.76.216,2,2442,0,0,2,2442,0.385752000,1.0200
194.237.188.20,<->,136.25.188.198,0,0,2,188,2,188,0.385649000,0.0022
207.62.95.240,<->,136.25.188.199,0,0,2,188,2,188,0.385464000,0.0032
215.158.238.223,<->,126.219.100.188,2,2101,0,0,2,2101,0.385129000,0.7233
136.25.188.160,<->,104.3.168.213,2,2666,0,0,2,2666,0.384727000,1.0589
200.175.157.151,<->,53.213.200.116,2,570,0,0,2,570,0.384623000,1.3102
136.25.189.15,<->,128.23.84.21,2,2394,0,0,2,2394,0.384497000,1.3809
215.158.238.176,<->,126.219.100.178,2,2149,0,0,2,2149,0.383444000,0.2657
215.158.239.71,<->,195.6.45.207,2,535,0,0,2,535,0.383265000,0.3262
138.55.243.19,<->,39.15.234.173,0,0,2,322,2,322,0.383142000,0.0002
136.25.188.44,<->,106.188.236.197,2,2714,0,0,2,2714,0.383141000,0.2629
215.158.239.6,<->,96.135.154.151,2,658,0,0,2,658,0.382614000,0.8342
133.178.226.61,<->,8.179.43.9,2,2490,0,0,2,2490,0.382242000,0.8916
215.158.239.29,<->,114.142.109.181,2,1591,0,0,2,1591,0.380936000,0.8314
195.127.94.67,<->,136.25.188.220,0,0,2,656,2,656,0.380388000,0.9713
215.158.239.95,<->,131.144.115.74,2,1394,0,0,2,1394,0.380273000,1.3053
215.158.239.57,<->,113.92.151.11,2,2442,0,0,2,2442,0.380190000,0.7214
118.90.27.231,<->,50.224.89.243,0,0,2,364,2,364,0.380148000,0.0002
133.178.226.7,<->,112.235.95.24,2,2410,0,0,2,2410,0.380080000,0.3824
195.7.105.250,<->,136.25.188.220,0,0,2,867,2,867,0.380042000,0.0118
215.158.239.99,<->,113.23.66.200,2,2890,0,0,2,2890,0.379996000,0.2272
142.227.45.230,<->,136.25.188.52,0,0,2,188,2,188,0.379982000,0.0009
133.178.227.2,<->,48.131.158.233,2,2314,0,0,2,2314,0.379695000,0.8058
215.158.238.32,<->,122.158.49.148,2,2730,0,0,2,2730,0.379291000,1.0911
207.77.77.132,<->,8.252.222.162,0,0,2,804,2,804,0.378934000,0.1662
215.158.239.86,<->,113.92.151.74,2,2868,0,0,2,2868,0.378304000,0.8753
111.20.168.180,<->,27.127.250.105,2,124,0,0,2,124,0.378137000,0.9995
197.113.99.171,<->,136.25.188.243,0,0,2,283,2,283,0.376790000,1.1000
215.158.239.93,<->,204.1.223.5,2,987,0,0,2,987,0.376688000,0.4218
136.25.188.163,<->,84.223.184.252,2,440,0,0,2,440,0.376194000,0.7391
133.8.10.152,<->,33.233.141.56,0,0,2,608,2,608,0.375564000,1.2726
215.158.238.105,<->,29.214.73.156,2,2010,0,0,2,2010,0.375321000,0.2586
136.25.188.192,<->,100.216.78.145,2,1487,0,0,2,1487,0.374918000,1.3907
220.55.96.175,<->,93.147.226.157,2,177,0,0,2,177,0.374714000,0.0902
215.158.239.50,<->,207.190.159.218,2,1075,0,0,2,1075,0.374564000,0.2300
215.158.239.56,<->,204.226.80.200,2,955,0,0,2,955,0.374379000,0.0002
136.25.189.30,<->,96.156.169.195,2,334,0,0,2,334,0.374268000,0.8104
149.56.86.41,<->,50.224.89.241,0,0,2,337,2,337,0.373698000,0.0063
207.92.10.130,<->,8.182.226.78,0,0,2,656,2,656,0.373628000,0.1838
206.195.188.76,<->,98.236.223.92,0,0,2,130,2,130,0.373449000,0.2106
142.208.120.204,<->,136.25.188.198,0,0,2,188,2,188,0.373226000,0.0022
220.28.73.211,<->,136.25.188.216,0,0,2,1664,2,1664,0.373037000,1.3744
215.158.239.79,<->,199.20.23.224,2,1434,0,0,2,1434,0.372766000,0.7605
97.19.3.156,<->,8.252.223.233,0,0,2,100,2,100,0.372553000,0.3534
215.158.239.94,<->,199.20.29.9,2,1027,0,0,2,1027,0.371892000,1.4399
196.88.224.202,<->,136.25.188.237,0,0,2,787,2,787,0.371781000,0.9210
231.138.49.16,<->,136.25.188.53,0,0,2,370,2,370,0.371617000,0.1068
215.158.238.177,<->,113.23.66.35,2,2201,0,0,2,2201,0.371395000,1.4952
136.25.188.44,<->,113.23.21.200,2,2634,0,0,2,2634,0.370838000,0.5063
192.171.32.164,<->,133.178.227.16,0,0,2,2281,2,2281,0.370789000,1.1973
192.204.170.201,<->,136.25.188.44,0,0,2,2506,2,2506,0.370340000,1.6044
136.25.189.30,<->,96.156.169.163,2,1544,0,0,2,1544,0.370032000,0.1483
143.135.255.175,<->,136.25.188.177,0,0,2,656,2,656,0.369837000,0.4958
215.158.239.93,<->,194.237.190.26,2,1690,0,0,2,1690,0.369678000,0.2371
139.193.141.139,<->,122.252.95.229,2,880,0,0,2,880,0.369305000,0.9921
111.20.168.175,<->,92.160.6.243,2,124,0,0,2,124,0.368206000,1.0061
215.158.238.141,<->,33.209.217.200,2,2914,0,0,2,2914,0.367779000,1.1591
136.25.188.225,<->,8.227.55.135,2,1693,0,0,2,1693,0.367639000,0.4690
215.158.239.95,<->,194.199.218.39,2,774,0,0,2,774,0.367173000,0.2127
195.40.112.222,<->,136.25.188.241,0,0,2,188,2,188,0.367161000,0.0037
136.25.188.237,<->,116.106.60.159,2,2410,0,0,2,2410,0.366457000,0.6492
215.158.238.250,<->,18.202.90.172,2,2473,0,0,2,2473,0.366450000,1.3937
195.14.69.122,<->,136.25.188.174,0,0,2,656,2,656,0.366167000,0.6476
202.33.49.114,<->,136.25.188.162,0,0,2,188,2,188,0.365786000,0.0000
215.158.239.96,<->,199.20.30.62,2,1694,0,0,2,1694,0.364903000,0.9996
142.191.1.22,<->,136.25.188.45,0,0,2,949,2,949,0.364859000,0.0020
215.158.238.105,<->,148.55.210.201,2,2570,0,0,2,2570,0.364836000,0.3175
215.158.239.49,<->,199.20.28.91,2,188,0,0,2,188,0.364374000,0.0903
108.35.240.113,<->,8.52.136.119,0,0,2,646,2,646,0.364363000,0.1114
136.25.189.33,<->,33.209.219.117,2,826,0,0,2,826,0.364039000,0.4493
146.249.226.127,<->,8.252.222.133,0,0,2,774,2,774,0.363651000,0.2908
220.55.78.176,<->,84.214.213.145,2,880,0,0,2,880,0.363052000,1.4588
215.158.239.4,<->,122.158.53.40,2,1739,0,0,2,1739,0.362962000,0.7315
207.172.108.124,<->,136.25.188.210,0,0,2,462,2,462,0.362866000,1.3887
199.14.90.176,<->,136.25.188.163,0,0,2,188,2,188,0.362675000,0.0039
133.178.227.244,<->,111.151.237.139,2,1218,0,0,2,1218,0.362311000,0.0004
215.158.238.148,<->,111.151.70.36,2,2682,0,0,2,2682,0.361788000,1.0195
132.163.115.100,<->,89.183.104.242,0,0,2,482,2,482,0.361073000,0.0629
215.158.239.77,<->,199.20.5.105,2,1073,0,0,2,1073,0.360881000,0.1200
215.158.238.143,<->,131.36.198.58,2,2666,0,0,2,2666,0.360410000,0.2409
195.14.248.228,<->,136.25.188.238,0,0,2,188,2,188,0.360124000,0.0026
142.244.255.166,<->,136.25.188.211,0,0,2,656,2,656,0.359906000,0.1955
199.70.28.203,<->,136.25.188.255,0,0,2,1530,2,1530,0.359811000,1.0386
136.25.189.202,<->,129.222.39.124,2,1083,0,0,2,1083,0.359352000,0.0233
133.178.226.38,<->,104.154.137.220,2,2474,0,0,2,2474,0.358996000,1.0606
143.134.66.96,<->,136.25.188.197,0,0,2,656,2,656,0.358894000,1.0797
195.15.40.214,<->,136.25.188.225,0,0,2,218,2,218,0.358694000,0.2210
215.158.238.177,<->,106.188.245.188,2,2122,0,0,2,2122,0.358476000,0.9940
220.39.233.7,<->,133.178.227.40,0,0,2,2179,2,2179,0.357436000,1.4766
136.25.188.172,<->,8.252.210.162,2,2698,0,0,2,2698,0.356809000,1.3226
215.158.61.145,<->,136.25.189.213,0,0,2,2051,2,2051,0.356745000,0.8220
143.13.162.16,<->,136.25.188.54,0,0,2,364,2,364,0.356200000,0.7790
133.178.226.90,<->,8.222.212.27,2,2234,0,0,2,2234,0.355718000,0.7449
129.236.114.39,<->,33.233.141.227,0,0,2,508,2,508,0.355521000,0.7044
210.229.230.21,<->,106.252.1.239,2,186,0,0,2,186,0.355157000,1.0471
229.96.182.37,<->,53.195.174.8,2,2605,0,0,2,2605,0.354159000,0.2257
144.65.187.11,<->,100.228.42.38,0,0,2,385,2,385,0.354156000,0.0221
215.158.238.141,<->,104.3.169.44,2,2234,0,0,2,2234,0.353763000,0.3545
50.145.94.82,<->,48.55.150.61,0,0,2,239,2,239,0.353753000,0.5793
136.25.189.16,<->,89.80.251.7,2,2538,0,0,2,2538,0.353195000,0.9842
215.158.140.204,<->,109.184.4.80,2,1076,0,0,2,1076,0.352919000,0.0190
117.111.232.65,<->,109.1.47.253,0,0,2,179,2,179,0.352689000,1.3285
133.178.227.62,<->,133.56.180.19,2,1689,0,0,2,1689,0.352001000,0.0001
204.2.41.205,<->,136.25.188.196,0,0,2,948,2,948,0.351735000,0.0022
212.118.51.49,<->,8.52.169.89,0,0,2,656,2,656,0.351469000,0.0271
221.102.143.189,<->,192.67.165.112,0,0,2,439,2,439,0.351342000,0.7162
133.178.226.30,<->,126.219.190.217,2,2250,0,0,2,2250,0.351266000,0.5733
133.178.227.30,<->,133.56.180.35,2,1082,0,0,2,1082,0.351067000,0.9800
97.126.112.4,<->,50.236.233.103,2,1302,0,0,2,1302,0.351008000,0.9115
215.158.239.56,<->,199.20.5.70,2,1073,0,0,2,1073,0.350634000,0.9384
215.158.239.48,<->,199.20.31.19,2,1706,0,0,2,1706,0.350346000,0.5590
252.98.180.157,<->,80.27.155.30,2,574,0,0,2,574,0.349972000,0.1499
111.146.136.41,<->,53.235.185.13,2,286,0,0,2,286,0.349917000,0.0458
202.77.251.220,<->,8.252.221.221,0,0,2,524,2,524,0.349779000,1.2828
69.242.172.63,<->,8.252.221.230,0,0,2,906,2,906,0.349646000,1.2666
133.178.226.28,<->,111.151.238.104,2,2346,0,0,2,2346,0.349517000,0.0911
159.137.162.213,<->,105.105.201.106,2,676,0,0,2,676,0.349467000,0.2430
215.158.238.134,<->,122.158.51.54,2,2330,0,0,2,2330,0.349424000,0.7241
159.36.5.214,<->,136.25.188.198,0,0,2,387,2,387,0.349388000,0.0000
215.158.238.250,<->,69.150.169.232,2,2206,0,0,2,2206,0.349173000,1.5734
48.19.213.154,<->,8.252.222.159,0,0,2,1639,2,1639,0.349152000,0.1862
215.158.239.215,<->,215.158.61.145,2,2803,0,0,2,2803,0.348897000,0.7902
80.38.40.8,<->,42.68.246.173,2,114,0,0,2,114,0.348663000,0.1382
210.95.218.219,<->,8.220.202.151,0,0,2,1386,2,1386,0.348263000,0.7045
136.25.189.16,<->,29.211.93.6,2,2266,0,0,2,2266,0.347106000,1.3706
58.51.8.239,<->,8.252.222.21,0,0,2,689,2,689,0.347023000,1.3231
136.25.188.254,<->,113.23.104.215,2,2266,0,0,2,2266,0.346855000,1.4446
215.158.239.96,<->,195.6.45.207,2,418,0,0,2,418,0.346584000,0.4767
215.158.239.111,<->,215.158.61.242,2,2713,0,0,2,2713,0.346523000,1.5649
246.44.136.14,<->,124.55.36.202,2,223,0,0,2,223,0.346479000,0.1088
93.181.154.87,<->,92.27.219.249,0,0,2,100,2,100,0.346471000,0.1549
215.158.239.68,<->,199.20.4.146,2,1056,0,0,2,1056,0.346065000,0.1596
215.158.238.104,<->,113.23.104.203,2,2474,0,0,2,2474,0.346041000,0.8458
215.158.238.142,<->,32.183.36.118,2,2634,0,0,2,2634,0.345987000,1.1109
133.178.226.202,<->,130.165.253.42,2,1376,0,0,2,1376,0.345415000,1.0751
136.25.188.179,<->,69.150.169.137,2,2490,0,0,2,2490,0.345327000,1.5632
215.158.238.64,<->,38.104.11.27,2,1506,0,0,2,1506,0.344615000,1.1533
215.158.239.8,<->,96.135.154.132,2,798,0,0,2,798,0.344335000,0.4732
215.158.239.84,<->,38.104.11.27,2,2634,0,0,2,2634,0.344284000,0.7005
215.158.238.106,<->,111.150.186.225,2,2682,0,0,2,2682,0.343975000,0.4095
215.158.140.241,<->,131.144.116.221,2,2703,0,0,2,2703,0.343880000,0.4134
215.158.140.172,<->,99.124.164.35,2,859,0,0,2,859,0.343671000,1.0942
204.61.232.46,<->,136.25.188.53,0,0,2,188,2,188,0.343643000,0.0022
215.158.140.163,<->,192.170.210.225,2,1389,0,0,2,1389,0.343585000,0.0003
221.102.121.56,<->,126.87.219.73,2,718,0,0,2,718,0.343158000,1.1122
215.158.239.69,<->,199.52.40.31,2,1499,0,0,2,1499,0.342994000,0.2822
215.158.239.69,<->,195.41.26.19,2,188,0,0,2,188,0.342833000,0.0029
133.178.227.44,<->,133.56.180.46,2,1082,0,0,2,1082,0.341441000,1.3135
194.234.135.124,<->,136.25.188.242,0,0,2,188,2,188,0.340817000,0.0016
147.47.62.86,<->,8.252.221.236,0,0,2,938,2,938,0.340669000,1.6462
192.170.144.68,<->,136.62.164.0,0,0,2,1127,2,1127,0.340493000,0.0000
133.178.226.60,<->,114.25.48.78,2,2426,0,0,2,2426,0.340430000,0.9395
246.254.97.104,<->,210.231.140.38,2,174,0,0,2,174,0.340335000,0.0000
215.158.238.64,<->,192.224.20.19,2,2522,0,0,2,2522,0.340130000,1.6465
220.28.104.193,<->,215.158.238.194,0,0,2,1378,2,1378,0.339849000,1.6490
195.50.75.207,<->,50.224.76.230,0,0,2,2600,2,2600,0.339655000,0.5413
133.178.226.14,<->,96.155.60.192,2,335,0,0,2,335,0.339403000,0.8814
139.172.72.143,<->,8.52.189.207,0,0,2,457,2,457,0.339173000,0.0588
215.158.140.75,<->,72.23.148.212,2,2146,0,0,2,2146,0.339108000,1.5621
195.54.71.167,<->,136.25.188.227,0,0,2,188,2,188,0.338626000,0.0022
215.158.140.92,<->,146.14.145.54,2,2199,0,0,2,2199,0.338470000,0.9170
195.5.111.87,<->,136.25.188.222,0,0,2,953,2,953,0.338363000,0.0000
215.158.239.48,<->,142.221.134.198,2,1030,0,0,2,1030,0.338071000,0.3406
199.7.179.250,<->,8.52.222.23,0,0,2,656,2,656,0.337928000,0.2876
243.49.81.35,<->,111.147.147.40,0,0,2,583,2,583,0.337185000,0.5265
133.178.227.246,<->,56.23.170.190,2,1642,0,0,2,1642,0.337050000,0.9431
144.87.238.91,<->,8.182.241.94,0,0,2,1172,2,1172,0.336505000,0.0233
142.229.0.171,<->,136.25.188.236,0,0,2,1083,2,1083,0.335463000,0.3102
80.41.28.151,<->,50.145.65.73,2,899,0,0,2,899,0.335209000,0.5076
145.252.116.199,<->,100.120.38.6,2,710,0,0,2,710,0.334504000,0.0664
142.228.169.90,<->,136.25.188.239,0,0,2,622,2,622,0.334409000,0.9928
133.178.227.1,<->,8.240.116.202,2,2234,0,0,2,2234,0.333882000,1.5821
97.126.46.193,<->,89.86.111.206,2,1164,0,0,2,1164,0.333686000,1.6248
120.158.117.139,<->,50.224.89.243,0,0,2,1217,2,1217,0.333667000,0.0036
192.65.40.174,<->,8.55.211.213,2,588,0,0,2,588,0.333080000,0.2355
215.158.238.133,<->,104.3.163.39,2,2778,0,0,2,2778,0.333031000,0.3659
207.62.110.132,<->,136.25.188.243,0,0,2,774,2,774,0.332374000,1.5078
148.146.105.150,<->,98.236.223.238,0,0,2,130,2,130,0.332176000,0.1886
215.158.239.70,<->,192.204.123.2,2,2682,0,0,2,2682,0.332043000,0.5428
148.155.131.56,<->,92.27.27.185,0,0,2,754,2,754,0.332020000,0.0000
197.113.99.91,<->,136.25.188.253,0,0,2,188,2,188,0.331719000,0.0000
159.23.227.241,<->,141.21.241.15,2,523,0,0,2,523,0.331709000,1.2190
215.158.239.93,<->,195.3.103.218,2,2394,0,0,2,2394,0.331553000,1.2041
215.158.239.48,<->,207.115.22.94,2,495,0,0,2,495,0.331531000,0.0000
192.67.175.129,<->,117.93.12.57,2,2646,0,0,2,2646,0.331193000,1.3298
223.115.183.103,<->,8.252.222.49,0,0,2,459,2,459,0.331189000,0.1700
158.156.107.86,<->,92.27.219.150,0,0,2,1030,2,1030,0.331049000,0.0003
73.14.208.191,<->,8.252.222.61,0,0,2,774,2,774,0.330709000,0.7381
192.64.244.21,<->,8.209.235.29,2,669,0,0,2,669,0.330638000,0.6561
215.158.239.85,<->,199.20.6.68,2,188,0,0,2,188,0.330341000,0.0000
136.25.188.162,<->,8.222.212.22,2,2730,0,0,2,2730,0.330229000,0.4237
232.31.155.200,<->,89.183.111.204,0,0,2,1174,2,1174,0.329833000,0.1632
80.27.157.212,<->,75.94.224.161,2,662,0,0,2,662,0.329584000,0.3106
136.25.188.254,<->,112.220.206.22,2,2474,0,0,2,2474,0.329523000,0.8770
145.116.223.6,<->,133.178.226.246,0,0,2,1146,2,1146,0.327320000,0.9026
215.158.239.86,<->,106.188.253.166,2,2554,0,0,2,2554,0.327094000,1.6458
204.200.54.126,<->,136.25.188.226,0,0,2,188,2,188,0.326561000,0.0000
215.158.239.79,<->,196.89.124.85,2,1059,0,0,2,1059,0.325948000,0.0036
215.158.239.192,<->,145.116.223.80,2,994,0,0,2,994,0.325568000,0.7749
109.1.24.111,<->,99.167.188.131,2,840,0,0,2,840,0.325092000,0.9991
247.136.255.233,<->,144.81.196.15,2,1309,0,0,2,1309,0.325014000,0.8601
215.158.238.107,<->,89.86.110.10,2,2346,0,0,2,2346,0.324188000,0.9033
195.13.64.188,<->,136.25.188.252,0,0,2,368,2,368,0.323651000,0.2841
215.158.239.4,<->,106.188.214.9,2,1760,0,0,2,1760,0.323295000,1.3331
139.163.7.204,<->,33.241.5.24,2,423,0,0,2,423,0.322924000,0.0000
136.25.189.33,<->,126.219.49.40,2,2538,0,0,2,2538,0.322370000,0.3096
215.158.140.241,<->,29.214.109.166,2,2079,0,0,2,2079,0.322357000,0.1440
215.158.238.99,<->,27.22.184.74,2,2442,0,0,2,2442,0.321845000,1.5932
136.25.189.29,<->,122.251.2.219,2,2538,0,0,2,2538,0.320634000,0.1867
202.77.250.77,<->,8.252.222.175,0,0,2,188,2,188,0.320612000,0.0000
142.255.224.168,<->,136.25.188.210,0,0,2,793,2,793,0.320452000,0.0022
143.94.164.184,<->,136.25.188.176,0,0,2,899,2,899,0.320435000,0.0022
136.25.188.197,<->,112.220.206.107,2,454,0,0,2,454,0.320138000,1.6472
215.158.239.77,<->,29.211.93.23,2,2618,0,0,2,2618,0.319599000,0.9550
204.200.44.157,<->,136.25.188.209,0,0,2,188,2,188,0.319558000,0.0000
215.158.239.58,<->,142.247.209.45,2,1346,0,0,2,1346,0.319358000,0.7805
215.158.238.243,<->,8.190.217.127,2,2204,0,0,2,2204,0.319000000,0.7659
215.158.239.81,<->,159.215.65.184,2,450,0,0,2,450,0.318205000,0.0003
123.129.29.202,<->,33.233.141.13,0,0,2,124,2,124,0.318203000,1.0001
195.71.62.57,<->,136.25.188.177,0,0,2,947,2,947,0.318004000,0.0016
215.158.239.76,<->,207.244.14.234,2,1088,0,0,2,1088,0.316144000,0.6054
199.38.42.23,<->,136.25.188.253,0,0,2,188,2,188,0.315933000,0.0039
235.42.34.22,<->,136.25.188.174,0,0,2,2362,2,2362,0.315787000,0.3987
215.158.239.56,<->,196.0.209.152,2,906,0,0,2,906,0.315319000,0.0395
220.28.114.28,<->,133.178.226.85,0,0,2,1919,2,1919,0.315149000,0.9569
204.187.163.107,<->,136.25.188.255,0,0,2,896,2,896,0.314680000,0.6228
215.158.238.97,<->,69.31.238.42,2,2714,0,0,2,2714,0.314514000,0.3496
215.158.238.149,<->,6.116.14.42,2,2666,0,0,2,2666,0.314142000,0.9995
129.236.114.39,<->,101.224.89.252,0,0,2,2755,2,2755,0.313768000,1.5326
215.158.239.69,<->,8.255.92.165,2,2714,0,0,2,2714,0.313513000,0.3455
215.158.238.243,<->,139.163.163.208,2,2362,0,0,2,2362,0.313354000,0.3025
98.230.212.157,<->,8.182.253.100,0,0,2,731,2,731,0.313007000,0.0351
215.158.239.97,<->,195.41.90.111,2,388,0,0,2,388,0.312701000,0.0242
207.61.160.213,<->,136.25.188.209,0,0,2,188,2,188,0.312215000,0.0033
207.86.243.25,<->,8.252.222.221,0,0,2,188,2,188,0.311897000,0.0000
159.137.162.213,<->,38.126.10.50,2,676,0,0,2,676,0.311361000,0.6159
215.158.239.76,<->,8.249.253.226,2,2538,0,0,2,2538,0.310843000,0.9401
136.25.189.57,<->,29.211.165.22,2,2410,0,0,2,2410,0.310672000,0.8088
215.158.238.132,<->,143.227.65.187,2,1410,0,0,2,1410,0.310508000,1.0929
136.25.189.82,<->,68.124.221.149,2,2730,0,0,2,2730,0.310375000,0.7640
215.158.238.104,<->,27.178.41.58,2,2586,0,0,2,2586,0.310226000,1.1831
159.137.162.213,<->,108.0.246.252,2,676,0,0,2,676,0.309144000,0.2414
117.5.250.34,<->,8.183.25.124,0,0,2,432,2,432,0.309084000,0.2539
136.139.59.102,<->,136.25.188.160,0,0,2,2666,2,2666,0.308056000,1.6384
111.20.40.252,<->,109.222.250.37,0,0,2,892,2,892,0.308000000,0.3868
142.237.201.159,<->,136.25.188.241,0,0,2,188,2,188,0.307454000,0.0042
215.158.239.93,<->,142.244.68.43,2,1077,0,0,2,1077,0.306938000,0.0629
159.31.202.215,<->,53.201.180.80,2,186,0,0,2,186,0.306416000,1.6360
196.115.133.150,<->,136.25.188.252,0,0,2,2586,2,2586,0.306385000,1.1791
202.77.250.77,<->,8.252.222.148,0,0,2,188,2,188,0.306341000,0.0000
159.23.227.171,<->,127.159.185.21,2,518,0,0,2,518,0.306228000,0.1567
145.252.114.80,<->,120.159.137.169,2,1142,0,0,2,1142,0.306039000,0.2718
136.25.189.45,<->,69.132.241.214,2,2282,0,0,2,2282,0.306001000,1.3463
215.158.61.242,<->,136.25.188.34,0,0,2,2362,2,2362,0.305991000,0.9735
215.158.239.96,<->,199.20.29.28,2,849,0,0,2,849,0.305357000,0.3999
32.233.112.4,<->,8.220.190.86,0,0,2,680,2,680,0.303891000,0.1999
136.25.188.222,<->,95.90.177.91,2,1080,0,0,2,1080,0.303771000,0.0018
215.158.238.133,<->,113.23.20.106,2,2538,0,0,2,2538,0.303516000,0.2964
142.223.185.59,<->,136.25.188.177,0,0,2,188,2,188,0.303050000,0.0022
215.158.239.51,<->,204.1.195.91,2,1174,0,0,2,1174,0.302287000,0.1096
133.178.226.77,<->,112.220.206.117,2,2458,0,0,2,2458,0.302274000,1.3997
215.158.239.58,<->,196.90.143.236,2,656,0,0,2,656,0.302180000,0.2996
215.158.239.84,<->,199.20.28.235,2,194,0,0,2,194,0.302034000,0.0705
136.25.189.59,<->,33.209.219.107,2,2698,0,0,2,2698,0.301975000,0.3633
215.158.6.231,<->,8.252.223.153,0,0,2,2480,2,2480,0.301890000,1.1263
215.158.239.86,<->,199.20.30.215,2,188,0,0,2,188,0.301755000,0.0500
111.147.75.29,<->,53.149.56.25,2,264,0,0,2,264,0.301605000,0.3060
133.178.227.246,<->,113.85.83.140,2,1340,0,0,2,1340,0.301319000,0.0011
215.158.238.67,<->,131.1.195.249,2,2666,0,0,2,2666,0.301155000,1.6117
215.158.238.95,<->,199.71.90.68,2,2378,0,0,2,2378,0.301123000,0.6047
215.158.238.120,<->,80.47.111.74,2,2362,0,0,2,2362,0.301111000,0.6490
133.178.227.79,<->,48.129.132.248,2,2378,0,0,2,2378,0.301092000,1.6445
53.224.112.122,<->,8.228.209.115,0,0,2,836,2,836,0.300872000,0.0912
215.158.239.5,<->,131.95.192.249,2,2977,0,0,2,2977,0.300800000,0.9865
192.224.21.33,<->,133.178.226.28,0,0,2,1234,2,1234,0.300502000,0.8180
224.93.235.38,<->,80.27.157.15,0,0,2,259,2,259,0.300339000,0.0000
215.158.239.95,<->,199.20.30.137,2,188,0,0,2,188,0.299520000,0.0001
215.158.238.134,<->,42.97.54.90,2,2602,0,0,2,2602,0.299499000,0.6096
133.178.226.90,<->,96.155.60.244,2,598,0,0,2,598,0.299403000,0.0491
136.25.189.88,<->,133.146.0.217,2,2474,0,0,2,2474,0.299331000,0.4654
215.158.238.47,<->,80.47.111.87,2,2250,0,0,2,2250,0.298659000,0.6806
143.22.109.149,<->,8.182.226.78,0,0,2,680,2,680,0.298190000,0.1699
215.158.239.51,<->,194.232.15.33,2,955,0,0,2,955,0.298031000,0.0028
133.178.226.61,<->,119.196.23.27,2,2698,0,0,2,2698,0.297395000,1.0455
215.158.238.221,<->,8.219.184.163,2,2269,0,0,2,2269,0.296657000,0.3260
133.178.227.16,<->,106.188.228.2,2,2778,0,0,2,2778,0.296656000,1.2794
215.158.239.96,<->,199.20.29.176,2,188,0,0,2,188,0.296458000,0.0506
215.158.238.223,<->,8.222.6.193,2,2181,0,0,2,2181,0.296368000,0.0200
215.158.238.45,<->,8.222.96.7,2,1522,0,0,2,1522,0.296104000,1.1511
202.33.241.197,<->,136.25.188.252,0,0,2,188,2,188,0.295445000,0.0199
133.178.227.1,<->,122.159.123.19,2,2436,0,0,2,2436,0.295377000,1.2802
215.158.238.81,<->,158.253.43.166,2,2602,0,0,2,2602,0.294412000,1.1310
215.158.238.104,<->,143.227.108.26,2,2394,0,0,2,2394,0.292117000,1.2693
136.25.189.31,<->,113.23.14.134,2,2458,0,0,2,2458,0.291502000,1.0377
199.14.207.55,<->,136.25.188.160,0,0,2,188,2,188,0.291184000,0.0020
215.158.238.236,<->,131.144.116.29,2,2108,0,0,2,2108,0.290872000,1.5503
94.194.188.21,<->,8.252.221.236,0,0,2,916,2,916,0.289914000,1.3193
101.112.192.32,<->,89.90.112.31,2,1816,0,0,2,1816,0.289708000,0.3562
218.4.190.253,<->,131.49.250.246,2,240,0,0,2,240,0.289694000,1.5086
215.158.239.58,<->,142.241.219.157,2,188,0,0,2,188,0.289633000,0.0039
243.117.93.2,<->,35.56.96.75,0,0,2,1742,2,1742,0.288385000,0.0838
136.25.188.254,<->,8.252.210.250,2,2570,0,0,2,2570,0.287989000,1.4163
119.253.0.22,<->,92.27.219.46,0,0,2,261,2,261,0.287185000,0.1529
202.77.92.35,<->,109.1.57.73,0,0,2,329,2,329,0.287069000,0.5598
136.25.189.14,<->,96.156.169.222,2,2018,0,0,2,2018,0.287021000,0.8601
136.25.189.0,<->,114.146.74.194,2,2586,0,0,2,2586,0.286982000,1.6711
136.25.188.197,<->,8.179.43.83,2,2682,0,0,2,2682,0.286704000,0.7606
207.188.217.118,<->,136.25.188.252,0,0,2,188,2,188,0.285749000,0.0022
100.218.98.18,<->,8.252.221.171,0,0,2,1815,2,1815,0.285569000,1.2778
215.158.239.69,<->,118.20.100.183,2,2906,0,0,2,2906,0.285210000,0.9879
216.184.2.246,<->,136.25.189.2,0,0,2,2682,2,2682,0.284890000,0.0268
136.25.188.254,<->,113.23.104.220,2,2554,0,0,2,2554,0.284784000,1.3390
215.158.238.82,<->,142.234.196.219,2,2698,0,0,2,2698,0.284008000,1.6166
215.158.239.48,<->,194.203.230.244,2,188,0,0,2,188,0.283898000,0.0000
215.158.239.49,<->,69.132.194.97,2,2762,0,0,2,2762,0.283371000,0.4677
133.178.226.28,<->,8.255.92.234,2,1362,0,0,2,1362,0.283103000,0.8702
221.102.56.46,<->,98.129.37.28,0,0,2,1606,2,1606,0.283086000,0.1243
215.158.238.80,<->,91.57.173.62,2,1282,0,0,2,1282,0.282379000,0.4307
215.158.239.76,<->,207.191.122.139,2,188,0,0,2,188,0.282307000,0.0100
197.113.99.154,<->,136.25.188.179,0,0,2,1264,2,1264,0.282238000,1.2014
215.158.239.96,<->,207.63.249.180,2,896,0,0,2,896,0.282228000,0.1400
109.222.254.231,<->,53.201.161.188,2,1564,0,0,2,1564,0.282104000,0.0810
215.158.239.57,<->,199.20.7.45,2,188,0,0,2,188,0.281802000,0.0611
215.158.238.221,<->,106.188.253.229,2,2134,0,0,2,2134,0.281785000,1.0941
199.15.141.195,<->,136.25.188.242,0,0,2,188,2,188,0.280765000,0.0586
200.174.207.0,<->,53.201.72.62,2,1864,0,0,2,1864,0.280038000,0.0014
130.239.147.103,<->,92.168.217.241,0,0,2,1088,2,1088,0.278661000,0.9985
204.185.109.210,<->,136.25.188.252,0,0,2,953,2,953,0.278641000,0.0228
215.158.239.76,<->,142.166.122.161,2,1378,0,0,2,1378,0.277996000,0.0940
106.168.190.67,<->,100.93.165.206,0,0,2,450,2,450,0.277948000,0.1743
215.158.238.122,<->,99.192.168.186,2,2526,0,0,2,2526,0.277409000,1.2235
215.158.239.56,<->,199.20.31.137,2,188,0,0,2,188,0.276958000,0.0107
215.158.238.241,<->,192.171.32.145,2,2315,0,0,2,2315,0.276740000,0.6346
207.56.239.111,<->,136.25.188.225,0,0,2,188,2,188,0.276632000,0.0000
215.158.239.59,<->,29.212.180.246,2,2522,0,0,2,2522,0.276334000,1.1646
224.93.235.33,<->,80.27.157.12,0,0,2,2722,2,2722,0.276207000,0.6647
136.25.188.174,<->,122.158.49.137,2,1506,0,0,2,1506,0.276122000,1.0812
215.158.234.99,<->,91.51.217.98,0,0,2,447,2,447,0.276089000,0.1119
215.158.239.56,<->,199.20.7.93,2,188,0,0,2,188,0.275796000,0.0095
215.158.61.242,<->,8.176.8.211,0,0,2,1315,2,1315,0.274256000,1.0400
133.178.226.49,<->,57.107.26.56,2,1274,0,0,2,1274,0.274017000,0.1253
215.158.239.94,<->,195.70.128.189,2,803,0,0,2,803,0.273862000,0.1827
196.206.210.12,<->,136.25.188.178,0,0,2,938,2,938,0.273636000,1.1500
215.158.239.87,<->,207.115.122.109,2,774,0,0,2,774,0.272516000,1.5900
215.158.239.19,<->,111.151.239.10,2,1554,0,0,2,1554,0.272284000,0.6923
220.28.73.211,<->,215.158.239.88,0,0,2,1783,2,1783,0.271830000,0.3866
215.158.239.50,<->,196.93.113.153,2,466,0,0,2,466,0.271810000,0.0593
133.178.226.29,<->,126.219.132.211,2,2618,0,0,2,2618,0.271550000,0.4417
207.173.199.186,<->,136.25.188.196,0,0,2,188,2,188,0.271490000,0.0000
136.25.189.33,<->,29.212.199.194,2,2570,0,0,2,2570,0.271407000,0.4347
223.115.66.128,<->,8.252.222.149,0,0,2,440,2,440,0.271271000,0.1621
215.158.61.202,<->,8.176.8.202,0,0,2,1563,2,1563,0.271247000,0.1880
203.215.188.184,<->,124.42.185.84,2,550,0,0,2,550,0.270915000,0.1687
215.158.239.78,<->,204.226.23.172,2,965,0,0,2,965,0.270871000,0.1697
61.125.166.13,<->,8.252.222.61,0,0,2,188,2,188,0.270660000,0.0006
199.32.126.132,<->,136.25.188.45,0,0,2,188,2,188,0.270624000,0.0029
90.240.140.125,<->,84.4.11.134,2,150,0,0,2,150,0.269572000,1.5480
215.158.238.148,<->,106.188.183.105,2,1642,0,0,2,1642,0.269560000,1.2576
215.158.239.48,<->,196.105.127.143,2,188,0,0,2,188,0.268822000,0.0200
215.158.238.135,<->,131.36.198.21,2,2593,0,0,2,2593,0.268820000,0.3999
136.25.189.1,<->,96.156.169.169,2,2906,0,0,2,2906,0.268674000,1.3178
215.158.239.94,<->,207.190.73.63,2,986,0,0,2,986,0.268603000,0.0012
92.26.155.243,<->,14.125.23.80,0,0,2,324,2,324,0.268575000,0.1658
97.182.1.35,<->,8.220.204.234,0,0,2,749,2,749,0.268234000,0.0604
215.158.239.87,<->,199.70.227.212,2,778,0,0,2,778,0.268013000,0.2465
215.158.239.59,<->,116.106.46.57,2,2774,0,0,2,2774,0.267111000,0.8717
215.158.42.59,<->,8.252.223.153,0,0,2,1522,2,1522,0.266937000,0.7344
215.158.140.202,<->,72.151.67.38,2,272,0,0,2,272,0.266479000,0.0002
69.103.121.183,<->,8.252.222.151,0,0,2,669,2,669,0.265955000,0.0036
136.25.189.88,<->,29.212.198.133,2,2714,0,0,2,2714,0.265526000,0.3363
142.190.39.7,<->,136.25.188.241,0,0,2,188,2,188,0.265505000,0.0024
215.158.239.233,<->,100.244.13.14,2,903,0,0,2,903,0.265174000,0.4180
136.25.189.77,<->,116.106.46.121,2,2704,0,0,2,2704,0.265102000,1.6790
195.71.143.161,<->,136.25.188.255,0,0,2,656,2,656,0.264206000,0.1323
194.237.117.52,<->,136.25.188.243,0,0,2,188,2,188,0.263629000,0.0022
53.231.94.90,<->,48.55.122.124,0,0,2,3008,2,3008,0.263377000,0.2844
215.158.238.82,<->,106.188.183.116,2,291,0,0,2,291,0.263217000,1.2876
221.102.56.69,<->,220.80.167.246,0,0,2,588,2,588,0.262800000,0.0283
215.158.239.84,<->,199.20.30.33,2,1492,0,0,2,1492,0.262732000,0.6603
204.200.48.116,<->,136.25.188.198,0,0,2,440,2,440,0.262666000,0.2196
215.158.238.236,<->,8.221.197.182,2,2235,0,0,2,2235,0.262206000,1.5080
199.111.88.50,<->,8.182.241.177,0,0,2,981,2,981,0.262110000,0.7058
204.61.232.46,<->,136.25.188.225,0,0,2,188,2,188,0.262078000,0.0022
215.158.238.134,<->,122.158.49.138,2,730,0,0,2,730,0.261839000,1.1131
246.253.217.195,<->,114.143.1.94,2,1424,0,0,2,1424,0.261239000,0.0000
142.191.121.7,<->,136.25.188.255,0,0,2,472,2,472,0.261187000,1.5168
215.158.238.96,<->,61.34.184.209,2,2426,0,0,2,2426,0.260861000,1.3166
142.191.245.48,<->,136.25.188.220,0,0,2,891,2,891,0.260789000,0.4317
139.163.169.169,<->,133.178.226.212,0,0,2,1628,2,1628,0.260783000,0.9056
215.158.30.187,<->,8.252.222.54,0,0,2,850,2,850,0.260562000,0.0008
204.200.37.77,<->,136.25.188.177,0,0,2,188,2,188,0.260472000,0.0000
215.158.239.92,<->,195.55.146.191,2,1063,0,0,2,1063,0.259953000,0.0141
133.178.227.16,<->,104.3.168.27,2,2602,0,0,2,2602,0.258962000,0.5750
133.8.10.152,<->,111.20.168.6,0,0,2,921,2,921,0.258740000,0.8764
136.25.189.196,<->,129.222.39.101,2,2412,0,0,2,2412,0.258166000,0.8228
136.25.188.255,<->,29.214.108.128,2,2854,0,0,2,2854,0.256864000,0.8098
215.158.239.86,<->,199.50.0.190,2,656,0,0,2,656,0.256094000,0.6696
136.25.189.32,<->,120.154.71.4,2,2666,0,0,2,2666,0.255708000,0.2663
133.178.227.19,<->,113.23.101.149,2,2095,0,0,2,2095,0.254891000,1.5429
136.25.188.29,<->,53.208.237.45,2,1858,0,0,2,1858,0.253929000,0.0230
192.226.161.54,<->,136.25.188.53,0,0,2,2538,2,2538,0.253867000,0.7228
215.158.239.76,<->,199.20.7.125,2,944,0,0,2,944,0.253532000,0.0000
142.241.242.212,<->,136.25.188.177,0,0,2,543,2,543,0.252661000,0.4109
215.158.238.176,<->,192.171.32.168,2,2175,0,0,2,2175,0.252625000,1.3522
204.200.63.211,<->,136.25.188.178,0,0,2,233,2,233,0.252210000,0.3074
249.101.92.61,<->,53.245.112.116,2,941,0,0,2,941,0.252190000,0.1996
43.52.17.33,<->,8.252.221.204,0,0,2,904,2,904,0.251754000,1.0518
54.92.61.160,<->,48.53.32.49,0,0,2,139,2,139,0.251747000,0.3174
136.25.188.44,<->,126.219.247.16,2,2522,0,0,2,2522,0.251613000,0.2221
143.72.76.181,<->,136.25.188.220,0,0,2,1072,2,1072,0.250886000,0.0149
105.67.82.43,<->,8.252.222.114,0,0,2,656,2,656,0.250609000,0.2767
207.7.232.242,<->,136.25.188.241,0,0,2,888,2,888,0.250541000,0.0008
136.25.189.59,<->,8.255.92.169,2,2682,0,0,2,2682,0.250349000,1.5214
136.25.189.17,<->,29.211.93.6,2,2474,0,0,2,2474,0.248755000,1.0916
215.158.140.229,<->,119.196.23.70,2,2135,0,0,2,2135,0.248544000,1.1590
231.142.212.15,<->,215.158.239.84,0,0,2,606,2,606,0.248332000,0.0049
220.28.85.14,<->,136.25.189.38,0,0,2,822,2,822,0.248019000,1.2954
215.158.239.96,<->,207.63.146.161,2,188,0,0,2,188,0.247458000,0.0000
197.125.117.164,<->,133.178.227.24,0,0,2,2778,2,2778,0.246625000,0.6101
215.158.239.49,<->,195.81.38.28,2,188,0,0,2,188,0.246593000,0.0000
136.25.189.29,<->,126.219.194.10,2,2870,0,0,2,2870,0.246136000,0.6144
94.192.105.48,<->,8.252.222.157,0,0,2,188,2,188,0.245499000,0.0000
215.158.238.106,<->,113.23.21.196,2,2298,0,0,2,2298,0.245324000,0.8896
215.158.61.192,<->,99.74.26.195,0,0,2,760,2,760,0.244942000,0.1826
207.21.15.205,<->,8.252.222.157,0,0,2,430,2,430,0.244739000,0.4801
159.137.162.213,<->,117.20.151.128,2,676,0,0,2,676,0.244636000,0.3082
142.166.44.1,<->,136.25.188.252,0,0,2,955,2,955,0.244400000,0.3812
194.233.15.136,<->,136.25.188.226,0,0,2,1652,2,1652,0.243929000,0.7198
215.158.239.56,<->,194.237.63.165,2,390,0,0,2,390,0.243866000,1.1624
105.106.112.147,<->,50.224.76.234,0,0,2,2002,2,2002,0.243577000,0.2427
140.139.8.104,<->,100.228.42.193,0,0,2,1234,2,1234,0.243403000,0.2681
138.121.99.24,<->,8.220.190.86,0,0,2,1296,2,1296,0.242752000,0.0850
139.163.16.210,<->,82.99.227.248,2,2038,0,0,2,2038,0.242410000,0.2784
215.158.3.139,<->,8.176.8.248,0,0,2,1082,2,1082,0.242254000,0.0453
142.228.131.149,<->,136.25.188.55,0,0,2,955,2,955,0.241616000,0.4928
241.75.192.120,<->,221.101.180.140,0,0,2,1431,2,1431,0.241509000,0.2443
194.237.3.118,<->,136.25.188.46,0,0,2,188,2,188,0.241233000,0.0009
159.137.162.213,<->,117.128.121.205,2,888,0,0,2,888,0.241173000,0.3504
215.158.238.82,<->,122.159.245.169,2,2682,0,0,2,2682,0.241128000,0.1990
136.25.189.1,<->,120.154.131.7,2,2644,0,0,2,2644,0.241032000,0.2875
196.246.217.59,<->,136.25.188.243,0,0,2,880,2,880,0.240567000,0.2642
133.178.226.43,<->,8.222.48.187,2,1500,0,0,2,1500,0.240302000,0.0005
215.158.238.115,<->,192.226.161.17,2,2506,0,0,2,2506,0.240216000,1.7041
215.158.238.196,<->,113.23.101.139,2,2143,0,0,2,2143,0.239332000,0.5538
215.158.61.242,<->,8.176.8.210,0,0,2,1969,2,1969,0.238415000,0.1051
215.158.61.191,<->,8.176.8.216,0,0,2,1227,2,1227,0.238149000,0.7611
215.158.238.45,<->,29.214.71.108,2,2618,0,0,2,2618,0.237647000,0.2362
215.158.238.66,<->,112.220.206.117,2,1139,0,0,2,1139,0.237308000,0.5418
225.120.222.185,<->,215.158.238.122,0,0,2,2650,2,2650,0.237269000,1.4676
215.158.239.92,<->,199.32.187.69,2,164,0,0,2,164,0.237101000,0.0165
54.37.130.82,<->,48.53.20.198,0,0,2,1150,2,1150,0.237057000,0.2990
204.2.41.205,<->,136.25.188.54,0,0,2,948,2,948,0.236864000,0.0019
133.178.226.31,<->,29.214.108.64,2,2810,0,0,2,2810,0.236318000,0.3618
136.25.189.18,<->,29.212.199.244,2,2602,0,0,2,2602,0.236059000,0.3017
215.158.140.60,<->,111.151.78.71,2,1532,0,0,2,1532,0.235938000,1.5187
215.158.239.96,<->,199.20.6.41,2,1319,0,0,2,1319,0.235537000,0.6889
215.158.239.49,<->,195.43.121.138,2,950,0,0,2,950,0.235527000,0.3892
215.158.239.51,<->,196.92.185.188,2,1338,0,0,2,1338,0.235143000,0.0599
136.25.189.77,<->,29.211.228.213,2,2707,0,0,2,2707,0.235066000,0.2770
215.158.3.213,<->,99.74.87.197,0,0,2,342,2,342,0.235044000,0.0106
215.158.239.70,<->,199.20.29.39,2,188,0,0,2,188,0.235010000,0.0444
215.158.239.84,<->,199.20.30.50,2,188,0,0,2,188,0.234924000,0.0105
215.158.239.79,<->,199.20.31.225,2,450,0,0,2,450,0.234841000,0.3697
215.158.239.50,<->,199.32.187.69,2,164,0,0,2,164,0.233829000,0.0281
215.158.239.87,<->,195.81.84.48,2,683,0,0,2,683,0.233322000,0.5800
215.158.238.177,<->,197.125.88.37,2,2174,0,0,2,2174,0.233115000,1.7475
215.158.140.229,<->,29.212.42.171,2,2386,0,0,2,2386,0.232938000,0.9072
215.158.239.57,<->,196.1.222.152,2,1111,0,0,2,1111,0.232758000,0.1202
139.163.163.240,<->,133.178.227.16,0,0,2,2570,2,2570,0.232613000,0.3443
136.25.188.163,<->,29.211.186.214,2,2538,0,0,2,2538,0.232458000,1.4538
215.158.239.99,<->,207.213.103.43,2,1022,0,0,2,1022,0.231983000,0.0000
92.160.6.243,<->,33.233.141.118,0,0,2,124,2,124,0.231828000,1.0000
94.194.229.217,<->,8.252.222.140,0,0,2,774,2,774,0.230907000,0.1366
195.5.195.237,<->,136.25.188.175,0,0,2,188,2,188,0.230853000,0.0032
215.158.239.79,<->,204.61.156.93,2,1071,0,0,2,1071,0.230664000,0.0267
199.68.195.104,<->,136.25.188.174,0,0,2,1186,2,1186,0.230391000,0.8359
215.158.239.82,<->,129.175.139.13,2,418,0,0,2,418,0.230297000,0.0002
199.68.238.166,<->,136.25.188.239,0,0,2,188,2,188,0.229823000,0.0033
215.158.238.95,<->,122.159.245.154,2,2634,0,0,2,2634,0.229671000,1.6350
215.158.239.78,<->,33.209.219.164,2,698,0,0,2,698,0.229112000,0.7889
195.12.100.232,<->,136.25.188.176,0,0,2,518,2,518,0.228919000,0.6635
215.158.239.95,<->,199.20.30.229,2,907,0,0,2,907,0.228489000,0.4201
142.240.9.194,<->,136.25.188.199,0,0,2,485,2,485,0.228451000,0.2184
204.184.168.96,<->,136.25.188.163,0,0,2,430,2,430,0.228085000,1.6209
215.158.239.48,<->,199.20.31.74,2,1072,0,0,2,1072,0.227068000,0.2568
202.33.241.197,<->,136.25.188.240,0,0,2,188,2,188,0.227040000,0.0000
204.20.175.50,<->,136.25.188.222,0,0,2,1130,2,1130,0.227004000,0.2995
215.158.239.104,<->,111.151.237.117,2,900,0,0,2,900,0.226609000,0.0002
215.158.239.48,<->,199.20.30.82,2,188,0,0,2,188,0.225909000,0.0201
204.63.5.183,<->,136.25.188.53,0,0,2,971,2,971,0.225808000,0.4801
136.25.189.1,<->,96.156.169.221,2,2698,0,0,2,2698,0.225377000,1.3417
215.158.238.133,<->,104.3.161.24,2,2682,0,0,2,2682,0.225237000,1.1306
69.103.135.5,<->,8.252.221.222,0,0,2,646,2,646,0.225169000,1.0149
215.158.238.83,<->,131.144.113.216,2,2458,0,0,2,2458,0.225088000,0.4148
133.178.226.77,<->,48.131.158.252,2,2698,0,0,2,2698,0.224883000,0.5968
199.15.38.100,<->,136.25.188.252,0,0,2,1043,2,1043,0.223913000,0.0145
199.72.87.54,<->,136.25.188.178,0,0,2,1562,2,1562,0.223851000,0.1878
215.158.238.143,<->,113.23.104.203,2,454,0,0,2,454,0.223542000,0.7658
215.158.238.148,<->,111.151.70.20,2,2410,0,0,2,2410,0.223498000,1.6960
215.158.238.141,<->,80.57.141.53,2,2378,0,0,2,2378,0.223077000,1.3609
215.158.238.33,<->,113.23.104.245,2,2378,0,0,2,2378,0.223007000,1.1515
215.158.238.67,<->,131.2.115.245,2,2714,0,0,2,2714,0.222874000,1.6737
231.139.15.225,<->,136.25.188.55,0,0,2,955,2,955,0.222683000,0.0058
196.207.51.126,<->,136.25.188.243,0,0,2,971,2,971,0.222536000,0.3096
195.71.178.125,<->,136.25.188.255,0,0,2,314,2,314,0.222132000,0.0034
215.158.239.92,<->,196.91.247.212,2,1079,0,0,2,1079,0.222110000,0.1400
136.25.189.1,<->,29.211.228.176,2,2474,0,0,2,2474,0.221214000,0.2500
204.200.52.198,<->,136.25.188.44,0,0,2,1032,2,1032,0.220485000,0.0167
207.57.129.16,<->,136.25.188.55,0,0,2,1694,2,1694,0.220411000,0.2832
197.112.167.113,<->,136.25.188.55,0,0,2,296,2,296,0.220122000,0.0000
218.85.24.6,<->,97.198.121.79,0,0,2,418,2,418,0.219913000,0.1908
210.229.230.22,<->,99.213.176.44,2,186,0,0,2,186,0.219265000,1.1552
215.158.239.76,<->,199.20.31.158,2,188,0,0,2,188,0.219100000,0.0000
215.158.239.97,<->,199.20.30.153,2,849,0,0,2,849,0.218893000,0.5081
8.252.223.175,<->,8.219.184.94,2,2202,0,0,2,2202,0.218878000,1.6084
133.178.226.30,<->,57.160.181.229,2,2752,0,0,2,2752,0.218195000,1.5047
215.158.239.56,<->,199.20.29.11,2,1621,0,0,2,1621,0.218098000,1.1544
215.158.239.69,<->,142.227.33.164,2,1066,0,0,2,1066,0.217562000,0.0274
215.158.239.48,<->,207.56.159.104,2,430,0,0,2,430,0.216962000,1.5832
133.178.227.1,<->,126.219.100.183,2,2109,0,0,2,2109,0.216898000,1.4458
133.178.227.16,<->,29.214.108.32,2,2118,0,0,2,2118,0.216831000,0.4534
215.158.238.83,<->,143.227.65.227,2,2458,0,0,2,2458,0.214696000,0.9846
143.134.162.186,<->,136.25.188.242,0,0,2,1169,2,1169,0.214403000,0.0178
136.25.188.175,<->,8.222.212.21,2,2474,0,0,2,2474,0.214339000,1.7310
142.244.102.123,<->,136.25.188.178,0,0,2,188,2,188,0.213992000,0.0027
136.25.188.223,<->,131.144.114.209,2,2458,0,0,2,2458,0.213886000,1.2745
215.158.239.68,<->,199.20.29.145,2,951,0,0,2,951,0.213575000,0.0000
215.158.238.177,<->,29.211.6.106,2,2390,0,0,2,2390,0.213494000,1.3459
195.5.223.172,<->,136.25.188.241,0,0,2,680,2,680,0.213421000,0.1679
136.25.188.53,<->,101.224.63.210,2,188,0,0,2,188,0.213178000,0.0003
204.21.247.24,<->,136.25.188.252,0,0,2,188,2,188,0.213026000,0.0019
136.25.189.15,<->,96.156.169.246,2,1650,0,0,2,1650,0.212227000,0.8754
196.89.40.44,<->,136.25.188.220,0,0,2,956,2,956,0.212138000,0.0019
215.158.238.82,<->,126.219.132.246,2,2506,0,0,2,2506,0.212033000,0.6170
220.28.115.46,<->,133.178.227.37,0,0,2,1854,2,1854,0.211832000,0.4455
215.158.239.68,<->,196.91.81.242,2,186,0,0,2,186,0.211667000,0.0003
247.136.134.38,<->,126.198.147.25,2,680,0,0,2,680,0.211634000,1.7341
215.158.140.231,<->,159.137.139.1,2,2621,0,0,2,2621,0.211617000,0.6140
136.98.166.244,<->,8.220.200.124,0,0,2,432,2,432,0.211191000,0.0492
143.53.209.117,<->,136.25.188.220,0,0,2,440,2,440,0.210488000,0.3523
195.12.232.125,<->,136.25.188.196,0,0,2,188,2,188,0.210446000,0.0023
215.158.238.247,<->,215.158.43.33,2,652,0,0,2,652,0.210398000,1.5080
146.224.6.9,<->,8.252.222.38,0,0,2,303,2,303,0.210308000,0.0013
215.158.239.87,<->,199.20.28.152,2,1063,0,0,2,1063,0.209922000,0.0600
136.25.189.28,<->,118.20.100.187,2,2554,0,0,2,2554,0.209728000,1.5774
220.55.78.167,<->,119.53.54.165,2,406,0,0,2,406,0.209698000,1.1805
215.158.239.87,<->,204.56.124.43,2,439,0,0,2,439,0.208122000,0.1902
215.158.238.33,<->,65.27.220.196,2,2794,0,0,2,2794,0.207758000,0.9382
215.158.238.133,<->,112.220.206.107,2,2186,0,0,2,2186,0.207193000,1.2964
215.158.239.56,<->,143.89.225.38,2,164,0,0,2,164,0.206694000,0.0399
199.33.90.170,<->,136.25.188.199,0,0,2,188,2,188,0.206482000,0.0034
136.25.189.81,<->,89.80.251.5,2,2554,0,0,2,2554,0.206425000,0.6504
204.184.137.77,<->,136.25.188.255,0,0,2,1362,2,1362,0.206346000,1.0500
215.158.140.83,<->,131.219.230.219,2,2116,0,0,2,2116,0.206242000,0.7608
215.158.140.165,<->,89.134.6.42,2,713,0,0,2,713,0.206022000,0.7361
109.1.23.148,<->,98.18.91.3,2,2461,0,0,2,2461,0.205730000,0.0743
143.132.89.138,<->,136.25.188.208,0,0,2,915,2,915,0.205287000,0.1428
136.138.112.226,<->,136.25.188.162,0,0,2,2394,2,2394,0.205286000,0.3698
215.158.239.108,<->,215.158.61.202,2,2370,0,0,2,2370,0.205220000,0.0871
215.158.239.95,<->,194.232.115.252,2,1338,0,0,2,1338,0.204982000,0.9062
98.67.158.232,<->,53.196.74.85,2,1365,0,0,2,1365,0.204848000,0.9552
201.136.143.24,<->,136.25.188.220,0,0,2,2666,2,2666,0.204429000,1.1200
92.27.219.39,<->,78.46.142.27,2,892,0,0,2,892,0.204387000,1.0173
220.20.200.57,<->,132.216.159.29,2,720,0,0,2,720,0.203993000,0.0350
215.158.238.66,<->,142.234.196.200,2,2714,0,0,2,2714,0.203360000,1.5354
215.158.238.188,<->,131.219.230.246,2,2182,0,0,2,2182,0.203280000,1.3643
142.255.51.0,<->,136.25.188.222,0,0,2,188,2,188,0.203179000,0.0018
136.25.189.5,<->,100.216.78.145,2,2104,0,0,2,2104,0.202969000,0.3488
136.25.189.13,<->,29.212.199.201,2,2730,0,0,2,2730,0.202846000,1.0260
215.158.61.183,<->,8.176.8.109,0,0,2,2188,2,2188,0.202642000,1.7908
143.10.103.166,<->,136.25.188.255,0,0,2,795,2,795,0.202377000,1.4359
215.158.239.78,<->,194.203.39.243,2,188,0,0,2,188,0.202287000,0.0399
215.158.239.56,<->,195.83.176.83,2,1071,0,0,2,1071,0.202152000,0.1212
133.178.226.28,<->,128.194.247.212,2,2410,0,0,2,2410,0.202151000,1.1268
197.113.99.236,<->,136.25.188.55,0,0,2,764,2,764,0.201977000,1.7415
224.93.235.36,<->,80.27.157.15,0,0,2,2002,2,2002,0.201939000,0.7911
215.158.238.129,<->,97.174.232.195,2,1011,0,0,2,1011,0.201736000,1.6505
138.43.230.96,<->,136.25.188.44,0,0,2,188,2,188,0.201581000,0.0001
197.62.72.127,<->,91.231.195.145,0,0,2,536,2,536,0.201508000,1.0069
149.163.129.232,<->,136.25.189.14,0,0,2,2586,2,2586,0.201506000,0.5593
204.58.57.119,<->,136.25.188.220,0,0,2,1071,2,1071,0.201479000,1.0972
204.200.55.93,<->,136.25.188.220,0,0,2,774,2,774,0.201045000,0.6920
215.158.239.57,<->,196.93.237.136,2,188,0,0,2,188,0.200685000,0.0000
89.129.154.158,<->,8.182.136.20,0,0,2,402,2,402,0.200505000,1.0742
136.25.188.255,<->,29.214.108.100,2,2618,0,0,2,2618,0.199973000,0.2255
133.178.227.76,<->,8.50.171.202,2,2426,0,0,2,2426,0.199423000,1.6779
215.158.238.96,<->,143.155.227.33,2,1291,0,0,2,1291,0.199334000,1.7689
56.114.235.120,<->,8.228.209.115,0,0,2,1383,2,1383,0.199314000,0.0517
136.25.189.47,<->,8.215.68.89,2,2842,0,0,2,2842,0.199293000,0.8435
215.158.238.66,<->,112.235.116.38,2,2602,0,0,2,2602,0.199054000,0.6887
8.252.221.236,<->,4.123.51.114,2,902,0,0,2,902,0.198729000,1.0454
142.254.36.120,<->,136.25.188.224,0,0,2,440,2,440,0.198547000,0.0345
133.178.226.90,<->,113.23.104.221,2,2682,0,0,2,2682,0.198244000,0.1163
215.158.239.71,<->,29.213.219.40,2,2667,0,0,2,2667,0.198151000,1.7908
215.158.239.78,<->,29.213.219.54,2,2362,0,0,2,2362,0.197997000,0.2905
89.155.61.186,<->,80.38.51.106,0,0,2,730,2,730,0.197733000,0.0000
215.158.239.99,<->,142.247.228.137,2,955,0,0,2,955,0.196904000,0.2331
215.158.239.95,<->,29.211.5.250,2,2666,0,0,2,2666,0.196644000,0.7369
136.25.189.77,<->,29.209.59.213,2,2618,0,0,2,2618,0.196468000,0.2641
215.158.238.243,<->,113.23.66.34,2,2238,0,0,2,2238,0.196464000,1.0052
239.227.104.241,<->,221.102.143.189,2,790,0,0,2,790,0.196138000,0.1892
215.158.239.56,<->,199.82.240.23,2,778,0,0,2,778,0.196134000,0.1795
215.158.239.48,<->,199.20.31.67,2,499,0,0,2,499,0.196084000,0.0000
210.236.91.164,<->,92.162.253.193,0,0,2,418,2,418,0.195966000,0.8272
136.25.188.226,<->,8.255.92.231,2,2394,0,0,2,2394,0.195948000,1.0947
204.185.76.235,<->,136.25.188.45,0,0,2,234,2,234,0.195277000,0.2010
215.158.239.95,<->,143.53.141.154,2,840,0,0,2,840,0.195200000,0.0156
143.10.206.6,<->,136.25.188.163,0,0,2,430,2,430,0.195155000,0.3814
133.178.227.79,<->,131.1.195.40,2,2164,0,0,2,2164,0.194886000,1.1546
215.158.239.56,<->,195.97.60.49,2,774,0,0,2,774,0.194751000,0.1981
133.178.227.19,<->,38.104.11.116,2,2118,0,0,2,2118,0.194587000,0.4590
215.158.239.84,<->,126.219.194.82,2,1329,0,0,2,1329,0.194583000,0.2802
17.249.7.237,<->,8.53.2.20,0,0,2,736,2,736,0.194513000,0.1913
195.42.140.1,<->,136.25.188.252,0,0,2,721,2,721,0.194011000,0.2153
204.185.153.50,<->,136.25.188.242,0,0,2,950,2,950,0.193964000,0.0000
133.178.227.76,<->,8.53.216.92,2,2227,0,0,2,2227,0.193723000,1.7862
136.25.189.30,<->,8.222.58.213,2,2650,0,0,2,2650,0.193454000,0.4557
215.158.239.92,<->,142.207.250.149,2,436,0,0,2,436,0.193022000,0.3300
133.178.226.37,<->,65.27.228.203,2,2778,0,0,2,2778,0.192876000,1.1723
215.158.239.79,<->,204.61.173.58,2,1088,0,0,2,1088,0.192168000,0.0600
136.25.188.236,<->,30.73.96.89,2,989,0,0,2,989,0.191990000,0.0000
215.158.239.17,<->,139.161.104.228,2,2542,0,0,2,2542,0.191839000,1.7533
136.25.188.254,<->,41.157.110.196,2,188,0,0,2,188,0.191531000,0.0006
48.129.133.40,<->,8.252.222.196,0,0,2,2650,2,2650,0.191261000,1.2760
136.25.189.32,<->,131.144.115.105,2,2618,0,0,2,2618,0.191033000,1.5681
142.255.37.135,<->,136.25.188.225,0,0,2,188,2,188,0.190997000,0.0039
136.25.189.33,<->,104.154.137.0,2,2618,0,0,2,2618,0.189798000,0.8693
204.186.24.58,<->,136.25.188.172,0,0,2,194,2,194,0.189469000,0.4198
207.57.242.46,<->,136.25.188.239,0,0,2,976,2,976,0.189417000,0.2762
215.158.239.70,<->,156.165.37.73,2,2666,0,0,2,2666,0.188958000,0.8801
141.199.76.220,<->,136.25.189.77,0,0,2,2586,2,2586,0.188065000,0.5300
97.126.14.75,<->,53.154.203.180,2,1206,0,0,2,1206,0.188005000,0.9972
215.158.61.203,<->,8.176.8.183,0,0,2,1842,2,1842,0.187912000,0.0001
136.25.188.226,<->,57.210.107.16,2,1451,0,0,2,1451,0.187838000,0.3054
215.158.239.77,<->,199.32.102.1,2,1026,0,0,2,1026,0.187726000,0.0252
80.40.21.214,<->,8.45.175.127,2,866,0,0,2,866,0.187225000,0.1878
148.55.210.200,<->,136.25.189.47,0,0,2,2698,2,2698,0.187162000,0.0901
215.158.238.106,<->,104.154.137.221,2,2634,0,0,2,2634,0.186978000,1.7127
98.57.214.227,<->,8.228.218.33,0,0,2,826,2,826,0.186891000,0.0001
215.158.239.94,<->,194.237.65.93,2,543,0,0,2,543,0.186359000,0.3506
215.158.140.241,<->,112.93.136.122,2,2194,0,0,2,2194,0.185384000,1.2701
215.158.140.229,<->,8.252.253.251,2,2318,0,0,2,2318,0.184523000,1.0948
195.15.236.116,<->,136.25.188.220,0,0,2,1077,2,1077,0.184343000,0.2198
133.178.226.95,<->,100.216.78.145,2,2439,0,0,2,2439,0.184108000,0.8018
223.115.250.102,<->,8.252.221.206,0,0,2,452,2,452,0.183933000,1.0482
195.14.81.169,<->,136.25.188.198,0,0,2,393,2,393,0.183372000,0.0039
142.240.168.221,<->,136.25.188.210,0,0,2,188,2,188,0.183070000,0.0027
111.20.171.168,<->,101.224.89.131,0,0,2,2362,2,2362,0.183002000,1.2872
215.158.239.215,<->,215.158.61.202,2,2040,0,0,2,2040,0.182139000,1.5295
136.25.189.57,<->,6.116.14.9,2,2442,0,0,2,2442,0.181997000,1.6305
215.158.239.56,<->,199.20.31.227,2,774,0,0,2,774,0.181206000,0.3098
132.234.106.64,<->,111.181.113.65,0,0,2,498,2,498,0.180769000,0.1289
195.68.164.36,<->,136.25.188.238,0,0,2,188,2,188,0.180746000,0.0102
136.25.188.254,<->,8.255.92.213,2,2442,0,0,2,2442,0.180517000,1.1851
196.89.213.141,<->,136.25.188.54,0,0,2,513,2,513,0.180455000,0.0281
215.158.238.104,<->,143.227.65.147,2,2554,0,0,2,2554,0.178968000,1.3783
145.208.180.148,<->,53.213.71.13,2,838,0,0,2,838,0.178621000,1.3050
215.158.239.79,<->,199.20.4.144,2,380,0,0,2,380,0.178549000,1.2984
247.118.160.185,<->,8.182.248.147,0,0,2,462,2,462,0.178539000,0.0760
215.158.239.69,<->,199.68.13.79,2,656,0,0,2,656,0.178311000,0.3213
215.158.140.60,<->,131.144.113.150,2,2479,0,0,2,2479,0.178177000,1.5074
215.158.140.60,<->,126.219.194.41,2,2136,0,0,2,2136,0.177915000,1.4281
215.158.239.95,<->,196.106.37.250,2,1693,0,0,2,1693,0.177596000,0.9096
195.13.185.107,<->,136.25.188.178,0,0,2,188,2,188,0.177274000,0.0012
204.186.172.248,<->,136.25.188.209,0,0,2,960,2,960,0.177080000,0.6781
196.251.167.249,<->,80.41.29.163,0,0,2,182,2,182,0.176911000,0.3100
246.108.91.178,<->,145.252.114.80,0,0,2,662,2,662,0.176657000,0.1208
220.39.233.198,<->,136.25.188.160,0,0,2,2762,2,2762,0.176394000,0.3757
48.19.203.141,<->,8.252.221.238,0,0,2,532,2,532,0.175832000,0.3424
215.158.239.49,<->,8.249.253.226,2,2570,0,0,2,2570,0.175464000,0.2951
142.252.135.17,<->,136.25.188.253,0,0,2,1626,2,1626,0.174788000,0.0032
159.137.162.213,<->,112.9.227.40,2,697,0,0,2,697,0.174576000,0.2977
80.27.158.225,<->,75.92.190.105,2,306,0,0,2,306,0.174541000,0.0001
101.70.105.197,<->,27.11.126.141,2,176,0,0,2,176,0.174357000,1.1507
251.24.86.17,<->,8.252.222.161,0,0,2,1243,2,1243,0.174163000,0.4553
215.158.239.49,<->,199.20.29.83,2,1063,0,0,2,1063,0.174141000,0.0500
195.65.1.171,<->,133.178.227.70,0,0,2,2746,2,2746,0.173799000,0.9456
215.158.239.93,<->,195.70.19.228,2,202,0,0,2,202,0.172096000,0.0102
215.158.238.209,<->,126.219.102.4,2,2113,0,0,2,2113,0.171901000,1.8023
215.158.239.33,<->,149.96.60.149,2,2707,0,0,2,2707,0.171770000,1.6319
215.158.239.84,<->,143.91.200.242,2,188,0,0,2,188,0.171326000,0.0000
159.137.162.213,<->,117.39.53.205,2,676,0,0,2,676,0.171147000,0.2940
215.158.238.133,<->,113.23.104.203,2,2394,0,0,2,2394,0.171109000,0.6316
215.158.239.76,<->,199.20.31.201,2,1156,0,0,2,1156,0.171032000,0.0621
142.227.132.171,<->,136.25.188.54,0,0,2,954,2,954,0.170166000,0.0027
215.158.239.96,<->,199.20.30.17,2,944,0,0,2,944,0.170000000,0.0000
142.227.132.171,<->,136.25.188.225,0,0,2,954,2,954,0.169861000,0.1979
149.103.163.101,<->,92.27.194.117,0,0,2,235,2,235,0.169578000,0.1758
207.63.113.124,<->,136.25.188.46,0,0,2,264,2,264,0.169290000,1.0146
136.25.189.15,<->,32.183.36.244,2,2650,0,0,2,2650,0.168944000,1.6555
215.158.239.93,<->,199.20.7.13,2,1078,0,0,2,1078,0.168891000,0.6010
215.158.238.134,<->,192.204.170.196,2,2650,0,0,2,2650,0.168685000,1.1443
194.237.65.93,<->,136.25.188.177,0,0,2,405,2,405,0.168382000,1.8074
136.25.188.52,<->,6.73.9.188,2,2570,0,0,2,2570,0.168219000,1.7544
207.239.154.200,<->,136.25.188.198,0,0,2,434,2,434,0.168043000,0.0493
92.26.138.178,<->,14.125.23.243,0,0,2,292,2,292,0.167954000,1.4700
144.87.238.89,<->,8.182.244.19,0,0,2,994,2,994,0.166968000,0.4121
215.158.239.99,<->,195.80.198.59,2,774,0,0,2,774,0.166888000,0.3120
215.158.239.76,<->,204.61.202.136,2,955,0,0,2,955,0.166677000,0.3708
215.158.238.246,<->,98.219.126.140,2,783,0,0,2,783,0.166607000,1.3582
136.25.188.160,<->,69.150.169.185,2,2714,0,0,2,2714,0.166389000,0.4921
215.158.239.58,<->,204.226.22.61,2,789,0,0,2,789,0.165316000,0.0013
136.25.188.211,<->,8.188.227.37,2,2522,0,0,2,2522,0.164615000,1.1555
252.98.149.193,<->,212.249.34.46,2,1474,0,0,2,1474,0.163572000,0.0674
215.158.239.59,<->,56.161.218.55,2,2794,0,0,2,2794,0.163275000,1.3340
53.200.87.5,<->,48.54.6.32,0,0,2,613,2,613,0.163221000,0.2836
149.96.53.43,<->,136.25.188.221,0,0,2,2346,2,2346,0.163023000,0.5357
215.158.239.86,<->,199.20.30.122,2,188,0,0,2,188,0.162864000,0.0000
215.158.239.70,<->,199.20.28.0,2,1083,0,0,2,1083,0.162452000,0.0001
204.200.48.116,<->,136.25.188.176,0,0,2,190,2,190,0.162250000,1.2517
142.241.13.237,<->,136.25.188.55,0,0,2,955,2,955,0.162082000,0.6891
89.155.31.210,<->,8.183.25.124,0,0,2,451,2,451,0.160602000,0.1258
235.138.15.215,<->,8.182.253.209,0,0,2,869,2,869,0.160172000,0.2301
215.158.239.49,<->,195.7.115.113,2,1066,0,0,2,1066,0.160096000,0.9800
146.133.39.117,<->,8.252.222.174,0,0,2,656,2,656,0.159715000,0.1548
215.158.239.97,<->,113.92.151.94,2,2873,0,0,2,2873,0.159661000,1.3342
136.25.189.34,<->,96.156.169.222,2,2090,0,0,2,2090,0.159037000,0.5969
215.158.239.69,<->,199.20.30.137,2,960,0,0,2,960,0.158631000,0.0000
53.148.20.156,<->,48.53.11.144,0,0,2,1888,2,1888,0.158543000,0.0013
129.78.117.76,<->,50.200.168.165,2,1174,0,0,2,1174,0.158344000,0.1398
221.102.113.220,<->,207.193.113.191,2,932,0,0,2,932,0.158115000,0.4893
215.158.140.231,<->,100.50.96.248,2,2281,0,0,2,2281,0.158032000,1.6082
215.158.140.83,<->,29.214.211.23,2,2092,0,0,2,2092,0.157513000,1.1749
215.158.140.83,<->,106.188.244.183,2,2150,0,0,2,2150,0.157402000,1.1163
142.252.79.72,<->,136.25.188.163,0,0,2,188,2,188,0.157129000,0.0017
215.158.239.35,<->,120.155.14.139,2,1370,0,0,2,1370,0.156741000,1.6336
196.89.213.141,<->,136.25.188.236,0,0,2,1103,2,1103,0.156654000,0.0153
132.216.159.4,<->,92.162.253.42,0,0,2,601,2,601,0.155863000,0.0000
215.158.140.83,<->,8.221.197.173,2,2457,0,0,2,2457,0.155833000,0.5175
100.240.143.236,<->,8.53.0.167,0,0,2,656,2,656,0.155731000,0.0327
215.158.238.83,<->,119.168.0.132,2,2362,0,0,2,2362,0.155671000,0.5068
215.158.238.251,<->,148.190.126.56,2,2086,0,0,2,2086,0.155526000,1.1211
142.208.39.25,<->,136.25.188.162,0,0,2,188,2,188,0.155409000,0.0029
192.227.190.20,<->,133.178.227.41,0,0,2,2650,2,2650,0.155257000,0.7126
220.55.112.205,<->,139.181.243.246,2,1078,0,0,2,1078,0.155230000,0.0000
149.163.129.230,<->,136.25.189.13,0,0,2,2410,2,2410,0.154979000,1.5659
133.178.226.18,<->,131.1.232.135,2,2698,0,0,2,2698,0.154847000,0.3534
220.51.255.205,<->,215.158.140.201,0,0,2,657,2,657,0.154721000,0.0228
139.160.226.173,<->,136.25.189.17,0,0,2,1554,2,1554,0.154514000,1.4748
215.158.238.133,<->,131.144.115.170,2,2218,0,0,2,2218,0.154409000,1.0665
215.158.239.70,<->,196.88.157.175,2,1026,0,0,2,1026,0.154366000,0.1531
215.158.238.59,<->,99.192.168.182,2,2843,0,0,2,2843,0.154198000,1.7880
143.45.0.148,<->,133.178.226.31,0,0,2,2794,2,2794,0.154146000,0.4145
136.25.189.17,<->,8.255.92.150,2,2618,0,0,2,2618,0.153221000,0.8781
220.28.114.28,<->,215.158.239.54,0,0,2,410,2,410,0.153002000,0.0001
215.158.238.135,<->,113.23.104.215,2,2442,0,0,2,2442,0.152245000,0.4222
215.158.239.69,<->,65.27.228.181,2,2554,0,0,2,2554,0.152174000,0.9270
142.228.19.170,<->,136.25.188.242,0,0,2,202,2,202,0.151946000,0.0181
133.178.226.56,<->,98.219.126.175,2,568,0,0,2,568,0.151878000,0.9851
215.158.239.56,<->,196.108.80.66,2,1080,0,0,2,1080,0.151832000,0.0586
156.165.37.84,<->,136.25.189.28,0,0,2,2602,2,2602,0.151644000,0.8244
207.175.167.40,<->,136.25.188.242,0,0,2,1078,2,1078,0.151409000,1.5803
195.55.67.217,<->,136.25.188.46,0,0,2,880,2,880,0.151328000,0.0735
215.158.239.87,<->,199.20.30.101,2,1080,0,0,2,1080,0.151097000,0.0101
215.158.140.231,<->,68.231.26.217,2,2272,0,0,2,2272,0.150959000,1.5719
207.119.143.199,<->,8.252.222.51,0,0,2,372,2,372,0.150954000,0.0175
136.25.188.221,<->,57.210.107.42,2,2570,0,0,2,2570,0.150642000,0.3160
215.158.239.95,<->,196.1.147.146,2,774,0,0,2,774,0.150511000,0.3593
215.158.239.93,<->,196.240.220.57,2,941,0,0,2,941,0.150450000,0.0016
215.158.238.243,<->,61.35.70.33,2,2150,0,0,2,2150,0.150121000,1.1912
215.158.239.92,<->,199.20.4.225,2,1078,0,0,2,1078,0.149771000,0.0705
215.158.140.87,<->,105.23.235.84,2,1106,0,0,2,1106,0.149074000,0.6689
195.41.245.135,<->,136.25.188.174,0,0,2,1695,2,1695,0.149005000,0.4866
136.25.189.1,<->,120.154.131.21,2,2618,0,0,2,2618,0.148455000,0.1489
215.158.238.80,<->,120.154.221.217,2,2394,0,0,2,2394,0.148401000,1.8000
215.158.239.93,<->,199.20.5.124,2,800,0,0,2,800,0.148374000,0.0243
143.135.41.182,<->,136.25.188.224,0,0,2,440,2,440,0.148180000,0.2955
215.158.238.9,<->,96.38.231.124,2,1490,0,0,2,1490,0.146936000,1.1344
142.209.175.125,<->,136.25.188.236,0,0,2,1154,2,1154,0.146767000,0.5337
148.55.210.235,<->,136.25.189.16,0,0,2,2346,2,2346,0.146505000,0.5000
215.158.239.96,<->,199.20.31.215,2,1562,0,0,2,1562,0.146227000,0.7204
220.20.200.55,<->,127.62.25.159,2,2472,0,0,2,2472,0.145926000,0.0007
204.184.189.241,<->,136.25.188.55,0,0,2,1083,2,1083,0.145862000,0.8395
249.101.125.43,<->,109.124.142.60,2,738,0,0,2,738,0.145656000,0.1694
197.125.110.221,<->,136.25.189.77,0,0,2,2506,2,2506,0.145505000,0.8778
195.7.218.163,<->,136.25.188.240,0,0,2,696,2,696,0.144882000,0.0097
193.39.70.95,<->,133.178.226.28,0,0,2,2522,2,2522,0.144368000,0.1737
215.158.239.56,<->,207.167.248.82,2,731,0,0,2,731,0.144311000,0.4300
224.93.235.37,<->,80.27.157.204,0,0,2,2674,2,2674,0.143697000,0.5255
192.224.146.144,<->,133.178.226.85,0,0,2,1493,2,1493,0.143430000,0.0011
194.218.10.143,<->,8.182.248.147,0,0,2,462,2,462,0.143359000,0.3187
133.178.226.212,<->,113.93.9.37,2,1479,0,0,2,1479,0.142890000,1.5923
136.114.101.93,<->,136.25.188.234,0,0,2,754,2,754,0.142711000,0.0001
215.158.238.104,<->,80.47.111.11,2,2586,0,0,2,2586,0.141997000,0.7951
141.97.5.136,<->,133.54.43.55,0,0,2,630,2,630,0.141746000,1.3773
215.158.238.132,<->,29.211.6.19,2,2284,0,0,2,2284,0.141516000,0.9622
215.158.239.56,<->,199.20.6.247,2,966,0,0,2,966,0.141367000,0.0000
17.15.182.172,<->,8.220.239.104,0,0,2,1500,2,1500,0.141131000,0.1290
143.10.144.64,<->,136.25.188.255,0,0,2,907,2,907,0.140975000,0.2334
207.172.190.167,<->,136.25.188.252,0,0,2,188,2,188,0.140822000,0.0000
215.158.239.99,<->,196.106.144.16,2,1338,0,0,2,1338,0.140799000,0.0401
136.25.188.237,<->,8.42.43.8,2,2682,0,0,2,2682,0.140650000,1.3805
136.25.188.225,<->,57.199.250.202,2,2730,0,0,2,2730,0.140618000,0.3268
207.178.51.137,<->,50.224.96.57,0,0,2,126,2,126,0.140585000,0.1504
133.178.227.1,<->,8.53.216.49,2,2194,0,0,2,2194,0.140059000,0.1739
215.158.238.188,<->,8.219.185.56,2,2538,0,0,2,2538,0.139878000,1.7443
215.158.238.33,<->,128.123.91.10,2,2538,0,0,2,2538,0.139614000,1.1196
36.116.164.202,<->,8.252.222.30,0,0,2,788,2,788,0.139536000,0.1828
194.245.177.149,<->,8.182.224.248,0,0,2,658,2,658,0.139393000,0.6806
215.158.239.56,<->,194.234.144.120,2,1076,0,0,2,1076,0.138841000,0.0148
215.158.239.50,<->,204.2.177.117,2,1081,0,0,2,1081,0.138615000,0.1101
215.158.238.134,<->,91.57.173.26,2,2538,0,0,2,2538,0.138268000,1.7082
215.158.238.198,<->,195.65.1.162,2,2185,0,0,2,2185,0.137873000,1.0715
222.62.112.179,<->,48.53.187.107,0,0,2,444,2,444,0.137857000,0.8721
215.158.239.78,<->,149.96.171.91,2,2490,0,0,2,2490,0.137778000,0.5320
142.253.203.77,<->,136.25.188.198,0,0,2,584,2,584,0.137559000,0.6263
215.171.79.67,<->,8.52.173.229,0,0,2,2044,2,2044,0.137420000,0.1239
215.158.238.75,<->,112.220.206.24,2,2458,0,0,2,2458,0.136802000,1.1977
159.137.139.27,<->,133.178.226.70,0,0,2,2634,2,2634,0.136543000,1.1403
207.173.68.4,<->,136.25.188.197,0,0,2,875,2,875,0.136344000,0.4694
215.158.239.87,<->,156.165.37.111,2,2634,0,0,2,2634,0.135874000,0.6944
207.22.228.195,<->,0.195.210.46,0,0,2,522,2,522,0.135822000,0.2935
142.255.148.143,<->,136.25.188.162,0,0,2,164,2,164,0.135560000,0.0042
215.158.238.45,<->,122.159.34.246,2,2426,0,0,2,2426,0.135045000,0.7597
207.236.49.110,<->,136.25.188.225,0,0,2,1211,2,1211,0.135003000,1.7051
215.158.239.113,<->,129.222.39.230,2,1150,0,0,2,1150,0.134928000,0.5797
136.25.189.34,<->,29.211.5.230,2,2538,0,0,2,2538,0.134686000,1.1482
215.158.239.93,<->,29.211.228.247,2,2771,0,0,2,2771,0.134450000,0.3418
136.25.188.199,<->,80.47.111.87,2,2378,0,0,2,2378,0.133841000,1.5568
136.25.189.80,<->,133.224.119.55,2,2778,0,0,2,2778,0.133818000,0.2554
142.208.205.70,<->,136.25.188.226,0,0,2,439,2,439,0.133407000,0.2404
207.239.27.8,<->,136.25.188.253,0,0,2,1068,2,1068,0.133376000,0.0077
215.158.239.24,<->,111.151.137.161,2,502,0,0,2,502,0.133062000,1.2140
215.158.239.87,<->,195.126.107.17,2,1072,0,0,2,1072,0.133045000,0.0148
148.56.229.119,<->,136.25.189.59,0,0,2,2554,2,2554,0.132138000,1.7025
215.158.239.58,<->,199.80.28.204,2,1206,0,0,2,1206,0.131679000,1.5649
215.158.239.84,<->,196.106.160.213,2,896,0,0,2,896,0.131519000,0.0607
149.250.115.54,<->,136.25.188.237,0,0,2,2506,2,2506,0.131444000,0.4119
133.178.226.90,<->,112.235.95.26,2,2522,0,0,2,2522,0.131190000,0.4291
215.158.239.93,<->,195.81.124.45,2,188,0,0,2,188,0.130882000,0.0000
136.25.189.59,<->,112.68.105.215,2,2682,0,0,2,2682,0.130788000,1.1409
195.70.116.13,<->,136.25.188.162,0,0,2,188,2,188,0.130269000,0.0010
215.158.140.60,<->,122.158.179.5,2,2121,0,0,2,2121,0.130167000,1.8244
215.158.239.84,<->,196.240.181.125,2,955,0,0,2,955,0.130074000,0.1959
215.158.140.147,<->,8.222.7.162,2,1549,0,0,2,1549,0.129892000,1.8408
136.25.188.175,<->,122.158.49.128,2,1634,0,0,2,1634,0.129889000,1.4834
92.26.154.123,<->,14.94.93.84,0,0,2,654,2,654,0.129790000,0.0000
215.158.238.148,<->,113.23.104.246,2,2298,0,0,2,2298,0.128959000,1.4129
215.158.238.123,<->,149.99.92.107,2,2410,0,0,2,2410,0.128716000,1.7363
215.158.61.189,<->,8.176.8.188,0,0,2,2266,2,2266,0.128582000,0.9442
153.168.22.239,<->,8.252.221.204,0,0,2,908,2,908,0.127594000,1.0617
80.40.17.181,<->,50.248.186.141,2,3008,0,0,2,3008,0.127011000,1.2162
215.158.238.83,<->,139.160.226.200,2,2586,0,0,2,2586,0.126378000,1.8300
196.87.49.136,<->,136.25.188.239,0,0,2,1723,2,1723,0.126367000,0.6398
136.129.71.11,<->,75.92.190.105,2,1478,0,0,2,1478,0.126316000,1.7642
215.158.239.58,<->,196.94.143.43,2,188,0,0,2,188,0.125834000,0.0200
136.138.112.13,<->,133.178.227.41,0,0,2,2938,2,2938,0.125719000,0.1562
144.83.112.140,<->,108.134.90.45,0,0,2,413,2,413,0.125634000,0.0421
136.25.188.44,<->,122.159.245.148,2,2618,0,0,2,2618,0.125099000,1.2651
252.98.149.193,<->,212.249.34.8,2,233,0,0,2,233,0.125016000,0.0008
195.14.126.103,<->,136.25.188.209,0,0,2,440,2,440,0.124248000,1.3356
111.20.168.185,<->,27.127.250.105,2,124,0,0,2,124,0.123985000,0.9993
133.178.226.31,<->,113.23.104.221,2,2522,0,0,2,2522,0.123849000,0.1170
221.102.143.189,<->,192.67.90.143,0,0,2,1670,2,1670,0.123664000,0.1677
148.165.26.29,<->,139.193.141.139,0,0,2,563,2,563,0.123585000,0.0087
215.158.238.113,<->,118.20.114.90,2,2650,0,0,2,2650,0.123307000,0.5620
104.153.164.174,<->,92.27.27.157,0,0,2,122,2,122,0.123213000,1.3995
215.158.238.133,<->,131.1.232.134,2,2554,0,0,2,2554,0.122807000,0.4480
111.150.187.125,<->,8.252.223.143,0,0,2,2058,2,2058,0.122492000,1.0601
92.168.217.229,<->,29.219.3.90,2,638,0,0,2,638,0.122445000,1.0810
215.158.239.78,<->,199.20.28.221,2,188,0,0,2,188,0.121115000,0.0099
133.178.227.76,<->,130.165.253.13,2,2488,0,0,2,2488,0.121022000,1.2879
195.43.49.234,<->,136.25.188.177,0,0,2,188,2,188,0.120973000,0.0020
196.89.228.140,<->,136.25.188.241,0,0,2,188,2,188,0.120885000,0.0025
205.184.168.20,<->,80.40.56.209,0,0,2,1352,2,1352,0.120437000,0.0001
136.25.188.223,<->,91.247.40.2,2,938,0,0,2,938,0.120338000,0.9281
215.158.239.49,<->,199.20.29.232,2,955,0,0,2,955,0.119811000,0.0000
215.158.239.95,<->,196.89.59.150,2,1071,0,0,2,1071,0.118893000,0.0136
247.136.156.42,<->,105.67.199.153,2,128,0,0,2,128,0.118621000,0.2012
215.158.239.56,<->,199.20.31.74,2,819,0,0,2,819,0.117729000,0.0000
204.56.107.102,<->,136.25.188.45,0,0,2,188,2,188,0.117587000,0.0030
215.158.61.193,<->,8.176.8.210,0,0,2,1130,2,1130,0.116972000,0.2606
215.158.238.73,<->,113.23.104.221,2,2314,0,0,2,2314,0.116821000,1.6686
215.158.61.193,<->,8.176.8.228,0,0,2,1316,2,1316,0.116712000,0.3536
99.187.125.121,<->,8.20.87.5,0,0,2,1145,2,1145,0.116028000,0.3575
215.158.239.85,<->,204.0.247.88,2,188,0,0,2,188,0.115634000,0.0105
215.158.238.113,<->,141.199.67.37,2,2426,0,0,2,2426,0.114673000,1.4671
148.26.113.119,<->,133.178.227.1,0,0,2,2134,2,2134,0.114607000,1.1873
215.158.238.220,<->,8.222.213.13,2,2103,0,0,2,2103,0.114255000,0.3433
139.148.164.122,<->,8.182.139.197,0,0,2,656,2,656,0.114107000,0.0758
220.28.73.211,<->,215.158.238.139,0,0,2,2028,2,2028,0.112357000,0.6389
136.25.188.196,<->,69.31.238.54,2,2506,0,0,2,2506,0.112280000,1.4792
215.158.239.5,<->,126.219.102.252,2,205,0,0,2,205,0.112112000,0.4115
206.103.215.59,<->,136.25.189.59,0,0,2,2586,2,2586,0.111828000,1.7784
215.158.238.99,<->,122.158.51.62,2,2634,0,0,2,2634,0.111677000,0.4427
199.38.49.30,<->,136.25.188.209,0,0,2,774,2,774,0.111650000,0.1863
143.52.58.245,<->,136.25.188.238,0,0,2,1214,2,1214,0.111506000,1.7201
108.134.119.54,<->,38.173.223.206,2,194,0,0,2,194,0.111482000,1.1671
215.158.238.95,<->,131.144.113.193,2,2426,0,0,2,2426,0.111449000,0.4782
133.178.226.38,<->,32.183.36.100,2,2570,0,0,2,2570,0.111376000,0.4072
140.20.190.103,<->,80.27.159.28,0,0,2,1722,2,1722,0.111324000,0.3761
215.158.239.93,<->,194.251.117.13,2,188,0,0,2,188,0.111169000,0.0000
215.158.238.250,<->,106.188.244.180,2,2410,0,0,2,2410,0.111093000,1.5878
215.158.239.70,<->,113.92.151.56,2,2847,0,0,2,2847,0.111042000,1.2141
215.158.238.114,<->,131.1.195.251,2,2682,0,0,2,2682,0.111006000,0.9270
8.252.221.230,<->,4.122.60.98,2,908,0,0,2,908,0.111002000,1.0291
133.178.226.30,<->,29.211.122.180,2,2314,0,0,2,2314,0.110699000,0.1606
215.158.239.49,<->,199.20.5.235,2,962,0,0,2,962,0.110464000,0.3698
215.158.239.50,<->,196.90.43.112,2,1055,0,0,2,1055,0.110205000,0.0612
133.178.227.27,<->,113.23.101.149,2,2044,0,0,2,2044,0.110202000,0.9758
98.128.214.64,<->,8.45.175.127,2,282,0,0,2,282,0.110012000,0.4689
204.63.80.101,<->,136.25.188.177,0,0,2,1079,2,1079,0.109949000,0.0001
207.56.188.98,<->,136.25.188.226,0,0,2,983,2,983,0.109437000,0.0034
215.158.238.133,<->,212.70.217.101,2,2586,0,0,2,2586,0.109131000,1.7810
215.158.238.133,<->,113.23.21.215,2,2458,0,0,2,2458,0.108572000,0.9418
133.178.226.28,<->,114.150.180.157,2,2394,0,0,2,2394,0.108522000,1.3453
215.158.239.17,<->,8.255.92.117,2,2433,0,0,2,2433,0.108517000,0.8463
215.158.239.49,<->,195.5.15.69,2,1205,0,0,2,1205,0.108440000,0.2714
136.25.189.11,<->,96.156.169.251,2,1932,0,0,2,1932,0.108306000,1.2504
133.178.227.27,<->,8.222.213.12,2,2185,0,0,2,2185,0.107431000,0.5196
75.31.146.58,<->,8.252.221.204,0,0,2,904,2,904,0.107290000,1.2720
215.158.238.114,<->,118.20.87.65,2,2538,0,0,2,2538,0.107097000,1.5955
204.2.252.19,<->,136.25.188.177,0,0,2,390,2,390,0.106217000,0.0036
115.85.162.14,<->,50.224.76.230,0,0,2,803,2,803,0.106040000,0.0009
143.13.221.216,<->,136.25.188.220,0,0,2,1063,2,1063,0.106019000,0.0237
142.166.98.108,<->,136.25.188.238,0,0,2,1699,2,1699,0.105879000,0.4047
215.158.239.92,<->,207.60.61.97,2,956,0,0,2,956,0.105089000,0.0157
110.66.221.173,<->,92.27.219.247,0,0,2,1490,2,1490,0.103853000,0.1260
215.158.238.33,<->,192.226.161.144,2,2458,0,0,2,2458,0.103487000,0.9518
220.28.114.28,<->,133.178.227.6,0,0,2,410,2,410,0.103403000,0.0001
136.25.189.88,<->,89.80.251.8,2,2426,0,0,2,2426,0.103335000,0.6110
199.73.34.80,<->,136.25.188.225,0,0,2,188,2,188,0.102767000,0.0160
204.187.124.135,<->,136.25.188.46,0,0,2,188,2,188,0.102722000,0.0097
136.25.188.221,<->,126.219.132.252,2,2506,0,0,2,2506,0.102485000,1.2203
215.158.239.85,<->,204.2.170.9,2,852,0,0,2,852,0.101965000,0.0697
215.158.140.75,<->,159.137.139.1,2,2280,0,0,2,2280,0.101682000,1.2272
215.158.238.66,<->,89.86.110.85,2,2490,0,0,2,2490,0.101305000,1.3396
195.127.59.18,<->,136.25.188.54,0,0,2,188,2,188,0.100115000,0.0018
231.136.216.8,<->,136.25.188.238,0,0,2,188,2,188,0.099996000,0.0019
215.158.238.134,<->,50.218.56.251,2,2458,0,0,2,2458,0.099868000,1.0549
200.174.194.133,<->,53.245.246.100,2,590,0,0,2,590,0.099842000,0.3106
215.158.238.188,<->,8.50.170.174,2,2319,0,0,2,2319,0.099745000,0.8902
136.25.189.82,<->,120.154.71.23,2,2442,0,0,2,2442,0.099422000,0.1051
195.125.180.140,<->,136.25.188.45,0,0,2,953,2,953,0.099379000,0.2753
215.158.239.50,<->,196.91.242.68,2,188,0,0,2,188,0.099326000,0.0101
86.135.107.2,<->,8.252.222.132,0,0,2,774,2,774,0.099127000,0.1930
215.158.61.183,<->,8.176.8.181,0,0,2,2842,2,2842,0.099098000,0.7867
215.158.239.30,<->,106.188.184.73,2,1567,0,0,2,1567,0.097697000,0.2664
198.154.155.94,<->,50.224.76.230,0,0,2,753,2,753,0.097503000,0.8527
207.201.68.244,<->,92.27.194.147,0,0,2,490,2,490,0.097446000,0.0146
196.242.4.14,<->,136.25.188.177,0,0,2,776,2,776,0.097061000,0.0795
215.158.239.56,<->,207.188.67.91,2,955,0,0,2,955,0.097009000,0.2285
133.178.226.61,<->,120.20.132.40,2,2394,0,0,2,2394,0.096825000,0.5594
215.158.239.66,<->,80.57.141.226,2,690,0,0,2,690,0.095607000,0.0001
215.158.238.135,<->,134.172.158.198,2,2506,0,0,2,2506,0.095459000,0.6486
215.158.238.81,<->,32.183.36.33,2,2426,0,0,2,2426,0.095384000,0.6118
220.50.242.203,<->,215.158.239.104,0,0,2,218,2,218,0.095031000,0.0035
231.142.8.154,<->,136.25.188.238,0,0,2,188,2,188,0.094194000,0.0022
215.158.238.99,<->,65.27.220.203,2,2506,0,0,2,2506,0.094055000,1.4033
215.158.239.76,<->,199.20.30.89,2,202,0,0,2,202,0.093994000,1.3901
139.163.66.167,<->,97.113.65.172,2,2254,0,0,2,2254,0.093772000,0.7192
205.127.108.115,<->,101.224.89.171,0,0,2,1119,2,1119,0.093621000,0.4827
215.158.239.95,<->,207.236.115.177,2,1136,0,0,2,1136,0.093568000,0.0146
231.140.69.7,<->,215.158.239.51,0,0,2,656,2,656,0.092877000,0.1645
215.158.239.49,<->,8.249.253.247,2,2602,0,0,2,2602,0.092745000,0.3339
133.178.227.24,<->,61.35.22.228,2,2230,0,0,2,2230,0.092420000,1.2859
215.158.239.166,<->,8.222.213.141,2,266,0,0,2,266,0.092312000,1.2754
245.244.35.2,<->,8.182.226.78,0,0,2,656,2,656,0.092278000,0.1612
251.24.86.2,<->,8.252.222.142,0,0,2,950,2,950,0.091908000,0.0000
195.13.194.219,<->,136.25.188.220,0,0,2,1074,2,1074,0.091660000,0.0150
215.158.239.56,<->,204.61.244.226,2,440,0,0,2,440,0.091559000,0.2377
75.214.182.135,<->,8.252.221.236,0,0,2,902,2,902,0.091469000,1.0830
210.229.230.21,<->,111.74.211.171,2,199,0,0,2,199,0.091377000,0.0040
197.113.99.98,<->,136.25.188.46,0,0,2,971,2,971,0.090947000,1.0899
133.178.226.61,<->,113.23.104.213,2,2458,0,0,2,2458,0.090293000,0.4719
17.97.197.211,<->,8.220.187.147,0,0,2,1116,2,1116,0.089644000,0.1240
215.158.239.99,<->,199.20.5.176,2,188,0,0,2,188,0.089563000,0.0372
133.178.226.70,<->,48.129.132.246,2,2506,0,0,2,2506,0.089222000,0.7415
17.41.75.11,<->,8.220.200.124,0,0,2,432,2,432,0.089086000,0.0963
215.158.238.196,<->,8.222.58.187,2,2179,0,0,2,2179,0.088488000,1.1013
215.158.239.56,<->,194.250.222.108,2,340,0,0,2,340,0.087956000,0.0372
215.158.239.93,<->,142.166.44.108,2,459,0,0,2,459,0.087694000,1.1008
215.158.239.41,<->,120.155.14.71,2,1503,0,0,2,1503,0.087598000,1.1646
195.40.113.60,<->,136.25.188.45,0,0,2,188,2,188,0.087237000,0.0042
136.25.189.32,<->,96.156.169.234,2,2714,0,0,2,2714,0.086709000,0.1387
220.28.85.14,<->,215.158.140.247,0,0,2,1086,2,1086,0.086649000,0.1505
215.158.239.70,<->,199.20.29.132,2,774,0,0,2,774,0.086506000,0.3896
215.158.239.85,<->,113.23.100.182,2,2506,0,0,2,2506,0.086389000,0.7926
111.146.199.215,<->,97.110.90.234,2,1090,0,0,2,1090,0.086380000,0.0001
133.178.227.27,<->,111.150.187.231,2,2091,0,0,2,2091,0.086165000,1.1891
215.158.239.56,<->,199.121.37.140,2,956,0,0,2,956,0.085925000,0.0018
207.57.19.45,<->,136.25.188.241,0,0,2,194,2,194,0.085271000,0.1012
215.158.239.48,<->,143.91.207.152,2,202,0,0,2,202,0.084997000,1.5301
133.178.226.90,<->,8.253.128.68,2,2746,0,0,2,2746,0.084276000,0.8171
111.11.29.157,<->,8.182.139.197,0,0,2,1947,2,1947,0.083947000,0.0011
215.158.239.56,<->,199.20.31.247,2,188,0,0,2,188,0.083408000,0.0000
111.150.187.185,<->,8.252.223.153,0,0,2,2570,2,2570,0.083362000,0.1092
231.140.229.197,<->,215.158.239.84,0,0,2,279,2,279,0.083270000,0.0037
136.25.189.0,<->,29.211.228.154,2,2695,0,0,2,2695,0.083207000,0.2190
111.147.191.120,<->,54.43.0.78,2,1377,0,0,2,1377,0.083136000,0.3566
136.25.188.176,<->,29.214.108.191,2,1978,0,0,2,1978,0.082577000,0.1465
133.178.227.19,<->,133.56.180.83,2,2714,0,0,2,2714,0.082506000,0.8953
215.158.140.83,<->,131.144.114.248,2,2168,0,0,2,2168,0.082437000,0.8358
95.246.87.146,<->,8.252.221.236,0,0,2,904,2,904,0.081978000,1.0240
142.208.195.173,<->,136.25.188.46,0,0,2,1033,2,1033,0.081784000,0.7311
215.158.239.99,<->,199.20.31.109,2,990,0,0,2,990,0.081242000,0.1291
142.249.138.140,<->,136.25.188.220,0,0,2,1200,2,1200,0.081114000,0.4244
133.178.227.70,<->,122.159.123.27,2,2227,0,0,2,2227,0.080690000,1.0305
220.28.85.14,<->,215.158.239.46,0,0,2,1873,2,1873,0.080253000,0.0033
196.251.73.169,<->,8.252.222.179,0,0,2,891,2,891,0.080243000,0.2454
136.25.189.87,<->,56.28.207.196,2,2155,0,0,2,2155,0.080243000,0.3879
215.158.239.79,<->,199.122.13.65,2,202,0,0,2,202,0.080142000,0.1451
215.158.239.56,<->,143.13.107.14,2,1141,0,0,2,1141,0.080025000,0.0394
112.208.20.249,<->,102.51.5.223,0,0,2,326,2,326,0.079841000,0.4443
215.158.239.48,<->,143.94.230.214,2,954,0,0,2,954,0.079813000,0.3000
100.228.42.160,<->,17.202.109.191,2,1170,0,0,2,1170,0.079147000,0.1080
192.64.227.90,<->,117.71.193.184,2,122,0,0,2,122,0.079138000,0.6233
199.51.130.193,<->,136.25.188.208,0,0,2,1071,2,1071,0.079097000,0.0265
195.15.131.184,<->,136.25.188.176,0,0,2,947,2,947,0.078601000,0.1526
215.158.239.49,<->,133.56.180.31,2,2602,0,0,2,2602,0.078280000,1.2661
215.158.239.50,<->,8.222.58.218,2,2570,0,0,2,2570,0.077635000,1.7482
245.61.110.28,<->,136.25.188.220,0,0,2,404,2,404,0.077551000,1.0011
215.158.238.120,<->,192.224.20.17,2,2554,0,0,2,2554,0.077414000,0.6761
136.181.51.228,<->,53.195.228.175,2,708,0,0,2,708,0.077404000,1.4769
204.186.152.142,<->,136.25.188.238,0,0,2,964,2,964,0.076970000,0.2000
215.158.61.195,<->,8.176.8.212,0,0,2,2038,2,2038,0.076808000,1.4707
215.158.239.78,<->,199.20.28.17,2,1079,0,0,2,1079,0.076793000,0.0610
204.184.127.58,<->,136.25.188.53,0,0,2,1701,2,1701,0.076757000,0.4803
109.222.200.67,<->,50.145.81.54,2,504,0,0,2,504,0.076604000,0.0809
215.158.238.83,<->,131.173.115.91,2,2426,0,0,2,2426,0.076531000,0.8055
215.158.239.99,<->,207.228.5.17,2,202,0,0,2,202,0.076332000,0.0000
215.158.238.82,<->,122.159.245.148,2,2378,0,0,2,2378,0.076276000,0.7517
136.25.188.240,<->,113.23.104.247,2,2282,0,0,2,2282,0.076206000,1.0085
136.25.188.241,<->,41.48.192.108,2,188,0,0,2,188,0.075858000,0.0009
199.68.100.152,<->,136.25.188.176,0,0,2,188,2,188,0.075845000,0.0027
215.158.140.199,<->,8.240.247.73,2,502,0,0,2,502,0.075085000,1.0697
231.136.200.213,<->,215.158.239.76,0,0,2,809,2,809,0.074671000,0.5534
195.12.113.10,<->,136.25.188.175,0,0,2,656,2,656,0.074435000,0.4103
93.149.28.231,<->,92.27.27.177,0,0,2,1512,2,1512,0.074381000,0.1461
17.41.129.238,<->,8.53.15.98,0,0,2,707,2,707,0.074133000,0.4570
115.235.50.183,<->,92.27.219.236,0,0,2,261,2,261,0.074051000,0.1374
215.158.140.92,<->,126.219.246.186,2,2504,0,0,2,2504,0.073984000,1.6665
145.237.135.90,<->,137.21.23.222,0,0,2,1076,2,1076,0.073927000,0.9880
159.137.234.218,<->,144.83.115.203,2,389,0,0,2,389,0.073585000,0.0652
122.12.244.202,<->,92.162.253.82,0,0,2,823,2,823,0.073419000,1.4682
199.32.193.136,<->,136.25.188.241,0,0,2,656,2,656,0.073343000,0.2951
136.25.188.55,<->,29.214.64.198,2,2666,0,0,2,2666,0.073143000,1.4280
136.25.189.57,<->,96.156.169.221,2,2714,0,0,2,2714,0.073133000,1.1179
199.82.190.198,<->,136.25.188.225,0,0,2,644,2,644,0.072637000,0.7039
199.70.213.175,<->,136.25.188.225,0,0,2,188,2,188,0.072466000,0.0029
215.158.234.146,<->,133.178.227.245,0,0,2,1628,2,1628,0.072262000,0.1453
80.41.24.161,<->,14.30.152.112,2,1439,0,0,2,1439,0.071938000,0.3782
133.178.227.57,<->,113.23.14.132,2,2190,0,0,2,2190,0.071918000,1.1101
136.25.188.174,<->,27.178.41.38,2,2618,0,0,2,2618,0.071864000,0.3113
239.36.168.170,<->,80.27.153.2,0,0,2,418,2,418,0.071776000,0.1542
192.204.170.214,<->,136.25.188.162,0,0,2,2698,2,2698,0.071725000,1.6132
215.158.239.49,<->,199.50.8.237,2,1346,0,0,2,1346,0.071655000,1.8519
215.158.238.94,<->,136.139.59.87,2,2586,0,0,2,2586,0.071636000,1.7685
220.20.200.114,<->,193.86.109.21,2,134,0,0,2,134,0.071622000,0.0000
215.158.238.132,<->,76.100.108.217,2,2618,0,0,2,2618,0.071019000,1.7155
156.152.163.10,<->,8.252.222.70,0,0,2,703,2,703,0.070931000,1.1402
112.220.206.101,<->,8.252.223.115,0,0,2,2661,2,2661,0.070252000,1.7333
202.33.81.124,<->,136.25.188.240,0,0,2,188,2,188,0.070141000,0.0000
215.158.239.50,<->,207.60.212.34,2,188,0,0,2,188,0.069584000,0.0022
133.178.227.41,<->,29.211.6.95,2,2275,0,0,2,2275,0.068583000,1.1279
199.53.215.39,<->,136.25.188.236,0,0,2,1338,2,1338,0.068362000,1.0796
242.6.19.104,<->,50.224.76.235,0,0,2,1405,2,1405,0.068169000,0.2306
195.124.123.81,<->,136.25.188.45,0,0,2,953,2,953,0.067999000,0.0198
133.178.227.19,<->,93.39.51.99,2,2233,0,0,2,2233,0.067992000,1.6817
215.158.238.220,<->,106.188.251.23,2,2586,0,0,2,2586,0.067821000,1.9053
69.243.90.125,<->,8.252.221.236,0,0,2,904,2,904,0.067699000,1.0018
93.181.154.88,<->,92.27.219.143,0,0,2,100,2,100,0.067491000,0.1375
215.158.239.70,<->,42.97.54.116,2,2618,0,0,2,2618,0.067420000,0.3657
142.220.239.211,<->,136.25.188.163,0,0,2,935,2,935,0.067383000,0.0036
215.158.238.83,<->,113.23.104.220,2,2394,0,0,2,2394,0.067371000,1.2137
215.158.238.74,<->,113.23.104.220,2,2554,0,0,2,2554,0.067306000,0.5533
95.246.75.18,<->,8.252.221.205,0,0,2,908,2,908,0.067125000,1.0168
116.106.60.148,<->,8.252.222.211,0,0,2,2522,2,2522,0.067060000,1.6990
106.23.130.104,<->,8.52.243.47,0,0,2,1468,2,1468,0.066800000,0.0155
231.255.222.140,<->,220.82.8.138,0,0,2,878,2,878,0.066533000,0.0000
215.158.239.57,<->,207.213.233.200,2,188,0,0,2,188,0.066438000,0.0098
6.145.169.208,<->,0.195.210.44,0,0,2,394,2,394,0.066422000,0.4401
227.29.202.198,<->,92.27.219.36,0,0,2,657,2,657,0.066272000,0.2807
136.25.188.161,<->,131.6.152.21,2,2522,0,0,2,2522,0.065403000,1.4040
207.60.32.237,<->,136.25.188.199,0,0,2,955,2,955,0.065037000,0.4139
252.98.32.15,<->,212.249.34.44,2,233,0,0,2,233,0.064611000,0.0021
143.134.189.85,<->,136.25.188.176,0,0,2,1681,2,1681,0.064091000,0.6426
204.185.247.124,<->,136.25.188.177,0,0,2,804,2,804,0.063813000,1.6198
159.137.162.213,<->,112.24.92.10,2,676,0,0,2,676,0.063669000,0.2911
199.72.36.168,<->,136.25.188.198,0,0,2,188,2,188,0.063308000,0.0034
109.214.180.166,<->,8.52.189.207,0,0,2,457,2,457,0.063150000,0.1414
197.113.64.134,<->,136.25.188.175,0,0,2,1011,2,1011,0.063049000,0.5189
143.10.203.192,<->,136.25.188.196,0,0,2,656,2,656,0.062477000,0.2648
215.158.239.40,<->,29.211.5.208,2,1564,0,0,2,1564,0.062163000,0.4737
198.157.156.82,<->,92.27.218.252,0,0,2,780,2,780,0.060333000,1.0033
215.158.239.95,<->,194.251.120.248,2,816,0,0,2,816,0.059889000,0.0351
196.146.72.101,<->,8.181.37.222,2,1833,0,0,2,1833,0.059882000,0.0000
192.231.173.39,<->,99.74.26.190,0,0,2,634,2,634,0.059862000,0.1394
132.168.196.110,<->,54.43.249.8,2,314,0,0,2,314,0.059629000,1.6451
143.155.228.41,<->,133.178.226.28,0,0,2,2474,2,2474,0.059179000,0.4492
136.25.188.209,<->,72.23.234.28,2,279,0,0,2,279,0.058938000,0.3121
136.25.188.237,<->,131.144.113.190,2,2570,0,0,2,2570,0.058820000,0.5705
220.39.29.77,<->,99.74.87.201,0,0,2,288,2,288,0.057913000,1.9324
220.28.108.254,<->,136.25.189.7,0,0,2,2216,2,2216,0.057886000,0.1427
249.101.105.144,<->,27.11.127.87,2,777,0,0,2,777,0.057692000,0.6202
215.158.238.236,<->,148.190.126.45,2,2149,0,0,2,2149,0.057255000,1.8492
194.232.200.149,<->,136.25.188.243,0,0,2,202,2,202,0.057175000,0.0271
109.51.73.125,<->,8.182.224.87,0,0,2,2575,2,2575,0.056971000,0.1866
196.240.180.180,<->,136.25.188.252,0,0,2,941,2,941,0.056303000,0.0022
215.158.238.82,<->,131.173.115.91,2,2586,0,0,2,2586,0.056118000,1.8559
215.158.61.203,<->,8.176.8.252,0,0,2,2050,2,2050,0.055737000,0.5691
215.158.239.92,<->,195.54.177.60,2,955,0,0,2,955,0.055319000,0.5588
133.244.30.133,<->,57.211.63.49,2,374,0,0,2,374,0.054322000,0.1799
133.178.226.37,<->,8.222.7.23,2,2458,0,0,2,2458,0.054109000,0.2227
193.21.28.201,<->,92.27.219.253,0,0,2,780,2,780,0.053697000,0.8520
100.92.28.155,<->,8.250.36.239,2,711,0,0,2,711,0.053449000,0.9220
215.158.239.41,<->,29.214.205.37,2,132,0,0,2,132,0.053426000,1.2266
139.163.10.82,<->,108.134.75.27,2,284,0,0,2,284,0.053252000,0.0090
216.184.1.109,<->,136.25.188.247,0,0,2,810,2,810,0.051938000,0.0002
196.87.31.201,<->,136.25.188.52,0,0,2,774,2,774,0.051907000,0.9800
112.208.20.255,<->,99.72.86.96,0,0,2,375,2,375,0.051815000,0.2822
136.25.188.160,<->,113.23.104.247,2,2378,0,0,2,2378,0.051279000,1.4216
215.158.238.221,<->,8.222.6.193,2,2159,0,0,2,2159,0.051254000,0.5851
106.168.190.250,<->,100.92.61.156,0,0,2,798,2,798,0.051058000,0.3183
195.70.37.130,<->,136.25.188.52,0,0,2,188,2,188,0.050821000,0.0021
215.158.238.92,<->,126.219.196.185,2,2698,0,0,2,2698,0.050731000,1.8580
195.69.252.157,<->,136.25.188.236,0,0,2,1075,2,1075,0.050699000,0.0154
215.158.239.57,<->,204.3.233.160,2,188,0,0,2,188,0.050552000,0.0000
197.113.99.127,<->,136.25.188.174,0,0,2,907,2,907,0.050090000,0.4215
215.158.239.50,<->,196.93.91.240,2,961,0,0,2,961,0.050032000,0.0097
192.64.208.1,<->,100.124.212.156,2,432,0,0,2,432,0.049438000,0.3123
215.158.239.57,<->,204.1.250.252,2,928,0,0,2,928,0.049239000,0.7082
195.55.61.107,<->,136.25.188.227,0,0,2,188,2,188,0.048796000,0.0020
139.36.120.223,<->,133.178.227.244,0,0,2,1422,2,1422,0.048741000,1.2235
215.158.239.49,<->,207.228.254.5,2,1054,0,0,2,1054,0.048362000,0.0111
215.158.239.49,<->,199.20.5.74,2,202,0,0,2,202,0.048318000,0.0901
207.51.234.203,<->,0.195.210.46,0,0,2,1410,2,1410,0.048298000,0.0002
133.54.43.51,<->,93.135.97.57,2,1560,0,0,2,1560,0.048280000,1.3453
215.158.239.50,<->,199.20.29.122,2,955,0,0,2,955,0.047873000,0.3413
221.102.56.69,<->,80.42.206.154,0,0,2,588,2,588,0.047242000,0.0701
215.158.239.58,<->,199.20.29.229,2,188,0,0,2,188,0.047234000,0.0000
197.109.193.7,<->,136.25.188.173,0,0,2,867,2,867,0.047056000,0.0301
215.158.239.92,<->,199.20.31.245,2,1197,0,0,2,1197,0.047028000,0.5400
6.145.166.161,<->,0.195.210.46,0,0,2,761,2,761,0.047008000,0.4692
17.143.206.194,<->,8.220.179.115,0,0,2,464,2,464,0.046875000,0.1870
215.158.239.56,<->,207.213.193.72,2,1051,0,0,2,1051,0.046745000,0.0101
195.68.103.22,<->,136.25.188.175,0,0,2,188,2,188,0.046533000,0.0000
215.158.239.33,<->,126.219.102.199,2,1560,0,0,2,1560,0.046415000,0.5318
133.178.226.14,<->,96.155.60.234,2,350,0,0,2,350,0.046221000,0.4343
215.158.239.51,<->,199.20.30.210,2,440,0,0,2,440,0.045852000,0.1400
220.28.89.239,<->,97.126.119.92,0,0,2,457,2,457,0.045448000,1.3089
215.158.239.94,<->,142.236.221.137,2,819,0,0,2,819,0.045446000,0.0158
220.39.233.169,<->,133.178.226.37,0,0,2,2522,2,2522,0.045310000,1.4407
133.178.227.14,<->,8.222.6.200,2,2394,0,0,2,2394,0.044874000,1.3263
215.158.239.95,<->,196.107.73.46,2,774,0,0,2,774,0.044595000,0.2898
98.67.132.221,<->,53.176.41.158,2,150,0,0,2,150,0.044147000,0.1434
231.140.220.148,<->,136.25.188.174,0,0,2,1072,2,1072,0.044045000,0.0168
220.28.65.9,<->,215.158.238.125,0,0,2,1649,2,1649,0.043982000,1.6288
215.158.239.59,<->,199.20.31.218,2,188,0,0,2,188,0.043939000,0.0799
215.158.239.95,<->,196.0.240.73,2,1562,0,0,2,1562,0.043928000,0.6591
8.182.235.164,<->,6.242.52.183,2,598,0,0,2,598,0.043873000,1.4043
215.158.140.241,<->,122.159.123.91,2,2341,0,0,2,2341,0.043570000,1.2808
220.55.119.112,<->,158.92.178.127,2,1428,0,0,2,1428,0.043539000,0.7662
215.158.238.75,<->,119.196.23.9,2,2458,0,0,2,2458,0.043440000,0.7172
215.158.239.224,<->,8.191.7.160,2,1556,0,0,2,1556,0.043374000,0.9366
195.7.72.61,<->,136.25.188.45,0,0,2,945,2,945,0.043373000,0.0017
133.178.226.80,<->,38.104.11.8,2,1650,0,0,2,1650,0.043334000,1.0482
199.83.9.109,<->,136.25.188.220,0,0,2,784,2,784,0.043014000,0.1885
215.158.238.190,<->,8.240.116.213,2,2178,0,0,2,2178,0.042862000,1.1991
215.158.238.92,<->,122.158.67.229,2,2426,0,0,2,2426,0.042486000,1.5805
93.181.154.105,<->,89.183.104.145,0,0,2,104,2,104,0.042247000,0.2517
215.158.238.149,<->,69.31.238.54,2,2554,0,0,2,2554,0.042211000,0.8313
222.254.238.230,<->,210.220.219.153,0,0,2,464,2,464,0.042029000,0.4233
133.178.226.61,<->,91.57.173.52,2,2522,0,0,2,2522,0.041769000,0.2000
229.96.180.39,<->,8.181.37.222,2,1833,0,0,2,1833,0.041532000,0.2585
92.27.219.171,<->,92.16.211.154,2,458,0,0,2,458,0.041422000,0.9775
197.160.64.44,<->,8.182.227.180,0,0,2,408,2,408,0.041353000,0.1195
143.89.180.162,<->,136.25.188.238,0,0,2,202,2,202,0.041342000,0.7741
43.52.217.38,<->,8.252.221.230,0,0,2,707,2,707,0.041191000,0.6143
136.25.189.29,<->,112.220.198.100,2,2490,0,0,2,2490,0.040874000,1.1778
220.28.85.14,<->,215.158.140.233,0,0,2,1581,2,1581,0.040480000,0.2193
199.33.17.180,<->,136.25.188.252,0,0,2,188,2,188,0.040415000,0.0012
215.158.239.70,<->,199.20.29.81,2,188,0,0,2,188,0.040119000,0.0000
192.64.229.128,<->,112.237.247.242,2,104,0,0,2,104,0.039898000,1.3684
195.124.60.10,<->,136.25.188.175,0,0,2,281,2,281,0.039524000,1.1800
207.236.47.30,<->,136.25.188.226,0,0,2,912,2,912,0.039230000,0.0791
91.251.118.155,<->,8.45.175.127,2,361,0,0,2,361,0.039127000,0.0353
195.55.229.202,<->,136.25.188.177,0,0,2,188,2,188,0.038200000,0.0020
215.158.238.80,<->,122.158.51.86,2,2602,0,0,2,2602,0.038116000,1.0924
215.158.239.58,<->,204.226.17.29,2,1112,0,0,2,1112,0.038008000,0.2658
158.192.3.223,<->,133.178.226.90,0,0,2,2666,2,2666,0.037852000,1.9098
215.158.238.134,<->,120.154.221.203,2,2586,0,0,2,2586,0.037689000,0.3862
146.193.21.83,<->,8.252.221.239,0,0,2,440,2,440,0.037446000,0.0004
207.56.138.208,<->,136.25.188.199,0,0,2,952,2,952,0.037230000,1.2323
215.158.239.108,<->,133.232.6.65,2,410,0,0,2,410,0.036666000,1.8561
136.25.188.44,<->,111.151.70.36,2,2506,0,0,2,2506,0.036410000,1.2991
199.68.100.152,<->,136.25.188.174,0,0,2,188,2,188,0.036041000,0.0020
142.191.245.48,<->,136.25.188.254,0,0,2,816,2,816,0.035871000,0.1023
133.178.226.80,<->,8.252.210.162,2,2650,0,0,2,2650,0.035818000,0.8670
133.178.227.1,<->,29.211.6.203,2,2176,0,0,2,2176,0.035691000,0.9438
192.64.196.112,<->,119.152.219.102,2,2423,0,0,2,2423,0.035423000,0.4815
245.244.35.4,<->,8.182.227.180,0,0,2,425,2,425,0.034916000,0.1627
213.21.35.45,<->,8.220.201.55,0,0,2,949,2,949,0.034869000,0.3247
207.62.191.68,<->,136.25.188.46,0,0,2,1067,2,1067,0.034681000,0.0150
215.158.239.93,<->,196.91.186.38,2,1640,0,0,2,1640,0.034662000,1.5099
204.187.168.225,<->,136.25.188.46,0,0,2,1061,2,1061,0.033807000,0.0597
159.36.238.148,<->,8.52.187.70,0,0,2,2377,2,2377,0.033795000,0.7782
231.140.198.240,<->,136.25.188.252,0,0,2,680,2,680,0.033049000,0.1746
94.194.30.83,<->,8.252.221.197,0,0,2,452,2,452,0.032998000,0.4358
215.158.239.34,<->,29.211.5.196,2,268,0,0,2,268,0.032520000,0.5768
129.175.139.42,<->,8.252.222.204,0,0,2,2649,2,2649,0.031925000,1.5124
215.158.239.48,<->,196.89.62.65,2,202,0,0,2,202,0.031873000,0.1092
215.158.239.68,<->,199.20.7.66,2,380,0,0,2,380,0.031862000,1.8601
253.103.78.162,<->,215.158.238.99,0,0,2,2554,2,2554,0.031840000,0.9967
139.5.114.186,<->,136.25.189.84,0,0,2,1018,2,1018,0.031790000,1.0376
143.12.162.87,<->,136.25.188.173,0,0,2,188,2,188,0.031602000,0.0020
215.158.238.132,<->,114.25.48.40,2,2442,0,0,2,2442,0.030909000,1.1654
136.25.189.81,<->,96.156.169.203,2,138,0,0,2,138,0.030883000,0.9033
215.158.238.132,<->,38.104.11.43,2,2538,0,0,2,2538,0.030720000,1.1593
215.158.238.250,<->,8.219.186.185,2,1424,0,0,2,1424,0.030584000,0.4761
215.158.238.63,<->,56.1.238.152,2,1967,0,0,2,1967,0.030498000,0.1038
215.158.238.108,<->,0.195.237.14,2,408,0,0,2,408,0.030165000,0.2349
215.158.239.79,<->,199.20.30.163,2,503,0,0,2,503,0.029759000,0.0098
142.253.200.78,<->,136.25.188.242,0,0,2,953,2,953,0.029230000,0.0015
139.160.226.233,<->,136.25.188.220,0,0,2,2522,2,2522,0.028607000,0.4288
215.158.239.58,<->,199.20.6.162,2,1105,0,0,2,1105,0.028426000,0.9398
143.227.65.185,<->,133.178.226.18,0,0,2,2442,2,2442,0.028243000,1.3203
136.25.188.210,<->,111.151.239.73,2,2330,0,0,2,2330,0.028164000,0.1881
215.158.238.190,<->,113.23.66.244,2,2199,0,0,2,2199,0.027981000,1.2697
215.158.239.96,<->,204.227.213.195,2,1022,0,0,2,1022,0.027655000,0.0018
142.241.17.213,<->,136.25.188.239,0,0,2,188,2,188,0.027196000,0.0025
215.202.174.56,<->,215.158.239.78,0,0,2,2234,2,2234,0.027163000,1.4356
195.124.7.219,<->,136.25.188.177,0,0,2,188,2,188,0.027043000,0.0000
136.25.189.57,<->,113.92.151.23,2,2730,0,0,2,2730,0.026566000,1.0848
99.235.201.88,<->,8.52.226.131,0,0,2,435,2,435,0.026263000,0.4280
215.158.238.221,<->,106.188.228.2,2,2490,0,0,2,2490,0.026065000,1.1831
215.158.239.51,<->,142.252.139.96,2,1096,0,0,2,1096,0.025888000,0.0155
215.158.239.56,<->,204.58.43.207,2,800,0,0,2,800,0.025634000,0.1650
197.113.64.202,<->,136.25.188.242,0,0,2,188,2,188,0.025616000,0.0000
210.158.44.13,<->,127.206.193.79,2,1733,0,0,2,1733,0.025448000,0.2018
215.158.239.49,<->,195.71.123.210,2,680,0,0,2,680,0.025434000,0.9065
195.54.67.155,<->,136.25.188.254,0,0,2,891,2,891,0.025432000,0.2176
220.55.111.137,<->,129.254.96.5,2,632,0,0,2,632,0.025152000,0.0523
207.86.9.133,<->,8.252.222.29,0,0,2,455,2,455,0.024784000,0.0038
215.158.61.242,<->,8.176.8.179,0,0,2,1316,2,1316,0.024629000,1.5468
215.158.238.176,<->,149.250.115.15,2,2151,0,0,2,2151,0.024423000,0.5786
215.158.23.26,<->,192.229.40.29,2,439,0,0,2,439,0.024186000,0.0176
192.204.170.198,<->,136.25.188.197,0,0,2,2714,2,2714,0.024118000,0.8377
215.158.140.177,<->,41.157.112.188,2,494,0,0,2,494,0.023903000,0.1116
136.25.189.0,<->,57.236.82.214,2,2602,0,0,2,2602,0.023594000,1.8376
207.60.40.90,<->,136.25.188.209,0,0,2,774,2,774,0.023581000,0.5019
215.158.239.87,<->,142.255.130.247,2,1134,0,0,2,1134,0.023571000,0.4250
215.158.239.126,<->,215.158.61.183,2,1562,0,0,2,1562,0.023229000,0.3363
199.60.209.85,<->,97.198.117.219,0,0,2,692,2,692,0.023045000,0.1399
215.158.239.95,<->,29.214.73.85,2,2682,0,0,2,2682,0.023044000,1.0023
142.227.70.185,<->,136.25.188.252,0,0,2,1034,2,1034,0.023015000,0.3672
215.158.140.76,<->,126.207.73.82,2,2161,0,0,2,2161,0.022859000,0.5545
136.25.189.0,<->,96.156.169.162,2,2842,0,0,2,2842,0.022417000,1.1299
197.7.105.203,<->,8.182.136.93,0,0,2,762,2,762,0.022240000,0.0690
133.54.43.69,<->,77.24.17.181,2,622,0,0,2,622,0.021568000,0.0002
215.158.239.99,<->,204.61.81.143,2,1054,0,0,2,1054,0.021447000,0.0151
194.233.160.232,<->,136.25.188.54,0,0,2,1672,2,1672,0.020781000,0.2501
204.187.132.62,<->,136.25.188.243,0,0,2,961,2,961,0.020484000,0.0000
215.158.238.1,<->,215.158.35.210,2,1562,0,0,2,1562,0.019826000,0.2641
89.183.104.251,<->,33.57.78.97,2,100,0,0,2,100,0.019682000,0.1317
215.158.238.106,<->,119.196.23.71,2,2698,0,0,2,2698,0.019506000,1.6147
136.25.189.29,<->,6.15.207.213,2,2650,0,0,2,2650,0.019414000,1.1862
215.158.238.148,<->,131.2.115.231,2,2602,0,0,2,2602,0.018545000,1.1052
215.158.239.70,<->,199.20.31.1,2,198,0,0,2,198,0.018076000,0.0808
215.158.239.68,<->,199.20.28.15,2,188,0,0,2,188,0.018050000,0.0000
129.236.73.9,<->,33.233.141.6,0,0,2,688,2,688,0.017820000,0.0000
215.158.239.217,<->,215.158.61.183,2,1316,0,0,2,1316,0.017801000,0.1429
215.158.239.77,<->,6.15.207.199,2,2442,0,0,2,2442,0.017755000,0.4335
220.28.65.9,<->,136.25.189.26,0,0,2,410,2,410,0.017269000,0.0001
207.173.69.109,<->,136.25.188.209,0,0,2,380,2,380,0.016928000,1.1586
200.174.202.93,<->,53.161.105.187,2,964,0,0,2,964,0.016424000,1.0609
159.137.162.213,<->,105.111.73.135,2,676,0,0,2,676,0.015943000,0.2337
144.70.14.36,<->,116.100.98.32,2,742,0,0,2,742,0.015798000,1.2499
215.158.238.123,<->,48.49.55.182,2,2458,0,0,2,2458,0.015698000,1.1763
142.208.11.158,<->,136.25.188.162,0,0,2,980,2,980,0.015402000,0.0023
235.42.34.53,<->,136.25.188.237,0,0,2,2650,2,2650,0.015199000,0.1097
215.158.140.60,<->,131.1.195.58,2,2100,0,0,2,2100,0.015146000,0.8697
22.61.14.243,<->,8.220.189.63,0,0,2,740,2,740,0.014367000,0.3591
136.25.189.14,<->,126.219.194.19,2,2696,0,0,2,2696,0.014106000,1.8230
215.158.239.79,<->,199.20.28.88,2,1255,0,0,2,1255,0.014063000,0.0590
215.158.61.202,<->,8.176.8.194,0,0,2,2786,2,2786,0.013659000,1.4202
195.41.238.252,<->,136.25.188.241,0,0,2,1530,2,1530,0.013135000,0.3784
215.158.238.68,<->,97.174.232.209,2,1011,0,0,2,1011,0.012843000,1.6024
197.161.241.95,<->,136.25.188.225,0,0,2,264,2,264,0.012595000,0.7296
111.146.233.114,<->,50.145.196.221,2,250,0,0,2,250,0.012337000,0.8800
133.178.227.79,<->,8.190.217.116,2,2184,0,0,2,2184,0.012260000,0.5690
133.178.226.14,<->,96.155.60.249,2,1555,0,0,2,1555,0.012209000,0.0800
204.200.43.103,<->,136.25.188.176,0,0,2,680,2,680,0.012114000,0.0388
215.158.239.57,<->,196.95.141.97,2,989,0,0,2,989,0.011755000,0.0010
215.158.238.133,<->,112.220.206.116,2,2538,0,0,2,2538,0.010959000,1.2702
143.132.230.253,<->,136.25.188.45,0,0,2,948,2,948,0.010747000,0.0041
215.158.238.95,<->,131.1.195.234,2,2923,0,0,2,2923,0.010277000,1.5040
215.158.140.92,<->,126.219.246.166,2,2158,0,0,2,2158,0.010061000,0.5239
220.20.200.16,<->,144.83.60.136,2,2685,0,0,2,2685,0.009579000,0.0000
136.128.19.81,<->,111.146.189.12,0,0,2,1257,2,1257,0.009323000,0.7381
204.187.52.200,<->,136.25.188.225,0,0,2,957,2,957,0.009032000,0.0097
123.92.223.41,<->,50.224.89.243,0,0,2,364,2,364,0.008695000,0.0003
210.95.218.219,<->,50.224.103.30,0,0,2,315,2,315,0.008330000,0.1046
215.158.238.66,<->,91.57.173.39,2,2442,0,0,2,2442,0.007898000,1.7909
139.163.13.115,<->,100.76.46.65,2,1033,0,0,2,1033,0.007777000,0.2980
215.158.239.57,<->,159.23.130.170,2,2410,0,0,2,2410,0.007699000,0.3058
215.158.238.149,<->,142.234.196.187,2,2714,0,0,2,2714,0.007557000,1.7877
143.72.83.44,<->,136.25.188.198,0,0,2,462,2,462,0.007369000,1.1968
89.204.29.47,<->,8.182.226.78,0,0,2,1951,2,1951,0.006527000,0.2544
204.130.120.232,<->,8.252.222.61,0,0,2,1019,2,1019,0.006500000,0.0060
215.158.239.56,<->,199.106.6.24,2,1070,0,0,2,1070,0.005818000,0.1098
215.158.238.223,<->,38.104.11.117,2,2634,0,0,2,2634,0.005761000,0.5522
204.62.118.170,<->,136.25.188.162,0,0,2,364,2,364,0.005602000,0.0000
207.188.167.176,<->,136.25.188.53,0,0,2,1024,2,1024,0.005229000,1.1816
136.25.188.163,<->,38.104.11.41,2,2866,0,0,2,2866,0.005007000,1.3710
231.140.171.197,<->,215.158.239.49,0,0,2,1063,2,1063,0.004918000,0.0215
215.158.239.95,<->,194.250.222.108,2,656,0,0,2,656,0.004516000,0.1652
215.158.239.95,<->,143.89.71.213,2,440,0,0,2,440,0.004300000,0.2266
136.25.189.82,<->,116.106.46.108,2,2446,0,0,2,2446,0.004143000,0.3947
204.2.4.234,<->,136.25.188.178,0,0,2,188,2,188,0.003949000,0.0030
215.158.239.95,<->,207.57.122.110,2,866,0,0,2,866,0.003929000,0.0119
215.158.239.49,<->,196.1.246.204,2,338,0,0,2,338,0.003713000,0.0200
215.158.140.175,<->,8.222.7.168,2,1956,0,0,2,1956,0.003549000,1.9504
143.128.30.18,<->,136.25.188.163,0,0,2,656,2,656,0.003465000,0.7627
136.139.59.106,<->,136.25.188.254,0,0,2,2554,2,2554,0.003121000,1.0270
80.27.158.226,<->,72.151.67.10,2,1631,0,0,2,1631,0.003035000,0.1393
204.141.228.215,<->,8.252.222.44,0,0,2,867,2,867,0.002369000,0.0173
212.70.217.105,<->,136.25.188.47,0,0,2,2602,2,2602,0.002130000,0.8217
192.227.190.20,<->,133.178.227.2,0,0,2,2196,2,2196,0.002088000,1.0239
215.158.239.69,<->,195.49.133.217,2,1722,0,0,2,1722,0.001906000,0.3591
196.89.216.223,<->,136.25.188.209,0,0,2,598,2,598,0.001682000,0.0050
207.56.228.61,<->,136.25.188.252,0,0,2,428,2,428,0.000657000,0.0027
215.158.239.78,<->,199.20.30.216,2,956,0,0,2,956,0.000535000,0.0000
143.42.16.202,<->,136.25.188.252,0,0,2,1419,2,1419,0.000503000,1.8129
215.158.238.64,<->,136.138.112.218,2,2682,0,0,2,2682,0.000478000,1.1023
6.9.213.201,<->,0.195.210.46,0,0,2,877,2,877,0.000453000,1.0449
215.158.238.241,<->,113.23.14.212,2,2474,0,0,2,2474,0.000285000,1.3809
215.158.34.122,<->,8.252.222.181,0,0,2,706,2,706,0.000225000,0.0053
199.52.135.210,<->,136.25.188.55,0,0,2,425,2,425,0.000170000,0.0020
199.15.53.151,<->,136.25.188.225,0,0,1,87,1,87,1.999883000,0.0000
215.158.239.49,<->,207.239.77.231,1,602,0,0,1,602,1.999680000,0.0000
89.183.104.233,<->,50.145.212.192,1,113,0,0,1,113,1.999666000,0.0000
203.116.195.130,<->,136.25.188.239,0,0,1,93,1,93,1.999518000,0.0000
195.68.182.218,<->,136.25.188.55,0,0,1,602,1,602,1.999503000,0.0000
215.158.239.93,<->,195.55.56.77,1,250,0,0,1,250,1.999387000,0.0000
144.108.94.67,<->,99.162.77.146,0,0,1,81,1,81,1.999306000,0.0000
215.158.239.51,<->,194.234.174.83,1,289,0,0,1,289,1.999227000,0.0000
249.101.121.157,<->,132.18.67.31,1,746,0,0,1,746,1.999142000,0.0000
215.158.239.32,<->,96.135.154.128,1,1318,0,0,1,1318,1.999115000,0.0000
220.199.235.135,<->,136.25.188.254,0,0,1,573,1,573,1.999100000,0.0000
192.224.146.3,<->,133.178.227.135,0,0,1,169,1,169,1.998840000,0.0000
220.11.205.87,<->,215.158.140.207,0,0,1,1003,1,1003,1.998803000,0.0000
101.224.182.5,<->,92.162.253.20,0,0,1,350,1,350,1.998174000,0.0000
137.45.27.47,<->,92.162.252.30,0,0,1,370,1,370,1.998020000,0.0000
143.43.30.232,<->,136.25.188.174,0,0,1,573,1,573,1.997929000,0.0000
215.158.239.30,<->,122.159.245.155,1,1467,0,0,1,1467,1.997854000,0.0000
221.102.143.189,<->,220.83.114.215,0,0,1,75,1,75,1.997807000,0.0000
197.113.99.126,<->,136.25.188.255,0,0,1,1344,1,1344,1.997713000,0.0000
53.149.17.194,<->,48.53.234.112,0,0,1,63,1,63,1.997625000,0.0000
248.239.96.151,<->,8.52.183.207,0,0,1,1119,1,1119,1.997367000,0.0000
133.178.226.29,<->,29.213.195.54,1,986,0,0,1,986,1.997237000,0.0000
207.61.33.70,<->,136.25.188.255,0,0,1,506,1,506,1.996870000,0.0000
204.200.32.9,<->,136.25.188.52,0,0,1,93,1,93,1.996568000,0.0000
215.158.140.185,<->,8.222.7.187,1,976,0,0,1,976,1.996185000,0.0000
203.116.21.200,<->,136.25.188.239,0,0,1,144,1,144,1.995973000,0.0000
215.158.239.93,<->,29.212.199.58,1,1421,0,0,1,1421,1.995878000,0.0000
215.158.239.78,<->,199.20.28.44,1,602,0,0,1,602,1.995806000,0.0000
202.178.8.69,<->,98.190.109.178,0,0,1,170,1,170,1.995655000,0.0000
8.45.168.98,<->,6.72.10.208,0,0,1,75,1,75,1.995454000,0.0000
199.73.188.22,<->,136.25.188.255,0,0,1,602,1,602,1.995301000,0.0000
76.101.120.51,<->,8.252.222.236,0,0,1,1453,1,1453,1.995142000,0.0000
195.43.195.19,<->,136.25.188.209,0,0,1,573,1,573,1.994530000,0.0000
136.25.188.220,<->,30.73.138.137,1,93,0,0,1,93,1.994471000,0.0000
203.212.90.184,<->,50.223.3.228,0,0,1,319,1,319,1.994287000,0.0000
129.225.135.32,<->,129.225.132.90,0,0,1,1504,1,1504,1.994279000,0.0000
199.81.208.250,<->,136.25.188.239,0,0,1,573,1,573,1.993902000,0.0000
133.178.227.43,<->,131.173.115.67,1,1360,0,0,1,1360,1.993319000,0.0000
136.25.189.16,<->,61.34.126.165,1,1373,0,0,1,1373,1.993142000,0.0000
215.158.239.57,<->,142.247.235.45,1,602,0,0,1,602,1.993131000,0.0000
207.88.93.20,<->,133.178.226.80,0,0,1,1213,1,1213,1.993016000,0.0000
129.95.133.231,<->,8.201.224.59,0,0,1,141,1,141,1.993000000,0.0000
195.42.82.107,<->,8.52.244.92,0,0,1,518,1,518,1.992981000,0.0000
215.158.239.34,<->,139.161.104.165,1,1223,0,0,1,1223,1.992856000,0.0000
252.98.149.255,<->,137.39.55.211,1,305,0,0,1,305,1.992629000,0.0000
221.102.56.69,<->,109.2.27.172,0,0,1,294,1,294,1.992599000,0.0000
240.173.231.52,<->,8.220.200.160,0,0,1,431,1,431,1.992496000,0.0000
116.238.52.134,<->,89.183.104.227,0,0,1,1396,1,1396,1.992285000,0.0000
133.32.39.45,<->,99.72.41.34,1,60,0,0,1,60,1.992188000,0.0000
221.196.122.79,<->,138.98.250.43,0,0,1,229,1,229,1.992104000,0.0000
215.158.238.221,<->,18.202.90.165,1,1232,0,0,1,1232,1.991939000,0.0000
231.142.204.217,<->,136.25.188.163,0,0,1,797,1,797,1.991771000,0.0000
92.27.27.169,<->,48.109.246.250,1,61,0,0,1,61,1.991341000,0.0000
139.106.73.221,<->,8.252.222.220,0,0,1,1245,1,1245,1.990949000,0.0000
89.183.104.184,<->,14.27.104.54,1,1396,0,0,1,1396,1.990823000,0.0000
215.158.239.84,<->,143.88.129.170,1,89,0,0,1,89,1.990521000,0.0000
215.158.239.86,<->,207.57.219.52,1,781,0,0,1,781,1.990494000,0.0000
220.20.200.53,<->,144.83.60.153,1,693,0,0,1,693,1.990315000,0.0000
54.58.25.251,<->,48.53.192.41,0,0,1,400,1,400,1.990017000,0.0000
215.158.239.77,<->,199.20.7.209,1,87,0,0,1,87,1.989809000,0.0000
204.141.86.218,<->,144.86.149.199,0,0,1,127,1,127,1.989765000,0.0000
199.121.174.137,<->,136.25.188.241,0,0,1,602,1,602,1.989669000,0.0000
215.158.239.121,<->,215.158.61.195,1,381,0,0,1,381,1.989209000,0.0000
142.241.218.213,<->,136.25.188.225,0,0,1,632,1,632,1.989126000,0.0000
48.132.118.109,<->,8.252.222.179,0,0,1,229,1,229,1.989104000,0.0000
92.27.128.253,<->,8.252.221.249,0,0,1,926,1,926,1.988865000,0.0000
92.27.218.64,<->,89.153.97.181,1,75,0,0,1,75,1.988748000,0.0000
212.70.217.68,<->,136.25.189.17,0,0,1,1357,1,1357,1.988739000,0.0000
215.158.238.32,<->,142.205.126.4,1,1117,0,0,1,1117,1.988644000,0.0000
215.158.239.50,<->,194.251.95.32,1,93,0,0,1,93,1.988081000,0.0000
215.158.238.140,<->,29.212.195.20,1,1133,0,0,1,1133,1.987636000,0.0000
101.87.173.115,<->,100.228.42.117,0,0,1,625,1,625,1.987319000,0.0000
215.158.239.85,<->,207.236.255.28,1,240,0,0,1,240,1.987288000,0.0000
48.17.42.158,<->,8.252.221.205,0,0,1,437,1,437,1.986988000,0.0000
132.118.97.71,<->,109.1.49.70,0,0,1,75,1,75,1.986961000,0.0000
159.112.9.198,<->,6.122.206.12,0,0,1,81,1,81,1.986905000,0.0000
136.25.188.227,<->,30.73.101.56,1,867,0,0,1,867,1.986886000,0.0000
215.158.239.121,<->,215.158.61.193,1,429,0,0,1,429,1.986669000,0.0000
215.158.239.94,<->,196.107.168.17,1,602,0,0,1,602,1.986596000,0.0000
199.69.238.49,<->,136.25.188.54,0,0,1,85,1,85,1.986533000,0.0000
48.19.62.158,<->,8.252.222.49,0,0,1,240,1,240,1.986383000,0.0000
215.158.238.80,<->,29.211.186.201,1,1229,0,0,1,1229,1.986282000,0.0000
192.229.210.156,<->,133.172.83.44,1,561,0,0,1,561,1.986156000,0.0000
215.158.238.133,<->,123.166.46.234,1,957,0,0,1,957,1.985383000,0.0000
200.174.191.226,<->,53.69.66.48,1,282,0,0,1,282,1.985339000,0.0000
215.158.238.141,<->,8.223.224.53,1,1101,0,0,1,1101,1.985055000,0.0000
111.147.139.145,<->,53.161.72.23,1,59,0,0,1,59,1.984998000,0.0000
80.40.57.225,<->,8.45.162.111,1,671,0,0,1,671,1.984927000,0.0000
107.70.254.54,<->,8.183.25.25,0,0,1,282,1,282,1.984896000,0.0000
215.158.239.99,<->,199.20.5.49,1,117,0,0,1,117,1.984887000,0.0000
17.41.75.11,<->,8.220.191.154,0,0,1,1301,1,1301,1.984784000,0.0000
204.186.64.221,<->,136.25.188.174,0,0,1,602,1,602,1.984641000,0.0000
158.199.107.170,<->,50.224.76.234,0,0,1,915,1,915,1.984542000,0.0000
48.131.158.200,<->,8.252.222.205,0,0,1,1341,1,1341,1.984358000,0.0000
215.158.239.48,<->,199.15.223.216,1,602,0,0,1,602,1.983765000,0.0000
220.28.108.254,<->,215.158.238.232,0,0,1,825,1,825,1.983444000,0.0000
89.164.47.38,<->,8.52.187.74,0,0,1,297,1,297,1.983175000,0.0000
148.23.229.32,<->,133.178.226.77,0,0,1,1325,1,1325,1.983036000,0.0000
215.158.238.105,<->,8.240.123.52,1,1213,0,0,1,1213,1.982941000,0.0000
215.158.238.95,<->,88.3.1.165,1,1229,0,0,1,1229,1.982905000,0.0000
215.158.140.201,<->,100.224.132.170,1,95,0,0,1,95,1.982780000,0.0000
136.181.53.208,<->,0.195.216.193,1,262,0,0,1,262,1.982702000,0.0000
246.253.146.35,<->,204.41.40.158,1,153,0,0,1,153,1.982619000,0.0000
246.253.253.106,<->,210.209.251.214,1,481,0,0,1,481,1.982407000,0.0000
146.223.137.30,<->,8.252.222.50,0,0,1,277,1,277,1.982181000,0.0000
218.38.100.178,<->,8.182.228.20,0,0,1,619,1,619,1.981881000,0.0000
204.184.80.39,<->,136.25.188.196,0,0,1,602,1,602,1.981787000,0.0000
215.158.239.50,<->,196.91.19.171,1,602,0,0,1,602,1.981438000,0.0000
89.204.73.239,<->,8.182.226.78,0,0,1,267,1,267,1.981342000,0.0000
136.25.188.44,<->,91.57.162.200,1,1325,0,0,1,1325,1.981302000,0.0000
215.158.239.33,<->,120.155.14.74,1,117,0,0,1,117,1.981274000,0.0000
194.232.105.125,<->,136.25.188.243,0,0,1,240,1,240,1.981085000,0.0000
101.70.127.164,<->,53.209.35.194,1,768,0,0,1,768,1.981054000,0.0000
215.158.238.83,<->,97.243.113.38,1,1101,0,0,1,1101,1.980888000,0.0000
136.25.188.175,<->,76.138.212.213,1,602,0,0,1,602,1.980549000,0.0000
58.202.35.36,<->,8.252.222.49,0,0,1,264,1,264,1.980372000,0.0000
215.158.238.190,<->,122.216.233.213,1,1032,0,0,1,1032,1.980367000,0.0000
199.15.37.255,<->,136.25.188.238,0,0,1,561,1,561,1.980233000,0.0000
199.80.187.109,<->,136.25.188.173,0,0,1,602,1,602,1.980198000,0.0000
142.167.37.185,<->,136.25.188.175,0,0,1,602,1,602,1.979990000,0.0000
195.14.37.76,<->,136.25.188.238,0,0,1,89,1,89,1.979868000,0.0000
215.158.238.73,<->,113.23.117.105,1,1085,0,0,1,1085,1.979610000,0.0000
136.25.189.46,<->,6.29.108.20,1,1309,0,0,1,1309,1.979403000,0.0000
215.158.238.251,<->,8.190.217.24,1,1052,0,0,1,1052,1.978821000,0.0000
210.221.107.50,<->,111.151.237.50,1,804,0,0,1,804,1.978499000,0.0000
195.6.242.36,<->,136.25.188.175,0,0,1,561,1,561,1.978345000,0.0000
215.158.239.48,<->,195.49.132.160,1,602,0,0,1,602,1.977940000,0.0000
216.184.1.82,<->,136.25.188.170,0,0,1,204,1,204,1.977479000,0.0000
197.161.241.25,<->,136.25.188.225,0,0,1,270,1,270,1.977351000,0.0000
215.158.239.79,<->,207.236.255.28,1,240,0,0,1,240,1.977161000,0.0000
129.225.132.224,<->,129.225.131.136,1,712,0,0,1,712,1.976740000,0.0000
199.20.6.240,<->,0.195.210.42,0,0,1,685,1,685,1.976691000,0.0000
144.83.60.153,<->,92.162.253.84,0,0,1,50,1,50,1.976657000,0.0000
246.253.235.153,<->,33.209.218.85,1,274,0,0,1,274,1.976595000,0.0000
215.158.61.203,<->,8.176.8.94,0,0,1,301,1,301,1.976140000,0.0000
215.158.239.49,<->,199.20.5.161,1,172,0,0,1,172,1.975922000,0.0000
215.158.239.87,<->,199.20.28.138,1,234,0,0,1,234,1.975753000,0.0000
159.137.162.213,<->,122.219.189.1,1,332,0,0,1,332,1.975743000,0.0000
133.178.226.28,<->,113.23.117.52,1,1165,0,0,1,1165,1.975726000,0.0000
215.158.239.77,<->,128.194.246.149,1,1309,0,0,1,1309,1.975424000,0.0000
139.163.26.146,<->,122.223.107.33,1,99,0,0,1,99,1.975126000,0.0000
199.15.53.151,<->,136.25.188.255,0,0,1,87,1,87,1.975071000,0.0000
136.25.189.18,<->,125.84.55.43,1,1213,0,0,1,1213,1.974724000,0.0000
159.112.9.198,<->,144.87.235.222,0,0,1,81,1,81,1.974554000,0.0000
231.140.229.79,<->,215.158.239.49,0,0,1,240,1,240,1.974465000,0.0000
215.158.239.79,<->,29.211.93.15,1,1373,0,0,1,1373,1.974437000,0.0000
133.178.227.19,<->,106.188.245.7,1,1229,0,0,1,1229,1.974364000,0.0000
89.216.124.92,<->,8.235.216.152,1,397,0,0,1,397,1.974155000,0.0000
90.240.120.21,<->,53.203.133.145,1,484,0,0,1,484,1.973657000,0.0000
215.158.239.43,<->,112.220.206.17,1,152,0,0,1,152,1.973549000,0.0000
53.91.151.204,<->,8.252.221.223,0,0,1,430,1,430,1.972667000,0.0000
133.178.226.19,<->,29.212.195.22,1,1277,0,0,1,1277,1.972462000,0.0000
205.127.108.113,<->,33.233.141.65,0,0,1,551,1,551,1.972373000,0.0000
127.168.165.134,<->,8.176.8.193,0,0,1,189,1,189,1.972295000,0.0000
215.158.239.57,<->,123.166.46.199,1,1069,0,0,1,1069,1.972267000,0.0000
221.102.143.189,<->,192.65.2.60,0,0,1,1469,1,1469,1.971990000,0.0000
215.158.238.107,<->,137.199.206.19,1,1325,0,0,1,1325,1.971964000,0.0000
239.227.117.98,<->,112.208.20.225,1,50,0,0,1,50,1.971759000,0.0000
111.20.172.119,<->,111.20.168.12,0,0,1,498,1,498,1.971660000,0.0000
109.222.252.103,<->,109.57.161.32,1,920,0,0,1,920,1.971302000,0.0000
159.23.226.109,<->,74.17.139.222,1,76,0,0,1,76,1.971200000,0.0000
215.158.238.120,<->,57.210.107.19,1,1197,0,0,1,1197,1.971192000,0.0000
220.55.91.54,<->,92.162.221.229,1,656,0,0,1,656,1.971186000,0.0000
215.158.140.147,<->,8.222.7.160,1,972,0,0,1,972,1.971053000,0.0000
133.178.226.224,<->,106.155.165.107,1,216,0,0,1,216,1.970848000,0.0000
207.172.112.26,<->,136.25.188.252,0,0,1,602,1,602,1.970832000,0.0000
136.129.94.157,<->,6.145.167.112,1,421,0,0,1,421,1.970589000,0.0000
215.158.238.104,<->,61.72.108.212,1,1309,0,0,1,1309,1.970538000,0.0000
195.42.1.166,<->,136.25.188.225,0,0,1,765,1,765,1.970480000,0.0000
200.174.214.170,<->,53.200.90.174,1,261,0,0,1,261,1.970241000,0.0000
136.25.188.177,<->,8.42.43.25,1,1292,0,0,1,1292,1.970067000,0.0000
196.206.172.111,<->,136.25.188.225,0,0,1,240,1,240,1.969829000,0.0000
215.158.239.48,<->,195.126.45.4,1,602,0,0,1,602,1.969776000,0.0000
215.158.239.77,<->,118.9.217.201,1,1373,0,0,1,1373,1.969710000,0.0000
207.56.107.29,<->,136.25.188.178,0,0,1,240,1,240,1.969500000,0.0000
6.145.165.30,<->,0.195.210.44,0,0,1,116,1,116,1.969420000,0.0000
220.20.200.136,<->,144.83.60.153,1,626,0,0,1,626,1.969396000,0.0000
215.158.238.134,<->,113.23.21.196,1,1213,0,0,1,1213,1.969290000,0.0000
159.178.76.115,<->,8.220.190.86,0,0,1,465,1,465,1.969236000,0.0000
195.15.241.133,<->,136.25.188.253,0,0,1,602,1,602,1.969235000,0.0000
215.158.239.57,<->,196.108.90.172,1,602,0,0,1,602,1.969024000,0.0000
136.25.189.196,<->,129.222.36.38,1,982,0,0,1,982,1.968944000,0.0000
86.135.191.79,<->,8.252.222.140,0,0,1,264,1,264,1.968804000,0.0000
215.158.239.84,<->,195.81.26.243,1,190,0,0,1,190,1.968324000,0.0000
142.248.24.177,<->,136.25.188.46,0,0,1,561,1,561,1.968314000,0.0000
195.71.147.207,<->,136.25.188.236,0,0,1,87,1,87,1.968183000,0.0000
215.158.239.69,<->,199.20.31.190,1,141,0,0,1,141,1.968161000,0.0000
137.21.23.50,<->,111.150.207.99,1,100,0,0,1,100,1.968110000,0.0000
29.214.109.137,<->,8.252.223.175,0,0,1,1357,1,1357,1.968050000,0.0000
215.158.2.9,<->,133.178.226.247,0,0,1,845,1,845,1.968048000,0.0000
143.155.227.43,<->,136.25.188.239,0,0,1,1117,1,1117,1.967980000,0.0000
195.14.129.170,<->,136.25.188.55,0,0,1,561,1,561,1.967941000,0.0000
136.25.188.237,<->,122.158.49.139,1,1277,0,0,1,1277,1.967894000,0.0000
215.158.238.9,<->,140.139.141.135,1,1453,0,0,1,1453,1.967585000,0.0000
199.68.95.113,<->,8.52.128.66,0,0,1,277,1,277,1.967353000,0.0000
207.60.85.200,<->,136.25.188.209,0,0,1,141,1,141,1.967243000,0.0000
139.163.26.146,<->,105.116.179.226,1,99,0,0,1,99,1.967008000,0.0000
215.158.238.123,<->,29.211.186.57,1,1165,0,0,1,1165,1.966804000,0.0000
215.158.238.92,<->,154.183.124.180,1,1229,0,0,1,1229,1.966641000,0.0000
215.158.238.188,<->,122.159.123.90,1,1229,0,0,1,1229,1.966331000,0.0000
207.61.156.170,<->,136.25.188.220,0,0,1,561,1,561,1.966053000,0.0000
139.163.96.101,<->,131.94.166.50,1,267,0,0,1,267,1.965814000,0.0000
204.186.83.224,<->,136.25.188.55,0,0,1,1095,1,1095,1.965810000,0.0000
215.158.239.50,<->,143.94.164.5,1,602,0,0,1,602,1.965732000,0.0000
232.31.71.89,<->,144.71.44.216,0,0,1,84,1,84,1.965264000,0.0000
199.122.48.74,<->,136.25.188.253,0,0,1,573,1,573,1.965053000,0.0000
121.209.172.180,<->,50.224.76.234,0,0,1,518,1,518,1.965052000,0.0000
136.25.188.255,<->,92.48.92.132,1,272,0,0,1,272,1.964889000,0.0000
109.222.250.46,<->,88.4.80.196,1,410,0,0,1,410,1.964814000,0.0000
155.197.244.164,<->,139.163.26.146,0,0,1,99,1,99,1.964495000,0.0000
215.158.238.95,<->,140.53.100.22,1,1229,0,0,1,1229,1.964167000,0.0000
65.26.112.170,<->,8.252.221.230,0,0,1,426,1,426,1.964027000,0.0000
142.221.186.126,<->,136.25.188.253,0,0,1,270,1,270,1.963824000,0.0000
215.158.238.241,<->,131.219.230.235,1,1229,0,0,1,1229,1.963497000,0.0000
215.158.239.95,<->,192.171.32.182,1,373,0,0,1,373,1.963482000,0.0000
195.54.158.83,<->,136.25.188.176,0,0,1,632,1,632,1.963437000,0.0000
215.158.61.223,<->,136.25.188.194,0,0,1,1439,1,1439,1.963309000,0.0000
215.158.238.123,<->,148.72.94.167,1,276,0,0,1,276,1.962875000,0.0000
95.246.204.167,<->,8.252.221.236,0,0,1,454,1,454,1.962712000,0.0000
50.176.169.181,<->,8.52.182.119,0,0,1,435,1,435,1.962637000,0.0000
140.190.33.153,<->,133.178.227.40,0,0,1,1140,1,1140,1.962423000,0.0000
247.118.183.57,<->,8.183.25.25,0,0,1,318,1,318,1.962420000,0.0000
57.220.150.11,<->,8.53.4.76,0,0,1,573,1,573,1.961990000,0.0000
140.71.205.43,<->,8.252.221.206,0,0,1,305,1,305,1.961955000,0.0000
220.39.21.53,<->,99.74.26.158,0,0,1,1157,1,1157,1.961843000,0.0000
100.206.91.174,<->,33.233.141.52,0,0,1,209,1,209,1.961648000,0.0000
215.158.140.193,<->,8.222.7.184,1,972,0,0,1,972,1.961482000,0.0000
215.158.238.250,<->,38.104.11.117,1,1052,0,0,1,1052,1.961427000,0.0000
136.25.189.80,<->,113.26.84.231,1,1437,0,0,1,1437,1.961118000,0.0000
207.1.41.245,<->,50.224.76.235,0,0,1,577,1,577,1.961118000,0.0000
215.158.238.135,<->,148.255.136.200,1,1341,0,0,1,1341,1.960862000,0.0000
112.157.94.18,<->,22.59.22.229,0,0,1,50,1,50,1.960653000,0.0000
215.158.239.75,<->,98.219.126.175,1,217,0,0,1,217,1.960378000,0.0000
215.158.239.17,<->,212.70.75.59,1,1174,0,0,1,1174,1.960352000,0.0000
204.186.57.169,<->,136.25.188.238,0,0,1,240,1,240,1.959670000,0.0000
215.158.61.195,<->,8.176.8.208,0,0,1,1405,1,1405,1.959563000,0.0000
195.41.196.215,<->,136.25.188.255,0,0,1,265,1,265,1.959256000,0.0000
136.25.189.33,<->,72.23.6.46,1,1357,0,0,1,1357,1.959043000,0.0000
221.196.90.92,<->,8.53.3.201,0,0,1,381,1,381,1.959035000,0.0000
143.251.236.204,<->,0.195.210.46,0,0,1,1414,1,1414,1.959019000,0.0000
215.158.238.104,<->,145.14.166.92,1,93,0,0,1,93,1.959001000,0.0000
145.208.183.77,<->,136.25.188.52,0,0,1,247,1,247,1.958962000,0.0000
215.158.239.79,<->,195.70.5.197,1,602,0,0,1,602,1.958918000,0.0000
215.158.239.95,<->,194.237.63.180,1,561,0,0,1,561,1.958691000,0.0000
136.25.188.174,<->,8.255.92.246,1,93,0,0,1,93,1.958020000,0.0000
195.43.106.95,<->,136.25.188.255,0,0,1,765,1,765,1.957961000,0.0000
215.158.140.178,<->,8.222.7.170,1,962,0,0,1,962,1.957727000,0.0000
201.211.113.187,<->,136.25.189.83,0,0,1,244,1,244,1.957629000,0.0000
247.136.237.127,<->,227.29.2.32,1,461,0,0,1,461,1.957334000,0.0000
136.25.188.230,<->,80.57.141.216,1,204,0,0,1,204,1.957276000,0.0000
8.52.248.211,<->,6.111.222.227,1,251,0,0,1,251,1.956623000,0.0000
204.21.74.184,<->,136.25.188.55,0,0,1,260,1,260,1.956466000,0.0000
136.25.188.209,<->,17.140.118.35,1,141,0,0,1,141,1.956378000,0.0000
133.178.226.61,<->,33.221.186.184,1,1277,0,0,1,1277,1.955680000,0.0000
129.31.169.157,<->,8.182.226.78,0,0,1,504,1,504,1.955475000,0.0000
207.162.161.250,<->,8.182.227.180,0,0,1,250,1,250,1.955470000,0.0000
199.14.5.85,<->,136.25.188.178,0,0,1,93,1,93,1.955427000,0.0000
112.220.206.7,<->,8.252.223.153,0,0,1,156,1,156,1.955238000,0.0000
137.23.166.40,<->,101.70.127.108,0,0,1,131,1,131,1.955017000,0.0000
136.25.189.52,<->,96.156.169.224,1,596,0,0,1,596,1.954762000,0.0000
92.27.219.215,<->,54.93.165.122,1,510,0,0,1,510,1.954739000,0.0000
210.236.218.58,<->,50.224.108.146,0,0,1,333,1,333,1.954471000,0.0000
215.158.238.241,<->,197.133.131.184,1,1194,0,0,1,1194,1.954368000,0.0000
215.158.61.193,<->,8.176.8.251,0,0,1,173,1,173,1.954366000,0.0000
204.200.60.174,<->,136.25.188.253,0,0,1,573,1,573,1.954307000,0.0000
136.25.189.45,<->,32.183.36.100,1,1373,0,0,1,1373,1.954193000,0.0000
136.25.189.33,<->,29.211.228.250,1,483,0,0,1,483,1.954176000,0.0000
144.70.14.36,<->,82.239.221.53,1,574,0,0,1,574,1.954099000,0.0000
247.136.131.55,<->,132.18.67.28,1,338,0,0,1,338,1.953801000,0.0000
133.178.226.61,<->,69.132.46.246,1,1357,0,0,1,1357,1.953742000,0.0000
215.158.239.86,<->,57.226.224.10,1,1453,0,0,1,1453,1.953582000,0.0000
215.158.238.96,<->,126.219.196.169,1,1181,0,0,1,1181,1.953535000,0.0000
215.158.239.59,<->,201.211.113.185,1,1357,0,0,1,1357,1.953369000,0.0000
207.191.140.59,<->,136.25.188.255,0,0,1,85,1,85,1.953239000,0.0000
221.196.91.180,<->,144.85.170.244,0,0,1,702,1,702,1.953138000,0.0000
101.70.115.201,<->,89.204.234.102,1,353,0,0,1,353,1.953096000,0.0000
144.85.170.248,<->,91.69.185.190,1,918,0,0,1,918,1.953074000,0.0000
136.25.188.220,<->,131.144.116.202,1,1245,0,0,1,1245,1.952891000,0.0000
159.112.9.198,<->,100.95.43.195,0,0,1,81,1,81,1.952878000,0.0000
136.25.188.45,<->,122.159.245.157,1,1357,0,0,1,1357,1.952861000,0.0000
195.4.113.29,<->,136.25.188.236,0,0,1,669,1,669,1.952571000,0.0000
215.158.238.96,<->,192.224.20.32,1,1341,0,0,1,1341,1.952342000,0.0000
207.44.226.99,<->,80.40.34.3,0,0,1,59,1,59,1.952207000,0.0000
196.112.237.105,<->,50.224.76.230,0,0,1,1045,1,1045,1.951722000,0.0000
215.158.238.133,<->,112.220.206.24,1,93,0,0,1,93,1.951592000,0.0000
43.52.138.163,<->,8.252.222.36,0,0,1,614,1,614,1.951493000,0.0000
215.158.238.123,<->,27.22.184.67,1,1213,0,0,1,1213,1.951016000,0.0000
53.201.106.213,<->,48.53.101.92,0,0,1,125,1,125,1.950885000,0.0000
215.158.239.5,<->,80.57.141.213,1,1029,0,0,1,1029,1.950822000,0.0000
149.117.120.82,<->,139.193.141.139,0,0,1,230,1,230,1.950805000,0.0000
159.65.139.148,<->,136.25.188.224,0,0,1,602,1,602,1.950799000,0.0000
215.158.239.56,<->,195.127.172.174,1,602,0,0,1,602,1.950432000,0.0000
140.174.80.101,<->,136.25.188.161,0,0,1,1373,1,1373,1.949880000,0.0000
159.112.9.198,<->,100.95.33.52,0,0,1,81,1,81,1.949553000,0.0000
251.98.38.228,<->,50.224.76.234,0,0,1,749,1,749,1.949534000,0.0000
58.169.46.42,<->,0.195.210.42,0,0,1,264,1,264,1.949479000,0.0000
207.61.69.66,<->,136.25.188.255,0,0,1,561,1,561,1.949373000,0.0000
115.121.142.77,<->,80.41.29.36,0,0,1,50,1,50,1.948565000,0.0000
215.158.239.92,<->,199.20.5.64,1,602,0,0,1,602,1.948519000,0.0000
197.104.60.82,<->,129.26.244.195,0,0,1,150,1,150,1.948313000,0.0000
136.25.189.12,<->,120.155.8.75,1,1229,0,0,1,1229,1.948177000,0.0000
215.158.238.133,<->,128.123.91.104,1,1341,0,0,1,1341,1.948088000,0.0000
215.158.239.85,<->,196.108.54.10,1,272,0,0,1,272,1.947866000,0.0000
199.50.72.71,<->,136.25.188.196,0,0,1,240,1,240,1.947854000,0.0000
215.158.239.59,<->,120.154.225.253,1,357,0,0,1,357,1.947787000,0.0000
133.178.226.29,<->,104.154.137.3,1,1037,0,0,1,1037,1.947578000,0.0000
247.152.218.158,<->,50.224.76.234,0,0,1,257,1,257,1.947520000,0.0000
101.71.1.223,<->,50.224.76.234,0,0,1,413,1,413,1.947340000,0.0000
215.158.238.67,<->,80.47.111.107,1,1229,0,0,1,1229,1.947328000,0.0000
134.171.98.246,<->,133.178.226.30,0,0,1,1181,1,1181,1.947254000,0.0000
192.67.186.145,<->,139.19.249.130,1,200,0,0,1,200,1.946728000,0.0000
138.37.95.126,<->,92.162.253.61,0,0,1,75,1,75,1.946599000,0.0000
199.69.119.10,<->,136.25.188.255,0,0,1,561,1,561,1.946530000,0.0000
136.25.189.32,<->,65.27.220.200,1,1213,0,0,1,1213,1.946431000,0.0000
215.158.238.198,<->,197.133.247.170,1,1057,0,0,1,1057,1.946221000,0.0000
138.37.95.126,<->,92.162.253.51,0,0,1,75,1,75,1.945732000,0.0000
235.247.110.194,<->,92.27.194.147,0,0,1,219,1,219,1.945704000,0.0000
200.174.161.100,<->,54.58.233.225,1,209,0,0,1,209,1.945393000,0.0000
111.151.230.73,<->,8.252.222.219,0,0,1,284,1,284,1.945293000,0.0000
215.158.239.47,<->,100.216.78.145,1,217,0,0,1,217,1.944939000,0.0000
136.25.188.234,<->,56.51.205.162,1,749,0,0,1,749,1.944917000,0.0000
215.158.239.68,<->,143.89.180.228,1,602,0,0,1,602,1.944789000,0.0000
215.158.238.209,<->,195.65.1.160,1,1224,0,0,1,1224,1.944581000,0.0000
233.85.145.23,<->,8.183.25.25,0,0,1,282,1,282,1.944498000,0.0000
197.113.99.56,<->,136.25.188.175,0,0,1,404,1,404,1.944275000,0.0000
143.44.245.255,<->,136.25.188.224,0,0,1,272,1,272,1.944255000,0.0000
207.61.69.66,<->,136.25.188.175,0,0,1,561,1,561,1.944110000,0.0000
133.178.227.242,<->,106.188.251.138,1,153,0,0,1,153,1.943918000,0.0000
215.158.239.95,<->,199.73.40.248,1,269,0,0,1,269,1.943612000,0.0000
138.37.95.126,<->,92.162.253.59,0,0,1,75,1,75,1.943081000,0.0000
221.102.113.114,<->,207.92.143.171,1,175,0,0,1,175,1.942912000,0.0000
111.199.236.133,<->,0.195.210.44,0,0,1,87,1,87,1.942889000,0.0000
102.232.97.3,<->,8.220.202.79,0,0,1,1173,1,1173,1.942752000,0.0000
159.23.227.171,<->,113.16.249.135,1,296,0,0,1,296,1.942562000,0.0000
215.158.238.250,<->,8.240.116.197,1,1261,0,0,1,1261,1.942102000,0.0000
53.203.246.22,<->,48.54.4.151,0,0,1,517,1,517,1.941916000,0.0000
136.25.188.220,<->,111.30.166.181,1,456,0,0,1,456,1.941915000,0.0000
215.158.238.33,<->,131.215.37.23,1,1277,0,0,1,1277,1.941612000,0.0000
142.255.150.216,<->,136.25.188.225,0,0,1,602,1,602,1.941568000,0.0000
215.158.239.69,<->,195.83.140.200,1,573,0,0,1,573,1.941353000,0.0000
204.63.45.166,<->,136.25.188.237,0,0,1,93,1,93,1.941169000,0.0000
231.141.45.107,<->,215.158.239.76,0,0,1,653,1,653,1.940969000,0.0000
93.147.56.233,<->,50.224.76.235,0,0,1,354,1,354,1.940768000,0.0000
133.178.227.24,<->,131.219.230.217,1,1183,0,0,1,1183,1.940547000,0.0000
6.145.148.2,<->,0.195.210.44,0,0,1,170,1,170,1.940487000,0.0000
207.51.228.37,<->,136.25.188.53,0,0,1,272,1,272,1.940090000,0.0000
215.158.239.95,<->,196.108.116.224,1,240,0,0,1,240,1.939895000,0.0000
215.158.239.91,<->,98.219.126.175,1,278,0,0,1,278,1.939664000,0.0000
159.137.162.213,<->,93.210.14.5,1,332,0,0,1,332,1.939227000,0.0000
215.158.239.76,<->,199.20.29.148,1,220,0,0,1,220,1.939188000,0.0000
131.82.78.204,<->,50.224.76.230,0,0,1,1106,1,1106,1.939090000,0.0000
133.178.227.40,<->,8.192.205.87,1,1045,0,0,1,1045,1.939068000,0.0000
144.85.170.254,<->,98.87.145.175,1,668,0,0,1,668,1.939065000,0.0000
215.158.238.92,<->,89.84.142.39,1,1101,0,0,1,1101,1.938875000,0.0000
142.182.67.40,<->,136.25.188.176,0,0,1,240,1,240,1.938659000,0.0000
215.158.140.112,<->,111.151.142.130,1,100,0,0,1,100,1.938437000,0.0000
200.174.180.133,<->,53.245.89.21,1,1169,0,0,1,1169,1.937955000,0.0000
129.236.115.174,<->,111.20.168.123,0,0,1,1220,1,1220,1.937865000,0.0000
215.158.239.57,<->,196.88.134.223,1,960,0,0,1,960,1.937810000,0.0000
136.25.188.163,<->,84.209.174.83,1,573,0,0,1,573,1.937705000,0.0000
136.25.189.43,<->,96.156.169.176,1,632,0,0,1,632,1.937607000,0.0000
215.158.238.45,<->,192.205.37.205,1,1152,0,0,1,1152,1.936956000,0.0000
96.232.239.2,<->,92.27.219.36,0,0,1,50,1,50,1.936847000,0.0000
215.158.3.29,<->,8.252.222.251,0,0,1,1421,1,1421,1.936754000,0.0000
204.1.132.51,<->,136.25.188.255,0,0,1,602,1,602,1.936620000,0.0000
75.214.144.153,<->,8.252.222.23,0,0,1,129,1,129,1.936234000,0.0000
221.102.56.69,<->,109.0.216.133,0,0,1,861,1,861,1.936111000,0.0000
215.158.239.95,<->,195.127.172.174,1,602,0,0,1,602,1.935925000,0.0000
204.3.185.182,<->,136.25.188.224,0,0,1,265,1,265,1.935787000,0.0000
215.158.239.79,<->,199.32.150.17,1,573,0,0,1,573,1.935696000,0.0000
136.25.189.82,<->,57.227.82.200,1,1373,0,0,1,1373,1.935457000,0.0000
215.158.239.84,<->,204.227.227.81,1,260,0,0,1,260,1.935301000,0.0000
207.237.239.11,<->,136.25.188.242,0,0,1,101,1,101,1.935162000,0.0000
195.124.109.223,<->,136.25.188.177,0,0,1,573,1,573,1.935118000,0.0000
215.158.239.85,<->,142.207.221.239,1,765,0,0,1,765,1.935033000,0.0000
215.158.239.95,<->,199.106.66.60,1,141,0,0,1,141,1.934992000,0.0000
215.158.239.25,<->,96.135.154.141,1,1280,0,0,1,1280,1.934857000,0.0000
143.79.216.80,<->,136.25.188.198,0,0,1,506,1,506,1.934757000,0.0000
101.70.119.145,<->,53.144.55.136,1,115,0,0,1,115,1.934569000,0.0000
144.85.169.211,<->,97.126.83.79,0,0,1,782,1,782,1.934405000,0.0000
215.158.239.84,<->,142.248.16.154,1,270,0,0,1,270,1.934198000,0.0000
220.20.200.92,<->,131.45.239.178,1,327,0,0,1,327,1.934021000,0.0000
139.193.141.132,<->,120.164.124.6,1,393,0,0,1,393,1.933769000,0.0000
142.254.7.206,<->,136.25.188.177,0,0,1,89,1,89,1.933691000,0.0000
142.229.173.87,<->,136.25.188.225,0,0,1,87,1,87,1.933678000,0.0000
133.178.227.245,<->,111.151.237.171,1,837,0,0,1,837,1.933645000,0.0000
215.158.238.140,<->,97.243.113.39,1,1357,0,0,1,1357,1.933511000,0.0000
221.102.56.69,<->,80.40.58.69,0,0,1,294,1,294,1.933490000,0.0000
136.25.189.221,<->,100.224.163.115,1,741,0,0,1,741,1.933106000,0.0000
215.158.239.57,<->,196.93.194.68,1,117,0,0,1,117,1.932867000,0.0000
232.31.30.124,<->,220.55.124.203,0,0,1,222,1,222,1.932802000,0.0000
215.158.239.78,<->,199.20.7.196,1,776,0,0,1,776,1.932052000,0.0000
142.167.122.186,<->,136.25.188.174,0,0,1,93,1,93,1.931907000,0.0000
215.158.239.78,<->,199.20.31.2,1,781,0,0,1,781,1.931616000,0.0000
199.38.204.210,<->,136.25.188.196,0,0,1,561,1,561,1.931588000,0.0000
133.178.226.30,<->,131.1.253.248,1,1228,0,0,1,1228,1.931330000,0.0000
136.25.189.82,<->,113.92.151.23,1,1379,0,0,1,1379,1.931103000,0.0000
197.112.162.151,<->,0.195.210.46,0,0,1,238,1,238,1.931070000,0.0000
215.158.140.181,<->,53.231.93.171,1,459,0,0,1,459,1.930714000,0.0000
229.45.58.205,<->,224.76.13.221,1,634,0,0,1,634,1.930479000,0.0000
156.142.159.13,<->,0.195.210.33,0,0,1,117,1,117,1.930353000,0.0000
229.105.173.34,<->,97.198.127.201,0,0,1,97,1,97,1.930187000,0.0000
215.158.238.74,<->,197.125.126.182,1,1213,0,0,1,1213,1.930082000,0.0000
126.16.39.86,<->,50.224.76.234,0,0,1,818,1,818,1.929994000,0.0000
133.178.227.21,<->,133.56.180.77,1,363,0,0,1,363,1.929742000,0.0000
136.25.189.30,<->,56.28.207.201,1,612,0,0,1,612,1.929717000,0.0000
231.143.164.38,<->,136.25.188.178,0,0,1,101,1,101,1.929357000,0.0000
215.158.239.85,<->,199.20.28.182,1,272,0,0,1,272,1.929256000,0.0000
109.222.197.2,<->,53.240.214.83,1,491,0,0,1,491,1.929170000,0.0000
210.229.230.19,<->,101.176.99.177,1,68,0,0,1,68,1.929158000,0.0000
215.158.239.58,<->,199.20.30.33,1,602,0,0,1,602,1.929024000,0.0000
136.25.188.179,<->,80.47.111.107,1,1117,0,0,1,1117,1.929002000,0.0000
200.175.245.165,<->,54.37.5.99,1,1344,0,0,1,1344,1.928829000,0.0000
192.64.196.32,<->,132.211.48.138,1,52,0,0,1,52,1.928727000,0.0000
127.255.84.41,<->,92.162.253.89,0,0,1,573,1,573,1.928679000,0.0000
199.70.88.221,<->,136.25.188.197,0,0,1,722,1,722,1.928279000,0.0000
210.156.156.166,<->,77.12.175.79,1,89,0,0,1,89,1.928225000,0.0000
215.158.239.94,<->,199.20.28.191,1,717,0,0,1,717,1.927923000,0.0000
132.213.199.16,<->,8.52.148.104,0,0,1,575,1,575,1.927815000,0.0000
143.22.109.161,<->,8.183.25.25,0,0,1,279,1,279,1.927481000,0.0000
215.158.239.56,<->,194.237.31.83,1,240,0,0,1,240,1.927189000,0.0000
207.236.167.132,<->,136.25.188.255,0,0,1,641,1,641,1.926999000,0.0000
220.55.113.112,<->,139.254.119.163,1,573,0,0,1,573,1.926962000,0.0000
99.74.26.158,<->,80.47.188.214,1,1426,0,0,1,1426,1.926950000,0.0000
221.101.8.215,<->,194.253.80.233,1,803,0,0,1,803,1.926665000,0.0000
8.182.227.210,<->,6.21.254.254,1,617,0,0,1,617,1.926554000,0.0000
133.178.227.242,<->,8.61.93.30,1,1177,0,0,1,1177,1.926288000,0.0000
109.222.242.225,<->,53.190.20.59,1,1023,0,0,1,1023,1.926255000,0.0000
120.248.220.30,<->,0.195.210.46,0,0,1,412,1,412,1.926199000,0.0000
133.178.226.214,<->,129.175.139.144,1,145,0,0,1,145,1.926180000,0.0000
215.158.140.75,<->,8.192.205.0,1,1231,0,0,1,1231,1.925917000,0.0000
195.5.39.197,<->,136.25.188.254,0,0,1,561,1,561,1.925907000,0.0000
215.158.238.33,<->,206.103.215.232,1,1309,0,0,1,1309,1.925657000,0.0000
215.158.239.48,<->,199.69.119.113,1,240,0,0,1,240,1.925610000,0.0000
220.204.48.175,<->,210.229.230.18,0,0,1,68,1,68,1.925350000,0.0000
136.25.189.82,<->,114.94.161.196,1,1357,0,0,1,1357,1.925340000,0.0000
215.158.140.196,<->,215.158.58.223,1,1262,0,0,1,1262,1.925202000,0.0000
148.129.19.104,<->,136.25.189.77,0,0,1,1357,1,1357,1.925167000,0.0000
111.199.237.242,<->,0.195.210.44,0,0,1,282,1,282,1.925099000,0.0000
199.39.232.84,<->,136.25.188.227,0,0,1,270,1,270,1.925035000,0.0000
215.158.239.101,<->,129.222.39.148,1,757,0,0,1,757,1.924982000,0.0000
232.31.121.5,<->,139.193.141.194,0,0,1,363,1,363,1.924952000,0.0000
8.228.216.50,<->,8.191.6.213,1,520,0,0,1,520,1.924841000,0.0000
136.25.189.15,<->,29.211.5.100,1,1293,0,0,1,1293,1.924779000,0.0000
204.187.88.239,<->,136.25.188.162,0,0,1,602,1,602,1.924756000,0.0000
210.229.230.20,<->,107.110.214.8,1,80,0,0,1,80,1.924028000,0.0000
142.253.110.56,<->,136.25.188.237,0,0,1,240,1,240,1.923935000,0.0000
207.61.16.250,<->,136.25.188.236,0,0,1,602,1,602,1.923873000,0.0000
215.158.238.106,<->,111.151.70.74,1,1229,0,0,1,1229,1.923523000,0.0000
195.54.136.191,<->,136.25.188.211,0,0,1,602,1,602,1.923393000,0.0000
210.229.230.20,<->,103.249.39.16,1,68,0,0,1,68,1.923155000,0.0000
207.172.165.168,<->,136.25.188.163,0,0,1,765,1,765,1.923067000,0.0000
195.68.97.165,<->,136.25.188.46,0,0,1,602,1,602,1.922668000,0.0000
215.158.58.238,<->,6.73.247.91,0,0,1,88,1,88,1.922663000,0.0000
220.20.200.248,<->,100.206.84.172,1,262,0,0,1,262,1.922023000,0.0000
144.85.170.208,<->,98.87.145.175,1,700,0,0,1,700,1.921974000,0.0000
215.158.238.236,<->,126.219.194.4,1,1088,0,0,1,1088,1.921842000,0.0000
92.27.27.144,<->,78.55.151.222,1,137,0,0,1,137,1.921790000,0.0000
199.72.37.232,<->,136.25.188.53,0,0,1,653,1,653,1.921715000,0.0000
215.158.238.132,<->,29.123.209.152,1,1021,0,0,1,1021,1.921642000,0.0000
215.158.239.57,<->,199.20.29.199,1,653,0,0,1,653,1.921626000,0.0000
204.62.38.5,<->,136.25.188.197,0,0,1,240,1,240,1.921346000,0.0000
204.200.43.102,<->,136.25.188.209,0,0,1,270,1,270,1.921281000,0.0000
215.158.238.188,<->,29.213.219.74,1,1035,0,0,1,1035,1.921260000,0.0000
195.71.80.95,<->,136.25.188.253,0,0,1,87,1,87,1.921011000,0.0000
215.158.239.94,<->,207.228.243.25,1,602,0,0,1,602,1.920836000,0.0000
204.187.10.241,<->,136.25.188.238,0,0,1,602,1,602,1.920636000,0.0000
215.158.239.93,<->,207.166.162.210,1,93,0,0,1,93,1.920599000,0.0000
215.158.238.216,<->,215.158.132.240,1,118,0,0,1,118,1.920455000,0.0000
196.88.84.24,<->,136.25.188.253,0,0,1,75,1,75,1.920433000,0.0000
192.229.216.117,<->,100.51.6.159,1,457,0,0,1,457,1.920433000,0.0000
215.158.239.84,<->,142.220.137.30,1,170,0,0,1,170,1.920094000,0.0000
138.127.205.203,<->,109.222.194.66,0,0,1,85,1,85,1.919846000,0.0000
133.178.226.196,<->,56.1.238.203,1,754,0,0,1,754,1.919664000,0.0000
215.158.238.75,<->,131.1.195.244,1,1427,0,0,1,1427,1.919349000,0.0000
192.204.123.39,<->,136.25.189.45,0,0,1,1245,1,1245,1.918884000,0.0000
54.37.192.99,<->,48.53.196.74,0,0,1,110,1,110,1.918858000,0.0000
100.200.205.94,<->,8.182.139.197,0,0,1,561,1,561,1.918772000,0.0000
215.158.61.183,<->,8.176.8.182,0,0,1,1133,1,1133,1.918584000,0.0000
215.158.239.119,<->,215.158.61.191,1,1469,0,0,1,1469,1.918191000,0.0000
192.229.215.71,<->,139.246.60.47,1,429,0,0,1,429,1.918024000,0.0000
136.25.189.29,<->,96.156.169.221,1,1357,0,0,1,1357,1.917749000,0.0000
215.158.239.58,<->,195.80.76.92,1,602,0,0,1,602,1.917674000,0.0000
199.66.234.74,<->,136.25.188.52,0,0,1,602,1,602,1.917614000,0.0000
145.252.127.99,<->,53.249.52.18,1,268,0,0,1,268,1.917510000,0.0000
109.222.220.98,<->,54.52.243.230,1,265,0,0,1,265,1.917422000,0.0000
66.47.83.74,<->,8.252.221.236,0,0,1,452,1,452,1.917119000,0.0000
215.158.238.64,<->,113.23.21.201,1,1213,0,0,1,1213,1.916952000,0.0000
215.158.239.93,<->,199.20.109.177,1,602,0,0,1,602,1.916416000,0.0000
105.201.16.44,<->,100.95.233.66,0,0,1,397,1,397,1.916410000,0.0000
215.158.239.18,<->,215.158.127.170,1,1136,0,0,1,1136,1.916300000,0.0000
140.174.85.65,<->,136.25.188.252,0,0,1,1357,1,1357,1.916284000,0.0000
6.145.170.79,<->,0.195.210.44,0,0,1,109,1,109,1.916194000,0.0000
143.184.194.248,<->,92.27.27.172,0,0,1,424,1,424,1.916168000,0.0000
199.68.33.241,<->,136.25.188.253,0,0,1,834,1,834,1.915743000,0.0000
215.158.239.181,<->,113.23.46.151,1,284,0,0,1,284,1.915605000,0.0000
136.25.188.237,<->,126.219.194.142,1,1149,0,0,1,1149,1.915294000,0.0000
136.98.166.244,<->,8.220.177.81,0,0,1,442,1,442,1.915264000,0.0000
149.167.183.180,<->,8.252.222.204,0,0,1,1197,1,1197,1.915058000,0.0000
17.27.56.184,<->,8.220.179.94,0,0,1,1046,1,1046,1.914531000,0.0000
102.45.243.14,<->,80.38.13.15,0,0,1,196,1,196,1.914515000,0.0000
195.71.146.117,<->,136.25.188.176,0,0,1,93,1,93,1.914513000,0.0000
133.8.10.153,<->,33.233.141.116,0,0,1,318,1,318,1.914428000,0.0000
157.134.14.26,<->,50.224.76.235,0,0,1,1305,1,1305,1.914272000,0.0000
207.62.130.203,<->,136.25.188.252,0,0,1,303,1,303,1.913771000,0.0000
131.99.233.50,<->,50.224.76.235,0,0,1,1214,1,1214,1.913460000,0.0000
202.33.61.112,<->,136.25.188.252,0,0,1,250,1,250,1.913394000,0.0000
215.158.239.56,<->,194.199.202.252,1,561,0,0,1,561,1.912822000,0.0000
133.178.226.111,<->,126.219.247.38,1,158,0,0,1,158,1.912746000,0.0000
133.178.226.28,<->,42.97.54.126,1,1245,0,0,1,1245,1.912627000,0.0000
98.23.97.118,<->,8.176.60.254,0,0,1,565,1,565,1.912611000,0.0000
195.55.8.127,<->,136.25.188.227,0,0,1,240,1,240,1.912598000,0.0000
215.158.238.75,<->,113.23.117.87,1,101,0,0,1,101,1.912492000,0.0000
215.158.239.76,<->,194.202.158.24,1,185,0,0,1,185,1.912349000,0.0000
129.78.112.99,<->,111.2.156.140,1,559,0,0,1,559,1.912309000,0.0000
215.158.239.28,<->,113.93.9.8,1,1489,0,0,1,1489,1.912190000,0.0000
145.252.124.87,<->,89.155.136.36,1,1268,0,0,1,1268,1.912126000,0.0000
215.158.239.78,<->,199.20.7.151,1,101,0,0,1,101,1.912080000,0.0000
215.158.239.79,<->,199.82.187.144,1,602,0,0,1,602,1.911611000,0.0000
54.36.29.60,<->,48.54.128.253,0,0,1,125,1,125,1.911314000,0.0000
220.20.200.20,<->,144.83.60.153,1,1034,0,0,1,1034,1.911311000,0.0000
215.158.239.92,<->,196.93.185.246,1,93,0,0,1,93,1.911294000,0.0000
215.158.61.243,<->,8.176.8.238,0,0,1,765,1,765,1.910930000,0.0000
139.163.26.146,<->,122.223.191.75,1,99,0,0,1,99,1.910873000,0.0000
215.158.239.71,<->,114.25.48.40,1,1213,0,0,1,1213,1.910728000,0.0000
215.158.239.68,<->,195.40.159.229,1,270,0,0,1,270,1.910705000,0.0000
149.109.218.105,<->,92.27.219.205,0,0,1,435,1,435,1.910520000,0.0000
215.158.238.133,<->,122.159.31.102,1,101,0,0,1,101,1.910409000,0.0000
98.219.117.2,<->,80.38.56.244,0,0,1,863,1,863,1.909947000,0.0000
194.252.68.61,<->,0.195.210.42,0,0,1,245,1,245,1.909805000,0.0000
215.158.239.76,<->,207.57.53.94,1,602,0,0,1,602,1.909689000,0.0000
197.113.99.61,<->,136.25.188.44,0,0,1,602,1,602,1.909548000,0.0000
220.20.200.39,<->,144.83.60.153,1,298,0,0,1,298,1.909462000,0.0000
8.55.211.213,<->,6.74.94.24,0,0,1,294,1,294,1.909432000,0.0000
215.158.239.31,<->,117.155.166.251,1,260,0,0,1,260,1.909389000,0.0000
133.178.226.95,<->,96.155.60.253,1,506,0,0,1,506,1.909361000,0.0000
17.255.114.134,<->,8.220.188.50,0,0,1,654,1,654,1.909203000,0.0000
194.234.227.156,<->,136.25.188.55,0,0,1,602,1,602,1.908815000,0.0000
50.224.49.195,<->,6.210.144.102,1,174,0,0,1,174,1.908463000,0.0000
138.98.152.67,<->,57.125.232.216,1,191,0,0,1,191,1.908239000,0.0000
215.158.239.96,<->,207.166.184.89,1,240,0,0,1,240,1.908237000,0.0000
148.229.98.75,<->,50.224.76.235,0,0,1,420,1,420,1.908201000,0.0000
120.89.238.112,<->,50.224.76.234,0,0,1,1411,1,1411,1.907784000,0.0000
215.158.238.106,<->,141.39.23.86,1,1213,0,0,1,1213,1.907747000,0.0000
133.178.227.27,<->,8.53.217.77,1,1341,0,0,1,1341,1.907334000,0.0000
234.182.161.111,<->,97.126.31.66,0,0,1,421,1,421,1.907231000,0.0000
250.50.79.124,<->,80.38.11.227,0,0,1,375,1,375,1.907180000,0.0000
215.158.239.123,<->,111.151.109.41,1,100,0,0,1,100,1.906621000,0.0000
215.158.239.96,<->,196.93.212.117,1,602,0,0,1,602,1.906453000,0.0000
144.95.111.40,<->,111.147.77.247,0,0,1,288,1,288,1.905774000,0.0000
113.16.253.190,<->,50.224.76.235,0,0,1,1421,1,1421,1.905485000,0.0000
56.121.39.173,<->,8.222.6.88,1,1131,0,0,1,1131,1.905308000,0.0000
215.158.239.33,<->,149.96.50.9,1,183,0,0,1,183,1.904676000,0.0000
207.57.78.162,<->,136.25.188.174,0,0,1,335,1,335,1.904238000,0.0000
197.113.99.129,<->,136.25.188.46,0,0,1,284,1,284,1.904232000,0.0000
246.253.253.97,<->,210.209.251.214,1,481,0,0,1,481,1.903761000,0.0000
148.129.19.195,<->,133.178.226.28,0,0,1,1069,1,1069,1.903733000,0.0000
215.158.238.209,<->,149.96.60.40,1,1104,0,0,1,1104,1.903697000,0.0000
145.242.126.105,<->,98.197.185.20,1,100,0,0,1,100,1.903534000,0.0000
53.160.164.131,<->,48.53.114.198,0,0,1,93,1,93,1.903019000,0.0000
247.152.222.147,<->,50.224.76.234,0,0,1,472,1,472,1.902415000,0.0000
133.178.226.7,<->,126.219.132.192,1,1341,0,0,1,1341,1.902391000,0.0000
48.16.238.48,<->,8.252.221.236,0,0,1,427,1,427,1.902191000,0.0000
136.25.188.235,<->,133.56.180.20,1,1125,0,0,1,1125,1.902180000,0.0000
246.253.253.97,<->,210.209.251.223,1,481,0,0,1,481,1.902139000,0.0000
215.158.239.68,<->,142.229.119.236,1,378,0,0,1,378,1.901611000,0.0000
133.244.31.123,<->,80.27.154.175,1,221,0,0,1,221,1.901476000,0.0000
215.158.238.67,<->,91.247.40.43,1,290,0,0,1,290,1.901473000,0.0000
215.158.238.196,<->,141.134.142.217,1,1103,0,0,1,1103,1.901072000,0.0000
133.178.226.28,<->,104.3.163.105,1,1101,0,0,1,1101,1.900644000,0.0000
142.207.89.194,<->,136.25.188.178,0,0,1,765,1,765,1.900466000,0.0000
132.187.73.3,<->,8.182.139.197,0,0,1,598,1,598,1.899870000,0.0000
195.12.249.171,<->,136.25.188.224,0,0,1,132,1,132,1.899797000,0.0000
207.61.74.4,<->,136.25.188.226,0,0,1,260,1,260,1.899735000,0.0000
215.158.61.203,<->,136.25.189.214,0,0,1,221,1,221,1.899731000,0.0000
251.24.86.2,<->,8.252.222.23,0,0,1,831,1,831,1.899465000,0.0000
133.178.226.37,<->,8.255.92.246,1,93,0,0,1,93,1.899461000,0.0000
220.28.65.9,<->,215.158.238.218,0,0,1,552,1,552,1.899074000,0.0000
215.158.239.33,<->,131.95.192.157,1,1481,0,0,1,1481,1.898925000,0.0000
215.158.238.236,<->,84.203.220.167,1,1389,0,0,1,1389,1.898797000,0.0000
231.140.87.155,<->,215.158.239.49,0,0,1,265,1,265,1.898526000,0.0000
89.204.117.248,<->,8.182.252.86,0,0,1,549,1,549,1.898383000,0.0000
42.90.159.228,<->,0.195.210.42,0,0,1,561,1,561,1.898125000,0.0000
145.242.126.15,<->,98.197.185.20,1,100,0,0,1,100,1.897513000,0.0000
199.25.143.93,<->,0.195.210.44,0,0,1,109,1,109,1.897313000,0.0000
104.209.253.210,<->,50.224.76.248,0,0,1,1050,1,1050,1.897271000,0.0000
111.20.171.169,<->,33.233.141.11,0,0,1,590,1,590,1.896985000,0.0000
89.216.124.13,<->,54.54.1.89,1,277,0,0,1,277,1.896709000,0.0000
89.183.104.129,<->,48.105.80.135,1,1384,0,0,1,1384,1.896622000,0.0000
232.104.124.176,<->,8.52.189.207,0,0,1,256,1,256,1.896466000,0.0000
112.38.133.95,<->,50.224.89.241,0,0,1,1101,1,1101,1.896465000,0.0000
215.158.33.106,<->,8.252.223.89,0,0,1,1338,1,1338,1.896400000,0.0000
215.158.239.87,<->,199.20.7.89,1,506,0,0,1,506,1.896287000,0.0000
132.234.106.64,<->,102.224.162.245,0,0,1,209,1,209,1.896218000,0.0000
204.185.17.53,<->,136.25.188.53,0,0,1,717,1,717,1.896180000,0.0000
215.158.239.94,<->,194.232.113.64,1,602,0,0,1,602,1.895804000,0.0000
57.221.68.6,<->,35.56.96.142,0,0,1,599,1,599,1.895753000,0.0000
204.120.149.124,<->,0.195.210.44,0,0,1,93,1,93,1.895521000,0.0000
139.160.226.247,<->,136.25.188.179,0,0,1,1181,1,1181,1.895476000,0.0000
215.158.239.51,<->,205.227.96.23,1,309,0,0,1,309,1.895425000,0.0000
140.145.218.97,<->,136.25.188.253,0,0,1,1213,1,1213,1.895381000,0.0000
136.25.188.253,<->,104.3.163.80,1,1341,0,0,1,1341,1.894856000,0.0000
17.204.25.210,<->,8.220.184.162,0,0,1,116,1,116,1.894843000,0.0000
197.113.99.150,<->,136.25.188.46,0,0,1,1033,1,1033,1.894695000,0.0000
194.233.3.53,<->,136.25.188.174,0,0,1,141,1,141,1.894620000,0.0000
215.158.239.34,<->,126.219.142.46,1,127,0,0,1,127,1.894585000,0.0000
126.198.147.25,<->,80.41.24.146,0,0,1,341,1,341,1.894526000,0.0000
209.91.132.145,<->,8.220.191.251,0,0,1,438,1,438,1.894490000,0.0000
215.158.44.186,<->,136.25.189.81,0,0,1,1148,1,1148,1.894445000,0.0000
215.158.239.96,<->,199.68.37.47,1,765,0,0,1,765,1.894273000,0.0000
196.201.77.4,<->,8.252.222.38,0,0,1,561,1,561,1.894120000,0.0000
194.254.119.10,<->,8.20.87.206,0,0,1,794,1,794,1.893801000,0.0000
215.158.239.34,<->,106.188.156.149,1,1469,0,0,1,1469,1.893728000,0.0000
215.158.238.73,<->,29.212.43.231,1,1229,0,0,1,1229,1.893689000,0.0000
199.70.65.46,<->,136.25.188.255,0,0,1,602,1,602,1.893503000,0.0000
195.7.202.189,<->,136.25.188.222,0,0,1,561,1,561,1.893446000,0.0000
220.38.84.244,<->,136.25.189.16,0,0,1,1197,1,1197,1.893171000,0.0000
195.71.173.250,<->,136.25.188.222,0,0,1,602,1,602,1.893097000,0.0000
111.147.142.93,<->,54.37.211.103,1,109,0,0,1,109,1.892907000,0.0000
215.158.239.78,<->,196.0.79.175,1,765,0,0,1,765,1.892716000,0.0000
139.193.141.139,<->,66.87.70.36,1,570,0,0,1,570,1.892600000,0.0000
215.158.61.182,<->,8.176.8.99,0,0,1,1341,1,1341,1.892461000,0.0000
195.41.158.126,<->,136.25.188.52,0,0,1,456,1,456,1.892359000,0.0000
215.158.238.25,<->,126.219.192.39,1,1485,0,0,1,1485,1.891975000,0.0000
215.158.239.48,<->,195.55.151.85,1,561,0,0,1,561,1.891780000,0.0000
202.33.231.244,<->,136.25.188.220,0,0,1,87,1,87,1.891653000,0.0000
215.158.239.50,<->,196.89.56.25,1,602,0,0,1,602,1.891495000,0.0000
202.33.27.12,<->,136.25.188.209,0,0,1,602,1,602,1.891225000,0.0000
133.178.226.49,<->,61.35.70.248,1,1197,0,0,1,1197,1.891109000,0.0000
215.158.239.76,<->,194.251.128.115,1,307,0,0,1,307,1.891064000,0.0000
136.25.188.225,<->,57.247.184.229,1,1341,0,0,1,1341,1.891062000,0.0000
207.59.201.32,<->,136.25.188.196,0,0,1,710,1,710,1.890794000,0.0000
216.184.0.60,<->,8.252.223.195,0,0,1,97,1,97,1.890530000,0.0000
215.158.140.173,<->,83.246.35.0,1,241,0,0,1,241,1.890364000,0.0000
111.20.168.122,<->,101.224.91.111,1,749,0,0,1,749,1.890343000,0.0000
199.72.43.98,<->,136.25.188.174,0,0,1,765,1,765,1.889840000,0.0000
215.158.61.183,<->,8.176.8.245,0,0,1,722,1,722,1.889797000,0.0000
215.158.103.203,<->,33.3.89.166,1,1333,0,0,1,1333,1.889678000,0.0000
215.158.239.69,<->,80.56.79.101,1,1197,0,0,1,1197,1.888992000,0.0000
209.91.187.192,<->,8.53.6.89,0,0,1,402,1,402,1.888798000,0.0000
215.158.140.173,<->,6.73.247.8,1,940,0,0,1,940,1.888347000,0.0000
205.121.147.33,<->,98.67.140.57,0,0,1,247,1,247,1.888333000,0.0000
131.8.156.179,<->,50.224.76.235,0,0,1,121,1,121,1.888259000,0.0000
136.25.188.211,<->,126.219.194.99,1,1213,0,0,1,1213,1.888161000,0.0000
106.23.143.139,<->,8.52.245.115,0,0,1,318,1,318,1.888096000,0.0000
92.27.219.18,<->,66.244.110.20,1,95,0,0,1,95,1.888027000,0.0000
142.220.59.69,<->,136.25.188.174,0,0,1,632,1,632,1.887912000,0.0000
207.79.113.247,<->,92.27.194.147,0,0,1,353,1,353,1.887652000,0.0000
109.222.245.43,<->,101.64.188.49,1,1199,0,0,1,1199,1.887546000,0.0000
133.178.227.40,<->,8.222.212.32,1,1145,0,0,1,1145,1.887355000,0.0000
215.158.238.80,<->,57.199.250.222,1,1197,0,0,1,1197,1.887309000,0.0000
198.204.76.208,<->,136.25.189.80,0,0,1,1229,1,1229,1.886970000,0.0000
116.178.189.227,<->,92.27.219.169,0,0,1,1396,1,1396,1.886717000,0.0000
133.178.226.19,<->,69.150.169.181,1,1277,0,0,1,1277,1.886549000,0.0000
204.58.60.210,<->,136.25.188.196,0,0,1,602,1,602,1.886496000,0.0000
202.33.250.116,<->,136.25.188.222,0,0,1,602,1,602,1.886301000,0.0000
133.178.227.41,<->,114.171.18.217,1,1054,0,0,1,1054,1.886047000,0.0000
215.158.239.7,<->,8.241.236.193,1,1416,0,0,1,1416,1.886041000,0.0000
136.25.188.45,<->,29.211.186.197,1,1213,0,0,1,1213,1.885820000,0.0000
121.252.25.55,<->,56.121.58.220,0,0,1,1108,1,1108,1.885799000,0.0000
215.158.239.51,<->,118.20.100.183,1,1373,0,0,1,1373,1.885367000,0.0000
215.158.238.51,<->,129.222.36.146,1,1326,0,0,1,1326,1.885281000,0.0000
215.158.239.76,<->,199.20.30.52,1,378,0,0,1,378,1.885231000,0.0000
75.144.70.129,<->,8.252.221.197,0,0,1,506,1,506,1.884860000,0.0000
119.54.237.6,<->,0.195.210.42,0,0,1,561,1,561,1.884773000,0.0000
250.93.112.120,<->,50.224.76.235,0,0,1,985,1,985,1.884580000,0.0000
215.158.238.148,<->,126.219.190.163,1,1309,0,0,1,1309,1.884323000,0.0000
215.158.239.57,<->,199.20.29.238,1,190,0,0,1,190,1.884252000,0.0000
204.114.26.24,<->,92.27.194.147,0,0,1,249,1,249,1.883947000,0.0000
215.158.238.95,<->,116.106.60.163,1,1357,0,0,1,1357,1.883939000,0.0000
159.137.141.82,<->,27.86.197.67,1,779,0,0,1,779,1.883374000,0.0000
215.158.238.97,<->,8.252.213.13,1,1373,0,0,1,1373,1.883224000,0.0000
142.208.100.154,<->,136.25.188.241,0,0,1,602,1,602,1.882931000,0.0000
6.145.167.188,<->,0.195.210.44,0,0,1,93,1,93,1.882803000,0.0000
196.246.241.77,<->,136.25.188.177,0,0,1,669,1,669,1.882783000,0.0000
194.233.38.180,<->,136.25.188.174,0,0,1,282,1,282,1.882670000,0.0000
215.158.238.187,<->,98.219.126.175,1,558,0,0,1,558,1.882113000,0.0000
207.236.159.236,<->,136.25.188.52,0,0,1,561,1,561,1.882076000,0.0000
247.136.152.205,<->,54.44.33.166,1,99,0,0,1,99,1.881993000,0.0000
129.209.93.208,<->,8.183.25.25,0,0,1,282,1,282,1.881901000,0.0000
231.255.191.45,<->,192.67.111.1,0,0,1,635,1,635,1.881341000,0.0000
215.158.238.250,<->,61.35.22.195,1,1079,0,0,1,1079,1.881196000,0.0000
144.85.170.254,<->,136.18.96.216,1,799,0,0,1,799,1.881082000,0.0000
215.158.238.236,<->,158.85.50.88,1,1110,0,0,1,1110,1.880771000,0.0000
8.183.25.25,<->,6.133.238.200,1,282,0,0,1,282,1.880767000,0.0000
207.190.192.89,<->,136.25.188.198,0,0,1,617,1,617,1.880764000,0.0000
139.163.17.164,<->,102.246.159.231,1,63,0,0,1,63,1.880721000,0.0000
139.193.141.139,<->,122.199.215.176,1,409,0,0,1,409,1.880568000,0.0000
215.158.238.133,<->,142.234.196.202,1,1213,0,0,1,1213,1.880473000,0.0000
139.163.26.146,<->,0.90.243.237,1,111,0,0,1,111,1.880448000,0.0000
215.158.239.70,<->,57.236.82.251,1,1341,0,0,1,1341,1.880431000,0.0000
136.25.189.77,<->,135.228.221.199,1,1213,0,0,1,1213,1.880030000,0.0000
220.80.242.167,<->,8.55.211.213,1,294,0,0,1,294,1.879800000,0.0000
204.185.198.81,<->,136.25.188.222,0,0,1,602,1,602,1.879679000,0.0000
80.41.252.160,<->,8.45.168.98,1,141,0,0,1,141,1.879617000,0.0000
210.229.230.22,<->,17.11.207.216,1,68,0,0,1,68,1.879120000,0.0000
53.214.118.195,<->,48.53.140.76,0,0,1,1169,1,1169,1.878744000,0.0000
220.28.110.130,<->,144.86.150.89,0,0,1,363,1,363,1.878534000,0.0000
199.54.0.147,<->,8.182.243.35,0,0,1,561,1,561,1.878325000,0.0000
159.137.162.213,<->,105.108.103.246,1,332,0,0,1,332,1.878320000,0.0000
195.43.255.251,<->,136.25.188.177,0,0,1,182,1,182,1.878177000,0.0000
145.252.123.37,<->,117.36.215.101,1,761,0,0,1,761,1.878041000,0.0000
215.158.61.202,<->,8.176.8.219,0,0,1,1501,1,1501,1.877636000,0.0000
141.25.2.220,<->,133.178.226.38,0,0,1,1341,1,1341,1.877594000,0.0000
215.158.239.41,<->,8.190.216.220,1,1326,0,0,1,1326,1.877042000,0.0000
239.66.236.28,<->,129.92.117.130,0,0,1,865,1,865,1.876895000,0.0000
136.25.188.179,<->,118.20.114.95,1,1181,0,0,1,1181,1.876681000,0.0000
204.56.125.183,<->,136.25.188.236,0,0,1,854,1,854,1.876402000,0.0000
207.236.166.125,<->,136.25.188.254,0,0,1,279,1,279,1.876398000,0.0000
207.206.62.204,<->,50.223.3.228,0,0,1,254,1,254,1.876167000,0.0000
137.45.27.47,<->,92.162.253.77,0,0,1,394,1,394,1.876093000,0.0000
215.158.140.60,<->,8.40.51.176,1,1089,0,0,1,1089,1.875684000,0.0000
207.61.141.2,<->,136.25.188.252,0,0,1,93,1,93,1.875522000,0.0000
159.224.178.58,<->,8.53.3.36,0,0,1,320,1,320,1.874991000,0.0000
224.250.191.6,<->,100.94.193.188,0,0,1,68,1,68,1.874577000,0.0000
246.253.253.107,<->,56.114.235.120,1,966,0,0,1,966,1.874576000,0.0000
205.127.108.115,<->,101.224.89.180,0,0,1,443,1,443,1.874575000,0.0000
111.150.186.220,<->,8.252.222.236,0,0,1,1005,1,1005,1.874505000,0.0000
210.229.230.21,<->,98.243.253.100,1,76,0,0,1,76,1.873153000,0.0000
126.198.147.25,<->,102.50.91.150,0,0,1,340,1,340,1.872923000,0.0000
210.229.230.19,<->,145.214.244.32,1,68,0,0,1,68,1.872704000,0.0000
133.178.226.90,<->,29.214.108.81,1,1213,0,0,1,1213,1.871956000,0.0000
142.206.35.4,<->,136.25.188.252,0,0,1,561,1,561,1.871896000,0.0000
215.158.238.190,<->,128.194.247.55,1,1325,0,0,1,1325,1.871719000,0.0000
207.190.192.89,<->,136.25.188.242,0,0,1,617,1,617,1.871508000,0.0000
111.150.207.206,<->,8.252.223.72,0,0,1,100,1,100,1.871239000,0.0000
215.158.133.207,<->,6.73.247.33,0,0,1,693,1,693,1.871236000,0.0000
53.213.63.83,<->,48.52.215.212,0,0,1,545,1,545,1.871045000,0.0000
210.209.251.211,<->,144.87.235.222,0,0,1,502,1,502,1.871042000,0.0000
194.253.81.104,<->,8.252.222.237,0,0,1,264,1,264,1.871036000,0.0000
215.158.238.82,<->,192.228.30.34,1,1133,0,0,1,1133,1.870959000,0.0000
159.13.142.108,<->,54.92.216.150,1,118,0,0,1,118,1.870954000,0.0000
143.10.246.59,<->,136.25.188.254,0,0,1,272,1,272,1.870945000,0.0000
215.158.239.92,<->,199.20.29.199,1,781,0,0,1,781,1.870469000,0.0000
133.178.227.251,<->,111.150.185.73,1,1357,0,0,1,1357,1.870346000,0.0000
144.87.238.89,<->,8.252.221.171,0,0,1,493,1,493,1.870148000,0.0000
215.158.238.83,<->,8.188.227.68,1,1213,0,0,1,1213,1.869955000,0.0000
96.232.239.14,<->,92.27.219.36,0,0,1,50,1,50,1.869698000,0.0000
215.158.238.149,<->,156.165.37.102,1,1261,0,0,1,1261,1.869498000,0.0000
136.25.189.0,<->,27.22.184.102,1,1341,0,0,1,1341,1.869425000,0.0000
109.29.240.65,<->,8.20.87.155,0,0,1,732,1,732,1.869368000,0.0000
215.158.238.96,<->,29.213.195.69,1,1261,0,0,1,1261,1.869305000,0.0000
136.105.124.7,<->,6.75.134.121,0,0,1,484,1,484,1.868737000,0.0000
221.101.8.215,<->,159.190.66.226,1,402,0,0,1,402,1.868549000,0.0000
204.1.228.207,<->,136.25.188.209,0,0,1,93,1,93,1.868257000,0.0000
195.127.104.56,<->,136.25.188.236,0,0,1,573,1,573,1.868108000,0.0000
215.158.238.243,<->,35.17.217.34,1,364,0,0,1,364,1.867898000,0.0000
136.25.188.239,<->,69.150.168.232,1,1197,0,0,1,1197,1.867591000,0.0000
143.135.41.59,<->,136.25.188.241,0,0,1,602,1,602,1.867495000,0.0000
139.163.10.228,<->,27.11.102.242,1,252,0,0,1,252,1.867491000,0.0000
193.39.70.92,<->,136.25.188.253,0,0,1,1117,1,1117,1.867005000,0.0000
215.158.239.51,<->,196.109.18.222,1,182,0,0,1,182,1.866410000,0.0000
136.25.188.220,<->,29.211.6.45,1,1093,0,0,1,1093,1.866007000,0.0000
143.135.128.235,<->,136.25.188.255,0,0,1,506,1,506,1.865564000,0.0000
215.158.140.75,<->,137.129.85.75,1,1230,0,0,1,1230,1.865496000,0.0000
111.147.181.133,<->,53.244.224.179,1,366,0,0,1,366,1.865204000,0.0000
204.185.219.110,<->,136.25.188.243,0,0,1,282,1,282,1.864795000,0.0000
43.55.236.104,<->,8.252.221.223,0,0,1,429,1,429,1.864352000,0.0000
215.158.238.21,<->,120.33.113.232,1,117,0,0,1,117,1.864331000,0.0000
204.153.2.131,<->,92.27.194.147,0,0,1,249,1,249,1.864014000,0.0000
249.101.89.113,<->,50.145.227.155,1,93,0,0,1,93,1.864008000,0.0000
207.188.238.153,<->,136.25.188.225,0,0,1,602,1,602,1.863827000,0.0000
215.158.239.50,<->,199.106.106.24,1,93,0,0,1,93,1.863477000,0.0000
215.158.238.50,<->,129.222.39.99,1,1353,0,0,1,1353,1.863316000,0.0000
199.122.47.69,<->,136.25.188.225,0,0,1,260,1,260,1.863161000,0.0000
148.35.65.45,<->,50.224.76.234,0,0,1,944,1,944,1.863052000,0.0000
215.158.238.223,<->,18.202.90.172,1,1261,0,0,1,1261,1.862711000,0.0000
133.178.226.227,<->,113.23.103.185,1,283,0,0,1,283,1.862480000,0.0000
221.102.56.69,<->,6.74.104.58,0,0,1,294,1,294,1.862365000,0.0000
215.158.239.51,<->,199.51.236.251,1,282,0,0,1,282,1.862076000,0.0000
215.158.238.148,<->,122.216.233.212,1,1245,0,0,1,1245,1.861953000,0.0000
204.185.148.180,<->,136.25.188.242,0,0,1,378,1,378,1.861759000,0.0000
136.25.188.209,<->,50.150.173.171,1,93,0,0,1,93,1.861441000,0.0000
220.55.123.87,<->,27.11.149.50,1,292,0,0,1,292,1.860746000,0.0000
96.232.239.36,<->,92.27.27.178,0,0,1,50,1,50,1.860477000,0.0000
215.158.239.56,<->,196.108.10.83,1,602,0,0,1,602,1.859932000,0.0000
215.158.239.78,<->,207.59.31.20,1,561,0,0,1,561,1.859650000,0.0000
215.158.239.94,<->,199.20.31.239,1,272,0,0,1,272,1.859411000,0.0000
215.158.239.77,<->,194.234.178.23,1,602,0,0,1,602,1.859384000,0.0000
204.185.99.57,<->,136.25.188.177,0,0,1,404,1,404,1.859366000,0.0000
204.200.32.9,<->,136.25.188.55,0,0,1,765,1,765,1.858987000,0.0000
129.224.112.221,<->,97.242.126.176,1,99,0,0,1,99,1.858980000,0.0000
197.113.99.250,<->,136.25.188.196,0,0,1,220,1,220,1.858860000,0.0000
215.158.239.58,<->,199.20.5.116,1,749,0,0,1,749,1.858859000,0.0000
231.140.153.11,<->,215.158.239.94,0,0,1,272,1,272,1.858806000,0.0000
192.170.245.60,<->,133.178.227.2,0,0,1,1092,1,1092,1.858666000,0.0000
215.158.239.96,<->,199.80.9.28,1,602,0,0,1,602,1.858212000,0.0000
133.178.227.27,<->,130.165.253.26,1,1031,0,0,1,1031,1.858090000,0.0000
8.55.211.213,<->,6.75.211.43,0,0,1,294,1,294,1.857985000,0.0000
92.168.217.206,<->,50.136.141.181,1,312,0,0,1,312,1.857864000,0.0000
136.25.188.161,<->,121.189.159.24,1,1325,0,0,1,1325,1.857828000,0.0000
215.158.61.182,<->,136.25.188.43,0,0,1,61,1,61,1.857807000,0.0000
215.158.239.113,<->,129.222.36.56,1,339,0,0,1,339,1.857559000,0.0000
195.55.79.136,<->,136.25.188.220,0,0,1,561,1,561,1.857209000,0.0000
133.178.226.61,<->,106.188.236.166,1,1373,0,0,1,1373,1.856911000,0.0000
199.102.146.243,<->,50.223.3.228,0,0,1,228,1,228,1.856898000,0.0000
215.158.238.66,<->,57.199.250.202,1,1309,0,0,1,1309,1.856873000,0.0000
215.158.239.58,<->,196.91.92.22,1,602,0,0,1,602,1.856751000,0.0000
136.25.189.193,<->,100.224.132.237,1,797,0,0,1,797,1.856245000,0.0000
133.178.226.227,<->,8.191.135.35,1,283,0,0,1,283,1.856164000,0.0000
195.17.159.19,<->,136.25.189.15,0,0,1,1229,1,1229,1.855699000,0.0000
132.200.51.118,<->,129.224.112.220,0,0,1,99,1,99,1.855607000,0.0000
215.158.239.56,<->,196.107.142.49,1,240,0,0,1,240,1.855371000,0.0000
215.158.58.220,<->,99.74.27.37,0,0,1,520,1,520,1.855029000,0.0000
91.231.195.229,<->,50.57.180.49,1,72,0,0,1,72,1.854928000,0.0000
215.158.239.57,<->,195.81.52.214,1,141,0,0,1,141,1.854751000,0.0000
97.20.14.218,<->,8.182.253.233,0,0,1,516,1,516,1.854498000,0.0000
207.207.19.108,<->,8.20.87.153,0,0,1,1005,1,1005,1.854441000,0.0000
136.25.189.221,<->,100.224.163.114,1,1237,0,0,1,1237,1.854437000,0.0000
136.128.5.253,<->,8.228.212.50,0,0,1,145,1,145,1.854350000,0.0000
142.248.178.25,<->,136.25.188.242,0,0,1,561,1,561,1.854190000,0.0000
133.178.226.37,<->,29.211.186.213,1,1341,0,0,1,1341,1.853922000,0.0000
133.178.227.78,<->,80.57.141.92,1,1451,0,0,1,1451,1.853745000,0.0000
139.193.141.139,<->,127.66.71.21,1,327,0,0,1,327,1.853688000,0.0000
136.25.188.45,<->,91.57.173.52,1,1229,0,0,1,1229,1.853415000,0.0000
215.158.239.49,<->,126.219.191.4,1,1373,0,0,1,1373,1.853161000,0.0000
222.35.163.82,<->,50.224.61.152,0,0,1,298,1,298,1.853068000,0.0000
138.98.148.32,<->,92.162.218.66,1,863,0,0,1,863,1.853028000,0.0000
138.98.240.68,<->,27.124.47.97,1,1135,0,0,1,1135,1.852907000,0.0000
133.178.227.19,<->,112.93.136.106,1,1389,0,0,1,1389,1.852802000,0.0000
50.55.175.77,<->,8.220.200.124,0,0,1,764,1,764,1.852430000,0.0000
215.158.239.50,<->,204.58.46.87,1,269,0,0,1,269,1.852261000,0.0000
142.253.191.95,<->,136.25.188.242,0,0,1,602,1,602,1.852225000,0.0000
192.229.43.38,<->,133.178.227.245,0,0,1,653,1,653,1.851799000,0.0000
215.158.239.114,<->,111.151.237.141,1,624,0,0,1,624,1.851768000,0.0000
149.56.227.77,<->,109.222.200.93,0,0,1,124,1,124,1.851698000,0.0000
215.158.238.36,<->,29.214.108.202,1,1325,0,0,1,1325,1.851496000,0.0000
215.158.238.65,<->,143.20.121.150,1,1181,0,0,1,1181,1.851392000,0.0000
118.125.64.225,<->,50.224.76.248,0,0,1,807,1,807,1.851257000,0.0000
139.163.96.103,<->,93.208.94.184,1,866,0,0,1,866,1.851163000,0.0000
239.227.119.111,<->,221.102.143.189,1,141,0,0,1,141,1.851042000,0.0000
215.158.239.84,<->,149.254.114.189,1,1325,0,0,1,1325,1.850601000,0.0000
215.158.238.82,<->,100.224.138.232,1,180,0,0,1,180,1.850516000,0.0000
247.136.138.95,<->,210.209.251.214,1,481,0,0,1,481,1.850221000,0.0000
139.193.141.209,<->,115.119.81.160,1,518,0,0,1,518,1.849998000,0.0000
215.158.239.105,<->,215.158.61.191,1,657,0,0,1,657,1.849902000,0.0000
50.53.52.221,<->,8.220.191.118,0,0,1,876,1,876,1.849835000,0.0000
93.212.228.200,<->,8.31.37.175,0,0,1,268,1,268,1.849648000,0.0000
136.25.189.16,<->,112.68.105.202,1,1277,0,0,1,1277,1.849214000,0.0000
129.175.139.238,<->,8.176.8.99,0,0,1,509,1,509,1.848915000,0.0000
142.166.91.143,<->,136.25.188.220,0,0,1,240,1,240,1.848740000,0.0000
207.236.167.132,<->,136.25.188.198,0,0,1,272,1,272,1.848446000,0.0000
215.158.140.93,<->,29.214.211.31,1,1081,0,0,1,1081,1.848107000,0.0000
254.78.46.138,<->,139.193.141.139,0,0,1,475,1,475,1.848080000,0.0000
133.178.227.76,<->,61.35.124.227,1,1079,0,0,1,1079,1.847629000,0.0000
197.113.99.18,<->,136.25.188.255,0,0,1,272,1,272,1.847519000,0.0000
143.129.165.28,<->,136.25.188.178,0,0,1,240,1,240,1.847325000,0.0000
215.158.238.201,<->,215.158.33.107,1,570,0,0,1,570,1.847146000,0.0000
207.196.103.111,<->,8.52.247.130,0,0,1,1054,1,1054,1.846959000,0.0000
215.158.238.81,<->,104.3.168.128,1,1229,0,0,1,1229,1.846883000,0.0000
246.253.235.153,<->,131.36.182.198,1,1323,0,0,1,1323,1.846479000,0.0000
6.145.169.124,<->,0.195.210.44,0,0,1,170,1,170,1.846243000,0.0000
210.229.230.22,<->,101.85.203.160,1,80,0,0,1,80,1.846158000,0.0000
133.178.226.49,<->,122.159.245.156,1,296,0,0,1,296,1.846152000,0.0000
207.236.159.236,<->,136.25.188.227,0,0,1,561,1,561,1.846055000,0.0000
192.64.217.166,<->,125.60.240.2,1,112,0,0,1,112,1.846002000,0.0000
215.158.239.87,<->,29.209.59.166,1,1098,0,0,1,1098,1.845851000,0.0000
215.158.238.135,<->,149.163.129.232,1,1133,0,0,1,1133,1.845606000,0.0000
215.158.239.95,<->,142.191.46.117,1,602,0,0,1,602,1.845492000,0.0000
134.48.74.144,<->,80.41.48.154,0,0,1,95,1,95,1.845441000,0.0000
215.158.238.148,<->,30.249.194.108,1,1117,0,0,1,1117,1.845344000,0.0000
215.158.239.48,<->,195.49.157.120,1,602,0,0,1,602,1.845314000,0.0000
144.85.170.208,<->,56.189.215.197,1,424,0,0,1,424,1.845038000,0.0000
80.41.20.160,<->,53.246.158.153,1,395,0,0,1,395,1.844962000,0.0000
215.158.239.48,<->,199.32.131.218,1,270,0,0,1,270,1.844741000,0.0000
215.158.239.51,<->,199.82.248.236,1,701,0,0,1,701,1.844689000,0.0000
129.16.253.244,<->,6.74.81.99,0,0,1,1023,1,1023,1.844521000,0.0000
111.151.109.41,<->,67.174.33.171,0,0,1,100,1,100,1.844222000,0.0000
215.158.239.38,<->,215.158.127.173,1,1503,0,0,1,1503,1.843856000,0.0000
215.158.239.97,<->,207.61.95.77,1,561,0,0,1,561,1.843852000,0.0000
200.175.215.55,<->,54.37.85.196,1,129,0,0,1,129,1.843691000,0.0000
247.136.154.185,<->,27.178.95.28,1,373,0,0,1,373,1.843503000,0.0000
199.80.212.171,<->,136.25.188.45,0,0,1,305,1,305,1.843487000,0.0000
231.142.4.176,<->,136.25.188.160,0,0,1,865,1,865,1.843055000,0.0000
99.187.125.121,<->,8.20.87.33,0,0,1,663,1,663,1.843003000,0.0000
97.148.162.246,<->,50.224.76.235,0,0,1,52,1,52,1.842913000,0.0000
215.158.238.95,<->,57.116.165.189,1,1149,0,0,1,1149,1.842850000,0.0000
110.16.52.39,<->,50.224.76.235,0,0,1,381,1,381,1.842807000,0.0000
221.102.143.189,<->,80.40.42.241,0,0,1,141,1,141,1.842785000,0.0000
43.52.23.227,<->,8.252.221.221,0,0,1,1273,1,1273,1.842580000,0.0000
215.158.238.97,<->,104.3.168.214,1,1373,0,0,1,1373,1.842474000,0.0000
145.176.45.183,<->,39.15.169.212,0,0,1,371,1,371,1.841988000,0.0000
192.65.127.160,<->,8.55.211.213,1,294,0,0,1,294,1.841748000,0.0000
215.158.239.87,<->,199.20.29.43,1,781,0,0,1,781,1.841608000,0.0000
133.178.226.234,<->,56.97.186.21,1,918,0,0,1,918,1.841088000,0.0000
199.70.61.118,<->,136.25.188.208,0,0,1,273,1,273,1.840655000,0.0000
220.20.200.155,<->,198.205.121.180,1,915,0,0,1,915,1.840429000,0.0000
193.21.29.219,<->,100.95.177.186,0,0,1,112,1,112,1.840305000,0.0000
204.200.45.245,<->,136.25.188.196,0,0,1,93,1,93,1.840040000,0.0000
215.158.239.248,<->,111.151.107.200,1,100,0,0,1,100,1.839956000,0.0000
215.158.140.76,<->,89.93.82.148,1,1155,0,0,1,1155,1.839737000,0.0000
215.158.239.56,<->,196.0.225.225,1,573,0,0,1,573,1.839619000,0.0000
215.158.239.58,<->,204.0.244.86,1,573,0,0,1,573,1.839599000,0.0000
215.158.239.19,<->,33.209.218.117,1,1444,0,0,1,1444,1.839355000,0.0000
133.178.227.76,<->,131.144.116.5,1,1405,0,0,1,1405,1.839086000,0.0000
215.158.239.56,<->,142.227.62.207,1,561,0,0,1,561,1.838796000,0.0000
142.207.84.202,<->,136.25.188.176,0,0,1,602,1,602,1.838515000,0.0000
215.158.239.94,<->,120.154.71.21,1,1293,0,0,1,1293,1.838356000,0.0000
192.224.20.57,<->,136.25.188.140,0,0,1,1277,1,1277,1.837580000,0.0000
220.20.200.157,<->,132.216.159.4,1,1290,0,0,1,1290,1.837348000,0.0000
136.25.188.252,<->,84.210.24.145,1,629,0,0,1,629,1.837286000,0.0000
199.69.87.93,<->,133.178.226.28,0,0,1,1261,1,1261,1.837224000,0.0000
133.178.227.24,<->,8.190.217.102,1,1405,0,0,1,1405,1.837166000,0.0000
110.235.137.248,<->,89.183.104.227,0,0,1,123,1,123,1.837126000,0.0000
136.25.189.0,<->,96.156.169.222,1,1437,0,0,1,1437,1.837017000,0.0000
215.158.238.241,<->,131.144.116.40,1,1050,0,0,1,1050,1.836998000,0.0000
145.252.113.224,<->,120.245.216.61,1,753,0,0,1,753,1.836968000,0.0000
54.37.220.84,<->,48.52.227.200,0,0,1,110,1,110,1.836718000,0.0000
136.25.188.211,<->,8.220.51.235,1,1245,0,0,1,1245,1.835829000,0.0000
111.168.45.61,<->,8.220.200.124,0,0,1,231,1,231,1.835826000,0.0000
136.25.189.62,<->,96.156.169.199,1,381,0,0,1,381,1.835288000,0.0000
120.47.187.252,<->,80.38.40.56,0,0,1,448,1,448,1.835264000,0.0000
92.168.217.253,<->,50.136.155.152,1,536,0,0,1,536,1.835251000,0.0000
142.227.35.179,<->,136.25.188.255,0,0,1,353,1,353,1.834930000,0.0000
215.158.239.102,<->,215.158.61.145,1,658,0,0,1,658,1.834875000,0.0000
207.172.153.47,<->,136.25.188.174,0,0,1,382,1,382,1.834828000,0.0000
139.33.175.144,<->,8.228.215.157,0,0,1,980,1,980,1.834685000,0.0000
136.25.188.179,<->,113.24.0.167,1,1341,0,0,1,1341,1.834017000,0.0000
215.158.238.134,<->,142.234.196.201,1,1357,0,0,1,1357,1.833902000,0.0000
215.158.239.57,<->,204.0.139.105,1,284,0,0,1,284,1.833895000,0.0000
192.74.94.29,<->,8.182.248.147,0,0,1,263,1,263,1.833477000,0.0000
54.39.188.63,<->,48.55.170.180,0,0,1,125,1,125,1.833317000,0.0000
215.158.239.20,<->,53.231.110.86,1,749,0,0,1,749,1.833293000,0.0000
197.107.69.146,<->,8.182.141.189,0,0,1,561,1,561,1.833246000,0.0000
141.20.135.7,<->,137.21.3.80,0,0,1,81,1,81,1.833225000,0.0000
204.186.76.153,<->,136.25.188.253,0,0,1,240,1,240,1.832969000,0.0000
152.137.242.164,<->,8.252.221.221,0,0,1,364,1,364,1.832609000,0.0000
133.178.226.31,<->,27.178.41.36,1,1229,0,0,1,1229,1.832470000,0.0000
199.52.178.99,<->,136.25.188.209,0,0,1,240,1,240,1.832445000,0.0000
215.158.239.56,<->,199.20.31.124,1,573,0,0,1,573,1.832346000,0.0000
121.116.91.122,<->,8.31.37.173,0,0,1,263,1,263,1.832184000,0.0000
215.158.239.94,<->,199.82.194.185,1,378,0,0,1,378,1.832054000,0.0000
215.158.61.254,<->,99.74.27.175,0,0,1,1422,1,1422,1.832012000,0.0000
202.33.26.110,<->,136.25.188.179,0,0,1,87,1,87,1.831854000,0.0000
215.158.238.95,<->,42.226.3.103,1,1245,0,0,1,1245,1.831623000,0.0000
215.158.239.78,<->,195.49.87.166,1,101,0,0,1,101,1.831223000,0.0000
215.158.238.81,<->,192.228.30.26,1,1213,0,0,1,1213,1.831062000,0.0000
215.158.238.83,<->,8.188.227.0,1,1197,0,0,1,1197,1.831062000,0.0000
198.151.9.125,<->,111.147.93.202,0,0,1,166,1,166,1.830777000,0.0000
194.136.215.179,<->,80.42.171.60,0,0,1,64,1,64,1.830377000,0.0000
215.158.239.42,<->,80.47.228.231,1,1497,0,0,1,1497,1.830297000,0.0000
127.202.220.209,<->,50.224.76.235,0,0,1,811,1,811,1.829923000,0.0000
215.158.239.50,<->,199.20.5.119,1,860,0,0,1,860,1.829829000,0.0000
108.39.30.89,<->,50.224.76.235,0,0,1,274,1,274,1.829810000,0.0000
92.27.219.145,<->,33.57.78.124,1,50,0,0,1,50,1.829056000,0.0000
215.158.3.183,<->,8.176.8.47,0,0,1,1325,1,1325,1.828891000,0.0000
136.25.189.83,<->,29.211.228.215,1,1213,0,0,1,1213,1.828722000,0.0000
213.186.52.88,<->,144.85.170.254,0,0,1,760,1,760,1.828154000,0.0000
157.127.180.7,<->,8.252.222.23,0,0,1,270,1,270,1.828110000,0.0000
215.158.140.75,<->,126.219.194.5,1,1091,0,0,1,1091,1.827841000,0.0000
221.102.126.240,<->,139.254.211.64,1,87,0,0,1,87,1.826968000,0.0000
204.200.34.121,<->,8.252.222.210,0,0,1,555,1,555,1.826859000,0.0000
133.178.227.79,<->,29.212.182.234,1,1056,0,0,1,1056,1.826496000,0.0000
231.142.6.144,<->,215.158.239.87,0,0,1,602,1,602,1.826453000,0.0000
215.158.239.87,<->,159.23.130.181,1,1213,0,0,1,1213,1.826239000,0.0000
215.158.239.92,<->,207.114.92.54,1,602,0,0,1,602,1.826146000,0.0000
195.15.237.131,<->,136.25.188.55,0,0,1,284,1,284,1.825252000,0.0000
215.202.174.52,<->,215.158.239.85,0,0,1,1133,1,1133,1.824740000,0.0000
215.158.238.221,<->,158.85.50.137,1,1181,0,0,1,1181,1.824644000,0.0000
195.4.96.223,<->,136.25.188.177,0,0,1,506,1,506,1.823861000,0.0000
157.31.243.22,<->,80.27.153.44,0,0,1,304,1,304,1.823585000,0.0000
139.160.226.221,<->,136.25.189.89,0,0,1,1245,1,1245,1.823458000,0.0000
215.158.239.49,<->,29.211.5.118,1,293,0,0,1,293,1.823448000,0.0000
247.136.223.190,<->,54.35.247.52,1,287,0,0,1,287,1.823362000,0.0000
127.106.219.2,<->,0.195.210.46,0,0,1,317,1,317,1.823356000,0.0000
215.158.239.79,<->,195.15.186.168,1,240,0,0,1,240,1.823156000,0.0000
139.193.141.139,<->,131.24.162.38,1,767,0,0,1,767,1.823085000,0.0000
215.158.61.183,<->,136.25.188.30,0,0,1,429,1,429,1.822986000,0.0000
215.158.239.87,<->,128.23.84.21,1,1213,0,0,1,1213,1.822952000,0.0000
215.158.239.56,<->,195.54.94.62,1,168,0,0,1,168,1.822839000,0.0000
136.25.189.1,<->,29.211.93.15,1,265,0,0,1,265,1.822744000,0.0000
207.72.115.190,<->,8.252.222.187,0,0,1,117,1,117,1.822571000,0.0000
215.158.239.92,<->,142.252.236.149,1,602,0,0,1,602,1.822425000,0.0000
139.188.57.145,<->,132.168.197.168,0,0,1,655,1,655,1.822375000,0.0000
220.38.84.229,<->,133.178.226.30,0,0,1,1181,1,1181,1.822081000,0.0000
199.70.61.118,<->,136.25.188.177,0,0,1,273,1,273,1.822073000,0.0000
144.232.215.251,<->,8.252.221.171,0,0,1,520,1,520,1.821938000,0.0000
246.253.253.99,<->,139.33.175.151,1,1097,0,0,1,1097,1.821846000,0.0000
215.158.140.60,<->,158.85.50.93,1,1049,0,0,1,1049,1.821685000,0.0000
215.158.239.32,<->,80.47.228.196,1,1449,0,0,1,1449,1.821577000,0.0000
146.14.154.200,<->,133.178.226.61,0,0,1,1197,1,1197,1.821565000,0.0000
136.25.189.14,<->,131.144.115.230,1,1357,0,0,1,1357,1.821515000,0.0000
140.71.206.77,<->,8.252.221.230,0,0,1,456,1,456,1.821503000,0.0000
215.158.239.50,<->,199.20.30.169,1,781,0,0,1,781,1.821377000,0.0000
197.113.99.163,<->,136.25.188.225,0,0,1,602,1,602,1.821213000,0.0000
195.71.62.222,<->,136.25.188.175,0,0,1,269,1,269,1.821080000,0.0000
197.113.64.255,<->,136.25.188.163,0,0,1,93,1,93,1.821060000,0.0000
199.82.241.83,<->,136.25.188.178,0,0,1,561,1,561,1.821053000,0.0000
143.132.153.33,<->,136.25.188.174,0,0,1,93,1,93,1.820433000,0.0000
215.158.239.71,<->,29.123.209.228,1,1341,0,0,1,1341,1.819741000,0.0000
58.48.140.98,<->,8.252.221.230,0,0,1,454,1,454,1.819512000,0.0000
148.188.34.166,<->,50.224.89.237,0,0,1,79,1,79,1.819190000,0.0000
215.158.239.70,<->,199.122.12.182,1,561,0,0,1,561,1.818836000,0.0000
215.158.238.188,<->,197.133.131.184,1,1106,0,0,1,1106,1.818610000,0.0000
215.158.238.218,<->,215.158.132.227,1,611,0,0,1,611,1.818276000,0.0000
195.12.100.132,<->,136.25.188.196,0,0,1,273,1,273,1.818099000,0.0000
215.158.238.140,<->,38.104.11.54,1,1309,0,0,1,1309,1.817920000,0.0000
136.25.188.197,<->,8.253.128.36,1,1341,0,0,1,1341,1.817173000,0.0000
198.156.25.132,<->,192.64.209.42,0,0,1,57,1,57,1.816968000,0.0000
144.108.64.184,<->,136.129.100.124,0,0,1,289,1,289,1.816861000,0.0000
207.163.164.201,<->,50.224.76.234,0,0,1,738,1,738,1.816731000,0.0000
145.208.190.226,<->,132.222.219.171,1,345,0,0,1,345,1.816711000,0.0000
193.21.29.218,<->,99.75.112.7,0,0,1,57,1,57,1.816147000,0.0000
138.121.99.24,<->,8.220.239.30,0,0,1,536,1,536,1.815896000,0.0000
98.248.253.162,<->,50.224.76.234,0,0,1,1003,1,1003,1.815747000,0.0000
215.158.238.122,<->,122.158.49.180,1,1133,0,0,1,1133,1.815731000,0.0000
136.25.188.45,<->,8.179.43.59,1,1309,0,0,1,1309,1.815290000,0.0000
89.183.104.231,<->,33.57.74.172,1,50,0,0,1,50,1.815274000,0.0000
215.158.239.68,<->,195.13.213.160,1,765,0,0,1,765,1.815139000,0.0000
215.158.238.132,<->,122.159.68.201,1,1133,0,0,1,1133,1.815116000,0.0000
204.58.181.98,<->,136.25.188.173,0,0,1,602,1,602,1.815011000,0.0000
215.158.239.95,<->,196.93.134.85,1,769,0,0,1,769,1.815007000,0.0000
194.237.25.123,<->,136.25.188.176,0,0,1,101,1,101,1.814931000,0.0000
195.70.50.11,<->,136.25.188.176,0,0,1,113,1,113,1.814898000,0.0000
136.25.189.82,<->,29.212.180.213,1,1245,0,0,1,1245,1.814853000,0.0000
54.38.7.135,<->,48.54.50.60,0,0,1,201,1,201,1.814724000,0.0000
136.25.188.53,<->,84.28.215.132,1,240,0,0,1,240,1.813541000,0.0000
215.158.239.87,<->,142.252.236.149,1,602,0,0,1,602,1.813524000,0.0000
204.3.128.102,<->,136.25.188.222,0,0,1,824,1,824,1.813424000,0.0000
139.193.141.139,<->,114.182.12.254,1,465,0,0,1,465,1.813190000,0.0000
192.74.94.26,<->,8.182.245.240,0,0,1,496,1,496,1.812981000,0.0000
215.158.238.143,<->,126.219.194.122,1,1213,0,0,1,1213,1.812844000,0.0000
215.158.238.96,<->,56.102.22.3,1,1149,0,0,1,1149,1.812828000,0.0000
198.249.85.113,<->,133.178.227.105,0,0,1,61,1,61,1.812685000,0.0000
215.158.238.74,<->,91.57.162.185,1,1341,0,0,1,1341,1.812167000,0.0000
246.254.97.229,<->,93.181.148.199,1,137,0,0,1,137,1.811884000,0.0000
17.96.223.98,<->,8.220.191.251,0,0,1,834,1,834,1.811799000,0.0000
215.158.239.95,<->,199.20.31.56,1,781,0,0,1,781,1.811774000,0.0000
6.145.171.84,<->,0.195.210.8,0,0,1,1053,1,1053,1.811396000,0.0000
133.178.226.98,<->,8.191.15.144,1,86,0,0,1,86,1.811271000,0.0000
136.25.189.18,<->,29.209.59.187,1,1148,0,0,1,1148,1.810953000,0.0000
127.205.189.77,<->,80.42.176.32,0,0,1,60,1,60,1.810856000,0.0000
231.140.2.204,<->,136.25.188.211,0,0,1,602,1,602,1.810811000,0.0000
136.25.189.52,<->,98.219.126.175,1,70,0,0,1,70,1.810516000,0.0000
207.239.59.243,<->,136.25.188.209,0,0,1,602,1,602,1.810510000,0.0000
215.158.140.167,<->,8.222.7.186,1,1095,0,0,1,1095,1.810352000,0.0000
111.147.251.182,<->,60.82.95.221,1,136,0,0,1,136,1.810199000,0.0000
215.158.239.95,<->,196.105.5.204,1,404,0,0,1,404,1.809108000,0.0000
133.178.227.59,<->,133.56.180.11,1,476,0,0,1,476,1.808828000,0.0000
80.42.166.61,<->,8.179.135.180,1,75,0,0,1,75,1.808028000,0.0000
215.158.239.56,<->,195.80.102.27,1,632,0,0,1,632,1.807968000,0.0000
220.28.73.211,<->,136.25.189.86,0,0,1,1297,1,1297,1.807966000,0.0000
54.37.93.17,<->,48.53.7.249,0,0,1,50,1,50,1.807711000,0.0000
89.183.104.231,<->,33.57.77.135,1,50,0,0,1,50,1.807559000,0.0000
142.190.228.22,<->,136.25.188.252,0,0,1,269,1,269,1.807510000,0.0000
192.64.193.89,<->,122.120.143.25,1,164,0,0,1,164,1.807365000,0.0000
140.218.109.105,<->,136.25.189.82,0,0,1,1357,1,1357,1.807122000,0.0000
215.158.239.86,<->,204.3.134.243,1,602,0,0,1,602,1.806781000,0.0000
92.27.219.182,<->,88.12.99.63,1,1396,0,0,1,1396,1.806683000,0.0000
129.26.254.44,<->,98.117.53.73,1,253,0,0,1,253,1.806624000,0.0000
142.228.18.30,<->,136.25.188.52,0,0,1,260,1,260,1.806573000,0.0000
133.178.227.14,<->,57.160.181.188,1,1120,0,0,1,1120,1.806073000,0.0000
119.159.22.233,<->,92.162.253.39,0,0,1,326,1,326,1.805353000,0.0000
136.25.189.34,<->,118.20.100.144,1,1197,0,0,1,1197,1.805253000,0.0000
143.155.227.33,<->,136.25.188.210,0,0,1,296,1,296,1.805083000,0.0000
220.20.200.60,<->,144.83.60.153,1,628,0,0,1,628,1.804253000,0.0000
136.25.189.82,<->,119.196.23.8,1,1469,0,0,1,1469,1.803934000,0.0000
246.253.253.99,<->,206.243.231.162,1,1029,0,0,1,1029,1.803784000,0.0000
220.50.253.93,<->,144.93.132.149,0,0,1,68,1,68,1.803745000,0.0000
215.158.238.141,<->,8.191.6.217,1,1085,0,0,1,1085,1.803628000,0.0000
215.158.239.49,<->,195.83.140.200,1,573,0,0,1,573,1.803259000,0.0000
207.236.131.57,<->,136.25.188.199,0,0,1,593,1,593,1.803110000,0.0000
133.8.10.153,<->,33.233.141.231,0,0,1,153,1,153,1.803003000,0.0000
252.152.59.8,<->,215.158.239.17,0,0,1,265,1,265,1.802980000,0.0000
199.68.20.34,<->,136.25.188.238,0,0,1,725,1,725,1.802891000,0.0000
143.38.87.41,<->,99.74.87.231,0,0,1,1501,1,1501,1.802775000,0.0000
192.65.88.12,<->,132.18.67.30,1,338,0,0,1,338,1.802616000,0.0000
133.178.226.30,<->,89.80.251.7,1,1181,0,0,1,1181,1.802576000,0.0000
215.158.140.241,<->,141.23.229.214,1,1232,0,0,1,1232,1.802554000,0.0000
133.178.227.27,<->,42.189.53.47,1,1421,0,0,1,1421,1.802543000,0.0000
195.88.189.40,<->,8.182.241.177,0,0,1,482,1,482,1.802486000,0.0000
220.55.72.171,<->,92.162.218.10,1,1276,0,0,1,1276,1.802473000,0.0000
220.28.85.14,<->,136.25.188.234,0,0,1,470,1,470,1.802447000,0.0000
215.158.238.6,<->,192.229.42.164,1,1017,0,0,1,1017,1.802413000,0.0000
142.206.165.175,<->,136.25.188.252,0,0,1,561,1,561,1.802324000,0.0000
215.158.238.133,<->,112.220.206.127,1,1165,0,0,1,1165,1.802066000,0.0000
215.158.238.115,<->,114.25.48.61,1,1229,0,0,1,1229,1.801830000,0.0000
133.178.227.242,<->,126.219.136.164,1,1277,0,0,1,1277,1.801758000,0.0000
215.158.238.82,<->,38.104.11.107,1,1133,0,0,1,1133,1.801458000,0.0000
215.158.238.92,<->,197.5.160.203,1,1213,0,0,1,1213,1.801302000,0.0000
215.158.61.209,<->,97.126.31.75,0,0,1,327,1,327,1.800956000,0.0000
143.177.241.68,<->,8.182.241.177,0,0,1,547,1,547,1.800781000,0.0000
215.158.238.45,<->,38.104.11.105,1,973,0,0,1,973,1.800742000,0.0000
93.181.154.87,<->,89.183.104.231,0,0,1,50,1,50,1.800323000,0.0000
143.95.22.76,<->,136.25.188.222,0,0,1,93,1,93,1.800235000,0.0000
215.158.238.106,<->,149.96.60.153,1,1117,0,0,1,1117,1.800196000,0.0000
215.158.239.69,<->,29.212.180.235,1,1053,0,0,1,1053,1.800031000,0.0000
215.158.239.7,<->,33.209.218.97,1,1393,0,0,1,1393,1.800030000,0.0000
100.50.96.246,<->,8.252.223.141,0,0,1,1405,1,1405,1.799898000,0.0000
215.158.238.45,<->,205.122.195.39,1,1069,0,0,1,1069,1.799831000,0.0000
215.158.238.188,<->,84.203.220.174,1,1043,0,0,1,1043,1.799814000,0.0000
136.25.188.53,<->,69.31.238.53,1,1277,0,0,1,1277,1.799719000,0.0000
143.135.73.220,<->,136.25.188.252,0,0,1,561,1,561,1.799294000,0.0000
133.178.226.29,<->,61.35.124.188,1,1181,0,0,1,1181,1.799293000,0.0000
215.158.239.79,<->,196.1.179.99,1,903,0,0,1,903,1.799174000,0.0000
133.178.226.8,<->,0.195.253.228,1,1357,0,0,1,1357,1.798569000,0.0000
199.83.86.181,<->,136.25.188.175,0,0,1,632,1,632,1.798511000,0.0000
133.178.226.28,<->,124.72.94.156,1,1245,0,0,1,1245,1.798407000,0.0000
111.147.87.240,<->,53.245.70.29,1,705,0,0,1,705,1.798404000,0.0000
142.249.101.48,<->,136.25.188.53,0,0,1,602,1,602,1.798185000,0.0000
139.193.141.209,<->,105.132.14.228,1,534,0,0,1,534,1.798170000,0.0000
199.81.38.70,<->,136.25.188.253,0,0,1,262,1,262,1.798119000,0.0000
215.158.238.209,<->,120.154.179.64,1,1373,0,0,1,1373,1.798027000,0.0000
112.7.105.198,<->,50.224.89.243,0,0,1,960,1,960,1.797836000,0.0000
129.225.134.223,<->,129.225.132.71,0,0,1,444,1,444,1.797765000,0.0000
136.25.188.223,<->,8.42.43.48,1,1341,0,0,1,1341,1.797227000,0.0000
8.183.25.25,<->,6.20.45.74,1,250,0,0,1,250,1.797147000,0.0000
201.192.40.105,<->,139.163.96.94,0,0,1,50,1,50,1.796978000,0.0000
207.190.192.89,<->,136.25.188.236,0,0,1,621,1,621,1.796886000,0.0000
207.1.114.63,<->,92.27.194.147,0,0,1,357,1,357,1.796544000,0.0000
215.158.239.58,<->,199.20.4.249,1,701,0,0,1,701,1.796266000,0.0000
195.41.130.180,<->,136.25.188.163,0,0,1,701,1,701,1.795950000,0.0000
235.42.35.52,<->,215.158.140.76,0,0,1,1240,1,1240,1.795885000,0.0000
220.39.202.215,<->,215.158.238.141,0,0,1,1277,1,1277,1.795746000,0.0000
133.178.226.83,<->,96.155.60.247,1,148,0,0,1,148,1.795718000,0.0000
136.25.189.202,<->,129.222.39.98,1,865,0,0,1,865,1.795526000,0.0000
221.102.56.69,<->,109.2.24.130,0,0,1,294,1,294,1.795495000,0.0000
215.158.238.92,<->,143.227.108.23,1,1277,0,0,1,1277,1.795490000,0.0000
136.25.189.80,<->,120.154.225.197,1,1357,0,0,1,1357,1.795143000,0.0000
204.187.170.223,<->,136.25.188.252,0,0,1,168,1,168,1.794556000,0.0000
144.85.170.245,<->,6.242.52.30,1,607,0,0,1,607,1.794489000,0.0000
215.158.239.56,<->,199.20.31.134,1,240,0,0,1,240,1.794420000,0.0000
89.90.104.87,<->,6.122.148.113,0,0,1,386,1,386,1.794394000,0.0000
215.158.239.182,<->,149.254.204.166,1,285,0,0,1,285,1.794148000,0.0000
195.54.103.119,<->,136.25.188.220,0,0,1,602,1,602,1.793930000,0.0000
196.89.241.99,<->,136.25.188.241,0,0,1,683,1,683,1.793747000,0.0000
215.158.61.145,<->,8.176.8.248,0,0,1,285,1,285,1.793658000,0.0000
111.150.207.239,<->,8.252.222.182,0,0,1,100,1,100,1.793587000,0.0000
249.101.218.52,<->,132.18.67.27,1,1439,0,0,1,1439,1.793427000,0.0000
215.158.239.87,<->,199.20.31.201,1,602,0,0,1,602,1.792971000,0.0000
246.254.97.113,<->,53.160.140.123,1,653,0,0,1,653,1.792873000,0.0000
80.56.83.69,<->,8.252.223.137,0,0,1,100,1,100,1.792803000,0.0000
215.158.238.177,<->,38.20.151.94,1,1039,0,0,1,1039,1.792660000,0.0000
215.158.238.95,<->,193.39.70.28,1,1197,0,0,1,1197,1.792579000,0.0000
136.25.189.34,<->,96.156.169.170,1,1501,0,0,1,1501,1.792119000,0.0000
215.158.239.56,<->,196.93.220.8,1,240,0,0,1,240,1.791769000,0.0000
215.158.140.253,<->,145.48.251.0,1,1046,0,0,1,1046,1.791762000,0.0000
133.178.227.24,<->,33.209.219.58,1,1437,0,0,1,1437,1.791729000,0.0000
138.98.214.132,<->,38.88.109.17,1,503,0,0,1,503,1.791519000,0.0000
133.178.226.78,<->,113.23.104.221,1,264,0,0,1,264,1.791490000,0.0000
215.158.238.105,<->,148.26.113.8,1,1197,0,0,1,1197,1.790972000,0.0000
215.158.238.65,<->,91.57.173.52,1,1389,0,0,1,1389,1.790966000,0.0000
136.25.189.17,<->,33.223.64.245,1,1165,0,0,1,1165,1.790373000,0.0000
215.158.238.92,<->,140.145.218.202,1,85,0,0,1,85,1.790120000,0.0000
215.158.238.106,<->,29.211.186.213,1,1341,0,0,1,1341,1.789944000,0.0000
215.158.238.149,<->,106.188.183.74,1,246,0,0,1,246,1.789583000,0.0000
204.60.99.48,<->,136.25.188.163,0,0,1,378,1,378,1.789545000,0.0000
224.250.64.90,<->,99.72.84.79,0,0,1,50,1,50,1.789314000,0.0000
215.158.238.246,<->,215.158.43.0,1,325,0,0,1,325,1.789252000,0.0000
215.158.238.95,<->,158.85.46.218,1,1229,0,0,1,1229,1.788765000,0.0000
221.102.56.69,<->,192.65.205.59,0,0,1,294,1,294,1.788648000,0.0000
144.83.60.153,<->,92.162.252.74,0,0,1,626,1,626,1.788597000,0.0000
215.158.239.32,<->,149.96.53.43,1,1395,0,0,1,1395,1.788578000,0.0000
133.178.226.57,<->,0.195.237.14,1,609,0,0,1,609,1.788567000,0.0000
136.25.188.253,<->,126.219.196.166,1,1069,0,0,1,1069,1.787881000,0.0000
136.25.188.253,<->,76.100.108.223,1,1309,0,0,1,1309,1.787811000,0.0000
133.178.227.254,<->,113.23.56.44,1,274,0,0,1,274,1.787440000,0.0000
215.158.239.245,<->,111.150.207.167,1,100,0,0,1,100,1.787320000,0.0000
53.167.135.197,<->,48.52.213.160,0,0,1,1277,1,1277,1.787019000,0.0000
136.25.188.224,<->,57.4.201.97,1,1197,0,0,1,1197,1.786851000,0.0000
143.23.127.118,<->,136.25.188.175,0,0,1,602,1,602,1.786815000,0.0000
199.15.202.72,<->,136.25.188.198,0,0,1,269,1,269,1.786697000,0.0000
215.158.238.32,<->,96.135.154.197,1,1037,0,0,1,1037,1.786574000,0.0000
132.128.61.174,<->,97.126.39.212,0,0,1,514,1,514,1.786448000,0.0000
138.79.139.178,<->,109.113.104.225,0,0,1,673,1,673,1.785874000,0.0000
136.138.112.208,<->,136.25.188.176,0,0,1,1341,1,1341,1.785777000,0.0000
215.158.140.11,<->,53.231.141.31,1,97,0,0,1,97,1.785678000,0.0000
136.25.189.14,<->,57.31.51.169,1,1309,0,0,1,1309,1.785396000,0.0000
143.135.48.53,<->,136.25.188.252,0,0,1,602,1,602,1.785283000,0.0000
143.132.153.33,<->,136.25.188.46,0,0,1,93,1,93,1.785020000,0.0000
215.158.239.95,<->,199.20.6.26,1,93,0,0,1,93,1.784910000,0.0000
53.214.235.47,<->,48.55.161.113,0,0,1,648,1,648,1.784648000,0.0000
215.158.61.182,<->,8.176.8.105,0,0,1,93,1,93,1.784002000,0.0000
215.158.239.93,<->,207.236.4.43,1,765,0,0,1,765,1.783975000,0.0000
215.158.239.87,<->,199.82.184.226,1,269,0,0,1,269,1.783203000,0.0000
142.254.47.85,<->,136.25.188.255,0,0,1,561,1,561,1.782937000,0.0000
207.175.169.16,<->,136.25.188.45,0,0,1,250,1,250,1.782232000,0.0000
220.28.73.211,<->,215.158.238.200,0,0,1,894,1,894,1.782215000,0.0000
215.158.140.231,<->,33.209.213.54,1,1055,0,0,1,1055,1.782166000,0.0000
215.158.239.84,<->,6.73.23.162,1,1213,0,0,1,1213,1.782156000,0.0000
142.208.121.211,<->,136.25.188.177,0,0,1,144,1,144,1.782145000,0.0000
215.158.140.76,<->,61.35.124.180,1,1050,0,0,1,1050,1.781665000,0.0000
143.227.65.147,<->,136.25.188.226,0,0,1,1213,1,1213,1.781642000,0.0000
144.88.76.40,<->,53.148.9.226,1,125,0,0,1,125,1.781634000,0.0000
215.158.239.93,<->,106.7.35.117,1,1245,0,0,1,1245,1.781485000,0.0000
159.112.9.198,<->,101.124.238.98,0,0,1,81,1,81,1.781196000,0.0000
227.23.167.28,<->,92.27.194.249,0,0,1,355,1,355,1.781041000,0.0000
224.54.170.218,<->,215.158.239.70,0,0,1,1357,1,1357,1.780957000,0.0000
204.187.121.47,<->,136.25.188.177,0,0,1,190,1,190,1.780750000,0.0000
143.14.0.13,<->,50.224.76.230,0,0,1,161,1,161,1.780601000,0.0000
215.158.238.40,<->,100.216.78.145,1,966,0,0,1,966,1.780285000,0.0000
136.25.189.1,<->,104.154.137.3,1,1229,0,0,1,1229,1.780102000,0.0000
215.158.239.50,<->,148.56.229.107,1,1213,0,0,1,1213,1.779938000,0.0000
215.158.239.57,<->,195.54.57.126,1,172,0,0,1,172,1.779839000,0.0000
215.158.238.105,<->,198.226.166.143,1,1261,0,0,1,1261,1.779760000,0.0000
215.158.239.8,<->,91.237.50.181,1,365,0,0,1,365,1.779724000,0.0000
145.242.124.39,<->,99.72.60.194,0,0,1,97,1,97,1.779664000,0.0000
215.158.239.50,<->,114.146.74.241,1,1341,0,0,1,1341,1.779502000,0.0000
207.77.199.147,<->,136.25.188.210,0,0,1,132,1,132,1.778797000,0.0000
97.85.137.195,<->,8.52.187.74,0,0,1,269,1,269,1.778555000,0.0000
143.68.134.50,<->,136.25.188.55,0,0,1,282,1,282,1.778457000,0.0000
192.229.216.117,<->,121.252.120.61,1,476,0,0,1,476,1.778233000,0.0000
84.203.220.187,<->,8.252.222.220,0,0,1,1277,1,1277,1.778051000,0.0000
215.158.238.45,<->,149.96.50.215,1,1437,0,0,1,1437,1.777821000,0.0000
215.158.238.82,<->,104.3.169.46,1,1245,0,0,1,1245,1.777552000,0.0000
204.200.169.232,<->,136.25.188.46,0,0,1,630,1,630,1.776941000,0.0000
215.158.238.196,<->,29.211.6.169,1,1106,0,0,1,1106,1.776780000,0.0000
215.158.238.73,<->,8.223.224.32,1,1341,0,0,1,1341,1.776198000,0.0000
215.158.239.6,<->,8.222.97.9,1,1287,0,0,1,1287,1.775598000,0.0000
246.45.209.210,<->,202.178.8.198,1,244,0,0,1,244,1.775314000,0.0000
215.158.239.48,<->,142.236.234.16,1,309,0,0,1,309,1.775037000,0.0000
133.178.227.2,<->,8.219.184.156,1,1149,0,0,1,1149,1.774748000,0.0000
192.227.190.231,<->,136.25.188.221,0,0,1,1373,1,1373,1.774078000,0.0000
215.158.238.216,<->,215.158.43.17,1,274,0,0,1,274,1.773956000,0.0000
136.25.189.59,<->,96.156.169.221,1,1380,0,0,1,1380,1.773863000,0.0000
133.85.181.248,<->,100.92.37.100,0,0,1,404,1,404,1.773462000,0.0000
215.158.239.70,<->,196.90.44.141,1,378,0,0,1,378,1.773431000,0.0000
133.178.226.247,<->,96.155.60.168,1,637,0,0,1,637,1.773395000,0.0000
206.241.10.193,<->,99.167.142.84,0,0,1,253,1,253,1.773179000,0.0000
100.224.209.9,<->,93.78.111.95,1,74,0,0,1,74,1.773172000,0.0000
221.102.143.189,<->,80.41.100.42,0,0,1,141,1,141,1.773139000,0.0000
196.247.156.146,<->,136.25.188.255,0,0,1,378,1,378,1.772812000,0.0000
243.123.125.57,<->,92.162.253.10,0,0,1,1055,1,1055,1.772746000,0.0000
215.158.140.76,<->,192.204.170.251,1,1130,0,0,1,1130,1.772588000,0.0000
198.73.22.146,<->,0.195.210.42,0,0,1,550,1,550,1.772546000,0.0000
142.248.88.198,<->,136.25.188.253,0,0,1,279,1,279,1.772495000,0.0000
133.178.227.39,<->,133.56.180.43,1,506,0,0,1,506,1.772457000,0.0000
215.158.239.50,<->,199.39.188.6,1,93,0,0,1,93,1.772379000,0.0000
195.7.64.30,<->,136.25.188.208,0,0,1,561,1,561,1.772347000,0.0000
215.158.239.86,<->,196.94.180.143,1,93,0,0,1,93,1.772314000,0.0000
215.158.238.67,<->,32.183.36.250,1,1357,0,0,1,1357,1.772233000,0.0000
133.178.227.24,<->,69.150.168.233,1,1421,0,0,1,1421,1.770971000,0.0000
215.158.238.65,<->,158.85.46.247,1,1229,0,0,1,1229,1.770250000,0.0000
146.173.129.74,<->,133.178.226.18,0,0,1,1277,1,1277,1.770045000,0.0000
50.224.76.248,<->,8.35.106.90,1,464,0,0,1,464,1.770016000,0.0000
133.178.226.60,<->,8.219.186.172,1,1053,0,0,1,1053,1.769837000,0.0000
204.63.248.181,<->,136.25.188.222,0,0,1,240,1,240,1.769553000,0.0000
145.16.3.71,<->,114.82.238.234,1,225,0,0,1,225,1.769304000,0.0000
111.199.225.5,<->,0.195.210.44,0,0,1,170,1,170,1.768931000,0.0000
215.158.239.96,<->,195.81.105.245,1,573,0,0,1,573,1.768817000,0.0000
215.158.238.141,<->,112.220.206.24,1,93,0,0,1,93,1.768747000,0.0000
207.173.38.16,<->,136.25.188.196,0,0,1,602,1,602,1.768457000,0.0000
97.126.113.29,<->,53.209.187.97,1,1358,0,0,1,1358,1.768426000,0.0000
207.232.233.27,<->,50.223.3.228,0,0,1,291,1,291,1.768142000,0.0000
215.158.238.95,<->,197.103.151.85,1,1261,0,0,1,1261,1.767949000,0.0000
215.158.239.33,<->,8.219.187.246,1,1027,0,0,1,1027,1.767947000,0.0000
145.252.114.15,<->,109.31.72.114,1,488,0,0,1,488,1.767689000,0.0000
215.158.239.35,<->,80.47.111.144,1,1294,0,0,1,1294,1.767683000,0.0000
221.102.143.189,<->,80.41.94.184,0,0,1,141,1,141,1.767327000,0.0000
215.158.238.82,<->,106.188.183.90,1,151,0,0,1,151,1.766752000,0.0000
233.145.98.134,<->,56.121.53.35,0,0,1,564,1,564,1.766470000,0.0000
215.158.238.95,<->,192.205.37.205,1,1114,0,0,1,1114,1.766433000,0.0000
115.233.228.114,<->,50.224.89.243,0,0,1,1046,1,1046,1.766431000,0.0000
215.158.238.96,<->,33.97.221.154,1,1165,0,0,1,1165,1.766359000,0.0000
231.143.10.237,<->,136.25.188.209,0,0,1,701,1,701,1.766079000,0.0000
247.136.144.152,<->,158.19.152.110,1,578,0,0,1,578,1.766015000,0.0000
133.178.226.227,<->,29.214.216.96,1,94,0,0,1,94,1.765814000,0.0000
215.158.239.95,<->,199.53.110.186,1,801,0,0,1,801,1.765751000,0.0000
220.28.65.9,<->,215.158.238.217,0,0,1,929,1,929,1.765717000,0.0000
215.158.238.190,<->,8.222.58.181,1,1150,0,0,1,1150,1.765662000,0.0000
195.40.162.216,<->,136.25.188.172,0,0,1,765,1,765,1.765543000,0.0000
54.39.10.127,<->,48.53.239.203,0,0,1,86,1,86,1.765529000,0.0000
145.116.118.123,<->,53.196.35.112,1,790,0,0,1,790,1.765243000,0.0000
215.158.239.35,<->,120.155.14.152,1,1204,0,0,1,1204,1.765041000,0.0000
133.178.227.172,<->,111.151.109.25,1,100,0,0,1,100,1.764857000,0.0000
159.137.231.128,<->,134.151.121.211,1,792,0,0,1,792,1.764824000,0.0000
53.201.200.21,<->,48.54.157.178,0,0,1,93,1,93,1.764653000,0.0000
215.158.140.185,<->,8.222.7.154,1,239,0,0,1,239,1.764237000,0.0000
109.222.200.155,<->,53.189.46.201,1,87,0,0,1,87,1.764027000,0.0000
215.158.238.32,<->,192.105.122.233,1,1085,0,0,1,1085,1.763861000,0.0000
111.151.107.180,<->,8.176.8.224,0,0,1,100,1,100,1.763844000,0.0000
215.158.239.70,<->,119.196.23.8,1,1389,0,0,1,1389,1.763816000,0.0000
129.236.115.161,<->,111.20.168.123,0,0,1,1262,1,1262,1.763649000,0.0000
120.21.175.67,<->,92.27.219.236,0,0,1,162,1,162,1.763532000,0.0000
133.178.227.2,<->,80.57.141.96,1,1391,0,0,1,1391,1.763506000,0.0000
133.178.226.28,<->,57.41.134.87,1,1213,0,0,1,1213,1.763480000,0.0000
133.178.227.41,<->,48.129.132.251,1,1213,0,0,1,1213,1.763473000,0.0000
145.79.71.96,<->,8.220.200.124,0,0,1,726,1,726,1.763397000,0.0000
215.158.239.49,<->,196.89.235.166,1,561,0,0,1,561,1.763108000,0.0000
215.158.239.95,<->,199.20.28.172,1,250,0,0,1,250,1.762726000,0.0000
215.158.238.99,<->,8.191.0.72,1,1341,0,0,1,1341,1.762377000,0.0000
215.158.61.145,<->,8.176.8.226,0,0,1,1405,1,1405,1.762291000,0.0000
207.58.88.154,<->,136.25.188.253,0,0,1,790,1,790,1.762181000,0.0000
215.158.61.145,<->,8.176.8.228,0,0,1,509,1,509,1.762122000,0.0000
208.122.230.62,<->,89.64.133.48,1,548,0,0,1,548,1.762066000,0.0000
136.25.189.17,<->,89.80.251.9,1,1293,0,0,1,1293,1.762035000,0.0000
109.222.205.21,<->,53.189.46.201,1,75,0,0,1,75,1.761898000,0.0000
195.127.213.157,<->,136.25.188.239,0,0,1,93,1,93,1.761569000,0.0000
142.209.132.200,<->,136.25.188.220,0,0,1,994,1,994,1.761516000,0.0000
215.158.239.248,<->,129.175.139.137,1,334,0,0,1,334,1.761400000,0.0000
138.98.203.225,<->,38.143.105.155,1,415,0,0,1,415,1.761209000,0.0000
221.102.56.69,<->,218.4.184.243,0,0,1,294,1,294,1.760849000,0.0000
215.158.61.183,<->,8.176.8.93,0,0,1,93,1,93,1.760775000,0.0000
129.209.93.101,<->,8.182.226.78,0,0,1,556,1,556,1.760664000,0.0000
215.158.238.190,<->,201.136.143.27,1,1421,0,0,1,1421,1.760421000,0.0000
136.25.188.196,<->,8.42.43.48,1,1325,0,0,1,1325,1.760331000,0.0000
101.70.121.237,<->,53.180.231.130,1,76,0,0,1,76,1.760244000,0.0000
243.123.125.57,<->,92.162.253.23,0,0,1,1035,1,1035,1.759982000,0.0000
143.128.131.105,<->,136.25.188.178,0,0,1,669,1,669,1.759797000,0.0000
196.89.25.19,<->,136.25.188.255,0,0,1,273,1,273,1.759634000,0.0000
215.158.239.49,<->,159.23.130.181,1,1277,0,0,1,1277,1.759428000,0.0000
215.158.239.56,<->,199.82.184.226,1,269,0,0,1,269,1.759348000,0.0000
144.87.235.222,<->,139.241.58.74,1,339,0,0,1,339,1.758821000,0.0000
207.162.190.8,<->,8.182.227.35,0,0,1,502,1,502,1.758737000,0.0000
138.98.203.225,<->,114.94.62.173,1,516,0,0,1,516,1.758667000,0.0000
199.69.74.63,<->,136.25.188.209,0,0,1,602,1,602,1.758027000,0.0000
199.68.189.178,<->,136.25.188.163,0,0,1,602,1,602,1.757940000,0.0000
215.158.239.93,<->,196.90.181.186,1,272,0,0,1,272,1.757928000,0.0000
129.224.112.252,<->,97.242.126.184,1,102,0,0,1,102,1.757904000,0.0000
111.20.171.168,<->,101.224.89.161,0,0,1,1197,1,1197,1.757649000,0.0000
192.228.30.52,<->,133.178.226.30,0,0,1,1181,1,1181,1.757515000,0.0000
243.117.83.26,<->,220.55.100.127,0,0,1,669,1,669,1.757493000,0.0000
215.158.238.25,<->,8.222.109.85,1,1421,0,0,1,1421,1.756986000,0.0000
83.199.244.81,<->,50.224.80.64,0,0,1,1409,1,1409,1.756931000,0.0000
129.114.179.191,<->,8.182.226.78,0,0,1,1493,1,1493,1.756757000,0.0000
221.102.56.69,<->,80.40.30.130,0,0,1,294,1,294,1.756411000,0.0000
207.12.133.19,<->,92.27.194.147,0,0,1,245,1,245,1.756376000,0.0000
195.89.62.158,<->,8.252.222.225,0,0,1,105,1,105,1.756332000,0.0000
8.228.216.186,<->,8.149.158.131,1,854,0,0,1,854,1.756007000,0.0000
229.45.57.252,<->,97.243.220.36,1,473,0,0,1,473,1.755982000,0.0000
215.158.238.97,<->,122.159.245.165,1,1213,0,0,1,1213,1.755723000,0.0000
215.202.174.57,<->,215.158.239.92,0,0,1,1117,1,1117,1.755714000,0.0000
215.158.238.123,<->,192.170.183.67,1,1229,0,0,1,1229,1.755660000,0.0000
136.25.188.44,<->,29.211.186.199,1,229,0,0,1,229,1.755622000,0.0000
221.196.123.231,<->,136.25.188.173,0,0,1,681,1,681,1.755558000,0.0000
207.60.77.97,<->,136.25.188.163,0,0,1,602,1,602,1.755414000,0.0000
199.69.131.82,<->,136.25.188.243,0,0,1,89,1,89,1.755242000,0.0000
100.92.17.20,<->,88.8.3.47,1,56,0,0,1,56,1.754572000,0.0000
215.158.239.95,<->,199.20.29.141,1,117,0,0,1,117,1.754479000,0.0000
215.158.140.92,<->,106.188.253.183,1,1085,0,0,1,1085,1.754353000,0.0000
199.15.134.51,<->,136.25.188.209,0,0,1,93,1,93,1.754022000,0.0000
215.158.239.32,<->,126.219.142.47,1,1486,0,0,1,1486,1.754020000,0.0000
207.188.231.68,<->,136.25.188.209,0,0,1,637,1,637,1.753811000,0.0000
139.193.141.139,<->,122.12.195.62,1,389,0,0,1,389,1.753497000,0.0000
109.119.182.230,<->,8.182.244.19,0,0,1,245,1,245,1.753484000,0.0000
220.28.108.254,<->,215.158.238.136,0,0,1,960,1,960,1.753009000,0.0000
215.158.238.47,<->,116.99.180.151,1,1197,0,0,1,1197,1.752557000,0.0000
133.178.226.198,<->,56.97.187.106,1,152,0,0,1,152,1.752138000,0.0000
215.158.238.83,<->,8.191.15.28,1,1245,0,0,1,1245,1.751268000,0.0000
136.25.189.27,<->,96.156.169.224,1,1427,0,0,1,1427,1.751266000,0.0000
198.230.205.140,<->,144.71.44.80,0,0,1,259,1,259,1.751179000,0.0000
111.151.109.39,<->,67.174.33.237,0,0,1,100,1,100,1.751143000,0.0000
197.147.61.143,<->,8.20.87.187,0,0,1,272,1,272,1.751100000,0.0000
220.243.198.21,<->,8.252.222.107,0,0,1,608,1,608,1.751071000,0.0000
136.25.189.46,<->,133.146.0.138,1,1165,0,0,1,1165,1.750954000,0.0000
215.158.239.85,<->,199.15.112.32,1,602,0,0,1,602,1.750886000,0.0000
101.70.119.145,<->,53.239.129.38,1,490,0,0,1,490,1.750760000,0.0000
215.158.238.54,<->,122.158.70.59,1,1261,0,0,1,1261,1.750679000,0.0000
221.102.56.69,<->,192.67.97.23,0,0,1,294,1,294,1.750609000,0.0000
215.158.239.69,<->,116.106.38.40,1,1053,0,0,1,1053,1.750414000,0.0000
215.158.238.73,<->,33.209.217.236,1,1213,0,0,1,1213,1.750349000,0.0000
138.98.217.32,<->,27.11.49.127,1,276,0,0,1,276,1.750314000,0.0000
159.137.249.250,<->,114.243.233.92,1,398,0,0,1,398,1.750176000,0.0000
142.253.111.62,<->,136.25.188.55,0,0,1,561,1,561,1.750010000,0.0000
50.224.80.67,<->,50.125.173.143,1,513,0,0,1,513,1.749835000,0.0000
215.158.239.51,<->,195.80.100.253,1,830,0,0,1,830,1.749357000,0.0000
215.158.239.101,<->,129.222.39.121,1,900,0,0,1,900,1.748988000,0.0000
204.153.100.136,<->,101.224.204.164,0,0,1,600,1,600,1.748873000,0.0000
54.92.55.77,<->,35.41.132.61,0,0,1,118,1,118,1.748659000,0.0000
210.229.230.19,<->,145.174.196.20,1,68,0,0,1,68,1.748641000,0.0000
136.25.188.255,<->,57.210.107.8,1,1261,0,0,1,1261,1.748435000,0.0000
215.158.238.83,<->,149.250.115.7,1,1373,0,0,1,1373,1.748391000,0.0000
220.20.200.139,<->,141.131.213.24,1,1328,0,0,1,1328,1.748184000,0.0000
210.229.230.20,<->,112.73.158.103,1,68,0,0,1,68,1.747812000,0.0000
215.158.238.133,<->,131.173.115.4,1,1341,0,0,1,1341,1.747758000,0.0000
8.182.253.40,<->,6.133.212.101,1,670,0,0,1,670,1.747386000,0.0000
159.137.162.213,<->,6.210.129.148,1,632,0,0,1,632,1.747165000,0.0000
131.195.9.102,<->,50.224.76.234,0,0,1,597,1,597,1.747122000,0.0000
215.158.239.77,<->,207.114.92.54,1,602,0,0,1,602,1.746709000,0.0000
197.113.99.126,<->,136.25.188.222,0,0,1,93,1,93,1.746484000,0.0000
133.178.227.57,<->,126.207.73.87,1,1046,0,0,1,1046,1.746397000,0.0000
133.199.186.90,<->,92.162.253.135,0,0,1,507,1,507,1.746208000,0.0000
215.158.238.117,<->,0.195.237.14,1,1060,0,0,1,1060,1.746138000,0.0000
96.115.136.205,<->,8.52.222.23,0,0,1,350,1,350,1.745443000,0.0000
215.158.239.95,<->,199.20.28.98,1,602,0,0,1,602,1.745340000,0.0000
145.116.223.76,<->,133.178.226.246,0,0,1,573,1,573,1.745305000,0.0000
97.126.123.108,<->,50.145.204.138,1,125,0,0,1,125,1.744925000,0.0000
215.158.239.69,<->,204.2.14.151,1,561,0,0,1,561,1.744914000,0.0000
215.158.239.84,<->,199.20.6.137,1,240,0,0,1,240,1.744800000,0.0000
215.158.239.92,<->,195.49.37.133,1,190,0,0,1,190,1.744410000,0.0000
215.158.140.93,<->,8.53.216.15,1,1211,0,0,1,1211,1.744136000,0.0000
142.206.64.174,<->,136.25.188.227,0,0,1,765,1,765,1.744045000,0.0000
195.55.79.143,<->,136.25.188.225,0,0,1,882,1,882,1.743956000,0.0000
250.109.247.154,<->,80.27.158.247,0,0,1,674,1,674,1.743890000,0.0000
192.64.235.77,<->,53.222.255.226,1,1220,0,0,1,1220,1.743797000,0.0000
215.158.238.241,<->,123.166.46.199,1,1059,0,0,1,1059,1.743678000,0.0000
142.255.61.97,<->,136.25.188.45,0,0,1,785,1,785,1.743166000,0.0000
139.163.26.238,<->,121.244.93.67,1,183,0,0,1,183,1.743086000,0.0000
136.129.94.157,<->,111.199.239.119,1,414,0,0,1,414,1.742766000,0.0000
206.103.215.196,<->,136.25.188.175,0,0,1,1261,1,1261,1.742681000,0.0000
61.63.197.113,<->,50.224.76.234,0,0,1,1087,1,1087,1.742261000,0.0000
210.229.230.22,<->,111.94.159.26,1,68,0,0,1,68,1.742199000,0.0000
112.220.206.122,<->,100.182.132.40,0,0,1,87,1,87,1.741897000,0.0000
215.158.238.133,<->,113.92.151.107,1,1220,0,0,1,1220,1.741630000,0.0000
100.81.104.145,<->,50.224.76.235,0,0,1,851,1,851,1.741150000,0.0000
215.158.239.94,<->,142.227.54.218,1,240,0,0,1,240,1.741000000,0.0000
215.158.238.135,<->,126.219.196.185,1,1261,0,0,1,1261,1.740830000,0.0000
89.86.110.11,<->,8.252.222.226,0,0,1,1181,1,1181,1.740614000,0.0000
215.158.238.92,<->,143.155.226.212,1,1213,0,0,1,1213,1.740424000,0.0000
8.52.181.95,<->,8.3.252.200,1,368,0,0,1,368,1.740317000,0.0000
215.158.238.148,<->,114.94.161.196,1,1165,0,0,1,1165,1.740302000,0.0000
133.178.226.19,<->,80.47.111.74,1,1181,0,0,1,1181,1.740066000,0.0000
220.20.200.249,<->,119.45.35.142,1,1030,0,0,1,1030,1.739637000,0.0000
136.25.188.160,<->,69.31.238.203,1,1341,0,0,1,1341,1.739465000,0.0000
207.57.191.210,<->,136.25.188.252,0,0,1,117,1,117,1.739424000,0.0000
215.158.238.45,<->,112.235.116.43,1,1117,0,0,1,1117,1.739361000,0.0000
136.25.189.46,<->,57.247.184.200,1,1357,0,0,1,1357,1.739127000,0.0000
215.158.238.148,<->,112.235.95.22,1,1197,0,0,1,1197,1.738291000,0.0000
204.200.46.104,<->,136.25.188.209,0,0,1,269,1,269,1.738043000,0.0000
241.120.29.225,<->,215.158.239.78,0,0,1,1309,1,1309,1.738016000,0.0000
97.80.236.157,<->,8.182.226.78,0,0,1,957,1,957,1.737982000,0.0000
215.158.238.64,<->,126.219.132.253,1,1341,0,0,1,1341,1.737459000,0.0000
220.55.72.171,<->,220.20.206.160,1,1424,0,0,1,1424,1.737407000,0.0000
215.158.238.53,<->,126.219.136.86,1,1325,0,0,1,1325,1.736624000,0.0000
197.113.99.57,<->,136.25.188.225,0,0,1,765,1,765,1.736443000,0.0000
102.30.117.134,<->,92.27.27.146,0,0,1,544,1,544,1.736361000,0.0000
111.147.220.188,<->,54.36.179.214,1,573,0,0,1,573,1.736127000,0.0000
224.129.13.57,<->,8.182.224.87,0,0,1,1163,1,1163,1.735801000,0.0000
215.158.238.94,<->,139.160.226.220,1,1197,0,0,1,1197,1.735527000,0.0000
215.158.239.95,<->,195.55.142.231,1,765,0,0,1,765,1.735441000,0.0000
136.25.189.80,<->,29.123.209.236,1,1357,0,0,1,1357,1.735316000,0.0000
199.50.209.48,<->,136.25.188.53,0,0,1,101,1,101,1.735115000,0.0000
215.158.238.66,<->,131.2.102.201,1,1277,0,0,1,1277,1.735025000,0.0000
133.178.226.28,<->,104.3.169.47,1,1181,0,0,1,1181,1.734663000,0.0000
215.158.238.82,<->,8.42.43.73,1,1357,0,0,1,1357,1.734622000,0.0000
129.78.116.178,<->,76.100.65.38,1,624,0,0,1,624,1.734553000,0.0000
215.158.239.59,<->,8.220.51.251,1,1293,0,0,1,1293,1.734481000,0.0000
133.178.226.18,<->,57.210.107.41,1,1325,0,0,1,1325,1.734463000,0.0000
215.158.239.5,<->,115.152.34.37,1,703,0,0,1,703,1.734156000,0.0000
215.158.238.67,<->,33.209.217.213,1,1462,0,0,1,1462,1.734155000,0.0000
124.42.155.231,<->,50.224.76.248,0,0,1,856,1,856,1.734105000,0.0000
215.158.239.79,<->,207.16.193.216,1,602,0,0,1,602,1.733953000,0.0000
215.158.238.209,<->,38.51.98.229,1,1213,0,0,1,1213,1.733759000,0.0000
215.158.239.182,<->,100.224.243.67,1,205,0,0,1,205,1.733678000,0.0000
136.25.188.226,<->,131.2.115.214,1,1197,0,0,1,1197,1.733526000,0.0000
215.158.140.221,<->,8.222.7.180,1,1111,0,0,1,1111,1.733342000,0.0000
128.135.233.211,<->,8.220.191.251,0,0,1,354,1,354,1.733071000,0.0000
8.183.25.20,<->,6.167.232.246,1,797,0,0,1,797,1.732979000,0.0000
195.6.221.70,<->,136.25.188.255,0,0,1,89,1,89,1.732867000,0.0000
213.38.171.239,<->,50.224.76.248,0,0,1,257,1,257,1.732702000,0.0000
138.121.99.24,<->,8.220.186.239,0,0,1,254,1,254,1.732575000,0.0000
215.158.238.58,<->,8.222.109.108,1,1325,0,0,1,1325,1.732461000,0.0000
207.194.67.34,<->,8.182.235.164,0,0,1,277,1,277,1.731810000,0.0000
215.158.239.97,<->,199.20.29.182,1,190,0,0,1,190,1.731735000,0.0000
207.188.231.68,<->,136.25.188.198,0,0,1,635,1,635,1.731286000,0.0000
214.85.253.103,<->,50.224.76.235,0,0,1,1217,1,1217,1.731237000,0.0000
215.158.238.66,<->,205.122.195.42,1,1037,0,0,1,1037,1.730807000,0.0000
143.135.236.115,<->,136.25.188.208,0,0,1,602,1,602,1.730673000,0.0000
215.158.140.229,<->,143.173.13.199,1,1046,0,0,1,1046,1.730339000,0.0000
215.158.238.36,<->,201.211.112.235,1,1469,0,0,1,1469,1.730158000,0.0000
136.25.188.172,<->,119.196.23.52,1,1357,0,0,1,1357,1.730152000,0.0000
215.158.140.229,<->,215.158.127.230,1,1194,0,0,1,1194,1.729962000,0.0000
136.25.188.44,<->,57.199.250.198,1,1357,0,0,1,1357,1.729675000,0.0000
225.120.222.187,<->,215.158.238.99,0,0,1,1229,1,1229,1.729629000,0.0000
215.158.239.113,<->,56.19.241.86,1,179,0,0,1,179,1.729529000,0.0000
156.165.37.75,<->,136.25.189.29,0,0,1,149,1,149,1.728865000,0.0000
92.27.67.44,<->,8.252.221.171,0,0,1,551,1,551,1.728810000,0.0000
215.158.239.79,<->,195.54.48.175,1,272,0,0,1,272,1.728800000,0.0000
84.203.220.182,<->,8.252.223.176,0,0,1,1373,1,1373,1.728658000,0.0000
207.172.29.9,<->,136.25.188.177,0,0,1,240,1,240,1.728518000,0.0000
136.25.188.220,<->,69.132.241.187,1,1469,0,0,1,1469,1.728391000,0.0000
195.5.82.217,<->,136.25.188.178,0,0,1,602,1,602,1.728240000,0.0000
215.158.239.58,<->,195.40.43.9,1,765,0,0,1,765,1.727607000,0.0000
215.158.140.168,<->,113.207.62.186,1,464,0,0,1,464,1.727565000,0.0000
215.158.238.81,<->,29.212.203.139,1,1085,0,0,1,1085,1.727035000,0.0000
215.158.239.58,<->,199.20.28.245,1,907,0,0,1,907,1.726679000,0.0000
247.136.136.208,<->,205.184.170.197,1,231,0,0,1,231,1.726591000,0.0000
136.25.188.255,<->,126.219.132.226,1,1357,0,0,1,1357,1.726263000,0.0000
207.236.183.94,<->,136.25.188.177,0,0,1,93,1,93,1.725826000,0.0000
215.158.238.133,<->,111.158.193.220,1,1085,0,0,1,1085,1.725637000,0.0000
225.120.222.187,<->,133.178.226.60,0,0,1,1229,1,1229,1.725539000,0.0000
215.158.238.120,<->,193.10.94.22,1,1229,0,0,1,1229,1.725326000,0.0000
215.158.238.92,<->,116.106.60.148,1,1277,0,0,1,1277,1.725053000,0.0000
142.227.65.64,<->,50.224.76.234,0,0,1,659,1,659,1.724889000,0.0000
204.184.142.81,<->,136.25.188.178,0,0,1,602,1,602,1.724856000,0.0000
215.158.140.178,<->,83.243.33.162,1,439,0,0,1,439,1.724538000,0.0000
220.38.84.244,<->,136.25.189.57,0,0,1,1213,1,1213,1.724076000,0.0000
136.25.188.41,<->,53.159.128.145,1,109,0,0,1,109,1.723678000,0.0000
239.227.117.98,<->,112.208.20.192,1,50,0,0,1,50,1.723488000,0.0000
136.25.188.242,<->,126.219.19.53,1,1197,0,0,1,1197,1.723266000,0.0000
136.25.189.15,<->,68.124.221.187,1,1245,0,0,1,1245,1.723233000,0.0000
121.252.25.54,<->,56.121.58.220,0,0,1,385,1,385,1.723213000,0.0000
138.80.112.237,<->,8.220.186.61,0,0,1,367,1,367,1.723092000,0.0000
215.158.238.75,<->,131.1.195.249,1,1309,0,0,1,1309,1.723061000,0.0000
136.25.189.30,<->,120.155.8.100,1,1373,0,0,1,1373,1.722331000,0.0000
241.0.191.98,<->,215.158.238.132,0,0,1,1373,1,1373,1.722132000,0.0000
56.13.192.154,<->,6.75.194.219,0,0,1,801,1,801,1.721954000,0.0000
17.235.235.172,<->,8.220.189.81,0,0,1,1099,1,1099,1.721726000,0.0000
207.50.113.136,<->,8.182.136.221,0,0,1,75,1,75,1.721720000,0.0000
215.158.238.95,<->,149.33.107.2,1,1069,0,0,1,1069,1.721704000,0.0000
89.183.104.165,<->,42.31.137.99,1,530,0,0,1,530,1.721673000,0.0000
215.158.238.198,<->,114.94.161.171,1,1101,0,0,1,1101,1.721458000,0.0000
215.158.239.99,<->,207.188.231.68,1,635,0,0,1,635,1.721276000,0.0000
215.158.238.97,<->,142.204.32.87,1,1213,0,0,1,1213,1.720995000,0.0000
133.54.43.69,<->,117.0.70.118,1,783,0,0,1,783,1.720806000,0.0000
197.107.123.12,<->,136.25.188.44,0,0,1,270,1,270,1.720188000,0.0000
159.190.87.59,<->,8.182.243.35,0,0,1,358,1,358,1.719926000,0.0000
215.158.239.49,<->,199.20.28.159,1,272,0,0,1,272,1.719828000,0.0000
133.178.227.24,<->,48.131.159.95,1,1085,0,0,1,1085,1.719778000,0.0000
143.227.65.184,<->,136.25.188.55,0,0,1,1341,1,1341,1.719429000,0.0000
215.158.239.56,<->,207.191.86.23,1,250,0,0,1,250,1.719389000,0.0000
215.158.238.97,<->,76.100.108.255,1,1357,0,0,1,1357,1.718765000,0.0000
111.199.237.231,<->,0.195.210.44,0,0,1,109,1,109,1.718684000,0.0000
120.39.68.1,<->,80.41.6.158,0,0,1,62,1,62,1.718141000,0.0000
194.220.115.30,<->,50.223.3.228,0,0,1,292,1,292,1.717757000,0.0000
195.40.46.190,<->,136.25.188.52,0,0,1,669,1,669,1.717653000,0.0000
136.25.188.160,<->,104.154.137.249,1,1325,0,0,1,1325,1.717618000,0.0000
92.27.219.190,<->,57.212.62.83,1,542,0,0,1,542,1.717385000,0.0000
192.204.170.196,<->,136.25.188.176,0,0,1,1079,1,1079,1.716949000,0.0000
215.158.61.242,<->,8.176.8.180,0,0,1,77,1,77,1.716919000,0.0000
136.138.112.251,<->,136.25.188.241,0,0,1,1197,1,1197,1.716781000,0.0000
195.54.77.223,<->,136.25.188.46,0,0,1,456,1,456,1.716618000,0.0000
133.178.226.72,<->,133.56.180.93,1,506,0,0,1,506,1.716513000,0.0000
136.116.9.155,<->,50.224.76.234,0,0,1,798,1,798,1.716177000,0.0000
221.102.56.69,<->,220.83.80.104,0,0,1,294,1,294,1.716111000,0.0000
215.158.238.190,<->,8.40.51.183,1,1042,0,0,1,1042,1.715994000,0.0000
144.85.170.208,<->,98.87.145.232,1,944,0,0,1,944,1.715960000,0.0000
159.137.162.213,<->,149.238.107.34,1,332,0,0,1,332,1.715775000,0.0000
215.158.238.95,<->,80.47.111.74,1,1037,0,0,1,1037,1.715621000,0.0000
112.208.20.167,<->,97.190.192.217,0,0,1,178,1,178,1.715305000,0.0000
215.158.239.76,<->,199.20.6.120,1,378,0,0,1,378,1.715280000,0.0000
53.213.63.210,<->,48.53.159.235,0,0,1,93,1,93,1.715177000,0.0000
197.113.99.126,<->,136.25.188.177,0,0,1,93,1,93,1.714960000,0.0000
215.158.239.56,<->,199.20.29.185,1,609,0,0,1,609,1.714803000,0.0000
136.25.188.174,<->,8.240.118.201,1,1197,0,0,1,1197,1.714581000,0.0000
215.158.239.56,<->,199.15.230.38,1,240,0,0,1,240,1.714535000,0.0000
144.83.60.153,<->,92.162.253.139,0,0,1,471,1,471,1.714181000,0.0000
133.54.43.82,<->,112.30.36.128,1,206,0,0,1,206,1.713896000,0.0000
215.158.239.50,<->,29.211.228.234,1,1427,0,0,1,1427,1.713342000,0.0000
215.158.140.60,<->,61.35.22.166,1,1108,0,0,1,1108,1.713237000,0.0000
92.27.27.151,<->,72.36.193.223,1,112,0,0,1,112,1.713158000,0.0000
215.158.61.227,<->,8.252.222.8,0,0,1,490,1,490,1.712850000,0.0000
215.158.239.99,<->,196.107.142.49,1,240,0,0,1,240,1.712806000,0.0000
215.158.239.77,<->,207.63.63.196,1,87,0,0,1,87,1.712643000,0.0000
201.136.143.22,<->,136.25.188.178,0,0,1,1456,1,1456,1.712642000,0.0000
101.126.177.88,<->,89.90.104.87,1,386,0,0,1,386,1.712472000,0.0000
205.72.167.142,<->,50.224.76.248,0,0,1,75,1,75,1.711897000,0.0000
138.98.180.141,<->,134.245.87.117,1,681,0,0,1,681,1.711764000,0.0000
139.241.56.171,<->,6.73.247.43,0,0,1,341,1,341,1.711137000,0.0000
133.178.227.79,<->,8.33.227.61,1,989,0,0,1,989,1.711055000,0.0000
204.185.26.120,<->,136.25.188.162,0,0,1,378,1,378,1.710939000,0.0000
196.17.190.33,<->,50.224.76.234,0,0,1,1106,1,1106,1.710692000,0.0000
215.158.238.132,<->,100.224.138.212,1,177,0,0,1,177,1.710651000,0.0000
136.25.188.226,<->,112.220.206.22,1,1229,0,0,1,1229,1.710553000,0.0000
215.158.238.83,<->,6.116.31.28,1,1181,0,0,1,1181,1.710543000,0.0000
215.158.238.103,<->,100.224.166.161,1,506,0,0,1,506,1.710403000,0.0000
215.158.238.198,<->,113.23.14.192,1,1389,0,0,1,1389,1.709870000,0.0000
215.158.238.113,<->,8.220.51.247,1,1437,0,0,1,1437,1.709651000,0.0000
133.178.226.61,<->,8.252.253.196,1,1085,0,0,1,1085,1.709025000,0.0000
136.25.188.163,<->,84.250.181.78,1,653,0,0,1,653,1.709016000,0.0000
215.158.238.64,<->,113.23.21.212,1,1197,0,0,1,1197,1.708782000,0.0000
200.177.71.212,<->,97.126.4.233,0,0,1,97,1,97,1.708758000,0.0000
129.225.132.224,<->,129.225.131.140,1,630,0,0,1,630,1.708667000,0.0000
197.113.64.168,<->,136.25.188.178,0,0,1,240,1,240,1.708653000,0.0000
8.182.235.164,<->,6.26.243.228,1,182,0,0,1,182,1.708597000,0.0000
133.178.227.41,<->,131.22.233.138,1,1036,0,0,1,1036,1.708401000,0.0000
136.25.189.82,<->,113.23.66.212,1,1309,0,0,1,1309,1.707722000,0.0000
215.158.239.41,<->,33.209.213.8,1,1419,0,0,1,1419,1.707663000,0.0000
89.183.106.29,<->,18.139.6.149,1,545,0,0,1,545,1.706852000,0.0000
133.178.226.29,<->,57.210.104.163,1,1101,0,0,1,1101,1.706834000,0.0000
215.158.239.97,<->,196.109.14.153,1,777,0,0,1,777,1.706781000,0.0000
215.158.239.97,<->,196.109.223.108,1,602,0,0,1,602,1.706426000,0.0000
249.101.120.43,<->,53.148.24.110,1,125,0,0,1,125,1.706419000,0.0000
246.253.168.231,<->,105.88.18.211,1,370,0,0,1,370,1.706165000,0.0000
158.192.3.218,<->,136.25.188.52,0,0,1,1229,1,1229,1.705713000,0.0000
215.158.238.92,<->,128.194.247.212,1,1229,0,0,1,1229,1.704739000,0.0000
197.113.64.166,<->,136.25.188.198,0,0,1,781,1,781,1.704315000,0.0000
215.158.238.83,<->,122.159.68.201,1,1229,0,0,1,1229,1.703063000,0.0000
159.109.245.39,<->,53.149.247.244,1,79,0,0,1,79,1.702428000,0.0000
215.158.238.123,<->,131.1.195.244,1,1371,0,0,1,1371,1.702382000,0.0000
17.34.35.51,<->,8.220.239.84,0,0,1,890,1,890,1.702307000,0.0000
215.158.239.41,<->,122.159.245.154,1,75,0,0,1,75,1.702084000,0.0000
136.25.189.43,<->,96.156.169.227,1,1317,0,0,1,1317,1.701949000,0.0000
143.114.150.67,<->,50.224.76.234,0,0,1,1384,1,1384,1.701785000,0.0000
251.21.173.35,<->,109.222.231.87,0,0,1,129,1,129,1.701655000,0.0000
133.178.227.24,<->,80.57.141.99,1,1111,0,0,1,1111,1.701551000,0.0000
197.113.99.96,<->,136.25.188.243,0,0,1,709,1,709,1.701272000,0.0000
109.127.156.13,<->,8.52.155.194,0,0,1,934,1,934,1.701052000,0.0000
215.158.238.99,<->,80.47.111.107,1,1149,0,0,1,1149,1.700971000,0.0000
142.227.97.23,<->,50.224.76.234,0,0,1,562,1,562,1.700323000,0.0000
215.158.238.21,<->,89.80.251.224,1,1309,0,0,1,1309,1.700187000,0.0000
195.4.112.113,<->,136.25.188.179,0,0,1,85,1,85,1.700068000,0.0000
136.25.188.237,<->,29.213.216.245,1,1341,0,0,1,1341,1.699774000,0.0000
215.158.238.113,<->,141.39.23.100,1,1357,0,0,1,1357,1.699484000,0.0000
133.178.226.37,<->,131.2.115.236,1,1181,0,0,1,1181,1.699273000,0.0000
53.149.38.189,<->,8.228.215.41,0,0,1,113,1,113,1.699138000,0.0000
215.158.239.49,<->,199.20.31.72,1,602,0,0,1,602,1.699135000,0.0000
205.185.247.66,<->,50.224.76.234,0,0,1,202,1,202,1.699075000,0.0000
144.87.238.89,<->,8.252.223.222,0,0,1,297,1,297,1.698322000,0.0000
195.13.138.191,<->,136.25.188.177,0,0,1,85,1,85,1.697783000,0.0000
215.158.238.72,<->,91.57.162.197,1,1341,0,0,1,1341,1.697598000,0.0000
133.178.226.18,<->,126.219.196.166,1,1069,0,0,1,1069,1.697085000,0.0000
215.158.239.50,<->,113.23.66.212,1,1437,0,0,1,1437,1.696996000,0.0000
207.193.113.211,<->,8.252.222.177,0,0,1,105,1,105,1.696785000,0.0000
215.158.238.251,<->,123.166.47.57,1,1133,0,0,1,1133,1.696590000,0.0000
149.221.157.147,<->,0.195.210.42,0,0,1,85,1,85,1.696434000,0.0000
215.158.238.82,<->,192.204.170.196,1,1181,0,0,1,1181,1.696240000,0.0000
133.178.226.31,<->,113.20.94.106,1,1149,0,0,1,1149,1.695550000,0.0000
136.25.188.47,<->,33.209.217.237,1,1165,0,0,1,1165,1.695492000,0.0000
215.158.238.190,<->,8.222.58.187,1,1036,0,0,1,1036,1.694851000,0.0000
111.20.168.122,<->,101.224.91.158,1,725,0,0,1,725,1.694539000,0.0000
215.158.239.49,<->,195.43.77.167,1,101,0,0,1,101,1.694475000,0.0000
54.38.126.203,<->,48.54.111.255,0,0,1,87,1,87,1.694256000,0.0000
215.158.238.81,<->,131.144.116.84,1,1229,0,0,1,1229,1.693792000,0.0000
159.137.162.213,<->,105.111.168.128,1,332,0,0,1,332,1.693652000,0.0000
109.2.108.59,<->,8.45.168.98,1,97,0,0,1,97,1.693622000,0.0000
195.6.200.217,<->,136.25.188.199,0,0,1,561,1,561,1.693394000,0.0000
221.102.143.189,<->,98.128.214.64,0,0,1,87,1,87,1.693133000,0.0000
220.50.242.215,<->,133.32.39.1,0,0,1,148,1,148,1.692587000,0.0000
134.21.177.68,<->,50.224.76.234,0,0,1,260,1,260,1.692534000,0.0000
192.64.244.65,<->,0.38.144.54,1,659,0,0,1,659,1.691895000,0.0000
92.27.219.199,<->,57.141.2.1,1,53,0,0,1,53,1.691753000,0.0000
215.158.239.58,<->,199.20.30.123,1,506,0,0,1,506,1.690829000,0.0000
207.191.58.224,<->,136.25.188.241,0,0,1,378,1,378,1.690820000,0.0000
213.38.197.82,<->,8.55.224.156,1,141,0,0,1,141,1.690810000,0.0000
215.158.239.49,<->,194.237.64.106,1,272,0,0,1,272,1.690526000,0.0000
215.158.239.180,<->,8.191.15.132,1,93,0,0,1,93,1.690082000,0.0000
92.27.219.145,<->,35.33.20.54,1,78,0,0,1,78,1.689976000,0.0000
215.158.239.68,<->,199.20.63.99,1,781,0,0,1,781,1.689957000,0.0000
215.158.195.89,<->,126.219.137.61,1,672,0,0,1,672,1.689897000,0.0000
204.130.115.175,<->,8.252.223.106,0,0,1,1389,1,1389,1.689730000,0.0000
159.47.123.42,<->,139.163.66.167,0,0,1,592,1,592,1.689464000,0.0000
17.33.68.18,<->,8.220.176.253,0,0,1,337,1,337,1.689073000,0.0000
215.158.238.116,<->,96.135.154.29,1,1485,0,0,1,1485,1.688889000,0.0000
215.158.61.183,<->,136.25.188.29,0,0,1,1199,1,1199,1.688875000,0.0000
215.158.140.231,<->,69.150.168.192,1,1111,0,0,1,1111,1.688546000,0.0000
215.158.195.38,<->,126.219.137.61,1,672,0,0,1,672,1.688514000,0.0000
133.178.226.61,<->,119.196.23.70,1,1341,0,0,1,1341,1.688044000,0.0000
215.158.61.242,<->,136.25.188.43,0,0,1,61,1,61,1.687567000,0.0000
111.151.109.51,<->,8.252.222.59,0,0,1,100,1,100,1.687456000,0.0000
215.158.238.135,<->,120.154.226.156,1,1245,0,0,1,1245,1.687311000,0.0000
215.158.239.96,<->,196.91.144.120,1,236,0,0,1,236,1.687255000,0.0000
215.158.239.95,<->,196.238.162.142,1,87,0,0,1,87,1.687111000,0.0000
133.178.227.250,<->,80.57.208.189,1,168,0,0,1,168,1.686916000,0.0000
136.25.189.28,<->,123.166.46.212,1,1277,0,0,1,1277,1.686460000,0.0000
215.158.238.122,<->,128.23.84.234,1,1117,0,0,1,1117,1.686340000,0.0000
50.224.76.235,<->,6.74.204.201,1,473,0,0,1,473,1.686287000,0.0000
200.174.165.247,<->,53.148.90.97,1,93,0,0,1,93,1.686278000,0.0000
89.141.10.60,<->,8.52.223.84,0,0,1,406,1,406,1.686241000,0.0000
204.184.244.125,<->,136.25.188.176,0,0,1,602,1,602,1.686179000,0.0000
133.8.10.152,<->,111.20.168.23,0,0,1,305,1,305,1.686062000,0.0000
196.89.25.19,<->,136.25.188.252,0,0,1,273,1,273,1.685488000,0.0000
215.158.61.189,<->,8.176.8.233,0,0,1,298,1,298,1.685237000,0.0000
144.85.170.254,<->,91.69.181.215,1,436,0,0,1,436,1.685171000,0.0000
139.163.20.196,<->,110.223.99.72,1,644,0,0,1,644,1.685168000,0.0000
133.178.226.37,<->,91.57.162.253,1,1341,0,0,1,1341,1.684935000,0.0000
215.158.140.75,<->,29.211.165.23,1,1036,0,0,1,1036,1.684228000,0.0000
109.222.212.198,<->,82.193.206.111,1,1168,0,0,1,1168,1.684045000,0.0000
148.186.207.196,<->,136.25.188.224,0,0,1,1165,1,1165,1.683943000,0.0000
215.158.239.95,<->,199.20.31.143,1,93,0,0,1,93,1.683662000,0.0000
207.188.63.122,<->,136.25.188.222,0,0,1,765,1,765,1.683000000,0.0000
144.85.170.254,<->,91.69.181.222,1,451,0,0,1,451,1.682988000,0.0000
114.205.133.225,<->,50.224.76.234,0,0,1,348,1,348,1.682826000,0.0000
215.158.238.66,<->,61.34.184.199,1,1325,0,0,1,1325,1.682518000,0.0000
215.158.61.183,<->,8.176.8.197,0,0,1,429,1,429,1.682504000,0.0000
207.172.118.63,<->,136.25.188.54,0,0,1,97,1,97,1.682294000,0.0000
192.226.44.69,<->,133.178.227.254,0,0,1,1459,1,1459,1.682211000,0.0000
142.207.96.32,<->,136.25.188.178,0,0,1,87,1,87,1.682191000,0.0000
215.158.239.92,<->,199.20.31.181,1,168,0,0,1,168,1.682011000,0.0000
215.158.239.77,<->,196.107.97.91,1,168,0,0,1,168,1.681693000,0.0000
75.137.144.228,<->,8.252.221.198,0,0,1,436,1,436,1.681191000,0.0000
215.158.140.178,<->,8.240.116.237,1,1207,0,0,1,1207,1.680747000,0.0000
215.158.238.81,<->,8.191.15.11,1,1037,0,0,1,1037,1.680300000,0.0000
92.27.219.172,<->,35.33.19.191,1,78,0,0,1,78,1.680265000,0.0000
89.204.33.10,<->,8.182.244.19,0,0,1,586,1,586,1.680037000,0.0000
215.158.238.197,<->,8.222.0.245,1,1204,0,0,1,1204,1.679959000,0.0000
207.60.135.50,<->,136.25.188.237,0,0,1,87,1,87,1.679811000,0.0000
196.245.127.38,<->,136.25.188.46,0,0,1,602,1,602,1.679414000,0.0000
215.158.239.49,<->,199.122.119.62,1,240,0,0,1,240,1.679301000,0.0000
221.102.56.69,<->,192.66.145.107,0,0,1,861,1,861,1.679269000,0.0000
136.25.188.160,<->,128.123.91.66,1,1309,0,0,1,1309,1.679136000,0.0000
194.253.83.145,<->,50.224.76.235,0,0,1,738,1,738,1.679060000,0.0000
215.158.238.236,<->,122.159.123.17,1,1225,0,0,1,1225,1.679026000,0.0000
195.41.46.91,<->,136.25.188.220,0,0,1,331,1,331,1.679022000,0.0000
215.158.238.243,<->,8.192.205.90,1,1048,0,0,1,1048,1.679016000,0.0000
215.158.238.81,<->,61.35.124.167,1,1261,0,0,1,1261,1.678693000,0.0000
133.178.227.39,<->,133.56.180.93,1,541,0,0,1,541,1.678560000,0.0000
215.158.238.243,<->,68.231.26.202,1,1090,0,0,1,1090,1.678452000,0.0000
142.255.65.48,<->,136.25.188.223,0,0,1,770,1,770,1.678174000,0.0000
220.28.114.117,<->,80.38.38.207,0,0,1,286,1,286,1.678163000,0.0000
221.102.143.189,<->,6.228.23.67,0,0,1,141,1,141,1.677886000,0.0000
133.178.226.227,<->,111.52.90.194,1,283,0,0,1,283,1.677770000,0.0000
215.158.239.84,<->,204.2.124.2,1,282,0,0,1,282,1.677482000,0.0000
215.158.140.93,<->,18.202.90.252,1,1116,0,0,1,1116,1.677452000,0.0000
142.249.104.143,<->,136.25.188.199,0,0,1,602,1,602,1.677234000,0.0000
143.200.139.22,<->,80.38.16.211,0,0,1,526,1,526,1.677079000,0.0000
98.150.172.76,<->,8.176.8.69,0,0,1,345,1,345,1.676882000,0.0000
215.158.239.48,<->,207.60.142.129,1,240,0,0,1,240,1.676860000,0.0000
215.158.239.57,<->,199.20.30.124,1,93,0,0,1,93,1.676826000,0.0000
197.198.16.58,<->,136.25.188.178,0,0,1,218,1,218,1.676672000,0.0000
215.158.239.94,<->,133.8.213.76,1,1213,0,0,1,1213,1.676333000,0.0000
136.25.188.52,<->,69.31.239.14,1,1245,0,0,1,1245,1.676291000,0.0000
140.79.209.148,<->,8.252.222.62,0,0,1,256,1,256,1.676164000,0.0000
215.158.61.183,<->,8.176.8.250,0,0,1,398,1,398,1.675464000,0.0000
215.158.239.68,<->,199.82.250.91,1,160,0,0,1,160,1.675434000,0.0000
215.158.238.23,<->,96.38.231.102,1,1325,0,0,1,1325,1.674742000,0.0000
215.158.239.51,<->,199.20.28.212,1,378,0,0,1,378,1.673931000,0.0000
143.134.96.189,<->,136.25.188.222,0,0,1,168,1,168,1.673873000,0.0000
215.158.238.95,<->,144.253.73.85,1,1225,0,0,1,1225,1.673564000,0.0000
215.158.238.82,<->,198.204.76.246,1,1357,0,0,1,1357,1.673141000,0.0000
207.60.89.10,<->,136.25.188.174,0,0,1,256,1,256,1.673074000,0.0000
199.73.34.17,<->,136.25.188.44,0,0,1,602,1,602,1.672929000,0.0000
215.158.239.96,<->,196.93.124.105,1,1118,0,0,1,1118,1.672588000,0.0000
215.158.239.51,<->,199.20.30.57,1,117,0,0,1,117,1.672426000,0.0000
133.178.226.235,<->,113.23.114.102,1,145,0,0,1,145,1.672406000,0.0000
144.85.170.254,<->,111.2.132.128,1,276,0,0,1,276,1.671663000,0.0000
221.102.56.69,<->,98.129.28.237,0,0,1,294,1,294,1.671195000,0.0000
246.254.97.107,<->,132.128.61.22,1,87,0,0,1,87,1.671128000,0.0000
215.158.239.40,<->,98.198.114.57,1,1000,0,0,1,1000,1.670971000,0.0000
197.198.21.33,<->,80.38.52.42,0,0,1,586,1,586,1.670871000,0.0000
133.178.226.29,<->,113.23.117.117,1,1277,0,0,1,1277,1.670725000,0.0000
136.25.188.44,<->,113.23.104.252,1,1277,0,0,1,1277,1.670365000,0.0000
215.158.140.231,<->,111.150.187.215,1,1179,0,0,1,1179,1.670258000,0.0000
215.158.238.132,<->,76.100.108.230,1,1373,0,0,1,1373,1.670251000,0.0000
133.178.227.135,<->,8.35.106.212,1,73,0,0,1,73,1.669861000,0.0000
145.170.224.41,<->,8.182.230.134,0,0,1,265,1,265,1.669246000,0.0000
202.178.8.84,<->,108.134.108.232,0,0,1,371,1,371,1.668747000,0.0000
159.137.152.34,<->,133.178.226.227,0,0,1,94,1,94,1.668721000,0.0000
215.158.239.40,<->,80.47.111.160,1,1220,0,0,1,1220,1.668610000,0.0000
199.83.110.179,<->,136.25.188.239,0,0,1,561,1,561,1.668216000,0.0000
133.178.226.60,<->,57.227.83.185,1,1149,0,0,1,1149,1.668129000,0.0000
124.47.116.59,<->,50.224.76.235,0,0,1,603,1,603,1.668094000,0.0000
207.239.110.42,<->,136.25.188.178,0,0,1,182,1,182,1.667826000,0.0000
240.117.25.98,<->,50.224.76.235,0,0,1,464,1,464,1.667803000,0.0000
143.155.227.33,<->,136.25.188.179,0,0,1,1197,1,1197,1.667681000,0.0000
143.87.173.176,<->,136.25.188.46,0,0,1,561,1,561,1.667670000,0.0000
111.20.168.123,<->,101.224.91.182,1,768,0,0,1,768,1.667509000,0.0000
221.102.143.189,<->,220.80.24.204,0,0,1,141,1,141,1.666900000,0.0000
136.25.188.167,<->,111.151.142.231,1,100,0,0,1,100,1.666057000,0.0000
197.113.89.43,<->,136.25.188.222,0,0,1,781,1,781,1.666014000,0.0000
8.55.211.213,<->,6.74.66.227,0,0,1,294,1,294,1.665623000,0.0000
136.25.188.196,<->,131.215.37.50,1,1197,0,0,1,1197,1.665146000,0.0000
215.158.238.241,<->,8.192.205.1,1,1405,0,0,1,1405,1.664942000,0.0000
133.178.226.37,<->,33.209.217.236,1,1229,0,0,1,1229,1.664889000,0.0000
215.158.239.51,<->,29.212.199.5,1,1437,0,0,1,1437,1.664568000,0.0000
133.178.227.41,<->,80.57.141.96,1,1343,0,0,1,1343,1.664341000,0.0000
136.25.188.252,<->,8.179.43.168,1,1293,0,0,1,1293,1.664295000,0.0000
145.252.126.139,<->,98.219.126.40,1,449,0,0,1,449,1.664046000,0.0000
215.158.238.66,<->,133.101.64.107,1,1197,0,0,1,1197,1.663771000,0.0000
133.178.226.28,<->,106.188.252.187,1,1277,0,0,1,1277,1.663524000,0.0000
215.158.238.82,<->,112.93.136.119,1,1085,0,0,1,1085,1.663262000,0.0000
69.246.60.77,<->,8.252.222.31,0,0,1,561,1,561,1.663039000,0.0000
215.158.239.77,<->,199.20.31.68,1,632,0,0,1,632,1.662994000,0.0000
132.249.70.11,<->,53.208.51.3,1,326,0,0,1,326,1.662706000,0.0000
215.158.239.79,<->,199.20.28.92,1,378,0,0,1,378,1.662495000,0.0000
210.220.219.153,<->,53.200.51.77,1,181,0,0,1,181,1.662099000,0.0000
197.113.99.146,<->,136.25.188.243,0,0,1,602,1,602,1.661804000,0.0000
133.178.226.29,<->,42.97.54.34,1,1325,0,0,1,1325,1.660962000,0.0000
215.158.238.86,<->,145.116.209.93,1,506,0,0,1,506,1.660878000,0.0000
249.101.111.216,<->,50.145.214.5,1,1330,0,0,1,1330,1.660549000,0.0000
17.15.183.16,<->,8.220.176.253,0,0,1,277,1,277,1.660105000,0.0000
111.151.106.254,<->,99.74.87.227,0,0,1,100,1,100,1.659498000,0.0000
136.25.189.1,<->,135.228.221.200,1,1341,0,0,1,1341,1.659321000,0.0000
215.158.239.68,<->,143.128.41.197,1,93,0,0,1,93,1.659054000,0.0000
215.158.238.251,<->,149.250.115.20,1,1357,0,0,1,1357,1.658787000,0.0000
215.158.61.145,<->,8.176.8.197,0,0,1,400,1,400,1.658663000,0.0000
215.158.238.80,<->,113.106.118.20,1,1197,0,0,1,1197,1.658276000,0.0000
221.102.143.189,<->,102.81.148.183,0,0,1,141,1,141,1.658177000,0.0000
122.12.244.168,<->,92.162.253.187,0,0,1,1040,1,1040,1.658026000,0.0000
215.158.238.94,<->,125.216.33.188,1,1325,0,0,1,1325,1.657993000,0.0000
199.12.122.149,<->,136.25.188.211,0,0,1,265,1,265,1.657923000,0.0000
136.25.188.224,<->,133.8.213.88,1,1181,0,0,1,1181,1.657921000,0.0000
142.223.140.161,<->,136.25.188.241,0,0,1,705,1,705,1.657687000,0.0000
215.158.239.50,<->,199.20.30.123,1,190,0,0,1,190,1.657567000,0.0000
215.158.239.33,<->,139.7.138.55,1,949,0,0,1,949,1.657166000,0.0000
215.158.238.105,<->,69.132.194.168,1,1213,0,0,1,1213,1.656854000,0.0000
91.231.192.88,<->,89.219.78.245,1,457,0,0,1,457,1.656752000,0.0000
133.178.227.1,<->,113.23.101.149,1,1089,0,0,1,1089,1.656718000,0.0000
215.158.140.185,<->,131.36.66.75,1,1223,0,0,1,1223,1.656469000,0.0000
136.25.189.33,<->,131.144.113.7,1,1389,0,0,1,1389,1.656435000,0.0000
89.216.124.92,<->,8.235.230.154,1,210,0,0,1,210,1.656314000,0.0000
215.158.238.81,<->,126.219.136.109,1,1181,0,0,1,1181,1.656020000,0.0000
215.158.239.77,<->,204.1.191.90,1,602,0,0,1,602,1.655941000,0.0000
231.136.200.213,<->,136.25.188.220,0,0,1,627,1,627,1.655857000,0.0000
142.220.162.20,<->,136.25.188.241,0,0,1,141,1,141,1.655788000,0.0000
215.158.239.56,<->,199.20.7.197,1,602,0,0,1,602,1.655715000,0.0000
215.158.238.81,<->,143.155.227.40,1,1117,0,0,1,1117,1.655700000,0.0000
246.45.208.200,<->,78.113.151.36,1,96,0,0,1,96,1.655613000,0.0000
215.158.238.109,<->,145.116.209.82,1,506,0,0,1,506,1.654988000,0.0000
215.158.239.35,<->,109.205.55.34,1,1419,0,0,1,1419,1.654745000,0.0000
220.55.100.127,<->,220.20.202.59,1,1353,0,0,1,1353,1.654095000,0.0000
32.236.164.211,<->,8.52.133.228,0,0,1,557,1,557,1.653949000,0.0000
215.158.238.250,<->,58.11.224.43,1,1154,0,0,1,1154,1.653356000,0.0000
152.43.88.177,<->,8.252.221.239,0,0,1,1177,1,1177,1.653178000,0.0000
99.92.13.169,<->,8.52.189.207,0,0,1,125,1,125,1.653063000,0.0000
136.25.188.173,<->,84.214.235.178,1,863,0,0,1,863,1.652741000,0.0000
139.163.5.140,<->,130.137.174.13,1,112,0,0,1,112,1.652445000,0.0000
220.28.115.46,<->,215.158.238.244,0,0,1,751,1,751,1.652338000,0.0000
221.102.143.189,<->,109.1.84.71,0,0,1,87,1,87,1.651931000,0.0000
194.233.126.136,<->,136.25.188.226,0,0,1,602,1,602,1.651694000,0.0000
136.181.53.215,<->,0.195.216.195,1,93,0,0,1,93,1.651461000,0.0000
136.25.188.218,<->,100.224.202.157,1,506,0,0,1,506,1.650867000,0.0000
136.25.188.177,<->,33.209.217.237,1,1420,0,0,1,1420,1.650499000,0.0000
129.209.89.218,<->,0.195.210.46,0,0,1,85,1,85,1.650453000,0.0000
196.246.241.77,<->,136.25.188.178,0,0,1,669,1,669,1.650452000,0.0000
153.111.177.167,<->,8.252.221.221,0,0,1,285,1,285,1.650261000,0.0000
215.158.238.236,<->,159.137.139.94,1,1309,0,0,1,1309,1.650199000,0.0000
109.214.180.166,<->,8.52.222.23,0,0,1,798,1,798,1.650137000,0.0000
204.187.24.163,<->,136.25.188.220,0,0,1,602,1,602,1.650071000,0.0000
202.33.235.80,<->,136.25.188.225,0,0,1,602,1,602,1.650004000,0.0000
114.251.240.197,<->,50.224.76.248,0,0,1,1417,1,1417,1.649621000,0.0000
143.155.227.59,<->,136.25.188.44,0,0,1,1117,1,1117,1.649465000,0.0000
215.158.239.87,<->,6.73.9.162,1,1373,0,0,1,1373,1.649204000,0.0000
215.158.238.198,<->,126.219.246.252,1,1181,0,0,1,1181,1.649153000,0.0000
98.236.238.137,<->,27.11.22.41,1,374,0,0,1,374,1.648904000,0.0000
215.158.239.233,<->,100.244.13.26,1,109,0,0,1,109,1.648809000,0.0000
215.158.238.134,<->,8.40.50.245,1,973,0,0,1,973,1.648714000,0.0000
143.53.79.89,<->,136.25.188.242,0,0,1,87,1,87,1.647973000,0.0000
206.89.65.36,<->,133.178.227.16,0,0,1,1086,1,1086,1.647891000,0.0000
222.65.18.127,<->,89.90.107.0,1,75,0,0,1,75,1.647726000,0.0000
148.23.229.100,<->,133.178.226.7,0,0,1,1437,1,1437,1.647454000,0.0000
133.178.227.27,<->,29.211.122.238,1,1108,0,0,1,1108,1.647217000,0.0000
80.42.191.110,<->,38.65.192.57,1,124,0,0,1,124,1.646854000,0.0000
143.224.177.3,<->,0.195.210.46,0,0,1,119,1,119,1.646697000,0.0000
215.158.239.101,<->,133.146.0.44,1,389,0,0,1,389,1.646679000,0.0000
215.158.239.95,<->,204.56.133.222,1,602,0,0,1,602,1.646590000,0.0000
136.25.188.44,<->,8.222.212.27,1,1117,0,0,1,1117,1.646483000,0.0000
133.73.194.38,<->,80.40.58.90,0,0,1,1135,1,1135,1.646141000,0.0000
210.226.165.189,<->,53.244.1.230,1,87,0,0,1,87,1.645994000,0.0000
215.158.239.93,<->,199.20.31.160,1,266,0,0,1,266,1.645917000,0.0000
215.158.140.230,<->,83.245.80.251,1,97,0,0,1,97,1.645890000,0.0000
215.158.239.92,<->,8.47.120.147,1,1293,0,0,1,1293,1.645515000,0.0000
220.20.200.7,<->,127.255.84.41,1,573,0,0,1,573,1.645455000,0.0000
215.158.239.127,<->,215.158.61.243,1,1388,0,0,1,1388,1.645293000,0.0000
17.61.4.176,<->,8.52.177.123,0,0,1,426,1,426,1.644922000,0.0000
215.158.61.202,<->,8.176.8.196,0,0,1,493,1,493,1.644754000,0.0000
215.158.140.76,<->,29.214.109.138,1,1083,0,0,1,1083,1.644720000,0.0000
215.158.239.84,<->,196.94.112.17,1,602,0,0,1,602,1.644610000,0.0000
205.127.108.114,<->,33.233.141.0,0,0,1,324,1,324,1.644472000,0.0000
133.178.227.76,<->,57.199.251.51,1,1389,0,0,1,1389,1.644466000,0.0000
213.21.35.44,<->,8.220.176.253,0,0,1,345,1,345,1.644275000,0.0000
239.66.110.113,<->,203.215.177.34,0,0,1,473,1,473,1.644053000,0.0000
215.158.140.19,<->,215.158.61.145,1,1406,0,0,1,1406,1.643586000,0.0000
215.158.238.73,<->,8.252.214.53,1,1325,0,0,1,1325,1.643461000,0.0000
17.192.237.19,<->,8.220.234.159,0,0,1,529,1,529,1.643453000,0.0000
192.67.168.13,<->,57.41.114.237,1,124,0,0,1,124,1.643109000,0.0000
133.178.226.93,<->,98.219.126.140,1,88,0,0,1,88,1.643001000,0.0000
100.174.6.88,<->,8.182.248.147,0,0,1,81,1,81,1.642959000,0.0000
215.158.239.48,<->,207.236.222.236,1,717,0,0,1,717,1.642578000,0.0000
221.102.143.189,<->,102.81.178.78,0,0,1,141,1,141,1.642501000,0.0000
215.158.238.114,<->,29.211.186.213,1,1309,0,0,1,1309,1.642109000,0.0000
194.232.165.179,<->,136.25.188.175,0,0,1,765,1,765,1.642020000,0.0000
126.198.149.124,<->,80.42.169.232,0,0,1,341,1,341,1.641905000,0.0000
94.192.19.253,<->,8.252.221.199,0,0,1,310,1,310,1.641826000,0.0000
200.175.72.206,<->,54.92.112.61,1,244,0,0,1,244,1.641642000,0.0000
215.158.239.108,<->,215.158.61.145,1,405,0,0,1,405,1.641607000,0.0000
207.179.171.123,<->,50.223.3.228,0,0,1,295,1,295,1.641393000,0.0000
100.206.88.223,<->,92.162.253.223,0,0,1,75,1,75,1.641299000,0.0000
195.70.16.90,<->,136.25.188.163,0,0,1,573,1,573,1.641242000,0.0000
215.158.238.123,<->,56.102.22.3,1,629,0,0,1,629,1.640913000,0.0000
192.224.21.11,<->,136.25.189.32,0,0,1,1405,1,1405,1.640850000,0.0000
136.141.149.197,<->,111.146.248.118,0,0,1,245,1,245,1.640600000,0.0000
199.54.0.36,<->,50.223.3.228,0,0,1,228,1,228,1.638950000,0.0000
133.54.17.198,<->,89.183.98.97,1,552,0,0,1,552,1.638807000,0.0000
210.209.251.214,<->,111.146.163.17,0,0,1,369,1,369,1.638639000,0.0000
201.139.255.95,<->,8.252.221.205,0,0,1,452,1,452,1.637612000,0.0000
112.208.20.199,<->,6.72.11.112,0,0,1,50,1,50,1.637381000,0.0000
215.158.239.32,<->,80.57.141.190,1,1208,0,0,1,1208,1.637239000,0.0000
139.193.141.139,<->,50.53.223.140,1,484,0,0,1,484,1.637028000,0.0000
126.198.147.25,<->,100.94.191.192,0,0,1,425,1,425,1.636679000,0.0000
199.70.201.244,<->,136.25.188.53,0,0,1,101,1,101,1.636515000,0.0000
145.89.42.24,<->,8.204.66.217,1,141,0,0,1,141,1.636384000,0.0000
215.158.140.14,<->,192.224.146.99,1,1220,0,0,1,1220,1.636297000,0.0000
215.158.239.85,<->,199.39.190.65,1,307,0,0,1,307,1.635749000,0.0000
143.134.237.58,<->,136.25.188.252,0,0,1,240,1,240,1.635631000,0.0000
215.158.239.58,<->,207.56.41.2,1,561,0,0,1,561,1.635416000,0.0000
197.7.105.245,<->,139.163.23.75,0,0,1,104,1,104,1.635135000,0.0000
133.178.227.238,<->,111.150.207.137,1,100,0,0,1,100,1.634975000,0.0000
215.158.140.92,<->,119.196.23.111,1,1085,0,0,1,1085,1.634752000,0.0000
6.145.169.23,<->,0.195.210.44,0,0,1,109,1,109,1.634685000,0.0000
220.28.114.28,<->,215.158.238.116,0,0,1,1398,1,1398,1.634412000,0.0000
93.181.154.21,<->,92.27.219.193,0,0,1,474,1,474,1.634065000,0.0000
215.158.238.81,<->,146.10.166.74,1,1165,0,0,1,1165,1.634056000,0.0000
133.178.227.24,<->,8.188.227.24,1,1082,0,0,1,1082,1.633768000,0.0000
252.72.198.243,<->,53.148.22.141,1,125,0,0,1,125,1.633622000,0.0000
8.222.49.195,<->,6.73.247.55,0,0,1,533,1,533,1.633439000,0.0000
136.25.189.27,<->,98.219.126.140,1,156,0,0,1,156,1.633197000,0.0000
136.25.188.254,<->,131.144.113.219,1,1261,0,0,1,1261,1.632278000,0.0000
133.178.226.28,<->,29.213.218.232,1,1133,0,0,1,1133,1.632159000,0.0000
196.113.189.197,<->,0.195.210.46,0,0,1,877,1,877,1.631895000,0.0000
215.158.238.120,<->,204.123.232.197,1,1325,0,0,1,1325,1.631866000,0.0000
215.158.61.243,<->,8.176.8.194,0,0,1,429,1,429,1.631809000,0.0000
194.232.230.2,<->,136.25.188.176,0,0,1,561,1,561,1.631809000,0.0000
215.158.140.76,<->,113.23.14.135,1,1397,0,0,1,1397,1.631588000,0.0000
215.158.140.93,<->,8.42.42.188,1,1198,0,0,1,1198,1.630887000,0.0000
215.158.61.209,<->,8.252.222.200,0,0,1,377,1,377,1.630434000,0.0000
144.85.170.208,<->,98.87.147.120,1,694,0,0,1,694,1.630236000,0.0000
215.158.239.87,<->,196.94.15.50,1,240,0,0,1,240,1.630096000,0.0000
17.39.170.244,<->,8.220.234.159,0,0,1,522,1,522,1.629736000,0.0000
210.229.230.20,<->,100.153.170.193,1,68,0,0,1,68,1.629371000,0.0000
207.162.182.125,<->,8.182.230.134,0,0,1,265,1,265,1.629052000,0.0000
221.254.174.158,<->,145.18.221.98,0,0,1,307,1,307,1.629024000,0.0000
136.25.188.236,<->,122.159.245.163,1,1341,0,0,1,1341,1.628516000,0.0000
215.158.239.84,<->,199.20.31.19,1,602,0,0,1,602,1.628449000,0.0000
129.92.117.26,<->,53.240.224.93,1,193,0,0,1,193,1.628406000,0.0000
89.183.110.72,<->,0.70.165.139,1,862,0,0,1,862,1.628341000,0.0000
215.158.238.250,<->,57.31.50.233,1,1191,0,0,1,1191,1.628301000,0.0000
136.25.189.1,<->,122.159.245.58,1,1165,0,0,1,1165,1.627746000,0.0000
215.158.239.5,<->,6.73.247.151,1,1279,0,0,1,1279,1.627666000,0.0000
54.59.235.248,<->,48.53.135.101,0,0,1,113,1,113,1.627433000,0.0000
101.87.156.153,<->,100.228.42.52,0,0,1,577,1,577,1.627261000,0.0000
215.158.140.241,<->,29.212.42.227,1,1045,0,0,1,1045,1.626968000,0.0000
199.70.204.12,<->,136.25.188.198,0,0,1,269,1,269,1.626931000,0.0000
152.46.106.237,<->,136.25.189.83,0,0,1,1325,1,1325,1.626848000,0.0000
215.158.239.49,<->,199.20.31.113,1,602,0,0,1,602,1.626661000,0.0000
215.158.238.133,<->,111.150.34.246,1,1437,0,0,1,1437,1.626500000,0.0000
133.178.227.4,<->,111.151.142.210,1,100,0,0,1,100,1.626334000,0.0000
215.158.239.6,<->,96.135.154.110,1,161,0,0,1,161,1.626002000,0.0000
133.178.227.27,<->,104.3.168.53,1,1085,0,0,1,1085,1.625821000,0.0000
231.140.223.134,<->,136.25.188.174,0,0,1,602,1,602,1.625701000,0.0000
111.151.109.19,<->,8.176.8.176,0,0,1,100,1,100,1.625458000,0.0000
215.158.239.85,<->,141.39.23.69,1,1357,0,0,1,1357,1.625369000,0.0000
215.158.238.75,<->,113.23.104.203,1,1261,0,0,1,1261,1.625271000,0.0000
97.43.55.64,<->,50.223.3.230,0,0,1,353,1,353,1.625094000,0.0000
195.124.55.155,<->,136.25.188.226,0,0,1,773,1,773,1.625068000,0.0000
133.32.39.1,<->,80.47.188.76,1,247,0,0,1,247,1.624834000,0.0000
204.130.158.101,<->,0.195.210.44,0,0,1,93,1,93,1.624602000,0.0000
221.102.56.69,<->,80.41.212.50,0,0,1,294,1,294,1.624567000,0.0000
133.178.226.29,<->,129.175.139.60,1,1221,0,0,1,1221,1.624508000,0.0000
148.240.82.247,<->,0.195.210.46,0,0,1,240,1,240,1.623640000,0.0000
199.122.49.168,<->,136.25.188.225,0,0,1,765,1,765,1.623188000,0.0000
248.239.155.247,<->,221.102.56.69,1,294,0,0,1,294,1.623115000,0.0000
215.158.239.41,<->,114.142.109.167,1,63,0,0,1,63,1.622323000,0.0000
215.158.239.87,<->,142.166.51.22,1,168,0,0,1,168,1.621862000,0.0000
221.196.123.25,<->,136.25.188.226,0,0,1,333,1,333,1.621745000,0.0000
220.39.233.120,<->,215.158.238.45,0,0,1,1021,1,1021,1.621661000,0.0000
215.158.61.243,<->,136.25.188.29,0,0,1,509,1,509,1.621640000,0.0000
235.42.34.23,<->,136.25.188.173,0,0,1,1325,1,1325,1.621561000,0.0000
133.178.227.57,<->,120.20.132.20,1,1213,0,0,1,1213,1.621355000,0.0000
144.71.44.80,<->,114.186.157.236,1,112,0,0,1,112,1.621320000,0.0000
215.158.238.140,<->,148.123.222.73,1,1101,0,0,1,1101,1.620859000,0.0000
215.158.239.122,<->,215.158.61.202,1,947,0,0,1,947,1.620667000,0.0000
133.178.226.60,<->,131.36.198.32,1,1325,0,0,1,1325,1.620518000,0.0000
129.148.0.173,<->,50.224.76.234,0,0,1,431,1,431,1.620512000,0.0000
215.158.238.65,<->,131.1.253.248,1,1228,0,0,1,1228,1.620307000,0.0000
207.88.64.72,<->,133.178.226.77,0,0,1,1357,1,1357,1.620192000,0.0000
144.85.170.208,<->,98.87.144.89,1,381,0,0,1,381,1.620072000,0.0000
215.158.239.77,<->,8.252.253.225,1,1197,0,0,1,1197,1.620045000,0.0000
215.158.239.0,<->,53.246.26.228,1,1438,0,0,1,1438,1.620021000,0.0000
241.75.160.2,<->,221.102.113.250,0,0,1,456,1,456,1.619982000,0.0000
145.242.126.124,<->,33.218.92.101,1,214,0,0,1,214,1.619649000,0.0000
195.61.150.70,<->,50.223.3.228,0,0,1,212,1,212,1.619532000,0.0000
192.64.239.241,<->,149.71.254.200,1,412,0,0,1,412,1.619069000,0.0000
156.165.37.100,<->,136.25.189.15,0,0,1,1101,1,1101,1.619020000,0.0000
246.253.253.107,<->,89.152.226.82,1,93,0,0,1,93,1.618813000,0.0000
194.237.23.184,<->,136.25.188.255,0,0,1,749,1,749,1.618520000,0.0000
133.178.226.37,<->,131.6.152.20,1,1277,0,0,1,1277,1.618472000,0.0000
133.178.227.242,<->,111.151.237.189,1,421,0,0,1,421,1.618110000,0.0000
139.148.158.59,<->,8.182.224.87,0,0,1,988,1,988,1.617731000,0.0000
215.158.238.66,<->,140.145.218.196,1,1085,0,0,1,1085,1.617679000,0.0000
133.178.226.76,<->,57.210.107.36,1,264,0,0,1,264,1.617451000,0.0000
246.44.56.126,<->,69.149.14.34,1,302,0,0,1,302,1.617213000,0.0000
199.51.158.15,<->,136.25.188.238,0,0,1,234,1,234,1.617022000,0.0000
215.158.238.221,<->,48.131.158.225,1,1085,0,0,1,1085,1.616905000,0.0000
69.103.121.183,<->,8.252.221.220,0,0,1,206,1,206,1.616273000,0.0000
204.184.41.206,<->,136.25.188.178,0,0,1,602,1,602,1.616106000,0.0000
215.158.238.236,<->,131.36.105.38,1,1331,0,0,1,1331,1.615769000,0.0000
114.41.220.60,<->,80.40.69.41,0,0,1,69,1,69,1.615715000,0.0000
199.82.251.207,<->,136.25.188.253,0,0,1,95,1,95,1.615428000,0.0000
139.163.96.93,<->,57.0.121.217,1,353,0,0,1,353,1.615323000,0.0000
212.70.217.124,<->,136.25.189.13,0,0,1,1373,1,1373,1.614858000,0.0000
144.72.193.201,<->,100.93.246.58,0,0,1,664,1,664,1.614818000,0.0000
149.250.116.33,<->,133.178.227.208,0,0,1,1309,1,1309,1.614336000,0.0000
215.158.238.66,<->,131.1.253.251,1,1330,0,0,1,1330,1.613701000,0.0000
215.158.239.70,<->,125.84.55.40,1,1245,0,0,1,1245,1.613327000,0.0000
192.226.161.53,<->,136.25.188.55,0,0,1,1213,1,1213,1.612756000,0.0000
203.212.35.24,<->,50.224.76.230,0,0,1,1237,1,1237,1.612752000,0.0000
215.158.238.84,<->,145.116.209.80,1,506,0,0,1,506,1.612594000,0.0000
136.25.189.14,<->,123.166.46.231,1,1197,0,0,1,1197,1.612397000,0.0000
215.158.238.23,<->,131.1.194.204,1,1469,0,0,1,1469,1.612005000,0.0000
199.15.158.230,<->,136.25.188.178,0,0,1,602,1,602,1.611902000,0.0000
200.175.211.132,<->,53.200.51.184,1,285,0,0,1,285,1.611894000,0.0000
195.40.126.203,<->,136.25.188.253,0,0,1,829,1,829,1.611450000,0.0000
133.178.227.2,<->,8.191.14.84,1,1366,0,0,1,1366,1.611394000,0.0000
112.97.29.171,<->,80.41.18.10,0,0,1,161,1,161,1.611302000,0.0000
145.116.118.171,<->,50.238.216.205,1,644,0,0,1,644,1.610835000,0.0000
213.186.52.58,<->,144.85.170.208,0,0,1,836,1,836,1.609870000,0.0000
136.129.94.157,<->,111.199.230.0,1,414,0,0,1,414,1.609811000,0.0000
133.178.226.37,<->,8.255.92.203,1,1357,0,0,1,1357,1.609235000,0.0000
94.192.236.19,<->,8.252.221.205,0,0,1,452,1,452,1.609074000,0.0000
122.108.105.69,<->,80.40.37.199,0,0,1,537,1,537,1.609035000,0.0000
133.178.226.7,<->,80.47.111.74,1,1165,0,0,1,1165,1.608979000,0.0000
215.158.238.104,<->,64.152.12.41,1,1373,0,0,1,1373,1.608758000,0.0000
215.158.239.41,<->,57.227.82.181,1,1404,0,0,1,1404,1.608735000,0.0000
111.147.98.205,<->,54.38.63.88,1,167,0,0,1,167,1.608551000,0.0000
215.158.238.47,<->,57.184.236.91,1,1165,0,0,1,1165,1.608043000,0.0000
133.178.226.90,<->,61.72.108.214,1,1213,0,0,1,1213,1.607717000,0.0000
133.178.226.19,<->,115.140.139.154,1,1309,0,0,1,1309,1.607533000,0.0000
215.158.238.65,<->,122.29.158.174,1,1213,0,0,1,1213,1.607140000,0.0000
210.209.251.211,<->,111.146.143.217,0,0,1,118,1,118,1.606787000,0.0000
133.178.226.37,<->,69.31.238.37,1,1357,0,0,1,1357,1.606563000,0.0000
243.117.93.143,<->,220.55.100.127,0,0,1,1343,1,1343,1.606375000,0.0000
215.158.238.251,<->,8.221.197.170,1,1085,0,0,1,1085,1.606293000,0.0000
192.64.202.25,<->,14.30.152.14,1,234,0,0,1,234,1.605861000,0.0000
111.150.207.112,<->,8.252.222.106,0,0,1,100,1,100,1.605829000,0.0000
133.8.10.152,<->,33.233.141.29,0,0,1,548,1,548,1.605658000,0.0000
98.3.249.220,<->,92.27.219.207,0,0,1,1396,1,1396,1.605561000,0.0000
207.173.191.9,<->,92.27.194.147,0,0,1,249,1,249,1.604731000,0.0000
136.25.188.232,<->,98.219.126.140,1,720,0,0,1,720,1.603098000,0.0000
215.158.239.93,<->,196.91.145.97,1,117,0,0,1,117,1.602902000,0.0000
204.200.51.85,<->,136.25.188.255,0,0,1,765,1,765,1.602416000,0.0000
139.192.40.145,<->,8.52.181.50,0,0,1,578,1,578,1.602380000,0.0000
196.88.147.90,<->,136.25.188.253,0,0,1,561,1,561,1.602261000,0.0000
215.158.238.105,<->,139.161.104.130,1,165,0,0,1,165,1.602144000,0.0000
50.54.40.210,<->,8.220.176.253,0,0,1,467,1,467,1.601730000,0.0000
159.37.0.186,<->,145.116.119.49,0,0,1,107,1,107,1.601667000,0.0000
50.224.80.64,<->,46.42.250.238,1,753,0,0,1,753,1.601470000,0.0000
148.55.210.212,<->,133.178.227.16,0,0,1,1034,1,1034,1.601376000,0.0000
215.158.239.51,<->,8.249.253.232,1,1373,0,0,1,1373,1.601367000,0.0000
139.193.141.139,<->,57.141.31.210,1,385,0,0,1,385,1.601332000,0.0000
133.178.226.30,<->,56.102.22.9,1,133,0,0,1,133,1.601233000,0.0000
136.25.189.202,<->,96.135.155.57,1,514,0,0,1,514,1.600923000,0.0000
126.109.2.56,<->,50.224.76.248,0,0,1,416,1,416,1.600738000,0.0000
199.70.39.110,<->,136.25.188.236,0,0,1,304,1,304,1.600702000,0.0000
126.198.149.124,<->,8.228.215.194,0,0,1,342,1,342,1.600696000,0.0000
215.158.140.92,<->,131.144.116.36,1,1408,0,0,1,1408,1.600676000,0.0000
8.252.221.221,<->,4.121.204.128,1,686,0,0,1,686,1.600471000,0.0000
215.158.239.99,<->,196.0.232.99,1,87,0,0,1,87,1.600117000,0.0000
122.216.233.104,<->,8.252.222.185,0,0,1,1117,1,1117,1.600110000,0.0000
98.67.150.9,<->,54.54.217.193,1,988,0,0,1,988,1.600097000,0.0000
196.89.195.65,<->,136.25.188.226,0,0,1,602,1,602,1.600091000,0.0000
139.193.141.139,<->,127.187.184.88,1,623,0,0,1,623,1.599964000,0.0000
221.102.121.24,<->,192.195.91.232,1,205,0,0,1,205,1.599927000,0.0000
114.183.125.131,<->,50.224.76.235,0,0,1,540,1,540,1.599694000,0.0000
215.158.238.248,<->,113.92.150.218,1,1271,0,0,1,1271,1.599626000,0.0000
139.163.41.95,<->,105.78.59.95,1,615,0,0,1,615,1.599454000,0.0000
97.80.4.236,<->,8.182.226.24,0,0,1,848,1,848,1.599380000,0.0000
133.178.226.28,<->,120.54.127.12,1,1261,0,0,1,1261,1.598664000,0.0000
119.86.172.235,<->,50.224.76.234,0,0,1,459,1,459,1.597780000,0.0000
215.158.238.134,<->,128.23.167.168,1,1325,0,0,1,1325,1.597720000,0.0000
215.158.239.78,<->,8.222.98.57,1,1229,0,0,1,1229,1.597645000,0.0000
215.158.238.240,<->,122.158.245.36,1,1210,0,0,1,1210,1.597603000,0.0000
50.145.94.82,<->,48.55.120.172,0,0,1,110,1,110,1.597341000,0.0000
136.25.188.162,<->,29.214.71.116,1,1197,0,0,1,1197,1.597298000,0.0000
143.227.65.253,<->,133.178.227.14,0,0,1,1229,1,1229,1.596521000,0.0000
136.25.189.13,<->,119.168.0.26,1,1357,0,0,1,1357,1.596420000,0.0000
136.25.189.81,<->,8.33.226.59,1,1373,0,0,1,1373,1.596248000,0.0000
215.158.140.60,<->,104.3.168.52,1,1056,0,0,1,1056,1.596233000,0.0000
215.158.239.96,<->,194.199.197.57,1,93,0,0,1,93,1.596138000,0.0000
215.158.239.96,<->,143.89.246.104,1,272,0,0,1,272,1.596007000,0.0000
195.124.216.84,<->,136.25.188.173,0,0,1,256,1,256,1.595675000,0.0000
136.25.188.161,<->,131.178.248.230,1,1181,0,0,1,1181,1.595550000,0.0000
8.49.69.216,<->,6.74.82.148,0,0,1,382,1,382,1.595535000,0.0000
100.80.61.12,<->,50.224.76.234,0,0,1,685,1,685,1.595465000,0.0000
215.158.239.49,<->,204.2.135.179,1,1099,0,0,1,1099,1.595446000,0.0000
146.234.124.46,<->,0.195.210.8,0,0,1,408,1,408,1.595274000,0.0000
229.45.205.24,<->,222.20.211.148,1,823,0,0,1,823,1.595205000,0.0000
220.20.200.84,<->,144.83.60.153,1,880,0,0,1,880,1.594949000,0.0000
215.158.239.76,<->,194.203.253.208,1,87,0,0,1,87,1.594789000,0.0000
48.131.159.5,<->,8.252.222.204,0,0,1,1245,1,1245,1.594709000,0.0000
80.38.8.26,<->,46.44.235.228,1,557,0,0,1,557,1.594407000,0.0000
35.63.129.87,<->,8.252.221.171,0,0,1,1445,1,1445,1.593081000,0.0000
215.158.238.241,<->,89.76.109.244,1,1357,0,0,1,1357,1.593059000,0.0000
215.158.61.227,<->,97.126.31.73,0,0,1,304,1,304,1.592539000,0.0000
215.158.238.33,<->,131.1.195.220,1,1213,0,0,1,1213,1.592483000,0.0000
109.119.182.234,<->,8.182.235.52,0,0,1,231,1,231,1.592450000,0.0000
97.149.111.99,<->,53.245.244.92,1,257,0,0,1,257,1.592341000,0.0000
106.186.90.127,<->,102.50.102.153,0,0,1,51,1,51,1.592133000,0.0000
204.1.195.12,<->,136.25.188.236,0,0,1,107,1,107,1.591762000,0.0000
215.158.238.65,<->,106.188.251.205,1,1261,0,0,1,1261,1.591590000,0.0000
215.158.239.49,<->,199.72.88.152,1,272,0,0,1,272,1.591570000,0.0000
215.158.239.58,<->,199.106.118.136,1,856,0,0,1,856,1.591246000,0.0000
97.203.38.177,<->,8.182.252.86,0,0,1,661,1,661,1.590880000,0.0000
145.176.8.232,<->,80.41.248.200,0,0,1,312,1,312,1.590853000,0.0000
215.158.239.43,<->,122.158.239.9,1,62,0,0,1,62,1.590851000,0.0000
215.158.239.33,<->,106.188.156.152,1,1470,0,0,1,1470,1.590792000,0.0000
204.184.17.86,<->,136.25.188.225,0,0,1,172,1,172,1.590586000,0.0000
109.222.211.206,<->,53.148.173.60,1,272,0,0,1,272,1.590265000,0.0000
142.255.231.1,<->,136.25.188.236,0,0,1,117,1,117,1.590175000,0.0000
215.158.61.243,<->,8.176.8.201,0,0,1,429,1,429,1.590040000,0.0000
204.62.134.29,<->,136.25.188.178,0,0,1,93,1,93,1.589959000,0.0000
197.113.99.127,<->,136.25.188.255,0,0,1,240,1,240,1.589956000,0.0000
215.158.238.32,<->,29.213.195.69,1,373,0,0,1,373,1.589653000,0.0000
143.72.126.147,<->,136.25.188.176,0,0,1,295,1,295,1.589348000,0.0000
133.178.227.79,<->,126.219.102.63,1,1186,0,0,1,1186,1.589318000,0.0000
194.237.14.1,<->,136.25.188.241,0,0,1,678,1,678,1.589195000,0.0000
215.158.239.56,<->,199.20.28.27,1,602,0,0,1,602,1.589150000,0.0000
111.151.142.231,<->,101.65.255.235,0,0,1,100,1,100,1.589003000,0.0000
136.25.188.163,<->,119.196.23.69,1,1325,0,0,1,1325,1.588799000,0.0000
200.174.205.199,<->,54.58.252.179,1,88,0,0,1,88,1.588660000,0.0000
133.178.226.61,<->,113.23.104.246,1,1213,0,0,1,1213,1.588253000,0.0000
215.158.238.123,<->,69.150.169.224,1,1133,0,0,1,1133,1.587699000,0.0000
112.164.79.122,<->,8.252.223.140,0,0,1,1053,1,1053,1.587596000,0.0000
221.102.143.189,<->,192.64.92.213,0,0,1,141,1,141,1.587533000,0.0000
133.178.226.213,<->,115.162.222.216,1,145,0,0,1,145,1.587412000,0.0000
197.125.110.229,<->,136.25.189.0,0,0,1,1485,1,1485,1.587401000,0.0000
111.150.207.168,<->,8.252.221.194,0,0,1,100,1,100,1.586612000,0.0000
144.85.170.208,<->,91.69.185.225,1,751,0,0,1,751,1.586367000,0.0000
215.158.239.240,<->,215.158.3.190,1,589,0,0,1,589,1.586237000,0.0000
204.60.160.33,<->,136.25.188.227,0,0,1,107,1,107,1.586089000,0.0000
142.254.6.200,<->,136.25.188.253,0,0,1,97,1,97,1.585812000,0.0000
136.25.188.198,<->,95.90.181.60,1,284,0,0,1,284,1.585575000,0.0000
136.25.188.173,<->,73.179.110.89,1,237,0,0,1,237,1.585370000,0.0000
213.221.90.185,<->,144.85.170.208,0,0,1,766,1,766,1.585280000,0.0000
204.63.107.30,<->,136.25.188.52,0,0,1,87,1,87,1.585107000,0.0000
145.48.251.10,<->,133.178.227.247,0,0,1,873,1,873,1.584572000,0.0000
215.158.239.96,<->,199.20.30.131,1,602,0,0,1,602,1.584469000,0.0000
142.227.251.30,<->,136.25.188.176,0,0,1,93,1,93,1.584015000,0.0000
215.158.238.148,<->,113.92.151.118,1,1033,0,0,1,1033,1.583512000,0.0000
72.212.0.209,<->,0.195.210.42,0,0,1,97,1,97,1.583173000,0.0000
92.27.219.203,<->,78.46.49.242,1,141,0,0,1,141,1.583067000,0.0000
215.158.239.33,<->,149.96.53.39,1,1492,0,0,1,1492,1.582955000,0.0000
130.77.160.72,<->,8.252.222.71,0,0,1,60,1,60,1.582488000,0.0000
215.158.238.133,<->,133.73.194.9,1,1005,0,0,1,1005,1.582274000,0.0000
8.182.244.19,<->,6.21.248.46,1,653,0,0,1,653,1.582258000,0.0000
213.21.35.44,<->,8.220.191.251,0,0,1,432,1,432,1.582075000,0.0000
97.199.179.77,<->,53.148.22.166,1,125,0,0,1,125,1.581895000,0.0000
246.253.145.63,<->,143.102.51.178,1,313,0,0,1,313,1.581818000,0.0000
111.146.139.157,<->,53.148.24.110,1,125,0,0,1,125,1.581793000,0.0000
129.92.116.243,<->,56.121.22.175,1,782,0,0,1,782,1.581657000,0.0000
142.254.6.200,<->,136.25.188.252,0,0,1,97,1,97,1.581606000,0.0000
215.158.238.141,<->,104.3.169.122,1,1149,0,0,1,1149,1.581131000,0.0000
153.111.155.23,<->,8.252.221.198,0,0,1,452,1,452,1.581032000,0.0000
235.42.34.54,<->,133.178.226.37,0,0,1,1341,1,1341,1.580547000,0.0000
215.158.238.121,<->,48.131.156.26,1,1373,0,0,1,1373,1.580269000,0.0000
133.178.226.19,<->,126.219.190.132,1,1197,0,0,1,1197,1.580096000,0.0000
243.49.81.44,<->,239.227.127.252,0,0,1,244,1,244,1.580083000,0.0000
215.158.238.221,<->,48.131.157.3,1,1213,0,0,1,1213,1.579913000,0.0000
111.151.109.46,<->,8.252.223.247,0,0,1,100,1,100,1.579873000,0.0000
133.178.227.14,<->,57.184.236.83,1,1046,0,0,1,1046,1.579713000,0.0000
215.158.239.59,<->,119.168.0.57,1,1245,0,0,1,1245,1.579700000,0.0000
215.158.238.65,<->,126.219.196.169,1,1261,0,0,1,1261,1.579660000,0.0000
215.158.140.75,<->,139.163.163.174,1,1081,0,0,1,1081,1.579066000,0.0000
136.25.189.34,<->,96.156.169.255,1,1072,0,0,1,1072,1.578956000,0.0000
64.104.131.193,<->,58.43.188.27,1,726,0,0,1,726,1.578940000,0.0000
129.78.114.117,<->,117.50.180.99,1,417,0,0,1,417,1.576585000,0.0000
215.158.239.56,<->,199.20.29.117,1,365,0,0,1,365,1.576291000,0.0000
199.122.47.69,<->,136.25.188.237,0,0,1,562,1,562,1.576096000,0.0000
215.158.239.84,<->,207.59.48.166,1,305,0,0,1,305,1.576016000,0.0000
195.70.122.241,<->,136.25.188.209,0,0,1,602,1,602,1.575778000,0.0000
215.158.239.84,<->,199.20.29.25,1,101,0,0,1,101,1.575757000,0.0000
215.158.140.181,<->,100.224.243.72,1,654,0,0,1,654,1.575008000,0.0000
127.255.92.200,<->,80.41.42.142,0,0,1,1404,1,1404,1.574909000,0.0000
204.200.50.113,<->,136.25.188.46,0,0,1,132,1,132,1.574848000,0.0000
215.158.61.189,<->,8.176.8.224,0,0,1,326,1,326,1.574443000,0.0000
98.67.155.63,<->,53.176.119.172,1,125,0,0,1,125,1.573979000,0.0000
207.64.65.44,<->,50.223.3.230,0,0,1,415,1,415,1.573684000,0.0000
215.158.238.93,<->,42.134.254.0,1,1165,0,0,1,1165,1.572886000,0.0000
136.25.188.232,<->,0.195.253.228,1,478,0,0,1,478,1.572676000,0.0000
215.158.239.101,<->,215.158.61.202,1,736,0,0,1,736,1.572643000,0.0000
215.158.239.49,<->,207.16.229.237,1,117,0,0,1,117,1.572362000,0.0000
139.193.141.139,<->,98.129.146.202,1,439,0,0,1,439,1.572325000,0.0000
215.158.239.87,<->,207.115.17.112,1,378,0,0,1,378,1.572121000,0.0000
215.158.239.56,<->,199.14.12.169,1,801,0,0,1,801,1.571950000,0.0000
199.38.118.82,<->,136.25.188.237,0,0,1,736,1,736,1.571874000,0.0000
133.178.227.255,<->,29.211.122.31,1,781,0,0,1,781,1.571858000,0.0000
133.178.227.16,<->,114.171.18.224,1,1033,0,0,1,1033,1.570584000,0.0000
136.25.189.83,<->,125.84.55.12,1,1373,0,0,1,1373,1.570537000,0.0000
215.158.238.112,<->,159.23.130.167,1,1165,0,0,1,1165,1.570522000,0.0000
99.187.125.121,<->,8.20.87.8,0,0,1,1009,1,1009,1.570513000,0.0000
204.63.69.130,<->,136.25.188.53,0,0,1,825,1,825,1.570130000,0.0000
111.146.226.14,<->,111.5.197.195,1,404,0,0,1,404,1.570088000,0.0000
68.75.140.160,<->,8.252.221.223,0,0,1,257,1,257,1.569978000,0.0000
94.194.69.2,<->,8.252.221.205,0,0,1,456,1,456,1.569683000,0.0000
215.158.239.49,<->,196.90.198.150,1,260,0,0,1,260,1.569586000,0.0000
215.158.238.223,<->,8.50.171.191,1,1389,0,0,1,1389,1.569523000,0.0000
220.38.162.73,<->,215.158.140.163,0,0,1,1422,1,1422,1.569049000,0.0000
215.158.239.48,<->,195.54.81.44,1,632,0,0,1,632,1.568996000,0.0000
206.103.215.203,<->,136.25.189.30,0,0,1,1357,1,1357,1.568979000,0.0000
215.158.239.48,<->,204.2.156.176,1,653,0,0,1,653,1.568809000,0.0000
143.10.103.63,<->,136.25.188.241,0,0,1,93,1,93,1.568469000,0.0000
199.71.117.99,<->,136.25.188.222,0,0,1,561,1,561,1.568197000,0.0000
215.158.238.67,<->,120.154.221.218,1,1197,0,0,1,1197,1.568137000,0.0000
133.178.227.16,<->,18.202.90.199,1,1032,0,0,1,1032,1.567866000,0.0000
227.229.33.126,<->,92.168.217.141,0,0,1,314,1,314,1.567674000,0.0000
129.78.115.95,<->,116.96.63.23,1,1031,0,0,1,1031,1.567650000,0.0000
215.158.238.142,<->,29.211.6.46,1,969,0,0,1,969,1.567068000,0.0000
136.25.189.202,<->,129.222.39.91,1,1144,0,0,1,1144,1.567062000,0.0000
136.25.189.12,<->,29.211.93.15,1,297,0,0,1,297,1.566585000,0.0000
122.158.179.41,<->,8.252.222.236,0,0,1,1101,1,1101,1.566584000,0.0000
215.158.140.185,<->,8.191.10.198,1,1181,0,0,1,1181,1.565634000,0.0000
215.158.239.57,<->,199.20.30.178,1,168,0,0,1,168,1.565612000,0.0000
112.208.20.199,<->,99.72.22.255,0,0,1,50,1,50,1.565605000,0.0000
220.55.72.171,<->,220.20.206.129,1,1298,0,0,1,1298,1.565514000,0.0000
249.101.211.202,<->,53.214.126.11,1,93,0,0,1,93,1.565289000,0.0000
136.25.189.57,<->,69.150.169.153,1,1357,0,0,1,1357,1.565239000,0.0000
133.178.226.196,<->,8.47.121.21,1,152,0,0,1,152,1.565082000,0.0000
215.158.61.191,<->,136.25.189.243,0,0,1,781,1,781,1.564774000,0.0000
241.75.192.120,<->,221.102.110.4,0,0,1,589,1,589,1.564579000,0.0000
215.158.238.83,<->,212.70.217.103,1,1341,0,0,1,1341,1.564282000,0.0000
215.158.61.202,<->,133.178.226.173,0,0,1,1179,1,1179,1.564251000,0.0000
133.178.227.16,<->,69.31.238.216,1,1043,0,0,1,1043,1.564063000,0.0000
93.191.36.129,<->,50.224.106.182,0,0,1,370,1,370,1.564026000,0.0000
215.158.238.82,<->,8.255.92.251,1,1121,0,0,1,1121,1.563975000,0.0000
133.178.226.29,<->,96.155.60.212,1,210,0,0,1,210,1.563938000,0.0000
136.25.188.254,<->,38.104.11.40,1,1325,0,0,1,1325,1.563323000,0.0000
136.25.188.226,<->,41.161.48.147,1,141,0,0,1,141,1.563128000,0.0000
143.10.103.63,<->,136.25.188.52,0,0,1,93,1,93,1.563018000,0.0000
204.185.111.190,<->,136.25.188.178,0,0,1,93,1,93,1.562902000,0.0000
50.224.76.235,<->,50.105.237.70,1,766,0,0,1,766,1.562050000,0.0000
139.148.142.18,<->,8.182.226.78,0,0,1,427,1,427,1.561861000,0.0000
192.226.161.85,<->,133.178.227.57,0,0,1,1087,1,1087,1.561357000,0.0000
192.171.32.152,<->,136.25.189.78,0,0,1,1229,1,1229,1.561314000,0.0000
221.102.123.190,<->,133.40.208.180,1,121,0,0,1,121,1.561304000,0.0000
207.162.137.19,<->,8.182.224.248,0,0,1,399,1,399,1.561237000,0.0000
215.158.239.78,<->,199.69.32.130,1,302,0,0,1,302,1.560923000,0.0000
215.158.238.74,<->,8.240.117.62,1,1245,0,0,1,1245,1.560653000,0.0000
245.158.27.7,<->,8.252.222.208,0,0,1,105,1,105,1.560423000,0.0000
143.135.13.76,<->,136.25.188.243,0,0,1,678,1,678,1.560240000,0.0000
215.158.239.48,<->,195.13.241.106,1,262,0,0,1,262,1.560118000,0.0000
210.229.230.20,<->,111.59.166.200,1,68,0,0,1,68,1.560100000,0.0000
144.83.60.153,<->,92.162.253.43,0,0,1,627,1,627,1.560038000,0.0000
215.158.238.148,<->,134.172.158.199,1,1261,0,0,1,1261,1.559498000,0.0000
136.25.188.172,<->,122.159.245.165,1,1117,0,0,1,1117,1.559017000,0.0000
204.186.42.147,<->,136.25.188.53,0,0,1,765,1,765,1.559008000,0.0000
207.59.81.196,<->,136.25.188.52,0,0,1,93,1,93,1.558765000,0.0000
215.158.238.92,<->,145.213.62.41,1,1261,0,0,1,1261,1.558708000,0.0000
213.186.61.2,<->,144.85.170.246,0,0,1,932,1,932,1.558667000,0.0000
215.158.239.50,<->,199.20.29.87,1,190,0,0,1,190,1.558623000,0.0000
220.38.162.62,<->,215.158.140.181,0,0,1,1418,1,1418,1.558595000,0.0000
139.163.96.94,<->,65.67.221.104,1,50,0,0,1,50,1.558294000,0.0000
215.158.239.69,<->,199.78.55.172,1,602,0,0,1,602,1.558108000,0.0000
48.129.132.210,<->,8.252.222.236,0,0,1,1437,1,1437,1.557893000,0.0000
215.158.239.95,<->,196.104.53.46,1,602,0,0,1,602,1.557700000,0.0000
207.173.31.171,<->,136.25.188.54,0,0,1,602,1,602,1.557393000,0.0000
215.158.140.241,<->,33.209.213.40,1,1083,0,0,1,1083,1.557022000,0.0000
133.178.226.70,<->,126.219.100.200,1,1245,0,0,1,1245,1.556914000,0.0000
215.158.239.76,<->,199.20.29.229,1,93,0,0,1,93,1.556387000,0.0000
200.174.143.130,<->,53.160.193.35,1,306,0,0,1,306,1.556220000,0.0000
215.158.239.50,<->,199.82.206.81,1,602,0,0,1,602,1.555909000,0.0000
215.158.239.82,<->,0.195.253.228,1,540,0,0,1,540,1.555525000,0.0000
215.201.235.99,<->,8.182.230.13,0,0,1,190,1,190,1.555289000,0.0000
215.158.238.148,<->,199.69.87.93,1,1117,0,0,1,1117,1.555139000,0.0000
133.178.226.30,<->,126.219.49.8,1,1165,0,0,1,1165,1.554966000,0.0000
144.87.238.91,<->,8.182.224.248,0,0,1,430,1,430,1.554542000,0.0000
109.127.101.16,<->,102.50.165.139,0,0,1,511,1,511,1.554354000,0.0000
220.39.174.212,<->,215.158.238.121,0,0,1,1213,1,1213,1.554342000,0.0000
144.85.170.249,<->,98.87.145.159,1,801,0,0,1,801,1.554306000,0.0000
255.133.225.73,<->,255.133.225.3,0,0,1,168,1,168,1.554212000,0.0000
136.119.203.136,<->,136.25.188.30,0,0,1,779,1,779,1.554160000,0.0000
215.158.239.50,<->,199.106.91.244,1,93,0,0,1,93,1.554137000,0.0000
207.188.251.181,<->,136.25.188.254,0,0,1,858,1,858,1.553432000,0.0000
215.158.238.134,<->,89.86.110.9,1,941,0,0,1,941,1.553245000,0.0000
215.158.238.93,<->,113.23.66.104,1,1149,0,0,1,1149,1.553179000,0.0000
136.138.112.192,<->,136.25.189.57,0,0,1,242,1,242,1.553129000,0.0000
133.135.214.46,<->,129.6.83.11,0,0,1,253,1,253,1.553123000,0.0000
215.158.239.244,<->,215.158.129.100,1,154,0,0,1,154,1.552549000,0.0000
215.158.140.60,<->,61.35.124.249,1,1313,0,0,1,1313,1.552511000,0.0000
143.76.140.114,<->,8.182.235.164,0,0,1,271,1,271,1.552425000,0.0000
197.146.101.6,<->,8.20.87.95,0,0,1,477,1,477,1.551880000,0.0000
215.158.140.230,<->,100.182.96.242,1,593,0,0,1,593,1.551830000,0.0000
133.135.214.222,<->,129.6.83.11,0,0,1,1041,1,1041,1.551291000,0.0000
111.146.144.40,<->,50.238.193.116,1,572,0,0,1,572,1.551002000,0.0000
194.237.64.106,<->,136.25.188.55,0,0,1,781,1,781,1.550295000,0.0000
215.158.239.76,<->,116.106.46.117,1,1420,0,0,1,1420,1.550234000,0.0000
91.43.47.235,<->,8.228.215.7,0,0,1,269,1,269,1.550030000,0.0000
133.178.227.16,<->,48.129.132.248,1,1021,0,0,1,1021,1.549923000,0.0000
116.254.112.84,<->,89.183.104.154,0,0,1,53,1,53,1.549812000,0.0000
53.91.176.230,<->,6.95.141.246,0,0,1,111,1,111,1.549536000,0.0000
100.50.100.169,<->,8.252.223.203,0,0,1,97,1,97,1.549388000,0.0000
215.158.238.99,<->,32.183.36.120,1,1325,0,0,1,1325,1.549090000,0.0000
215.158.239.105,<->,215.158.61.193,1,765,0,0,1,765,1.549074000,0.0000
133.178.227.246,<->,8.35.106.240,1,988,0,0,1,988,1.548939000,0.0000
215.158.239.71,<->,128.23.84.8,1,1085,0,0,1,1085,1.548728000,0.0000
136.25.188.160,<->,8.252.210.160,1,1373,0,0,1,1373,1.548555000,0.0000
133.178.226.7,<->,57.160.181.216,1,1181,0,0,1,1181,1.548411000,0.0000
215.158.238.99,<->,118.20.87.79,1,1293,0,0,1,1293,1.548217000,0.0000
136.25.189.1,<->,96.156.169.160,1,1341,0,0,1,1341,1.548165000,0.0000
133.178.226.18,<->,61.35.22.166,1,1357,0,0,1,1357,1.547396000,0.0000
144.72.194.209,<->,137.137.124.27,0,0,1,659,1,659,1.547302000,0.0000
139.253.153.32,<->,92.162.253.43,0,0,1,332,1,332,1.547020000,0.0000
97.53.41.28,<->,8.182.139.235,0,0,1,381,1,381,1.546995000,0.0000
215.158.239.69,<->,199.20.30.68,1,765,0,0,1,765,1.546674000,0.0000
221.102.56.69,<->,213.38.198.219,0,0,1,294,1,294,1.546617000,0.0000
111.151.109.41,<->,8.252.223.137,0,0,1,100,1,100,1.546517000,0.0000
133.178.226.41,<->,0.195.253.228,1,67,0,0,1,67,1.546275000,0.0000
215.158.140.241,<->,198.204.77.201,1,309,0,0,1,309,1.545708000,0.0000
99.171.89.123,<->,8.182.244.237,0,0,1,897,1,897,1.544823000,0.0000
195.14.125.36,<->,136.25.188.54,0,0,1,93,1,93,1.544720000,0.0000
200.174.157.158,<->,54.59.92.175,1,825,0,0,1,825,1.544621000,0.0000
197.113.64.236,<->,136.25.188.222,0,0,1,382,1,382,1.544520000,0.0000
133.178.227.18,<->,102.225.141.41,1,1429,0,0,1,1429,1.544276000,0.0000
215.158.238.114,<->,143.155.227.59,1,1277,0,0,1,1277,1.543933000,0.0000
232.31.179.43,<->,220.55.125.160,0,0,1,221,1,221,1.543707000,0.0000
215.158.239.56,<->,199.20.30.110,1,93,0,0,1,93,1.543345000,0.0000
122.223.218.50,<->,50.224.76.235,0,0,1,534,1,534,1.543262000,0.0000
215.158.239.71,<->,126.219.49.136,1,1213,0,0,1,1213,1.543247000,0.0000
215.158.238.188,<->,192.226.161.159,1,1076,0,0,1,1076,1.542971000,0.0000
149.150.27.239,<->,0.195.210.42,0,0,1,507,1,507,1.542819000,0.0000
215.158.239.57,<->,199.20.30.110,1,93,0,0,1,93,1.542679000,0.0000
199.121.20.35,<->,136.25.188.236,0,0,1,85,1,85,1.542636000,0.0000
139.163.26.146,<->,117.130.31.76,1,111,0,0,1,111,1.542576000,0.0000
144.86.150.8,<->,112.3.174.85,1,1336,0,0,1,1336,1.542443000,0.0000
199.82.215.142,<->,136.25.188.44,0,0,1,89,1,89,1.542433000,0.0000
246.253.253.107,<->,89.205.211.115,1,445,0,0,1,445,1.542336000,0.0000
136.25.189.15,<->,68.124.221.169,1,1373,0,0,1,1373,1.541873000,0.0000
215.158.239.68,<->,196.92.128.113,1,101,0,0,1,101,1.541772000,0.0000
231.143.236.165,<->,136.25.188.174,0,0,1,632,1,632,1.541623000,0.0000
235.226.7.5,<->,139.193.141.139,0,0,1,521,1,521,1.541064000,0.0000
215.158.239.125,<->,215.158.61.203,1,490,0,0,1,490,1.540849000,0.0000
215.158.239.79,<->,199.20.30.110,1,93,0,0,1,93,1.540645000,0.0000
8.52.181.238,<->,8.3.152.166,1,372,0,0,1,372,1.540295000,0.0000
195.40.48.37,<->,91.231.195.125,0,0,1,158,1,158,1.540017000,0.0000
215.158.239.57,<->,199.20.30.126,1,93,0,0,1,93,1.539790000,0.0000
143.155.227.59,<->,136.25.188.224,0,0,1,1085,1,1085,1.539692000,0.0000
215.158.238.32,<->,148.224.137.67,1,1357,0,0,1,1357,1.539605000,0.0000
213.221.90.175,<->,144.85.170.208,0,0,1,446,1,446,1.539578000,0.0000
215.158.238.244,<->,215.158.33.161,1,294,0,0,1,294,1.539284000,0.0000
76.179.64.128,<->,8.252.221.204,0,0,1,447,1,447,1.538944000,0.0000
215.158.239.56,<->,199.15.116.154,1,781,0,0,1,781,1.538912000,0.0000
200.174.199.250,<->,53.161.180.137,1,75,0,0,1,75,1.537995000,0.0000
195.42.86.105,<->,136.25.188.241,0,0,1,269,1,269,1.537908000,0.0000
215.158.140.195,<->,8.222.7.163,1,1068,0,0,1,1068,1.537649000,0.0000
36.116.253.245,<->,8.252.221.223,0,0,1,248,1,248,1.537523000,0.0000
220.55.125.160,<->,27.11.41.174,1,281,0,0,1,281,1.537273000,0.0000
215.158.239.96,<->,143.94.246.7,1,93,0,0,1,93,1.537215000,0.0000
216.144.221.244,<->,215.158.140.205,0,0,1,398,1,398,1.537103000,0.0000
215.158.61.203,<->,8.176.8.176,0,0,1,205,1,205,1.536997000,0.0000
122.221.169.96,<->,50.224.76.230,0,0,1,868,1,868,1.536466000,0.0000
139.163.68.55,<->,138.126.101.172,1,51,0,0,1,51,1.536333000,0.0000
204.152.117.163,<->,50.224.76.234,0,0,1,1065,1,1065,1.536142000,0.0000
222.42.150.75,<->,50.224.76.235,0,0,1,1001,1,1001,1.536107000,0.0000
97.100.51.225,<->,80.27.152.229,0,0,1,1093,1,1093,1.535562000,0.0000
215.158.239.92,<->,6.29.108.40,1,1325,0,0,1,1325,1.535396000,0.0000
215.158.238.148,<->,111.150.34.229,1,1245,0,0,1,1245,1.534998000,0.0000
215.158.238.97,<->,116.99.180.189,1,1373,0,0,1,1373,1.534939000,0.0000
215.158.238.95,<->,80.57.141.73,1,1181,0,0,1,1181,1.534574000,0.0000
204.186.203.185,<->,136.25.188.220,0,0,1,602,1,602,1.534083000,0.0000
122.159.34.215,<->,8.252.222.209,0,0,1,1085,1,1085,1.533665000,0.0000
220.20.202.153,<->,129.78.117.164,0,0,1,656,1,656,1.533642000,0.0000
215.158.239.79,<->,199.20.29.43,1,632,0,0,1,632,1.532953000,0.0000
109.127.101.16,<->,99.73.161.56,0,0,1,499,1,499,1.532870000,0.0000
98.67.141.11,<->,53.190.201.207,1,172,0,0,1,172,1.532829000,0.0000
215.158.239.49,<->,6.73.23.219,1,1245,0,0,1,1245,1.532265000,0.0000
80.40.4.150,<->,0.195.221.196,1,1323,0,0,1,1323,1.532249000,0.0000
215.158.239.49,<->,195.55.190.198,1,269,0,0,1,269,1.531943000,0.0000
53.148.239.43,<->,48.54.67.114,0,0,1,1307,1,1307,1.531879000,0.0000
93.95.33.184,<->,50.224.76.235,0,0,1,477,1,477,1.531776000,0.0000
133.178.226.227,<->,29.212.206.231,1,624,0,0,1,624,1.531518000,0.0000
143.128.183.153,<->,136.25.188.176,0,0,1,240,1,240,1.531476000,0.0000
139.163.26.146,<->,50.163.241.220,1,99,0,0,1,99,1.531279000,0.0000
195.77.33.211,<->,50.224.76.230,0,0,1,1429,1,1429,1.530326000,0.0000
207.190.207.138,<->,136.25.188.178,0,0,1,593,1,593,1.530234000,0.0000
215.158.239.49,<->,215.158.44.231,1,1357,0,0,1,1357,1.530218000,0.0000
192.67.161.228,<->,144.72.64.8,1,676,0,0,1,676,1.530187000,0.0000
133.178.226.78,<->,102.225.141.21,1,1101,0,0,1,1101,1.529988000,0.0000
251.21.232.45,<->,109.222.231.152,0,0,1,134,1,134,1.529859000,0.0000
8.182.245.110,<->,6.133.205.116,1,321,0,0,1,321,1.529694000,0.0000
215.158.238.32,<->,131.1.195.220,1,1197,0,0,1,1197,1.529662000,0.0000
220.87.83.83,<->,50.224.80.64,0,0,1,1265,1,1265,1.529585000,0.0000
220.28.114.119,<->,145.252.118.62,0,0,1,312,1,312,1.529506000,0.0000
207.173.149.81,<->,136.25.188.176,0,0,1,1075,1,1075,1.529308000,0.0000
200.174.124.138,<->,53.214.81.160,1,641,0,0,1,641,1.528932000,0.0000
215.158.239.93,<->,114.146.74.203,1,1357,0,0,1,1357,1.528402000,0.0000
215.158.239.99,<->,199.20.31.108,1,1085,0,0,1,1085,1.528357000,0.0000
224.93.235.33,<->,80.27.157.207,0,0,1,897,1,897,1.528253000,0.0000
215.158.238.133,<->,131.36.198.34,1,1250,0,0,1,1250,1.528161000,0.0000
215.158.239.85,<->,207.190.160.214,1,918,0,0,1,918,1.528073000,0.0000
220.60.19.177,<->,215.158.238.35,0,0,1,446,1,446,1.527960000,0.0000
92.168.217.183,<->,50.136.181.207,1,313,0,0,1,313,1.527553000,0.0000
143.79.198.56,<->,136.25.188.242,0,0,1,93,1,93,1.527228000,0.0000
220.28.114.114,<->,98.236.254.203,0,0,1,277,1,277,1.526926000,0.0000
144.85.170.254,<->,91.69.185.245,1,1044,0,0,1,1044,1.526703000,0.0000
200.175.139.231,<->,53.213.12.173,1,87,0,0,1,87,1.526479000,0.0000
139.160.226.234,<->,136.25.188.236,0,0,1,1229,1,1229,1.526192000,0.0000
204.1.247.229,<->,136.25.188.236,0,0,1,765,1,765,1.526168000,0.0000
248.225.25.242,<->,56.9.27.51,1,435,0,0,1,435,1.525805000,0.0000
133.178.226.61,<->,116.99.180.166,1,1325,0,0,1,1325,1.525634000,0.0000
8.183.25.25,<->,8.20.102.81,1,341,0,0,1,341,1.525337000,0.0000
215.158.239.181,<->,131.36.66.137,1,284,0,0,1,284,1.525312000,0.0000
143.53.234.215,<->,136.25.188.177,0,0,1,93,1,93,1.525203000,0.0000
215.158.238.221,<->,126.219.60.220,1,1100,0,0,1,1100,1.525133000,0.0000
199.69.108.148,<->,136.25.188.227,0,0,1,170,1,170,1.525050000,0.0000
215.158.238.66,<->,106.188.193.36,1,1101,0,0,1,1101,1.524946000,0.0000
202.33.10.37,<->,136.25.188.220,0,0,1,87,1,87,1.524865000,0.0000
159.109.242.255,<->,111.151.109.41,1,100,0,0,1,100,1.524583000,0.0000
89.205.211.109,<->,8.228.216.50,0,0,1,433,1,433,1.524539000,0.0000
221.102.56.1,<->,129.1.81.150,0,0,1,87,1,87,1.524427000,0.0000
215.158.238.120,<->,131.173.115.84,1,1373,0,0,1,1373,1.524416000,0.0000
215.158.239.57,<->,196.109.123.164,1,781,0,0,1,781,1.524348000,0.0000
109.222.220.98,<->,54.43.249.8,1,157,0,0,1,157,1.524314000,0.0000
139.163.26.146,<->,112.9.220.178,1,99,0,0,1,99,1.524262000,0.0000
152.40.191.96,<->,8.252.222.174,0,0,1,141,1,141,1.524037000,0.0000
136.25.188.255,<->,122.159.245.165,1,1101,0,0,1,1101,1.524013000,0.0000
243.148.62.228,<->,0.195.210.42,0,0,1,146,1,146,1.523858000,0.0000
215.158.238.93,<->,6.116.31.20,1,1309,0,0,1,1309,1.523739000,0.0000
111.151.106.254,<->,99.74.27.191,0,0,1,100,1,100,1.523486000,0.0000
132.200.108.136,<->,129.224.112.221,0,0,1,109,1,109,1.522961000,0.0000
215.158.238.93,<->,57.236.82.233,1,1197,0,0,1,1197,1.522625000,0.0000
192.204.170.200,<->,136.25.188.254,0,0,1,973,1,973,1.522563000,0.0000
142.247.219.16,<->,136.25.188.242,0,0,1,194,1,194,1.522395000,0.0000
215.158.239.84,<->,199.70.185.46,1,141,0,0,1,141,1.522340000,0.0000
133.8.10.152,<->,111.20.168.21,0,0,1,305,1,305,1.522293000,0.0000
231.143.126.85,<->,136.25.188.225,0,0,1,765,1,765,1.522149000,0.0000
215.158.140.229,<->,29.211.6.102,1,1409,0,0,1,1409,1.521944000,0.0000
215.158.239.32,<->,215.158.127.163,1,137,0,0,1,137,1.521879000,0.0000
215.158.239.70,<->,199.20.28.249,1,602,0,0,1,602,1.521150000,0.0000
215.158.61.183,<->,8.176.8.179,0,0,1,399,1,399,1.521048000,0.0000
231.143.11.100,<->,136.25.188.239,0,0,1,378,1,378,1.520888000,0.0000
215.158.239.29,<->,158.166.175.248,1,58,0,0,1,58,1.520721000,0.0000
146.249.227.32,<->,8.252.222.51,0,0,1,101,1,101,1.520638000,0.0000
133.178.227.1,<->,133.56.180.90,1,1277,0,0,1,1277,1.520064000,0.0000
215.158.238.122,<->,29.212.203.139,1,1213,0,0,1,1213,1.519665000,0.0000
132.249.70.157,<->,111.151.237.22,1,190,0,0,1,190,1.519562000,0.0000
215.158.239.56,<->,199.20.30.255,1,1120,0,0,1,1120,1.519235000,0.0000
215.158.238.51,<->,129.222.36.178,1,1396,0,0,1,1396,1.519035000,0.0000
136.214.10.160,<->,92.27.194.249,0,0,1,384,1,384,1.518890000,0.0000
97.168.66.53,<->,53.209.238.110,1,362,0,0,1,362,1.518859000,0.0000
143.135.207.170,<->,136.25.188.178,0,0,1,749,1,749,1.518336000,0.0000
215.158.140.231,<->,212.70.75.35,1,1089,0,0,1,1089,1.518307000,0.0000
220.28.85.14,<->,215.158.238.88,0,0,1,648,1,648,1.518239000,0.0000
215.158.239.25,<->,96.135.154.112,1,468,0,0,1,468,1.518165000,0.0000
159.137.243.168,<->,143.52.91.253,1,539,0,0,1,539,1.517990000,0.0000
129.236.115.40,<->,111.20.168.123,0,0,1,377,1,377,1.517972000,0.0000
215.158.140.172,<->,8.222.7.169,1,1071,0,0,1,1071,1.517739000,0.0000
115.139.125.51,<->,50.224.76.230,0,0,1,697,1,697,1.517732000,0.0000
136.25.188.209,<->,131.1.253.209,1,1341,0,0,1,1341,1.517646000,0.0000
136.25.189.78,<->,131.144.115.252,1,1373,0,0,1,1373,1.517553000,0.0000
215.158.239.30,<->,212.70.75.25,1,1156,0,0,1,1156,1.517328000,0.0000
192.170.179.5,<->,133.32.39.0,0,0,1,247,1,247,1.517225000,0.0000
253.182.227.8,<->,215.158.238.95,0,0,1,1085,1,1085,1.517167000,0.0000
215.158.238.86,<->,145.116.209.82,1,506,0,0,1,506,1.517166000,0.0000
92.162.219.33,<->,80.38.36.175,0,0,1,1248,1,1248,1.517059000,0.0000
136.25.189.1,<->,94.110.153.229,1,120,0,0,1,120,1.516431000,0.0000
215.158.239.92,<->,195.43.186.225,1,240,0,0,1,240,1.515811000,0.0000
215.158.239.85,<->,199.20.30.176,1,289,0,0,1,289,1.515430000,0.0000
197.113.99.168,<->,136.25.188.255,0,0,1,87,1,87,1.515249000,0.0000
215.158.239.99,<->,207.56.214.26,1,798,0,0,1,798,1.515141000,0.0000
143.230.72.6,<->,8.20.87.153,0,0,1,840,1,840,1.515102000,0.0000
149.96.60.153,<->,133.178.226.28,0,0,1,1261,1,1261,1.514896000,0.0000
142.179.40.120,<->,50.224.76.234,0,0,1,53,1,53,1.514642000,0.0000
249.101.84.243,<->,54.58.97.161,1,58,0,0,1,58,1.514165000,0.0000
213.186.61.127,<->,144.85.170.208,0,0,1,433,1,433,1.514115000,0.0000
215.158.239.85,<->,195.54.89.72,1,272,0,0,1,272,1.514001000,0.0000
215.158.239.99,<->,199.121.76.183,1,632,0,0,1,632,1.513600000,0.0000
215.158.239.58,<->,207.62.22.34,1,832,0,0,1,832,1.513424000,0.0000
111.151.107.208,<->,97.126.31.64,0,0,1,100,1,100,1.513012000,0.0000
220.28.115.46,<->,136.25.189.5,0,0,1,1192,1,1192,1.512993000,0.0000
144.85.170.208,<->,98.87.147.158,1,716,0,0,1,716,1.512883000,0.0000
215.158.238.133,<->,29.211.186.137,1,1277,0,0,1,1277,1.512675000,0.0000
215.158.239.76,<->,196.104.8.201,1,101,0,0,1,101,1.512559000,0.0000
202.33.255.198,<->,136.25.188.240,0,0,1,93,1,93,1.512222000,0.0000
215.158.238.76,<->,139.163.161.19,1,506,0,0,1,506,1.512108000,0.0000
50.224.76.235,<->,33.245.207.237,1,925,0,0,1,925,1.512097000,0.0000
215.158.239.87,<->,142.227.55.17,1,602,0,0,1,602,1.511686000,0.0000
136.25.189.88,<->,8.42.43.73,1,1485,0,0,1,1485,1.510914000,0.0000
220.28.65.9,<->,215.158.239.75,0,0,1,652,1,652,1.510812000,0.0000
43.52.205.49,<->,8.252.221.239,0,0,1,364,1,364,1.510783000,0.0000
246.253.145.7,<->,145.89.27.67,1,318,0,0,1,318,1.510203000,0.0000
133.178.227.40,<->,102.225.141.57,1,1093,0,0,1,1093,1.510188000,0.0000
220.39.233.54,<->,133.178.227.14,0,0,1,1245,1,1245,1.509992000,0.0000
209.91.247.57,<->,8.53.4.16,0,0,1,502,1,502,1.509983000,0.0000
215.158.238.67,<->,106.188.183.73,1,1440,0,0,1,1440,1.509896000,0.0000
136.25.189.1,<->,131.144.113.60,1,1309,0,0,1,1309,1.509780000,0.0000
123.191.161.64,<->,92.27.219.184,0,0,1,323,1,323,1.509779000,0.0000
111.199.239.217,<->,0.195.210.44,0,0,1,93,1,93,1.508924000,0.0000
215.158.238.100,<->,100.224.166.158,1,506,0,0,1,506,1.508783000,0.0000
215.158.239.93,<->,196.89.181.155,1,87,0,0,1,87,1.508144000,0.0000
148.55.77.89,<->,139.193.141.139,0,0,1,374,1,374,1.508029000,0.0000
220.20.200.93,<->,144.83.60.153,1,678,0,0,1,678,1.507786000,0.0000
215.158.238.148,<->,42.226.3.119,1,1309,0,0,1,1309,1.507641000,0.0000
144.87.235.222,<->,132.18.67.29,1,195,0,0,1,195,1.507425000,0.0000
215.158.238.82,<->,148.55.210.208,1,1357,0,0,1,1357,1.507347000,0.0000
143.79.133.25,<->,136.25.188.252,0,0,1,541,1,541,1.507262000,0.0000
148.129.30.43,<->,136.25.189.77,0,0,1,1341,1,1341,1.506926000,0.0000
215.158.238.190,<->,8.57.163.151,1,1277,0,0,1,1277,1.506869000,0.0000
90.240.140.153,<->,50.149.34.234,1,511,0,0,1,511,1.506437000,0.0000
148.129.19.124,<->,133.178.226.61,0,0,1,1373,1,1373,1.506100000,0.0000
215.158.239.70,<->,195.43.186.225,1,240,0,0,1,240,1.506018000,0.0000
139.193.141.132,<->,29.223.227.192,1,329,0,0,1,329,1.505851000,0.0000
207.193.35.39,<->,8.182.227.18,0,0,1,530,1,530,1.505611000,0.0000
215.158.239.253,<->,144.253.73.231,1,94,0,0,1,94,1.505560000,0.0000
215.158.238.106,<->,111.150.34.250,1,1309,0,0,1,1309,1.504791000,0.0000
48.129.132.228,<->,8.252.222.211,0,0,1,1213,1,1213,1.504672000,0.0000
17.31.40.178,<->,8.220.189.63,0,0,1,454,1,454,1.504062000,0.0000
215.158.239.92,<->,199.20.31.6,1,56,0,0,1,56,1.504061000,0.0000
215.158.239.57,<->,195.96.175.234,1,602,0,0,1,602,1.503738000,0.0000
143.42.143.177,<->,136.25.188.240,0,0,1,825,1,825,1.503697000,0.0000
133.178.226.19,<->,50.218.56.234,1,1181,0,0,1,1181,1.503614000,0.0000
17.199.106.163,<->,8.220.179.94,0,0,1,665,1,665,1.503405000,0.0000
215.158.239.76,<->,199.20.29.42,1,781,0,0,1,781,1.503256000,0.0000
109.222.216.202,<->,92.27.78.103,1,218,0,0,1,218,1.503210000,0.0000
215.158.239.96,<->,199.20.29.115,1,632,0,0,1,632,1.503182000,0.0000
207.40.11.106,<->,50.224.76.234,0,0,1,1062,1,1062,1.502989000,0.0000
136.25.188.211,<->,113.23.20.232,1,1341,0,0,1,1341,1.502923000,0.0000
215.158.61.202,<->,8.176.8.224,0,0,1,93,1,93,1.502863000,0.0000
111.147.192.122,<->,54.41.253.68,1,157,0,0,1,157,1.502556000,0.0000
215.158.239.93,<->,207.114.77.109,1,260,0,0,1,260,1.502263000,0.0000
139.163.0.100,<->,107.112.71.200,1,163,0,0,1,163,1.502022000,0.0000
159.37.0.178,<->,145.116.119.49,0,0,1,107,1,107,1.501940000,0.0000
117.46.137.244,<->,50.224.76.234,0,0,1,1199,1,1199,1.501924000,0.0000
129.31.169.113,<->,8.183.25.124,0,0,1,87,1,87,1.501824000,0.0000
69.240.78.251,<->,8.252.222.30,0,0,1,141,1,141,1.501530000,0.0000
139.163.26.146,<->,92.181.226.174,1,99,0,0,1,99,1.501487000,0.0000
246.253.253.169,<->,139.33.174.178,1,1270,0,0,1,1270,1.501263000,0.0000
192.64.217.166,<->,142.174.218.147,1,112,0,0,1,112,1.501240000,0.0000
136.25.188.254,<->,29.211.6.38,1,1197,0,0,1,1197,1.500548000,0.0000
142.227.132.130,<->,136.25.188.197,0,0,1,240,1,240,1.500283000,0.0000
215.158.238.251,<->,8.222.6.215,1,1026,0,0,1,1026,1.500039000,0.0000
215.158.239.34,<->,126.219.102.181,1,1479,0,0,1,1479,1.499953000,0.0000
210.229.230.22,<->,81.107.212.18,1,80,0,0,1,80,1.499360000,0.0000
215.158.238.176,<->,126.219.246.238,1,1245,0,0,1,1245,1.499275000,0.0000
97.4.40.55,<->,80.38.37.64,0,0,1,126,1,126,1.499141000,0.0000
215.158.238.92,<->,143.88.15.41,1,1149,0,0,1,1149,1.498853000,0.0000
215.158.239.78,<->,196.89.181.155,1,87,0,0,1,87,1.498783000,0.0000
210.220.219.150,<->,53.224.118.41,1,181,0,0,1,181,1.498755000,0.0000
92.27.27.188,<->,42.94.211.47,1,1396,0,0,1,1396,1.498533000,0.0000
215.158.239.48,<->,142.208.240.181,1,87,0,0,1,87,1.498467000,0.0000
204.41.22.99,<->,139.193.141.139,0,0,1,182,1,182,1.498191000,0.0000
241.5.27.214,<->,215.158.140.75,0,0,1,1072,1,1072,1.497911000,0.0000
133.178.227.19,<->,8.222.2.21,1,1137,0,0,1,1137,1.496454000,0.0000
247.136.250.61,<->,198.41.102.232,1,68,0,0,1,68,1.496244000,0.0000
136.25.189.32,<->,123.166.46.234,1,1293,0,0,1,1293,1.496200000,0.0000
136.25.189.88,<->,8.179.43.55,1,1229,0,0,1,1229,1.495938000,0.0000
210.220.219.178,<->,53.239.143.73,1,269,0,0,1,269,1.495900000,0.0000
212.70.217.75,<->,136.25.189.83,0,0,1,1197,1,1197,1.495799000,0.0000
220.39.174.104,<->,133.178.227.16,0,0,1,1058,1,1058,1.494955000,0.0000
216.144.221.249,<->,215.158.140.221,0,0,1,186,1,186,1.494902000,0.0000
215.158.239.94,<->,149.163.129.243,1,1293,0,0,1,1293,1.494482000,0.0000
215.158.239.59,<->,158.253.43.167,1,1261,0,0,1,1261,1.494412000,0.0000
133.178.227.208,<->,8.42.42.194,1,586,0,0,1,586,1.494214000,0.0000
215.158.239.76,<->,199.106.245.8,1,602,0,0,1,602,1.493203000,0.0000
80.38.16.208,<->,37.119.83.124,1,451,0,0,1,451,1.492762000,0.0000
199.59.123.115,<->,50.223.3.228,0,0,1,171,1,171,1.492737000,0.0000
130.146.158.154,<->,89.216.124.92,0,0,1,473,1,473,1.492707000,0.0000
215.158.239.49,<->,131.144.115.100,1,1229,0,0,1,1229,1.492582000,0.0000
102.45.20.234,<->,54.69.141.102,1,99,0,0,1,99,1.491452000,0.0000
246.253.253.6,<->,46.198.194.141,1,1201,0,0,1,1201,1.490326000,0.0000
215.158.238.241,<->,84.203.220.166,1,1261,0,0,1,1261,1.490147000,0.0000
143.129.165.171,<->,136.25.188.253,0,0,1,602,1,602,1.490048000,0.0000
215.158.238.132,<->,29.211.122.180,1,1181,0,0,1,1181,1.489691000,0.0000
215.158.239.59,<->,195.49.13.174,1,141,0,0,1,141,1.489682000,0.0000
61.125.168.197,<->,8.252.222.70,0,0,1,520,1,520,1.489354000,0.0000
215.158.239.10,<->,96.135.154.98,1,433,0,0,1,433,1.488387000,0.0000
215.158.239.70,<->,135.229.0.214,1,1373,0,0,1,1373,1.488201000,0.0000
142.236.26.159,<->,136.25.188.255,0,0,1,170,1,170,1.488039000,0.0000
98.236.90.77,<->,8.37.124.174,1,97,0,0,1,97,1.488022000,0.0000
215.158.238.148,<->,8.191.6.90,1,1181,0,0,1,1181,1.487668000,0.0000
210.229.230.18,<->,192.176.51.172,1,68,0,0,1,68,1.487594000,0.0000
125.197.1.201,<->,50.224.76.234,0,0,1,878,1,878,1.487318000,0.0000
215.158.238.121,<->,8.252.210.251,1,1277,0,0,1,1277,1.487265000,0.0000
144.67.250.107,<->,108.134.98.139,0,0,1,117,1,117,1.487120000,0.0000
252.135.0.205,<->,139.193.141.132,0,0,1,87,1,87,1.487116000,0.0000
200.175.199.11,<->,53.167.3.63,1,461,0,0,1,461,1.486926000,0.0000
215.158.239.42,<->,122.158.246.183,1,1448,0,0,1,1448,1.486493000,0.0000
133.148.242.157,<->,8.220.202.24,0,0,1,415,1,415,1.486248000,0.0000
215.158.239.76,<->,207.191.238.79,1,657,0,0,1,657,1.486119000,0.0000
215.158.239.86,<->,131.144.113.9,1,1197,0,0,1,1197,1.486108000,0.0000
142.190.143.50,<->,136.25.188.174,0,0,1,781,1,781,1.485665000,0.0000
215.158.61.242,<->,136.25.188.39,0,0,1,1392,1,1392,1.485626000,0.0000
17.33.88.98,<->,8.52.154.228,0,0,1,736,1,736,1.485602000,0.0000
246.253.169.113,<->,97.223.4.2,1,183,0,0,1,183,1.485379000,0.0000
98.217.53.146,<->,50.224.76.234,0,0,1,1124,1,1124,1.485329000,0.0000
143.134.97.75,<->,136.25.188.178,0,0,1,624,1,624,1.485183000,0.0000
143.10.47.43,<->,136.25.188.178,0,0,1,87,1,87,1.484926000,0.0000
215.158.239.94,<->,207.61.203.69,1,85,0,0,1,85,1.484811000,0.0000
111.147.76.87,<->,53.148.24.110,1,125,0,0,1,125,1.484745000,0.0000
99.187.125.121,<->,8.20.87.10,0,0,1,891,1,891,1.484203000,0.0000
215.158.239.95,<->,199.20.28.106,1,685,0,0,1,685,1.484061000,0.0000
225.120.222.235,<->,133.178.226.29,0,0,1,989,1,989,1.483923000,0.0000
100.124.212.246,<->,80.41.38.205,0,0,1,255,1,255,1.483744000,0.0000
215.158.238.64,<->,8.179.43.53,1,1245,0,0,1,1245,1.483587000,0.0000
136.25.189.15,<->,130.117.160.70,1,1181,0,0,1,1181,1.483248000,0.0000
136.129.92.245,<->,98.231.104.72,1,209,0,0,1,209,1.483118000,0.0000
136.25.189.29,<->,116.106.44.35,1,1165,0,0,1,1165,1.482942000,0.0000
221.102.56.69,<->,99.75.22.179,0,0,1,294,1,294,1.482765000,0.0000
109.2.111.102,<->,8.45.175.127,1,141,0,0,1,141,1.482669000,0.0000
215.158.140.8,<->,215.158.61.195,1,938,0,0,1,938,1.482467000,0.0000
137.19.242.61,<->,50.224.15.251,1,333,0,0,1,333,1.481996000,0.0000
133.178.227.79,<->,133.56.180.9,1,1247,0,0,1,1247,1.481906000,0.0000
204.200.166.123,<->,136.25.188.236,0,0,1,797,1,797,1.481881000,0.0000
215.158.239.78,<->,29.211.165.20,1,1213,0,0,1,1213,1.481608000,0.0000
215.158.199.224,<->,138.73.248.205,0,0,1,129,1,129,1.481410000,0.0000
149.100.112.91,<->,139.193.141.139,0,0,1,534,1,534,1.481157000,0.0000
195.71.163.42,<->,136.25.188.55,0,0,1,85,1,85,1.480940000,0.0000
143.18.198.122,<->,8.182.224.87,0,0,1,1139,1,1139,1.480808000,0.0000
215.158.238.210,<->,8.219.185.122,1,558,0,0,1,558,1.480740000,0.0000
97.182.7.16,<->,8.52.181.95,0,0,1,346,1,346,1.480438000,0.0000
111.146.197.80,<->,53.244.1.14,1,797,0,0,1,797,1.480280000,0.0000
199.15.133.244,<->,136.25.188.227,0,0,1,602,1,602,1.480105000,0.0000
215.158.239.94,<->,29.211.228.217,1,1412,0,0,1,1412,1.480078000,0.0000
143.129.169.210,<->,136.25.188.163,0,0,1,141,1,141,1.480020000,0.0000
139.193.141.139,<->,98.164.243.95,1,365,0,0,1,365,1.479757000,0.0000
215.158.238.135,<->,205.227.96.23,1,1325,0,0,1,1325,1.479718000,0.0000
133.178.227.57,<->,122.159.123.36,1,1076,0,0,1,1076,1.479080000,0.0000
101.124.235.213,<->,89.74.85.198,1,305,0,0,1,305,1.478887000,0.0000
136.25.188.179,<->,113.23.7.55,1,1181,0,0,1,1181,1.478801000,0.0000
215.158.239.58,<->,194.234.250.232,1,85,0,0,1,85,1.478234000,0.0000
215.158.238.47,<->,114.25.48.62,1,1181,0,0,1,1181,1.478215000,0.0000
199.73.103.114,<->,136.25.188.238,0,0,1,260,1,260,1.477550000,0.0000
80.27.159.59,<->,72.151.67.12,1,213,0,0,1,213,1.477479000,0.0000
133.178.227.14,<->,8.241.237.161,1,1294,0,0,1,1294,1.477463000,0.0000
136.139.59.102,<->,136.25.188.174,0,0,1,1309,1,1309,1.477266000,0.0000
220.20.200.193,<->,159.70.46.125,1,970,0,0,1,970,1.476957000,0.0000
136.181.47.188,<->,53.240.176.115,1,797,0,0,1,797,1.476747000,0.0000
149.197.245.156,<->,80.40.16.41,0,0,1,59,1,59,1.475885000,0.0000
142.239.121.93,<->,133.178.226.29,0,0,1,1133,1,1133,1.475640000,0.0000
142.236.127.231,<->,136.25.188.176,0,0,1,73,1,73,1.475527000,0.0000
215.158.238.133,<->,156.181.149.245,1,1341,0,0,1,1341,1.474945000,0.0000
249.101.84.219,<->,54.61.53.169,1,322,0,0,1,322,1.474862000,0.0000
196.89.56.249,<->,136.25.188.241,0,0,1,302,1,302,1.474815000,0.0000
159.112.9.198,<->,111.146.211.230,0,0,1,81,1,81,1.474712000,0.0000
109.1.71.12,<->,8.49.69.216,1,353,0,0,1,353,1.474625000,0.0000
207.60.253.155,<->,136.25.188.254,0,0,1,141,1,141,1.474339000,0.0000
203.89.231.103,<->,50.224.80.64,0,0,1,97,1,97,1.474264000,0.0000
136.25.189.16,<->,8.222.3.223,1,1181,0,0,1,1181,1.474113000,0.0000
215.158.238.67,<->,106.188.183.106,1,126,0,0,1,126,1.474058000,0.0000
195.7.227.153,<->,136.25.188.238,0,0,1,602,1,602,1.473967000,0.0000
136.25.188.163,<->,122.158.51.60,1,1245,0,0,1,1245,1.473842000,0.0000
215.158.238.72,<->,8.190.216.234,1,1325,0,0,1,1325,1.473494000,0.0000
192.226.161.38,<->,136.25.188.255,0,0,1,1197,1,1197,1.473210000,0.0000
192.227.190.233,<->,133.178.226.18,0,0,1,1405,1,1405,1.472579000,0.0000
133.178.226.49,<->,113.23.113.227,1,1229,0,0,1,1229,1.472563000,0.0000
215.158.239.29,<->,8.255.92.123,1,1100,0,0,1,1100,1.472353000,0.0000
152.40.232.143,<->,8.252.222.141,0,0,1,641,1,641,1.472305000,0.0000
215.158.238.243,<->,192.171.32.152,1,1085,0,0,1,1085,1.471816000,0.0000
136.25.189.1,<->,120.154.71.20,1,1373,0,0,1,1373,1.471442000,0.0000
215.158.239.70,<->,148.26.113.42,1,1085,0,0,1,1085,1.471195000,0.0000
215.158.239.56,<->,199.20.29.67,1,602,0,0,1,602,1.471096000,0.0000
215.158.239.99,<->,196.94.139.126,1,653,0,0,1,653,1.470659000,0.0000
215.158.61.243,<->,8.176.8.105,0,0,1,285,1,285,1.470390000,0.0000
215.158.238.64,<->,122.158.49.195,1,1069,0,0,1,1069,1.470320000,0.0000
136.25.188.220,<->,122.159.245.164,1,1101,0,0,1,1101,1.470265000,0.0000
142.236.24.91,<->,92.27.194.147,0,0,1,248,1,248,1.470013000,0.0000
139.185.223.103,<->,97.168.93.121,0,0,1,983,1,983,1.469891000,0.0000
215.158.238.66,<->,143.155.226.245,1,1245,0,0,1,1245,1.469782000,0.0000
221.196.122.52,<->,136.25.188.173,0,0,1,348,1,348,1.469644000,0.0000
205.91.181.210,<->,92.27.219.247,0,0,1,61,1,61,1.469618000,0.0000
133.178.226.61,<->,106.188.252.233,1,1197,0,0,1,1197,1.469375000,0.0000
204.2.36.142,<->,136.25.188.220,0,0,1,256,1,256,1.468338000,0.0000
76.179.15.94,<->,8.252.222.37,0,0,1,781,1,781,1.467762000,0.0000
131.82.121.131,<->,50.224.76.235,0,0,1,862,1,862,1.467246000,0.0000
95.245.112.186,<->,8.252.221.230,0,0,1,454,1,454,1.467133000,0.0000
136.25.188.255,<->,132.145.241.230,1,228,0,0,1,228,1.466928000,0.0000
215.158.61.195,<->,136.25.188.34,0,0,1,61,1,61,1.466596000,0.0000
133.54.20.137,<->,59.146.100.23,1,454,0,0,1,454,1.465230000,0.0000
207.58.249.78,<->,136.25.188.54,0,0,1,252,1,252,1.464778000,0.0000
215.158.238.9,<->,8.191.10.214,1,1500,0,0,1,1500,1.464655000,0.0000
192.204.170.197,<->,136.25.188.220,0,0,1,1325,1,1325,1.463278000,0.0000
215.158.239.6,<->,106.188.214.29,1,1455,0,0,1,1455,1.462927000,0.0000
215.158.239.78,<->,199.20.28.86,1,165,0,0,1,165,1.462747000,0.0000
215.158.238.81,<->,192.205.37.205,1,1406,0,0,1,1406,1.462239000,0.0000
159.112.9.198,<->,111.181.112.48,0,0,1,81,1,81,1.462154000,0.0000
109.1.6.108,<->,53.167.10.58,1,412,0,0,1,412,1.461979000,0.0000
200.175.217.203,<->,53.213.103.24,1,161,0,0,1,161,1.461575000,0.0000
215.158.239.68,<->,202.33.255.198,1,93,0,0,1,93,1.461388000,0.0000
80.41.234.245,<->,56.13.192.190,1,237,0,0,1,237,1.461373000,0.0000
129.1.112.127,<->,8.45.168.98,1,208,0,0,1,208,1.461317000,0.0000
195.40.131.57,<->,136.25.188.179,0,0,1,561,1,561,1.461254000,0.0000
133.178.227.76,<->,18.202.90.199,1,1139,0,0,1,1139,1.461092000,0.0000
220.38.238.124,<->,133.178.227.79,0,0,1,1179,1,1179,1.461021000,0.0000
140.68.10.122,<->,8.252.222.158,0,0,1,132,1,132,1.460941000,0.0000
215.158.61.191,<->,8.176.8.196,0,0,1,269,1,269,1.460665000,0.0000
215.158.140.11,<->,22.45.211.91,1,613,0,0,1,613,1.460465000,0.0000
199.81.215.251,<->,50.224.76.235,0,0,1,1284,1,1284,1.460350000,0.0000
149.210.211.99,<->,50.224.76.248,0,0,1,1053,1,1053,1.460192000,0.0000
136.25.188.198,<->,114.66.221.60,1,669,0,0,1,669,1.459926000,0.0000
136.25.189.57,<->,29.212.198.171,1,1357,0,0,1,1357,1.459925000,0.0000
136.25.189.29,<->,96.156.169.220,1,341,0,0,1,341,1.459874000,0.0000
215.158.239.50,<->,120.154.131.47,1,1389,0,0,1,1389,1.459836000,0.0000
133.178.227.245,<->,111.151.237.158,1,1108,0,0,1,1108,1.459759000,0.0000
195.70.105.69,<->,136.25.188.225,0,0,1,765,1,765,1.459532000,0.0000
221.102.103.73,<->,207.23.68.228,1,75,0,0,1,75,1.459356000,0.0000
38.81.154.202,<->,8.52.182.119,0,0,1,271,1,271,1.458956000,0.0000
207.162.163.246,<->,8.182.138.83,0,0,1,261,1,261,1.458512000,0.0000
133.178.227.8,<->,111.150.207.168,1,100,0,0,1,100,1.458451000,0.0000
215.158.140.207,<->,199.47.179.172,1,501,0,0,1,501,1.458376000,0.0000
133.178.227.2,<->,106.188.252.230,1,1213,0,0,1,1213,1.458337000,0.0000
6.145.165.86,<->,0.195.210.46,0,0,1,418,1,418,1.457351000,0.0000
215.158.61.189,<->,136.25.189.222,0,0,1,221,1,221,1.456772000,0.0000
99.162.65.136,<->,53.245.244.92,1,257,0,0,1,257,1.456489000,0.0000
215.158.239.85,<->,80.56.72.245,1,1165,0,0,1,1165,1.456352000,0.0000
207.60.152.130,<->,91.231.195.125,0,0,1,158,1,158,1.456071000,0.0000
99.175.107.24,<->,53.214.235.71,1,417,0,0,1,417,1.455456000,0.0000
212.100.244.206,<->,8.52.128.75,0,0,1,767,1,767,1.454981000,0.0000
133.178.226.80,<->,33.209.217.222,1,1213,0,0,1,1213,1.454754000,0.0000
215.158.239.94,<->,207.166.75.195,1,632,0,0,1,632,1.454380000,0.0000
112.208.20.246,<->,100.93.119.230,0,0,1,163,1,163,1.454006000,0.0000
139.193.141.209,<->,82.198.36.203,1,511,0,0,1,511,1.453958000,0.0000
215.158.238.82,<->,57.227.83.250,1,1229,0,0,1,1229,1.453892000,0.0000
220.28.65.9,<->,215.158.238.145,0,0,1,364,1,364,1.453700000,0.0000
133.178.227.2,<->,122.216.233.219,1,1088,0,0,1,1088,1.453519000,0.0000
131.178.248.254,<->,80.40.4.150,0,0,1,410,1,410,1.453505000,0.0000
215.158.239.97,<->,199.20.30.90,1,781,0,0,1,781,1.453433000,0.0000
195.124.40.68,<->,136.25.188.198,0,0,1,93,1,93,1.453408000,0.0000
215.158.239.93,<->,196.91.30.78,1,602,0,0,1,602,1.452982000,0.0000
206.195.129.169,<->,144.86.146.31,0,0,1,1040,1,1040,1.452802000,0.0000
215.158.239.32,<->,8.252.214.213,1,1498,0,0,1,1498,1.452612000,0.0000
215.158.239.56,<->,199.20.29.156,1,378,0,0,1,378,1.452323000,0.0000
215.158.239.50,<->,142.252.177.167,1,93,0,0,1,93,1.452253000,0.0000
215.158.239.229,<->,128.156.85.186,1,100,0,0,1,100,1.452139000,0.0000
215.158.238.33,<->,156.181.149.249,1,1293,0,0,1,1293,1.452042000,0.0000
215.158.238.93,<->,6.116.31.21,1,1261,0,0,1,1261,1.451678000,0.0000
225.222.118.180,<->,8.220.176.253,0,0,1,267,1,267,1.451269000,0.0000
215.158.238.107,<->,29.211.186.199,1,1485,0,0,1,1485,1.451049000,0.0000
136.25.188.173,<->,133.167.148.155,1,591,0,0,1,591,1.450916000,0.0000
132.44.144.167,<->,50.224.76.248,0,0,1,951,1,951,1.450879000,0.0000
246.254.97.113,<->,210.231.140.55,1,1476,0,0,1,1476,1.449567000,0.0000
195.124.60.10,<->,136.25.188.163,0,0,1,602,1,602,1.449550000,0.0000
136.25.189.28,<->,29.214.73.167,1,1197,0,0,1,1197,1.449442000,0.0000
207.88.204.64,<->,50.224.76.234,0,0,1,1161,1,1161,1.449293000,0.0000
109.29.69.147,<->,8.220.191.251,0,0,1,473,1,473,1.449075000,0.0000
215.158.239.86,<->,199.63.178.200,1,1277,0,0,1,1277,1.448529000,0.0000
210.229.230.18,<->,103.47.53.131,1,68,0,0,1,68,1.448072000,0.0000
247.136.131.55,<->,210.209.251.214,1,481,0,0,1,481,1.447940000,0.0000
89.86.110.227,<->,8.252.223.131,0,0,1,1153,1,1153,1.447596000,0.0000
215.158.238.143,<->,29.212.198.151,1,1309,0,0,1,1309,1.447322000,0.0000
192.64.210.157,<->,14.30.152.51,1,976,0,0,1,976,1.447185000,0.0000
210.229.230.19,<->,50.204.15.57,1,68,0,0,1,68,1.446792000,0.0000
215.158.239.95,<->,196.88.134.223,1,561,0,0,1,561,1.446377000,0.0000
197.113.99.181,<->,136.25.188.198,0,0,1,602,1,602,1.446302000,0.0000
215.158.61.202,<->,136.25.189.194,0,0,1,269,1,269,1.445985000,0.0000
215.158.140.92,<->,126.219.101.175,1,1023,0,0,1,1023,1.445235000,0.0000
220.38.84.202,<->,133.178.226.28,0,0,1,1213,1,1213,1.444903000,0.0000
215.158.238.99,<->,199.69.87.69,1,1389,0,0,1,1389,1.444725000,0.0000
215.158.239.4,<->,144.253.55.16,1,1171,0,0,1,1171,1.444283000,0.0000
215.158.238.64,<->,113.23.104.221,1,1101,0,0,1,1101,1.444038000,0.0000
215.158.140.229,<->,8.57.163.158,1,1098,0,0,1,1098,1.443254000,0.0000
196.245.45.193,<->,136.25.188.198,0,0,1,93,1,93,1.443170000,0.0000
215.158.238.133,<->,106.188.251.194,1,1007,0,0,1,1007,1.443072000,0.0000
221.102.99.189,<->,199.12.100.120,1,375,0,0,1,375,1.443071000,0.0000
50.224.76.248,<->,29.128.174.25,1,1086,0,0,1,1086,1.442997000,0.0000
109.119.182.243,<->,8.182.136.236,0,0,1,250,1,250,1.442433000,0.0000
200.174.220.137,<->,54.39.6.118,1,434,0,0,1,434,1.442405000,0.0000
196.89.255.151,<->,136.25.188.225,0,0,1,93,1,93,1.442379000,0.0000
215.158.239.49,<->,199.80.85.234,1,269,0,0,1,269,1.442246000,0.0000
213.186.52.10,<->,144.85.170.246,0,0,1,891,1,891,1.442220000,0.0000
207.173.101.95,<->,136.25.188.160,0,0,1,765,1,765,1.441978000,0.0000
133.178.227.50,<->,80.57.141.64,1,1373,0,0,1,1373,1.441950000,0.0000
143.79.29.191,<->,136.25.188.46,0,0,1,426,1,426,1.441357000,0.0000
133.178.226.29,<->,29.123.209.149,1,1277,0,0,1,1277,1.441286000,0.0000
207.232.222.142,<->,133.54.28.143,0,0,1,396,1,396,1.441233000,0.0000
215.158.239.93,<->,207.61.15.197,1,85,0,0,1,85,1.440618000,0.0000
215.158.238.121,<->,113.23.111.182,1,1373,0,0,1,1373,1.440598000,0.0000
143.227.65.186,<->,136.25.188.160,0,0,1,1197,1,1197,1.440576000,0.0000
215.158.238.67,<->,80.47.111.74,1,1165,0,0,1,1165,1.440523000,0.0000
136.25.188.211,<->,113.20.94.75,1,1309,0,0,1,1309,1.440377000,0.0000
138.121.99.24,<->,8.220.178.246,0,0,1,561,1,561,1.439992000,0.0000
215.158.239.97,<->,196.109.149.114,1,637,0,0,1,637,1.439824000,0.0000
215.158.238.66,<->,131.36.198.24,1,1273,0,0,1,1273,1.439762000,0.0000
143.10.227.173,<->,136.25.188.196,0,0,1,602,1,602,1.439669000,0.0000
109.119.182.230,<->,8.182.136.236,0,0,1,250,1,250,1.439611000,0.0000
215.158.238.134,<->,133.186.30.36,1,1309,0,0,1,1309,1.438862000,0.0000
8.55.212.136,<->,6.74.242.83,0,0,1,141,1,141,1.438626000,0.0000
133.178.226.90,<->,57.210.107.25,1,1462,0,0,1,1462,1.438353000,0.0000
198.226.166.143,<->,133.178.226.30,0,0,1,1133,1,1133,1.438205000,0.0000
109.119.182.246,<->,8.182.136.236,0,0,1,250,1,250,1.437595000,0.0000
215.158.238.92,<->,113.23.104.247,1,93,0,0,1,93,1.437319000,0.0000
215.158.140.184,<->,98.249.65.2,1,178,0,0,1,178,1.437308000,0.0000
220.31.194.162,<->,145.116.119.49,0,0,1,95,1,95,1.437051000,0.0000
199.50.136.7,<->,136.25.188.226,0,0,1,269,1,269,1.437048000,0.0000
215.158.238.73,<->,8.252.210.248,1,1229,0,0,1,1229,1.436320000,0.0000
215.158.238.74,<->,131.144.113.180,1,1245,0,0,1,1245,1.436257000,0.0000
215.158.239.76,<->,207.191.73.225,1,141,0,0,1,141,1.435849000,0.0000
139.163.26.146,<->,118.90.58.35,1,99,0,0,1,99,1.435804000,0.0000
215.158.238.107,<->,122.29.159.87,1,1229,0,0,1,1229,1.435598000,0.0000
136.25.189.94,<->,96.156.169.199,1,980,0,0,1,980,1.435487000,0.0000
215.158.239.32,<->,106.188.156.206,1,1485,0,0,1,1485,1.435189000,0.0000
215.158.127.165,<->,8.252.222.139,0,0,1,489,1,489,1.435155000,0.0000
215.158.239.95,<->,196.94.227.74,1,107,0,0,1,107,1.434750000,0.0000
215.158.60.32,<->,133.178.226.213,0,0,1,319,1,319,1.434634000,0.0000
136.25.189.59,<->,29.212.199.34,1,1357,0,0,1,1357,1.434526000,0.0000
239.66.76.150,<->,100.94.91.165,0,0,1,786,1,786,1.434121000,0.0000
140.161.45.32,<->,136.25.189.58,0,0,1,1213,1,1213,1.433880000,0.0000
215.158.239.50,<->,122.159.245.29,1,1213,0,0,1,1213,1.433577000,0.0000
220.60.81.144,<->,136.25.189.33,0,0,1,1099,1,1099,1.433358000,0.0000
139.163.68.55,<->,56.9.27.149,1,51,0,0,1,51,1.433058000,0.0000
8.182.239.241,<->,6.242.35.66,1,404,0,0,1,404,1.432823000,0.0000
196.246.171.55,<->,136.25.188.173,0,0,1,602,1,602,1.432661000,0.0000
220.39.21.52,<->,133.32.39.1,0,0,1,247,1,247,1.431753000,0.0000
221.102.143.189,<->,98.128.162.225,0,0,1,63,1,63,1.431591000,0.0000
221.196.122.207,<->,136.25.188.226,0,0,1,289,1,289,1.431256000,0.0000
215.158.238.92,<->,143.227.65.224,1,1309,0,0,1,1309,1.431063000,0.0000
207.236.24.89,<->,136.25.188.55,0,0,1,744,1,744,1.430903000,0.0000
215.158.239.95,<->,207.190.184.136,1,172,0,0,1,172,1.430747000,0.0000
215.158.238.140,<->,193.18.105.54,1,1197,0,0,1,1197,1.430136000,0.0000
215.158.238.92,<->,80.47.228.215,1,996,0,0,1,996,1.430105000,0.0000
215.158.239.41,<->,192.170.245.163,1,914,0,0,1,914,1.430053000,0.0000
99.175.115.144,<->,53.69.209.31,1,125,0,0,1,125,1.429869000,0.0000
195.70.125.179,<->,136.25.188.162,0,0,1,285,1,285,1.429587000,0.0000
215.158.238.83,<->,80.47.111.11,1,93,0,0,1,93,1.429550000,0.0000
92.168.217.252,<->,88.122.34.13,1,315,0,0,1,315,1.429291000,0.0000
215.158.238.135,<->,112.220.206.107,1,1101,0,0,1,1101,1.429160000,0.0000
215.158.239.113,<->,129.222.39.125,1,624,0,0,1,624,1.428791000,0.0000
215.158.239.94,<->,199.20.30.63,1,240,0,0,1,240,1.428470000,0.0000
144.83.60.153,<->,92.162.253.94,0,0,1,75,1,75,1.428132000,0.0000
138.98.210.200,<->,99.170.109.141,1,101,0,0,1,101,1.427727000,0.0000
136.158.73.56,<->,133.178.227.227,0,0,1,94,1,94,1.427657000,0.0000
215.158.239.182,<->,144.253.73.244,1,226,0,0,1,226,1.427649000,0.0000
215.158.239.49,<->,117.155.166.216,1,1229,0,0,1,1229,1.427048000,0.0000
136.25.189.33,<->,68.124.221.158,1,1213,0,0,1,1213,1.425617000,0.0000
143.44.75.225,<->,136.25.188.225,0,0,1,93,1,93,1.425570000,0.0000
148.146.91.23,<->,136.25.188.199,0,0,1,1213,1,1213,1.425204000,0.0000
54.37.130.82,<->,48.55.72.9,0,0,1,577,1,577,1.424980000,0.0000
140.174.85.72,<->,136.25.189.46,0,0,1,1325,1,1325,1.424930000,0.0000
142.221.188.66,<->,136.25.188.253,0,0,1,303,1,303,1.424860000,0.0000
215.158.239.69,<->,196.108.238.88,1,907,0,0,1,907,1.424777000,0.0000
215.158.239.232,<->,100.244.13.26,1,109,0,0,1,109,1.424298000,0.0000
133.178.227.43,<->,8.191.14.88,1,1200,0,0,1,1200,1.424265000,0.0000
53.69.143.15,<->,48.55.110.73,0,0,1,81,1,81,1.424157000,0.0000
136.129.94.157,<->,6.145.166.196,1,414,0,0,1,414,1.423981000,0.0000
132.250.195.43,<->,6.138.238.145,0,0,1,205,1,205,1.423908000,0.0000
210.229.230.18,<->,103.36.39.102,1,68,0,0,1,68,1.423296000,0.0000
215.158.238.148,<->,215.158.199.155,1,1197,0,0,1,1197,1.423250000,0.0000
210.229.230.20,<->,103.12.39.16,1,68,0,0,1,68,1.423011000,0.0000
136.139.59.124,<->,136.25.188.172,0,0,1,93,1,93,1.422746000,0.0000
215.158.239.97,<->,199.20.4.254,1,749,0,0,1,749,1.421961000,0.0000
136.25.188.179,<->,69.132.194.169,1,1213,0,0,1,1213,1.421924000,0.0000
215.158.238.135,<->,111.151.70.30,1,1487,0,0,1,1487,1.421712000,0.0000
215.158.239.95,<->,199.20.29.254,1,93,0,0,1,93,1.421591000,0.0000
157.127.139.203,<->,8.252.221.223,0,0,1,318,1,318,1.421310000,0.0000
136.25.188.44,<->,131.173.115.89,1,1389,0,0,1,1389,1.420637000,0.0000
215.158.238.64,<->,139.160.226.215,1,1245,0,0,1,1245,1.420485000,0.0000
136.25.189.31,<->,8.33.226.56,1,1357,0,0,1,1357,1.420375000,0.0000
215.158.239.48,<->,204.226.48.181,1,312,0,0,1,312,1.420178000,0.0000
204.60.11.253,<->,136.25.188.225,0,0,1,87,1,87,1.419470000,0.0000
252.72.199.121,<->,53.148.21.222,1,125,0,0,1,125,1.418287000,0.0000
133.178.226.30,<->,113.23.113.198,1,1245,0,0,1,1245,1.418243000,0.0000
142.167.103.21,<->,136.25.188.53,0,0,1,269,1,269,1.418216000,0.0000
220.80.203.35,<->,8.45.162.111,1,1237,0,0,1,1237,1.418109000,0.0000
204.185.39.72,<->,136.25.188.45,0,0,1,136,1,136,1.417306000,0.0000
69.128.107.113,<->,53.214.77.100,1,115,0,0,1,115,1.417102000,0.0000
235.42.34.33,<->,215.158.238.123,0,0,1,1325,1,1325,1.416972000,0.0000
133.178.227.2,<->,8.40.51.113,1,1373,0,0,1,1373,1.416891000,0.0000
139.163.26.146,<->,92.180.160.229,1,99,0,0,1,99,1.416805000,0.0000
215.158.238.134,<->,29.212.189.31,1,1085,0,0,1,1085,1.416722000,0.0000
133.178.226.38,<->,64.152.12.85,1,1277,0,0,1,1277,1.416580000,0.0000
222.244.24.203,<->,215.158.238.107,0,0,1,69,1,69,1.416522000,0.0000
192.64.217.166,<->,33.123.162.14,1,112,0,0,1,112,1.416201000,0.0000
143.13.48.59,<->,136.25.188.178,0,0,1,602,1,602,1.415891000,0.0000
215.158.238.66,<->,212.70.217.70,1,1213,0,0,1,1213,1.415664000,0.0000
203.215.160.157,<->,6.243.218.191,1,111,0,0,1,111,1.415177000,0.0000
252.98.149.157,<->,137.39.55.81,1,849,0,0,1,849,1.414732000,0.0000
196.247.183.106,<->,136.25.188.238,0,0,1,101,1,101,1.414417000,0.0000
92.27.219.243,<->,33.57.74.149,1,50,0,0,1,50,1.413864000,0.0000
143.76.153.141,<->,8.182.227.180,0,0,1,250,1,250,1.413677000,0.0000
149.96.53.39,<->,136.25.188.47,0,0,1,1341,1,1341,1.413409000,0.0000
215.158.239.50,<->,207.228.242.169,1,101,0,0,1,101,1.413070000,0.0000
215.158.61.191,<->,8.176.8.255,0,0,1,861,1,861,1.412945000,0.0000
215.158.239.97,<->,207.57.17.96,1,93,0,0,1,93,1.412610000,0.0000
136.25.188.51,<->,98.219.126.140,1,616,0,0,1,616,1.411830000,0.0000
246.254.97.109,<->,139.33.175.144,1,216,0,0,1,216,1.411330000,0.0000
207.172.169.238,<->,136.25.188.163,0,0,1,117,1,117,1.411022000,0.0000
133.178.227.16,<->,128.23.167.186,1,1175,0,0,1,1175,1.410738000,0.0000
144.87.235.222,<->,112.208.20.140,1,50,0,0,1,50,1.410630000,0.0000
145.144.97.237,<->,8.222.6.88,1,1143,0,0,1,1143,1.410552000,0.0000
136.25.189.16,<->,96.156.169.168,1,1469,0,0,1,1469,1.410321000,0.0000
204.200.35.204,<->,136.25.188.225,0,0,1,497,1,497,1.410206000,0.0000
156.181.149.34,<->,136.25.189.81,0,0,1,1213,1,1213,1.410109000,0.0000
215.158.238.190,<->,68.231.26.203,1,1133,0,0,1,1133,1.410064000,0.0000
215.158.239.43,<->,128.95.93.135,1,282,0,0,1,282,1.409767000,0.0000
207.172.1.228,<->,136.25.188.252,0,0,1,765,1,765,1.409614000,0.0000
215.158.239.81,<->,100.216.78.145,1,183,0,0,1,183,1.409452000,0.0000
215.158.239.35,<->,57.210.104.245,1,1311,0,0,1,1311,1.409346000,0.0000
149.163.134.231,<->,133.178.227.2,0,0,1,1045,1,1045,1.409252000,0.0000
249.101.93.221,<->,109.127.101.16,1,499,0,0,1,499,1.408620000,0.0000
220.50.217.46,<->,8.52.228.29,0,0,1,759,1,759,1.408242000,0.0000
201.211.112.219,<->,133.178.226.30,0,0,1,1069,1,1069,1.407891000,0.0000
207.117.212.70,<->,8.182.239.140,0,0,1,75,1,75,1.407681000,0.0000
43.55.252.156,<->,8.252.221.230,0,0,1,454,1,454,1.407463000,0.0000
215.158.238.64,<->,111.151.70.54,1,1373,0,0,1,1373,1.407424000,0.0000
215.158.238.45,<->,89.80.251.7,1,1101,0,0,1,1101,1.407058000,0.0000
127.106.241.57,<->,0.195.210.44,0,0,1,109,1,109,1.406944000,0.0000
195.12.236.137,<->,136.25.188.222,0,0,1,272,1,272,1.406869000,0.0000
142.236.192.102,<->,136.25.188.242,0,0,1,859,1,859,1.406703000,0.0000
215.158.238.133,<->,42.97.54.26,1,1085,0,0,1,1085,1.406565000,0.0000
207.173.189.193,<->,136.25.188.255,0,0,1,602,1,602,1.406484000,0.0000
215.158.238.83,<->,113.23.104.215,1,1261,0,0,1,1261,1.406460000,0.0000
253.103.78.162,<->,136.25.188.162,0,0,1,1405,1,1405,1.406330000,0.0000
197.113.99.241,<->,136.25.188.222,0,0,1,602,1,602,1.405948000,0.0000
50.224.80.67,<->,8.238.74.141,1,340,0,0,1,340,1.405077000,0.0000
215.158.238.243,<->,126.219.194.16,1,1093,0,0,1,1093,1.404441000,0.0000
215.158.140.60,<->,8.190.217.148,1,1049,0,0,1,1049,1.404327000,0.0000
222.21.15.70,<->,109.222.220.116,0,0,1,82,1,82,1.404296000,0.0000
215.158.239.95,<->,199.20.29.151,1,765,0,0,1,765,1.404177000,0.0000
246.253.253.97,<->,111.151.239.156,1,675,0,0,1,675,1.404173000,0.0000
223.114.90.164,<->,8.252.221.199,0,0,1,301,1,301,1.404156000,0.0000
158.253.43.183,<->,136.25.188.226,0,0,1,1181,1,1181,1.403574000,0.0000
127.212.165.217,<->,89.183.104.159,0,0,1,378,1,378,1.403364000,0.0000
215.158.3.212,<->,133.178.227.243,0,0,1,861,1,861,1.403304000,0.0000
215.158.140.76,<->,8.220.54.227,1,1183,0,0,1,1183,1.403187000,0.0000
136.25.188.226,<->,120.20.132.22,1,1341,0,0,1,1341,1.402966000,0.0000
215.158.239.78,<->,29.214.73.139,1,133,0,0,1,133,1.402868000,0.0000
97.4.117.28,<->,56.121.51.247,0,0,1,522,1,522,1.402372000,0.0000
89.216.125.234,<->,53.229.32.4,1,1019,0,0,1,1019,1.402005000,0.0000
136.139.59.124,<->,136.25.189.89,0,0,1,93,1,93,1.401997000,0.0000
136.25.189.34,<->,57.4.201.137,1,1213,0,0,1,1213,1.401945000,0.0000
221.102.103.73,<->,207.118.195.146,1,428,0,0,1,428,1.401525000,0.0000
215.158.239.85,<->,196.94.109.52,1,717,0,0,1,717,1.400829000,0.0000
231.140.128.144,<->,215.158.239.56,0,0,1,87,1,87,1.400690000,0.0000
109.113.90.155,<->,8.182.245.152,0,0,1,656,1,656,1.400228000,0.0000
215.158.140.219,<->,8.176.6.40,1,576,0,0,1,576,1.400052000,0.0000
199.32.118.218,<->,136.25.188.197,0,0,1,765,1,765,1.400035000,0.0000
215.158.30.28,<->,136.25.189.28,0,0,1,101,1,101,1.399682000,0.0000
215.158.239.97,<->,207.236.94.93,1,1088,0,0,1,1088,1.399624000,0.0000
109.222.212.28,<->,53.84.124.210,1,241,0,0,1,241,1.399587000,0.0000
195.5.142.153,<->,136.25.188.177,0,0,1,602,1,602,1.399468000,0.0000
215.158.238.106,<->,138.126.75.36,1,1197,0,0,1,1197,1.399165000,0.0000
215.158.238.123,<->,118.20.114.81,1,1389,0,0,1,1389,1.398798000,0.0000
192.67.175.59,<->,132.18.67.26,1,192,0,0,1,192,1.398591000,0.0000
105.163.53.213,<->,80.41.26.51,0,0,1,112,1,112,1.398175000,0.0000
215.158.239.68,<->,207.63.240.255,1,87,0,0,1,87,1.398066000,0.0000
133.178.226.38,<->,38.104.11.16,1,1165,0,0,1,1165,1.397921000,0.0000
215.158.127.244,<->,8.252.223.142,0,0,1,1077,1,1077,1.397424000,0.0000
136.25.189.78,<->,96.156.169.169,1,423,0,0,1,423,1.397336000,0.0000
215.158.238.96,<->,64.152.12.87,1,1277,0,0,1,1277,1.397269000,0.0000
215.158.238.135,<->,128.123.91.104,1,1165,0,0,1,1165,1.397055000,0.0000
215.158.239.78,<->,196.94.238.66,1,602,0,0,1,602,1.396954000,0.0000
215.158.239.17,<->,199.82.11.179,1,263,0,0,1,263,1.396675000,0.0000
111.147.166.45,<->,53.149.44.254,1,125,0,0,1,125,1.396597000,0.0000
215.158.238.209,<->,131.36.105.41,1,1178,0,0,1,1178,1.396420000,0.0000
136.11.64.218,<->,8.53.2.189,0,0,1,211,1,211,1.396040000,0.0000
221.102.143.189,<->,80.40.17.42,0,0,1,87,1,87,1.395794000,0.0000
215.158.239.96,<->,195.54.150.59,1,669,0,0,1,669,1.395768000,0.0000
133.135.214.222,<->,101.76.17.252,0,0,1,436,1,436,1.395592000,0.0000
194.232.2.136,<->,136.25.188.242,0,0,1,756,1,756,1.395517000,0.0000
215.158.61.202,<->,136.25.188.39,0,0,1,781,1,781,1.395410000,0.0000
48.129.133.80,<->,8.252.223.143,0,0,1,1181,1,1181,1.394960000,0.0000
201.211.112.219,<->,133.178.226.29,0,0,1,1069,1,1069,1.394864000,0.0000
195.68.154.205,<->,136.25.188.198,0,0,1,602,1,602,1.394054000,0.0000
6.145.149.227,<->,0.195.210.46,0,0,1,441,1,441,1.394016000,0.0000
215.158.61.211,<->,8.252.222.105,0,0,1,483,1,483,1.394008000,0.0000
136.25.189.15,<->,57.199.250.198,1,1453,0,0,1,1453,1.393689000,0.0000
215.158.239.182,<->,29.214.216.64,1,285,0,0,1,285,1.393459000,0.0000
215.158.238.45,<->,99.74.26.116,1,1069,0,0,1,1069,1.393263000,0.0000
92.168.217.254,<->,50.136.154.212,1,315,0,0,1,315,1.392883000,0.0000
215.158.239.51,<->,199.20.28.249,1,602,0,0,1,602,1.392859000,0.0000
215.158.61.193,<->,136.25.188.40,0,0,1,781,1,781,1.392851000,0.0000
111.150.186.232,<->,8.252.222.237,0,0,1,1213,1,1213,1.392758000,0.0000
215.158.61.189,<->,8.176.8.245,0,0,1,397,1,397,1.392441000,0.0000
204.17.171.198,<->,50.223.3.228,0,0,1,295,1,295,1.391837000,0.0000
231.143.107.87,<->,136.25.188.226,0,0,1,107,1,107,1.391797000,0.0000
133.178.227.57,<->,61.35.70.37,1,1117,0,0,1,1117,1.391560000,0.0000
142.228.169.90,<->,136.25.188.252,0,0,1,561,1,561,1.390710000,0.0000
207.11.112.165,<->,8.252.222.161,0,0,1,877,1,877,1.390453000,0.0000
201.209.14.61,<->,139.193.141.139,0,0,1,397,1,397,1.390315000,0.0000
215.158.239.50,<->,199.20.31.197,1,602,0,0,1,602,1.389814000,0.0000
207.56.107.29,<->,136.25.188.253,0,0,1,765,1,765,1.389286000,0.0000
133.20.191.58,<->,8.20.87.94,0,0,1,254,1,254,1.388560000,0.0000
136.25.189.18,<->,120.155.8.109,1,1213,0,0,1,1213,1.388329000,0.0000
142.221.15.189,<->,136.25.188.252,0,0,1,87,1,87,1.388007000,0.0000
143.128.216.164,<->,136.25.188.220,0,0,1,93,1,93,1.387967000,0.0000
122.222.237.212,<->,92.27.219.32,0,0,1,217,1,217,1.387961000,0.0000
252.98.138.179,<->,50.224.34.245,1,1136,0,0,1,1136,1.387352000,0.0000
8.52.182.119,<->,6.82.175.133,1,271,0,0,1,271,1.386617000,0.0000
133.178.227.40,<->,29.211.6.119,1,1309,0,0,1,1309,1.386518000,0.0000
215.158.239.33,<->,57.210.104.228,1,104,0,0,1,104,1.386063000,0.0000
215.158.239.97,<->,196.106.26.214,1,602,0,0,1,602,1.386020000,0.0000
204.186.122.183,<->,136.25.188.222,0,0,1,272,1,272,1.385992000,0.0000
215.158.140.188,<->,100.224.243.66,1,804,0,0,1,804,1.385659000,0.0000
144.94.162.244,<->,0.195.210.42,0,0,1,717,1,717,1.385520000,0.0000
143.43.193.213,<->,50.224.76.235,0,0,1,890,1,890,1.385305000,0.0000
215.158.238.92,<->,158.192.5.136,1,1325,0,0,1,1325,1.385246000,0.0000
92.27.219.219,<->,33.57.78.103,1,54,0,0,1,54,1.384733000,0.0000
97.126.4.233,<->,53.196.130.109,1,385,0,0,1,385,1.384636000,0.0000
109.1.61.153,<->,53.167.159.127,1,57,0,0,1,57,1.384348000,0.0000
99.187.125.121,<->,8.20.87.2,0,0,1,1009,1,1009,1.383707000,0.0000
204.63.248.181,<->,136.25.188.243,0,0,1,781,1,781,1.383657000,0.0000
215.158.238.65,<->,125.84.145.37,1,1197,0,0,1,1197,1.383645000,0.0000
136.25.188.44,<->,57.184.236.82,1,1309,0,0,1,1309,1.382693000,0.0000
136.25.188.211,<->,113.23.104.220,1,1213,0,0,1,1213,1.382668000,0.0000
136.181.42.74,<->,54.49.224.150,1,223,0,0,1,223,1.382378000,0.0000
195.54.102.95,<->,136.25.188.179,0,0,1,101,1,101,1.382020000,0.0000
246.253.169.93,<->,8.35.106.89,1,509,0,0,1,509,1.381791000,0.0000
215.158.239.87,<->,207.212.47.193,1,854,0,0,1,854,1.381783000,0.0000
215.158.239.85,<->,199.20.4.252,1,1128,0,0,1,1128,1.381159000,0.0000
215.158.238.23,<->,111.151.71.52,1,1309,0,0,1,1309,1.380873000,0.0000
215.158.238.209,<->,131.1.194.253,1,1085,0,0,1,1085,1.380499000,0.0000
92.162.253.98,<->,33.229.46.107,1,1408,0,0,1,1408,1.380297000,0.0000
206.158.155.251,<->,139.193.141.139,0,0,1,353,1,353,1.380284000,0.0000
207.239.173.59,<->,136.25.188.176,0,0,1,87,1,87,1.379964000,0.0000
196.114.37.188,<->,50.224.76.234,0,0,1,1226,1,1226,1.379797000,0.0000
215.158.238.32,<->,8.191.15.11,1,1197,0,0,1,1197,1.379783000,0.0000
204.21.246.104,<->,136.25.188.220,0,0,1,282,1,282,1.379634000,0.0000
215.158.239.79,<->,142.252.67.76,1,85,0,0,1,85,1.379557000,0.0000
144.85.170.244,<->,139.128.205.252,1,827,0,0,1,827,1.379505000,0.0000
128.150.111.92,<->,50.224.76.230,0,0,1,494,1,494,1.379369000,0.0000
221.196.122.207,<->,136.25.188.209,0,0,1,289,1,289,1.379138000,0.0000
215.158.238.106,<->,148.56.229.100,1,1213,0,0,1,1213,1.378888000,0.0000
159.13.229.102,<->,132.240.86.217,1,177,0,0,1,177,1.378752000,0.0000
133.178.227.76,<->,111.150.39.23,1,1120,0,0,1,1120,1.378354000,0.0000
199.38.241.87,<->,136.25.188.243,0,0,1,235,1,235,1.378297000,0.0000
136.139.59.124,<->,136.25.188.222,0,0,1,93,1,93,1.378290000,0.0000
136.25.188.176,<->,120.20.132.0,1,1025,0,0,1,1025,1.378213000,0.0000
8.252.221.205,<->,4.123.114.127,1,456,0,0,1,456,1.378088000,0.0000
215.158.239.29,<->,61.34.126.202,1,1453,0,0,1,1453,1.377962000,0.0000
247.136.209.128,<->,27.40.0.127,1,196,0,0,1,196,1.377743000,0.0000
210.229.230.21,<->,111.93.85.22,1,68,0,0,1,68,1.377493000,0.0000
192.227.191.250,<->,133.178.227.208,0,0,1,93,1,93,1.377481000,0.0000
207.59.201.32,<->,136.25.188.52,0,0,1,709,1,709,1.377348000,0.0000
149.163.129.160,<->,136.25.189.57,0,0,1,1357,1,1357,1.377335000,0.0000
195.54.62.5,<->,136.25.188.220,0,0,1,300,1,300,1.376973000,0.0000
215.158.140.60,<->,139.106.73.234,1,1165,0,0,1,1165,1.376508000,0.0000
100.115.92.207,<->,97.110.90.36,1,137,0,0,1,137,1.376154000,0.0000
215.158.238.223,<->,100.50.96.239,1,1117,0,0,1,1117,1.376016000,0.0000
196.247.24.238,<->,136.25.188.175,0,0,1,172,1,172,1.375740000,0.0000
215.158.140.164,<->,8.222.7.160,1,818,0,0,1,818,1.375496000,0.0000
215.158.238.67,<->,29.213.218.232,1,1293,0,0,1,1293,1.375228000,0.0000
215.158.239.95,<->,139.160.226.200,1,1389,0,0,1,1389,1.375163000,0.0000
221.102.56.69,<->,218.4.179.115,0,0,1,294,1,294,1.375143000,0.0000
220.20.200.194,<->,113.168.237.37,1,552,0,0,1,552,1.374991000,0.0000
215.158.239.92,<->,195.49.164.235,1,797,0,0,1,797,1.374978000,0.0000
215.158.238.121,<->,143.155.227.59,1,244,0,0,1,244,1.374971000,0.0000
204.186.72.133,<->,136.25.188.53,0,0,1,190,1,190,1.374809000,0.0000
215.158.238.133,<->,122.158.51.91,1,1181,0,0,1,1181,1.374744000,0.0000
133.178.227.208,<->,111.151.237.128,1,1437,0,0,1,1437,1.374124000,0.0000
8.252.222.46,<->,4.121.146.241,1,602,0,0,1,602,1.373872000,0.0000
215.158.238.134,<->,8.219.186.181,1,1021,0,0,1,1021,1.373606000,0.0000
139.193.141.139,<->,6.228.183.5,1,576,0,0,1,576,1.373604000,0.0000
215.158.140.184,<->,6.82.175.133,1,225,0,0,1,225,1.372875000,0.0000
6.145.153.218,<->,0.195.210.44,0,0,1,173,1,173,1.372865000,0.0000
212.164.143.230,<->,46.41.87.241,1,359,0,0,1,359,1.372595000,0.0000
136.25.188.163,<->,57.227.82.203,1,1341,0,0,1,1341,1.372535000,0.0000
204.63.125.33,<->,136.25.188.242,0,0,1,172,1,172,1.372522000,0.0000
215.158.238.81,<->,148.55.210.213,1,1357,0,0,1,1357,1.372511000,0.0000
215.158.238.81,<->,131.144.113.168,1,1213,0,0,1,1213,1.372191000,0.0000
252.98.135.226,<->,106.5.211.8,1,162,0,0,1,162,1.372014000,0.0000
48.18.250.117,<->,8.252.222.38,0,0,1,121,1,121,1.371800000,0.0000
8.252.223.175,<->,8.219.184.92,1,1231,0,0,1,1231,1.371584000,0.0000
142.253.75.50,<->,136.25.188.196,0,0,1,602,1,602,1.371383000,0.0000
215.158.239.69,<->,199.20.31.18,1,87,0,0,1,87,1.371172000,0.0000
215.158.140.178,<->,6.15.196.147,1,781,0,0,1,781,1.371101000,0.0000
143.94.23.34,<->,50.224.76.234,0,0,1,857,1,857,1.370808000,0.0000
215.158.238.107,<->,149.99.92.67,1,1005,0,0,1,1005,1.370795000,0.0000
99.74.26.152,<->,8.240.120.93,1,525,0,0,1,525,1.370411000,0.0000
50.224.76.248,<->,17.139.200.50,1,722,0,0,1,722,1.370359000,0.0000
215.158.238.73,<->,80.47.111.26,1,1341,0,0,1,1341,1.369930000,0.0000
65.26.119.20,<->,50.224.76.248,0,0,1,764,1,764,1.369805000,0.0000
231.138.130.211,<->,136.25.188.227,0,0,1,93,1,93,1.369154000,0.0000
215.158.238.75,<->,8.240.117.62,1,1197,0,0,1,1197,1.368691000,0.0000
80.40.33.147,<->,8.55.135.127,1,394,0,0,1,394,1.368571000,0.0000
215.158.238.209,<->,8.42.42.148,1,1405,0,0,1,1405,1.368384000,0.0000
119.45.10.74,<->,92.162.253.94,0,0,1,214,1,214,1.368364000,0.0000
196.21.87.7,<->,50.224.76.234,0,0,1,786,1,786,1.367830000,0.0000
132.123.40.33,<->,111.151.237.13,1,271,0,0,1,271,1.367826000,0.0000
246.253.253.171,<->,56.114.235.120,1,486,0,0,1,486,1.367786000,0.0000
215.158.239.68,<->,199.20.30.197,1,602,0,0,1,602,1.367643000,0.0000
197.113.99.27,<->,136.25.188.252,0,0,1,753,1,753,1.367315000,0.0000
215.158.238.63,<->,8.192.205.94,1,433,0,0,1,433,1.367136000,0.0000
142.208.190.55,<->,136.25.188.175,0,0,1,650,1,650,1.367090000,0.0000
133.178.226.7,<->,120.20.132.54,1,1325,0,0,1,1325,1.367052000,0.0000
104.203.8.6,<->,50.224.76.248,0,0,1,661,1,661,1.367038000,0.0000
215.158.239.56,<->,198.204.76.195,1,1229,0,0,1,1229,1.366658000,0.0000
149.251.213.181,<->,8.252.222.227,0,0,1,1341,1,1341,1.366473000,0.0000
200.175.133.69,<->,53.69.18.13,1,87,0,0,1,87,1.366196000,0.0000
54.36.210.180,<->,48.53.34.115,0,0,1,110,1,110,1.366159000,0.0000
139.207.175.72,<->,50.224.76.235,0,0,1,1100,1,1100,1.365960000,0.0000
194.254.134.22,<->,92.27.194.147,0,0,1,248,1,248,1.365693000,0.0000
201.211.112.247,<->,133.178.227.2,0,0,1,1469,1,1469,1.365475000,0.0000
215.158.239.50,<->,199.20.31.238,1,602,0,0,1,602,1.365314000,0.0000
215.158.238.133,<->,89.86.110.85,1,1213,0,0,1,1213,1.365068000,0.0000
159.137.252.189,<->,38.253.84.123,1,222,0,0,1,222,1.365014000,0.0000
132.49.144.232,<->,54.36.194.252,1,125,0,0,1,125,1.364973000,0.0000
192.171.32.186,<->,133.178.227.1,0,0,1,1341,1,1341,1.364287000,0.0000
215.158.238.64,<->,113.23.104.247,1,1229,0,0,1,1229,1.364251000,0.0000
132.200.62.217,<->,132.20.222.234,1,97,0,0,1,97,1.364157000,0.0000
215.158.238.141,<->,131.144.115.171,1,1261,0,0,1,1261,1.364024000,0.0000
207.59.201.32,<->,136.25.188.227,0,0,1,696,1,696,1.363759000,0.0000
215.158.239.56,<->,142.166.40.166,1,456,0,0,1,456,1.363543000,0.0000
192.65.82.37,<->,8.45.168.98,1,458,0,0,1,458,1.363234000,0.0000
117.41.238.88,<->,50.224.76.230,0,0,1,1462,1,1462,1.363010000,0.0000
215.158.238.90,<->,98.219.126.140,1,659,0,0,1,659,1.362965000,0.0000
215.158.238.98,<->,111.150.186.224,1,1309,0,0,1,1309,1.362434000,0.0000
248.225.27.2,<->,139.123.56.52,1,150,0,0,1,150,1.361584000,0.0000
136.25.188.176,<->,131.1.253.210,1,1457,0,0,1,1457,1.361571000,0.0000
133.178.227.24,<->,100.50.96.222,1,1069,0,0,1,1069,1.361369000,0.0000
8.252.222.63,<->,4.123.43.176,1,87,0,0,1,87,1.361264000,0.0000
215.158.238.176,<->,8.220.54.215,1,1129,0,0,1,1129,1.361194000,0.0000
207.172.206.228,<->,136.25.188.237,0,0,1,378,1,378,1.360671000,0.0000
213.221.90.240,<->,144.85.170.208,0,0,1,440,1,440,1.359816000,0.0000
133.178.227.41,<->,8.222.6.193,1,935,0,0,1,935,1.359500000,0.0000
132.200.62.137,<->,132.200.51.75,1,801,0,0,1,801,1.358571000,0.0000
193.114.179.141,<->,50.224.105.38,0,0,1,433,1,433,1.358405000,0.0000
156.165.33.55,<->,133.178.226.30,0,0,1,1021,1,1021,1.358278000,0.0000
142.221.188.66,<->,136.25.188.209,0,0,1,316,1,316,1.358220000,0.0000
97.11.164.237,<->,54.59.120.90,1,356,0,0,1,356,1.358135000,0.0000
8.252.223.145,<->,8.222.6.193,1,1070,0,0,1,1070,1.357016000,0.0000
215.158.238.199,<->,29.211.165.26,1,1267,0,0,1,1267,1.356972000,0.0000
144.85.170.254,<->,98.87.144.72,1,710,0,0,1,710,1.356915000,0.0000
91.69.181.169,<->,50.224.105.36,0,0,1,446,1,446,1.356521000,0.0000
215.158.238.97,<->,143.155.227.33,1,264,0,0,1,264,1.355750000,0.0000
136.25.188.161,<->,113.20.94.98,1,1293,0,0,1,1293,1.355443000,0.0000
133.178.227.24,<->,69.150.168.231,1,1097,0,0,1,1097,1.355394000,0.0000
196.148.120.203,<->,57.144.209.128,1,430,0,0,1,430,1.355184000,0.0000
143.13.180.223,<->,136.25.188.198,0,0,1,617,1,617,1.355149000,0.0000
255.133.39.74,<->,53.231.144.222,1,97,0,0,1,97,1.355065000,0.0000
192.226.44.75,<->,136.25.188.29,0,0,1,1042,1,1042,1.354581000,0.0000
204.187.46.190,<->,136.25.188.252,0,0,1,250,1,250,1.354540000,0.0000
215.158.238.82,<->,29.212.203.155,1,1197,0,0,1,1197,1.354201000,0.0000
215.202.174.55,<->,136.25.189.12,0,0,1,1165,1,1165,1.354150000,0.0000
242.121.32.147,<->,212.164.134.114,0,0,1,65,1,65,1.353308000,0.0000
136.25.188.163,<->,8.190.216.201,1,1389,0,0,1,1389,1.352741000,0.0000
136.25.189.78,<->,72.23.6.46,1,1213,0,0,1,1213,1.352237000,0.0000
133.178.226.61,<->,29.212.195.10,1,1149,0,0,1,1149,1.351893000,0.0000
195.13.130.115,<->,136.25.188.197,0,0,1,252,1,252,1.351616000,0.0000
54.58.137.120,<->,48.52.117.46,0,0,1,65,1,65,1.351333000,0.0000
8.252.222.199,<->,4.121.253.129,1,350,0,0,1,350,1.351228000,0.0000
97.126.100.53,<->,54.55.56.239,1,337,0,0,1,337,1.351119000,0.0000
114.183.235.64,<->,99.74.27.84,0,0,1,1190,1,1190,1.350334000,0.0000
89.155.44.123,<->,8.182.251.151,0,0,1,320,1,320,1.350334000,0.0000
195.14.91.226,<->,136.25.188.252,0,0,1,93,1,93,1.349678000,0.0000
215.158.238.32,<->,193.39.70.95,1,1085,0,0,1,1085,1.349318000,0.0000
215.158.140.217,<->,192.228.81.200,1,830,0,0,1,830,1.349107000,0.0000
215.158.238.141,<->,38.104.11.60,1,1425,0,0,1,1425,1.349082000,0.0000
215.158.239.76,<->,199.20.4.50,1,113,0,0,1,113,1.348589000,0.0000
215.158.239.5,<->,8.222.7.168,1,1135,0,0,1,1135,1.348420000,0.0000
144.85.170.254,<->,91.69.185.193,1,435,0,0,1,435,1.348111000,0.0000
199.15.1.146,<->,136.25.188.53,0,0,1,302,1,302,1.348083000,0.0000
255.133.225.38,<->,255.133.225.23,0,0,1,111,1,111,1.347946000,0.0000
144.83.60.153,<->,92.162.253.110,0,0,1,626,1,626,1.347840000,0.0000
215.158.239.56,<->,194.251.126.128,1,93,0,0,1,93,1.347681000,0.0000
215.158.140.217,<->,8.192.194.217,1,386,0,0,1,386,1.347407000,0.0000
207.231.197.31,<->,8.252.222.62,0,0,1,240,1,240,1.347365000,0.0000
215.158.239.87,<->,199.20.5.71,1,797,0,0,1,797,1.347320000,0.0000
215.158.61.145,<->,8.176.8.180,0,0,1,589,1,589,1.346647000,0.0000
254.70.243.200,<->,109.1.32.164,0,0,1,70,1,70,1.346607000,0.0000
215.158.239.70,<->,8.215.68.57,1,1413,0,0,1,1413,1.346463000,0.0000
204.200.34.97,<->,136.25.188.162,0,0,1,132,1,132,1.346225000,0.0000
136.25.188.160,<->,131.215.37.28,1,1309,0,0,1,1309,1.346207000,0.0000
136.25.189.18,<->,131.144.113.10,1,1437,0,0,1,1437,1.346118000,0.0000
215.158.238.36,<->,69.31.239.99,1,1453,0,0,1,1453,1.345986000,0.0000
136.25.188.211,<->,131.173.115.86,1,1373,0,0,1,1373,1.345826000,0.0000
215.158.239.85,<->,143.52.21.138,1,340,0,0,1,340,1.345557000,0.0000
215.158.238.73,<->,119.196.23.70,1,1245,0,0,1,1245,1.345452000,0.0000
8.182.229.174,<->,6.133.194.44,1,607,0,0,1,607,1.344944000,0.0000
194.253.82.85,<->,8.252.222.236,0,0,1,117,1,117,1.344928000,0.0000
215.158.238.194,<->,56.100.165.6,1,556,0,0,1,556,1.344754000,0.0000
215.158.238.92,<->,56.1.237.75,1,1069,0,0,1,1069,1.344542000,0.0000
224.93.235.34,<->,80.27.157.204,0,0,1,1345,1,1345,1.344497000,0.0000
203.114.24.27,<->,136.25.188.197,0,0,1,765,1,765,1.344301000,0.0000
8.252.221.236,<->,4.122.187.30,1,458,0,0,1,458,1.344282000,0.0000
215.158.238.134,<->,193.39.69.168,1,1053,0,0,1,1053,1.344092000,0.0000
215.158.238.115,<->,143.155.227.33,1,264,0,0,1,264,1.343940000,0.0000
213.186.59.172,<->,144.85.170.208,0,0,1,435,1,435,1.343842000,0.0000
80.42.138.200,<->,53.157.65.184,1,188,0,0,1,188,1.343535000,0.0000
215.158.239.115,<->,215.158.61.193,1,621,0,0,1,621,1.342895000,0.0000
29.212.43.237,<->,8.252.222.204,0,0,1,1053,1,1053,1.342797000,0.0000
159.223.64.144,<->,144.85.170.208,0,0,1,395,1,395,1.341859000,0.0000
132.249.70.195,<->,92.26.137.227,1,1095,0,0,1,1095,1.341171000,0.0000
109.1.8.94,<->,53.213.1.69,1,109,0,0,1,109,1.340529000,0.0000
215.158.238.140,<->,124.52.96.46,1,1293,0,0,1,1293,1.340116000,0.0000
215.158.140.75,<->,29.213.219.52,1,1073,0,0,1,1073,1.339894000,0.0000
215.158.239.109,<->,215.158.61.145,1,658,0,0,1,658,1.338873000,0.0000
195.68.226.21,<->,136.25.188.54,0,0,1,765,1,765,1.338422000,0.0000
136.25.189.243,<->,54.42.119.66,1,213,0,0,1,213,1.338405000,0.0000
195.68.58.205,<->,136.25.188.46,0,0,1,93,1,93,1.337943000,0.0000
195.40.209.59,<->,136.25.188.255,0,0,1,240,1,240,1.337576000,0.0000
139.244.182.238,<->,8.220.239.132,0,0,1,640,1,640,1.337435000,0.0000
111.151.142.208,<->,6.73.247.4,0,0,1,100,1,100,1.337143000,0.0000
139.163.26.146,<->,110.87.180.223,1,99,0,0,1,99,1.337082000,0.0000
133.178.227.16,<->,8.240.116.53,1,1221,0,0,1,1221,1.337042000,0.0000
215.158.238.113,<->,197.103.151.87,1,1197,0,0,1,1197,1.336758000,0.0000
142.182.62.124,<->,136.25.188.175,0,0,1,656,1,656,1.336566000,0.0000
120.83.116.209,<->,89.183.104.156,0,0,1,1396,1,1396,1.336327000,0.0000
215.158.238.92,<->,48.131.156.16,1,1469,0,0,1,1469,1.336294000,0.0000
143.42.155.197,<->,136.25.188.53,0,0,1,306,1,306,1.336095000,0.0000
93.181.154.23,<->,92.27.27.171,0,0,1,147,1,147,1.335994000,0.0000
195.83.28.83,<->,80.38.3.11,0,0,1,551,1,551,1.335781000,0.0000
136.25.188.172,<->,29.211.6.55,1,1357,0,0,1,1357,1.335720000,0.0000
215.158.238.82,<->,139.160.226.235,1,1405,0,0,1,1405,1.335407000,0.0000
215.158.239.34,<->,113.93.9.40,1,1198,0,0,1,1198,1.335112000,0.0000
212.105.232.45,<->,109.222.207.181,0,0,1,119,1,119,1.335034000,0.0000
133.178.227.12,<->,80.57.141.67,1,1340,0,0,1,1340,1.334876000,0.0000
215.158.239.93,<->,199.20.7.50,1,87,0,0,1,87,1.334839000,0.0000
215.158.61.182,<->,8.176.8.213,0,0,1,1407,1,1407,1.334564000,0.0000
136.25.189.8,<->,56.28.207.191,1,351,0,0,1,351,1.334291000,0.0000
221.102.56.69,<->,109.2.82.112,0,0,1,294,1,294,1.334216000,0.0000
215.158.238.134,<->,57.227.77.108,1,1245,0,0,1,1245,1.334017000,0.0000
144.64.138.9,<->,27.11.34.178,1,333,0,0,1,333,1.333929000,0.0000
213.186.61.57,<->,144.85.170.208,0,0,1,747,1,747,1.333706000,0.0000
215.158.239.49,<->,204.3.242.18,1,765,0,0,1,765,1.333478000,0.0000
204.185.78.129,<->,136.25.188.199,0,0,1,240,1,240,1.333282000,0.0000
136.25.189.77,<->,113.92.151.21,1,1213,0,0,1,1213,1.332440000,0.0000
133.178.226.61,<->,38.51.98.246,1,1229,0,0,1,1229,1.332383000,0.0000
133.178.227.252,<->,91.57.169.11,1,758,0,0,1,758,1.332261000,0.0000
136.25.189.13,<->,6.15.207.233,1,1213,0,0,1,1213,1.332213000,0.0000
203.48.152.122,<->,0.195.210.44,0,0,1,93,1,93,1.331947000,0.0000
215.158.239.95,<->,8.249.253.234,1,1357,0,0,1,1357,1.331641000,0.0000
148.255.136.202,<->,136.25.189.16,0,0,1,1181,1,1181,1.331541000,0.0000
215.158.140.147,<->,6.73.247.5,1,897,0,0,1,897,1.330638000,0.0000
133.178.226.29,<->,112.93.136.102,1,1117,0,0,1,1117,1.330499000,0.0000
133.178.226.19,<->,57.227.189.183,1,1213,0,0,1,1213,1.330414000,0.0000
133.178.227.1,<->,56.51.205.196,1,1143,0,0,1,1143,1.330157000,0.0000
143.22.102.185,<->,8.182.248.147,0,0,1,263,1,263,1.330040000,0.0000
215.158.238.198,<->,8.57.163.188,1,1293,0,0,1,1293,1.329724000,0.0000
231.138.197.58,<->,136.25.188.253,0,0,1,586,1,586,1.329209000,0.0000
220.38.84.231,<->,215.158.239.92,0,0,1,1197,1,1197,1.329081000,0.0000
142.236.219.73,<->,136.25.188.225,0,0,1,765,1,765,1.329068000,0.0000
215.158.195.9,<->,111.150.207.201,1,100,0,0,1,100,1.329067000,0.0000
215.158.238.109,<->,0.195.237.14,1,880,0,0,1,880,1.328787000,0.0000
50.224.76.230,<->,8.238.181.176,1,562,0,0,1,562,1.328419000,0.0000
204.139.18.203,<->,50.223.3.228,0,0,1,294,1,294,1.327727000,0.0000
215.158.239.192,<->,145.116.223.93,1,141,0,0,1,141,1.327673000,0.0000
197.113.88.116,<->,144.86.150.79,0,0,1,663,1,663,1.327246000,0.0000
215.158.239.252,<->,8.47.189.76,1,154,0,0,1,154,1.327179000,0.0000
218.4.190.6,<->,159.112.9.198,1,81,0,0,1,81,1.327087000,0.0000
220.55.124.143,<->,220.20.198.107,1,1176,0,0,1,1176,1.326973000,0.0000
215.158.140.80,<->,98.219.126.175,1,591,0,0,1,591,1.326846000,0.0000
146.199.211.55,<->,0.195.210.42,0,0,1,893,1,893,1.326678000,0.0000
111.146.249.8,<->,53.149.173.81,1,247,0,0,1,247,1.326626000,0.0000
199.50.123.48,<->,136.25.188.252,0,0,1,93,1,93,1.326212000,0.0000
241.120.29.238,<->,136.25.189.1,0,0,1,1309,1,1309,1.325841000,0.0000
195.41.210.241,<->,136.25.188.44,0,0,1,242,1,242,1.325359000,0.0000
215.158.239.71,<->,42.189.53.21,1,1144,0,0,1,1144,1.325108000,0.0000
215.158.238.66,<->,8.191.6.216,1,1053,0,0,1,1053,1.324667000,0.0000
199.121.49.183,<->,136.25.188.225,0,0,1,172,1,172,1.324431000,0.0000
201.209.65.171,<->,92.27.27.182,0,0,1,282,1,282,1.323567000,0.0000
192.226.44.67,<->,133.178.227.244,0,0,1,1021,1,1021,1.323564000,0.0000
136.25.188.27,<->,111.151.106.235,1,100,0,0,1,100,1.322812000,0.0000
215.158.239.30,<->,122.158.239.248,1,1201,0,0,1,1201,1.322735000,0.0000
207.59.253.196,<->,136.25.188.175,0,0,1,273,1,273,1.321911000,0.0000
215.158.238.73,<->,122.158.49.130,1,316,0,0,1,316,1.321792000,0.0000
111.147.166.52,<->,53.148.21.215,1,125,0,0,1,125,1.321566000,0.0000
215.158.238.72,<->,113.23.104.203,1,1325,0,0,1,1325,1.320896000,0.0000
139.163.26.146,<->,108.3.160.18,1,99,0,0,1,99,1.320858000,0.0000
8.52.183.207,<->,6.16.234.145,1,1190,0,0,1,1190,1.320527000,0.0000
143.134.97.211,<->,136.25.188.197,0,0,1,141,1,141,1.320319000,0.0000
215.158.239.59,<->,106.188.253.173,1,1400,0,0,1,1400,1.320298000,0.0000
146.149.77.200,<->,8.252.221.236,0,0,1,452,1,452,1.320121000,0.0000
212.164.140.243,<->,126.231.20.192,1,336,0,0,1,336,1.319848000,0.0000
200.174.28.185,<->,54.36.8.171,1,577,0,0,1,577,1.319818000,0.0000
215.158.238.209,<->,29.211.122.151,1,1376,0,0,1,1376,1.319776000,0.0000
139.193.141.139,<->,131.148.119.65,1,405,0,0,1,405,1.319477000,0.0000
149.161.62.53,<->,139.193.141.139,0,0,1,413,1,413,1.319375000,0.0000
207.60.249.92,<->,136.25.188.220,0,0,1,93,1,93,1.318857000,0.0000
215.158.238.132,<->,112.220.206.116,1,1149,0,0,1,1149,1.318290000,0.0000
215.158.238.64,<->,113.23.104.220,1,1085,0,0,1,1085,1.318249000,0.0000
215.158.239.85,<->,196.93.114.117,1,172,0,0,1,172,1.318078000,0.0000
192.65.25.7,<->,8.55.211.213,1,294,0,0,1,294,1.317923000,0.0000
199.14.203.234,<->,136.25.188.173,0,0,1,602,1,602,1.317851000,0.0000
215.158.140.76,<->,158.166.173.32,1,1076,0,0,1,1076,1.317758000,0.0000
50.224.76.235,<->,48.129.113.186,1,160,0,0,1,160,1.317140000,0.0000
215.158.239.95,<->,199.20.6.22,1,765,0,0,1,765,1.316889000,0.0000
136.25.189.95,<->,96.156.169.209,1,324,0,0,1,324,1.316870000,0.0000
215.158.239.96,<->,199.20.28.252,1,853,0,0,1,853,1.316847000,0.0000
133.178.227.16,<->,122.216.233.89,1,1213,0,0,1,1213,1.316213000,0.0000
215.158.238.107,<->,88.3.1.165,1,1261,0,0,1,1261,1.316029000,0.0000
92.27.219.155,<->,42.124.197.42,1,80,0,0,1,80,1.315795000,0.0000
149.254.114.188,<->,136.25.188.44,0,0,1,1293,1,1293,1.315635000,0.0000
215.158.239.70,<->,148.21.212.181,1,1341,0,0,1,1341,1.315557000,0.0000
249.101.120.210,<->,22.5.212.226,1,476,0,0,1,476,1.315308000,0.0000
220.55.124.65,<->,92.162.218.53,1,427,0,0,1,427,1.314660000,0.0000
194.233.54.93,<->,136.25.188.46,0,0,1,602,1,602,1.314642000,0.0000
199.81.193.82,<->,136.25.188.243,0,0,1,93,1,93,1.314379000,0.0000
139.241.115.4,<->,133.178.227.7,0,0,1,573,1,573,1.314160000,0.0000
136.25.189.42,<->,96.156.169.218,1,439,0,0,1,439,1.314140000,0.0000
143.227.65.146,<->,133.178.226.18,0,0,1,1277,1,1277,1.313635000,0.0000
215.158.238.36,<->,131.144.115.170,1,1149,0,0,1,1149,1.313310000,0.0000
204.184.27.177,<->,136.25.188.253,0,0,1,117,1,117,1.313235000,0.0000
215.158.238.199,<->,29.214.73.193,1,1219,0,0,1,1219,1.313180000,0.0000
215.158.239.28,<->,8.222.7.160,1,945,0,0,1,945,1.313108000,0.0000
75.214.101.131,<->,8.252.221.199,0,0,1,394,1,394,1.313107000,0.0000
58.143.178.4,<->,8.252.221.230,0,0,1,454,1,454,1.313069000,0.0000
126.198.149.124,<->,111.147.155.165,0,0,1,344,1,344,1.312965000,0.0000
48.18.199.49,<->,8.252.221.204,0,0,1,449,1,449,1.312917000,0.0000
215.158.239.79,<->,142.207.217.218,1,561,0,0,1,561,1.312793000,0.0000
215.158.238.66,<->,140.19.166.161,1,1149,0,0,1,1149,1.312749000,0.0000
133.178.227.40,<->,8.222.6.193,1,1018,0,0,1,1018,1.312576000,0.0000
215.158.61.182,<->,8.176.8.191,0,0,1,861,1,861,1.312307000,0.0000
215.158.239.35,<->,126.219.142.36,1,1265,0,0,1,1265,1.312030000,0.0000
215.158.140.24,<->,111.150.207.168,1,100,0,0,1,100,1.311490000,0.0000
198.30.245.43,<->,137.21.2.203,0,0,1,413,1,413,1.310996000,0.0000
215.158.238.82,<->,29.211.228.69,1,1085,0,0,1,1085,1.310785000,0.0000
111.2.136.178,<->,8.182.226.78,0,0,1,416,1,416,1.310171000,0.0000
144.72.195.98,<->,111.146.147.251,0,0,1,814,1,814,1.309900000,0.0000
215.158.238.65,<->,112.220.206.116,1,1117,0,0,1,1117,1.309660000,0.0000
8.252.221.236,<->,4.121.147.111,1,456,0,0,1,456,1.309438000,0.0000
215.158.238.236,<->,48.129.133.55,1,1181,0,0,1,1181,1.309301000,0.0000
215.158.140.75,<->,69.31.239.7,1,1044,0,0,1,1044,1.308839000,0.0000
220.20.200.54,<->,159.70.33.186,1,301,0,0,1,301,1.308796000,0.0000
207.21.165.166,<->,8.252.222.225,0,0,1,105,1,105,1.308625000,0.0000
225.120.222.154,<->,136.25.188.221,0,0,1,1197,1,1197,1.308575000,0.0000
54.58.47.197,<->,48.52.68.86,0,0,1,579,1,579,1.308551000,0.0000
215.158.140.83,<->,72.23.148.226,1,1385,0,0,1,1385,1.308357000,0.0000
215.158.238.67,<->,113.23.104.203,1,1261,0,0,1,1261,1.308180000,0.0000
6.145.152.250,<->,0.195.210.44,0,0,1,87,1,87,1.307804000,0.0000
200.174.210.169,<->,53.200.100.60,1,63,0,0,1,63,1.307461000,0.0000
111.20.168.122,<->,101.224.91.211,1,742,0,0,1,742,1.307441000,0.0000
215.158.239.42,<->,29.211.5.208,1,1474,0,0,1,1474,1.307367000,0.0000
215.158.239.30,<->,125.84.52.215,1,80,0,0,1,80,1.306472000,0.0000
215.158.239.4,<->,122.158.246.245,1,1503,0,0,1,1503,1.306266000,0.0000
215.158.238.133,<->,89.86.110.9,1,1085,0,0,1,1085,1.306231000,0.0000
215.158.239.84,<->,204.226.125.255,1,141,0,0,1,141,1.305824000,0.0000
207.206.28.52,<->,50.223.3.228,0,0,1,200,1,200,1.305705000,0.0000
216.184.2.78,<->,99.74.27.13,0,0,1,861,1,861,1.305594000,0.0000
215.158.239.121,<->,215.158.61.243,1,749,0,0,1,749,1.305518000,0.0000
109.222.242.51,<->,53.85.78.187,1,362,0,0,1,362,1.305138000,0.0000
145.116.214.177,<->,133.178.227.138,0,0,1,836,1,836,1.304877000,0.0000
136.25.189.46,<->,126.219.60.220,1,1245,0,0,1,1245,1.304772000,0.0000
215.158.238.82,<->,113.23.104.221,1,93,0,0,1,93,1.304732000,0.0000
159.36.244.13,<->,8.52.183.207,0,0,1,999,1,999,1.304475000,0.0000
144.64.136.137,<->,27.15.11.177,1,450,0,0,1,450,1.304069000,0.0000
196.247.132.206,<->,136.25.188.54,0,0,1,1095,1,1095,1.304061000,0.0000
215.158.239.94,<->,113.23.14.212,1,1197,0,0,1,1197,1.303782000,0.0000
207.173.72.84,<->,136.25.188.44,0,0,1,593,1,593,1.303680000,0.0000
215.158.239.78,<->,199.20.31.32,1,1106,0,0,1,1106,1.303453000,0.0000
215.158.239.57,<->,196.106.97.237,1,632,0,0,1,632,1.303196000,0.0000
136.25.189.14,<->,117.155.166.219,1,1277,0,0,1,1277,1.302935000,0.0000
215.158.238.120,<->,126.219.132.165,1,1309,0,0,1,1309,1.302723000,0.0000
109.1.40.189,<->,53.68.234.251,1,231,0,0,1,231,1.302241000,0.0000
143.155.227.40,<->,136.25.188.199,0,0,1,1341,1,1341,1.302129000,0.0000
215.158.239.7,<->,8.252.214.200,1,175,0,0,1,175,1.302065000,0.0000
196.148.120.168,<->,27.11.59.51,1,53,0,0,1,53,1.301589000,0.0000
195.65.192.81,<->,50.224.76.234,0,0,1,907,1,907,1.301072000,0.0000
215.158.44.182,<->,136.25.189.1,0,0,1,1357,1,1357,1.300995000,0.0000
215.158.140.177,<->,204.251.8.19,1,109,0,0,1,109,1.300948000,0.0000
133.178.226.19,<->,48.49.55.188,1,1117,0,0,1,1117,1.300689000,0.0000
215.158.238.80,<->,192.227.190.245,1,1389,0,0,1,1389,1.300685000,0.0000
136.25.189.28,<->,120.155.8.110,1,1389,0,0,1,1389,1.300021000,0.0000
215.158.239.57,<->,131.6.152.21,1,1213,0,0,1,1213,1.300006000,0.0000
207.239.35.185,<->,136.25.188.196,0,0,1,593,1,593,1.299302000,0.0000
207.58.99.223,<->,136.25.188.46,0,0,1,87,1,87,1.299085000,0.0000
145.76.230.104,<->,33.233.141.16,0,0,1,260,1,260,1.297955000,0.0000
133.178.226.90,<->,57.199.250.203,1,1325,0,0,1,1325,1.297189000,0.0000
215.158.238.133,<->,120.154.221.235,1,1213,0,0,1,1213,1.297117000,0.0000
145.252.126.224,<->,42.140.56.190,1,590,0,0,1,590,1.296817000,0.0000
215.158.239.4,<->,8.191.15.80,1,71,0,0,1,71,1.296686000,0.0000
215.158.239.48,<->,196.110.250.206,1,378,0,0,1,378,1.296521000,0.0000
215.158.238.93,<->,131.2.102.59,1,1197,0,0,1,1197,1.296497000,0.0000
139.193.141.139,<->,113.129.239.137,1,421,0,0,1,421,1.296450000,0.0000
133.178.226.19,<->,113.23.104.247,1,1117,0,0,1,1117,1.295972000,0.0000
136.25.188.211,<->,69.132.194.105,1,1357,0,0,1,1357,1.295817000,0.0000
136.25.189.29,<->,30.249.194.153,1,1357,0,0,1,1357,1.295816000,0.0000
109.222.197.239,<->,54.53.12.57,1,59,0,0,1,59,1.295759000,0.0000
144.85.170.254,<->,91.69.185.154,1,762,0,0,1,762,1.295628000,0.0000
215.158.238.45,<->,29.213.219.103,1,1229,0,0,1,1229,1.295524000,0.0000
215.158.239.76,<->,196.90.196.130,1,765,0,0,1,765,1.293957000,0.0000
215.158.239.50,<->,206.103.214.39,1,1309,0,0,1,1309,1.293709000,0.0000
133.178.227.19,<->,97.243.113.38,1,1112,0,0,1,1112,1.293681000,0.0000
215.158.140.76,<->,68.231.26.200,1,1157,0,0,1,1157,1.293318000,0.0000
133.135.214.174,<->,129.6.83.11,0,0,1,697,1,697,1.293294000,0.0000
215.158.239.84,<->,148.217.121.181,1,1325,0,0,1,1325,1.293195000,0.0000
251.24.42.145,<->,8.182.224.87,0,0,1,1134,1,1134,1.292722000,0.0000
92.27.27.161,<->,0.48.226.240,1,1396,0,0,1,1396,1.292068000,0.0000
231.143.162.104,<->,136.25.188.225,0,0,1,765,1,765,1.291967000,0.0000
69.246.60.200,<->,8.252.222.48,0,0,1,671,1,671,1.291884000,0.0000
215.158.239.40,<->,138.126.75.62,1,1181,0,0,1,1181,1.291326000,0.0000
136.25.188.160,<->,80.47.111.74,1,1165,0,0,1,1165,1.291177000,0.0000
215.158.238.73,<->,8.190.217.127,1,1213,0,0,1,1213,1.291142000,0.0000
118.131.233.12,<->,92.27.194.114,0,0,1,543,1,543,1.291062000,0.0000
215.158.61.183,<->,8.176.8.104,0,0,1,333,1,333,1.290714000,0.0000
215.158.238.148,<->,57.210.107.36,1,1341,0,0,1,1341,1.290655000,0.0000
207.92.143.171,<->,8.252.222.187,0,0,1,117,1,117,1.290625000,0.0000
241.5.27.245,<->,215.158.239.87,0,0,1,1357,1,1357,1.289647000,0.0000
111.150.207.192,<->,8.252.221.165,0,0,1,100,1,100,1.289557000,0.0000
204.56.106.117,<->,136.25.188.54,0,0,1,224,1,224,1.289469000,0.0000
159.223.99.55,<->,8.52.183.207,0,0,1,721,1,721,1.288883000,0.0000
215.158.238.104,<->,8.191.10.87,1,165,0,0,1,165,1.288658000,0.0000
215.158.239.77,<->,106.188.253.148,1,1306,0,0,1,1306,1.288642000,0.0000
148.55.210.207,<->,133.178.226.31,0,0,1,1357,1,1357,1.288520000,0.0000
215.158.239.95,<->,199.20.28.85,1,93,0,0,1,93,1.288298000,0.0000
215.158.238.73,<->,193.39.69.170,1,1101,0,0,1,1101,1.288295000,0.0000
215.158.239.95,<->,195.55.178.184,1,545,0,0,1,545,1.288259000,0.0000
215.158.238.25,<->,113.92.151.99,1,69,0,0,1,69,1.288209000,0.0000
136.25.188.160,<->,8.252.213.21,1,1229,0,0,1,1229,1.288158000,0.0000
144.87.238.91,<->,8.182.253.40,0,0,1,203,1,203,1.288119000,0.0000
136.25.188.199,<->,8.179.43.54,1,1293,0,0,1,1293,1.288097000,0.0000
199.68.247.252,<->,136.25.188.252,0,0,1,93,1,93,1.288078000,0.0000
197.4.13.58,<->,133.178.226.61,0,0,1,1373,1,1373,1.287864000,0.0000
201.206.177.82,<->,80.42.185.53,0,0,1,1067,1,1067,1.287609000,0.0000
142.253.110.56,<->,136.25.188.196,0,0,1,93,1,93,1.287429000,0.0000
133.178.227.41,<->,29.211.165.26,1,1353,0,0,1,1353,1.287220000,0.0000
202.33.41.25,<->,136.25.188.174,0,0,1,288,1,288,1.287176000,0.0000
192.227.190.235,<->,136.25.188.211,0,0,1,1501,1,1501,1.287091000,0.0000
204.56.10.186,<->,136.25.188.162,0,0,1,749,1,749,1.286629000,0.0000
215.158.238.135,<->,134.172.158.199,1,1165,0,0,1,1165,1.286604000,0.0000
140.71.207.94,<->,8.252.221.204,0,0,1,503,1,503,1.286108000,0.0000
133.178.227.41,<->,80.57.141.107,1,1301,0,0,1,1301,1.285761000,0.0000
125.9.59.246,<->,109.1.25.177,0,0,1,124,1,124,1.285111000,0.0000
196.112.237.233,<->,136.25.189.80,0,0,1,1229,1,1229,1.285106000,0.0000
148.55.210.198,<->,136.25.188.254,0,0,1,1181,1,1181,1.284686000,0.0000
97.126.8.42,<->,54.49.112.232,1,1475,0,0,1,1475,1.284511000,0.0000
215.158.239.94,<->,196.90.196.130,1,765,0,0,1,765,1.284497000,0.0000
98.101.92.221,<->,8.182.136.57,0,0,1,1233,1,1233,1.284005000,0.0000
215.158.238.72,<->,120.154.221.235,1,1277,0,0,1,1277,1.283835000,0.0000
215.158.239.122,<->,53.246.131.101,1,109,0,0,1,109,1.283735000,0.0000
144.87.238.89,<->,8.182.228.189,0,0,1,608,1,608,1.283694000,0.0000
199.71.209.205,<->,136.25.188.226,0,0,1,602,1,602,1.283651000,0.0000
215.158.238.142,<->,8.220.51.250,1,1165,0,0,1,1165,1.283642000,0.0000
215.158.238.92,<->,8.241.236.66,1,1181,0,0,1,1181,1.283410000,0.0000
215.158.238.177,<->,29.214.108.56,1,1069,0,0,1,1069,1.283344000,0.0000
112.208.20.238,<->,102.51.80.93,0,0,1,260,1,260,1.283331000,0.0000
210.158.44.137,<->,124.58.27.63,1,186,0,0,1,186,1.282816000,0.0000
224.42.18.241,<->,139.193.141.139,0,0,1,328,1,328,1.282709000,0.0000
215.158.239.92,<->,199.33.243.74,1,87,0,0,1,87,1.282629000,0.0000
48.19.109.38,<->,8.252.221.238,0,0,1,322,1,322,1.282196000,0.0000
139.254.214.188,<->,58.132.150.196,1,1201,0,0,1,1201,1.282161000,0.0000
144.64.139.153,<->,27.155.173.243,1,400,0,0,1,400,1.281629000,0.0000
53.200.99.253,<->,48.52.85.160,0,0,1,93,1,93,1.281525000,0.0000
196.202.71.116,<->,92.27.194.147,0,0,1,249,1,249,1.281117000,0.0000
102.44.70.160,<->,92.162.253.45,0,0,1,364,1,364,1.280686000,0.0000
200.174.218.8,<->,53.214.117.149,1,1182,0,0,1,1182,1.280190000,0.0000
159.137.160.61,<->,120.101.94.28,1,361,0,0,1,361,1.278947000,0.0000
17.115.98.58,<->,8.220.188.183,0,0,1,580,1,580,1.278794000,0.0000
249.101.216.84,<->,54.38.254.96,1,272,0,0,1,272,1.278543000,0.0000
199.32.125.184,<->,136.25.188.54,0,0,1,653,1,653,1.278542000,0.0000
221.102.56.69,<->,192.64.102.83,0,0,1,294,1,294,1.278443000,0.0000
215.158.239.92,<->,195.55.185.12,1,378,0,0,1,378,1.278418000,0.0000
210.221.107.173,<->,8.37.242.210,1,263,0,0,1,263,1.278312000,0.0000
215.158.238.105,<->,158.192.3.233,1,1229,0,0,1,1229,1.278057000,0.0000
149.57.170.237,<->,92.168.217.222,0,0,1,345,1,345,1.277994000,0.0000
149.250.115.40,<->,136.25.188.55,0,0,1,1357,1,1357,1.277971000,0.0000
215.158.238.135,<->,112.68.105.246,1,1213,0,0,1,1213,1.277575000,0.0000
133.135.217.206,<->,129.6.83.11,0,0,1,589,1,589,1.277547000,0.0000
215.158.239.51,<->,196.90.196.130,1,765,0,0,1,765,1.277483000,0.0000
215.158.238.92,<->,143.155.227.33,1,1149,0,0,1,1149,1.276802000,0.0000
215.202.174.52,<->,136.25.189.14,0,0,1,1085,1,1085,1.276784000,0.0000
111.147.222.196,<->,54.58.49.91,1,110,0,0,1,110,1.275985000,0.0000
248.225.27.2,<->,53.239.32.16,1,257,0,0,1,257,1.275925000,0.0000
231.143.148.221,<->,136.25.188.53,0,0,1,685,1,685,1.275881000,0.0000
145.89.249.42,<->,50.224.76.230,0,0,1,872,1,872,1.275292000,0.0000
207.56.153.215,<->,136.25.188.255,0,0,1,717,1,717,1.274905000,0.0000
109.222.238.4,<->,54.43.164.11,1,157,0,0,1,157,1.274736000,0.0000
215.158.239.56,<->,195.71.93.107,1,270,0,0,1,270,1.274669000,0.0000
243.117.107.129,<->,80.38.1.52,0,0,1,956,1,956,1.274636000,0.0000
206.103.215.23,<->,136.25.189.15,0,0,1,1341,1,1341,1.274539000,0.0000
80.42.155.74,<->,8.55.152.101,1,129,0,0,1,129,1.274427000,0.0000
136.25.188.237,<->,48.131.158.246,1,1341,0,0,1,1341,1.274273000,0.0000
215.158.239.29,<->,80.47.111.161,1,1040,0,0,1,1040,1.274160000,0.0000
215.158.61.183,<->,8.176.8.247,0,0,1,1365,1,1365,1.274115000,0.0000
215.158.61.237,<->,8.252.223.64,0,0,1,467,1,467,1.273933000,0.0000
235.42.35.91,<->,215.158.238.148,0,0,1,1069,1,1069,1.273860000,0.0000
215.158.238.143,<->,104.154.137.200,1,1197,0,0,1,1197,1.273637000,0.0000
215.158.238.64,<->,143.155.227.57,1,1101,0,0,1,1101,1.273409000,0.0000
215.158.238.188,<->,126.219.132.218,1,1085,0,0,1,1085,1.273375000,0.0000
195.70.56.191,<->,8.52.226.196,0,0,1,148,1,148,1.273094000,0.0000
136.25.189.17,<->,68.124.221.170,1,1197,0,0,1,1197,1.273079000,0.0000
220.28.108.254,<->,136.25.189.8,0,0,1,249,1,249,1.272417000,0.0000
146.10.166.54,<->,133.178.226.30,0,0,1,1181,1,1181,1.272185000,0.0000
195.7.12.255,<->,136.25.188.55,0,0,1,151,1,151,1.271534000,0.0000
215.158.140.184,<->,38.81.154.202,1,225,0,0,1,225,1.271296000,0.0000
215.158.238.134,<->,61.35.124.191,1,1133,0,0,1,1133,1.269746000,0.0000
215.158.239.7,<->,145.13.164.170,1,172,0,0,1,172,1.269332000,0.0000
203.212.93.0,<->,8.52.182.119,0,0,1,250,1,250,1.268882000,0.0000
215.158.238.45,<->,29.212.195.3,1,1229,0,0,1,1229,1.268409000,0.0000
215.158.238.96,<->,128.194.247.212,1,1453,0,0,1,1453,1.268227000,0.0000
139.193.141.139,<->,33.98.12.115,1,432,0,0,1,432,1.267233000,0.0000
136.25.188.196,<->,131.1.253.247,1,1229,0,0,1,1229,1.266946000,0.0000
215.158.140.75,<->,201.211.112.233,1,1053,0,0,1,1053,1.266901000,0.0000
133.178.226.90,<->,131.36.198.20,1,1133,0,0,1,1133,1.266648000,0.0000
216.184.1.112,<->,136.25.188.165,0,0,1,204,1,204,1.266189000,0.0000
215.158.239.50,<->,199.20.28.139,1,117,0,0,1,117,1.265765000,0.0000
215.158.238.67,<->,111.151.70.36,1,1165,0,0,1,1165,1.265068000,0.0000
144.83.60.153,<->,92.162.253.133,0,0,1,905,1,905,1.264275000,0.0000
133.178.226.80,<->,57.4.201.97,1,1213,0,0,1,1213,1.263785000,0.0000
212.70.217.106,<->,136.25.189.77,0,0,1,1373,1,1373,1.263411000,0.0000
133.178.226.30,<->,8.191.6.90,1,1261,0,0,1,1261,1.263243000,0.0000
215.158.238.106,<->,143.155.227.59,1,93,0,0,1,93,1.262933000,0.0000
133.178.226.30,<->,38.104.11.118,1,1133,0,0,1,1133,1.262834000,0.0000
136.25.188.160,<->,29.211.186.215,1,1213,0,0,1,1213,1.262696000,0.0000
246.254.97.113,<->,139.33.174.19,1,596,0,0,1,596,1.262595000,0.0000
231.142.9.149,<->,215.158.239.57,0,0,1,715,1,715,1.262398000,0.0000
215.158.239.48,<->,195.14.223.235,1,765,0,0,1,765,1.261942000,0.0000
215.158.238.96,<->,27.178.41.49,1,1229,0,0,1,1229,1.261858000,0.0000
136.25.188.173,<->,80.47.111.87,1,1261,0,0,1,1261,1.261617000,0.0000
136.181.50.70,<->,0.195.216.195,1,87,0,0,1,87,1.261574000,0.0000
215.158.238.67,<->,122.158.51.53,1,1261,0,0,1,1261,1.260797000,0.0000
220.39.233.197,<->,133.178.226.19,0,0,1,1213,1,1213,1.260420000,0.0000
215.158.238.135,<->,29.213.195.69,1,1245,0,0,1,1245,1.260394000,0.0000
128.156.85.186,<->,8.176.8.227,0,0,1,100,1,100,1.260150000,0.0000
196.206.193.146,<->,136.25.188.46,0,0,1,101,1,101,1.259563000,0.0000
144.72.193.17,<->,132.163.8.243,0,0,1,606,1,606,1.259321000,0.0000
215.158.239.58,<->,199.20.29.53,1,781,0,0,1,781,1.259176000,0.0000
207.78.233.227,<->,92.27.194.147,0,0,1,249,1,249,1.259168000,0.0000
215.158.140.207,<->,8.222.7.170,1,238,0,0,1,238,1.258953000,0.0000
194.233.74.159,<->,136.25.188.227,0,0,1,107,1,107,1.258723000,0.0000
136.25.188.221,<->,69.31.239.24,1,1181,0,0,1,1181,1.258571000,0.0000
215.158.238.56,<->,148.129.19.250,1,1453,0,0,1,1453,1.258546000,0.0000
142.221.251.142,<->,136.25.188.220,0,0,1,497,1,497,1.258262000,0.0000
111.25.52.96,<->,98.67.141.138,0,0,1,75,1,75,1.258052000,0.0000
215.158.140.83,<->,29.211.122.251,1,1167,0,0,1,1167,1.257789000,0.0000
220.28.85.14,<->,133.178.226.41,0,0,1,187,1,187,1.257773000,0.0000
215.158.238.113,<->,204.154.223.150,1,1341,0,0,1,1341,1.257531000,0.0000
192.204.123.0,<->,136.25.189.88,0,0,1,1373,1,1373,1.257227000,0.0000
215.158.239.49,<->,123.166.47.58,1,1245,0,0,1,1245,1.256990000,0.0000
195.7.56.194,<->,136.25.188.162,0,0,1,701,1,701,1.256987000,0.0000
215.158.238.236,<->,126.219.246.238,1,1117,0,0,1,1117,1.256276000,0.0000
215.158.238.9,<->,113.23.117.31,1,1325,0,0,1,1325,1.256120000,0.0000
213.221.90.178,<->,144.85.170.254,0,0,1,338,1,338,1.256033000,0.0000
215.158.239.70,<->,212.70.217.75,1,1213,0,0,1,1213,1.255982000,0.0000
215.158.239.50,<->,194.232.252.138,1,93,0,0,1,93,1.255719000,0.0000
143.53.111.161,<->,136.25.188.220,0,0,1,850,1,850,1.255534000,0.0000
220.39.233.197,<->,133.178.226.61,0,0,1,1357,1,1357,1.255436000,0.0000
204.185.223.182,<->,136.25.188.209,0,0,1,236,1,236,1.255054000,0.0000
112.208.20.199,<->,98.128.186.137,0,0,1,147,1,147,1.254824000,0.0000
253.182.227.8,<->,136.25.188.227,0,0,1,1197,1,1197,1.254626000,0.0000
210.229.230.19,<->,159.184.231.124,1,68,0,0,1,68,1.254049000,0.0000
159.13.243.75,<->,54.58.113.240,1,271,0,0,1,271,1.253943000,0.0000
159.23.130.164,<->,136.25.188.254,0,0,1,1341,1,1341,1.253706000,0.0000
111.20.172.118,<->,101.224.89.157,0,0,1,1275,1,1275,1.253585000,0.0000
204.200.56.148,<->,136.25.188.209,0,0,1,508,1,508,1.253405000,0.0000
92.168.217.198,<->,0.47.243.72,1,315,0,0,1,315,1.253178000,0.0000
133.178.226.227,<->,8.53.216.3,1,920,0,0,1,920,1.253163000,0.0000
133.178.226.60,<->,131.144.116.237,1,1037,0,0,1,1037,1.253142000,0.0000
144.85.170.254,<->,91.69.185.180,1,749,0,0,1,749,1.252914000,0.0000
133.90.61.177,<->,8.220.186.82,0,0,1,353,1,353,1.252590000,0.0000
215.158.61.253,<->,99.74.26.134,0,0,1,382,1,382,1.252383000,0.0000
215.158.238.33,<->,8.252.213.37,1,1373,0,0,1,1373,1.252373000,0.0000
215.158.238.120,<->,42.195.144.225,1,93,0,0,1,93,1.252218000,0.0000
138.126.75.85,<->,136.25.188.47,0,0,1,1149,1,1149,1.251857000,0.0000
148.129.19.217,<->,136.25.188.162,0,0,1,1245,1,1245,1.251772000,0.0000
84.20.180.29,<->,0.195.210.33,0,0,1,101,1,101,1.251710000,0.0000
215.158.238.190,<->,33.221.186.184,1,1090,0,0,1,1090,1.250393000,0.0000
143.13.48.59,<->,136.25.188.163,0,0,1,602,1,602,1.250359000,0.0000
136.181.52.227,<->,0.195.216.193,1,101,0,0,1,101,1.250116000,0.0000
204.200.51.94,<->,136.25.188.243,0,0,1,132,1,132,1.249932000,0.0000
215.158.238.45,<->,8.253.128.20,1,1469,0,0,1,1469,1.249916000,0.0000
220.20.200.85,<->,119.45.80.77,1,359,0,0,1,359,1.249338000,0.0000
133.178.226.225,<->,113.24.30.219,1,281,0,0,1,281,1.249264000,0.0000
159.137.249.250,<->,27.11.125.44,1,723,0,0,1,723,1.248934000,0.0000
196.240.242.210,<->,136.25.188.241,0,0,1,561,1,561,1.248576000,0.0000
196.204.59.224,<->,136.25.188.238,0,0,1,282,1,282,1.248571000,0.0000
220.40.166.218,<->,133.178.226.28,0,0,1,1181,1,1181,1.248230000,0.0000
215.158.239.76,<->,142.229.151.74,1,701,0,0,1,701,1.247110000,0.0000
210.229.230.21,<->,100.148.17.45,1,68,0,0,1,68,1.247035000,0.0000
215.158.238.176,<->,201.211.112.235,1,1341,0,0,1,1341,1.247011000,0.0000
215.158.238.121,<->,69.150.169.42,1,1165,0,0,1,1165,1.245503000,0.0000
215.158.238.115,<->,91.247.40.68,1,469,0,0,1,469,1.245342000,0.0000
195.107.225.155,<->,50.224.76.234,0,0,1,1196,1,1196,1.245339000,0.0000
253.182.227.8,<->,136.25.188.179,0,0,1,1325,1,1325,1.245160000,0.0000
195.55.49.14,<->,136.25.188.252,0,0,1,141,1,141,1.244857000,0.0000
197.113.99.41,<->,136.25.188.53,0,0,1,101,1,101,1.244421000,0.0000
143.20.222.208,<->,50.224.76.235,0,0,1,731,1,731,1.244358000,0.0000
109.222.209.61,<->,50.233.50.26,1,768,0,0,1,768,1.244295000,0.0000
143.91.217.78,<->,136.25.188.209,0,0,1,701,1,701,1.244061000,0.0000
136.25.189.58,<->,114.94.161.213,1,1357,0,0,1,1357,1.243884000,0.0000
218.85.24.6,<->,50.224.76.234,0,0,1,842,1,842,1.243642000,0.0000
215.158.238.99,<->,115.140.139.149,1,1213,0,0,1,1213,1.243432000,0.0000
210.229.230.22,<->,109.105.145.158,1,68,0,0,1,68,1.243054000,0.0000
215.158.239.57,<->,114.146.74.226,1,1053,0,0,1,1053,1.243001000,0.0000
199.68.189.24,<->,136.25.188.198,0,0,1,170,1,170,1.242996000,0.0000
215.158.140.93,<->,122.159.123.10,1,1042,0,0,1,1042,1.242060000,0.0000
249.229.106.112,<->,8.43.210.80,0,0,1,756,1,756,1.242034000,0.0000
215.158.239.56,<->,196.106.119.34,1,632,0,0,1,632,1.241989000,0.0000
215.158.239.94,<->,38.104.11.40,1,1245,0,0,1,1245,1.241985000,0.0000
136.25.189.15,<->,68.124.221.182,1,1405,0,0,1,1405,1.241654000,0.0000
215.158.239.58,<->,142.191.235.114,1,93,0,0,1,93,1.241526000,0.0000
215.158.61.202,<->,8.176.8.250,0,0,1,1405,1,1405,1.241506000,0.0000
215.158.238.82,<->,122.159.31.168,1,1117,0,0,1,1117,1.241458000,0.0000
195.70.205.28,<->,136.25.188.236,0,0,1,653,1,653,1.241442000,0.0000
126.198.149.124,<->,100.93.22.85,0,0,1,340,1,340,1.240631000,0.0000
215.158.238.133,<->,114.25.48.78,1,1117,0,0,1,1117,1.240519000,0.0000
215.158.238.66,<->,113.23.104.215,1,1197,0,0,1,1197,1.240513000,0.0000
215.158.238.250,<->,113.23.56.88,1,1088,0,0,1,1088,1.240484000,0.0000
144.85.170.254,<->,98.87.146.71,1,705,0,0,1,705,1.240466000,0.0000
215.158.238.75,<->,38.104.11.40,1,1485,0,0,1,1485,1.240426000,0.0000
215.158.239.70,<->,69.150.169.187,1,1093,0,0,1,1093,1.240339000,0.0000
136.25.189.0,<->,119.196.23.55,1,1309,0,0,1,1309,1.240338000,0.0000
144.71.40.160,<->,64.163.196.59,1,428,0,0,1,428,1.240284000,0.0000
215.158.238.9,<->,8.222.109.84,1,1325,0,0,1,1325,1.240277000,0.0000
215.158.239.56,<->,199.20.30.116,1,190,0,0,1,190,1.240255000,0.0000
142.253.192.140,<->,136.25.188.198,0,0,1,170,1,170,1.239725000,0.0000
97.233.39.9,<->,8.220.190.86,0,0,1,75,1,75,1.239723000,0.0000
126.198.147.25,<->,92.27.27.183,0,0,1,341,1,341,1.239689000,0.0000
133.178.227.23,<->,100.224.133.123,1,543,0,0,1,543,1.239634000,0.0000
133.178.226.80,<->,96.155.60.212,1,147,0,0,1,147,1.239578000,0.0000
220.55.173.143,<->,53.192.240.221,1,161,0,0,1,161,1.239200000,0.0000
215.158.238.134,<->,57.210.107.27,1,1309,0,0,1,1309,1.238968000,0.0000
215.158.239.244,<->,112.235.86.193,1,154,0,0,1,154,1.238965000,0.0000
136.25.188.254,<->,8.222.212.27,1,1117,0,0,1,1117,1.238308000,0.0000
192.64.87.18,<->,8.45.175.127,1,208,0,0,1,208,1.238129000,0.0000
126.198.141.74,<->,80.40.31.32,0,0,1,68,1,68,1.237554000,0.0000
215.158.238.135,<->,42.97.54.90,1,1101,0,0,1,1101,1.237258000,0.0000
143.155.227.43,<->,133.178.226.37,0,0,1,1293,1,1293,1.237024000,0.0000
215.158.239.95,<->,199.82.248.216,1,238,0,0,1,238,1.236630000,0.0000
100.230.151.30,<->,80.27.153.11,0,0,1,1504,1,1504,1.236524000,0.0000
136.18.96.45,<->,8.182.226.78,0,0,1,535,1,535,1.236511000,0.0000
195.13.207.241,<->,136.25.188.198,0,0,1,749,1,749,1.236182000,0.0000
196.89.117.145,<->,136.25.188.178,0,0,1,302,1,302,1.235931000,0.0000
192.178.208.163,<->,98.67.158.12,0,0,1,95,1,95,1.235750000,0.0000
6.145.168.118,<->,0.195.210.44,0,0,1,87,1,87,1.235303000,0.0000
222.31.192.130,<->,8.220.189.63,0,0,1,1153,1,1153,1.235204000,0.0000
128.108.35.102,<->,8.52.179.237,0,0,1,443,1,443,1.234945000,0.0000
220.20.200.172,<->,119.159.22.233,1,343,0,0,1,343,1.234777000,0.0000
235.253.218.229,<->,215.158.238.132,0,0,1,1373,1,1373,1.234708000,0.0000
215.158.239.239,<->,129.175.139.243,1,245,0,0,1,245,1.234635000,0.0000
111.150.186.232,<->,8.252.222.176,0,0,1,1277,1,1277,1.234268000,0.0000
231.142.7.60,<->,215.158.239.56,0,0,1,282,1,282,1.234177000,0.0000
215.158.238.107,<->,148.26.113.31,1,1197,0,0,1,1197,1.234031000,0.0000
215.158.239.58,<->,196.109.125.225,1,179,0,0,1,179,1.233959000,0.0000
215.158.239.215,<->,215.158.61.189,1,330,0,0,1,330,1.233918000,0.0000
215.158.238.112,<->,112.93.136.104,1,1293,0,0,1,1293,1.233373000,0.0000
143.148.128.142,<->,0.195.210.46,0,0,1,1208,1,1208,1.233279000,0.0000
215.158.238.148,<->,113.20.94.112,1,1197,0,0,1,1197,1.232744000,0.0000
215.158.238.92,<->,141.199.76.251,1,1149,0,0,1,1149,1.232690000,0.0000
139.163.96.104,<->,50.94.121.229,1,198,0,0,1,198,1.232509000,0.0000
133.178.226.29,<->,38.104.11.126,1,1245,0,0,1,1245,1.232440000,0.0000
112.208.20.199,<->,102.50.212.36,0,0,1,50,1,50,1.232179000,0.0000
215.158.239.231,<->,53.157.243.122,1,237,0,0,1,237,1.230847000,0.0000
112.11.97.199,<->,8.31.37.161,0,0,1,907,1,907,1.230370000,0.0000
220.28.85.14,<->,133.178.227.60,0,0,1,571,1,571,1.230009000,0.0000
198.35.143.131,<->,139.163.26.146,0,0,1,99,1,99,1.229917000,0.0000
114.76.111.145,<->,92.162.253.150,0,0,1,439,1,439,1.229916000,0.0000
215.158.238.113,<->,57.199.250.196,1,1357,0,0,1,1357,1.229750000,0.0000
215.158.238.114,<->,192.226.161.157,1,1373,0,0,1,1373,1.229354000,0.0000
215.158.239.56,<->,196.0.105.26,1,141,0,0,1,141,1.229061000,0.0000
215.202.175.5,<->,215.158.238.133,0,0,1,1229,1,1229,1.228745000,0.0000
197.113.99.203,<->,136.25.188.173,0,0,1,136,1,136,1.228696000,0.0000
199.33.55.240,<->,136.25.188.255,0,0,1,602,1,602,1.228459000,0.0000
136.129.30.3,<->,50.224.76.248,0,0,1,70,1,70,1.228385000,0.0000
35.55.6.217,<->,8.183.25.224,0,0,1,87,1,87,1.228167000,0.0000
192.170.255.220,<->,133.32.39.0,0,0,1,247,1,247,1.227939000,0.0000
133.178.227.14,<->,8.219.187.251,1,1341,0,0,1,1341,1.227901000,0.0000
215.158.239.76,<->,196.0.254.96,1,602,0,0,1,602,1.227512000,0.0000
215.158.239.84,<->,199.20.30.168,1,781,0,0,1,781,1.227392000,0.0000
239.66.110.113,<->,203.215.177.29,0,0,1,615,1,615,1.227381000,0.0000
215.158.238.107,<->,206.103.249.181,1,1309,0,0,1,1309,1.227076000,0.0000
215.158.239.93,<->,199.76.70.154,1,132,0,0,1,132,1.227004000,0.0000
136.25.189.0,<->,8.252.253.196,1,1373,0,0,1,1373,1.226995000,0.0000
82.121.224.75,<->,8.52.180.14,0,0,1,75,1,75,1.226697000,0.0000
133.178.226.197,<->,56.97.187.17,1,152,0,0,1,152,1.226575000,0.0000
215.158.238.104,<->,143.155.227.33,1,1101,0,0,1,1101,1.226400000,0.0000
215.158.239.35,<->,149.96.53.54,1,1477,0,0,1,1477,1.226382000,0.0000
253.66.34.7,<->,8.52.183.207,0,0,1,890,1,890,1.225931000,0.0000
136.25.189.83,<->,113.92.151.24,1,1252,0,0,1,1252,1.225732000,0.0000
204.186.199.78,<->,136.25.188.209,0,0,1,765,1,765,1.225535000,0.0000
251.21.173.35,<->,109.222.232.22,0,0,1,134,1,134,1.225394000,0.0000
215.158.238.238,<->,8.219.185.104,1,667,0,0,1,667,1.225150000,0.0000
215.158.239.40,<->,8.190.216.249,1,95,0,0,1,95,1.225141000,0.0000
220.28.108.254,<->,215.158.239.67,0,0,1,1324,1,1324,1.224842000,0.0000
129.224.112.252,<->,97.242.126.187,1,102,0,0,1,102,1.224769000,0.0000
215.158.239.58,<->,195.49.130.151,1,749,0,0,1,749,1.224511000,0.0000
215.158.238.132,<->,128.110.138.173,1,1117,0,0,1,1117,1.224421000,0.0000
215.158.239.85,<->,113.92.151.118,1,1245,0,0,1,1245,1.223984000,0.0000
133.178.227.78,<->,96.155.60.130,1,1037,0,0,1,1037,1.223940000,0.0000
209.91.128.36,<->,8.52.139.19,0,0,1,637,1,637,1.223691000,0.0000
215.158.140.93,<->,192.224.20.45,1,959,0,0,1,959,1.222973000,0.0000
215.158.238.83,<->,111.151.70.52,1,1229,0,0,1,1229,1.221616000,0.0000
193.10.94.23,<->,136.25.188.162,0,0,1,1277,1,1277,1.221528000,0.0000
215.158.238.233,<->,126.219.234.254,1,100,0,0,1,100,1.221521000,0.0000
215.158.238.64,<->,42.226.3.107,1,1277,0,0,1,1277,1.221413000,0.0000
133.8.10.152,<->,33.233.141.121,0,0,1,284,1,284,1.221251000,0.0000
215.158.239.70,<->,56.20.41.31,1,1341,0,0,1,1341,1.220813000,0.0000
56.9.244.247,<->,8.182.226.78,0,0,1,811,1,811,1.220767000,0.0000
132.136.195.201,<->,98.119.93.145,1,467,0,0,1,467,1.220616000,0.0000
136.25.188.250,<->,0.195.237.14,1,960,0,0,1,960,1.219954000,0.0000
132.118.97.71,<->,80.42.154.222,0,0,1,93,1,93,1.219465000,0.0000
133.178.226.30,<->,120.155.8.109,1,1373,0,0,1,1373,1.219210000,0.0000
204.21.142.191,<->,136.25.188.220,0,0,1,656,1,656,1.219083000,0.0000
215.158.238.66,<->,57.210.107.8,1,1229,0,0,1,1229,1.219034000,0.0000
207.172.10.180,<->,136.25.188.225,0,0,1,105,1,105,1.218733000,0.0000
136.25.189.12,<->,68.124.221.169,1,1165,0,0,1,1165,1.218667000,0.0000
92.27.218.242,<->,29.250.106.180,1,194,0,0,1,194,1.218316000,0.0000
215.158.239.48,<->,199.20.31.138,1,234,0,0,1,234,1.217885000,0.0000
215.158.238.45,<->,143.45.0.148,1,1229,0,0,1,1229,1.217632000,0.0000
213.186.61.53,<->,144.85.170.208,0,0,1,442,1,442,1.217452000,0.0000
133.178.226.29,<->,106.188.252.212,1,1245,0,0,1,1245,1.217082000,0.0000
133.178.226.43,<->,98.219.126.175,1,278,0,0,1,278,1.217052000,0.0000
215.158.140.60,<->,158.192.3.71,1,1090,0,0,1,1090,1.216651000,0.0000
220.55.100.127,<->,220.20.202.53,1,1359,0,0,1,1359,1.216635000,0.0000
215.158.239.56,<->,195.43.91.147,1,506,0,0,1,506,1.216250000,0.0000
215.158.238.92,<->,201.136.143.26,1,1069,0,0,1,1069,1.215913000,0.0000
97.203.79.210,<->,8.182.228.189,0,0,1,480,1,480,1.215693000,0.0000
215.158.238.123,<->,131.4.188.255,1,1229,0,0,1,1229,1.215133000,0.0000
192.64.254.164,<->,8.45.162.111,1,75,0,0,1,75,1.214904000,0.0000
159.13.135.29,<->,53.213.20.251,1,749,0,0,1,749,1.214742000,0.0000
94.195.98.61,<->,8.252.221.197,0,0,1,507,1,507,1.214452000,0.0000
99.215.70.113,<->,8.182.228.189,0,0,1,496,1,496,1.214205000,0.0000
133.178.226.30,<->,133.73.194.20,1,1325,0,0,1,1325,1.214200000,0.0000
215.158.239.92,<->,199.68.184.64,1,669,0,0,1,669,1.213913000,0.0000
133.178.227.76,<->,126.219.100.248,1,1069,0,0,1,1069,1.213900000,0.0000
136.25.189.31,<->,122.216.233.153,1,1213,0,0,1,1213,1.213891000,0.0000
216.184.2.212,<->,6.73.247.25,0,0,1,1205,1,1205,1.213889000,0.0000
195.41.194.52,<->,136.25.188.44,0,0,1,322,1,322,1.213791000,0.0000
195.110.170.238,<->,99.72.240.156,0,0,1,50,1,50,1.213746000,0.0000
117.0.107.131,<->,92.168.217.228,0,0,1,536,1,536,1.213661000,0.0000
148.26.113.236,<->,133.178.227.27,0,0,1,1037,1,1037,1.213653000,0.0000
121.79.53.224,<->,111.147.100.68,0,0,1,150,1,150,1.213633000,0.0000
142.252.140.253,<->,136.25.188.236,0,0,1,270,1,270,1.213497000,0.0000
215.158.238.177,<->,38.104.11.119,1,1405,0,0,1,1405,1.213355000,0.0000
132.212.185.37,<->,80.42.130.198,0,0,1,890,1,890,1.213160000,0.0000
215.158.238.45,<->,198.226.166.143,1,1341,0,0,1,1341,1.213143000,0.0000
215.158.238.45,<->,146.10.166.72,1,1341,0,0,1,1341,1.212814000,0.0000
225.170.68.28,<->,97.198.118.57,0,0,1,425,1,425,1.212396000,0.0000
133.178.226.232,<->,100.224.243.118,1,334,0,0,1,334,1.212231000,0.0000
195.12.232.91,<->,136.25.188.225,0,0,1,316,1,316,1.211821000,0.0000
215.158.238.189,<->,8.219.185.106,1,458,0,0,1,458,1.211473000,0.0000
220.20.200.89,<->,122.12.244.202,1,611,0,0,1,611,1.211070000,0.0000
204.58.93.172,<->,50.224.76.234,0,0,1,930,1,930,1.210939000,0.0000
215.158.238.66,<->,57.227.83.251,1,1325,0,0,1,1325,1.210880000,0.0000
136.25.189.14,<->,8.47.120.246,1,1245,0,0,1,1245,1.210723000,0.0000
215.158.140.75,<->,80.47.152.201,1,1084,0,0,1,1084,1.210686000,0.0000
234.182.161.104,<->,215.158.140.188,0,0,1,423,1,423,1.210490000,0.0000
136.25.188.255,<->,122.158.49.154,1,1213,0,0,1,1213,1.210141000,0.0000
215.158.238.75,<->,112.220.206.107,1,1117,0,0,1,1117,1.210097000,0.0000
72.210.211.251,<->,33.233.141.84,0,0,1,572,1,572,1.209789000,0.0000
136.25.188.248,<->,100.216.78.145,1,1140,0,0,1,1140,1.209740000,0.0000
143.155.227.33,<->,136.25.188.172,0,0,1,190,1,190,1.209696000,0.0000
97.126.17.109,<->,50.233.108.108,1,68,0,0,1,68,1.209433000,0.0000
146.171.130.228,<->,133.178.227.16,0,0,1,1325,1,1325,1.209161000,0.0000
215.158.238.67,<->,122.158.49.149,1,453,0,0,1,453,1.208999000,0.0000
136.25.188.160,<->,124.72.95.5,1,1229,0,0,1,1229,1.208776000,0.0000
204.200.35.204,<->,136.25.188.46,0,0,1,507,1,507,1.208718000,0.0000
206.103.215.34,<->,136.25.189.0,0,0,1,1197,1,1197,1.208442000,0.0000
69.243.223.45,<->,8.252.221.196,0,0,1,345,1,345,1.208427000,0.0000
254.242.184.207,<->,58.202.245.16,1,547,0,0,1,547,1.208321000,0.0000
54.59.75.111,<->,48.52.80.13,0,0,1,93,1,93,1.208314000,0.0000
215.158.61.189,<->,136.25.188.34,0,0,1,685,1,685,1.207905000,0.0000
158.55.218.34,<->,50.224.76.235,0,0,1,1093,1,1093,1.207859000,0.0000
148.99.76.44,<->,0.195.210.8,0,0,1,564,1,564,1.207646000,0.0000
215.158.239.19,<->,8.222.7.180,1,1106,0,0,1,1106,1.207450000,0.0000
136.25.188.178,<->,131.173.115.84,1,1293,0,0,1,1293,1.207372000,0.0000
243.123.125.57,<->,210.158.44.41,0,0,1,1035,1,1035,1.207208000,0.0000
215.158.238.120,<->,194.205.112.168,1,1357,0,0,1,1357,1.207019000,0.0000
119.159.22.233,<->,92.162.253.252,0,0,1,367,1,367,1.206800000,0.0000
199.38.203.99,<->,136.25.188.53,0,0,1,101,1,101,1.206778000,0.0000
136.25.188.161,<->,113.20.94.83,1,1229,0,0,1,1229,1.206453000,0.0000
220.20.200.13,<->,144.83.60.153,1,472,0,0,1,472,1.206436000,0.0000
132.136.194.171,<->,116.184.23.7,1,58,0,0,1,58,1.206057000,0.0000
196.246.202.18,<->,136.25.188.177,0,0,1,742,1,742,1.206050000,0.0000
136.25.188.45,<->,113.23.104.203,1,1341,0,0,1,1341,1.205793000,0.0000
119.163.235.139,<->,50.224.76.235,0,0,1,868,1,868,1.205644000,0.0000
252.132.50.7,<->,8.252.222.208,0,0,1,105,1,105,1.205462000,0.0000
215.158.239.51,<->,69.150.169.38,1,1229,0,0,1,1229,1.205186000,0.0000
136.25.188.196,<->,8.227.55.83,1,246,0,0,1,246,1.205164000,0.0000
17.116.39.130,<->,8.220.186.82,0,0,1,168,1,168,1.205140000,0.0000
213.186.59.253,<->,144.85.170.244,0,0,1,876,1,876,1.205100000,0.0000
100.93.188.233,<->,89.205.210.165,1,97,0,0,1,97,1.204799000,0.0000
149.163.129.241,<->,133.178.227.57,0,0,1,1037,1,1037,1.203563000,0.0000
136.25.188.223,<->,122.159.245.172,1,1341,0,0,1,1341,1.203458000,0.0000
136.25.188.161,<->,114.25.48.25,1,1149,0,0,1,1149,1.203187000,0.0000
215.158.238.83,<->,38.104.11.27,1,1181,0,0,1,1181,1.202566000,0.0000
215.158.239.43,<->,8.219.187.249,1,1265,0,0,1,1265,1.202398000,0.0000
136.25.189.18,<->,118.20.100.120,1,1016,0,0,1,1016,1.202326000,0.0000
215.158.238.82,<->,57.199.250.212,1,1341,0,0,1,1341,1.202254000,0.0000
139.163.166.118,<->,136.25.188.176,0,0,1,93,1,93,1.202096000,0.0000
204.185.182.19,<->,136.25.188.225,0,0,1,749,1,749,1.202069000,0.0000
142.228.165.122,<->,136.25.188.196,0,0,1,765,1,765,1.201913000,0.0000
143.89.63.84,<->,136.25.188.238,0,0,1,282,1,282,1.201898000,0.0000
111.147.153.228,<->,53.221.175.173,1,125,0,0,1,125,1.201703000,0.0000
199.71.214.85,<->,136.25.188.254,0,0,1,781,1,781,1.201322000,0.0000
210.236.92.115,<->,133.54.43.46,0,0,1,668,1,668,1.200515000,0.0000
215.158.238.117,<->,145.116.209.82,1,506,0,0,1,506,1.200415000,0.0000
215.158.239.92,<->,48.131.157.39,1,1357,0,0,1,1357,1.199765000,0.0000
193.11.129.102,<->,136.25.189.57,0,0,1,789,1,789,1.199673000,0.0000
215.158.238.81,<->,193.10.94.23,1,1197,0,0,1,1197,1.199401000,0.0000
207.193.113.167,<->,8.252.222.29,0,0,1,95,1,95,1.199329000,0.0000
215.158.238.198,<->,61.35.124.188,1,1085,0,0,1,1085,1.198980000,0.0000
132.128.49.138,<->,35.56.97.244,0,0,1,1009,1,1009,1.198952000,0.0000
215.158.239.79,<->,195.43.148.38,1,93,0,0,1,93,1.198751000,0.0000
215.158.238.82,<->,192.228.30.102,1,1325,0,0,1,1325,1.198672000,0.0000
215.158.238.103,<->,100.224.166.122,1,506,0,0,1,506,1.198628000,0.0000
215.158.238.227,<->,120.155.8.88,1,146,0,0,1,146,1.198563000,0.0000
215.158.238.59,<->,126.219.102.72,1,1453,0,0,1,1453,1.198531000,0.0000
210.220.219.150,<->,91.43.106.196,1,93,0,0,1,93,1.198273000,0.0000
215.158.238.96,<->,50.218.56.251,1,1245,0,0,1,1245,1.198254000,0.0000
111.151.142.230,<->,8.252.221.232,0,0,1,100,1,100,1.197881000,0.0000
210.229.230.22,<->,26.209.247.67,1,80,0,0,1,80,1.197691000,0.0000
215.158.238.236,<->,29.211.165.35,1,1116,0,0,1,1116,1.197388000,0.0000
144.83.60.153,<->,92.162.253.141,0,0,1,1218,1,1218,1.197173000,0.0000
235.253.218.229,<->,133.178.226.30,0,0,1,1309,1,1309,1.196917000,0.0000
215.158.238.133,<->,123.130.141.150,1,1277,0,0,1,1277,1.196874000,0.0000
207.191.168.51,<->,136.25.188.222,0,0,1,132,1,132,1.196435000,0.0000
194.220.121.53,<->,50.224.76.230,0,0,1,1220,1,1220,1.196233000,0.0000
215.158.61.243,<->,136.25.188.35,0,0,1,658,1,658,1.196166000,0.0000
199.122.184.238,<->,8.52.228.29,0,0,1,497,1,497,1.195952000,0.0000
215.158.239.18,<->,8.255.92.117,1,1033,0,0,1,1033,1.195906000,0.0000
235.253.220.246,<->,215.158.239.77,0,0,1,1357,1,1357,1.195788000,0.0000
215.158.239.167,<->,111.151.237.138,1,583,0,0,1,583,1.195651000,0.0000
215.158.238.112,<->,144.253.73.85,1,1344,0,0,1,1344,1.195529000,0.0000
143.79.114.100,<->,136.25.188.173,0,0,1,170,1,170,1.195526000,0.0000
215.158.140.83,<->,33.221.186.171,1,1092,0,0,1,1092,1.195299000,0.0000
86.194.118.34,<->,0.195.210.24,0,0,1,363,1,363,1.195086000,0.0000
133.178.226.31,<->,112.220.206.88,1,1181,0,0,1,1181,1.194621000,0.0000
215.158.239.5,<->,96.135.154.155,1,109,0,0,1,109,1.194414000,0.0000
215.158.238.107,<->,29.212.195.20,1,1213,0,0,1,1213,1.194259000,0.0000
207.172.230.255,<->,136.25.188.53,0,0,1,781,1,781,1.193723000,0.0000
144.94.162.244,<->,0.195.210.33,0,0,1,125,1,125,1.193652000,0.0000
136.25.188.225,<->,48.129.133.31,1,1341,0,0,1,1341,1.193157000,0.0000
215.158.239.31,<->,8.252.214.214,1,110,0,0,1,110,1.193104000,0.0000
215.158.238.221,<->,148.189.137.55,1,1050,0,0,1,1050,1.192438000,0.0000
136.25.188.253,<->,29.212.182.215,1,989,0,0,1,989,1.192357000,0.0000
136.25.189.78,<->,133.146.0.75,1,1293,0,0,1,1293,1.192329000,0.0000
215.158.238.133,<->,149.99.94.68,1,1389,0,0,1,1389,1.191986000,0.0000
133.178.226.220,<->,100.224.163.94,1,557,0,0,1,557,1.191881000,0.0000
215.158.239.34,<->,8.219.187.244,1,965,0,0,1,965,1.191620000,0.0000
99.162.77.146,<->,53.201.37.127,1,642,0,0,1,642,1.191213000,0.0000
215.158.140.60,<->,149.163.129.149,1,1150,0,0,1,1150,1.190546000,0.0000
133.178.226.215,<->,130.36.8.103,1,767,0,0,1,767,1.190310000,0.0000
221.102.143.189,<->,192.64.244.13,0,0,1,141,1,141,1.190163000,0.0000
146.132.48.23,<->,136.25.189.81,0,0,1,1389,1,1389,1.190158000,0.0000
215.158.239.48,<->,204.1.185.76,1,573,0,0,1,573,1.189817000,0.0000
139.163.26.146,<->,136.116.9.17,1,99,0,0,1,99,1.189063000,0.0000
133.178.227.79,<->,114.146.74.195,1,1057,0,0,1,1057,1.188729000,0.0000
215.158.239.94,<->,8.33.226.42,1,1357,0,0,1,1357,1.188319000,0.0000
216.144.222.136,<->,215.158.140.144,0,0,1,1397,1,1397,1.187955000,0.0000
215.158.238.209,<->,18.202.90.165,1,1107,0,0,1,1107,1.187562000,0.0000
207.173.86.38,<->,136.25.188.174,0,0,1,681,1,681,1.187226000,0.0000
133.178.226.38,<->,106.188.251.218,1,66,0,0,1,66,1.187117000,0.0000
129.225.132.224,<->,129.225.131.152,1,1345,0,0,1,1345,1.187000000,0.0000
133.178.226.213,<->,112.235.95.84,1,152,0,0,1,152,1.186848000,0.0000
133.32.1.140,<->,115.121.228.207,1,276,0,0,1,276,1.186477000,0.0000
143.227.65.245,<->,136.25.188.178,0,0,1,1357,1,1357,1.186343000,0.0000
247.136.132.244,<->,109.219.207.11,1,369,0,0,1,369,1.186228000,0.0000
109.127.101.16,<->,102.50.64.197,0,0,1,230,1,230,1.185790000,0.0000
215.158.239.79,<->,195.127.211.141,1,259,0,0,1,259,1.185519000,0.0000
136.25.188.55,<->,116.107.47.34,1,1229,0,0,1,1229,1.185493000,0.0000
210.209.251.214,<->,109.222.238.4,0,0,1,481,1,481,1.185454000,0.0000
196.206.196.182,<->,136.25.188.174,0,0,1,382,1,382,1.185203000,0.0000
142.229.110.49,<->,136.25.188.178,0,0,1,308,1,308,1.185070000,0.0000
215.158.238.141,<->,148.190.126.29,1,1197,0,0,1,1197,1.185013000,0.0000
215.158.238.141,<->,143.155.227.33,1,1261,0,0,1,1261,1.184928000,0.0000
207.63.65.6,<->,136.25.188.176,0,0,1,141,1,141,1.184705000,0.0000
97.126.7.170,<->,53.190.133.102,1,134,0,0,1,134,1.184547000,0.0000
207.60.52.98,<->,136.25.188.255,0,0,1,170,1,170,1.184539000,0.0000
136.25.188.211,<->,69.132.194.169,1,1437,0,0,1,1437,1.184485000,0.0000
215.158.238.143,<->,125.216.43.104,1,1485,0,0,1,1485,1.184459000,0.0000
136.25.188.226,<->,112.220.206.24,1,1229,0,0,1,1229,1.184414000,0.0000
215.158.238.45,<->,122.158.49.233,1,1261,0,0,1,1261,1.184348000,0.0000
212.118.48.193,<->,192.229.216.117,0,0,1,451,1,451,1.184179000,0.0000
215.158.239.57,<->,114.150.180.156,1,1309,0,0,1,1309,1.184143000,0.0000
221.95.117.170,<->,50.224.76.230,0,0,1,1102,1,1102,1.183605000,0.0000
215.158.239.99,<->,196.104.62.175,1,190,0,0,1,190,1.183496000,0.0000
204.186.127.48,<->,136.25.188.222,0,0,1,717,1,717,1.182900000,0.0000
232.31.155.12,<->,97.198.118.56,0,0,1,400,1,400,1.182592000,0.0000
50.224.76.235,<->,48.130.162.38,1,507,0,0,1,507,1.181942000,0.0000
215.158.238.66,<->,143.88.15.53,1,1309,0,0,1,1309,1.181839000,0.0000
144.85.170.208,<->,91.69.185.132,1,838,0,0,1,838,1.181607000,0.0000
215.158.238.107,<->,143.20.121.150,1,1181,0,0,1,1181,1.181451000,0.0000
207.191.232.222,<->,136.25.188.226,0,0,1,272,1,272,1.181083000,0.0000
136.25.189.45,<->,112.68.105.213,1,1373,0,0,1,1373,1.180735000,0.0000
144.75.218.95,<->,17.61.6.229,1,245,0,0,1,245,1.180687000,0.0000
144.85.170.254,<->,91.69.181.209,1,444,0,0,1,444,1.180059000,0.0000
207.63.0.126,<->,136.25.188.177,0,0,1,771,1,771,1.180022000,0.0000
137.179.183.36,<->,53.167.113.10,1,705,0,0,1,705,1.179993000,0.0000
215.158.3.13,<->,99.73.241.125,0,0,1,458,1,458,1.179949000,0.0000
8.228.216.50,<->,8.191.6.125,1,1067,0,0,1,1067,1.179691000,0.0000
146.188.225.225,<->,89.183.104.144,0,0,1,226,1,226,1.179624000,0.0000
215.158.239.58,<->,196.108.189.52,1,101,0,0,1,101,1.179476000,0.0000
143.10.39.95,<->,136.25.188.175,0,0,1,260,1,260,1.179475000,0.0000
132.123.44.18,<->,8.222.6.255,1,1150,0,0,1,1150,1.179037000,0.0000
192.224.146.52,<->,133.178.227.134,0,0,1,1323,1,1323,1.178871000,0.0000
93.181.154.110,<->,92.27.27.148,0,0,1,64,1,64,1.178634000,0.0000
17.3.51.127,<->,8.220.176.253,0,0,1,312,1,312,1.178609000,0.0000
133.178.226.29,<->,126.219.132.218,1,1149,0,0,1,1149,1.178547000,0.0000
133.178.226.29,<->,131.144.113.214,1,1277,0,0,1,1277,1.178087000,0.0000
215.158.239.79,<->,195.83.24.157,1,358,0,0,1,358,1.177427000,0.0000
215.158.238.140,<->,114.150.180.157,1,1213,0,0,1,1213,1.177118000,0.0000
159.23.130.164,<->,133.178.226.61,0,0,1,1341,1,1341,1.176961000,0.0000
143.13.128.96,<->,136.25.188.253,0,0,1,1005,1,1005,1.176531000,0.0000
215.158.61.193,<->,136.25.188.35,0,0,1,381,1,381,1.176463000,0.0000
159.23.227.171,<->,106.132.139.141,1,292,0,0,1,292,1.176205000,0.0000
215.158.239.40,<->,8.255.92.81,1,1018,0,0,1,1018,1.176063000,0.0000
50.224.89.239,<->,42.35.49.134,1,91,0,0,1,91,1.176033000,0.0000
231.136.253.109,<->,136.25.188.255,0,0,1,240,1,240,1.175873000,0.0000
220.255.14.30,<->,139.193.141.139,0,0,1,349,1,349,1.175683000,0.0000
132.249.70.169,<->,82.195.35.9,1,737,0,0,1,737,1.175673000,0.0000
215.158.239.68,<->,207.114.54.210,1,861,0,0,1,861,1.175624000,0.0000
204.186.141.244,<->,136.25.188.53,0,0,1,101,1,101,1.175015000,0.0000
221.102.126.240,<->,220.21.27.234,1,229,0,0,1,229,1.174542000,0.0000
136.25.188.50,<->,0.195.253.228,1,545,0,0,1,545,1.174409000,0.0000
215.158.238.190,<->,195.65.1.180,1,1048,0,0,1,1048,1.174143000,0.0000
136.25.188.172,<->,80.47.228.213,1,1389,0,0,1,1389,1.173480000,0.0000
252.98.135.226,<->,106.5.211.7,1,162,0,0,1,162,1.173344000,0.0000
129.224.112.252,<->,97.242.126.176,1,99,0,0,1,99,1.172943000,0.0000
221.102.143.189,<->,98.129.25.93,0,0,1,87,1,87,1.172456000,0.0000
113.2.177.77,<->,50.224.76.235,0,0,1,571,1,571,1.172239000,0.0000
215.158.239.40,<->,120.155.14.85,1,1214,0,0,1,1214,1.172004000,0.0000
196.240.242.55,<->,136.25.188.238,0,0,1,269,1,269,1.171934000,0.0000
133.54.17.207,<->,57.4.50.131,1,212,0,0,1,212,1.171838000,0.0000
215.158.140.172,<->,107.118.3.253,1,481,0,0,1,481,1.171647000,0.0000
109.51.169.114,<->,8.182.226.78,0,0,1,822,1,822,1.171302000,0.0000
136.25.188.171,<->,111.150.207.201,1,100,0,0,1,100,1.170904000,0.0000
50.48.55.79,<->,8.220.235.178,0,0,1,518,1,518,1.170662000,0.0000
221.102.56.25,<->,192.65.64.124,0,0,1,141,1,141,1.170447000,0.0000
133.178.226.232,<->,111.150.207.201,1,100,0,0,1,100,1.170194000,0.0000
199.121.94.233,<->,136.25.188.176,0,0,1,316,1,316,1.170165000,0.0000
84.200.127.223,<->,6.95.3.106,0,0,1,450,1,450,1.169590000,0.0000
143.155.227.33,<->,133.178.226.37,0,0,1,1101,1,1101,1.169376000,0.0000
141.199.76.215,<->,136.25.189.57,0,0,1,1357,1,1357,1.169147000,0.0000
215.158.3.33,<->,99.73.241.125,0,0,1,458,1,458,1.168749000,0.0000
215.158.238.95,<->,29.209.59.166,1,1229,0,0,1,1229,1.168578000,0.0000
215.158.238.142,<->,119.168.0.40,1,1309,0,0,1,1309,1.168208000,0.0000
215.158.238.121,<->,194.205.112.170,1,1277,0,0,1,1277,1.168155000,0.0000
215.158.238.95,<->,141.103.76.137,1,1053,0,0,1,1053,1.168056000,0.0000
207.60.111.65,<->,136.25.188.54,0,0,1,658,1,658,1.168004000,0.0000
122.158.179.43,<->,8.252.223.153,0,0,1,1043,1,1043,1.167372000,0.0000
136.25.188.237,<->,122.159.245.165,1,1277,0,0,1,1277,1.167205000,0.0000
207.88.82.50,<->,0.195.210.42,0,0,1,113,1,113,1.167136000,0.0000
220.55.116.0,<->,84.214.213.6,1,680,0,0,1,680,1.167116000,0.0000
50.224.76.230,<->,18.201.229.119,1,851,0,0,1,851,1.166500000,0.0000
210.229.230.21,<->,6.141.138.161,1,68,0,0,1,68,1.166264000,0.0000
127.70.144.165,<->,50.224.76.235,0,0,1,552,1,552,1.166148000,0.0000
215.158.238.236,<->,131.219.110.169,1,1095,0,0,1,1095,1.165982000,0.0000
215.158.238.132,<->,113.23.117.86,1,1245,0,0,1,1245,1.165875000,0.0000
142.207.223.34,<->,136.25.188.162,0,0,1,765,1,765,1.165785000,0.0000
249.176.116.24,<->,224.148.203.58,0,0,1,572,1,572,1.165597000,0.0000
215.158.238.223,<->,140.174.84.228,1,1325,0,0,1,1325,1.165483000,0.0000
215.158.239.76,<->,149.252.245.36,1,1277,0,0,1,1277,1.165467000,0.0000
133.178.227.12,<->,56.1.237.9,1,1452,0,0,1,1452,1.165444000,0.0000
215.158.239.68,<->,202.33.23.96,1,87,0,0,1,87,1.165299000,0.0000
207.236.29.192,<->,136.25.188.238,0,0,1,265,1,265,1.165216000,0.0000
195.3.103.216,<->,136.25.189.1,0,0,1,1197,1,1197,1.165150000,0.0000
243.117.92.129,<->,80.38.54.70,0,0,1,1412,1,1412,1.164935000,0.0000
197.103.151.87,<->,133.178.226.61,0,0,1,1357,1,1357,1.164617000,0.0000
215.158.239.76,<->,196.91.71.96,1,180,0,0,1,180,1.164054000,0.0000
136.25.188.225,<->,91.57.162.216,1,1277,0,0,1,1277,1.163269000,0.0000
129.225.132.224,<->,129.225.131.138,1,659,0,0,1,659,1.163263000,0.0000
200.174.122.61,<->,53.214.103.50,1,973,0,0,1,973,1.162934000,0.0000
146.193.112.243,<->,8.252.221.206,0,0,1,223,1,223,1.162694000,0.0000
133.178.226.7,<->,8.219.187.245,1,1497,0,0,1,1497,1.162222000,0.0000
133.178.227.14,<->,29.211.165.11,1,1194,0,0,1,1194,1.162035000,0.0000
215.158.238.143,<->,113.23.117.86,1,1229,0,0,1,1229,1.161345000,0.0000
197.113.99.93,<->,136.25.188.236,0,0,1,765,1,765,1.161195000,0.0000
215.158.238.123,<->,131.1.195.223,1,1448,0,0,1,1448,1.160988000,0.0000
215.158.239.84,<->,196.92.205.203,1,190,0,0,1,190,1.160983000,0.0000
144.83.60.153,<->,92.162.253.60,0,0,1,411,1,411,1.160916000,0.0000
215.158.61.253,<->,8.252.221.245,0,0,1,1157,1,1157,1.160856000,0.0000
199.82.190.234,<->,136.25.188.176,0,0,1,93,1,93,1.160727000,0.0000
97.126.24.188,<->,53.231.179.172,1,97,0,0,1,97,1.160239000,0.0000
215.158.239.79,<->,199.82.190.234,1,93,0,0,1,93,1.159803000,0.0000
80.27.109.237,<->,8.252.223.213,0,0,1,129,1,129,1.159771000,0.0000
210.158.44.150,<->,127.62.26.151,1,310,0,0,1,310,1.159415000,0.0000
198.204.76.245,<->,136.25.189.29,0,0,1,1309,1,1309,1.159320000,0.0000
136.25.189.8,<->,96.156.169.210,1,510,0,0,1,510,1.159306000,0.0000
215.158.238.198,<->,197.125.118.95,1,1188,0,0,1,1188,1.158843000,0.0000
213.221.90.140,<->,144.85.170.208,0,0,1,740,1,740,1.158840000,0.0000
111.147.135.6,<->,53.148.22.108,1,125,0,0,1,125,1.158484000,0.0000
105.205.123.121,<->,92.168.217.245,0,0,1,544,1,544,1.158162000,0.0000
136.25.189.59,<->,32.183.36.249,1,1373,0,0,1,1373,1.158065000,0.0000
159.117.147.237,<->,92.162.253.191,0,0,1,1086,1,1086,1.157857000,0.0000
144.253.73.246,<->,133.178.227.228,0,0,1,285,1,285,1.157757000,0.0000
215.158.239.50,<->,195.54.60.2,1,765,0,0,1,765,1.157278000,0.0000
247.136.144.224,<->,66.244.99.65,1,71,0,0,1,71,1.156930000,0.0000
75.137.148.199,<->,8.252.221.198,0,0,1,524,1,524,1.155950000,0.0000
215.158.238.73,<->,122.158.49.195,1,1261,0,0,1,1261,1.155949000,0.0000
124.42.155.136,<->,8.252.221.171,0,0,1,319,1,319,1.155921000,0.0000
136.25.189.82,<->,80.56.79.73,1,1386,0,0,1,1386,1.155748000,0.0000
133.178.227.19,<->,8.252.213.36,1,1072,0,0,1,1072,1.155346000,0.0000
215.158.140.93,<->,126.219.102.25,1,1037,0,0,1,1037,1.155336000,0.0000
215.158.238.221,<->,120.154.227.171,1,1085,0,0,1,1085,1.155298000,0.0000
142.223.114.231,<->,136.25.188.238,0,0,1,1496,1,1496,1.155234000,0.0000
109.51.92.28,<->,8.182.244.19,0,0,1,685,1,685,1.155188000,0.0000
192.224.20.52,<->,133.178.227.250,0,0,1,1405,1,1405,1.155007000,0.0000
195.13.84.248,<->,136.25.188.238,0,0,1,269,1,269,1.154940000,0.0000
86.198.148.135,<->,0.195.210.24,0,0,1,621,1,621,1.154577000,0.0000
221.101.8.230,<->,218.5.150.2,1,488,0,0,1,488,1.154257000,0.0000
80.57.138.196,<->,8.252.221.165,0,0,1,100,1,100,1.154124000,0.0000
215.158.239.96,<->,195.83.231.12,1,240,0,0,1,240,1.154055000,0.0000
215.158.238.47,<->,69.31.238.232,1,1357,0,0,1,1357,1.153842000,0.0000
215.158.238.81,<->,212.70.75.55,1,1277,0,0,1,1277,1.153841000,0.0000
80.40.55.49,<->,54.44.113.39,1,622,0,0,1,622,1.153050000,0.0000
195.109.35.75,<->,99.73.186.154,0,0,1,78,1,78,1.152932000,0.0000
215.158.238.98,<->,65.27.228.230,1,1133,0,0,1,1133,1.152809000,0.0000
136.25.188.52,<->,112.220.206.117,1,1101,0,0,1,1101,1.152762000,0.0000
215.158.238.95,<->,131.36.198.57,1,1413,0,0,1,1413,1.152657000,0.0000
220.28.104.193,<->,215.158.140.89,0,0,1,217,1,217,1.152603000,0.0000
220.31.31.23,<->,8.182.241.177,0,0,1,512,1,512,1.152558000,0.0000
215.158.238.143,<->,112.220.206.117,1,1133,0,0,1,1133,1.152552000,0.0000
215.158.239.4,<->,29.212.196.25,1,212,0,0,1,212,1.152291000,0.0000
215.158.140.177,<->,113.207.62.36,1,1045,0,0,1,1045,1.152228000,0.0000
98.129.85.211,<->,97.4.157.23,1,92,0,0,1,92,1.152213000,0.0000
215.158.238.113,<->,57.227.83.183,1,1341,0,0,1,1341,1.152179000,0.0000
159.23.226.13,<->,112.11.52.165,1,83,0,0,1,83,1.152158000,0.0000
215.158.238.82,<->,100.224.202.8,1,1149,0,0,1,1149,1.152043000,0.0000
215.158.238.33,<->,29.211.186.213,1,1229,0,0,1,1229,1.151754000,0.0000
143.155.227.33,<->,136.25.188.221,0,0,1,190,1,190,1.151247000,0.0000
159.137.162.213,<->,112.70.222.21,1,632,0,0,1,632,1.151231000,0.0000
99.162.65.136,<->,53.214.235.71,1,257,0,0,1,257,1.150992000,0.0000
220.55.72.171,<->,220.20.206.153,1,1297,0,0,1,1297,1.150520000,0.0000
141.182.238.203,<->,8.252.221.223,0,0,1,268,1,268,1.150464000,0.0000
156.135.202.220,<->,50.223.3.230,0,0,1,483,1,483,1.150411000,0.0000
218.233.211.196,<->,8.220.202.4,0,0,1,81,1,81,1.150030000,0.0000
215.158.238.176,<->,131.144.116.5,1,1357,0,0,1,1357,1.149834000,0.0000
215.158.42.21,<->,136.25.189.221,0,0,1,405,1,405,1.149438000,0.0000
136.25.188.160,<->,57.199.250.196,1,1325,0,0,1,1325,1.149113000,0.0000
159.80.141.193,<->,8.252.223.143,0,0,1,1025,1,1025,1.149071000,0.0000
215.158.238.133,<->,80.47.111.75,1,1277,0,0,1,1277,1.148824000,0.0000
215.158.238.107,<->,128.69.139.73,1,1117,0,0,1,1117,1.148582000,0.0000
210.157.223.1,<->,50.224.80.67,0,0,1,415,1,415,1.148275000,0.0000
111.147.216.130,<->,53.148.22.112,1,125,0,0,1,125,1.148070000,0.0000
129.26.243.201,<->,112.208.20.140,1,163,0,0,1,163,1.148039000,0.0000
215.158.61.193,<->,8.176.8.84,0,0,1,319,1,319,1.147911000,0.0000
231.142.252.181,<->,136.25.188.209,0,0,1,93,1,93,1.147897000,0.0000
136.25.189.19,<->,131.144.113.60,1,1229,0,0,1,1229,1.147396000,0.0000
136.25.189.57,<->,133.146.0.88,1,1373,0,0,1,1373,1.147257000,0.0000
149.128.96.82,<->,133.178.226.76,0,0,1,93,1,93,1.146962000,0.0000
136.25.188.222,<->,80.47.111.87,1,93,0,0,1,93,1.146526000,0.0000
215.158.238.198,<->,192.224.20.234,1,1084,0,0,1,1084,1.146336000,0.0000
192.67.140.203,<->,93.170.135.84,1,469,0,0,1,469,1.146284000,0.0000
215.158.140.11,<->,215.158.61.145,1,285,0,0,1,285,1.146032000,0.0000
149.29.174.76,<->,50.224.76.234,0,0,1,669,1,669,1.145509000,0.0000
215.158.238.95,<->,212.70.75.25,1,1101,0,0,1,1101,1.144712000,0.0000
215.158.239.59,<->,135.228.221.201,1,1373,0,0,1,1373,1.144670000,0.0000
56.121.53.122,<->,17.199.155.30,1,435,0,0,1,435,1.143960000,0.0000
89.183.108.72,<->,78.48.0.51,1,50,0,0,1,50,1.143638000,0.0000
215.158.239.56,<->,199.82.189.142,1,749,0,0,1,749,1.143521000,0.0000
136.25.189.139,<->,111.151.109.20,1,100,0,0,1,100,1.143205000,0.0000
139.148.142.187,<->,8.52.189.173,0,0,1,336,1,336,1.143057000,0.0000
235.42.34.40,<->,215.158.238.67,0,0,1,1277,1,1277,1.142295000,0.0000
246.253.253.101,<->,54.37.162.116,1,794,0,0,1,794,1.142192000,0.0000
204.3.40.131,<->,136.25.188.174,0,0,1,93,1,93,1.142162000,0.0000
195.215.92.47,<->,50.223.3.228,0,0,1,271,1,271,1.142055000,0.0000
215.158.238.73,<->,27.178.41.49,1,1213,0,0,1,1213,1.141927000,0.0000
215.158.140.60,<->,8.50.171.255,1,1061,0,0,1,1061,1.141744000,0.0000
215.158.238.45,<->,116.99.180.232,1,1309,0,0,1,1309,1.141535000,0.0000
215.158.238.105,<->,199.69.87.93,1,1325,0,0,1,1325,1.141224000,0.0000
215.158.238.220,<->,113.207.62.36,1,1104,0,0,1,1104,1.141040000,0.0000
99.175.119.241,<->,53.149.30.218,1,125,0,0,1,125,1.140836000,0.0000
220.183.137.190,<->,92.27.219.191,0,0,1,736,1,736,1.140794000,0.0000
215.158.239.41,<->,122.159.245.172,1,108,0,0,1,108,1.140296000,0.0000
136.25.189.88,<->,29.209.59.213,1,1277,0,0,1,1277,1.139964000,0.0000
215.158.238.142,<->,100.224.138.248,1,133,0,0,1,133,1.139840000,0.0000
142.221.253.237,<->,136.25.188.45,0,0,1,561,1,561,1.139821000,0.0000
111.199.238.96,<->,0.195.210.33,0,0,1,374,1,374,1.139753000,0.0000
246.254.97.104,<->,210.231.140.55,1,884,0,0,1,884,1.139750000,0.0000
50.224.76.230,<->,0.246.227.151,1,1253,0,0,1,1253,1.138795000,0.0000
220.39.29.160,<->,215.158.239.120,0,0,1,144,1,144,1.138794000,0.0000
136.139.59.106,<->,136.25.188.210,0,0,1,1117,1,1117,1.138652000,0.0000
144.86.151.244,<->,92.162.221.160,1,499,0,0,1,499,1.138597000,0.0000
136.139.59.106,<->,136.25.188.253,0,0,1,1261,1,1261,1.138507000,0.0000
195.42.108.172,<->,136.25.188.243,0,0,1,93,1,93,1.138435000,0.0000
215.158.239.78,<->,195.55.11.216,1,87,0,0,1,87,1.138229000,0.0000
215.158.239.30,<->,113.93.9.37,1,1460,0,0,1,1460,1.138144000,0.0000
215.158.239.76,<->,199.20.31.9,1,765,0,0,1,765,1.137408000,0.0000
136.181.42.3,<->,91.40.231.175,1,125,0,0,1,125,1.137122000,0.0000
199.121.86.116,<->,136.25.188.178,0,0,1,85,1,85,1.137024000,0.0000
215.158.239.28,<->,98.166.239.60,1,1459,0,0,1,1459,1.136965000,0.0000
136.181.42.3,<->,8.49.69.216,1,141,0,0,1,141,1.136933000,0.0000
107.10.183.170,<->,8.52.171.120,0,0,1,657,1,657,1.136812000,0.0000
221.102.143.189,<->,220.80.213.14,0,0,1,141,1,141,1.136773000,0.0000
136.25.188.197,<->,57.199.250.213,1,1357,0,0,1,1357,1.136688000,0.0000
215.158.239.33,<->,126.219.142.149,1,1481,0,0,1,1481,1.136360000,0.0000
133.178.227.79,<->,122.216.233.124,1,1041,0,0,1,1041,1.136267000,0.0000
109.222.252.122,<->,53.231.158.110,1,511,0,0,1,511,1.136154000,0.0000
215.158.238.220,<->,156.165.37.94,1,1043,0,0,1,1043,1.136049000,0.0000
134.160.217.145,<->,92.27.219.61,0,0,1,599,1,599,1.135999000,0.0000
117.131.109.97,<->,92.27.27.165,0,0,1,321,1,321,1.135939000,0.0000
136.25.189.33,<->,57.4.201.182,1,1165,0,0,1,1165,1.135631000,0.0000
215.158.238.53,<->,8.222.109.108,1,1309,0,0,1,1309,1.135353000,0.0000
239.66.109.147,<->,220.55.72.216,0,0,1,419,1,419,1.135316000,0.0000
139.193.141.139,<->,127.106.135.213,1,311,0,0,1,311,1.135050000,0.0000
197.113.99.169,<->,136.25.188.226,0,0,1,93,1,93,1.134982000,0.0000
215.158.238.106,<->,8.191.10.86,1,213,0,0,1,213,1.134977000,0.0000
133.178.226.61,<->,29.214.108.148,1,1037,0,0,1,1037,1.134513000,0.0000
133.178.226.227,<->,122.158.206.246,1,282,0,0,1,282,1.134355000,0.0000
26.223.52.82,<->,8.220.179.94,0,0,1,849,1,849,1.134174000,0.0000
220.20.200.141,<->,144.83.60.153,1,643,0,0,1,643,1.134173000,0.0000
144.87.238.89,<->,8.182.136.146,0,0,1,517,1,517,1.133402000,0.0000
141.172.209.250,<->,8.252.221.230,0,0,1,494,1,494,1.132497000,0.0000
111.150.207.54,<->,97.126.31.66,0,0,1,100,1,100,1.132255000,0.0000
215.158.238.123,<->,112.70.164.59,1,1117,0,0,1,1117,1.132078000,0.0000
249.62.176.61,<->,215.158.239.234,0,0,1,777,1,777,1.132014000,0.0000
91.221.139.249,<->,8.252.223.228,0,0,1,238,1,238,1.131950000,0.0000
102.231.186.190,<->,8.49.69.216,1,141,0,0,1,141,1.131909000,0.0000
215.158.239.96,<->,199.20.31.248,1,172,0,0,1,172,1.131717000,0.0000
136.25.189.55,<->,96.156.169.165,1,1269,0,0,1,1269,1.131714000,0.0000
202.178.8.69,<->,144.64.139.43,0,0,1,300,1,300,1.130867000,0.0000
215.158.239.76,<->,199.82.190.234,1,93,0,0,1,93,1.130751000,0.0000
215.158.239.49,<->,196.92.93.217,1,765,0,0,1,765,1.130599000,0.0000
215.202.174.56,<->,215.158.239.97,0,0,1,1117,1,1117,1.130425000,0.0000
220.39.233.208,<->,136.25.188.46,0,0,1,1438,1,1438,1.130420000,0.0000
144.74.132.71,<->,50.224.76.235,0,0,1,1020,1,1020,1.130289000,0.0000
215.158.238.196,<->,149.163.129.232,1,1389,0,0,1,1389,1.130200000,0.0000
143.79.216.80,<->,136.25.188.46,0,0,1,93,1,93,1.130196000,0.0000
215.158.238.95,<->,201.211.113.163,1,1165,0,0,1,1165,1.129690000,0.0000
215.158.239.50,<->,207.59.172.221,1,87,0,0,1,87,1.129612000,0.0000
50.224.76.235,<->,50.163.8.133,1,1175,0,0,1,1175,1.129492000,0.0000
143.89.63.84,<->,136.25.188.176,0,0,1,282,1,282,1.129454000,0.0000
215.158.61.183,<->,8.176.8.210,0,0,1,429,1,429,1.129358000,0.0000
100.228.42.160,<->,56.109.10.125,1,709,0,0,1,709,1.129218000,0.0000
220.55.98.90,<->,197.158.1.206,1,490,0,0,1,490,1.128881000,0.0000
215.158.140.177,<->,6.15.196.203,1,993,0,0,1,993,1.128530000,0.0000
143.155.227.59,<->,136.25.188.209,0,0,1,264,1,264,1.128486000,0.0000
133.178.227.1,<->,8.222.6.193,1,989,0,0,1,989,1.128356000,0.0000
133.178.226.234,<->,56.1.238.231,1,740,0,0,1,740,1.128328000,0.0000
207.61.126.116,<->,136.25.188.55,0,0,1,593,1,593,1.128288000,0.0000
220.39.233.201,<->,215.158.238.115,0,0,1,1277,1,1277,1.128029000,0.0000
215.158.140.76,<->,131.1.194.203,1,1041,0,0,1,1041,1.128019000,0.0000
215.158.239.101,<->,129.222.39.116,1,820,0,0,1,820,1.127925000,0.0000
6.145.164.0,<->,0.195.210.44,0,0,1,182,1,182,1.127630000,0.0000
215.158.238.67,<->,38.104.11.106,1,1005,0,0,1,1005,1.127545000,0.0000
207.172.154.164,<->,136.25.188.177,0,0,1,475,1,475,1.127414000,0.0000
136.25.188.47,<->,8.42.43.66,1,1341,0,0,1,1341,1.127384000,0.0000
136.25.188.208,<->,122.159.245.165,1,1133,0,0,1,1133,1.127263000,0.0000
215.158.238.92,<->,192.226.44.91,1,1229,0,0,1,1229,1.127150000,0.0000
207.62.106.96,<->,136.25.188.198,0,0,1,591,1,591,1.126734000,0.0000
118.66.41.107,<->,50.224.76.235,0,0,1,70,1,70,1.126663000,0.0000
215.158.239.18,<->,29.211.5.201,1,1472,0,0,1,1472,1.126636000,0.0000
144.83.60.153,<->,92.162.253.96,0,0,1,994,1,994,1.126611000,0.0000
199.121.171.120,<->,136.25.188.241,0,0,1,673,1,673,1.126487000,0.0000
129.175.139.161,<->,67.174.33.137,0,0,1,381,1,381,1.126426000,0.0000
215.158.239.41,<->,149.96.60.11,1,1453,0,0,1,1453,1.126416000,0.0000
254.126.121.12,<->,100.94.188.60,0,0,1,75,1,75,1.125966000,0.0000
215.158.238.239,<->,8.219.186.187,1,1229,0,0,1,1229,1.125836000,0.0000
136.25.189.19,<->,8.252.214.230,1,1177,0,0,1,1177,1.125720000,0.0000
215.158.239.71,<->,113.23.66.197,1,1373,0,0,1,1373,1.125377000,0.0000
221.102.56.69,<->,6.74.97.41,0,0,1,294,1,294,1.124285000,0.0000
136.25.189.36,<->,100.216.78.145,1,1064,0,0,1,1064,1.124264000,0.0000
195.124.209.136,<->,136.25.188.253,0,0,1,149,1,149,1.123909000,0.0000
139.163.26.146,<->,110.243.138.180,1,99,0,0,1,99,1.123669000,0.0000
137.129.3.188,<->,58.43.188.12,1,479,0,0,1,479,1.123484000,0.0000
143.79.26.245,<->,136.25.188.242,0,0,1,577,1,577,1.123420000,0.0000
252.98.138.108,<->,159.112.9.198,1,81,0,0,1,81,1.123235000,0.0000
210.220.219.153,<->,91.41.85.245,1,446,0,0,1,446,1.122730000,0.0000
133.178.227.24,<->,111.150.187.231,1,1088,0,0,1,1088,1.122722000,0.0000
215.158.238.133,<->,113.23.14.165,1,1245,0,0,1,1245,1.121928000,0.0000
33.98.183.45,<->,8.20.87.153,0,0,1,1138,1,1138,1.121781000,0.0000
199.71.14.17,<->,136.25.188.54,0,0,1,269,1,269,1.121623000,0.0000
139.193.141.139,<->,119.45.23.69,1,562,0,0,1,562,1.120678000,0.0000
142.207.218.88,<->,136.25.188.176,0,0,1,170,1,170,1.120519000,0.0000
136.25.189.31,<->,29.209.59.215,1,1277,0,0,1,1277,1.119997000,0.0000
133.178.227.57,<->,106.188.253.166,1,1044,0,0,1,1044,1.119798000,0.0000
132.216.20.184,<->,80.40.56.122,0,0,1,87,1,87,1.119472000,0.0000
248.239.129.134,<->,231.255.222.140,1,207,0,0,1,207,1.119423000,0.0000
133.178.226.160,<->,111.151.142.233,1,100,0,0,1,100,1.119320000,0.0000
241.180.252.231,<->,92.27.27.175,0,0,1,1412,1,1412,1.119207000,0.0000
215.158.239.86,<->,202.107.204.42,1,1149,0,0,1,1149,1.118984000,0.0000
101.238.103.211,<->,8.55.221.148,1,81,0,0,1,81,1.118342000,0.0000
195.13.84.248,<->,136.25.188.222,0,0,1,269,1,269,1.118311000,0.0000
136.25.189.81,<->,131.6.152.4,1,1197,0,0,1,1197,1.118256000,0.0000
215.158.239.227,<->,53.245.246.122,1,1133,0,0,1,1133,1.118232000,0.0000
8.182.136.81,<->,6.242.51.21,1,391,0,0,1,391,1.118105000,0.0000
220.55.119.126,<->,198.146.28.33,1,446,0,0,1,446,1.117864000,0.0000
136.25.188.242,<->,30.73.149.65,1,577,0,0,1,577,1.117706000,0.0000
221.102.143.189,<->,6.73.198.167,0,0,1,141,1,141,1.117472000,0.0000
80.27.155.117,<->,56.7.53.161,1,641,0,0,1,641,1.117299000,0.0000
131.45.239.178,<->,92.162.253.34,0,0,1,338,1,338,1.117069000,0.0000
213.186.59.248,<->,139.163.17.164,0,0,1,442,1,442,1.116608000,0.0000
249.101.95.241,<->,54.53.120.141,1,125,0,0,1,125,1.116448000,0.0000
204.200.48.116,<->,136.25.188.178,0,0,1,95,1,95,1.115861000,0.0000
210.229.227.19,<->,145.208.183.77,0,0,1,68,1,68,1.115595000,0.0000
143.76.154.165,<->,8.182.252.44,0,0,1,665,1,665,1.115413000,0.0000
129.92.117.26,<->,53.240.94.87,1,418,0,0,1,418,1.115359000,0.0000
215.158.140.241,<->,131.2.115.212,1,1052,0,0,1,1052,1.115135000,0.0000
215.158.239.68,<->,204.58.217.55,1,653,0,0,1,653,1.114867000,0.0000
139.163.26.146,<->,117.45.143.145,1,111,0,0,1,111,1.114687000,0.0000
111.150.207.202,<->,8.176.8.102,0,0,1,100,1,100,1.114532000,0.0000
159.137.152.183,<->,133.178.226.212,0,0,1,334,1,334,1.114093000,0.0000
133.178.227.16,<->,104.3.168.148,1,1085,0,0,1,1085,1.114023000,0.0000
50.224.76.235,<->,29.211.4.107,1,780,0,0,1,780,1.113705000,0.0000
104.246.207.98,<->,50.224.76.234,0,0,1,1407,1,1407,1.113337000,0.0000
231.140.94.203,<->,136.25.188.45,0,0,1,141,1,141,1.113230000,0.0000
215.158.238.223,<->,72.23.148.249,1,1437,0,0,1,1437,1.113194000,0.0000
229.45.205.24,<->,124.148.1.107,1,213,0,0,1,213,1.113139000,0.0000
215.158.238.133,<->,29.209.4.26,1,1069,0,0,1,1069,1.113089000,0.0000
97.22.63.90,<->,8.182.226.78,0,0,1,641,1,641,1.112980000,0.0000
248.225.31.77,<->,53.240.233.79,1,477,0,0,1,477,1.112769000,0.0000
215.158.239.87,<->,199.69.190.94,1,625,0,0,1,625,1.112602000,0.0000
229.61.97.86,<->,192.67.182.48,0,0,1,61,1,61,1.112476000,0.0000
109.222.213.25,<->,54.48.24.50,1,75,0,0,1,75,1.112344000,0.0000
208.68.192.15,<->,8.182.224.87,0,0,1,1008,1,1008,1.112200000,0.0000
195.14.142.88,<->,136.25.188.236,0,0,1,101,1,101,1.112139000,0.0000
204.184.208.155,<->,136.25.188.241,0,0,1,172,1,172,1.111980000,0.0000
129.236.115.34,<->,111.20.168.123,0,0,1,690,1,690,1.111788000,0.0000
195.68.93.177,<->,136.25.188.220,0,0,1,602,1,602,1.111777000,0.0000
97.199.145.69,<->,54.37.145.129,1,524,0,0,1,524,1.111694000,0.0000
202.33.232.35,<->,136.25.188.236,0,0,1,859,1,859,1.110623000,0.0000
158.192.3.236,<->,136.25.188.160,0,0,1,1357,1,1357,1.110463000,0.0000
142.228.14.111,<->,136.25.188.162,0,0,1,593,1,593,1.109603000,0.0000
215.158.238.141,<->,131.144.113.180,1,1261,0,0,1,1261,1.109414000,0.0000
136.181.46.177,<->,50.238.245.100,1,87,0,0,1,87,1.109258000,0.0000
215.158.239.95,<->,199.32.175.22,1,602,0,0,1,602,1.108940000,0.0000
192.226.161.17,<->,133.178.226.29,0,0,1,1197,1,1197,1.108919000,0.0000
111.147.191.165,<->,54.69.101.127,1,125,0,0,1,125,1.108735000,0.0000
99.162.77.146,<->,53.161.230.230,1,285,0,0,1,285,1.108520000,0.0000
133.178.227.40,<->,72.23.148.232,1,1046,0,0,1,1046,1.108455000,0.0000
197.107.3.206,<->,136.25.188.238,0,0,1,132,1,132,1.108257000,0.0000
213.186.52.66,<->,144.85.170.208,0,0,1,726,1,726,1.108117000,0.0000
35.56.16.129,<->,8.182.224.87,0,0,1,1296,1,1296,1.108089000,0.0000
143.155.227.59,<->,133.178.226.38,0,0,1,93,1,93,1.107624000,0.0000
207.8.14.35,<->,8.252.222.222,0,0,1,765,1,765,1.107479000,0.0000
220.39.174.124,<->,215.158.238.209,0,0,1,1121,1,1121,1.107147000,0.0000
108.134.126.133,<->,100.206.91.45,1,367,0,0,1,367,1.106835000,0.0000
111.150.207.51,<->,8.252.223.67,0,0,1,100,1,100,1.106354000,0.0000
146.249.226.104,<->,8.252.222.157,0,0,1,93,1,93,1.106347000,0.0000
101.70.107.178,<->,54.52.48.70,1,88,0,0,1,88,1.106144000,0.0000
53.213.200.116,<->,48.53.37.167,0,0,1,93,1,93,1.105970000,0.0000
207.191.153.44,<->,136.25.188.255,0,0,1,240,1,240,1.105962000,0.0000
206.51.47.69,<->,192.64.217.166,0,0,1,112,1,112,1.105817000,0.0000
215.158.239.95,<->,199.69.190.94,1,625,0,0,1,625,1.105781000,0.0000
220.39.202.203,<->,215.158.238.105,0,0,1,149,1,149,1.105654000,0.0000
215.158.238.123,<->,29.214.69.5,1,1197,0,0,1,1197,1.105298000,0.0000
111.20.168.13,<->,54.37.219.162,1,97,0,0,1,97,1.105265000,0.0000
195.126.25.205,<->,136.25.188.236,0,0,1,93,1,93,1.104843000,0.0000
195.85.180.83,<->,8.182.229.19,0,0,1,262,1,262,1.104815000,0.0000
136.25.189.4,<->,96.156.169.227,1,1072,0,0,1,1072,1.104778000,0.0000
133.178.226.214,<->,29.211.199.33,1,145,0,0,1,145,1.104757000,0.0000
215.158.239.18,<->,215.158.42.96,1,1165,0,0,1,1165,1.104171000,0.0000
133.54.43.38,<->,117.24.150.38,1,777,0,0,1,777,1.103925000,0.0000
94.108.46.88,<->,0.195.210.46,0,0,1,272,1,272,1.103747000,0.0000
215.158.239.51,<->,196.106.156.210,1,240,0,0,1,240,1.103385000,0.0000
136.25.188.176,<->,131.1.253.244,1,1357,0,0,1,1357,1.101953000,0.0000
243.117.93.112,<->,80.38.36.175,0,0,1,1363,1,1363,1.101832000,0.0000
205.127.108.113,<->,33.233.141.75,0,0,1,83,1,83,1.101028000,0.0000
101.70.127.164,<->,53.209.248.108,1,771,0,0,1,771,1.100947000,0.0000
215.158.238.148,<->,118.20.114.86,1,1213,0,0,1,1213,1.100899000,0.0000
133.178.227.2,<->,80.57.141.65,1,1133,0,0,1,1133,1.100866000,0.0000
210.229.230.18,<->,108.165.142.247,1,68,0,0,1,68,1.100826000,0.0000
215.158.127.28,<->,136.25.188.37,0,0,1,738,1,738,1.100770000,0.0000
221.102.56.69,<->,192.65.241.179,0,0,1,294,1,294,1.100713000,0.0000
210.229.230.22,<->,98.178.105.18,1,68,0,0,1,68,1.100650000,0.0000
215.158.61.191,<->,8.176.8.236,0,0,1,861,1,861,1.100599000,0.0000
215.158.238.176,<->,119.196.23.10,1,1043,0,0,1,1043,1.100539000,0.0000
136.25.189.31,<->,119.196.23.21,1,1341,0,0,1,1341,1.100038000,0.0000
136.25.188.237,<->,57.160.181.203,1,1277,0,0,1,1277,1.100014000,0.0000
215.158.239.35,<->,8.222.97.69,1,95,0,0,1,95,1.099842000,0.0000
215.158.61.222,<->,8.252.222.246,0,0,1,360,1,360,1.099836000,0.0000
95.246.172.42,<->,8.252.221.223,0,0,1,320,1,320,1.099377000,0.0000
133.178.227.19,<->,29.214.211.55,1,1032,0,0,1,1032,1.098052000,0.0000
136.25.188.224,<->,113.23.104.246,1,93,0,0,1,93,1.097668000,0.0000
92.27.27.158,<->,84.10.176.198,1,599,0,0,1,599,1.097247000,0.0000
215.158.238.91,<->,56.19.241.59,1,264,0,0,1,264,1.096243000,0.0000
143.155.227.54,<->,136.25.188.211,0,0,1,1373,1,1373,1.096139000,0.0000
215.158.239.79,<->,204.2.2.173,1,282,0,0,1,282,1.095921000,0.0000
192.228.80.165,<->,133.32.39.1,0,0,1,247,1,247,1.095774000,0.0000
215.158.239.57,<->,199.20.30.163,1,93,0,0,1,93,1.095770000,0.0000
215.158.61.189,<->,136.25.189.196,0,0,1,1149,1,1149,1.095602000,0.0000
136.25.189.12,<->,120.155.8.71,1,245,0,0,1,245,1.095512000,0.0000
205.227.96.8,<->,136.25.189.88,0,0,1,1213,1,1213,1.095271000,0.0000
146.193.75.8,<->,8.252.221.236,0,0,1,454,1,454,1.095096000,0.0000
252.64.251.36,<->,80.27.157.123,0,0,1,257,1,257,1.094723000,0.0000
215.158.61.202,<->,136.25.188.36,0,0,1,397,1,397,1.094549000,0.0000
159.240.4.24,<->,8.20.87.92,0,0,1,92,1,92,1.094520000,0.0000
195.54.56.6,<->,136.25.188.236,0,0,1,712,1,712,1.094105000,0.0000
193.53.171.164,<->,144.64.139.133,0,0,1,200,1,200,1.094067000,0.0000
137.194.151.102,<->,50.224.76.235,0,0,1,259,1,259,1.093541000,0.0000
215.158.238.67,<->,106.188.183.87,1,1399,0,0,1,1399,1.093482000,0.0000
199.73.176.81,<->,136.25.188.52,0,0,1,93,1,93,1.093443000,0.0000
215.158.238.133,<->,96.38.231.165,1,1117,0,0,1,1117,1.093135000,0.0000
215.202.174.59,<->,136.25.189.59,0,0,1,1213,1,1213,1.093032000,0.0000
204.200.42.226,<->,136.25.188.178,0,0,1,653,1,653,1.092805000,0.0000
251.24.86.2,<->,8.252.222.239,0,0,1,87,1,87,1.092781000,0.0000
215.158.238.32,<->,57.227.77.108,1,1165,0,0,1,1165,1.092066000,0.0000
50.224.76.235,<->,48.129.148.191,1,1138,0,0,1,1138,1.092062000,0.0000
215.158.239.182,<->,80.47.161.166,1,753,0,0,1,753,1.091983000,0.0000
136.25.189.82,<->,120.154.131.22,1,1357,0,0,1,1357,1.091981000,0.0000
215.158.239.57,<->,119.196.23.22,1,1085,0,0,1,1085,1.091179000,0.0000
80.40.63.6,<->,22.36.147.6,1,113,0,0,1,113,1.090674000,0.0000
213.186.52.118,<->,144.85.170.208,0,0,1,436,1,436,1.090149000,0.0000
89.181.225.9,<->,58.128.248.29,1,245,0,0,1,245,1.090056000,0.0000
221.102.56.69,<->,98.128.109.60,0,0,1,294,1,294,1.090023000,0.0000
205.127.108.113,<->,101.224.89.186,0,0,1,83,1,83,1.089986000,0.0000
133.178.226.29,<->,42.226.3.118,1,1261,0,0,1,1261,1.089296000,0.0000
8.220.185.20,<->,6.101.98.202,1,689,0,0,1,689,1.089127000,0.0000
209.91.207.218,<->,8.53.11.187,0,0,1,463,1,463,1.089101000,0.0000
158.157.1.198,<->,133.54.43.80,0,0,1,634,1,634,1.088585000,0.0000
93.181.154.23,<->,92.27.219.243,0,0,1,50,1,50,1.088016000,0.0000
144.85.170.208,<->,91.69.181.137,1,451,0,0,1,451,1.087779000,0.0000
136.25.188.174,<->,56.161.218.52,1,1149,0,0,1,1149,1.087757000,0.0000
215.158.61.145,<->,8.176.8.225,0,0,1,657,1,657,1.087505000,0.0000
195.126.60.209,<->,136.25.188.53,0,0,1,263,1,263,1.087430000,0.0000
92.30.203.218,<->,8.220.184.162,0,0,1,481,1,481,1.087275000,0.0000
205.175.197.160,<->,139.163.68.55,0,0,1,63,1,63,1.086933000,0.0000
143.94.97.133,<->,50.224.76.230,0,0,1,1110,1,1110,1.086882000,0.0000
210.229.230.22,<->,130.19.167.229,1,80,0,0,1,80,1.086854000,0.0000
215.158.238.45,<->,33.209.219.8,1,1005,0,0,1,1005,1.086247000,0.0000
247.152.220.29,<->,50.224.76.235,0,0,1,95,1,95,1.086086000,0.0000
215.158.239.56,<->,199.20.28.57,1,910,0,0,1,910,1.085738000,0.0000
204.187.117.251,<->,136.25.188.227,0,0,1,602,1,602,1.085536000,0.0000
92.27.209.249,<->,53.157.11.198,1,209,0,0,1,209,1.085325000,0.0000
104.230.210.45,<->,50.224.76.234,0,0,1,1030,1,1030,1.084917000,0.0000
195.68.204.193,<->,136.25.188.242,0,0,1,113,1,113,1.083940000,0.0000
215.158.239.86,<->,57.236.82.251,1,181,0,0,1,181,1.083777000,0.0000
107.253.12.221,<->,8.182.251.218,0,0,1,450,1,450,1.083737000,0.0000
139.163.26.146,<->,6.72.204.164,1,111,0,0,1,111,1.083630000,0.0000
136.25.189.18,<->,57.227.83.183,1,1357,0,0,1,1357,1.083240000,0.0000
215.158.238.25,<->,148.21.212.232,1,1469,0,0,1,1469,1.083043000,0.0000
197.113.64.237,<->,136.25.188.220,0,0,1,101,1,101,1.082738000,0.0000
80.40.63.6,<->,8.45.168.98,1,129,0,0,1,129,1.082647000,0.0000
144.85.170.208,<->,91.69.181.159,1,769,0,0,1,769,1.082266000,0.0000
201.192.55.103,<->,80.38.21.161,0,0,1,271,1,271,1.082173000,0.0000
215.158.61.202,<->,8.176.8.225,0,0,1,1501,1,1501,1.081754000,0.0000
215.158.238.96,<->,29.214.71.87,1,1165,0,0,1,1165,1.081539000,0.0000
136.25.189.14,<->,98.166.239.34,1,1453,0,0,1,1453,1.081524000,0.0000
215.158.140.83,<->,8.57.163.141,1,1163,0,0,1,1163,1.081464000,0.0000
76.179.26.127,<->,8.252.221.221,0,0,1,819,1,819,1.081458000,0.0000
143.173.13.198,<->,133.178.227.41,0,0,1,1405,1,1405,1.081187000,0.0000
133.178.227.24,<->,126.219.60.234,1,1261,0,0,1,1261,1.080675000,0.0000
111.150.187.196,<->,8.252.223.176,0,0,1,1051,1,1051,1.080319000,0.0000
197.198.41.118,<->,0.195.210.46,0,0,1,1198,1,1198,1.080216000,0.0000
215.158.61.203,<->,8.176.8.199,0,0,1,885,1,885,1.080185000,0.0000
133.178.226.225,<->,106.188.226.66,1,94,0,0,1,94,1.079990000,0.0000
139.79.68.159,<->,8.220.176.253,0,0,1,274,1,274,1.079286000,0.0000
159.133.57.200,<->,56.0.39.108,1,92,0,0,1,92,1.079163000,0.0000
215.158.238.93,<->,106.188.251.222,1,1222,0,0,1,1222,1.078746000,0.0000
50.224.76.248,<->,6.75.72.161,1,481,0,0,1,481,1.078500000,0.0000
140.218.109.36,<->,136.25.188.242,0,0,1,1165,1,1165,1.078397000,0.0000
215.158.238.79,<->,139.163.161.34,1,505,0,0,1,505,1.078049000,0.0000
231.140.186.73,<->,215.158.239.51,0,0,1,624,1,624,1.077827000,0.0000
246.253.217.210,<->,130.77.96.33,1,618,0,0,1,618,1.077681000,0.0000
142.206.165.64,<->,136.25.188.236,0,0,1,87,1,87,1.077270000,0.0000
144.87.238.91,<->,8.252.221.171,0,0,1,103,1,103,1.077250000,0.0000
139.163.96.127,<->,89.220.203.245,1,50,0,0,1,50,1.077184000,0.0000
145.242.126.139,<->,53.94.218.235,1,604,0,0,1,604,1.076871000,0.0000
215.158.238.215,<->,215.158.132.240,1,436,0,0,1,436,1.075711000,0.0000
142.240.51.65,<->,136.25.188.222,0,0,1,93,1,93,1.075700000,0.0000
133.178.226.7,<->,125.216.33.131,1,1341,0,0,1,1341,1.075639000,0.0000
215.158.238.75,<->,113.23.117.95,1,1293,0,0,1,1293,1.075591000,0.0000
133.178.227.27,<->,133.56.180.11,1,85,0,0,1,85,1.074943000,0.0000
97.126.17.147,<->,54.92.217.131,1,118,0,0,1,118,1.074783000,0.0000
133.178.227.138,<->,80.47.104.32,1,1162,0,0,1,1162,1.074506000,0.0000
199.73.240.168,<->,92.27.194.147,0,0,1,246,1,246,1.074395000,0.0000
89.204.94.77,<->,8.182.224.87,0,0,1,1265,1,1265,1.074234000,0.0000
220.28.65.9,<->,136.25.189.27,0,0,1,783,1,783,1.074176000,0.0000
111.150.207.99,<->,99.74.26.110,0,0,1,100,1,100,1.073822000,0.0000
215.158.238.66,<->,98.166.239.42,1,1373,0,0,1,1373,1.073768000,0.0000
215.158.238.188,<->,148.21.212.227,1,1084,0,0,1,1084,1.073747000,0.0000
215.158.140.229,<->,8.220.54.107,1,1085,0,0,1,1085,1.073307000,0.0000
215.158.238.243,<->,192.204.170.235,1,1045,0,0,1,1045,1.073252000,0.0000
251.24.86.2,<->,8.252.222.148,0,0,1,750,1,750,1.073225000,0.0000
215.158.239.146,<->,111.151.237.153,1,538,0,0,1,538,1.072967000,0.0000
215.158.238.107,<->,111.150.186.175,1,1341,0,0,1,1341,1.072863000,0.0000
215.158.238.241,<->,8.42.42.108,1,1229,0,0,1,1229,1.072777000,0.0000
136.25.189.29,<->,29.214.108.245,1,1229,0,0,1,1229,1.072350000,0.0000
133.178.227.57,<->,112.93.136.105,1,1068,0,0,1,1068,1.072085000,0.0000
92.27.117.27,<->,89.183.107.0,0,0,1,109,1,109,1.071851000,0.0000
215.158.238.72,<->,143.155.227.33,1,190,0,0,1,190,1.071673000,0.0000
199.55.114.51,<->,8.182.235.164,0,0,1,538,1,538,1.071310000,0.0000
20.192.240.91,<->,0.195.209.34,1,128,0,0,1,128,1.070632000,0.0000
194.211.72.44,<->,8.52.168.63,0,0,1,259,1,259,1.070221000,0.0000
142.166.6.171,<->,136.25.188.220,0,0,1,616,1,616,1.070183000,0.0000
133.178.226.233,<->,115.162.222.164,1,152,0,0,1,152,1.069539000,0.0000
195.71.54.116,<->,136.25.188.255,0,0,1,95,1,95,1.069520000,0.0000
111.146.144.47,<->,54.39.180.173,1,125,0,0,1,125,1.069088000,0.0000
235.253.220.216,<->,215.158.238.196,0,0,1,1232,1,1232,1.069067000,0.0000
143.10.249.236,<->,136.25.188.55,0,0,1,866,1,866,1.068771000,0.0000
195.68.58.47,<->,136.25.188.211,0,0,1,602,1,602,1.068428000,0.0000
192.67.130.147,<->,8.20.81.7,1,260,0,0,1,260,1.067866000,0.0000
220.20.200.248,<->,118.45.59.45,1,670,0,0,1,670,1.067614000,0.0000
215.158.238.143,<->,113.23.104.215,1,1133,0,0,1,1133,1.067308000,0.0000
136.25.189.86,<->,96.156.169.209,1,972,0,0,1,972,1.067230000,0.0000
138.121.99.24,<->,8.52.175.13,0,0,1,125,1,125,1.066937000,0.0000
204.35.186.89,<->,50.223.3.228,0,0,1,218,1,218,1.066921000,0.0000
50.224.76.235,<->,4.129.153.247,1,195,0,0,1,195,1.066702000,0.0000
133.178.227.2,<->,80.57.141.55,1,1269,0,0,1,1269,1.066681000,0.0000
136.25.188.45,<->,72.23.179.39,1,1165,0,0,1,1165,1.066575000,0.0000
215.158.140.8,<->,96.156.169.127,1,557,0,0,1,557,1.066484000,0.0000
48.18.147.158,<->,8.252.221.197,0,0,1,390,1,390,1.066345000,0.0000
210.209.251.211,<->,101.70.96.205,0,0,1,516,1,516,1.066031000,0.0000
220.82.56.122,<->,132.128.61.93,1,302,0,0,1,302,1.066020000,0.0000
136.25.189.29,<->,57.31.50.218,1,1213,0,0,1,1213,1.065792000,0.0000
148.21.212.148,<->,136.25.189.32,0,0,1,1277,1,1277,1.064863000,0.0000
92.27.219.241,<->,8.44.19.122,1,1177,0,0,1,1177,1.064815000,0.0000
6.145.172.220,<->,0.195.210.44,0,0,1,87,1,87,1.064377000,0.0000
215.158.61.182,<->,8.176.8.179,0,0,1,381,1,381,1.063092000,0.0000
137.21.23.51,<->,111.150.207.51,1,100,0,0,1,100,1.062930000,0.0000
136.25.188.49,<->,0.195.253.228,1,1319,0,0,1,1319,1.062401000,0.0000
215.158.238.104,<->,139.160.226.230,1,1229,0,0,1,1229,1.062254000,0.0000
199.122.116.222,<->,136.25.188.45,0,0,1,797,1,797,1.062238000,0.0000
207.59.144.70,<->,91.231.195.125,0,0,1,110,1,110,1.062177000,0.0000
215.158.238.105,<->,143.20.121.130,1,1085,0,0,1,1085,1.062163000,0.0000
26.222.236.29,<->,8.220.177.81,0,0,1,398,1,398,1.062115000,0.0000
156.165.37.86,<->,136.25.189.82,0,0,1,1325,1,1325,1.062096000,0.0000
54.37.173.208,<->,8.228.215.157,0,0,1,394,1,394,1.062037000,0.0000
148.26.113.56,<->,136.25.189.82,0,0,1,1101,1,1101,1.061884000,0.0000
133.178.227.1,<->,106.188.228.2,1,1405,0,0,1,1405,1.061696000,0.0000
143.155.227.59,<->,136.25.188.221,0,0,1,264,1,264,1.061583000,0.0000
215.158.140.229,<->,148.190.126.41,1,1384,0,0,1,1384,1.061581000,0.0000
215.158.239.50,<->,6.73.247.53,1,1373,0,0,1,1373,1.061455000,0.0000
133.178.226.199,<->,115.162.222.218,1,145,0,0,1,145,1.061437000,0.0000
136.116.9.106,<->,50.224.80.67,0,0,1,398,1,398,1.060999000,0.0000
215.158.238.66,<->,192.228.30.102,1,1197,0,0,1,1197,1.060438000,0.0000
204.185.52.138,<->,136.25.188.252,0,0,1,87,1,87,1.060066000,0.0000
66.63.229.89,<->,8.252.221.198,0,0,1,420,1,420,1.059515000,0.0000
207.206.9.47,<->,50.224.76.235,0,0,1,1420,1,1420,1.059341000,0.0000
69.128.122.123,<->,54.59.99.218,1,1192,0,0,1,1192,1.059279000,0.0000
122.216.233.89,<->,8.252.223.153,0,0,1,1042,1,1042,1.058995000,0.0000
215.158.238.143,<->,122.216.233.246,1,1293,0,0,1,1293,1.058909000,0.0000
215.158.238.109,<->,145.116.209.92,1,506,0,0,1,506,1.058765000,0.0000
50.55.48.215,<->,8.220.191.154,0,0,1,264,1,264,1.058533000,0.0000
132.18.67.31,<->,99.74.164.54,0,0,1,350,1,350,1.058441000,0.0000
215.158.239.76,<->,204.61.75.214,1,93,0,0,1,93,1.058088000,0.0000
215.158.239.215,<->,215.158.61.243,1,399,0,0,1,399,1.057997000,0.0000
133.178.226.30,<->,61.34.184.198,1,1245,0,0,1,1245,1.057961000,0.0000
136.25.188.47,<->,120.20.132.38,1,1245,0,0,1,1245,1.057681000,0.0000
215.158.239.84,<->,142.195.246.147,1,182,0,0,1,182,1.057640000,0.0000
197.5.160.221,<->,136.25.188.224,0,0,1,1181,1,1181,1.057618000,0.0000
231.143.236.63,<->,136.25.188.220,0,0,1,234,1,234,1.057584000,0.0000
54.37.67.188,<->,48.54.84.190,0,0,1,110,1,110,1.057463000,0.0000
195.68.3.184,<->,136.25.188.252,0,0,1,602,1,602,1.057030000,0.0000
84.14.137.3,<->,8.43.215.120,0,0,1,309,1,309,1.057001000,0.0000
207.60.59.8,<->,136.25.188.220,0,0,1,717,1,717,1.056848000,0.0000
215.158.238.67,<->,112.220.206.117,1,1277,0,0,1,1277,1.056574000,0.0000
144.85.170.254,<->,98.87.146.72,1,702,0,0,1,702,1.056290000,0.0000
53.221.175.155,<->,8.30.107.52,0,0,1,125,1,125,1.055905000,0.0000
136.25.189.34,<->,96.156.169.169,1,186,0,0,1,186,1.055505000,0.0000
215.158.238.104,<->,140.174.85.72,1,293,0,0,1,293,1.055441000,0.0000
215.158.238.169,<->,80.47.184.252,1,171,0,0,1,171,1.055078000,0.0000
220.40.166.218,<->,215.158.238.140,0,0,1,1213,1,1213,1.054803000,0.0000
111.199.238.74,<->,8.182.140.228,0,0,1,738,1,738,1.054225000,0.0000
215.158.239.69,<->,199.20.4.209,1,602,0,0,1,602,1.054109000,0.0000
145.200.61.224,<->,92.162.253.62,0,0,1,393,1,393,1.053630000,0.0000
136.25.189.34,<->,8.252.253.247,1,1373,0,0,1,1373,1.053517000,0.0000
210.229.230.22,<->,109.88.195.33,1,68,0,0,1,68,1.053460000,0.0000
215.158.58.203,<->,136.25.189.213,0,0,1,93,1,93,1.053164000,0.0000
210.229.230.22,<->,91.209.206.184,1,68,0,0,1,68,1.052985000,0.0000
230.156.243.220,<->,8.252.222.158,0,0,1,89,1,89,1.052918000,0.0000
222.31.15.60,<->,215.158.238.210,0,0,1,386,1,386,1.052886000,0.0000
196.204.103.233,<->,136.25.188.177,0,0,1,765,1,765,1.052809000,0.0000
215.158.239.78,<->,195.55.155.189,1,93,0,0,1,93,1.052345000,0.0000
215.158.239.50,<->,199.20.31.34,1,422,0,0,1,422,1.052202000,0.0000
195.15.148.9,<->,136.25.188.220,0,0,1,282,1,282,1.051773000,0.0000
254.95.204.215,<->,139.193.141.139,0,0,1,224,1,224,1.051648000,0.0000
215.158.239.92,<->,195.14.225.55,1,93,0,0,1,93,1.051343000,0.0000
133.178.226.90,<->,106.188.236.158,1,1019,0,0,1,1019,1.051162000,0.0000
192.67.166.64,<->,56.114.235.120,1,194,0,0,1,194,1.050727000,0.0000
111.146.254.148,<->,53.245.233.186,1,109,0,0,1,109,1.050351000,0.0000
139.163.68.55,<->,0.97.212.203,1,51,0,0,1,51,1.050083000,0.0000
95.247.96.36,<->,8.252.221.198,0,0,1,456,1,456,1.050081000,0.0000
215.158.238.142,<->,131.36.198.50,1,1459,0,0,1,1459,1.049843000,0.0000
139.193.141.209,<->,0.34.0.84,1,536,0,0,1,536,1.049782000,0.0000
119.184.224.85,<->,109.1.24.200,0,0,1,851,1,851,1.049760000,0.0000
136.25.189.13,<->,114.166.219.8,1,1373,0,0,1,1373,1.049589000,0.0000
80.40.43.150,<->,8.209.235.29,1,553,0,0,1,553,1.049180000,0.0000
215.158.140.60,<->,201.211.113.33,1,1142,0,0,1,1142,1.049112000,0.0000
133.178.226.7,<->,131.173.115.10,1,989,0,0,1,989,1.048791000,0.0000
121.119.162.206,<->,50.224.76.248,0,0,1,336,1,336,1.048642000,0.0000
136.25.189.15,<->,29.123.209.236,1,1325,0,0,1,1325,1.048020000,0.0000
215.158.58.190,<->,99.74.145.29,0,0,1,1048,1,1048,1.047990000,0.0000
215.158.239.57,<->,199.20.31.255,1,157,0,0,1,157,1.047721000,0.0000
192.67.158.190,<->,56.13.192.154,1,801,0,0,1,801,1.047144000,0.0000
234.182.161.111,<->,97.126.31.73,0,0,1,401,1,401,1.047112000,0.0000
215.158.238.105,<->,120.154.177.197,1,1133,0,0,1,1133,1.047106000,0.0000
195.55.138.16,<->,136.25.188.175,0,0,1,653,1,653,1.046878000,0.0000
215.158.238.66,<->,118.20.101.16,1,957,0,0,1,957,1.046658000,0.0000
251.122.143.50,<->,50.224.76.234,0,0,1,801,1,801,1.046356000,0.0000
159.23.225.213,<->,33.4.134.245,1,76,0,0,1,76,1.046222000,0.0000
204.21.175.59,<->,136.25.188.178,0,0,1,260,1,260,1.046119000,0.0000
215.158.239.35,<->,149.96.50.218,1,1502,0,0,1,1502,1.045502000,0.0000
109.2.71.61,<->,92.27.5.85,1,53,0,0,1,53,1.045419000,0.0000
215.158.239.114,<->,82.112.3.187,1,261,0,0,1,261,1.044896000,0.0000
142.247.210.85,<->,136.25.188.225,0,0,1,93,1,93,1.044431000,0.0000
36.123.54.248,<->,8.20.87.10,0,0,1,97,1,97,1.044274000,0.0000
246.254.97.229,<->,132.18.67.30,1,1197,0,0,1,1197,1.043346000,0.0000
215.158.58.201,<->,99.74.27.23,0,0,1,435,1,435,1.043267000,0.0000
199.81.182.147,<->,136.25.188.52,0,0,1,93,1,93,1.043194000,0.0000
136.25.188.237,<->,118.20.87.44,1,1229,0,0,1,1229,1.042778000,0.0000
246.254.97.113,<->,158.19.152.114,1,506,0,0,1,506,1.042350000,0.0000
201.218.172.234,<->,109.222.250.107,0,0,1,119,1,119,1.042275000,0.0000
97.126.24.188,<->,53.198.157.71,1,362,0,0,1,362,1.042245000,0.0000
142.209.105.143,<->,136.25.188.175,0,0,1,259,1,259,1.042238000,0.0000
133.178.227.16,<->,80.47.152.229,1,1165,0,0,1,1165,1.042167000,0.0000
215.158.239.30,<->,69.31.238.203,1,1404,0,0,1,1404,1.041758000,0.0000
215.158.239.76,<->,196.109.46.20,1,260,0,0,1,260,1.041745000,0.0000
133.178.227.41,<->,80.57.141.43,1,1229,0,0,1,1229,1.041508000,0.0000
199.39.15.249,<->,136.25.188.178,0,0,1,781,1,781,1.041111000,0.0000
92.168.217.147,<->,0.47.218.84,1,543,0,0,1,543,1.041079000,0.0000
215.158.239.48,<->,207.57.52.88,1,894,0,0,1,894,1.040508000,0.0000
144.85.170.254,<->,91.69.185.208,1,744,0,0,1,744,1.040350000,0.0000
215.158.239.253,<->,56.97.187.116,1,289,0,0,1,289,1.039967000,0.0000
215.158.238.112,<->,98.249.65.11,1,338,0,0,1,338,1.039874000,0.0000
203.215.188.177,<->,111.151.237.20,1,269,0,0,1,269,1.039644000,0.0000
215.158.238.236,<->,158.85.50.170,1,1097,0,0,1,1097,1.039524000,0.0000
192.67.178.214,<->,132.211.48.21,1,59,0,0,1,59,1.039396000,0.0000
192.170.241.103,<->,8.252.222.65,0,0,1,171,1,171,1.039208000,0.0000
218.38.100.178,<->,8.182.226.78,0,0,1,389,1,389,1.039034000,0.0000
215.158.239.56,<->,199.121.65.88,1,260,0,0,1,260,1.038839000,0.0000
196.148.166.194,<->,8.255.175.14,1,180,0,0,1,180,1.038838000,0.0000
113.123.137.156,<->,92.168.217.228,0,0,1,548,1,548,1.038721000,0.0000
111.151.231.56,<->,8.252.221.167,0,0,1,171,1,171,1.038338000,0.0000
215.158.239.94,<->,113.23.66.254,1,1389,0,0,1,1389,1.038006000,0.0000
197.113.99.181,<->,136.25.188.243,0,0,1,765,1,765,1.037938000,0.0000
112.208.20.199,<->,99.72.196.59,0,0,1,50,1,50,1.037854000,0.0000
136.25.189.34,<->,96.156.169.229,1,85,0,0,1,85,1.037691000,0.0000
54.38.193.155,<->,48.54.146.64,0,0,1,483,1,483,1.037214000,0.0000
200.174.209.22,<->,54.38.7.230,1,285,0,0,1,285,1.036572000,0.0000
144.85.170.208,<->,98.87.146.78,1,659,0,0,1,659,1.036498000,0.0000
215.158.238.122,<->,143.155.231.4,1,1181,0,0,1,1181,1.036261000,0.0000
129.92.117.26,<->,54.52.191.63,1,93,0,0,1,93,1.035919000,0.0000
215.158.239.194,<->,53.176.57.216,1,518,0,0,1,518,1.035681000,0.0000
215.158.238.45,<->,192.226.161.103,1,1341,0,0,1,1341,1.035680000,0.0000
53.244.110.182,<->,48.53.107.207,0,0,1,152,1,152,1.035558000,0.0000
159.248.57.134,<->,136.25.188.209,0,0,1,448,1,448,1.035476000,0.0000
109.207.237.37,<->,50.224.76.235,0,0,1,877,1,877,1.035350000,0.0000
215.158.238.236,<->,33.209.210.244,1,1233,0,0,1,1233,1.035282000,0.0000
213.186.52.93,<->,144.85.170.244,0,0,1,888,1,888,1.035216000,0.0000
215.158.140.206,<->,8.222.7.182,1,1044,0,0,1,1044,1.035173000,0.0000
243.117.107.172,<->,80.38.1.52,0,0,1,1001,1,1001,1.034954000,0.0000
207.63.4.200,<->,136.25.188.243,0,0,1,116,1,116,1.034075000,0.0000
125.42.81.5,<->,80.41.29.200,0,0,1,684,1,684,1.034037000,0.0000
197.107.15.98,<->,136.25.188.252,0,0,1,853,1,853,1.033777000,0.0000
195.54.50.104,<->,136.25.188.242,0,0,1,117,1,117,1.033706000,0.0000
136.25.189.77,<->,0.34.21.24,1,1357,0,0,1,1357,1.033619000,0.0000
215.158.239.22,<->,215.158.127.153,1,240,0,0,1,240,1.033569000,0.0000
207.88.64.75,<->,136.25.188.198,0,0,1,974,1,974,1.033556000,0.0000
215.158.239.58,<->,196.105.36.152,1,234,0,0,1,234,1.033495000,0.0000
215.158.239.17,<->,8.255.92.100,1,1188,0,0,1,1188,1.033256000,0.0000
142.201.0.93,<->,8.182.250.65,0,0,1,712,1,712,1.032970000,0.0000
215.158.239.69,<->,192.171.32.154,1,1181,0,0,1,1181,1.032764000,0.0000
142.208.86.226,<->,136.25.188.253,0,0,1,172,1,172,1.032539000,0.0000
205.122.195.39,<->,133.178.226.19,0,0,1,1149,1,1149,1.032087000,0.0000
215.158.238.106,<->,143.155.227.33,1,264,0,0,1,264,1.031910000,0.0000
199.68.150.36,<->,136.25.188.241,0,0,1,780,1,780,1.031836000,0.0000
98.67.154.211,<->,53.148.102.101,1,97,0,0,1,97,1.031322000,0.0000
41.156.17.148,<->,14.71.95.171,0,0,1,1298,1,1298,1.031164000,0.0000
143.155.227.40,<->,136.25.188.161,0,0,1,1213,1,1213,1.031041000,0.0000
133.178.226.30,<->,89.86.110.68,1,1181,0,0,1,1181,1.030333000,0.0000
215.158.239.32,<->,80.57.141.192,1,1260,0,0,1,1260,1.030129000,0.0000
215.158.61.193,<->,8.176.8.232,0,0,1,1385,1,1385,1.030038000,0.0000
215.158.239.30,<->,8.222.97.61,1,95,0,0,1,95,1.029922000,0.0000
215.158.239.95,<->,148.26.113.10,1,1229,0,0,1,1229,1.029626000,0.0000
220.85.11.250,<->,50.224.76.234,0,0,1,705,1,705,1.029487000,0.0000
215.158.239.87,<->,195.43.176.39,1,260,0,0,1,260,1.029274000,0.0000
215.158.238.126,<->,98.219.126.140,1,636,0,0,1,636,1.029272000,0.0000
97.41.242.133,<->,48.54.85.219,0,0,1,155,1,155,1.029216000,0.0000
101.70.96.205,<->,91.40.92.170,1,1504,0,0,1,1504,1.028876000,0.0000
215.158.238.58,<->,149.33.107.9,1,1357,0,0,1,1357,1.028863000,0.0000
144.85.170.208,<->,98.87.145.170,1,710,0,0,1,710,1.028327000,0.0000
210.229.230.18,<->,6.167.84.3,1,68,0,0,1,68,1.027782000,0.0000
215.202.175.5,<->,8.252.222.211,0,0,1,1229,1,1229,1.027744000,0.0000
247.136.162.79,<->,26.218.95.13,1,97,0,0,1,97,1.027738000,0.0000
194.237.7.104,<->,136.25.188.196,0,0,1,685,1,685,1.027645000,0.0000
136.25.188.162,<->,120.154.221.219,1,1325,0,0,1,1325,1.027586000,0.0000
140.174.84.21,<->,133.178.227.57,0,0,1,1081,1,1081,1.027467000,0.0000
136.25.189.19,<->,113.143.223.216,1,197,0,0,1,197,1.027096000,0.0000
215.158.239.48,<->,196.90.192.245,1,1054,0,0,1,1054,1.026804000,0.0000
215.158.239.51,<->,199.20.30.197,1,408,0,0,1,408,1.026632000,0.0000
195.40.21.252,<->,136.25.188.178,0,0,1,303,1,303,1.026597000,0.0000
146.15.20.243,<->,80.27.155.29,0,0,1,982,1,982,1.026337000,0.0000
215.158.238.251,<->,131.219.230.200,1,1044,0,0,1,1044,1.026258000,0.0000
198.204.76.245,<->,136.25.189.2,0,0,1,1373,1,1373,1.026231000,0.0000
133.178.226.31,<->,57.210.107.9,1,1197,0,0,1,1197,1.025567000,0.0000
215.158.239.113,<->,129.222.39.146,1,905,0,0,1,905,1.025432000,0.0000
215.158.239.234,<->,53.157.243.122,1,333,0,0,1,333,1.025291000,0.0000
252.98.135.226,<->,106.5.211.6,1,162,0,0,1,162,1.024868000,0.0000
215.158.239.76,<->,196.91.44.119,1,93,0,0,1,93,1.024426000,0.0000
215.158.103.203,<->,131.74.153.132,1,478,0,0,1,478,1.024273000,0.0000
53.224.89.221,<->,8.228.219.242,0,0,1,113,1,113,1.023954000,0.0000
48.137.28.241,<->,8.252.222.223,0,0,1,845,1,845,1.023562000,0.0000
149.254.114.194,<->,136.25.189.33,0,0,1,1389,1,1389,1.023131000,0.0000
220.80.187.186,<->,8.45.175.127,1,75,0,0,1,75,1.023066000,0.0000
215.158.239.33,<->,106.188.214.41,1,1461,0,0,1,1461,1.022862000,0.0000
136.25.188.199,<->,113.23.104.213,1,1357,0,0,1,1357,1.022804000,0.0000
145.79.67.241,<->,8.220.189.81,0,0,1,427,1,427,1.022692000,0.0000
195.3.103.217,<->,136.25.189.80,0,0,1,1229,1,1229,1.022605000,0.0000
215.158.140.85,<->,122.29.159.29,1,334,0,0,1,334,1.022521000,0.0000
215.158.61.195,<->,8.176.8.180,0,0,1,1386,1,1386,1.022421000,0.0000
98.67.154.55,<->,53.210.236.172,1,76,0,0,1,76,1.022214000,0.0000
115.233.236.124,<->,50.224.89.243,0,0,1,961,1,961,1.022133000,0.0000
215.158.239.78,<->,199.20.29.53,1,781,0,0,1,781,1.022084000,0.0000
215.158.238.177,<->,193.39.68.239,1,1075,0,0,1,1075,1.021934000,0.0000
215.158.239.79,<->,199.20.29.183,1,1141,0,0,1,1141,1.021851000,0.0000
215.158.238.92,<->,8.220.51.219,1,1309,0,0,1,1309,1.021816000,0.0000
215.158.238.107,<->,131.215.37.57,1,1309,0,0,1,1309,1.021059000,0.0000
215.158.239.57,<->,207.167.232.63,1,602,0,0,1,602,1.020860000,0.0000
215.158.61.183,<->,136.25.188.42,0,0,1,657,1,657,1.020447000,0.0000
215.158.239.78,<->,199.20.30.94,1,101,0,0,1,101,1.020218000,0.0000
50.224.76.235,<->,29.154.146.144,1,1013,0,0,1,1013,1.019727000,0.0000
215.158.238.149,<->,114.25.48.32,1,1341,0,0,1,1341,1.019523000,0.0000
215.158.239.92,<->,194.232.222.255,1,765,0,0,1,765,1.019360000,0.0000
210.95.218.218,<->,8.220.180.184,0,0,1,600,1,600,1.018708000,0.0000
204.34.141.202,<->,50.224.76.234,0,0,1,795,1,795,1.018066000,0.0000
133.32.39.31,<->,111.151.106.200,1,100,0,0,1,100,1.017952000,0.0000
136.25.188.239,<->,72.8.163.72,1,602,0,0,1,602,1.017587000,0.0000
102.83.209.113,<->,8.45.162.111,1,87,0,0,1,87,1.017192000,0.0000
215.158.239.95,<->,142.254.68.249,1,303,0,0,1,303,1.017100000,0.0000
220.20.200.28,<->,119.159.22.233,1,345,0,0,1,345,1.016786000,0.0000
199.121.242.135,<->,136.25.188.177,0,0,1,93,1,93,1.016329000,0.0000
73.70.219.44,<->,8.252.222.178,0,0,1,863,1,863,1.016243000,0.0000
215.158.238.74,<->,215.158.3.27,1,1197,0,0,1,1197,1.016030000,0.0000
215.158.238.148,<->,120.154.221.218,1,1149,0,0,1,1149,1.016004000,0.0000
50.224.76.230,<->,6.4.63.97,1,898,0,0,1,898,1.015627000,0.0000
194.245.226.192,<->,8.252.222.179,0,0,1,87,1,87,1.015487000,0.0000
108.38.16.192,<->,50.224.80.64,0,0,1,403,1,403,1.015357000,0.0000
215.158.238.41,<->,111.151.142.164,1,100,0,0,1,100,1.014900000,0.0000
132.128.61.42,<->,80.41.0.92,0,0,1,75,1,75,1.014649000,0.0000
129.224.112.252,<->,97.242.126.195,1,122,0,0,1,122,1.014639000,0.0000
215.158.239.78,<->,57.247.184.202,1,1293,0,0,1,1293,1.014520000,0.0000
89.164.10.227,<->,50.224.76.234,0,0,1,726,1,726,1.014295000,0.0000
215.158.238.133,<->,128.110.138.182,1,1325,0,0,1,1325,1.014226000,0.0000
147.11.11.151,<->,102.44.106.77,0,0,1,613,1,613,1.013893000,0.0000
215.158.239.93,<->,196.106.35.205,1,1084,0,0,1,1084,1.013490000,0.0000
215.158.238.177,<->,142.93.98.208,1,1060,0,0,1,1060,1.013264000,0.0000
223.36.99.25,<->,133.178.227.24,0,0,1,1148,1,1148,1.013251000,0.0000
98.67.154.150,<->,53.231.149.209,1,401,0,0,1,401,1.013228000,0.0000
132.153.80.240,<->,8.53.4.76,0,0,1,467,1,467,1.013152000,0.0000
215.158.238.83,<->,33.239.214.176,1,1197,0,0,1,1197,1.013077000,0.0000
145.236.82.22,<->,8.52.176.86,0,0,1,438,1,438,1.012840000,0.0000
136.25.189.0,<->,123.166.46.213,1,1229,0,0,1,1229,1.012757000,0.0000
145.116.118.225,<->,53.181.140.67,1,626,0,0,1,626,1.012498000,0.0000
157.127.224.62,<->,8.252.221.204,0,0,1,454,1,454,1.012431000,0.0000
142.191.48.191,<->,136.25.188.220,0,0,1,765,1,765,1.012088000,0.0000
215.158.140.75,<->,113.23.7.238,1,1030,0,0,1,1030,1.011705000,0.0000
92.168.217.193,<->,75.95.132.23,1,608,0,0,1,608,1.011594000,0.0000
141.24.62.221,<->,100.228.42.88,0,0,1,685,1,685,1.011510000,0.0000
92.27.219.189,<->,42.59.238.156,1,80,0,0,1,80,1.011318000,0.0000
215.158.61.182,<->,8.176.8.232,0,0,1,1149,1,1149,1.011065000,0.0000
215.158.239.14,<->,139.161.104.53,1,93,0,0,1,93,1.010960000,0.0000
133.178.227.1,<->,8.220.54.219,1,1099,0,0,1,1099,1.009942000,0.0000
137.46.171.47,<->,8.53.4.241,0,0,1,649,1,649,1.009897000,0.0000
215.158.239.5,<->,69.31.238.52,1,1411,0,0,1,1411,1.009630000,0.0000
215.158.239.69,<->,196.106.47.167,1,653,0,0,1,653,1.009407000,0.0000
202.33.192.45,<->,136.25.188.220,0,0,1,93,1,93,1.009354000,0.0000
215.158.238.64,<->,57.210.107.8,1,1261,0,0,1,1261,1.008685000,0.0000
215.158.239.59,<->,113.92.151.53,1,1365,0,0,1,1365,1.008154000,0.0000
215.158.238.83,<->,198.204.76.253,1,1069,0,0,1,1069,1.008141000,0.0000
133.178.226.198,<->,29.211.110.77,1,145,0,0,1,145,1.008094000,0.0000
215.158.239.58,<->,207.63.148.252,1,602,0,0,1,602,1.008003000,0.0000
132.128.49.14,<->,35.56.97.244,0,0,1,1010,1,1010,1.007837000,0.0000
94.192.164.159,<->,8.252.222.172,0,0,1,1101,1,1101,1.007598000,0.0000
215.158.239.69,<->,196.110.205.219,1,378,0,0,1,378,1.007418000,0.0000
220.20.200.59,<->,144.83.60.153,1,627,0,0,1,627,1.007401000,0.0000
215.158.239.49,<->,199.20.31.30,1,240,0,0,1,240,1.006685000,0.0000
136.25.188.52,<->,57.210.107.8,1,1277,0,0,1,1277,1.006455000,0.0000
210.229.230.18,<->,158.164.109.21,1,93,0,0,1,93,1.006406000,0.0000
136.25.188.162,<->,8.240.118.187,1,1309,0,0,1,1309,1.006257000,0.0000
140.174.84.0,<->,136.25.188.224,0,0,1,1053,1,1053,1.006094000,0.0000
132.128.61.174,<->,6.122.200.0,0,0,1,141,1,141,1.005985000,0.0000
197.103.151.87,<->,133.178.226.37,0,0,1,1373,1,1373,1.005946000,0.0000
210.208.242.230,<->,144.87.235.222,0,0,1,139,1,139,1.005914000,0.0000
220.38.239.140,<->,215.158.140.228,0,0,1,1037,1,1037,1.005885000,0.0000
195.55.178.184,<->,136.25.188.174,0,0,1,1047,1,1047,1.005777000,0.0000
251.122.143.50,<->,8.220.186.82,0,0,1,238,1,238,1.005754000,0.0000
220.20.200.92,<->,144.83.60.153,1,324,0,0,1,324,1.005442000,0.0000
195.14.170.189,<->,136.25.188.53,0,0,1,93,1,93,1.005276000,0.0000
56.148.119.166,<->,8.20.87.95,0,0,1,774,1,774,1.004822000,0.0000
204.0.235.242,<->,136.25.188.45,0,0,1,89,1,89,1.004742000,0.0000
215.158.238.113,<->,118.20.114.86,1,1261,0,0,1,1261,1.004186000,0.0000
142.240.161.240,<->,136.25.188.45,0,0,1,602,1,602,1.004115000,0.0000
215.158.239.85,<->,8.249.253.226,1,1373,0,0,1,1373,1.003967000,0.0000
220.28.114.28,<->,136.25.188.248,0,0,1,253,1,253,1.003876000,0.0000
136.25.188.44,<->,111.150.34.233,1,1293,0,0,1,1293,1.003669000,0.0000
215.158.238.93,<->,192.224.21.67,1,1197,0,0,1,1197,1.003209000,0.0000
129.224.112.252,<->,97.242.126.200,1,110,0,0,1,110,1.003093000,0.0000
133.178.226.28,<->,114.25.48.78,1,1197,0,0,1,1197,1.002954000,0.0000
136.25.188.174,<->,112.220.206.117,1,1181,0,0,1,1181,1.002813000,0.0000
131.2.232.124,<->,80.42.141.34,0,0,1,476,1,476,1.001885000,0.0000
221.102.56.69,<->,80.42.218.23,0,0,1,294,1,294,1.001535000,0.0000
136.25.188.196,<->,112.220.206.88,1,1325,0,0,1,1325,1.001270000,0.0000
136.25.188.175,<->,69.31.238.203,1,1341,0,0,1,1341,1.001189000,0.0000
215.158.239.94,<->,199.20.23.73,1,93,0,0,1,93,1.000804000,0.0000
50.224.80.64,<->,46.44.217.168,1,753,0,0,1,753,0.999751000,0.0000
215.158.140.241,<->,192.204.170.227,1,1200,0,0,1,1200,0.999676000,0.0000
97.22.56.145,<->,8.183.25.124,0,0,1,261,1,261,0.999613000,0.0000
195.77.121.207,<->,8.20.87.206,0,0,1,76,1,76,0.999606000,0.0000
204.130.115.166,<->,8.252.223.175,0,0,1,1058,1,1058,0.999293000,0.0000
136.25.188.220,<->,57.210.104.163,1,1213,0,0,1,1213,0.999160000,0.0000
101.70.118.242,<->,54.48.33.198,1,733,0,0,1,733,0.999051000,0.0000
215.158.239.182,<->,57.210.104.45,1,282,0,0,1,282,0.998757000,0.0000
215.158.238.106,<->,27.22.184.75,1,1357,0,0,1,1357,0.998756000,0.0000
136.25.188.173,<->,8.179.43.83,1,1341,0,0,1,1341,0.998392000,0.0000
207.191.232.222,<->,136.25.188.225,0,0,1,272,1,272,0.998129000,0.0000
197.113.99.203,<->,136.25.188.253,0,0,1,349,1,349,0.997851000,0.0000
221.102.103.73,<->,194.253.94.195,1,469,0,0,1,469,0.997548000,0.0000
221.102.56.69,<->,109.3.152.35,0,0,1,294,1,294,0.997057000,0.0000
148.55.210.193,<->,136.25.188.252,0,0,1,1325,1,1325,0.996827000,0.0000
207.56.33.193,<->,136.25.188.226,0,0,1,303,1,303,0.996643000,0.0000
215.158.239.93,<->,199.20.29.71,1,101,0,0,1,101,0.996527000,0.0000
215.158.238.132,<->,112.235.95.75,1,1229,0,0,1,1229,0.996472000,0.0000
215.158.238.135,<->,139.160.226.230,1,1213,0,0,1,1213,0.996461000,0.0000
215.158.238.221,<->,29.211.122.244,1,1055,0,0,1,1055,0.996372000,0.0000
215.158.239.69,<->,199.20.30.239,1,797,0,0,1,797,0.996342000,0.0000
133.178.226.30,<->,89.86.110.11,1,1213,0,0,1,1213,0.996091000,0.0000
76.101.167.186,<->,8.252.222.141,0,0,1,87,1,87,0.995922000,0.0000
215.158.238.91,<->,145.116.209.76,1,506,0,0,1,506,0.995892000,0.0000
215.158.140.185,<->,8.222.7.181,1,1227,0,0,1,1227,0.995865000,0.0000
215.158.239.19,<->,192.170.245.245,1,1185,0,0,1,1185,0.995863000,0.0000
194.237.98.164,<->,136.25.188.238,0,0,1,714,1,714,0.995560000,0.0000
199.68.20.34,<->,136.25.188.252,0,0,1,724,1,724,0.995476000,0.0000
215.158.238.107,<->,32.183.36.53,1,1197,0,0,1,1197,0.995059000,0.0000
136.25.188.47,<->,8.191.15.7,1,1341,0,0,1,1341,0.994438000,0.0000
139.163.26.146,<->,109.0.217.13,1,157,0,0,1,157,0.994060000,0.0000
215.158.239.70,<->,8.249.253.226,1,1213,0,0,1,1213,0.993920000,0.0000
201.47.169.72,<->,101.224.167.119,0,0,1,58,1,58,0.993749000,0.0000
133.178.226.38,<->,116.106.60.170,1,1213,0,0,1,1213,0.993701000,0.0000
192.65.42.219,<->,8.55.195.24,1,87,0,0,1,87,0.993465000,0.0000
109.208.21.233,<->,97.126.119.191,0,0,1,298,1,298,0.993064000,0.0000
221.102.56.69,<->,80.40.10.250,0,0,1,294,1,294,0.992435000,0.0000
215.158.238.105,<->,135.253.11.53,1,1229,0,0,1,1229,0.991978000,0.0000
136.25.189.41,<->,96.156.169.238,1,741,0,0,1,741,0.991148000,0.0000
200.174.201.41,<->,53.213.148.81,1,1243,0,0,1,1243,0.991102000,0.0000
194.211.231.146,<->,91.231.195.125,0,0,1,214,1,214,0.991069000,0.0000
199.111.215.20,<->,8.182.235.164,0,0,1,326,1,326,0.990877000,0.0000
133.178.227.24,<->,72.23.148.244,1,1027,0,0,1,1027,0.990727000,0.0000
215.158.238.141,<->,38.206.2.171,1,133,0,0,1,133,0.990681000,0.0000
143.251.236.192,<->,0.195.210.46,0,0,1,589,1,589,0.990600000,0.0000
210.229.230.21,<->,87.61.245.99,1,68,0,0,1,68,0.990441000,0.0000
241.75.192.120,<->,50.224.88.109,0,0,1,51,1,51,0.990068000,0.0000
158.73.248.94,<->,89.183.110.72,0,0,1,1439,1,1439,0.989978000,0.0000
196.146.24.52,<->,97.243.220.36,1,64,0,0,1,64,0.989681000,0.0000
215.158.239.32,<->,106.188.184.98,1,66,0,0,1,66,0.989545000,0.0000
215.158.61.202,<->,8.176.8.96,0,0,1,1401,1,1401,0.989497000,0.0000
215.158.238.95,<->,192.229.40.91,1,1085,0,0,1,1085,0.989462000,0.0000
136.25.189.77,<->,94.110.153.255,1,1499,0,0,1,1499,0.989226000,0.0000
215.158.239.92,<->,196.7.147.224,1,172,0,0,1,172,0.988877000,0.0000
143.148.100.254,<->,0.195.210.34,0,0,1,87,1,87,0.988617000,0.0000
133.178.227.41,<->,29.211.165.85,1,1187,0,0,1,1187,0.988505000,0.0000
53.167.66.5,<->,48.55.35.47,0,0,1,508,1,508,0.988456000,0.0000
215.158.238.112,<->,29.213.216.255,1,1229,0,0,1,1229,0.988123000,0.0000
133.178.226.28,<->,113.20.94.98,1,1101,0,0,1,1101,0.987989000,0.0000
215.158.239.56,<->,142.241.242.229,1,93,0,0,1,93,0.987895000,0.0000
138.98.147.21,<->,38.16.228.146,1,1344,0,0,1,1344,0.987612000,0.0000
204.143.20.66,<->,8.182.250.65,0,0,1,579,1,579,0.987533000,0.0000
224.250.64.91,<->,100.94.188.19,0,0,1,68,1,68,0.987522000,0.0000
215.158.238.123,<->,146.10.166.70,1,1181,0,0,1,1181,0.987144000,0.0000
50.224.76.235,<->,29.95.75.90,1,1086,0,0,1,1086,0.986781000,0.0000
215.158.239.68,<->,199.20.31.14,1,117,0,0,1,117,0.986679000,0.0000
215.158.238.72,<->,38.104.11.55,1,1357,0,0,1,1357,0.986193000,0.0000
251.21.231.243,<->,109.222.230.50,0,0,1,500,1,500,0.986172000,0.0000
223.115.220.58,<->,8.252.221.236,0,0,1,454,1,454,0.986102000,0.0000
113.23.77.201,<->,101.126.182.154,0,0,1,308,1,308,0.985817000,0.0000
215.158.239.50,<->,196.104.200.133,1,157,0,0,1,157,0.985780000,0.0000
199.32.137.31,<->,136.25.188.242,0,0,1,765,1,765,0.985512000,0.0000
215.158.238.73,<->,193.39.70.0,1,1213,0,0,1,1213,0.985243000,0.0000
197.113.99.89,<->,136.25.188.241,0,0,1,87,1,87,0.985213000,0.0000
215.158.239.32,<->,8.241.236.246,1,1203,0,0,1,1203,0.985082000,0.0000
245.61.110.58,<->,8.20.87.153,0,0,1,782,1,782,0.984393000,0.0000
215.158.239.56,<->,199.20.31.169,1,93,0,0,1,93,0.984371000,0.0000
224.33.81.227,<->,192.64.200.222,0,0,1,101,1,101,0.984243000,0.0000
136.25.188.254,<->,131.2.115.214,1,1197,0,0,1,1197,0.983984000,0.0000
214.85.127.177,<->,50.224.76.235,0,0,1,972,1,972,0.983688000,0.0000
215.158.140.185,<->,144.252.156.92,1,800,0,0,1,800,0.983643000,0.0000
215.158.238.141,<->,29.212.43.247,1,1101,0,0,1,1101,0.983177000,0.0000
231.136.198.109,<->,136.25.188.163,0,0,1,303,1,303,0.983152000,0.0000
210.229.230.19,<->,114.199.71.219,1,68,0,0,1,68,0.982671000,0.0000
204.21.174.204,<->,136.25.188.225,0,0,1,305,1,305,0.982600000,0.0000
109.222.230.147,<->,14.71.93.20,1,93,0,0,1,93,0.982247000,0.0000
144.83.60.153,<->,92.162.253.36,0,0,1,627,1,627,0.982111000,0.0000
148.217.121.180,<->,136.25.189.29,0,0,1,1245,1,1245,0.982048000,0.0000
215.158.238.80,<->,29.211.186.217,1,1341,0,0,1,1341,0.981791000,0.0000
220.20.200.5,<->,144.83.60.153,1,395,0,0,1,395,0.981360000,0.0000
139.47.194.179,<->,100.92.48.176,0,0,1,391,1,391,0.981275000,0.0000
215.158.239.70,<->,196.91.85.7,1,602,0,0,1,602,0.981233000,0.0000
204.186.129.219,<->,136.25.188.225,0,0,1,117,1,117,0.980911000,0.0000
148.217.121.182,<->,136.25.189.13,0,0,1,1213,1,1213,0.980623000,0.0000
215.158.239.87,<->,196.91.211.45,1,284,0,0,1,284,0.980386000,0.0000
142.191.237.192,<->,136.25.188.255,0,0,1,93,1,93,0.980384000,0.0000
109.222.198.150,<->,56.114.235.120,1,507,0,0,1,507,0.979859000,0.0000
221.196.122.52,<->,136.25.188.163,0,0,1,348,1,348,0.979788000,0.0000
215.158.239.71,<->,56.161.218.42,1,1245,0,0,1,1245,0.979729000,0.0000
204.184.197.122,<->,136.25.188.176,0,0,1,282,1,282,0.979150000,0.0000
204.187.136.157,<->,136.25.188.173,0,0,1,240,1,240,0.978882000,0.0000
136.25.189.30,<->,96.156.169.253,1,94,0,0,1,94,0.978783000,0.0000
210.218.99.216,<->,56.120.235.2,1,595,0,0,1,595,0.978343000,0.0000
101.70.127.164,<->,53.209.60.99,1,732,0,0,1,732,0.977542000,0.0000
133.178.226.29,<->,29.211.122.247,1,1389,0,0,1,1389,0.977246000,0.0000
103.157.92.113,<->,8.52.188.75,0,0,1,461,1,461,0.977129000,0.0000
48.131.159.10,<->,8.252.223.175,0,0,1,1181,1,1181,0.977088000,0.0000
148.224.137.81,<->,136.25.189.0,0,0,1,1341,1,1341,0.977044000,0.0000
215.158.238.45,<->,113.190.46.8,1,1053,0,0,1,1053,0.976922000,0.0000
199.39.238.203,<->,136.25.188.178,0,0,1,93,1,93,0.976812000,0.0000
210.229.230.19,<->,110.76.8.220,1,68,0,0,1,68,0.976433000,0.0000
215.158.238.134,<->,29.212.43.236,1,1213,0,0,1,1213,0.976084000,0.0000
215.158.238.135,<->,131.215.37.53,1,1261,0,0,1,1261,0.975793000,0.0000
220.28.104.193,<->,133.178.227.29,0,0,1,615,1,615,0.975617000,0.0000
209.171.148.225,<->,8.52.178.124,0,0,1,685,1,685,0.975284000,0.0000
215.158.239.97,<->,199.20.31.207,1,247,0,0,1,247,0.975189000,0.0000
196.246.182.145,<->,136.25.188.176,0,0,1,378,1,378,0.974643000,0.0000
144.85.170.254,<->,17.90.66.204,1,739,0,0,1,739,0.974612000,0.0000
199.80.156.77,<->,136.25.188.174,0,0,1,593,1,593,0.974444000,0.0000
215.158.239.86,<->,57.236.82.215,1,1389,0,0,1,1389,0.974090000,0.0000
215.158.238.1,<->,192.229.43.55,1,741,0,0,1,741,0.973907000,0.0000
192.65.173.125,<->,8.55.220.143,1,129,0,0,1,129,0.973880000,0.0000
215.158.239.33,<->,8.255.92.103,1,1348,0,0,1,1348,0.973745000,0.0000
97.168.64.50,<->,54.92.55.77,1,118,0,0,1,118,0.973740000,0.0000
213.221.90.230,<->,144.85.170.208,0,0,1,435,1,435,0.973477000,0.0000
215.158.238.132,<->,126.219.196.185,1,1149,0,0,1,1149,0.973445000,0.0000
143.29.161.66,<->,50.224.76.230,0,0,1,75,1,75,0.972897000,0.0000
215.158.61.183,<->,8.176.8.195,0,0,1,400,1,400,0.972854000,0.0000
210.229.230.22,<->,96.253.8.137,1,68,0,0,1,68,0.972619000,0.0000
215.158.239.85,<->,29.213.219.42,1,1362,0,0,1,1362,0.972403000,0.0000
58.202.32.58,<->,8.252.221.204,0,0,1,452,1,452,0.972112000,0.0000
194.194.188.83,<->,50.224.76.235,0,0,1,941,1,941,0.972095000,0.0000
69.243.32.83,<->,8.252.221.197,0,0,1,438,1,438,0.971977000,0.0000
215.158.61.191,<->,8.176.8.217,0,0,1,397,1,397,0.971949000,0.0000
215.158.239.49,<->,196.109.46.20,1,260,0,0,1,260,0.971795000,0.0000
215.158.140.218,<->,53.246.31.6,1,367,0,0,1,367,0.971253000,0.0000
215.158.239.77,<->,199.20.23.28,1,685,0,0,1,685,0.971218000,0.0000
111.199.225.136,<->,0.195.210.44,0,0,1,87,1,87,0.971171000,0.0000
139.163.71.197,<->,119.223.130.3,1,280,0,0,1,280,0.971142000,0.0000
129.224.112.252,<->,97.242.126.202,1,109,0,0,1,109,0.971023000,0.0000
57.1.20.68,<->,0.195.210.42,0,0,1,85,1,85,0.970700000,0.0000
231.136.198.109,<->,215.158.239.76,0,0,1,302,1,302,0.970552000,0.0000
136.25.188.172,<->,112.220.206.116,1,1133,0,0,1,1133,0.970503000,0.0000
136.129.94.157,<->,111.199.227.15,1,416,0,0,1,416,0.970337000,0.0000
246.108.106.187,<->,111.147.185.223,0,0,1,50,1,50,0.969731000,0.0000
213.186.52.80,<->,144.85.170.208,0,0,1,443,1,443,0.969615000,0.0000
136.25.189.12,<->,113.92.151.117,1,1213,0,0,1,1213,0.969547000,0.0000
215.158.239.31,<->,215.158.127.181,1,296,0,0,1,296,0.969523000,0.0000
90.240.140.154,<->,53.214.81.160,1,660,0,0,1,660,0.969484000,0.0000
223.177.36.73,<->,8.252.221.230,0,0,1,454,1,454,0.969377000,0.0000
207.61.111.71,<->,136.25.188.52,0,0,1,721,1,721,0.968829000,0.0000
80.41.18.163,<->,8.209.235.29,1,725,0,0,1,725,0.968786000,0.0000
247.136.232.233,<->,53.148.22.85,1,125,0,0,1,125,0.968641000,0.0000
215.158.239.227,<->,139.36.120.124,1,309,0,0,1,309,0.968205000,0.0000
221.102.123.190,<->,98.131.227.91,1,121,0,0,1,121,0.968047000,0.0000
142.236.202.186,<->,136.25.188.225,0,0,1,794,1,794,0.967866000,0.0000
215.158.239.18,<->,29.214.205.38,1,1340,0,0,1,1340,0.967284000,0.0000
203.117.50.219,<->,0.195.210.44,0,0,1,125,1,125,0.966975000,0.0000
92.27.219.240,<->,8.0.99.113,1,550,0,0,1,550,0.966882000,0.0000
136.25.188.252,<->,56.161.218.62,1,1357,0,0,1,1357,0.966798000,0.0000
241.120.29.241,<->,215.158.239.57,0,0,1,1181,1,1181,0.966555000,0.0000
215.158.239.50,<->,196.104.175.12,1,141,0,0,1,141,0.966344000,0.0000
215.158.238.114,<->,122.159.245.164,1,1229,0,0,1,1229,0.966195000,0.0000
109.222.252.7,<->,53.246.154.134,1,660,0,0,1,660,0.965974000,0.0000
143.135.57.101,<->,8.52.222.199,0,0,1,514,1,514,0.965506000,0.0000
8.252.221.221,<->,4.123.161.8,1,132,0,0,1,132,0.965409000,0.0000
200.175.83.223,<->,53.149.94.186,1,577,0,0,1,577,0.964851000,0.0000
159.23.225.228,<->,130.242.204.14,1,76,0,0,1,76,0.964753000,0.0000
215.158.239.86,<->,72.23.194.223,1,1213,0,0,1,1213,0.964603000,0.0000
136.25.189.92,<->,96.156.169.209,1,807,0,0,1,807,0.964067000,0.0000
215.158.238.23,<->,8.252.214.239,1,1229,0,0,1,1229,0.963987000,0.0000
133.56.201.50,<->,8.52.189.221,0,0,1,987,1,987,0.963885000,0.0000
136.25.188.236,<->,80.47.228.213,1,1245,0,0,1,1245,0.963821000,0.0000
204.187.194.213,<->,136.25.188.198,0,0,1,136,1,136,0.963741000,0.0000
249.101.236.84,<->,53.213.100.206,1,231,0,0,1,231,0.962917000,0.0000
117.33.13.193,<->,92.168.217.228,0,0,1,332,1,332,0.962825000,0.0000
195.124.165.237,<->,136.25.188.220,0,0,1,1080,1,1080,0.962475000,0.0000
75.214.236.212,<->,8.252.221.230,0,0,1,499,1,499,0.962437000,0.0000
194.237.11.0,<->,136.25.188.163,0,0,1,797,1,797,0.962116000,0.0000
220.20.200.122,<->,144.83.60.153,1,628,0,0,1,628,0.961892000,0.0000
143.14.191.92,<->,136.25.189.80,0,0,1,1309,1,1309,0.961660000,0.0000
215.158.238.134,<->,8.53.216.76,1,1229,0,0,1,1229,0.961541000,0.0000
195.14.220.180,<->,136.25.188.52,0,0,1,299,1,299,0.961051000,0.0000
215.158.238.248,<->,8.253.128.36,1,1225,0,0,1,1225,0.960924000,0.0000
221.102.56.69,<->,192.67.74.7,0,0,1,294,1,294,0.960485000,0.0000
195.40.157.134,<->,136.25.188.54,0,0,1,93,1,93,0.960434000,0.0000
80.41.16.226,<->,38.87.248.58,1,112,0,0,1,112,0.960173000,0.0000
141.24.62.195,<->,100.228.42.88,0,0,1,737,1,737,0.959726000,0.0000
215.158.238.81,<->,112.220.206.116,1,1261,0,0,1,1261,0.959601000,0.0000
215.158.239.95,<->,56.20.41.3,1,1453,0,0,1,1453,0.959543000,0.0000
220.55.229.56,<->,100.94.52.121,0,0,1,465,1,465,0.959490000,0.0000
215.158.140.92,<->,29.214.71.56,1,1111,0,0,1,1111,0.959389000,0.0000
215.158.239.101,<->,129.222.36.132,1,109,0,0,1,109,0.958216000,0.0000
139.193.141.139,<->,82.150.219.116,1,224,0,0,1,224,0.958128000,0.0000
248.239.64.14,<->,8.55.216.92,1,141,0,0,1,141,0.958007000,0.0000
246.254.97.229,<->,111.20.62.72,1,548,0,0,1,548,0.957766000,0.0000
215.158.239.70,<->,196.93.124.127,1,136,0,0,1,136,0.957722000,0.0000
251.122.146.43,<->,8.52.222.23,0,0,1,516,1,516,0.957366000,0.0000
136.25.189.202,<->,129.222.39.156,1,942,0,0,1,942,0.956668000,0.0000
215.158.239.211,<->,210.231.140.46,1,70,0,0,1,70,0.956339000,0.0000
89.216.124.92,<->,54.50.145.179,1,75,0,0,1,75,0.955626000,0.0000
115.149.99.162,<->,111.147.150.12,0,0,1,61,1,61,0.955618000,0.0000
133.178.227.14,<->,133.56.180.82,1,1250,0,0,1,1250,0.954798000,0.0000
75.214.65.176,<->,8.252.221.204,0,0,1,456,1,456,0.954509000,0.0000
136.25.189.28,<->,112.220.198.85,1,1293,0,0,1,1293,0.954248000,0.0000
146.249.221.205,<->,8.252.221.221,0,0,1,270,1,270,0.954203000,0.0000
215.158.238.101,<->,145.116.209.82,1,506,0,0,1,506,0.954194000,0.0000
127.79.24.44,<->,50.224.76.235,0,0,1,107,1,107,0.954108000,0.0000
17.0.65.173,<->,8.20.87.94,0,0,1,956,1,956,0.953873000,0.0000
142.207.145.245,<->,136.25.188.54,0,0,1,93,1,93,0.953143000,0.0000
215.158.238.123,<->,131.2.115.246,1,1229,0,0,1,1229,0.952624000,0.0000
48.17.34.134,<->,8.252.221.198,0,0,1,454,1,454,0.952616000,0.0000
199.69.15.64,<->,136.25.188.174,0,0,1,93,1,93,0.952552000,0.0000
215.158.239.50,<->,142.229.177.113,1,909,0,0,1,909,0.952352000,0.0000
215.158.238.66,<->,61.34.184.202,1,1181,0,0,1,1181,0.952266000,0.0000
132.18.67.27,<->,102.231.177.130,0,0,1,360,1,360,0.952263000,0.0000
136.25.188.252,<->,48.131.158.213,1,1293,0,0,1,1293,0.951972000,0.0000
91.231.222.203,<->,0.195.210.44,0,0,1,87,1,87,0.951732000,0.0000
109.1.45.170,<->,56.114.235.120,1,559,0,0,1,559,0.951704000,0.0000
215.158.239.77,<->,199.71.97.231,1,765,0,0,1,765,0.951663000,0.0000
111.230.154.167,<->,50.224.76.235,0,0,1,199,1,199,0.951517000,0.0000
136.25.189.15,<->,96.135.155.7,1,1389,0,0,1,1389,0.951083000,0.0000
239.66.110.113,<->,203.215.177.36,0,0,1,447,1,447,0.951041000,0.0000
215.158.238.81,<->,139.160.226.246,1,1341,0,0,1,1341,0.950941000,0.0000
215.158.238.47,<->,29.211.186.213,1,1421,0,0,1,1421,0.950595000,0.0000
148.129.19.215,<->,136.25.188.221,0,0,1,1325,1,1325,0.950557000,0.0000
204.2.117.32,<->,136.25.188.55,0,0,1,93,1,93,0.950445000,0.0000
215.158.239.71,<->,126.219.49.170,1,1357,0,0,1,1357,0.949643000,0.0000
200.174.51.16,<->,53.161.15.106,1,214,0,0,1,214,0.949194000,0.0000
148.129.30.28,<->,136.25.189.82,0,0,1,1373,1,1373,0.947947000,0.0000
111.150.74.42,<->,8.176.8.71,0,0,1,445,1,445,0.947344000,0.0000
254.126.121.48,<->,109.0.230.164,0,0,1,85,1,85,0.946979000,0.0000
142.236.6.229,<->,136.25.188.52,0,0,1,542,1,542,0.946634000,0.0000
192.229.216.117,<->,149.181.231.91,1,422,0,0,1,422,0.946621000,0.0000
215.158.61.145,<->,8.176.8.244,0,0,1,77,1,77,0.946022000,0.0000
210.209.251.211,<->,109.2.43.79,0,0,1,442,1,442,0.945875000,0.0000
97.126.113.184,<->,89.205.211.109,1,445,0,0,1,445,0.945325000,0.0000
248.239.128.55,<->,233.145.251.212,1,624,0,0,1,624,0.945005000,0.0000
117.15.100.145,<->,50.224.80.67,0,0,1,449,1,449,0.944453000,0.0000
125.216.43.59,<->,8.252.222.204,0,0,1,1181,1,1181,0.944339000,0.0000
99.115.52.80,<->,8.220.190.86,0,0,1,544,1,544,0.943812000,0.0000
192.204.151.81,<->,136.25.188.161,0,0,1,1373,1,1373,0.943677000,0.0000
215.158.239.17,<->,8.241.236.249,1,112,0,0,1,112,0.943622000,0.0000
231.255.128.152,<->,159.137.255.68,0,0,1,97,1,97,0.943215000,0.0000
139.193.141.139,<->,50.74.34.51,1,552,0,0,1,552,0.943025000,0.0000
218.5.22.135,<->,100.228.42.201,0,0,1,569,1,569,0.942809000,0.0000
215.158.239.50,<->,195.55.212.4,1,593,0,0,1,593,0.942700000,0.0000
215.158.195.73,<->,111.151.109.41,1,100,0,0,1,100,0.942602000,0.0000
215.158.238.107,<->,143.155.227.54,1,1117,0,0,1,1117,0.942531000,0.0000
133.178.227.8,<->,133.56.180.37,1,541,0,0,1,541,0.942517000,0.0000
194.154.22.157,<->,50.224.80.64,0,0,1,572,1,572,0.942338000,0.0000
246.253.134.201,<->,148.113.197.188,1,661,0,0,1,661,0.942213000,0.0000
99.162.77.146,<->,53.69.140.220,1,234,0,0,1,234,0.941887000,0.0000
210.229.230.22,<->,89.241.175.253,1,80,0,0,1,80,0.941279000,0.0000
215.158.238.73,<->,143.227.65.185,1,1069,0,0,1,1069,0.941268000,0.0000
111.150.206.53,<->,101.224.204.164,0,0,1,996,1,996,0.941042000,0.0000
136.126.235.34,<->,8.220.198.131,0,0,1,1036,1,1036,0.940979000,0.0000
133.178.226.111,<->,133.56.180.87,1,1254,0,0,1,1254,0.940289000,0.0000
133.178.227.247,<->,99.74.26.149,1,93,0,0,1,93,0.939910000,0.0000
215.158.239.94,<->,149.184.89.90,1,1309,0,0,1,1309,0.939890000,0.0000
215.158.238.107,<->,158.184.99.168,1,1037,0,0,1,1037,0.939518000,0.0000
192.67.176.62,<->,26.218.94.114,1,141,0,0,1,141,0.939382000,0.0000
215.158.239.49,<->,207.56.150.97,1,781,0,0,1,781,0.939363000,0.0000
215.158.238.66,<->,126.219.190.171,1,1277,0,0,1,1277,0.939215000,0.0000
137.160.171.29,<->,8.182.226.78,0,0,1,381,1,381,0.939152000,0.0000
215.158.239.16,<->,8.255.92.138,1,1026,0,0,1,1026,0.938756000,0.0000
215.158.239.5,<->,120.155.14.71,1,184,0,0,1,184,0.938603000,0.0000
80.27.155.30,<->,75.94.79.196,1,1073,0,0,1,1073,0.938554000,0.0000
215.158.238.248,<->,120.190.31.242,1,1227,0,0,1,1227,0.938508000,0.0000
215.158.239.84,<->,199.20.31.92,1,93,0,0,1,93,0.938479000,0.0000
215.158.238.141,<->,136.139.59.106,1,1101,0,0,1,1101,0.938439000,0.0000
120.123.160.244,<->,50.224.76.235,0,0,1,1291,1,1291,0.938433000,0.0000
98.67.131.10,<->,54.43.1.179,1,173,0,0,1,173,0.938185000,0.0000
132.18.67.28,<->,109.222.201.157,0,0,1,285,1,285,0.938179000,0.0000
192.67.184.130,<->,50.248.185.173,1,369,0,0,1,369,0.938093000,0.0000
215.158.239.71,<->,29.123.209.239,1,1197,0,0,1,1197,0.938017000,0.0000
133.178.226.19,<->,122.158.179.41,1,1085,0,0,1,1085,0.937742000,0.0000
142.236.6.229,<->,136.25.188.220,0,0,1,543,1,543,0.937681000,0.0000
215.158.238.107,<->,129.175.139.42,1,1389,0,0,1,1389,0.936976000,0.0000
215.158.61.189,<->,8.176.8.254,0,0,1,658,1,658,0.936893000,0.0000
159.162.14.181,<->,8.182.227.180,0,0,1,1035,1,1035,0.936866000,0.0000
204.90.88.30,<->,50.224.75.114,0,0,1,988,1,988,0.936827000,0.0000
199.50.173.206,<->,136.25.188.199,0,0,1,781,1,781,0.936132000,0.0000
215.158.238.92,<->,111.150.187.55,1,1165,0,0,1,1165,0.936060000,0.0000
109.222.195.52,<->,53.69.81.44,1,125,0,0,1,125,0.935886000,0.0000
142.228.169.94,<->,136.25.188.55,0,0,1,270,1,270,0.935618000,0.0000
194.233.59.40,<->,136.25.188.174,0,0,1,871,1,871,0.935427000,0.0000
199.69.238.231,<->,136.25.188.198,0,0,1,749,1,749,0.934612000,0.0000
215.158.238.140,<->,30.249.194.149,1,1053,0,0,1,1053,0.934536000,0.0000
215.158.239.93,<->,199.15.120.211,1,516,0,0,1,516,0.933620000,0.0000
144.85.170.248,<->,98.87.144.220,1,789,0,0,1,789,0.933537000,0.0000
144.85.170.254,<->,80.30.20.95,1,395,0,0,1,395,0.933091000,0.0000
136.25.188.178,<->,59.158.77.214,1,93,0,0,1,93,0.933010000,0.0000
215.158.238.9,<->,198.204.77.167,1,1309,0,0,1,1309,0.933001000,0.0000
207.61.42.201,<->,136.25.188.176,0,0,1,93,1,93,0.931701000,0.0000
136.25.188.225,<->,8.220.51.228,1,1309,0,0,1,1309,0.931312000,0.0000
220.39.233.38,<->,215.158.238.142,0,0,1,1149,1,1149,0.931301000,0.0000
134.6.77.156,<->,92.27.219.141,0,0,1,145,1,145,0.930785000,0.0000
224.250.64.90,<->,100.94.111.50,0,0,1,68,1,68,0.930446000,0.0000
110.16.211.248,<->,50.224.76.235,0,0,1,86,1,86,0.930343000,0.0000
233.225.68.219,<->,111.147.83.94,0,0,1,323,1,323,0.929870000,0.0000
215.158.238.113,<->,8.191.15.70,1,101,0,0,1,101,0.929613000,0.0000
215.158.239.70,<->,207.16.32.235,1,93,0,0,1,93,0.929415000,0.0000
155.219.88.62,<->,136.129.94.189,0,0,1,351,1,351,0.929344000,0.0000
17.27.56.184,<->,8.220.176.253,0,0,1,275,1,275,0.928469000,0.0000
145.185.206.51,<->,8.252.222.37,0,0,1,638,1,638,0.928206000,0.0000
199.39.120.46,<->,136.25.188.225,0,0,1,929,1,929,0.928076000,0.0000
129.225.135.203,<->,129.225.132.224,0,0,1,97,1,97,0.927834000,0.0000
193.53.171.7,<->,80.38.7.235,0,0,1,506,1,506,0.927825000,0.0000
215.158.238.82,<->,106.188.252.178,1,93,0,0,1,93,0.927700000,0.0000
50.136.222.83,<->,8.20.87.95,0,0,1,262,1,262,0.927288000,0.0000
215.158.239.113,<->,129.222.39.214,1,109,0,0,1,109,0.926488000,0.0000
133.178.226.7,<->,131.2.115.245,1,1341,0,0,1,1341,0.926414000,0.0000
215.158.238.223,<->,106.188.251.53,1,1389,0,0,1,1389,0.925970000,0.0000
98.212.218.241,<->,50.224.76.248,0,0,1,722,1,722,0.925894000,0.0000
158.192.3.5,<->,133.178.226.28,0,0,1,1181,1,1181,0.925744000,0.0000
133.178.227.14,<->,29.211.165.34,1,1293,0,0,1,1293,0.925608000,0.0000
148.55.210.192,<->,136.25.188.178,0,0,1,1357,1,1357,0.925604000,0.0000
101.70.96.205,<->,54.48.32.155,1,836,0,0,1,836,0.925569000,0.0000
215.158.239.49,<->,97.243.113.59,1,1229,0,0,1,1229,0.925183000,0.0000
215.158.239.232,<->,144.22.87.63,1,1093,0,0,1,1093,0.925079000,0.0000
145.176.8.235,<->,6.74.197.79,0,0,1,283,1,283,0.924917000,0.0000
215.158.238.133,<->,149.96.53.42,1,1341,0,0,1,1341,0.924910000,0.0000
50.224.76.235,<->,6.73.186.38,1,267,0,0,1,267,0.924848000,0.0000
215.158.238.196,<->,106.188.245.22,1,1177,0,0,1,1177,0.924843000,0.0000
210.229.230.22,<->,35.63.66.82,1,68,0,0,1,68,0.924769000,0.0000
215.158.239.79,<->,199.20.31.18,1,101,0,0,1,101,0.924645000,0.0000
215.158.239.113,<->,129.222.36.103,1,1209,0,0,1,1209,0.924552000,0.0000
205.127.108.113,<->,101.224.89.208,0,0,1,1263,1,1263,0.923900000,0.0000
120.154.99.74,<->,8.252.222.204,0,0,1,1149,1,1149,0.923745000,0.0000
53.148.22.108,<->,35.41.132.79,0,0,1,125,1,125,0.923719000,0.0000
215.158.238.148,<->,80.47.228.219,1,1341,0,0,1,1341,0.923618000,0.0000
136.129.94.157,<->,6.145.165.55,1,414,0,0,1,414,0.923549000,0.0000
195.78.220.158,<->,50.224.76.235,0,0,1,982,1,982,0.923425000,0.0000
199.33.84.183,<->,136.25.188.236,0,0,1,252,1,252,0.923413000,0.0000
215.158.239.78,<->,140.218.109.107,1,1213,0,0,1,1213,0.921746000,0.0000
215.158.61.202,<->,8.176.8.178,0,0,1,573,1,573,0.921579000,0.0000
196.119.218.20,<->,92.27.194.147,0,0,1,246,1,246,0.921493000,0.0000
199.121.240.240,<->,136.25.188.163,0,0,1,765,1,765,0.921251000,0.0000
109.1.18.191,<->,100.124.212.156,1,337,0,0,1,337,0.920423000,0.0000
215.158.61.145,<->,8.176.8.210,0,0,1,1388,1,1388,0.920110000,0.0000
215.158.239.68,<->,142.227.64.172,1,209,0,0,1,209,0.919825000,0.0000
112.28.164.193,<->,92.168.217.181,0,0,1,784,1,784,0.919420000,0.0000
99.175.119.121,<->,53.149.20.33,1,125,0,0,1,125,0.919383000,0.0000
215.158.238.120,<->,158.253.43.167,1,1181,0,0,1,1181,0.919318000,0.0000
136.18.144.220,<->,8.182.226.78,0,0,1,577,1,577,0.919266000,0.0000
136.25.188.237,<->,8.50.236.136,1,1309,0,0,1,1309,0.918352000,0.0000
144.85.170.244,<->,111.38.251.144,1,748,0,0,1,748,0.918123000,0.0000
80.40.43.190,<->,8.45.175.127,1,433,0,0,1,433,0.917765000,0.0000
133.178.227.2,<->,133.56.180.91,1,1259,0,0,1,1259,0.917652000,0.0000
158.166.175.187,<->,136.25.189.1,0,0,1,1197,1,1197,0.917408000,0.0000
195.14.224.37,<->,136.25.188.160,0,0,1,765,1,765,0.917148000,0.0000
207.2.112.219,<->,8.20.87.153,0,0,1,965,1,965,0.917130000,0.0000
215.158.239.49,<->,142.253.109.23,1,672,0,0,1,672,0.916783000,0.0000
215.158.239.30,<->,158.166.175.250,1,101,0,0,1,101,0.916333000,0.0000
215.158.238.196,<->,148.190.124.22,1,133,0,0,1,133,0.916294000,0.0000
204.200.59.77,<->,136.25.188.253,0,0,1,132,1,132,0.916123000,0.0000
215.158.239.33,<->,137.129.85.91,1,1140,0,0,1,1140,0.915963000,0.0000
215.158.239.18,<->,158.166.175.235,1,1500,0,0,1,1500,0.915939000,0.0000
53.239.75.116,<->,8.228.215.8,0,0,1,257,1,257,0.915808000,0.0000
215.158.238.95,<->,206.103.215.57,1,1021,0,0,1,1021,0.915688000,0.0000
127.255.90.89,<->,92.162.253.155,0,0,1,290,1,290,0.915619000,0.0000
17.245.1.120,<->,8.220.239.104,0,0,1,75,1,75,0.915560000,0.0000
215.158.239.71,<->,113.23.14.217,1,1373,0,0,1,1373,0.915319000,0.0000
215.158.238.74,<->,126.219.60.202,1,1293,0,0,1,1293,0.915137000,0.0000
133.178.226.80,<->,8.191.15.4,1,1197,0,0,1,1197,0.915054000,0.0000
215.158.239.79,<->,199.20.29.115,1,765,0,0,1,765,0.914819000,0.0000
215.158.239.68,<->,195.40.143.22,1,793,0,0,1,793,0.914656000,0.0000
99.162.75.124,<->,53.214.102.249,1,465,0,0,1,465,0.914559000,0.0000
142.248.105.238,<->,136.25.188.252,0,0,1,75,1,75,0.914173000,0.0000
141.84.51.10,<->,8.252.221.205,0,0,1,454,1,454,0.913387000,0.0000
143.155.227.57,<->,136.25.188.237,0,0,1,1389,1,1389,0.912959000,0.0000
215.158.238.251,<->,48.129.132.249,1,1309,0,0,1,1309,0.912826000,0.0000
157.84.49.220,<->,92.181.196.31,0,0,1,63,1,63,0.912288000,0.0000
148.184.48.93,<->,91.231.195.147,0,0,1,642,1,642,0.911944000,0.0000
221.102.56.69,<->,6.74.93.51,0,0,1,294,1,294,0.911643000,0.0000
215.158.239.99,<->,199.20.29.24,1,632,0,0,1,632,0.911603000,0.0000
100.161.107.233,<->,100.93.168.223,0,0,1,97,1,97,0.911452000,0.0000
215.158.238.81,<->,80.47.111.107,1,1277,0,0,1,1277,0.910991000,0.0000
136.25.189.42,<->,100.216.78.145,1,89,0,0,1,89,0.910895000,0.0000
200.174.7.150,<->,50.145.3.84,1,129,0,0,1,129,0.910582000,0.0000
223.120.101.156,<->,8.252.222.162,0,0,1,141,1,141,0.910437000,0.0000
215.158.127.59,<->,8.176.8.85,0,0,1,698,1,698,0.910243000,0.0000
199.12.99.193,<->,8.252.222.237,0,0,1,1119,1,1119,0.910227000,0.0000
80.40.109.15,<->,8.55.211.213,1,294,0,0,1,294,0.910099000,0.0000
215.158.238.135,<->,8.191.6.217,1,1245,0,0,1,1245,0.910079000,0.0000
8.252.223.153,<->,8.219.184.100,1,1102,0,0,1,1102,0.909606000,0.0000
220.43.27.91,<->,145.19.9.106,0,0,1,77,1,77,0.909554000,0.0000
133.178.227.50,<->,8.252.210.251,1,1302,0,0,1,1302,0.909295000,0.0000
50.224.76.234,<->,48.129.152.119,1,430,0,0,1,430,0.908593000,0.0000
235.42.34.11,<->,215.158.238.93,0,0,1,1053,1,1053,0.908582000,0.0000
215.158.238.100,<->,8.240.148.59,1,109,0,0,1,109,0.908503000,0.0000
199.15.166.72,<->,136.25.188.160,0,0,1,593,1,593,0.908160000,0.0000
204.58.63.91,<->,136.25.188.198,0,0,1,893,1,893,0.908081000,0.0000
111.199.227.182,<->,0.195.210.44,0,0,1,136,1,136,0.908075000,0.0000
133.178.226.200,<->,65.26.114.236,1,152,0,0,1,152,0.908006000,0.0000
53.148.184.48,<->,48.54.120.23,0,0,1,938,1,938,0.907878000,0.0000
136.25.188.198,<->,8.222.7.55,1,1382,0,0,1,1382,0.907762000,0.0000
220.28.73.211,<->,136.25.188.192,0,0,1,659,1,659,0.907737000,0.0000
213.186.52.50,<->,144.85.170.254,0,0,1,729,1,729,0.907554000,0.0000
215.158.238.233,<->,111.151.142.235,1,100,0,0,1,100,0.907448000,0.0000
215.158.239.86,<->,204.123.232.197,1,1229,0,0,1,1229,0.907090000,0.0000
215.158.239.77,<->,196.108.88.245,1,586,0,0,1,586,0.906546000,0.0000
136.25.188.174,<->,41.142.21.110,1,157,0,0,1,157,0.906297000,0.0000
215.158.239.59,<->,141.199.76.240,1,1357,0,0,1,1357,0.906230000,0.0000
139.163.26.146,<->,136.91.153.222,1,99,0,0,1,99,0.905339000,0.0000
215.158.238.32,<->,111.150.34.250,1,1181,0,0,1,1181,0.905277000,0.0000
136.25.189.13,<->,56.28.207.192,1,1485,0,0,1,1485,0.905094000,0.0000
242.21.107.132,<->,139.193.141.139,0,0,1,315,1,315,0.904964000,0.0000
215.158.238.134,<->,113.23.117.107,1,1341,0,0,1,1341,0.904768000,0.0000
27.118.95.205,<->,8.52.245.115,0,0,1,87,1,87,0.904622000,0.0000
129.236.120.197,<->,101.120.23.64,0,0,1,497,1,497,0.904416000,0.0000
224.213.229.102,<->,109.222.200.21,0,0,1,843,1,843,0.904219000,0.0000
224.148.1.28,<->,210.231.140.55,1,868,0,0,1,868,0.903850000,0.0000
143.74.137.76,<->,8.252.222.161,0,0,1,765,1,765,0.903511000,0.0000
133.178.227.57,<->,104.154.137.243,1,1136,0,0,1,1136,0.903422000,0.0000
215.158.61.191,<->,8.176.8.224,0,0,1,461,1,461,0.903025000,0.0000
54.50.95.107,<->,8.228.219.34,0,0,1,410,1,410,0.902761000,0.0000
220.38.238.41,<->,133.178.227.40,0,0,1,1146,1,1146,0.902135000,0.0000
110.65.7.153,<->,89.183.104.131,0,0,1,580,1,580,0.901907000,0.0000
215.158.238.177,<->,8.220.54.227,1,1197,0,0,1,1197,0.901774000,0.0000
144.87.238.89,<->,8.182.227.233,0,0,1,528,1,528,0.901520000,0.0000
193.64.253.32,<->,109.222.192.144,0,0,1,829,1,829,0.901295000,0.0000
215.158.239.71,<->,57.31.51.245,1,1181,0,0,1,1181,0.901157000,0.0000
80.27.153.42,<->,66.195.157.130,1,833,0,0,1,833,0.901000000,0.0000
136.25.188.80,<->,111.151.106.254,1,100,0,0,1,100,0.900831000,0.0000
215.158.239.97,<->,195.49.106.73,1,602,0,0,1,602,0.900623000,0.0000
144.85.170.208,<->,91.69.185.186,1,784,0,0,1,784,0.900435000,0.0000
126.198.149.124,<->,102.51.52.218,0,0,1,341,1,341,0.900421000,0.0000
50.224.76.248,<->,42.34.255.152,1,823,0,0,1,823,0.900274000,0.0000
92.27.219.189,<->,33.57.78.94,1,50,0,0,1,50,0.898730000,0.0000
215.158.239.87,<->,195.80.82.72,1,282,0,0,1,282,0.898347000,0.0000
215.158.140.231,<->,130.13.228.203,1,1138,0,0,1,1138,0.898280000,0.0000
215.158.140.74,<->,26.218.209.9,1,645,0,0,1,645,0.897778000,0.0000
136.25.188.253,<->,114.25.48.63,1,1229,0,0,1,1229,0.897608000,0.0000
215.158.239.79,<->,194.232.14.77,1,602,0,0,1,602,0.897506000,0.0000
159.70.47.29,<->,144.86.146.31,0,0,1,1114,1,1114,0.897467000,0.0000
195.55.64.153,<->,136.25.188.222,0,0,1,781,1,781,0.897367000,0.0000
215.158.238.67,<->,8.191.6.101,1,1245,0,0,1,1245,0.897199000,0.0000
133.178.226.215,<->,6.29.108.74,1,772,0,0,1,772,0.897118000,0.0000
48.131.159.4,<->,8.252.223.130,0,0,1,1133,1,1133,0.897060000,0.0000
42.230.95.115,<->,39.248.89.73,0,0,1,93,1,93,0.896948000,0.0000
133.32.39.8,<->,111.150.207.168,1,100,0,0,1,100,0.896857000,0.0000
143.13.34.41,<->,136.25.188.209,0,0,1,315,1,315,0.896650000,0.0000
215.158.239.87,<->,199.20.29.203,1,272,0,0,1,272,0.896416000,0.0000
133.178.226.30,<->,128.110.138.182,1,1069,0,0,1,1069,0.896353000,0.0000
215.158.239.18,<->,113.86.1.52,1,105,0,0,1,105,0.895031000,0.0000
142.249.56.74,<->,136.25.188.222,0,0,1,89,1,89,0.894619000,0.0000
215.158.238.33,<->,113.23.104.213,1,93,0,0,1,93,0.894520000,0.0000
221.102.56.69,<->,192.65.178.170,0,0,1,294,1,294,0.893425000,0.0000
215.158.238.113,<->,29.211.186.199,1,1341,0,0,1,1341,0.893300000,0.0000
97.126.24.188,<->,50.239.27.120,1,269,0,0,1,269,0.892987000,0.0000
17.30.176.93,<->,8.220.206.230,0,0,1,234,1,234,0.892975000,0.0000
215.158.239.32,<->,8.190.216.229,1,1330,0,0,1,1330,0.892908000,0.0000
215.158.238.82,<->,113.23.104.223,1,1181,0,0,1,1181,0.892507000,0.0000
215.158.239.4,<->,8.255.92.83,1,1096,0,0,1,1096,0.892312000,0.0000
133.178.226.245,<->,111.151.109.35,1,100,0,0,1,100,0.891989000,0.0000
215.158.239.69,<->,29.214.73.151,1,1293,0,0,1,1293,0.891963000,0.0000
215.158.239.97,<->,199.20.29.7,1,378,0,0,1,378,0.891687000,0.0000
215.158.238.95,<->,136.139.59.106,1,1309,0,0,1,1309,0.891396000,0.0000
133.178.227.41,<->,29.214.69.233,1,1112,0,0,1,1112,0.891257000,0.0000
139.160.226.212,<->,136.25.189.57,0,0,1,1357,1,1357,0.891238000,0.0000
221.102.154.17,<->,192.64.236.238,0,0,1,141,1,141,0.891117000,0.0000
215.158.239.56,<->,194.237.186.85,1,332,0,0,1,332,0.890922000,0.0000
136.25.189.15,<->,27.22.184.84,1,1213,0,0,1,1213,0.890758000,0.0000
221.163.96.13,<->,80.41.23.81,0,0,1,104,1,104,0.890604000,0.0000
207.57.180.6,<->,136.25.188.46,0,0,1,669,1,669,0.890207000,0.0000
112.208.20.152,<->,111.146.164.226,0,0,1,191,1,191,0.889931000,0.0000
215.158.239.49,<->,199.20.31.92,1,93,0,0,1,93,0.889905000,0.0000
50.224.76.235,<->,0.159.34.250,1,519,0,0,1,519,0.889880000,0.0000
215.158.239.86,<->,199.20.31.92,1,93,0,0,1,93,0.889870000,0.0000
204.62.41.84,<->,136.25.188.196,0,0,1,93,1,93,0.889640000,0.0000
215.158.238.81,<->,197.125.108.20,1,1373,0,0,1,1373,0.889332000,0.0000
215.158.238.133,<->,104.3.168.149,1,1341,0,0,1,1341,0.889288000,0.0000
215.158.239.51,<->,199.20.5.41,1,250,0,0,1,250,0.889281000,0.0000
80.40.34.240,<->,50.248.185.204,1,353,0,0,1,353,0.889062000,0.0000
195.22.22.252,<->,50.224.76.234,0,0,1,953,1,953,0.889059000,0.0000
223.115.143.166,<->,8.252.221.237,0,0,1,634,1,634,0.889013000,0.0000
53.201.200.21,<->,48.55.88.154,0,0,1,63,1,63,0.889007000,0.0000
202.33.33.176,<->,136.25.188.240,0,0,1,93,1,93,0.888906000,0.0000
215.158.239.85,<->,122.52.97.61,1,1245,0,0,1,1245,0.888745000,0.0000
215.158.43.138,<->,133.178.227.119,0,0,1,93,1,93,0.888323000,0.0000
213.186.61.87,<->,144.85.170.254,0,0,1,749,1,749,0.888043000,0.0000
136.25.188.46,<->,122.159.245.165,1,1133,0,0,1,1133,0.888030000,0.0000
144.85.170.208,<->,91.69.181.170,1,763,0,0,1,763,0.887894000,0.0000
215.158.238.105,<->,115.157.30.33,1,1197,0,0,1,1197,0.887775000,0.0000
198.183.68.172,<->,92.27.219.230,0,0,1,146,1,146,0.886126000,0.0000
220.28.114.28,<->,133.178.226.55,0,0,1,516,1,516,0.885937000,0.0000
139.163.26.146,<->,113.123.210.253,1,111,0,0,1,111,0.885906000,0.0000
215.158.239.76,<->,149.254.114.243,1,1357,0,0,1,1357,0.885475000,0.0000
220.55.113.152,<->,92.27.131.90,1,211,0,0,1,211,0.885329000,0.0000
215.158.238.148,<->,126.219.190.117,1,1229,0,0,1,1229,0.885059000,0.0000
133.178.227.41,<->,131.219.230.192,1,1389,0,0,1,1389,0.884098000,0.0000
136.25.188.253,<->,72.23.194.203,1,1229,0,0,1,1229,0.883917000,0.0000
215.158.238.75,<->,148.55.210.235,1,1341,0,0,1,1341,0.883898000,0.0000
196.246.191.34,<->,136.25.188.177,0,0,1,190,1,190,0.883296000,0.0000
215.158.239.71,<->,33.209.219.124,1,1197,0,0,1,1197,0.883111000,0.0000
129.236.115.197,<->,111.20.168.123,0,0,1,377,1,377,0.882502000,0.0000
215.158.238.66,<->,198.204.76.255,1,93,0,0,1,93,0.882279000,0.0000
215.158.140.172,<->,8.190.216.244,1,916,0,0,1,916,0.882187000,0.0000
204.35.170.185,<->,50.224.76.230,0,0,1,895,1,895,0.882155000,0.0000
215.158.239.94,<->,130.150.82.120,1,1325,0,0,1,1325,0.882145000,0.0000
249.101.227.24,<->,127.157.237.188,1,556,0,0,1,556,0.881829000,0.0000
215.158.140.231,<->,197.133.247.180,1,1392,0,0,1,1392,0.881643000,0.0000
215.158.238.141,<->,42.226.3.118,1,1261,0,0,1,1261,0.880258000,0.0000
215.158.238.104,<->,143.155.227.57,1,1101,0,0,1,1101,0.879925000,0.0000
215.158.238.73,<->,104.3.161.84,1,1229,0,0,1,1229,0.879453000,0.0000
215.158.238.115,<->,215.158.42.151,1,101,0,0,1,101,0.879045000,0.0000
215.158.238.99,<->,149.96.53.40,1,1213,0,0,1,1213,0.878885000,0.0000
210.220.219.179,<->,8.232.198.216,1,242,0,0,1,242,0.878876000,0.0000
136.25.189.13,<->,29.211.5.69,1,1325,0,0,1,1325,0.878579000,0.0000
194.232.229.200,<->,136.25.188.173,0,0,1,307,1,307,0.878364000,0.0000
6.145.169.8,<->,0.195.210.44,0,0,1,87,1,87,0.878187000,0.0000
232.31.192.215,<->,97.198.118.56,0,0,1,398,1,398,0.878165000,0.0000
143.155.227.58,<->,136.25.188.225,0,0,1,1085,1,1085,0.877652000,0.0000
243.117.93.179,<->,80.38.62.152,0,0,1,1040,1,1040,0.877310000,0.0000
215.158.238.73,<->,112.220.206.22,1,1229,0,0,1,1229,0.876487000,0.0000
215.158.238.96,<->,192.227.190.244,1,293,0,0,1,293,0.876026000,0.0000
95.245.200.203,<->,8.252.221.199,0,0,1,270,1,270,0.875357000,0.0000
210.229.230.18,<->,122.245.128.236,1,68,0,0,1,68,0.875042000,0.0000
249.229.107.171,<->,8.52.142.49,0,0,1,1201,1,1201,0.873868000,0.0000
111.20.168.123,<->,92.160.9.244,1,580,0,0,1,580,0.873135000,0.0000
204.200.42.156,<->,136.25.188.209,0,0,1,472,1,472,0.872844000,0.0000
148.88.91.35,<->,139.193.141.139,0,0,1,578,1,578,0.872759000,0.0000
50.224.76.235,<->,0.241.13.184,1,1275,0,0,1,1275,0.872566000,0.0000
136.25.188.161,<->,29.213.218.232,1,1165,0,0,1,1165,0.872263000,0.0000
215.158.238.104,<->,143.155.227.54,1,1149,0,0,1,1149,0.871789000,0.0000
58.202.212.54,<->,50.224.76.234,0,0,1,686,1,686,0.871731000,0.0000
215.158.239.79,<->,207.191.178.156,1,456,0,0,1,456,0.871338000,0.0000
133.178.226.198,<->,125.84.55.74,1,152,0,0,1,152,0.871156000,0.0000
215.158.238.74,<->,133.73.194.9,1,1341,0,0,1,1341,0.870738000,0.0000
133.178.227.251,<->,29.212.207.49,1,240,0,0,1,240,0.870535000,0.0000
8.220.176.253,<->,6.101.63.48,1,488,0,0,1,488,0.870332000,0.0000
215.158.239.50,<->,61.35.124.182,1,1197,0,0,1,1197,0.870313000,0.0000
215.158.238.251,<->,155.197.206.245,1,1056,0,0,1,1056,0.870177000,0.0000
206.55.134.66,<->,80.42.140.207,0,0,1,121,1,121,0.870165000,0.0000
215.158.238.66,<->,148.55.210.231,1,1341,0,0,1,1341,0.870065000,0.0000
133.178.227.2,<->,8.53.217.99,1,1222,0,0,1,1222,0.869655000,0.0000
215.158.238.120,<->,141.23.229.105,1,1341,0,0,1,1341,0.869263000,0.0000
215.158.239.35,<->,118.20.114.90,1,1464,0,0,1,1464,0.868935000,0.0000
69.103.113.149,<->,8.252.222.134,0,0,1,785,1,785,0.868934000,0.0000
215.158.238.112,<->,106.188.252.233,1,1373,0,0,1,1373,0.868610000,0.0000
215.158.146.244,<->,8.252.223.120,0,0,1,227,1,227,0.868373000,0.0000
215.158.238.241,<->,119.168.0.234,1,1107,0,0,1,1107,0.868366000,0.0000
192.67.172.34,<->,100.124.212.246,1,75,0,0,1,75,0.868111000,0.0000
133.178.226.37,<->,122.158.49.131,1,309,0,0,1,309,0.867987000,0.0000
215.158.238.73,<->,106.188.183.73,1,122,0,0,1,122,0.867939000,0.0000
199.52.130.58,<->,136.25.188.176,0,0,1,93,1,93,0.867890000,0.0000
215.158.239.34,<->,96.135.154.101,1,87,0,0,1,87,0.867716000,0.0000
215.158.140.229,<->,104.3.168.150,1,1368,0,0,1,1368,0.867163000,0.0000
136.181.50.197,<->,106.176.67.97,1,112,0,0,1,112,0.866471000,0.0000
206.103.215.40,<->,136.25.189.45,0,0,1,1437,1,1437,0.866458000,0.0000
215.158.238.148,<->,126.219.132.243,1,1197,0,0,1,1197,0.865754000,0.0000
139.163.26.146,<->,104.189.27.196,1,157,0,0,1,157,0.865639000,0.0000
207.61.137.58,<->,136.25.188.53,0,0,1,701,1,701,0.864879000,0.0000
215.158.234.105,<->,137.137.116.117,0,0,1,707,1,707,0.864619000,0.0000
195.55.64.153,<->,136.25.188.45,0,0,1,781,1,781,0.864416000,0.0000
53.161.180.137,<->,48.55.163.98,0,0,1,181,1,181,0.864073000,0.0000
206.141.194.98,<->,97.126.13.85,0,0,1,58,1,58,0.864045000,0.0000
215.158.238.45,<->,122.216.233.104,1,1197,0,0,1,1197,0.863092000,0.0000
215.158.239.94,<->,199.20.29.153,1,632,0,0,1,632,0.862171000,0.0000
215.158.238.90,<->,100.224.166.163,1,506,0,0,1,506,0.861749000,0.0000
215.158.239.56,<->,195.126.170.210,1,101,0,0,1,101,0.861244000,0.0000
128.156.85.146,<->,8.176.8.208,0,0,1,100,1,100,0.861145000,0.0000
215.158.239.57,<->,199.20.29.100,1,172,0,0,1,172,0.860772000,0.0000
215.158.238.106,<->,140.174.80.153,1,1245,0,0,1,1245,0.860360000,0.0000
215.158.239.97,<->,142.236.92.15,1,602,0,0,1,602,0.860195000,0.0000
133.135.213.14,<->,129.6.83.11,0,0,1,1173,1,1173,0.859978000,0.0000
215.158.238.107,<->,148.217.121.141,1,1197,0,0,1,1197,0.859649000,0.0000
204.184.96.13,<->,136.25.188.178,0,0,1,93,1,93,0.859643000,0.0000
223.114.173.152,<->,8.252.221.222,0,0,1,336,1,336,0.859391000,0.0000
249.101.106.195,<->,220.28.65.25,1,109,0,0,1,109,0.859209000,0.0000
215.158.239.96,<->,199.20.6.78,1,101,0,0,1,101,0.859140000,0.0000
143.132.80.71,<->,136.25.188.175,0,0,1,146,1,146,0.859046000,0.0000
136.25.188.172,<->,113.23.104.221,1,1261,0,0,1,1261,0.858370000,0.0000
136.25.188.179,<->,113.23.104.247,1,1229,0,0,1,1229,0.858145000,0.0000
197.113.99.197,<->,136.25.188.242,0,0,1,132,1,132,0.857703000,0.0000
215.158.238.221,<->,131.219.110.180,1,1056,0,0,1,1056,0.857504000,0.0000
220.20.200.37,<->,144.83.60.153,1,75,0,0,1,75,0.857415000,0.0000
215.158.239.222,<->,215.158.61.243,1,378,0,0,1,378,0.857409000,0.0000
109.222.231.242,<->,54.51.151.171,1,241,0,0,1,241,0.857317000,0.0000
136.25.188.173,<->,48.129.133.47,1,1325,0,0,1,1325,0.857165000,0.0000
215.158.238.66,<->,0.34.21.19,1,1181,0,0,1,1181,0.857011000,0.0000
203.114.93.245,<->,136.25.188.174,0,0,1,1005,1,1005,0.856965000,0.0000
144.87.238.89,<->,8.182.251.151,0,0,1,566,1,566,0.856922000,0.0000
133.178.226.160,<->,111.151.107.208,1,100,0,0,1,100,0.856717000,0.0000
215.158.140.76,<->,131.219.230.225,1,1044,0,0,1,1044,0.856490000,0.0000
136.25.189.31,<->,96.156.169.168,1,186,0,0,1,186,0.856365000,0.0000
246.253.168.231,<->,29.249.228.84,1,85,0,0,1,85,0.856095000,0.0000
195.14.13.180,<->,136.25.188.177,0,0,1,284,1,284,0.856046000,0.0000
215.158.238.243,<->,131.219.110.137,1,1373,0,0,1,1373,0.855928000,0.0000
215.158.239.94,<->,204.2.105.75,1,305,0,0,1,305,0.855675000,0.0000
215.158.238.121,<->,93.156.41.103,1,149,0,0,1,149,0.855324000,0.0000
133.178.227.1,<->,8.191.14.88,1,1111,0,0,1,1111,0.855090000,0.0000
231.143.200.156,<->,136.25.188.52,0,0,1,1052,1,1052,0.854979000,0.0000
215.158.239.99,<->,199.20.28.29,1,632,0,0,1,632,0.854567000,0.0000
200.175.141.134,<->,54.59.66.233,1,515,0,0,1,515,0.854382000,0.0000
133.178.226.227,<->,8.47.189.8,1,621,0,0,1,621,0.854017000,0.0000
229.45.200.94,<->,27.158.122.184,1,427,0,0,1,427,0.853778000,0.0000
142.239.121.87,<->,133.178.226.49,0,0,1,1325,1,1325,0.853473000,0.0000
144.85.170.244,<->,17.42.178.222,1,835,0,0,1,835,0.853362000,0.0000
136.181.47.216,<->,53.190.247.74,1,93,0,0,1,93,0.853154000,0.0000
142.228.78.231,<->,136.25.188.208,0,0,1,853,1,853,0.852991000,0.0000
129.78.116.160,<->,92.162.219.10,1,607,0,0,1,607,0.852567000,0.0000
215.158.140.204,<->,133.20.250.202,1,192,0,0,1,192,0.852387000,0.0000
200.175.245.4,<->,53.167.66.5,1,508,0,0,1,508,0.851880000,0.0000
215.158.238.123,<->,143.14.191.92,1,1229,0,0,1,1229,0.851357000,0.0000
215.158.239.94,<->,199.20.31.45,1,1125,0,0,1,1125,0.850899000,0.0000
215.158.239.17,<->,80.57.141.220,1,1302,0,0,1,1302,0.850896000,0.0000
6.145.168.153,<->,0.195.210.44,0,0,1,87,1,87,0.850647000,0.0000
136.25.188.161,<->,6.116.31.20,1,1373,0,0,1,1373,0.850483000,0.0000
215.158.238.141,<->,128.23.84.234,1,1117,0,0,1,1117,0.849878000,0.0000
215.158.239.34,<->,8.252.214.212,1,293,0,0,1,293,0.849714000,0.0000
158.253.43.168,<->,133.178.226.18,0,0,1,1197,1,1197,0.849542000,0.0000
215.158.238.75,<->,143.227.65.157,1,1293,0,0,1,1293,0.849390000,0.0000
215.158.238.66,<->,158.192.3.223,1,1373,0,0,1,1373,0.848843000,0.0000
215.158.61.191,<->,8.176.8.178,0,0,1,1421,1,1421,0.848495000,0.0000
192.65.118.85,<->,8.45.162.111,1,87,0,0,1,87,0.848451000,0.0000
210.229.230.22,<->,100.107.158.124,1,68,0,0,1,68,0.848140000,0.0000
133.178.226.201,<->,113.23.114.107,1,152,0,0,1,152,0.847252000,0.0000
215.158.238.221,<->,106.188.251.56,1,1085,0,0,1,1085,0.847201000,0.0000
247.136.177.126,<->,141.46.197.44,1,1251,0,0,1,1251,0.847071000,0.0000
136.25.189.57,<->,8.47.120.154,1,1341,0,0,1,1341,0.847006000,0.0000
126.198.149.124,<->,100.95.250.35,0,0,1,345,1,345,0.846813000,0.0000
133.178.226.37,<->,118.20.114.94,1,1357,0,0,1,1357,0.846686000,0.0000
143.68.193.3,<->,136.25.188.220,0,0,1,85,1,85,0.846582000,0.0000
133.178.226.60,<->,57.210.104.163,1,1053,0,0,1,1053,0.845774000,0.0000
195.4.113.29,<->,136.25.188.220,0,0,1,685,1,685,0.845663000,0.0000
221.102.56.69,<->,6.74.255.56,0,0,1,294,1,294,0.845651000,0.0000
215.158.239.49,<->,196.108.8.45,1,101,0,0,1,101,0.845326000,0.0000
215.158.238.92,<->,119.168.0.138,1,1341,0,0,1,1341,0.845272000,0.0000
144.85.170.208,<->,98.87.124.2,1,697,0,0,1,697,0.845224000,0.0000
215.158.238.82,<->,106.188.183.98,1,134,0,0,1,134,0.844822000,0.0000
99.72.115.232,<->,8.55.211.213,1,294,0,0,1,294,0.844419000,0.0000
111.146.149.244,<->,53.149.29.29,1,125,0,0,1,125,0.844034000,0.0000
235.253.220.227,<->,215.158.238.54,0,0,1,1421,1,1421,0.843945000,0.0000
221.102.143.189,<->,80.41.80.157,0,0,1,141,1,141,0.843740000,0.0000
101.70.96.248,<->,54.42.184.216,1,291,0,0,1,291,0.843636000,0.0000
215.158.238.133,<->,148.129.19.107,1,1213,0,0,1,1213,0.843546000,0.0000
215.158.238.133,<->,131.2.115.252,1,1309,0,0,1,1309,0.843311000,0.0000
143.155.227.57,<->,133.178.226.31,0,0,1,1373,1,1373,0.842919000,0.0000
204.186.92.108,<->,136.25.188.236,0,0,1,93,1,93,0.842793000,0.0000
204.21.75.114,<->,136.25.188.242,0,0,1,146,1,146,0.842370000,0.0000
136.25.188.224,<->,113.23.104.247,1,1085,0,0,1,1085,0.841940000,0.0000
136.25.189.30,<->,125.84.55.22,1,1229,0,0,1,1229,0.841748000,0.0000
216.38.40.208,<->,145.116.118.116,0,0,1,651,1,651,0.841716000,0.0000
144.90.91.85,<->,92.27.219.163,0,0,1,66,1,66,0.841704000,0.0000
215.158.61.145,<->,136.25.189.209,0,0,1,399,1,399,0.841626000,0.0000
215.158.238.47,<->,206.103.215.202,1,1373,0,0,1,1373,0.841592000,0.0000
215.158.238.66,<->,69.150.169.224,1,1261,0,0,1,1261,0.841514000,0.0000
99.187.125.121,<->,8.20.87.11,0,0,1,510,1,510,0.841301000,0.0000
133.178.227.245,<->,8.61.93.39,1,477,0,0,1,477,0.841191000,0.0000
215.158.239.154,<->,111.151.237.171,1,785,0,0,1,785,0.840935000,0.0000
133.178.226.30,<->,93.190.35.178,1,1085,0,0,1,1085,0.840901000,0.0000
215.158.238.149,<->,38.104.11.118,1,1229,0,0,1,1229,0.840827000,0.0000
111.147.249.144,<->,50.145.213.17,1,75,0,0,1,75,0.840712000,0.0000
215.158.238.140,<->,149.184.89.21,1,1293,0,0,1,1293,0.840582000,0.0000
215.158.61.191,<->,8.176.8.183,0,0,1,1197,1,1197,0.840360000,0.0000
215.158.238.106,<->,8.189.240.232,1,1261,0,0,1,1261,0.840287000,0.0000
215.158.239.79,<->,199.20.30.172,1,190,0,0,1,190,0.840046000,0.0000
133.178.227.61,<->,100.216.78.145,1,407,0,0,1,407,0.839795000,0.0000
215.158.238.223,<->,48.131.157.3,1,1213,0,0,1,1213,0.839631000,0.0000
148.21.212.171,<->,136.25.189.81,0,0,1,1341,1,1341,0.839070000,0.0000
215.158.239.58,<->,142.247.210.117,1,705,0,0,1,705,0.838873000,0.0000
111.181.118.201,<->,8.55.195.124,1,141,0,0,1,141,0.838229000,0.0000
215.158.238.95,<->,120.20.132.2,1,1405,0,0,1,1405,0.837940000,0.0000
221.102.56.69,<->,98.128.50.78,0,0,1,294,1,294,0.837759000,0.0000
249.101.194.239,<->,112.208.20.255,1,50,0,0,1,50,0.837662000,0.0000
215.158.239.85,<->,143.72.59.210,1,85,0,0,1,85,0.836759000,0.0000
215.158.239.87,<->,142.253.112.239,1,87,0,0,1,87,0.836346000,0.0000
231.255.190.2,<->,192.67.139.230,0,0,1,673,1,673,0.836122000,0.0000
136.25.188.225,<->,133.23.136.210,1,113,0,0,1,113,0.836111000,0.0000
142.227.194.228,<->,136.25.188.196,0,0,1,578,1,578,0.836048000,0.0000
144.85.170.208,<->,103.40.248.158,1,391,0,0,1,391,0.835875000,0.0000
215.158.239.76,<->,199.20.31.218,1,573,0,0,1,573,0.835708000,0.0000
210.229.230.22,<->,96.161.183.14,1,68,0,0,1,68,0.835258000,0.0000
204.184.91.6,<->,136.25.188.255,0,0,1,272,1,272,0.835166000,0.0000
215.158.239.76,<->,199.20.20.241,1,765,0,0,1,765,0.834818000,0.0000
215.158.238.103,<->,100.224.166.120,1,461,0,0,1,461,0.834759000,0.0000
215.158.238.96,<->,123.166.46.220,1,973,0,0,1,973,0.834731000,0.0000
158.253.43.167,<->,133.178.226.38,0,0,1,1341,1,1341,0.834622000,0.0000
144.83.60.153,<->,92.162.253.145,0,0,1,546,1,546,0.833832000,0.0000
215.158.239.69,<->,141.39.23.86,1,1325,0,0,1,1325,0.833825000,0.0000
129.224.112.252,<->,97.242.126.182,1,101,0,0,1,101,0.833513000,0.0000
204.187.18.61,<->,136.25.188.224,0,0,1,602,1,602,0.833079000,0.0000
97.11.170.243,<->,54.58.32.144,1,87,0,0,1,87,0.832938000,0.0000
199.69.24.204,<->,136.25.188.199,0,0,1,616,1,616,0.832714000,0.0000
142.167.108.163,<->,136.25.188.252,0,0,1,653,1,653,0.832553000,0.0000
92.168.217.209,<->,50.136.144.96,1,315,0,0,1,315,0.832438000,0.0000
235.42.35.86,<->,133.178.226.28,0,0,1,1069,1,1069,0.832436000,0.0000
136.25.189.89,<->,61.35.70.230,1,1373,0,0,1,1373,0.832312000,0.0000
210.231.140.55,<->,109.1.30.25,0,0,1,846,1,846,0.831870000,0.0000
204.58.218.182,<->,136.25.188.177,0,0,1,93,1,93,0.831377000,0.0000
100.124.212.156,<->,80.42.174.211,0,0,1,305,1,305,0.831287000,0.0000
215.158.61.242,<->,136.25.189.210,0,0,1,657,1,657,0.830923000,0.0000
215.158.239.79,<->,196.107.72.172,1,169,0,0,1,169,0.830888000,0.0000
136.25.188.237,<->,38.20.151.87,1,1181,0,0,1,1181,0.830843000,0.0000
148.31.106.171,<->,136.25.188.253,0,0,1,1213,1,1213,0.830743000,0.0000
210.209.251.211,<->,111.147.85.3,0,0,1,442,1,442,0.830392000,0.0000
133.178.226.77,<->,131.36.198.24,1,1213,0,0,1,1213,0.830330000,0.0000
198.42.206.19,<->,89.183.111.197,0,0,1,603,1,603,0.830220000,0.0000
50.97.188.57,<->,8.220.176.253,0,0,1,479,1,479,0.829595000,0.0000
113.127.245.199,<->,92.27.219.39,0,0,1,182,1,182,0.829581000,0.0000
199.80.3.106,<->,136.25.188.162,0,0,1,93,1,93,0.829578000,0.0000
136.25.188.144,<->,122.159.241.253,1,223,0,0,1,223,0.829307000,0.0000
91.41.83.140,<->,8.228.209.115,0,0,1,87,1,87,0.828612000,0.0000
129.224.112.252,<->,97.242.126.194,1,112,0,0,1,112,0.828280000,0.0000
215.158.238.93,<->,149.163.129.232,1,1213,0,0,1,1213,0.828193000,0.0000
215.158.140.76,<->,29.211.228.217,1,1048,0,0,1,1048,0.828019000,0.0000
195.15.191.220,<->,136.25.188.226,0,0,1,669,1,669,0.827577000,0.0000
215.158.238.223,<->,69.31.238.218,1,1405,0,0,1,1405,0.827465000,0.0000
215.158.239.49,<->,114.25.48.54,1,1229,0,0,1,1229,0.827338000,0.0000
215.158.238.89,<->,56.20.122.91,1,508,0,0,1,508,0.827174000,0.0000
220.28.114.28,<->,136.25.188.195,0,0,1,1315,1,1315,0.826808000,0.0000
50.224.76.235,<->,30.183.186.22,1,861,0,0,1,861,0.826335000,0.0000
143.128.136.139,<->,136.25.188.44,0,0,1,382,1,382,0.826130000,0.0000
136.25.189.78,<->,96.156.169.221,1,1293,0,0,1,1293,0.825936000,0.0000
215.158.239.28,<->,29.214.74.161,1,99,0,0,1,99,0.825600000,0.0000
159.109.250.48,<->,106.5.211.4,1,149,0,0,1,149,0.825587000,0.0000
109.214.186.222,<->,50.224.76.248,0,0,1,1365,1,1365,0.825480000,0.0000
148.16.160.84,<->,139.193.141.139,0,0,1,341,1,341,0.825327000,0.0000
17.156.124.197,<->,8.20.87.95,0,0,1,262,1,262,0.825309000,0.0000
133.178.227.1,<->,8.42.42.101,1,1101,0,0,1,1101,0.824858000,0.0000
133.135.213.65,<->,129.6.83.11,0,0,1,1201,1,1201,0.824760000,0.0000
215.158.239.84,<->,199.20.5.115,1,602,0,0,1,602,0.824422000,0.0000
136.25.189.77,<->,135.229.0.202,1,1357,0,0,1,1357,0.824206000,0.0000
199.82.75.107,<->,136.25.188.241,0,0,1,602,1,602,0.824119000,0.0000
215.158.238.113,<->,131.36.105.37,1,1106,0,0,1,1106,0.823874000,0.0000
192.64.217.166,<->,149.151.124.60,1,112,0,0,1,112,0.823836000,0.0000
136.25.189.28,<->,56.161.218.20,1,1277,0,0,1,1277,0.823743000,0.0000
92.162.253.223,<->,92.27.44.83,1,586,0,0,1,586,0.823642000,0.0000
136.25.188.194,<->,98.219.126.140,1,744,0,0,1,744,0.823455000,0.0000
229.45.205.24,<->,220.50.226.64,1,698,0,0,1,698,0.823187000,0.0000
92.162.253.204,<->,91.243.255.6,1,651,0,0,1,651,0.822793000,0.0000
215.158.61.183,<->,8.176.8.228,0,0,1,1421,1,1421,0.822721000,0.0000
215.158.238.106,<->,139.160.226.221,1,1181,0,0,1,1181,0.822498000,0.0000
239.227.66.217,<->,221.102.143.189,1,141,0,0,1,141,0.822477000,0.0000
229.65.17.196,<->,215.158.239.19,0,0,1,428,1,428,0.822325000,0.0000
215.158.238.82,<->,80.47.111.27,1,1229,0,0,1,1229,0.822306000,0.0000
215.158.238.198,<->,69.132.46.135,1,1405,0,0,1,1405,0.822156000,0.0000
215.158.239.40,<->,131.95.192.176,1,91,0,0,1,91,0.821932000,0.0000
215.158.239.40,<->,8.252.253.188,1,66,0,0,1,66,0.821830000,0.0000
215.158.238.135,<->,111.150.34.246,1,1373,0,0,1,1373,0.821629000,0.0000
133.178.226.38,<->,122.159.245.149,1,1213,0,0,1,1213,0.821486000,0.0000
145.208.183.77,<->,53.148.225.225,1,247,0,0,1,247,0.821387000,0.0000
215.158.239.79,<->,199.20.6.144,1,93,0,0,1,93,0.821347000,0.0000
210.220.157.79,<->,136.25.188.178,0,0,1,1373,1,1373,0.821135000,0.0000
202.33.226.132,<->,136.25.188.220,0,0,1,863,1,863,0.821081000,0.0000
136.25.188.46,<->,113.23.20.116,1,1293,0,0,1,1293,0.821072000,0.0000
126.159.11.10,<->,50.224.76.230,0,0,1,1015,1,1015,0.820783000,0.0000
136.25.188.47,<->,113.23.104.246,1,93,0,0,1,93,0.820487000,0.0000
215.158.49.77,<->,136.116.28.232,0,0,1,539,1,539,0.820450000,0.0000
143.239.149.114,<->,8.20.87.195,0,0,1,509,1,509,0.820326000,0.0000
215.158.238.113,<->,192.226.161.158,1,1213,0,0,1,1213,0.820235000,0.0000
142.206.40.253,<->,136.25.188.238,0,0,1,456,1,456,0.819998000,0.0000
199.73.78.31,<->,136.25.188.53,0,0,1,781,1,781,0.819918000,0.0000
136.25.188.161,<->,29.212.43.236,1,1149,0,0,1,1149,0.819468000,0.0000
199.81.31.221,<->,136.25.188.253,0,0,1,89,1,89,0.819070000,0.0000
215.158.238.47,<->,193.10.94.25,1,1213,0,0,1,1213,0.819029000,0.0000
133.178.227.79,<->,113.143.223.138,1,1045,0,0,1,1045,0.818847000,0.0000
136.25.189.90,<->,57.31.64.92,1,1197,0,0,1,1197,0.818799000,0.0000
215.158.140.60,<->,8.40.51.233,1,1084,0,0,1,1084,0.818786000,0.0000
215.158.238.81,<->,113.23.104.203,1,1293,0,0,1,1293,0.818700000,0.0000
207.11.121.137,<->,8.252.222.186,0,0,1,303,1,303,0.818509000,0.0000
136.25.188.201,<->,98.219.126.140,1,1112,0,0,1,1112,0.818312000,0.0000
133.54.16.199,<->,121.213.100.244,1,350,0,0,1,350,0.818029000,0.0000
221.102.143.189,<->,192.64.72.222,0,0,1,141,1,141,0.817513000,0.0000
136.25.189.46,<->,57.31.51.176,1,1165,0,0,1,1165,0.817296000,0.0000
133.178.226.28,<->,113.23.117.69,1,1325,0,0,1,1325,0.817202000,0.0000
205.14.77.10,<->,192.64.210.220,0,0,1,70,1,70,0.817149000,0.0000
215.158.238.123,<->,33.209.217.214,1,1413,0,0,1,1413,0.816834000,0.0000
98.236.90.61,<->,54.43.51.222,1,157,0,0,1,157,0.816130000,0.0000
215.158.239.84,<->,196.88.121.14,1,121,0,0,1,121,0.816112000,0.0000
215.158.238.83,<->,57.227.82.251,1,1325,0,0,1,1325,0.815972000,0.0000
235.37.190.201,<->,136.25.189.30,0,0,1,1229,1,1229,0.815611000,0.0000
148.88.36.236,<->,139.193.141.139,0,0,1,634,1,634,0.814805000,0.0000
215.158.239.35,<->,215.158.42.117,1,935,0,0,1,935,0.814686000,0.0000
133.178.226.28,<->,29.213.216.255,1,1309,0,0,1,1309,0.814374000,0.0000
109.1.9.162,<->,106.5.211.9,1,149,0,0,1,149,0.813930000,0.0000
215.158.61.193,<->,8.176.8.238,0,0,1,173,1,173,0.813590000,0.0000
224.93.235.39,<->,80.27.157.204,0,0,1,1325,1,1325,0.813538000,0.0000
139.148.1.93,<->,8.183.25.124,0,0,1,578,1,578,0.813411000,0.0000
136.25.188.220,<->,41.175.89.220,1,85,0,0,1,85,0.812847000,0.0000
53.148.20.156,<->,48.52.87.32,0,0,1,87,1,87,0.812644000,0.0000
215.158.103.203,<->,53.73.20.119,1,234,0,0,1,234,0.812185000,0.0000
136.25.189.2,<->,113.143.223.213,1,1229,0,0,1,1229,0.811934000,0.0000
246.254.97.228,<->,206.243.231.162,1,967,0,0,1,967,0.811646000,0.0000
100.228.42.193,<->,57.18.37.133,1,749,0,0,1,749,0.811626000,0.0000
144.70.164.220,<->,8.228.222.96,0,0,1,132,1,132,0.811364000,0.0000
215.202.175.22,<->,136.25.188.161,0,0,1,1165,1,1165,0.811315000,0.0000
215.158.238.105,<->,206.103.215.229,1,1213,0,0,1,1213,0.810915000,0.0000
133.178.226.60,<->,112.220.206.22,1,1117,0,0,1,1117,0.810797000,0.0000
215.158.239.99,<->,196.92.244.20,1,1080,0,0,1,1080,0.810664000,0.0000
204.62.143.9,<->,136.25.188.198,0,0,1,93,1,93,0.810353000,0.0000
101.70.121.77,<->,8.37.175.39,1,317,0,0,1,317,0.810070000,0.0000
195.121.135.23,<->,139.193.141.139,0,0,1,420,1,420,0.809545000,0.0000
145.252.125.112,<->,112.86.216.201,1,278,0,0,1,278,0.809306000,0.0000
215.158.140.76,<->,33.209.217.27,1,1388,0,0,1,1388,0.809222000,0.0000
215.158.238.198,<->,113.23.7.195,1,1261,0,0,1,1261,0.809214000,0.0000
215.158.61.242,<->,8.176.8.195,0,0,1,399,1,399,0.808327000,0.0000
109.221.142.67,<->,50.224.76.235,0,0,1,401,1,401,0.808148000,0.0000
136.25.188.254,<->,112.235.95.5,1,1181,0,0,1,1181,0.807796000,0.0000
215.158.239.93,<->,29.214.109.164,1,1197,0,0,1,1197,0.807655000,0.0000
143.134.6.217,<->,136.25.188.46,0,0,1,305,1,305,0.807399000,0.0000
111.20.172.118,<->,111.20.168.24,0,0,1,306,1,306,0.807089000,0.0000
92.27.219.241,<->,53.214.239.188,1,419,0,0,1,419,0.806439000,0.0000
199.33.112.95,<->,136.25.188.162,0,0,1,605,1,605,0.806315000,0.0000
215.158.238.149,<->,114.25.48.55,1,1229,0,0,1,1229,0.806076000,0.0000
215.158.239.8,<->,96.135.154.156,1,414,0,0,1,414,0.805204000,0.0000
156.158.74.255,<->,139.163.96.94,0,0,1,50,1,50,0.805147000,0.0000
215.158.239.79,<->,131.144.113.52,1,1357,0,0,1,1357,0.805090000,0.0000
215.158.238.97,<->,29.213.216.213,1,117,0,0,1,117,0.804983000,0.0000
215.158.239.56,<->,196.90.83.92,1,93,0,0,1,93,0.804461000,0.0000
133.178.226.18,<->,131.173.115.10,1,1213,0,0,1,1213,0.804314000,0.0000
215.158.238.45,<->,192.227.190.232,1,1357,0,0,1,1357,0.804259000,0.0000
215.158.239.84,<->,126.219.60.213,1,1229,0,0,1,1229,0.804186000,0.0000
222.65.19.163,<->,129.19.164.75,1,75,0,0,1,75,0.804135000,0.0000
144.85.170.254,<->,139.128.103.160,1,735,0,0,1,735,0.804112000,0.0000
215.158.61.145,<->,8.176.8.240,0,0,1,1421,1,1421,0.803998000,0.0000
207.58.223.94,<->,136.25.188.227,0,0,1,235,1,235,0.803862000,0.0000
197.113.99.156,<->,136.25.188.226,0,0,1,101,1,101,0.803803000,0.0000
215.158.239.79,<->,199.20.29.154,1,573,0,0,1,573,0.803777000,0.0000
201.211.113.35,<->,133.178.227.79,0,0,1,1405,1,1405,0.803702000,0.0000
215.158.238.45,<->,128.123.91.50,1,1229,0,0,1,1229,0.803659000,0.0000
215.158.239.78,<->,199.20.30.129,1,797,0,0,1,797,0.803562000,0.0000
136.25.188.39,<->,111.151.237.142,1,1074,0,0,1,1074,0.803070000,0.0000
215.158.239.95,<->,199.20.29.209,1,632,0,0,1,632,0.802699000,0.0000
215.158.239.86,<->,131.144.113.68,1,1293,0,0,1,1293,0.802634000,0.0000
215.158.61.182,<->,8.176.8.199,0,0,1,1349,1,1349,0.802604000,0.0000
215.158.239.17,<->,145.13.164.231,1,151,0,0,1,151,0.801916000,0.0000
96.236.7.59,<->,8.52.134.84,0,0,1,961,1,961,0.801740000,0.0000
139.193.141.139,<->,120.19.84.242,1,321,0,0,1,321,0.801655000,0.0000
215.158.238.188,<->,148.26.113.119,1,1028,0,0,1,1028,0.801325000,0.0000
145.130.205.239,<->,8.182.137.40,0,0,1,929,1,929,0.801202000,0.0000
215.158.140.13,<->,109.126.137.238,1,497,0,0,1,497,0.800597000,0.0000
210.229.230.18,<->,80.240.245.7,1,68,0,0,1,68,0.800414000,0.0000
215.158.239.57,<->,195.54.65.95,1,378,0,0,1,378,0.800234000,0.0000
89.183.104.226,<->,35.33.16.78,1,78,0,0,1,78,0.799830000,0.0000
142.229.189.230,<->,136.25.188.174,0,0,1,608,1,608,0.799799000,0.0000
215.158.239.49,<->,120.154.131.37,1,1181,0,0,1,1181,0.799776000,0.0000
235.37.190.219,<->,215.158.239.59,0,0,1,1421,1,1421,0.799724000,0.0000
215.158.238.223,<->,29.211.228.202,1,1148,0,0,1,1148,0.799609000,0.0000
144.87.238.89,<->,8.182.239.140,0,0,1,461,1,461,0.799554000,0.0000
136.25.188.163,<->,50.179.15.252,1,85,0,0,1,85,0.799349000,0.0000
215.158.238.141,<->,120.155.14.163,1,1165,0,0,1,1165,0.799072000,0.0000
210.220.219.151,<->,53.208.110.227,1,397,0,0,1,397,0.799002000,0.0000
69.246.47.115,<->,8.252.222.95,0,0,1,344,1,344,0.798951000,0.0000
195.14.84.154,<->,136.25.188.55,0,0,1,701,1,701,0.798807000,0.0000
215.158.238.73,<->,128.123.91.58,1,1373,0,0,1,1373,0.798660000,0.0000
215.110.27.82,<->,8.220.190.86,0,0,1,570,1,570,0.798287000,0.0000
215.158.238.32,<->,29.211.122.181,1,1229,0,0,1,1229,0.797330000,0.0000
215.158.238.74,<->,143.227.65.185,1,1085,0,0,1,1085,0.797219000,0.0000
142.229.189.230,<->,136.25.188.255,0,0,1,608,1,608,0.797182000,0.0000
215.158.239.76,<->,196.90.247.27,1,501,0,0,1,501,0.796931000,0.0000
215.158.239.85,<->,204.226.14.183,1,93,0,0,1,93,0.796671000,0.0000
140.29.6.161,<->,8.252.222.30,0,0,1,689,1,689,0.796435000,0.0000
215.158.140.80,<->,96.156.169.112,1,63,0,0,1,63,0.796361000,0.0000
133.178.227.229,<->,100.224.132.152,1,94,0,0,1,94,0.796350000,0.0000
156.138.132.220,<->,139.163.96.94,0,0,1,50,1,50,0.796206000,0.0000
221.102.56.69,<->,98.128.50.14,0,0,1,294,1,294,0.796064000,0.0000
215.158.238.92,<->,149.17.136.247,1,1357,0,0,1,1357,0.795938000,0.0000
196.115.61.105,<->,92.27.194.147,0,0,1,248,1,248,0.795614000,0.0000
212.70.75.122,<->,136.25.188.211,0,0,1,1213,1,1213,0.795608000,0.0000
109.113.92.170,<->,8.182.227.240,0,0,1,110,1,110,0.795580000,0.0000
215.158.238.132,<->,104.3.169.46,1,1037,0,0,1,1037,0.795569000,0.0000
192.170.157.185,<->,136.62.168.88,0,0,1,141,1,141,0.795483000,0.0000
8.176.49.169,<->,0.220.255.202,1,75,0,0,1,75,0.795443000,0.0000
126.198.76.241,<->,97.198.118.56,0,0,1,359,1,359,0.795383000,0.0000
204.185.119.153,<->,136.25.188.55,0,0,1,717,1,717,0.795360000,0.0000
100.228.42.102,<->,17.43.174.250,1,957,0,0,1,957,0.795329000,0.0000
215.158.239.32,<->,96.135.154.110,1,130,0,0,1,130,0.795199000,0.0000
111.14.20.30,<->,8.252.222.36,0,0,1,87,1,87,0.795020000,0.0000
140.28.153.237,<->,139.163.96.94,0,0,1,50,1,50,0.794977000,0.0000
202.232.100.249,<->,92.168.217.252,0,0,1,544,1,544,0.794720000,0.0000
215.158.140.167,<->,8.191.6.69,1,1168,0,0,1,1168,0.794664000,0.0000
215.158.239.57,<->,196.91.74.178,1,757,0,0,1,757,0.794449000,0.0000
111.146.235.42,<->,0.195.216.195,1,93,0,0,1,93,0.794040000,0.0000
215.158.239.84,<->,143.72.80.9,1,301,0,0,1,301,0.794004000,0.0000
248.225.27.2,<->,53.208.247.245,1,349,0,0,1,349,0.793693000,0.0000
220.55.123.87,<->,126.198.67.220,1,278,0,0,1,278,0.793650000,0.0000
232.31.192.204,<->,97.198.118.56,0,0,1,380,1,380,0.793562000,0.0000
246.253.253.107,<->,109.127.101.16,1,557,0,0,1,557,0.793514000,0.0000
195.68.127.154,<->,136.25.188.227,0,0,1,717,1,717,0.793096000,0.0000
215.158.239.6,<->,212.70.75.129,1,1080,0,0,1,1080,0.793022000,0.0000
215.158.238.148,<->,80.47.111.74,1,1165,0,0,1,1165,0.792832000,0.0000
215.158.238.148,<->,131.144.115.215,1,1165,0,0,1,1165,0.792824000,0.0000
215.158.238.106,<->,126.148.130.18,1,1149,0,0,1,1149,0.792539000,0.0000
136.25.188.175,<->,57.160.181.231,1,1247,0,0,1,1247,0.792442000,0.0000
50.223.3.228,<->,35.55.6.121,1,239,0,0,1,239,0.791950000,0.0000
143.42.211.61,<->,136.25.188.55,0,0,1,247,1,247,0.791789000,0.0000
32.236.164.211,<->,8.220.239.104,0,0,1,640,1,640,0.791534000,0.0000
148.56.229.109,<->,136.25.189.17,0,0,1,1245,1,1245,0.791365000,0.0000
231.143.237.213,<->,136.25.188.53,0,0,1,282,1,282,0.790780000,0.0000
215.158.140.120,<->,111.150.207.168,1,100,0,0,1,100,0.790718000,0.0000
32.233.119.118,<->,8.220.191.154,0,0,1,1190,1,1190,0.790547000,0.0000
246.253.198.51,<->,113.56.138.242,1,663,0,0,1,663,0.790439000,0.0000
142.244.205.46,<->,136.25.188.163,0,0,1,765,1,765,0.790419000,0.0000
213.186.59.155,<->,144.85.170.254,0,0,1,797,1,797,0.789460000,0.0000
195.102.51.30,<->,8.20.87.206,0,0,1,228,1,228,0.789215000,0.0000
136.25.189.59,<->,29.213.219.58,1,1229,0,0,1,1229,0.788875000,0.0000
215.158.239.76,<->,207.167.190.198,1,781,0,0,1,781,0.788855000,0.0000
95.245.73.153,<->,8.252.221.230,0,0,1,452,1,452,0.788601000,0.0000
136.25.188.255,<->,112.220.206.18,1,1357,0,0,1,1357,0.788199000,0.0000
215.158.238.135,<->,143.155.227.40,1,1293,0,0,1,1293,0.788125000,0.0000
220.28.115.46,<->,215.158.239.52,0,0,1,743,1,743,0.787812000,0.0000
215.158.238.67,<->,126.219.132.197,1,1357,0,0,1,1357,0.787692000,0.0000
249.101.82.5,<->,139.33.174.178,1,1268,0,0,1,1268,0.787534000,0.0000
197.113.64.144,<->,136.25.188.174,0,0,1,1103,1,1103,0.787302000,0.0000
215.158.238.223,<->,120.154.179.31,1,1229,0,0,1,1229,0.787230000,0.0000
17.194.236.193,<->,8.220.176.253,0,0,1,274,1,274,0.786738000,0.0000
232.31.149.177,<->,132.249.70.169,0,0,1,60,1,60,0.786738000,0.0000
215.158.239.59,<->,29.123.209.236,1,1357,0,0,1,1357,0.786447000,0.0000
136.25.188.160,<->,8.252.210.162,1,1245,0,0,1,1245,0.786206000,0.0000
215.158.239.85,<->,133.224.119.54,1,1373,0,0,1,1373,0.785728000,0.0000
215.158.239.56,<->,199.20.31.153,1,250,0,0,1,250,0.785386000,0.0000
223.120.101.156,<->,8.252.222.47,0,0,1,141,1,141,0.785022000,0.0000
133.178.227.2,<->,69.150.168.219,1,1437,0,0,1,1437,0.784728000,0.0000
136.25.189.1,<->,96.156.169.215,1,94,0,0,1,94,0.784425000,0.0000
215.158.239.96,<->,143.42.134.73,1,89,0,0,1,89,0.784254000,0.0000
215.158.239.87,<->,57.199.250.202,1,1373,0,0,1,1373,0.784183000,0.0000
215.158.239.76,<->,207.167.180.154,1,93,0,0,1,93,0.784108000,0.0000
144.83.60.153,<->,92.162.253.12,0,0,1,1074,1,1074,0.783951000,0.0000
204.17.25.212,<->,92.27.234.126,0,0,1,431,1,431,0.783758000,0.0000
206.103.215.213,<->,136.25.189.83,0,0,1,1357,1,1357,0.783674000,0.0000
207.60.54.198,<->,136.25.188.254,0,0,1,811,1,811,0.783320000,0.0000
80.38.62.184,<->,37.48.133.102,1,267,0,0,1,267,0.783204000,0.0000
210.158.44.191,<->,102.45.233.201,1,179,0,0,1,179,0.783184000,0.0000
53.240.6.143,<->,8.228.220.12,0,0,1,50,1,50,0.782827000,0.0000
145.76.230.104,<->,101.224.89.228,0,0,1,532,1,532,0.782704000,0.0000
140.174.85.226,<->,133.178.227.16,0,0,1,1035,1,1035,0.782688000,0.0000
198.71.150.99,<->,80.38.16.15,0,0,1,889,1,889,0.782685000,0.0000
131.191.242.144,<->,50.224.76.235,0,0,1,947,1,947,0.782512000,0.0000
136.158.73.51,<->,133.178.227.227,0,0,1,94,1,94,0.782382000,0.0000
215.158.61.182,<->,8.176.8.248,0,0,1,61,1,61,0.782311000,0.0000
215.158.239.92,<->,196.90.83.92,1,93,0,0,1,93,0.782291000,0.0000
215.158.238.9,<->,113.23.101.99,1,1309,0,0,1,1309,0.782120000,0.0000
17.254.108.35,<->,8.220.178.198,0,0,1,665,1,665,0.781415000,0.0000
239.66.104.94,<->,97.198.118.56,0,0,1,566,1,566,0.781304000,0.0000
75.214.135.150,<->,8.252.222.142,0,0,1,117,1,117,0.780719000,0.0000
50.224.76.234,<->,38.12.28.107,1,1388,0,0,1,1388,0.780566000,0.0000
207.225.102.55,<->,0.195.210.46,0,0,1,568,1,568,0.780396000,0.0000
136.25.188.240,<->,30.73.219.65,1,765,0,0,1,765,0.780145000,0.0000
136.25.188.249,<->,0.195.237.14,1,244,0,0,1,244,0.779815000,0.0000
199.39.125.225,<->,136.25.188.176,0,0,1,765,1,765,0.779682000,0.0000
215.158.140.93,<->,113.23.101.164,1,1381,0,0,1,1381,0.779197000,0.0000
111.147.209.101,<->,53.201.142.135,1,125,0,0,1,125,0.778755000,0.0000
246.253.201.22,<->,149.68.156.164,1,81,0,0,1,81,0.778741000,0.0000
139.241.64.235,<->,8.252.223.143,0,0,1,97,1,97,0.778720000,0.0000
215.158.238.99,<->,149.99.92.107,1,1229,0,0,1,1229,0.778489000,0.0000
215.158.239.94,<->,212.70.75.118,1,1229,0,0,1,1229,0.778367000,0.0000
144.90.91.91,<->,92.27.219.163,0,0,1,1303,1,1303,0.778295000,0.0000
215.158.239.77,<->,8.33.226.42,1,1213,0,0,1,1213,0.777684000,0.0000
215.158.239.92,<->,199.20.29.12,1,117,0,0,1,117,0.777308000,0.0000
215.158.127.2,<->,8.176.8.85,0,0,1,599,1,599,0.776383000,0.0000
137.24.196.227,<->,89.183.110.72,0,0,1,693,1,693,0.776304000,0.0000
111.146.140.132,<->,17.61.177.228,1,746,0,0,1,746,0.776234000,0.0000
149.103.143.40,<->,139.193.141.139,0,0,1,379,1,379,0.776020000,0.0000
133.178.226.90,<->,122.158.51.61,1,1357,0,0,1,1357,0.775697000,0.0000
133.178.227.24,<->,8.190.217.43,1,1389,0,0,1,1389,0.775443000,0.0000
215.158.61.145,<->,136.25.189.196,0,0,1,400,1,400,0.774901000,0.0000
136.25.189.59,<->,126.219.194.7,1,1390,0,0,1,1390,0.774761000,0.0000
249.101.114.4,<->,53.213.235.225,1,887,0,0,1,887,0.774705000,0.0000
220.50.215.93,<->,89.216.125.215,0,0,1,212,1,212,0.774363000,0.0000
215.158.239.114,<->,215.158.61.242,1,173,0,0,1,173,0.774295000,0.0000
246.253.145.197,<->,143.99.29.57,1,589,0,0,1,589,0.774290000,0.0000
215.158.238.82,<->,143.155.227.59,1,1181,0,0,1,1181,0.773864000,0.0000
97.11.170.243,<->,53.69.140.220,1,234,0,0,1,234,0.773608000,0.0000
215.158.238.133,<->,140.190.33.180,1,1357,0,0,1,1357,0.773556000,0.0000
213.186.52.92,<->,144.85.170.254,0,0,1,441,1,441,0.773366000,0.0000
199.72.44.182,<->,136.25.188.209,0,0,1,101,1,101,0.773272000,0.0000
143.85.248.50,<->,50.223.3.228,0,0,1,200,1,200,0.773131000,0.0000
196.112.113.236,<->,8.252.222.142,0,0,1,315,1,315,0.773121000,0.0000
133.178.226.29,<->,114.143.139.170,1,973,0,0,1,973,0.773087000,0.0000
53.203.244.195,<->,48.53.80.15,0,0,1,269,1,269,0.772850000,0.0000
195.124.95.2,<->,136.25.188.177,0,0,1,781,1,781,0.772676000,0.0000
215.158.238.196,<->,69.31.239.14,1,1082,0,0,1,1082,0.772197000,0.0000
215.158.238.236,<->,29.214.109.164,1,1389,0,0,1,1389,0.772135000,0.0000
139.106.97.80,<->,101.124.235.41,0,0,1,61,1,61,0.771981000,0.0000
97.21.115.188,<->,8.220.191.152,0,0,1,260,1,260,0.771301000,0.0000
17.30.191.234,<->,8.52.189.207,0,0,1,770,1,770,0.770944000,0.0000
142.227.128.98,<->,136.25.188.239,0,0,1,653,1,653,0.770776000,0.0000
220.55.126.63,<->,137.44.153.224,1,285,0,0,1,285,0.770652000,0.0000
215.158.238.72,<->,57.210.107.19,1,1085,0,0,1,1085,0.769896000,0.0000
215.158.239.94,<->,196.93.174.232,1,394,0,0,1,394,0.769844000,0.0000
232.31.43.146,<->,97.198.118.56,0,0,1,409,1,409,0.769715000,0.0000
197.113.52.108,<->,92.27.27.163,0,0,1,348,1,348,0.769490000,0.0000
143.155.227.40,<->,136.25.188.210,0,0,1,1437,1,1437,0.769419000,0.0000
202.33.229.219,<->,136.25.188.236,0,0,1,93,1,93,0.769244000,0.0000
215.158.238.108,<->,100.224.166.161,1,506,0,0,1,506,0.769176000,0.0000
215.158.239.87,<->,116.106.60.161,1,93,0,0,1,93,0.769091000,0.0000
247.118.144.42,<->,53.213.69.234,1,419,0,0,1,419,0.768807000,0.0000
112.208.20.81,<->,99.72.196.59,0,0,1,50,1,50,0.768541000,0.0000
136.25.188.163,<->,61.72.108.238,1,1197,0,0,1,1197,0.768534000,0.0000
215.158.238.66,<->,114.146.74.212,1,1245,0,0,1,1245,0.768356000,0.0000
136.25.188.211,<->,8.42.43.39,1,1423,0,0,1,1423,0.767895000,0.0000
215.158.238.73,<->,113.23.104.252,1,1293,0,0,1,1293,0.767674000,0.0000
69.128.141.135,<->,53.160.193.35,1,306,0,0,1,306,0.767477000,0.0000
80.40.21.203,<->,42.124.217.53,1,68,0,0,1,68,0.767305000,0.0000
215.158.140.92,<->,122.159.123.53,1,1095,0,0,1,1095,0.767068000,0.0000
133.178.227.2,<->,113.92.150.217,1,1161,0,0,1,1161,0.767029000,0.0000
133.178.226.28,<->,29.211.186.55,1,1101,0,0,1,1101,0.766920000,0.0000
215.158.239.57,<->,199.20.28.194,1,781,0,0,1,781,0.766698000,0.0000
92.27.219.207,<->,54.36.9.141,1,54,0,0,1,54,0.766399000,0.0000
215.158.239.91,<->,139.5.114.139,1,204,0,0,1,204,0.766365000,0.0000
192.204.123.117,<->,136.25.188.237,0,0,1,1101,1,1101,0.765788000,0.0000
133.178.226.30,<->,38.104.11.116,1,1373,0,0,1,1373,0.765557000,0.0000
200.175.32.151,<->,53.68.64.193,1,508,0,0,1,508,0.765287000,0.0000
195.41.79.175,<->,136.25.188.55,0,0,1,711,1,711,0.765213000,0.0000
215.158.239.92,<->,199.20.30.97,1,765,0,0,1,765,0.764926000,0.0000
158.192.3.222,<->,136.25.188.237,0,0,1,1197,1,1197,0.764759000,0.0000
133.178.227.15,<->,8.191.14.1,1,1411,0,0,1,1411,0.764743000,0.0000
215.158.239.84,<->,199.20.29.101,1,378,0,0,1,378,0.764660000,0.0000
215.158.239.79,<->,196.90.112.117,1,765,0,0,1,765,0.764384000,0.0000
36.123.54.247,<->,8.20.87.5,0,0,1,97,1,97,0.763940000,0.0000
215.158.239.95,<->,199.20.6.114,1,172,0,0,1,172,0.763837000,0.0000
136.25.189.77,<->,96.156.169.247,1,70,0,0,1,70,0.763502000,0.0000
240.208.49.128,<->,0.195.210.42,0,0,1,206,1,206,0.763307000,0.0000
215.158.239.77,<->,142.249.122.150,1,93,0,0,1,93,0.763234000,0.0000
215.158.238.251,<->,113.20.94.202,1,1041,0,0,1,1041,0.763207000,0.0000
133.178.226.7,<->,118.20.87.71,1,1357,0,0,1,1357,0.762996000,0.0000
215.158.239.99,<->,199.39.64.238,1,87,0,0,1,87,0.762990000,0.0000
148.46.100.128,<->,50.224.76.234,0,0,1,220,1,220,0.762416000,0.0000
98.67.150.9,<->,53.218.56.159,1,189,0,0,1,189,0.762305000,0.0000
207.172.153.47,<->,136.25.188.163,0,0,1,382,1,382,0.762184000,0.0000
232.31.192.207,<->,97.198.118.56,0,0,1,695,1,695,0.761718000,0.0000
89.183.104.231,<->,48.111.111.145,1,121,0,0,1,121,0.761601000,0.0000
133.178.226.30,<->,89.86.110.9,1,1213,0,0,1,1213,0.761549000,0.0000
136.25.189.89,<->,124.72.94.18,1,1213,0,0,1,1213,0.761530000,0.0000
207.3.128.159,<->,159.23.227.182,0,0,1,83,1,83,0.761528000,0.0000
215.158.239.50,<->,199.20.31.62,1,602,0,0,1,602,0.761068000,0.0000
215.158.239.59,<->,199.20.30.147,1,93,0,0,1,93,0.760639000,0.0000
100.228.42.97,<->,92.175.46.229,1,749,0,0,1,749,0.760603000,0.0000
97.126.7.170,<->,53.180.154.23,1,134,0,0,1,134,0.760527000,0.0000
111.151.142.231,<->,99.74.26.112,0,0,1,100,1,100,0.760503000,0.0000
111.150.186.1,<->,80.27.156.242,0,0,1,668,1,668,0.760304000,0.0000
204.20.175.50,<->,136.25.188.174,0,0,1,172,1,172,0.760127000,0.0000
133.178.226.19,<->,113.23.104.221,1,1373,0,0,1,1373,0.759992000,0.0000
200.175.252.134,<->,54.58.25.251,1,400,0,0,1,400,0.759986000,0.0000
215.158.239.41,<->,149.96.53.41,1,248,0,0,1,248,0.759975000,0.0000
113.6.134.86,<->,100.228.42.88,0,0,1,737,1,737,0.759816000,0.0000
201.211.113.181,<->,136.25.189.1,0,0,1,1165,1,1165,0.759791000,0.0000
69.22.182.164,<->,50.224.76.234,0,0,1,891,1,891,0.759787000,0.0000
111.146.145.46,<->,53.149.2.103,1,125,0,0,1,125,0.759556000,0.0000
207.59.30.197,<->,136.25.188.211,0,0,1,245,1,245,0.759437000,0.0000
215.158.238.98,<->,69.31.238.234,1,1357,0,0,1,1357,0.759284000,0.0000
247.136.205.152,<->,53.246.51.76,1,595,0,0,1,595,0.759244000,0.0000
6.145.151.200,<->,0.195.210.44,0,0,1,87,1,87,0.759118000,0.0000
215.158.238.148,<->,137.199.206.4,1,1229,0,0,1,1229,0.759076000,0.0000
92.168.217.204,<->,68.0.157.121,1,537,0,0,1,537,0.759063000,0.0000
215.158.239.97,<->,199.20.30.244,1,93,0,0,1,93,0.758688000,0.0000
194.237.35.160,<->,136.25.188.225,0,0,1,87,1,87,0.758631000,0.0000
231.143.66.34,<->,136.25.188.225,0,0,1,602,1,602,0.758129000,0.0000
129.92.114.30,<->,54.54.203.214,1,125,0,0,1,125,0.757784000,0.0000
215.158.238.92,<->,8.219.185.97,1,1261,0,0,1,1261,0.757782000,0.0000
196.202.62.38,<->,8.182.227.180,0,0,1,552,1,552,0.757781000,0.0000
215.158.239.70,<->,199.106.63.13,1,602,0,0,1,602,0.757708000,0.0000
215.158.239.48,<->,196.92.210.132,1,93,0,0,1,93,0.757503000,0.0000
215.158.238.115,<->,61.72.108.193,1,1261,0,0,1,1261,0.757490000,0.0000
56.189.215.197,<->,8.52.171.236,0,0,1,285,1,285,0.757152000,0.0000
140.138.86.214,<->,136.25.188.242,0,0,1,1197,1,1197,0.756932000,0.0000
109.3.152.190,<->,8.45.168.98,1,196,0,0,1,196,0.756918000,0.0000
111.150.207.168,<->,99.74.87.225,0,0,1,100,1,100,0.756899000,0.0000
197.113.99.130,<->,136.25.188.252,0,0,1,949,1,949,0.756591000,0.0000
136.25.189.15,<->,6.29.108.5,1,1293,0,0,1,1293,0.756548000,0.0000
136.25.188.44,<->,112.220.206.22,1,1101,0,0,1,1101,0.756455000,0.0000
136.25.189.59,<->,61.35.124.249,1,1357,0,0,1,1357,0.756271000,0.0000
220.80.162.195,<->,8.55.216.92,1,141,0,0,1,141,0.756222000,0.0000
143.132.143.58,<->,136.25.188.160,0,0,1,426,1,426,0.755945000,0.0000
136.25.189.13,<->,133.146.0.170,1,1293,0,0,1,1293,0.755558000,0.0000
196.239.46.187,<->,92.27.194.147,0,0,1,249,1,249,0.755535000,0.0000
215.158.140.92,<->,100.50.96.201,1,1214,0,0,1,1214,0.755222000,0.0000
215.158.239.96,<->,199.20.29.190,1,101,0,0,1,101,0.755207000,0.0000
196.25.1.192,<->,8.52.168.63,0,0,1,262,1,262,0.755019000,0.0000
221.102.56.51,<->,80.41.241.216,0,0,1,413,1,413,0.755018000,0.0000
125.216.43.60,<->,8.252.222.204,0,0,1,1229,1,1229,0.754759000,0.0000
142.249.245.193,<->,136.25.188.238,0,0,1,781,1,781,0.754750000,0.0000
139.193.141.139,<->,104.189.57.198,1,303,0,0,1,303,0.754723000,0.0000
136.25.189.202,<->,129.222.39.173,1,109,0,0,1,109,0.754686000,0.0000
232.88.132.205,<->,8.220.188.43,0,0,1,587,1,587,0.754428000,0.0000
133.178.226.19,<->,118.20.108.74,1,1197,0,0,1,1197,0.754153000,0.0000
221.196.123.30,<->,80.38.35.198,0,0,1,653,1,653,0.753644000,0.0000
127.255.84.41,<->,92.162.253.93,0,0,1,573,1,573,0.753618000,0.0000
215.158.238.74,<->,106.188.252.233,1,1181,0,0,1,1181,0.753451000,0.0000
207.63.119.212,<->,136.25.188.54,0,0,1,89,1,89,0.753298000,0.0000
195.20.147.230,<->,50.223.3.228,0,0,1,295,1,295,0.753224000,0.0000
136.25.189.46,<->,96.156.169.247,1,1502,0,0,1,1502,0.753155000,0.0000
204.21.184.43,<->,136.25.188.236,0,0,1,701,1,701,0.753042000,0.0000
215.158.61.242,<->,8.176.8.252,0,0,1,1477,1,1477,0.752825000,0.0000
231.143.36.229,<->,136.25.188.46,0,0,1,93,1,93,0.752732000,0.0000
142.239.121.92,<->,133.178.226.18,0,0,1,1069,1,1069,0.752525000,0.0000
215.158.61.189,<->,136.25.189.214,0,0,1,765,1,765,0.752176000,0.0000
210.220.219.182,<->,192.179.63.29,1,317,0,0,1,317,0.752144000,0.0000
136.25.189.202,<->,129.222.39.50,1,109,0,0,1,109,0.751990000,0.0000
215.158.238.135,<->,120.154.221.217,1,1229,0,0,1,1229,0.750863000,0.0000
136.25.188.47,<->,61.35.22.193,1,1373,0,0,1,1373,0.750751000,0.0000
204.200.63.135,<->,136.25.188.252,0,0,1,637,1,637,0.750616000,0.0000
192.64.221.19,<->,106.176.179.39,1,1479,0,0,1,1479,0.750520000,0.0000
6.145.166.164,<->,0.195.210.44,0,0,1,87,1,87,0.750358000,0.0000
215.158.239.59,<->,199.20.5.35,1,93,0,0,1,93,0.750056000,0.0000
215.158.239.34,<->,131.95.192.158,1,1476,0,0,1,1476,0.750028000,0.0000
215.158.238.80,<->,113.23.104.203,1,93,0,0,1,93,0.749818000,0.0000
48.16.116.59,<->,8.252.221.236,0,0,1,454,1,454,0.749761000,0.0000
133.178.226.60,<->,30.249.194.214,1,1341,0,0,1,1341,0.749698000,0.0000
95.244.118.4,<->,8.252.222.36,0,0,1,87,1,87,0.749697000,0.0000
194.195.200.120,<->,50.224.76.230,0,0,1,568,1,568,0.749687000,0.0000
213.38.249.208,<->,8.49.69.216,1,382,0,0,1,382,0.749358000,0.0000
207.162.185.28,<->,8.182.227.180,0,0,1,75,1,75,0.749281000,0.0000
144.85.170.244,<->,98.87.145.30,1,956,0,0,1,956,0.749168000,0.0000
207.61.158.105,<->,136.25.188.55,0,0,1,252,1,252,0.749039000,0.0000
196.115.24.237,<->,8.182.226.78,0,0,1,616,1,616,0.749019000,0.0000
93.73.247.21,<->,92.168.217.245,0,0,1,541,1,541,0.748542000,0.0000
136.25.189.90,<->,96.156.169.254,1,1501,0,0,1,1501,0.748306000,0.0000
210.158.44.41,<->,89.143.163.60,1,1260,0,0,1,1260,0.748050000,0.0000
215.158.239.84,<->,33.223.64.255,1,1357,0,0,1,1357,0.748008000,0.0000
92.27.194.117,<->,29.237.9.30,1,371,0,0,1,371,0.747915000,0.0000
210.209.251.214,<->,111.147.160.100,0,0,1,481,1,481,0.747555000,0.0000
215.158.61.211,<->,99.74.27.172,0,0,1,335,1,335,0.747511000,0.0000
210.229.230.18,<->,100.202.111.157,1,68,0,0,1,68,0.747232000,0.0000
215.158.239.56,<->,199.121.109.137,1,101,0,0,1,101,0.746876000,0.0000
215.158.239.78,<->,196.90.0.243,1,93,0,0,1,93,0.746315000,0.0000
215.158.239.95,<->,142.207.217.218,1,614,0,0,1,614,0.746238000,0.0000
136.25.188.211,<->,8.252.213.29,1,1373,0,0,1,1373,0.746202000,0.0000
139.163.26.146,<->,104.227.201.147,1,99,0,0,1,99,0.745422000,0.0000
148.217.121.180,<->,136.25.189.12,0,0,1,1197,1,1197,0.745054000,0.0000
238.110.17.82,<->,50.224.76.235,0,0,1,299,1,299,0.744878000,0.0000
215.158.239.48,<->,207.228.187.17,1,801,0,0,1,801,0.744054000,0.0000
215.158.239.34,<->,126.219.102.182,1,1032,0,0,1,1032,0.743826000,0.0000
116.234.157.117,<->,50.224.76.234,0,0,1,1120,1,1120,0.743480000,0.0000
215.158.238.92,<->,29.214.73.165,1,1197,0,0,1,1197,0.743394000,0.0000
215.158.58.140,<->,99.74.27.166,0,0,1,561,1,561,0.743263000,0.0000
98.129.127.190,<->,88.8.215.100,1,59,0,0,1,59,0.743119000,0.0000
109.1.21.151,<->,8.55.135.127,1,75,0,0,1,75,0.743116000,0.0000
133.178.226.77,<->,96.155.60.244,1,228,0,0,1,228,0.743050000,0.0000
207.173.101.203,<->,136.25.188.253,0,0,1,797,1,797,0.742494000,0.0000
215.158.238.83,<->,131.144.116.87,1,1037,0,0,1,1037,0.742188000,0.0000
199.73.184.38,<->,136.25.188.175,0,0,1,765,1,765,0.742159000,0.0000
133.54.43.38,<->,112.15.4.244,1,311,0,0,1,311,0.741664000,0.0000
133.178.226.7,<->,8.222.212.27,1,1101,0,0,1,1101,0.741619000,0.0000
207.194.78.58,<->,92.27.194.147,0,0,1,230,1,230,0.741500000,0.0000
199.54.3.20,<->,8.182.224.248,0,0,1,424,1,424,0.741406000,0.0000
215.158.238.92,<->,131.36.198.50,1,1472,0,0,1,1472,0.741359000,0.0000
215.158.238.238,<->,126.219.100.211,1,1084,0,0,1,1084,0.741194000,0.0000
136.25.188.220,<->,61.35.22.241,1,1373,0,0,1,1373,0.740905000,0.0000
133.178.227.14,<->,29.212.182.213,1,1085,0,0,1,1085,0.740725000,0.0000
17.42.29.117,<->,8.220.181.167,0,0,1,717,1,717,0.740443000,0.0000
215.158.238.120,<->,69.132.194.169,1,1165,0,0,1,1165,0.740396000,0.0000
132.249.70.183,<->,53.94.69.91,1,231,0,0,1,231,0.740341000,0.0000
48.19.216.67,<->,8.252.222.160,0,0,1,306,1,306,0.740034000,0.0000
224.250.56.88,<->,97.126.31.75,0,0,1,728,1,728,0.739982000,0.0000
88.202.152.49,<->,50.224.76.234,0,0,1,582,1,582,0.739577000,0.0000
215.158.238.32,<->,118.20.101.16,1,1245,0,0,1,1245,0.739476000,0.0000
195.69.252.157,<->,136.25.188.242,0,0,1,117,1,117,0.739364000,0.0000
215.158.238.240,<->,122.158.245.22,1,1229,0,0,1,1229,0.739094000,0.0000
119.112.101.8,<->,92.162.253.132,0,0,1,285,1,285,0.738522000,0.0000
195.12.178.2,<->,136.25.188.255,0,0,1,746,1,746,0.737705000,0.0000
136.177.72.3,<->,92.162.253.74,0,0,1,769,1,769,0.737297000,0.0000
207.172.44.213,<->,136.25.188.176,0,0,1,190,1,190,0.737128000,0.0000
133.178.227.29,<->,111.151.109.41,1,100,0,0,1,100,0.737048000,0.0000
136.25.189.30,<->,113.143.223.229,1,1421,0,0,1,1421,0.736541000,0.0000
113.169.98.62,<->,50.224.76.230,0,0,1,552,1,552,0.736228000,0.0000
215.158.238.92,<->,131.1.253.244,1,1444,0,0,1,1444,0.735896000,0.0000
136.25.188.224,<->,29.211.228.69,1,1117,0,0,1,1117,0.735553000,0.0000
56.9.159.83,<->,8.182.251.218,0,0,1,702,1,702,0.735511000,0.0000
199.72.50.190,<->,92.27.194.147,0,0,1,249,1,249,0.734697000,0.0000
111.151.142.211,<->,8.252.221.116,0,0,1,100,1,100,0.734639000,0.0000
215.158.238.56,<->,126.219.196.105,1,1293,0,0,1,1293,0.733825000,0.0000
221.102.143.189,<->,6.73.237.197,0,0,1,141,1,141,0.733811000,0.0000
215.158.239.194,<->,139.36.119.82,1,1069,0,0,1,1069,0.733796000,0.0000
192.224.20.27,<->,133.178.226.31,0,0,1,1229,1,1229,0.733763000,0.0000
215.158.238.64,<->,115.140.139.149,1,1213,0,0,1,1213,0.733631000,0.0000
220.55.140.187,<->,92.27.234.26,0,0,1,97,1,97,0.733527000,0.0000
133.178.227.41,<->,61.35.124.201,1,1373,0,0,1,1373,0.733378000,0.0000
215.158.238.81,<->,6.73.9.181,1,1229,0,0,1,1229,0.732341000,0.0000
215.158.238.141,<->,113.23.117.93,1,1181,0,0,1,1181,0.732092000,0.0000
215.158.238.96,<->,159.23.130.167,1,1181,0,0,1,1181,0.731859000,0.0000
148.238.148.147,<->,89.183.110.72,0,0,1,887,1,887,0.731159000,0.0000
215.158.140.75,<->,8.40.51.129,1,1194,0,0,1,1194,0.731008000,0.0000
215.158.239.101,<->,129.222.36.87,1,948,0,0,1,948,0.730364000,0.0000
141.199.76.223,<->,136.25.189.81,0,0,1,1213,1,1213,0.730129000,0.0000
243.117.93.198,<->,159.137.243.250,0,0,1,101,1,101,0.730068000,0.0000
220.20.200.14,<->,127.255.84.41,1,573,0,0,1,573,0.729983000,0.0000
221.102.56.69,<->,213.38.232.168,0,0,1,294,1,294,0.729680000,0.0000
215.158.239.34,<->,33.209.213.2,1,200,0,0,1,200,0.729634000,0.0000
207.59.30.197,<->,136.25.188.225,0,0,1,327,1,327,0.729551000,0.0000
207.58.161.119,<->,136.25.188.209,0,0,1,617,1,617,0.729368000,0.0000
215.158.239.87,<->,207.217.81.70,1,1229,0,0,1,1229,0.729321000,0.0000
215.158.238.251,<->,119.168.0.250,1,1143,0,0,1,1143,0.729178000,0.0000
215.158.239.87,<->,149.184.89.88,1,1341,0,0,1,1341,0.729128000,0.0000
133.178.227.40,<->,112.235.95.68,1,1420,0,0,1,1420,0.729109000,0.0000
195.55.27.178,<->,136.25.188.174,0,0,1,93,1,93,0.728963000,0.0000
215.158.238.95,<->,29.213.219.30,1,1309,0,0,1,1309,0.728843000,0.0000
109.222.222.94,<->,53.234.162.13,1,125,0,0,1,125,0.728802000,0.0000
215.158.238.67,<->,33.209.217.203,1,1197,0,0,1,1197,0.728526000,0.0000
133.178.227.24,<->,8.50.171.253,1,1373,0,0,1,1373,0.728507000,0.0000
231.140.220.234,<->,136.25.188.53,0,0,1,862,1,862,0.728158000,0.0000
222.79.83.198,<->,210.229.230.22,0,0,1,68,1,68,0.728014000,0.0000
215.158.239.79,<->,201.211.113.180,1,1245,0,0,1,1245,0.727784000,0.0000
192.64.236.57,<->,137.226.59.195,1,97,0,0,1,97,0.727777000,0.0000
158.85.62.60,<->,133.178.226.197,0,0,1,145,1,145,0.727661000,0.0000
133.178.227.251,<->,29.214.74.136,1,1133,0,0,1,1133,0.727630000,0.0000
115.139.55.246,<->,50.224.76.235,0,0,1,860,1,860,0.727515000,0.0000
201.194.181.151,<->,89.183.104.144,0,0,1,941,1,941,0.727254000,0.0000
132.249.70.183,<->,53.188.42.81,1,87,0,0,1,87,0.727137000,0.0000
99.74.27.88,<->,80.56.83.82,1,100,0,0,1,100,0.726651000,0.0000
215.158.238.96,<->,111.151.70.65,1,1325,0,0,1,1325,0.726500000,0.0000
247.118.150.119,<->,8.182.228.163,0,0,1,537,1,537,0.726407000,0.0000
192.170.245.62,<->,136.25.189.2,0,0,1,852,1,852,0.725757000,0.0000
215.158.239.35,<->,122.158.246.249,1,1372,0,0,1,1372,0.725749000,0.0000
145.170.226.128,<->,8.183.25.25,0,0,1,368,1,368,0.725234000,0.0000
215.158.238.104,<->,113.20.94.123,1,1181,0,0,1,1181,0.725056000,0.0000
89.183.106.29,<->,42.44.75.221,1,666,0,0,1,666,0.724994000,0.0000
100.95.240.201,<->,27.12.1.152,1,60,0,0,1,60,0.724878000,0.0000
50.145.209.112,<->,8.228.219.1,0,0,1,93,1,93,0.724779000,0.0000
133.178.226.28,<->,32.183.36.53,1,1165,0,0,1,1165,0.724714000,0.0000
207.58.246.46,<->,136.25.188.54,0,0,1,87,1,87,0.724632000,0.0000
199.68.125.1,<->,136.25.188.174,0,0,1,765,1,765,0.724500000,0.0000
215.158.239.16,<->,8.255.92.67,1,948,0,0,1,948,0.724090000,0.0000
204.56.105.239,<->,136.25.188.220,0,0,1,240,1,240,0.724056000,0.0000
111.150.207.168,<->,99.74.26.101,0,0,1,100,1,100,0.723852000,0.0000
58.51.8.74,<->,8.252.221.230,0,0,1,511,1,511,0.723513000,0.0000
139.163.68.55,<->,100.241.191.24,1,51,0,0,1,51,0.723148000,0.0000
222.254.247.163,<->,210.220.219.178,0,0,1,461,1,461,0.723096000,0.0000
215.158.239.93,<->,91.247.40.79,1,629,0,0,1,629,0.722921000,0.0000
136.25.188.44,<->,111.151.70.41,1,1245,0,0,1,1245,0.722799000,0.0000
210.156.111.217,<->,200.164.14.129,1,396,0,0,1,396,0.722752000,0.0000
215.158.238.223,<->,192.170.245.6,1,1050,0,0,1,1050,0.722534000,0.0000
195.42.58.202,<->,136.25.188.54,0,0,1,685,1,685,0.722243000,0.0000
207.58.76.191,<->,136.25.188.254,0,0,1,685,1,685,0.722127000,0.0000
215.158.239.58,<->,199.20.28.239,1,602,0,0,1,602,0.722017000,0.0000
199.15.77.28,<->,136.25.188.198,0,0,1,132,1,132,0.721986000,0.0000
221.102.56.51,<->,6.228.38.150,0,0,1,413,1,413,0.721720000,0.0000
215.158.239.96,<->,204.1.166.183,1,781,0,0,1,781,0.721717000,0.0000
215.158.239.97,<->,195.70.3.141,1,87,0,0,1,87,0.721610000,0.0000
215.158.238.80,<->,113.23.104.246,1,93,0,0,1,93,0.721377000,0.0000
148.190.124.62,<->,133.178.227.16,0,0,1,1437,1,1437,0.721168000,0.0000
215.158.238.107,<->,128.211.32.18,1,1229,0,0,1,1229,0.720609000,0.0000
53.148.153.145,<->,8.52.222.253,0,0,1,93,1,93,0.720593000,0.0000
215.158.238.96,<->,148.146.91.22,1,1213,0,0,1,1213,0.720525000,0.0000
215.158.140.92,<->,201.211.113.32,1,1445,0,0,1,1445,0.720472000,0.0000
215.158.238.107,<->,192.229.40.54,1,1181,0,0,1,1181,0.719448000,0.0000
139.36.120.249,<->,101.224.207.61,0,0,1,893,1,893,0.719344000,0.0000
136.25.188.198,<->,131.36.198.43,1,1436,0,0,1,1436,0.719181000,0.0000
199.69.87.94,<->,136.25.188.237,0,0,1,1053,1,1053,0.718914000,0.0000
215.158.239.50,<->,195.49.96.28,1,331,0,0,1,331,0.718696000,0.0000
215.158.239.34,<->,149.96.60.11,1,1495,0,0,1,1495,0.718383000,0.0000
246.254.97.113,<->,139.33.175.144,1,340,0,0,1,340,0.717998000,0.0000
215.158.239.92,<->,199.20.6.166,1,93,0,0,1,93,0.717868000,0.0000
195.15.228.209,<->,136.25.188.253,0,0,1,146,1,146,0.717693000,0.0000
212.70.75.120,<->,136.25.188.226,0,0,1,1341,1,1341,0.717450000,0.0000
199.111.215.109,<->,8.182.230.205,0,0,1,502,1,502,0.717383000,0.0000
215.158.239.58,<->,199.20.28.242,1,426,0,0,1,426,0.717330000,0.0000
235.42.34.22,<->,136.25.189.59,0,0,1,1357,1,1357,0.717305000,0.0000
215.158.61.183,<->,8.176.8.183,0,0,1,1133,1,1133,0.717285000,0.0000
221.102.56.69,<->,192.67.86.35,0,0,1,294,1,294,0.717034000,0.0000
133.178.226.200,<->,133.146.0.147,1,890,0,0,1,890,0.716576000,0.0000
215.158.238.250,<->,192.227.190.8,1,1373,0,0,1,1373,0.715932000,0.0000
133.178.226.28,<->,122.216.233.185,1,1325,0,0,1,1325,0.715890000,0.0000
132.18.67.30,<->,100.92.68.156,0,0,1,397,1,397,0.715845000,0.0000
136.25.189.29,<->,61.35.124.165,1,1277,0,0,1,1277,0.715323000,0.0000
129.16.253.232,<->,100.182.137.123,0,0,1,1110,1,1110,0.715112000,0.0000
126.198.149.124,<->,99.75.118.25,0,0,1,341,1,341,0.714952000,0.0000
215.158.140.61,<->,126.219.194.161,1,1274,0,0,1,1274,0.714851000,0.0000
221.196.123.21,<->,136.25.188.209,0,0,1,282,1,282,0.714468000,0.0000
58.60.3.50,<->,8.252.221.230,0,0,1,452,1,452,0.714257000,0.0000
215.158.61.182,<->,8.176.8.207,0,0,1,413,1,413,0.714144000,0.0000
133.178.227.19,<->,80.47.152.245,1,1197,0,0,1,1197,0.713800000,0.0000
111.150.187.222,<->,8.252.223.176,0,0,1,1049,1,1049,0.713521000,0.0000
17.5.13.116,<->,8.220.191.251,0,0,1,465,1,465,0.713086000,0.0000
53.167.165.55,<->,48.52.167.131,0,0,1,502,1,502,0.713055000,0.0000
220.28.65.9,<->,133.178.226.8,0,0,1,884,1,884,0.713033000,0.0000
133.244.31.123,<->,80.27.154.173,1,205,0,0,1,205,0.712908000,0.0000
215.158.238.221,<->,61.35.124.166,1,1213,0,0,1,1213,0.712385000,0.0000
129.236.114.39,<->,33.233.141.68,0,0,1,456,1,456,0.712093000,0.0000
195.55.219.201,<->,136.25.188.253,0,0,1,146,1,146,0.712088000,0.0000
215.158.238.81,<->,8.252.214.133,1,1085,0,0,1,1085,0.712022000,0.0000
239.66.240.179,<->,144.86.146.31,0,0,1,838,1,838,0.711924000,0.0000
144.85.170.208,<->,111.216.99.92,1,727,0,0,1,727,0.711901000,0.0000
215.158.61.195,<->,8.176.8.242,0,0,1,717,1,717,0.710911000,0.0000
139.5.113.141,<->,133.32.39.1,0,0,1,181,1,181,0.710677000,0.0000
200.175.204.226,<->,53.201.72.62,1,93,0,0,1,93,0.710553000,0.0000
196.115.133.150,<->,136.25.189.2,0,0,1,1325,1,1325,0.709616000,0.0000
221.102.56.69,<->,109.0.215.102,0,0,1,294,1,294,0.709500000,0.0000
215.158.239.87,<->,29.211.93.22,1,1373,0,0,1,1373,0.709474000,0.0000
207.57.129.65,<->,136.25.188.46,0,0,1,85,1,85,0.708990000,0.0000
111.150.207.137,<->,99.74.26.96,0,0,1,100,1,100,0.708327000,0.0000
215.158.238.102,<->,100.224.166.158,1,505,0,0,1,505,0.708084000,0.0000
80.41.196.234,<->,8.55.224.156,1,141,0,0,1,141,0.707970000,0.0000
133.178.227.43,<->,8.219.187.246,1,1306,0,0,1,1306,0.707588000,0.0000
145.16.103.60,<->,8.35.106.57,1,97,0,0,1,97,0.707496000,0.0000
215.158.239.99,<->,199.20.28.220,1,240,0,0,1,240,0.707013000,0.0000
109.222.211.98,<->,53.224.105.49,1,485,0,0,1,485,0.706976000,0.0000
218.138.21.44,<->,8.220.190.86,0,0,1,367,1,367,0.706936000,0.0000
235.253.220.214,<->,133.178.227.2,0,0,1,1188,1,1188,0.706130000,0.0000
143.23.92.141,<->,136.25.188.53,0,0,1,146,1,146,0.706013000,0.0000
139.163.167.27,<->,133.178.227.242,0,0,1,993,1,993,0.705809000,0.0000
215.158.239.95,<->,199.20.28.90,1,764,0,0,1,764,0.705569000,0.0000
117.38.98.160,<->,50.224.76.230,0,0,1,497,1,497,0.705283000,0.0000
220.55.122.79,<->,27.11.34.178,1,268,0,0,1,268,0.705067000,0.0000
207.173.44.120,<->,136.25.188.209,0,0,1,765,1,765,0.704140000,0.0000
101.224.174.108,<->,33.3.176.210,1,161,0,0,1,161,0.703991000,0.0000
136.25.189.29,<->,122.251.2.212,1,1357,0,0,1,1357,0.703975000,0.0000
215.158.239.87,<->,199.20.28.3,1,583,0,0,1,583,0.703910000,0.0000
156.165.37.73,<->,136.25.189.13,0,0,1,1277,1,1277,0.703589000,0.0000
210.229.230.18,<->,101.193.94.205,1,68,0,0,1,68,0.703446000,0.0000
195.55.212.125,<->,136.25.188.209,0,0,1,670,1,670,0.703294000,0.0000
215.158.239.95,<->,143.134.191.112,1,93,0,0,1,93,0.702594000,0.0000
136.25.188.45,<->,111.151.70.41,1,1165,0,0,1,1165,0.702343000,0.0000
204.200.34.12,<->,136.25.188.163,0,0,1,93,1,93,0.702053000,0.0000
207.193.113.191,<->,8.252.222.174,0,0,1,115,1,115,0.701887000,0.0000
136.25.188.168,<->,0.195.237.14,1,1274,0,0,1,1274,0.701829000,0.0000
215.158.239.84,<->,29.123.209.237,1,341,0,0,1,341,0.701770000,0.0000
136.25.188.179,<->,113.23.104.221,1,1277,0,0,1,1277,0.701566000,0.0000
199.120.15.89,<->,136.25.188.252,0,0,1,701,1,701,0.701165000,0.0000
142.166.50.130,<->,136.25.188.176,0,0,1,653,1,653,0.700975000,0.0000
215.158.239.50,<->,207.228.12.183,1,602,0,0,1,602,0.700963000,0.0000
215.158.238.142,<->,38.104.11.0,1,386,0,0,1,386,0.700709000,0.0000
215.158.239.56,<->,194.203.63.134,1,877,0,0,1,877,0.700509000,0.0000
8.252.222.37,<->,4.122.53.95,1,101,0,0,1,101,0.700356000,0.0000
215.158.238.119,<->,145.116.209.92,1,506,0,0,1,506,0.700213000,0.0000
133.178.226.60,<->,115.140.139.155,1,1357,0,0,1,1357,0.699266000,0.0000
145.255.249.236,<->,80.38.60.123,0,0,1,975,1,975,0.699099000,0.0000
246.254.97.113,<->,132.18.67.30,1,217,0,0,1,217,0.698676000,0.0000
215.158.239.71,<->,61.35.124.168,1,1293,0,0,1,1293,0.698418000,0.0000
100.92.51.73,<->,27.253.69.248,1,412,0,0,1,412,0.698194000,0.0000
144.71.42.15,<->,105.200.46.248,1,447,0,0,1,447,0.697977000,0.0000
133.178.227.16,<->,8.50.170.201,1,1261,0,0,1,1261,0.697208000,0.0000
136.25.189.80,<->,33.209.219.75,1,1373,0,0,1,1373,0.696903000,0.0000
215.158.238.95,<->,29.211.228.81,1,1038,0,0,1,1038,0.696875000,0.0000
6.145.171.243,<->,0.195.210.44,0,0,1,93,1,93,0.696597000,0.0000
215.158.239.96,<->,142.255.143.151,1,87,0,0,1,87,0.696597000,0.0000
196.200.227.12,<->,8.252.222.185,0,0,1,87,1,87,0.696578000,0.0000
8.222.49.230,<->,6.73.247.24,0,0,1,117,1,117,0.696578000,0.0000
246.254.97.105,<->,111.151.239.115,1,327,0,0,1,327,0.696304000,0.0000
220.55.77.155,<->,105.201.86.202,1,262,0,0,1,262,0.696241000,0.0000
139.193.141.139,<->,126.207.88.132,1,345,0,0,1,345,0.696040000,0.0000
215.158.239.34,<->,149.96.50.20,1,1497,0,0,1,1497,0.695942000,0.0000
215.158.238.73,<->,122.158.49.151,1,469,0,0,1,469,0.695738000,0.0000
136.25.188.177,<->,30.73.135.115,1,93,0,0,1,93,0.695568000,0.0000
142.249.59.202,<->,136.25.188.54,0,0,1,85,1,85,0.695423000,0.0000
99.187.125.121,<->,8.20.87.6,0,0,1,510,1,510,0.695128000,0.0000
243.117.93.168,<->,144.86.144.224,0,0,1,1193,1,1193,0.695074000,0.0000
133.178.226.7,<->,8.219.187.251,1,1078,0,0,1,1078,0.695037000,0.0000
149.97.34.22,<->,50.224.76.234,0,0,1,573,1,573,0.694685000,0.0000
215.158.238.45,<->,119.196.23.9,1,1213,0,0,1,1213,0.694467000,0.0000
204.200.34.7,<->,136.25.188.53,0,0,1,224,1,224,0.694086000,0.0000
133.178.227.19,<->,128.194.247.52,1,1078,0,0,1,1078,0.694013000,0.0000
215.158.238.81,<->,192.204.170.244,1,1293,0,0,1,1293,0.693669000,0.0000
215.158.238.133,<->,131.36.198.41,1,1400,0,0,1,1400,0.693531000,0.0000
8.182.224.87,<->,6.20.48.254,1,897,0,0,1,897,0.693390000,0.0000
196.119.216.12,<->,50.223.3.228,0,0,1,228,1,228,0.693356000,0.0000
221.102.143.189,<->,192.65.116.41,0,0,1,141,1,141,0.693248000,0.0000
199.69.70.141,<->,136.25.188.178,0,0,1,765,1,765,0.693122000,0.0000
215.158.238.223,<->,97.243.113.40,1,1074,0,0,1,1074,0.692570000,0.0000
215.158.238.243,<->,149.250.115.39,1,1181,0,0,1,1181,0.692154000,0.0000
142.241.142.33,<->,136.25.188.253,0,0,1,101,1,101,0.691636000,0.0000
56.114.235.120,<->,8.228.213.135,0,0,1,1076,1,1076,0.691540000,0.0000
92.66.73.171,<->,50.224.76.248,0,0,1,190,1,190,0.691253000,0.0000
142.239.121.92,<->,133.178.226.28,0,0,1,1165,1,1165,0.691244000,0.0000
196.247.220.182,<->,136.25.188.174,0,0,1,240,1,240,0.691239000,0.0000
245.241.43.37,<->,8.204.53.229,1,294,0,0,1,294,0.691020000,0.0000
207.172.102.178,<->,136.25.188.173,0,0,1,146,1,146,0.690889000,0.0000
199.72.20.51,<->,136.25.188.225,0,0,1,765,1,765,0.690849000,0.0000
215.158.239.96,<->,207.114.215.13,1,250,0,0,1,250,0.690514000,0.0000
199.70.203.153,<->,136.25.188.255,0,0,1,717,1,717,0.690424000,0.0000
196.22.94.231,<->,89.183.104.177,0,0,1,1396,1,1396,0.690334000,0.0000
215.158.238.220,<->,48.129.133.53,1,981,0,0,1,981,0.690074000,0.0000
247.136.251.138,<->,53.148.27.10,1,125,0,0,1,125,0.689856000,0.0000
215.158.238.82,<->,8.190.217.152,1,1357,0,0,1,1357,0.689158000,0.0000
215.158.238.104,<->,118.20.87.65,1,1213,0,0,1,1213,0.688900000,0.0000
136.25.189.34,<->,96.156.169.195,1,1485,0,0,1,1485,0.688801000,0.0000
136.25.189.82,<->,126.219.191.20,1,1181,0,0,1,1181,0.688540000,0.0000
215.158.239.87,<->,195.127.164.233,1,270,0,0,1,270,0.688424000,0.0000
215.158.239.57,<->,199.20.29.9,1,117,0,0,1,117,0.688347000,0.0000
215.158.238.80,<->,113.23.104.223,1,1133,0,0,1,1133,0.688178000,0.0000
192.204.170.244,<->,133.178.226.80,0,0,1,1149,1,1149,0.687791000,0.0000
97.203.12.51,<->,8.182.227.35,0,0,1,640,1,640,0.687430000,0.0000
202.33.19.155,<->,136.25.188.236,0,0,1,93,1,93,0.687214000,0.0000
215.158.239.218,<->,145.234.121.50,1,518,0,0,1,518,0.687058000,0.0000
144.64.139.154,<->,84.214.213.10,1,1376,0,0,1,1376,0.687044000,0.0000
76.179.20.16,<->,8.252.222.21,0,0,1,347,1,347,0.686944000,0.0000
215.158.238.53,<->,8.246.253.81,1,1357,0,0,1,1357,0.686943000,0.0000
194.216.205.175,<->,136.25.188.178,0,0,1,141,1,141,0.686774000,0.0000
205.20.150.175,<->,109.1.16.10,0,0,1,112,1,112,0.686503000,0.0000
215.158.238.24,<->,113.92.151.99,1,1218,0,0,1,1218,0.685886000,0.0000
196.246.151.187,<->,136.25.188.197,0,0,1,823,1,823,0.685761000,0.0000
249.101.193.220,<->,97.110.90.232,1,414,0,0,1,414,0.685527000,0.0000
136.25.188.160,<->,131.1.253.247,1,1389,0,0,1,1389,0.685181000,0.0000
215.158.61.242,<->,8.176.8.202,0,0,1,658,1,658,0.685164000,0.0000
215.158.239.38,<->,111.150.207.140,1,100,0,0,1,100,0.685123000,0.0000
107.253.12.221,<->,8.182.139.197,0,0,1,315,1,315,0.684802000,0.0000
215.158.239.78,<->,143.135.37.247,1,269,0,0,1,269,0.684734000,0.0000
139.253.175.86,<->,101.70.110.59,0,0,1,673,1,673,0.684453000,0.0000
221.102.56.69,<->,102.81.240.180,0,0,1,294,1,294,0.684417000,0.0000
158.192.3.219,<->,136.25.188.44,0,0,1,1149,1,1149,0.684416000,0.0000
215.158.238.135,<->,207.88.93.20,1,1341,0,0,1,1341,0.684399000,0.0000
215.158.239.31,<->,8.252.214.212,1,284,0,0,1,284,0.684367000,0.0000
133.178.227.79,<->,126.219.194.55,1,1063,0,0,1,1063,0.684005000,0.0000
133.178.226.19,<->,80.47.111.11,1,1181,0,0,1,1181,0.684003000,0.0000
215.158.238.80,<->,57.210.107.16,1,1309,0,0,1,1309,0.683758000,0.0000
111.147.213.111,<->,54.69.178.55,1,128,0,0,1,128,0.683372000,0.0000
136.25.189.53,<->,96.156.169.210,1,1248,0,0,1,1248,0.683054000,0.0000
204.187.113.253,<->,136.25.188.199,0,0,1,282,1,282,0.681933000,0.0000
215.158.239.19,<->,106.188.156.219,1,253,0,0,1,253,0.681831000,0.0000
136.25.188.252,<->,29.213.219.103,1,1229,0,0,1,1229,0.681675000,0.0000
227.56.253.56,<->,220.20.200.66,0,0,1,1215,1,1215,0.681657000,0.0000
215.158.61.243,<->,8.176.8.216,0,0,1,1395,1,1395,0.681190000,0.0000
247.136.131.3,<->,75.95.103.7,1,73,0,0,1,73,0.680932000,0.0000
137.21.23.51,<->,111.150.207.80,1,100,0,0,1,100,0.680687000,0.0000
136.25.189.29,<->,29.212.180.163,1,1213,0,0,1,1213,0.680588000,0.0000
215.158.238.190,<->,131.219.110.168,1,1117,0,0,1,1117,0.680389000,0.0000
139.36.120.117,<->,99.74.26.144,0,0,1,1454,1,1454,0.680372000,0.0000
133.178.227.135,<->,29.212.136.152,1,925,0,0,1,925,0.680357000,0.0000
148.60.121.245,<->,133.178.226.19,0,0,1,1229,1,1229,0.680131000,0.0000
136.18.189.67,<->,8.182.136.57,0,0,1,1330,1,1330,0.680014000,0.0000
215.158.238.92,<->,143.155.227.58,1,1325,0,0,1,1325,0.679692000,0.0000
139.193.141.209,<->,122.238.67.234,1,559,0,0,1,559,0.679644000,0.0000
193.64.187.35,<->,98.236.223.238,0,0,1,159,1,159,0.679333000,0.0000
143.155.227.59,<->,133.178.226.31,0,0,1,1277,1,1277,0.679006000,0.0000
215.158.238.106,<->,149.254.114.247,1,1229,0,0,1,1229,0.678850000,0.0000
215.158.239.248,<->,139.163.167.61,1,147,0,0,1,147,0.678745000,0.0000
100.93.144.126,<->,27.12.1.152,1,60,0,0,1,60,0.678583000,0.0000
204.17.28.74,<->,50.224.76.230,0,0,1,1117,1,1117,0.677740000,0.0000
139.114.137.74,<->,100.228.42.52,0,0,1,653,1,653,0.677294000,0.0000
58.242.129.41,<->,8.252.221.196,0,0,1,345,1,345,0.677199000,0.0000
111.20.168.123,<->,92.160.6.227,1,377,0,0,1,377,0.677109000,0.0000
144.86.148.17,<->,92.162.221.215,1,1426,0,0,1,1426,0.677031000,0.0000
159.137.152.190,<->,133.178.226.214,0,0,1,334,1,334,0.676979000,0.0000
215.158.239.97,<->,207.115.186.252,1,781,0,0,1,781,0.676802000,0.0000
92.162.218.130,<->,80.38.62.152,0,0,1,975,1,975,0.676653000,0.0000
215.158.238.141,<->,131.215.37.40,1,1165,0,0,1,1165,0.676511000,0.0000
136.25.188.162,<->,113.23.104.203,1,1165,0,0,1,1165,0.676172000,0.0000
133.178.226.29,<->,122.158.246.172,1,1197,0,0,1,1197,0.675936000,0.0000
215.158.239.34,<->,8.191.15.68,1,174,0,0,1,174,0.675442000,0.0000
99.187.125.121,<->,8.20.87.3,0,0,1,635,1,635,0.675135000,0.0000
132.214.63.61,<->,58.43.188.13,1,205,0,0,1,205,0.674541000,0.0000
192.224.21.67,<->,133.178.226.29,0,0,1,1213,1,1213,0.674208000,0.0000
220.28.104.193,<->,215.158.238.247,0,0,1,1258,1,1258,0.673910000,0.0000
215.158.238.106,<->,27.178.41.9,1,1309,0,0,1,1309,0.673882000,0.0000
215.158.239.95,<->,199.106.231.216,1,1117,0,0,1,1117,0.673507000,0.0000
148.190.126.57,<->,133.178.227.79,0,0,1,1421,1,1421,0.673335000,0.0000
199.68.125.1,<->,136.25.188.209,0,0,1,765,1,765,0.673266000,0.0000
239.66.119.155,<->,159.137.235.224,0,0,1,470,1,470,0.672999000,0.0000
136.25.189.43,<->,96.156.169.238,1,299,0,0,1,299,0.672815000,0.0000
210.229.230.18,<->,91.55.91.83,1,68,0,0,1,68,0.672621000,0.0000
121.252.25.54,<->,56.121.56.58,0,0,1,1245,1,1245,0.672445000,0.0000
207.60.155.192,<->,136.25.188.163,0,0,1,765,1,765,0.672314000,0.0000
139.193.141.139,<->,50.25.206.110,1,280,0,0,1,280,0.672237000,0.0000
215.158.239.94,<->,196.115.133.150,1,1389,0,0,1,1389,0.672220000,0.0000
140.138.86.221,<->,136.25.188.253,0,0,1,1245,1,1245,0.672095000,0.0000
136.25.188.198,<->,126.219.194.182,1,336,0,0,1,336,0.671889000,0.0000
192.64.248.200,<->,48.106.107.129,1,53,0,0,1,53,0.671022000,0.0000
107.10.167.99,<->,8.52.186.119,0,0,1,354,1,354,0.670963000,0.0000
215.158.239.76,<->,199.20.28.246,1,117,0,0,1,117,0.670946000,0.0000
215.158.140.229,<->,89.76.109.227,1,1039,0,0,1,1039,0.670404000,0.0000
139.163.0.99,<->,82.162.150.21,1,391,0,0,1,391,0.670119000,0.0000
128.221.182.45,<->,50.224.76.235,0,0,1,457,1,457,0.670074000,0.0000
84.214.213.150,<->,80.38.62.152,0,0,1,792,1,792,0.670059000,0.0000
215.158.239.92,<->,196.109.59.80,1,602,0,0,1,602,0.669500000,0.0000
215.158.238.190,<->,112.93.136.123,1,1341,0,0,1,1341,0.669355000,0.0000
98.128.226.115,<->,8.55.224.156,1,141,0,0,1,141,0.669338000,0.0000
192.229.42.171,<->,136.25.188.180,0,0,1,209,1,209,0.669227000,0.0000
215.158.239.18,<->,126.219.142.155,1,1438,0,0,1,1438,0.668585000,0.0000
136.25.188.179,<->,8.249.253.149,1,1229,0,0,1,1229,0.668536000,0.0000
136.25.188.162,<->,69.150.169.180,1,1197,0,0,1,1197,0.668363000,0.0000
215.158.239.87,<->,201.211.113.181,1,1309,0,0,1,1309,0.668204000,0.0000
109.1.59.53,<->,100.123.121.232,1,863,0,0,1,863,0.667999000,0.0000
215.158.239.93,<->,199.63.178.200,1,1229,0,0,1,1229,0.667938000,0.0000
221.102.143.189,<->,98.128.164.99,0,0,1,141,1,141,0.667851000,0.0000
197.125.118.14,<->,133.178.227.16,0,0,1,1142,1,1142,0.667831000,0.0000
136.25.189.15,<->,126.219.60.192,1,1341,0,0,1,1341,0.667554000,0.0000
98.236.90.195,<->,93.254.7.61,1,55,0,0,1,55,0.667451000,0.0000
17.88.221.236,<->,8.52.134.29,0,0,1,433,1,433,0.667166000,0.0000
247.136.165.38,<->,134.161.152.3,1,243,0,0,1,243,0.666831000,0.0000
215.158.238.209,<->,119.196.23.20,1,1144,0,0,1,1144,0.666688000,0.0000
213.186.59.241,<->,144.85.170.254,0,0,1,729,1,729,0.666222000,0.0000
215.158.140.228,<->,139.1.221.212,1,180,0,0,1,180,0.666035000,0.0000
132.216.20.184,<->,80.40.43.127,0,0,1,125,1,125,0.665792000,0.0000
220.20.200.29,<->,193.2.24.169,1,558,0,0,1,558,0.664810000,0.0000
136.25.189.202,<->,129.222.39.121,1,109,0,0,1,109,0.664102000,0.0000
136.25.189.30,<->,128.69.139.84,1,1229,0,0,1,1229,0.663524000,0.0000
213.38.247.248,<->,8.55.211.213,1,294,0,0,1,294,0.663287000,0.0000
193.21.29.244,<->,80.40.61.86,0,0,1,381,1,381,0.663212000,0.0000
215.158.239.58,<->,207.59.4.117,1,781,0,0,1,781,0.662710000,0.0000
215.158.238.66,<->,33.209.219.55,1,1277,0,0,1,1277,0.662191000,0.0000
215.158.61.242,<->,8.176.8.227,0,0,1,1420,1,1420,0.662072000,0.0000
89.183.106.29,<->,42.226.41.119,1,613,0,0,1,613,0.661505000,0.0000
136.25.188.239,<->,98.195.175.99,1,141,0,0,1,141,0.661380000,0.0000
193.25.56.161,<->,50.224.76.230,0,0,1,1064,1,1064,0.661030000,0.0000
199.33.113.5,<->,136.25.188.197,0,0,1,717,1,717,0.660815000,0.0000
133.178.226.30,<->,121.20.63.196,1,1149,0,0,1,1149,0.660458000,0.0000
215.158.140.92,<->,8.191.7.118,1,1402,0,0,1,1402,0.660374000,0.0000
215.158.238.221,<->,131.219.110.138,1,1469,0,0,1,1469,0.660203000,0.0000
215.158.238.133,<->,8.240.116.198,1,1405,0,0,1,1405,0.659858000,0.0000
144.83.60.153,<->,92.162.253.88,0,0,1,514,1,514,0.659260000,0.0000
133.178.227.247,<->,8.191.135.67,1,601,0,0,1,601,0.659005000,0.0000
133.178.227.27,<->,8.219.184.161,1,1365,0,0,1,1365,0.658989000,0.0000
215.158.238.120,<->,192.226.161.63,1,1277,0,0,1,1277,0.658729000,0.0000
29.214.108.240,<->,8.252.223.141,0,0,1,1103,1,1103,0.658137000,0.0000
192.204.170.215,<->,136.25.188.252,0,0,1,1213,1,1213,0.658136000,0.0000
139.163.96.94,<->,74.172.105.164,1,50,0,0,1,50,0.657679000,0.0000
221.102.143.189,<->,109.3.178.60,0,0,1,141,1,141,0.657481000,0.0000
159.137.192.179,<->,138.81.213.82,1,639,0,0,1,639,0.657439000,0.0000
215.158.239.56,<->,199.20.31.112,1,101,0,0,1,101,0.657262000,0.0000
195.70.94.211,<->,50.224.76.234,0,0,1,644,1,644,0.656873000,0.0000
143.155.226.123,<->,136.25.188.45,0,0,1,1341,1,1341,0.656701000,0.0000
215.158.239.95,<->,199.20.6.208,1,765,0,0,1,765,0.656446000,0.0000
142.166.114.214,<->,136.25.188.236,0,0,1,101,1,101,0.656261000,0.0000
215.158.238.64,<->,112.93.136.89,1,1373,0,0,1,1373,0.656198000,0.0000
215.158.239.92,<->,199.20.4.177,1,234,0,0,1,234,0.656023000,0.0000
144.85.170.208,<->,91.69.185.208,1,749,0,0,1,749,0.655707000,0.0000
197.113.99.109,<->,136.25.188.253,0,0,1,101,1,101,0.655653000,0.0000
6.145.167.149,<->,0.195.210.44,0,0,1,109,1,109,0.655497000,0.0000
139.36.120.125,<->,99.74.26.149,0,0,1,525,1,525,0.655395000,0.0000
204.184.108.215,<->,136.25.188.253,0,0,1,653,1,653,0.655232000,0.0000
17.34.58.13,<->,8.220.235.114,0,0,1,1411,1,1411,0.654649000,0.0000
215.158.239.92,<->,199.20.6.199,1,763,0,0,1,763,0.654046000,0.0000
207.59.44.200,<->,136.25.188.174,0,0,1,707,1,707,0.654002000,0.0000
144.87.238.89,<->,8.182.251.218,0,0,1,686,1,686,0.653794000,0.0000
105.94.46.174,<->,92.168.217.225,0,0,1,731,1,731,0.653754000,0.0000
133.178.227.26,<->,69.246.42.54,1,1213,0,0,1,1213,0.653504000,0.0000
132.200.63.92,<->,132.200.62.136,0,0,1,1351,1,1351,0.653418000,0.0000
215.158.238.123,<->,80.57.141.60,1,1181,0,0,1,1181,0.653166000,0.0000
204.184.197.122,<->,136.25.188.46,0,0,1,282,1,282,0.653091000,0.0000
91.234.186.104,<->,8.252.221.249,0,0,1,672,1,672,0.652948000,0.0000
215.158.238.209,<->,122.251.2.236,1,1056,0,0,1,1056,0.652066000,0.0000
215.158.239.68,<->,199.20.30.62,1,1022,0,0,1,1022,0.651645000,0.0000
215.158.239.92,<->,143.99.90.145,1,700,0,0,1,700,0.650902000,0.0000
111.147.75.241,<->,53.244.240.54,1,277,0,0,1,277,0.650899000,0.0000
136.25.188.174,<->,8.42.43.36,1,1357,0,0,1,1357,0.650662000,0.0000
192.204.191.129,<->,133.32.39.0,0,0,1,247,1,247,0.649978000,0.0000
152.46.83.147,<->,80.27.158.136,0,0,1,125,1,125,0.649914000,0.0000
136.25.188.44,<->,91.247.40.52,1,421,0,0,1,421,0.649902000,0.0000
132.249.142.223,<->,8.52.169.61,0,0,1,717,1,717,0.649818000,0.0000
215.158.238.75,<->,80.47.111.90,1,1373,0,0,1,1373,0.649795000,0.0000
204.184.56.182,<->,136.25.188.44,0,0,1,238,1,238,0.649467000,0.0000
22.61.14.243,<->,8.220.234.165,0,0,1,435,1,435,0.649465000,0.0000
89.204.173.123,<->,80.38.57.225,0,0,1,611,1,611,0.649345000,0.0000
133.178.227.40,<->,126.219.102.9,1,1044,0,0,1,1044,0.649175000,0.0000
56.9.244.173,<->,8.182.241.53,0,0,1,93,1,93,0.648726000,0.0000
196.89.74.120,<->,136.25.188.163,0,0,1,93,1,93,0.647893000,0.0000
145.252.121.82,<->,91.69.185.132,1,412,0,0,1,412,0.647476000,0.0000
215.158.238.223,<->,57.199.250.221,1,1405,0,0,1,1405,0.647295000,0.0000
204.184.1.23,<->,136.25.188.46,0,0,1,136,1,136,0.647113000,0.0000
242.6.91.85,<->,136.25.189.34,0,0,1,111,1,111,0.647070000,0.0000
215.158.239.29,<->,139.7.138.31,1,992,0,0,1,992,0.647062000,0.0000
215.158.238.176,<->,106.188.251.41,1,93,0,0,1,93,0.646849000,0.0000
231.255.128.157,<->,97.198.123.121,0,0,1,122,1,122,0.646827000,0.0000
136.25.188.223,<->,38.104.11.54,1,1405,0,0,1,1405,0.646540000,0.0000
210.229.230.18,<->,100.155.201.187,1,68,0,0,1,68,0.646442000,0.0000
143.10.156.243,<->,136.25.188.255,0,0,1,616,1,616,0.646078000,0.0000
111.150.207.137,<->,8.252.221.75,0,0,1,100,1,100,0.645979000,0.0000
53.64.93.17,<->,8.20.87.4,0,0,1,670,1,670,0.645514000,0.0000
205.224.29.85,<->,82.229.132.133,0,0,1,144,1,144,0.645078000,0.0000
215.158.238.251,<->,4.7.157.72,1,1138,0,0,1,1138,0.645027000,0.0000
221.102.143.189,<->,192.66.172.117,0,0,1,141,1,141,0.644878000,0.0000
120.126.50.203,<->,50.224.76.248,0,0,1,1316,1,1316,0.644824000,0.0000
193.4.105.60,<->,50.224.76.248,0,0,1,729,1,729,0.644737000,0.0000
136.25.188.178,<->,29.211.186.212,1,1389,0,0,1,1389,0.644220000,0.0000
139.163.5.140,<->,42.47.113.167,1,112,0,0,1,112,0.644087000,0.0000
215.158.239.50,<->,143.44.248.149,1,779,0,0,1,779,0.643977000,0.0000
215.158.140.76,<->,140.173.227.37,1,1085,0,0,1,1085,0.643222000,0.0000
215.158.238.123,<->,29.214.66.254,1,1165,0,0,1,1165,0.643165000,0.0000
220.38.84.250,<->,215.158.238.107,0,0,1,1325,1,1325,0.642991000,0.0000
215.158.239.57,<->,196.91.186.38,1,820,0,0,1,820,0.642985000,0.0000
136.25.189.59,<->,57.31.64.70,1,1133,0,0,1,1133,0.642926000,0.0000
215.158.239.96,<->,207.188.101.252,1,344,0,0,1,344,0.642707000,0.0000
215.158.238.33,<->,114.25.48.52,1,1389,0,0,1,1389,0.642690000,0.0000
215.158.238.53,<->,131.144.116.55,1,1357,0,0,1,1357,0.642576000,0.0000
143.129.169.210,<->,136.25.188.162,0,0,1,141,1,141,0.642526000,0.0000
194.237.96.103,<->,136.25.188.46,0,0,1,93,1,93,0.642153000,0.0000
215.158.238.107,<->,106.188.252.217,1,1389,0,0,1,1389,0.641611000,0.0000
92.162.253.63,<->,8.4.159.46,1,269,0,0,1,269,0.641541000,0.0000
109.119.182.188,<->,109.1.59.53,0,0,1,385,1,385,0.641428000,0.0000
17.245.253.19,<->,8.220.181.149,0,0,1,371,1,371,0.641279000,0.0000
215.158.239.48,<->,199.20.30.218,1,101,0,0,1,101,0.641247000,0.0000
98.232.172.226,<->,6.133.244.165,1,454,0,0,1,454,0.641160000,0.0000
132.128.61.174,<->,101.126.186.68,0,0,1,413,1,413,0.641042000,0.0000
76.179.37.77,<->,8.252.222.95,0,0,1,285,1,285,0.640797000,0.0000
195.5.62.123,<->,136.25.188.54,0,0,1,85,1,85,0.640539000,0.0000
193.53.171.162,<->,108.134.112.170,0,0,1,243,1,243,0.640219000,0.0000
159.137.162.213,<->,120.250.122.210,1,632,0,0,1,632,0.639989000,0.0000
133.178.227.70,<->,8.222.6.193,1,1000,0,0,1,1000,0.639902000,0.0000
159.112.9.198,<->,132.149.115.220,0,0,1,81,1,81,0.639759000,0.0000
136.25.189.57,<->,96.156.169.254,1,1074,0,0,1,1074,0.639358000,0.0000
215.158.239.218,<->,206.241.19.118,1,310,0,0,1,310,0.639106000,0.0000
215.158.239.51,<->,196.108.135.169,1,170,0,0,1,170,0.638935000,0.0000
100.93.185.72,<->,8.55.224.156,1,141,0,0,1,141,0.638740000,0.0000
101.70.121.211,<->,53.86.250.203,1,501,0,0,1,501,0.638475000,0.0000
204.200.35.27,<->,136.25.188.44,0,0,1,170,1,170,0.638375000,0.0000
215.158.239.33,<->,8.191.15.8,1,130,0,0,1,130,0.638026000,0.0000
215.158.238.32,<->,8.249.253.149,1,1165,0,0,1,1165,0.638016000,0.0000
111.147.115.147,<->,53.148.134.85,1,705,0,0,1,705,0.637494000,0.0000
129.225.134.75,<->,129.225.132.224,0,0,1,917,1,917,0.637090000,0.0000
215.158.238.133,<->,212.70.75.108,1,1165,0,0,1,1165,0.636936000,0.0000
215.158.238.66,<->,106.188.252.235,1,1181,0,0,1,1181,0.636934000,0.0000
136.25.189.90,<->,56.161.218.60,1,1421,0,0,1,1421,0.636901000,0.0000
192.67.175.129,<->,117.85.5.33,1,1496,0,0,1,1496,0.636896000,0.0000
8.252.222.205,<->,4.120.229.56,1,343,0,0,1,343,0.636209000,0.0000
215.158.238.133,<->,57.210.107.11,1,1357,0,0,1,1357,0.636012000,0.0000
133.178.227.243,<->,100.224.133.68,1,859,0,0,1,859,0.635829000,0.0000
199.91.177.40,<->,8.252.222.176,0,0,1,105,1,105,0.635804000,0.0000
142.223.144.174,<->,136.25.188.252,0,0,1,101,1,101,0.635694000,0.0000
215.158.238.92,<->,8.220.51.235,1,1309,0,0,1,1309,0.635664000,0.0000
192.228.30.43,<->,133.178.226.28,0,0,1,1165,1,1165,0.635662000,0.0000
222.244.24.215,<->,215.158.239.57,0,0,1,1213,1,1213,0.635525000,0.0000
194.232.96.97,<->,136.25.188.225,0,0,1,765,1,765,0.635298000,0.0000
215.158.238.190,<->,89.86.110.223,1,1149,0,0,1,1149,0.634771000,0.0000
215.158.239.17,<->,29.209.59.201,1,932,0,0,1,932,0.634514000,0.0000
141.15.11.120,<->,97.149.24.218,0,0,1,535,1,535,0.634362000,0.0000
231.140.187.31,<->,215.158.239.76,0,0,1,589,1,589,0.634067000,0.0000
145.118.222.76,<->,8.220.176.253,0,0,1,274,1,274,0.633868000,0.0000
215.158.238.208,<->,206.103.215.197,1,1368,0,0,1,1368,0.633859000,0.0000
136.25.188.179,<->,99.141.104.180,1,85,0,0,1,85,0.633765000,0.0000
158.192.3.232,<->,136.25.188.197,0,0,1,1341,1,1341,0.633733000,0.0000
215.158.239.18,<->,80.47.111.182,1,1050,0,0,1,1050,0.633640000,0.0000
220.28.104.193,<->,136.25.189.40,0,0,1,388,1,388,0.633537000,0.0000
133.178.226.38,<->,38.206.2.168,1,1229,0,0,1,1229,0.632541000,0.0000
6.145.166.38,<->,0.195.210.46,0,0,1,87,1,87,0.632498000,0.0000
17.6.195.239,<->,8.220.177.81,0,0,1,499,1,499,0.632464000,0.0000
215.158.239.69,<->,195.49.58.104,1,897,0,0,1,897,0.632391000,0.0000
142.249.42.81,<->,136.25.188.177,0,0,1,561,1,561,0.632081000,0.0000
215.158.238.123,<->,135.253.11.54,1,1213,0,0,1,1213,0.631308000,0.0000
204.62.195.166,<->,136.25.188.197,0,0,1,1020,1,1020,0.631260000,0.0000
207.57.108.97,<->,136.25.188.176,0,0,1,93,1,93,0.631093000,0.0000
215.158.239.69,<->,148.55.210.216,1,1229,0,0,1,1229,0.630907000,0.0000
215.158.239.52,<->,0.195.237.14,1,1408,0,0,1,1408,0.630585000,0.0000
136.25.188.226,<->,48.131.158.214,1,1277,0,0,1,1277,0.630542000,0.0000
205.106.31.29,<->,192.67.170.200,0,0,1,61,1,61,0.630367000,0.0000
195.15.172.171,<->,136.25.188.254,0,0,1,602,1,602,0.630250000,0.0000
215.158.238.198,<->,8.222.2.54,1,1198,0,0,1,1198,0.630097000,0.0000
159.13.218.93,<->,53.167.26.83,1,678,0,0,1,678,0.629400000,0.0000
133.178.226.28,<->,133.73.194.11,1,1149,0,0,1,1149,0.628953000,0.0000
215.158.239.77,<->,199.20.29.47,1,564,0,0,1,564,0.628830000,0.0000
215.158.238.133,<->,131.1.253.248,1,1238,0,0,1,1238,0.628732000,0.0000
215.158.140.184,<->,100.116.190.4,1,1003,0,0,1,1003,0.628387000,0.0000
215.158.238.82,<->,131.144.113.190,1,1229,0,0,1,1229,0.628284000,0.0000
195.0.175.222,<->,8.52.181.95,0,0,1,277,1,277,0.628267000,0.0000
98.156.168.196,<->,8.20.87.94,0,0,1,365,1,365,0.628084000,0.0000
136.25.188.254,<->,113.23.104.246,1,264,0,0,1,264,0.627798000,0.0000
215.158.239.92,<->,199.20.30.119,1,93,0,0,1,93,0.627746000,0.0000
220.81.10.32,<->,112.208.20.181,1,163,0,0,1,163,0.627368000,0.0000
133.178.227.115,<->,111.150.207.137,1,100,0,0,1,100,0.627291000,0.0000
136.25.189.57,<->,120.155.8.111,1,1181,0,0,1,1181,0.627164000,0.0000
143.232.93.56,<->,8.20.87.179,0,0,1,1013,1,1013,0.627150000,0.0000
205.175.193.162,<->,50.224.76.234,0,0,1,571,1,571,0.626532000,0.0000
215.158.238.141,<->,148.56.229.108,1,1069,0,0,1,1069,0.626462000,0.0000
213.221.90.194,<->,144.85.170.208,0,0,1,771,1,771,0.625839000,0.0000
207.59.132.245,<->,136.25.188.226,0,0,1,908,1,908,0.625611000,0.0000
247.157.68.96,<->,141.111.203.119,1,112,0,0,1,112,0.625601000,0.0000
136.18.58.122,<->,8.182.235.164,0,0,1,326,1,326,0.625523000,0.0000
207.6.70.5,<->,8.182.224.248,0,0,1,526,1,526,0.625425000,0.0000
200.175.34.30,<->,53.68.42.250,1,495,0,0,1,495,0.625304000,0.0000
215.158.238.82,<->,114.25.48.52,1,1309,0,0,1,1309,0.625271000,0.0000
144.85.170.246,<->,98.87.124.55,1,842,0,0,1,842,0.624998000,0.0000
144.87.238.89,<->,8.252.223.193,0,0,1,532,1,532,0.624653000,0.0000
252.98.135.226,<->,210.209.251.223,1,481,0,0,1,481,0.624173000,0.0000
146.249.227.139,<->,8.252.221.236,0,0,1,454,1,454,0.624124000,0.0000
215.158.238.73,<->,29.211.228.42,1,1133,0,0,1,1133,0.624060000,0.0000
197.113.64.228,<->,136.25.188.163,0,0,1,190,1,190,0.624001000,0.0000
75.31.153.171,<->,8.252.221.222,0,0,1,383,1,383,0.623753000,0.0000
215.158.140.75,<->,113.20.94.68,1,1056,0,0,1,1056,0.623256000,0.0000
215.158.238.84,<->,98.219.126.175,1,377,0,0,1,377,0.622931000,0.0000
105.203.241.189,<->,50.224.76.248,0,0,1,695,1,695,0.622781000,0.0000
215.158.238.149,<->,122.159.245.165,1,1261,0,0,1,1261,0.622535000,0.0000
215.158.239.50,<->,199.20.28.4,1,602,0,0,1,602,0.622486000,0.0000
139.44.225.31,<->,132.18.67.28,1,353,0,0,1,353,0.622457000,0.0000
207.58.180.32,<->,136.25.188.225,0,0,1,85,1,85,0.622227000,0.0000
159.23.227.225,<->,112.10.159.14,1,199,0,0,1,199,0.622172000,0.0000
195.43.205.193,<->,136.25.188.242,0,0,1,541,1,541,0.622131000,0.0000
196.112.119.95,<->,0.195.210.44,0,0,1,93,1,93,0.621961000,0.0000
215.158.239.93,<->,199.20.31.136,1,242,0,0,1,242,0.621532000,0.0000
136.25.189.85,<->,96.156.169.208,1,407,0,0,1,407,0.621016000,0.0000
132.153.80.16,<->,8.52.154.152,0,0,1,476,1,476,0.620644000,0.0000
136.25.188.55,<->,8.220.51.229,1,1213,0,0,1,1213,0.620492000,0.0000
215.158.239.57,<->,57.31.99.1,1,1229,0,0,1,1229,0.620346000,0.0000
136.25.189.14,<->,113.92.151.92,1,1405,0,0,1,1405,0.619612000,0.0000
136.25.188.161,<->,27.22.184.67,1,1117,0,0,1,1117,0.619368000,0.0000
215.158.239.93,<->,199.20.28.67,1,717,0,0,1,717,0.619107000,0.0000
197.113.99.68,<->,136.25.188.255,0,0,1,813,1,813,0.618924000,0.0000
215.158.239.87,<->,140.174.85.73,1,1325,0,0,1,1325,0.618792000,0.0000
139.193.141.209,<->,92.70.153.19,1,530,0,0,1,530,0.618754000,0.0000
133.178.226.74,<->,98.219.126.140,1,275,0,0,1,275,0.618754000,0.0000
215.158.239.248,<->,122.159.122.92,1,154,0,0,1,154,0.618159000,0.0000
136.25.189.77,<->,6.116.14.11,1,405,0,0,1,405,0.618127000,0.0000
195.15.239.197,<->,136.25.188.243,0,0,1,170,1,170,0.618080000,0.0000
215.158.239.58,<->,196.90.28.22,1,602,0,0,1,602,0.617952000,0.0000
142.177.128.44,<->,50.224.76.234,0,0,1,1270,1,1270,0.617886000,0.0000
215.158.239.85,<->,120.155.8.84,1,1245,0,0,1,1245,0.617513000,0.0000
8.182.251.151,<->,6.133.203.187,1,486,0,0,1,486,0.617406000,0.0000
50.224.76.235,<->,0.245.16.144,1,889,0,0,1,889,0.616803000,0.0000
215.158.238.140,<->,148.55.210.231,1,1277,0,0,1,1277,0.616248000,0.0000
58.143.177.240,<->,8.252.222.178,0,0,1,752,1,752,0.616214000,0.0000
109.1.15.105,<->,8.45.175.127,1,208,0,0,1,208,0.616016000,0.0000
136.25.189.46,<->,112.220.198.95,1,1197,0,0,1,1197,0.616010000,0.0000
220.28.115.46,<->,136.25.188.235,0,0,1,751,1,751,0.615934000,0.0000
215.158.238.236,<->,192.204.170.250,1,1052,0,0,1,1052,0.615376000,0.0000
221.102.143.189,<->,220.80.8.7,0,0,1,141,1,141,0.615337000,0.0000
215.158.239.41,<->,118.20.114.95,1,1321,0,0,1,1321,0.615275000,0.0000
133.244.31.122,<->,80.27.154.173,1,97,0,0,1,97,0.615164000,0.0000
195.13.130.115,<->,136.25.188.173,0,0,1,252,1,252,0.613860000,0.0000
215.158.238.134,<->,29.214.71.118,1,1069,0,0,1,1069,0.613776000,0.0000
215.158.239.92,<->,196.111.85.53,1,909,0,0,1,909,0.613627000,0.0000
215.158.239.182,<->,113.207.62.154,1,283,0,0,1,283,0.613315000,0.0000
199.80.150.122,<->,136.25.188.209,0,0,1,172,1,172,0.613129000,0.0000
138.126.13.23,<->,50.224.76.235,0,0,1,880,1,880,0.612735000,0.0000
144.85.170.254,<->,91.69.181.217,1,720,0,0,1,720,0.612581000,0.0000
215.158.239.205,<->,109.126.137.212,1,741,0,0,1,741,0.612320000,0.0000
136.25.188.172,<->,29.214.64.199,1,1357,0,0,1,1357,0.612225000,0.0000
215.158.238.66,<->,112.93.136.88,1,1021,0,0,1,1021,0.612120000,0.0000
142.208.41.60,<->,136.25.188.46,0,0,1,561,1,561,0.611953000,0.0000
215.158.239.97,<->,199.20.30.36,1,845,0,0,1,845,0.611902000,0.0000
210.209.251.211,<->,97.126.119.28,0,0,1,1404,1,1404,0.611879000,0.0000
235.42.34.34,<->,136.25.188.252,0,0,1,1309,1,1309,0.611426000,0.0000
92.161.83.172,<->,92.27.219.166,0,0,1,1394,1,1394,0.611301000,0.0000
215.158.239.76,<->,207.16.32.235,1,93,0,0,1,93,0.611204000,0.0000
221.102.56.46,<->,192.65.245.38,0,0,1,252,1,252,0.611109000,0.0000
133.178.226.29,<->,118.20.108.91,1,1133,0,0,1,1133,0.611054000,0.0000
243.123.125.57,<->,92.162.253.231,0,0,1,1039,1,1039,0.611052000,0.0000
215.158.239.179,<->,8.191.15.133,1,793,0,0,1,793,0.610431000,0.0000
199.69.87.69,<->,136.25.188.237,0,0,1,1053,1,1053,0.610422000,0.0000
137.47.204.97,<->,8.220.188.50,0,0,1,893,1,893,0.610354000,0.0000
194.253.240.189,<->,50.223.3.228,0,0,1,228,1,228,0.610345000,0.0000
215.158.239.253,<->,8.191.135.47,1,283,0,0,1,283,0.610017000,0.0000
215.158.238.47,<->,56.161.218.55,1,1389,0,0,1,1389,0.609989000,0.0000
210.229.230.19,<->,97.208.112.127,1,68,0,0,1,68,0.609920000,0.0000
220.38.239.213,<->,133.178.227.42,0,0,1,1005,1,1005,0.609094000,0.0000
199.80.37.144,<->,136.25.188.174,0,0,1,87,1,87,0.608621000,0.0000
133.178.226.29,<->,113.23.117.118,1,1197,0,0,1,1197,0.608407000,0.0000
144.85.170.246,<->,98.87.146.231,1,883,0,0,1,883,0.608386000,0.0000
207.60.19.235,<->,136.25.188.53,0,0,1,273,1,273,0.608352000,0.0000
125.10.47.171,<->,80.40.24.45,0,0,1,1208,1,1208,0.608266000,0.0000
136.25.188.223,<->,122.159.245.157,1,93,0,0,1,93,0.608058000,0.0000
53.161.15.106,<->,48.53.220.217,0,0,1,214,1,214,0.607746000,0.0000
111.20.168.123,<->,101.224.91.140,1,800,0,0,1,800,0.607727000,0.0000
215.158.238.223,<->,131.219.110.180,1,1421,0,0,1,1421,0.607724000,0.0000
136.25.189.13,<->,120.20.132.43,1,1088,0,0,1,1088,0.607487000,0.0000
222.244.24.200,<->,215.158.238.96,0,0,1,1309,1,1309,0.607421000,0.0000
220.28.85.14,<->,215.158.238.40,0,0,1,1200,1,1200,0.607366000,0.0000
221.102.143.189,<->,80.41.54.222,0,0,1,141,1,141,0.607111000,0.0000
194.253.248.68,<->,8.252.222.236,0,0,1,601,1,601,0.607007000,0.0000
100.108.68.20,<->,8.52.187.176,0,0,1,702,1,702,0.606844000,0.0000
215.158.238.221,<->,33.209.217.41,1,1108,0,0,1,1108,0.606748000,0.0000
215.158.239.59,<->,142.204.2.84,1,1229,0,0,1,1229,0.606111000,0.0000
215.158.140.76,<->,57.199.251.39,1,1395,0,0,1,1395,0.606044000,0.0000
207.63.8.92,<->,136.25.188.243,0,0,1,716,1,716,0.605862000,0.0000
220.28.73.211,<->,136.25.188.215,0,0,1,1042,1,1042,0.605244000,0.0000
139.163.26.146,<->,122.223.21.151,1,111,0,0,1,111,0.605134000,0.0000
159.137.189.229,<->,27.150.102.249,1,441,0,0,1,441,0.604665000,0.0000
195.54.94.157,<->,136.25.188.46,0,0,1,170,1,170,0.604460000,0.0000
215.158.239.79,<->,196.92.170.76,1,101,0,0,1,101,0.604208000,0.0000
215.158.239.68,<->,195.55.11.119,1,146,0,0,1,146,0.604205000,0.0000
210.229.230.19,<->,97.245.247.173,1,68,0,0,1,68,0.604109000,0.0000
136.25.189.16,<->,113.143.223.204,1,1229,0,0,1,1229,0.604058000,0.0000
215.158.239.35,<->,131.95.192.176,1,1359,0,0,1,1359,0.603764000,0.0000
144.83.60.153,<->,92.162.253.74,0,0,1,365,1,365,0.603709000,0.0000
97.126.13.83,<->,54.52.207.31,1,157,0,0,1,157,0.603582000,0.0000
136.25.189.80,<->,113.23.66.247,1,1469,0,0,1,1469,0.603102000,0.0000
136.25.188.220,<->,29.214.71.87,1,1005,0,0,1,1005,0.602986000,0.0000
196.119.221.14,<->,92.27.194.147,0,0,1,315,1,315,0.602727000,0.0000
215.158.238.105,<->,141.162.130.246,1,1085,0,0,1,1085,0.602578000,0.0000
207.41.108.253,<->,8.182.241.177,0,0,1,582,1,582,0.602088000,0.0000
133.178.226.30,<->,76.100.141.20,1,1197,0,0,1,1197,0.602022000,0.0000
159.178.76.115,<->,8.52.189.207,0,0,1,465,1,465,0.601967000,0.0000
215.158.238.133,<->,125.84.60.105,1,1133,0,0,1,1133,0.601881000,0.0000
142.200.230.208,<->,50.224.76.235,0,0,1,1197,1,1197,0.601305000,0.0000
215.158.239.95,<->,195.80.130.58,1,827,0,0,1,827,0.601010000,0.0000
246.253.253.171,<->,53.213.238.198,1,619,0,0,1,619,0.600707000,0.0000
215.158.238.196,<->,8.222.6.193,1,1065,0,0,1,1065,0.600670000,0.0000
8.252.223.175,<->,8.222.6.193,1,955,0,0,1,955,0.600307000,0.0000
215.158.239.57,<->,194.228.138.175,1,404,0,0,1,404,0.599811000,0.0000
133.178.226.28,<->,29.211.6.52,1,400,0,0,1,400,0.598992000,0.0000
232.31.155.21,<->,97.198.118.56,0,0,1,404,1,404,0.598819000,0.0000
136.25.189.80,<->,135.229.0.214,1,1325,0,0,1,1325,0.598753000,0.0000
199.72.102.100,<->,136.25.188.253,0,0,1,101,1,101,0.598693000,0.0000
139.163.95.3,<->,97.227.196.236,1,528,0,0,1,528,0.598534000,0.0000
215.158.238.65,<->,131.2.115.246,1,1245,0,0,1,1245,0.598243000,0.0000
50.224.76.248,<->,50.51.78.188,1,478,0,0,1,478,0.598187000,0.0000
97.126.4.233,<->,53.201.139.67,1,87,0,0,1,87,0.597854000,0.0000
215.158.238.81,<->,131.144.113.181,1,1053,0,0,1,1053,0.597652000,0.0000
215.158.238.96,<->,126.219.102.245,1,1101,0,0,1,1101,0.597629000,0.0000
192.228.30.221,<->,133.178.227.243,0,0,1,598,1,598,0.597555000,0.0000
133.178.227.16,<->,69.150.168.254,1,1245,0,0,1,1245,0.597257000,0.0000
29.214.108.233,<->,8.252.223.160,0,0,1,1041,1,1041,0.597060000,0.0000
215.158.238.251,<->,158.85.50.137,1,1050,0,0,1,1050,0.597040000,0.0000
136.25.188.239,<->,57.210.107.8,1,1245,0,0,1,1245,0.596572000,0.0000
136.25.189.85,<->,129.175.139.162,1,117,0,0,1,117,0.596355000,0.0000
215.158.239.32,<->,106.188.214.42,1,103,0,0,1,103,0.596192000,0.0000
144.85.170.245,<->,91.69.181.133,1,768,0,0,1,768,0.596009000,0.0000
144.253.73.232,<->,133.178.227.235,0,0,1,94,1,94,0.595202000,0.0000
207.178.147.200,<->,139.193.141.209,0,0,1,545,1,545,0.595202000,0.0000
100.228.42.97,<->,92.175.44.111,1,573,0,0,1,573,0.594629000,0.0000
204.61.111.1,<->,136.25.188.55,0,0,1,328,1,328,0.594622000,0.0000
204.184.91.6,<->,136.25.188.222,0,0,1,272,1,272,0.594236000,0.0000
199.15.129.188,<->,136.25.188.196,0,0,1,100,1,100,0.594156000,0.0000
144.85.170.208,<->,91.69.185.131,1,451,0,0,1,451,0.594126000,0.0000
204.21.153.119,<->,136.25.188.252,0,0,1,754,1,754,0.593973000,0.0000
220.20.200.94,<->,133.248.86.103,1,1021,0,0,1,1021,0.593915000,0.0000
215.158.140.164,<->,141.199.67.10,1,1247,0,0,1,1247,0.593679000,0.0000
215.158.239.92,<->,199.122.248.201,1,602,0,0,1,602,0.593311000,0.0000
199.50.209.190,<->,136.25.188.241,0,0,1,593,1,593,0.592792000,0.0000
199.61.238.80,<->,50.224.76.234,0,0,1,59,1,59,0.592766000,0.0000
26.236.42.98,<->,8.220.190.86,0,0,1,1282,1,1282,0.592415000,0.0000
143.20.222.208,<->,50.224.76.234,0,0,1,1048,1,1048,0.592182000,0.0000
215.158.239.87,<->,207.167.253.182,1,1125,0,0,1,1125,0.592038000,0.0000
111.20.168.123,<->,92.160.6.97,1,377,0,0,1,377,0.591984000,0.0000
199.15.22.26,<->,136.25.188.163,0,0,1,141,1,141,0.591958000,0.0000
215.158.239.49,<->,195.80.132.108,1,93,0,0,1,93,0.591893000,0.0000
232.31.148.11,<->,97.198.118.56,0,0,1,416,1,416,0.591881000,0.0000
215.158.140.231,<->,156.165.33.9,1,1102,0,0,1,1102,0.591818000,0.0000
103.121.131.2,<->,8.220.190.86,0,0,1,558,1,558,0.591797000,0.0000
215.158.140.75,<->,192.226.161.99,1,1442,0,0,1,1442,0.591786000,0.0000
220.20.200.91,<->,131.45.239.178,1,526,0,0,1,526,0.591753000,0.0000
143.135.73.220,<->,136.25.188.177,0,0,1,1009,1,1009,0.591696000,0.0000
220.28.65.9,<->,136.25.189.10,0,0,1,662,1,662,0.591633000,0.0000
136.25.188.44,<->,126.219.132.252,1,1277,0,0,1,1277,0.590626000,0.0000
215.158.238.133,<->,8.217.44.52,1,1245,0,0,1,1245,0.590533000,0.0000
106.22.92.216,<->,8.52.166.232,0,0,1,484,1,484,0.590408000,0.0000
215.158.239.92,<->,196.91.245.45,1,541,0,0,1,541,0.590220000,0.0000
204.142.57.128,<->,50.223.3.228,0,0,1,170,1,170,0.590124000,0.0000
139.241.56.46,<->,99.74.87.215,0,0,1,357,1,357,0.590104000,0.0000
215.158.238.220,<->,58.169.54.154,1,209,0,0,1,209,0.590044000,0.0000
252.98.141.99,<->,210.209.251.223,1,481,0,0,1,481,0.589625000,0.0000
215.158.238.143,<->,6.73.247.91,1,1213,0,0,1,1213,0.589390000,0.0000
213.186.52.58,<->,144.85.170.246,0,0,1,888,1,888,0.589204000,0.0000
111.147.148.245,<->,53.244.246.126,1,109,0,0,1,109,0.588698000,0.0000
136.25.189.2,<->,126.219.49.40,1,1213,0,0,1,1213,0.588678000,0.0000
136.129.94.157,<->,111.199.239.9,1,414,0,0,1,414,0.588654000,0.0000
215.158.238.105,<->,131.6.152.17,1,1165,0,0,1,1165,0.588476000,0.0000
220.28.85.14,<->,133.178.226.85,0,0,1,827,1,827,0.588313000,0.0000
136.25.189.16,<->,128.23.84.26,1,1325,0,0,1,1325,0.587919000,0.0000
136.25.189.29,<->,8.47.120.219,1,1213,0,0,1,1213,0.587596000,0.0000
141.102.147.150,<->,92.162.253.86,0,0,1,1180,1,1180,0.587301000,0.0000
90.240.140.153,<->,54.59.43.115,1,604,0,0,1,604,0.587283000,0.0000
215.158.238.126,<->,100.224.166.158,1,506,0,0,1,506,0.587271000,0.0000
215.158.238.241,<->,8.50.171.220,1,1040,0,0,1,1040,0.587211000,0.0000
144.85.170.254,<->,98.87.144.231,1,396,0,0,1,396,0.587142000,0.0000
195.14.126.59,<->,136.25.188.46,0,0,1,649,1,649,0.587080000,0.0000
138.126.13.23,<->,50.224.76.230,0,0,1,546,1,546,0.586515000,0.0000
215.158.238.65,<->,192.228.30.85,1,1245,0,0,1,1245,0.586432000,0.0000
215.158.238.250,<->,149.254.114.124,1,1177,0,0,1,1177,0.586356000,0.0000
200.174.192.136,<->,54.37.1.37,1,318,0,0,1,318,0.586354000,0.0000
215.158.238.105,<->,159.182.91.27,1,1117,0,0,1,1117,0.586287000,0.0000
195.214.29.232,<->,50.223.3.228,0,0,1,228,1,228,0.586277000,0.0000
205.187.74.216,<->,109.1.18.115,0,0,1,336,1,336,0.585911000,0.0000
210.229.230.20,<->,110.241.106.59,1,277,0,0,1,277,0.585572000,0.0000
128.145.161.120,<->,8.220.179.243,0,0,1,317,1,317,0.584442000,0.0000
215.158.239.79,<->,199.20.28.197,1,256,0,0,1,256,0.584408000,0.0000
221.102.143.189,<->,220.81.19.4,0,0,1,141,1,141,0.584223000,0.0000
98.129.68.142,<->,8.45.168.98,1,87,0,0,1,87,0.584046000,0.0000
215.158.238.64,<->,8.220.51.216,1,1181,0,0,1,1181,0.583438000,0.0000
215.158.238.241,<->,192.171.32.152,1,1045,0,0,1,1045,0.583047000,0.0000
213.186.52.112,<->,144.85.170.254,0,0,1,884,1,884,0.582944000,0.0000
142.209.157.97,<->,136.25.188.252,0,0,1,95,1,95,0.582403000,0.0000
207.61.74.42,<->,136.25.188.176,0,0,1,602,1,602,0.582321000,0.0000
215.158.239.41,<->,29.212.195.149,1,75,0,0,1,75,0.581861000,0.0000
215.158.238.64,<->,114.94.161.204,1,1133,0,0,1,1133,0.581722000,0.0000
215.158.239.99,<->,207.167.186.84,1,669,0,0,1,669,0.581581000,0.0000
111.181.125.231,<->,8.55.227.120,1,196,0,0,1,196,0.580894000,0.0000
221.102.143.189,<->,102.83.236.228,0,0,1,141,1,141,0.580885000,0.0000
195.6.239.178,<->,136.25.188.225,0,0,1,653,1,653,0.580573000,0.0000
194.232.222.255,<->,136.25.188.239,0,0,1,765,1,765,0.580486000,0.0000
133.178.227.247,<->,69.132.159.48,1,861,0,0,1,861,0.580143000,0.0000
215.158.238.72,<->,131.251.111.3,1,1341,0,0,1,1341,0.579854000,0.0000
216.184.2.234,<->,136.25.189.32,0,0,1,1118,1,1118,0.579791000,0.0000
133.178.227.19,<->,29.211.165.89,1,1045,0,0,1,1045,0.579277000,0.0000
136.25.189.2,<->,56.28.207.201,1,101,0,0,1,101,0.578983000,0.0000
133.178.226.29,<->,29.213.219.30,1,1229,0,0,1,1229,0.578894000,0.0000
215.158.238.64,<->,122.159.245.163,1,93,0,0,1,93,0.578640000,0.0000
215.158.3.195,<->,8.176.8.36,0,0,1,601,1,601,0.578584000,0.0000
215.158.140.241,<->,57.97.102.151,1,1322,0,0,1,1322,0.578360000,0.0000
142.172.96.121,<->,8.220.189.63,0,0,1,634,1,634,0.577349000,0.0000
224.93.235.36,<->,80.27.157.204,0,0,1,1345,1,1345,0.577203000,0.0000
215.158.239.84,<->,199.20.23.105,1,93,0,0,1,93,0.577136000,0.0000
215.158.239.17,<->,80.57.141.171,1,1152,0,0,1,1152,0.576873000,0.0000
215.158.238.81,<->,88.51.246.250,1,1181,0,0,1,1181,0.576267000,0.0000
235.254.160.52,<->,92.27.219.219,0,0,1,153,1,153,0.576194000,0.0000
215.158.238.133,<->,197.125.88.7,1,1341,0,0,1,1341,0.575828000,0.0000
204.185.167.224,<->,136.25.188.163,0,0,1,351,1,351,0.575593000,0.0000
42.66.86.95,<->,8.220.176.253,0,0,1,545,1,545,0.575331000,0.0000
215.158.239.210,<->,106.188.184.103,1,325,0,0,1,325,0.575270000,0.0000
215.158.239.68,<->,199.20.31.109,1,93,0,0,1,93,0.575213000,0.0000
143.43.38.70,<->,136.25.188.174,0,0,1,781,1,781,0.574938000,0.0000
43.54.163.41,<->,8.252.221.222,0,0,1,385,1,385,0.574914000,0.0000
215.158.239.97,<->,196.91.53.11,1,93,0,0,1,93,0.574745000,0.0000
133.32.39.1,<->,8.45.242.87,1,247,0,0,1,247,0.574212000,0.0000
201.192.214.122,<->,139.163.96.103,0,0,1,706,1,706,0.573989000,0.0000
215.158.238.98,<->,98.249.65.10,1,97,0,0,1,97,0.573921000,0.0000
136.25.189.90,<->,135.228.221.200,1,1373,0,0,1,1373,0.573102000,0.0000
215.158.239.97,<->,199.20.31.245,1,117,0,0,1,117,0.572915000,0.0000
215.158.238.143,<->,57.227.83.196,1,1357,0,0,1,1357,0.572884000,0.0000
136.25.188.53,<->,119.196.23.21,1,1309,0,0,1,1309,0.572821000,0.0000
101.70.112.204,<->,8.232.214.178,1,87,0,0,1,87,0.572735000,0.0000
215.158.239.70,<->,192.224.21.11,1,1229,0,0,1,1229,0.572707000,0.0000
213.186.61.53,<->,144.85.170.254,0,0,1,1031,1,1031,0.572500000,0.0000
215.158.238.96,<->,8.240.118.180,1,1309,0,0,1,1309,0.572375000,0.0000
215.158.239.49,<->,199.20.4.59,1,849,0,0,1,849,0.572294000,0.0000
215.158.61.195,<->,8.176.8.210,0,0,1,823,1,823,0.570660000,0.0000
48.131.156.42,<->,8.252.222.176,0,0,1,1357,1,1357,0.570547000,0.0000
195.70.210.121,<->,92.27.194.147,0,0,1,246,1,246,0.570302000,0.0000
101.235.67.95,<->,8.20.81.7,1,730,0,0,1,730,0.570270000,0.0000
215.158.23.53,<->,145.116.206.214,1,68,0,0,1,68,0.569920000,0.0000
215.158.238.32,<->,57.227.81.35,1,1133,0,0,1,1133,0.569836000,0.0000
215.158.140.229,<->,48.131.159.6,1,1245,0,0,1,1245,0.569706000,0.0000
232.31.192.217,<->,97.198.118.56,0,0,1,375,1,375,0.569650000,0.0000
215.158.140.83,<->,112.93.136.122,1,73,0,0,1,73,0.569632000,0.0000
142.254.141.3,<->,136.25.188.226,0,0,1,87,1,87,0.569612000,0.0000
207.3.132.1,<->,139.193.141.139,0,0,1,614,1,614,0.569481000,0.0000
198.34.203.242,<->,50.224.76.230,0,0,1,1064,1,1064,0.569145000,0.0000
192.67.159.184,<->,109.219.207.0,1,331,0,0,1,331,0.568878000,0.0000
136.25.188.211,<->,122.158.245.88,1,1357,0,0,1,1357,0.568512000,0.0000
221.102.143.189,<->,213.38.156.109,0,0,1,141,1,141,0.568469000,0.0000
119.128.250.34,<->,50.224.76.248,0,0,1,1226,1,1226,0.568297000,0.0000
76.11.5.51,<->,35.56.100.173,0,0,1,342,1,342,0.567770000,0.0000
215.158.238.105,<->,116.106.60.163,1,1357,0,0,1,1357,0.567756000,0.0000
76.179.80.245,<->,8.252.221.221,0,0,1,549,1,549,0.567549000,0.0000
215.158.238.120,<->,118.20.87.79,1,1357,0,0,1,1357,0.567272000,0.0000
197.113.99.135,<->,136.25.188.209,0,0,1,765,1,765,0.567228000,0.0000
133.178.227.255,<->,8.35.106.108,1,300,0,0,1,300,0.567046000,0.0000
131.78.5.109,<->,89.183.104.143,0,0,1,97,1,97,0.566967000,0.0000
136.25.189.82,<->,133.224.119.33,1,1229,0,0,1,1229,0.566787000,0.0000
133.178.226.37,<->,76.100.108.230,1,1213,0,0,1,1213,0.566551000,0.0000
139.193.141.139,<->,117.23.6.36,1,419,0,0,1,419,0.566236000,0.0000
202.33.240.214,<->,136.25.188.227,0,0,1,87,1,87,0.566167000,0.0000
194.237.250.14,<->,136.25.188.236,0,0,1,157,1,157,0.565932000,0.0000
215.158.140.187,<->,99.124.166.199,1,373,0,0,1,373,0.565455000,0.0000
215.158.140.11,<->,53.160.111.19,1,728,0,0,1,728,0.565431000,0.0000
144.71.44.67,<->,143.73.157.209,1,616,0,0,1,616,0.565402000,0.0000
220.55.104.32,<->,203.120.90.182,1,548,0,0,1,548,0.565225000,0.0000
215.158.239.113,<->,129.222.36.154,1,1235,0,0,1,1235,0.564420000,0.0000
136.25.188.160,<->,119.196.23.43,1,1341,0,0,1,1341,0.564395000,0.0000
215.158.239.96,<->,195.13.169.16,1,93,0,0,1,93,0.564270000,0.0000
99.167.60.63,<->,92.27.219.179,0,0,1,257,1,257,0.564033000,0.0000
215.158.239.43,<->,122.158.239.251,1,1500,0,0,1,1500,0.563341000,0.0000
215.158.239.42,<->,8.241.236.248,1,1477,0,0,1,1477,0.563117000,0.0000
195.6.221.235,<->,136.25.188.175,0,0,1,117,1,117,0.562966000,0.0000
215.158.239.244,<->,145.234.107.201,1,154,0,0,1,154,0.562927000,0.0000
215.158.239.95,<->,207.61.246.164,1,701,0,0,1,701,0.562880000,0.0000
215.158.239.76,<->,199.20.28.3,1,581,0,0,1,581,0.562697000,0.0000
130.237.156.145,<->,50.224.76.234,0,0,1,998,1,998,0.562681000,0.0000
207.188.104.86,<->,136.25.188.222,0,0,1,93,1,93,0.562664000,0.0000
207.59.200.176,<->,92.27.194.147,0,0,1,249,1,249,0.562430000,0.0000
195.69.233.232,<->,136.25.188.196,0,0,1,632,1,632,0.562359000,0.0000
136.25.188.45,<->,122.158.51.63,1,1165,0,0,1,1165,0.562328000,0.0000
215.158.238.74,<->,192.205.37.235,1,1261,0,0,1,1261,0.562237000,0.0000
199.69.165.34,<->,136.25.188.238,0,0,1,1379,1,1379,0.561930000,0.0000
136.25.188.44,<->,48.129.133.32,1,1389,0,0,1,1389,0.561579000,0.0000
215.158.140.60,<->,122.251.2.195,1,1089,0,0,1,1089,0.560614000,0.0000
215.158.140.241,<->,119.168.0.231,1,1197,0,0,1,1197,0.560552000,0.0000
133.178.227.57,<->,69.150.168.218,1,1057,0,0,1,1057,0.560402000,0.0000
220.28.85.14,<->,133.178.227.52,0,0,1,1305,1,1305,0.560237000,0.0000
89.183.110.107,<->,75.24.59.240,1,108,0,0,1,108,0.560092000,0.0000
215.158.239.84,<->,199.20.31.230,1,172,0,0,1,172,0.559992000,0.0000
143.52.112.102,<->,136.25.188.55,0,0,1,618,1,618,0.559666000,0.0000
215.158.239.57,<->,141.199.76.228,1,1245,0,0,1,1245,0.559544000,0.0000
207.86.141.69,<->,8.20.87.153,0,0,1,801,1,801,0.559387000,0.0000
215.158.239.96,<->,204.2.2.173,1,327,0,0,1,327,0.559237000,0.0000
80.40.17.186,<->,22.249.18.74,1,650,0,0,1,650,0.559036000,0.0000
232.31.155.15,<->,97.198.118.56,0,0,1,394,1,394,0.558887000,0.0000
215.158.140.229,<->,76.100.141.52,1,1089,0,0,1,1089,0.558833000,0.0000
194.232.238.24,<->,136.25.188.55,0,0,1,781,1,781,0.558617000,0.0000
197.113.99.27,<->,136.25.188.254,0,0,1,97,1,97,0.558463000,0.0000
111.146.174.85,<->,53.244.230.218,1,956,0,0,1,956,0.558077000,0.0000
215.158.238.132,<->,104.3.163.105,1,1373,0,0,1,1373,0.557626000,0.0000
195.12.2.213,<->,136.25.188.198,0,0,1,89,1,89,0.557598000,0.0000
210.229.230.18,<->,100.107.26.137,1,80,0,0,1,80,0.557410000,0.0000
159.23.227.147,<->,94.196.172.177,1,76,0,0,1,76,0.557363000,0.0000
17.240.3.26,<->,8.220.188.138,0,0,1,601,1,601,0.557303000,0.0000
97.94.1.70,<->,92.27.219.208,0,0,1,90,1,90,0.557071000,0.0000
200.174.99.189,<->,53.160.81.233,1,601,0,0,1,601,0.556966000,0.0000
232.31.192.223,<->,97.198.118.56,0,0,1,532,1,532,0.556906000,0.0000
248.239.187.11,<->,8.45.175.127,1,321,0,0,1,321,0.556869000,0.0000
136.25.188.56,<->,0.195.253.228,1,463,0,0,1,463,0.556734000,0.0000
215.158.238.105,<->,68.124.221.43,1,1085,0,0,1,1085,0.556600000,0.0000
58.60.45.22,<->,8.252.221.223,0,0,1,580,1,580,0.556502000,0.0000
215.158.238.104,<->,140.173.227.38,1,1229,0,0,1,1229,0.556457000,0.0000
54.38.126.203,<->,48.53.101.0,0,0,1,125,1,125,0.556193000,0.0000
215.158.239.70,<->,128.69.139.87,1,1213,0,0,1,1213,0.555820000,0.0000
204.0.251.51,<->,136.25.188.174,0,0,1,602,1,602,0.555807000,0.0000
136.25.188.174,<->,98.166.239.41,1,1325,0,0,1,1325,0.555774000,0.0000
215.158.238.107,<->,86.151.231.8,1,1373,0,0,1,1373,0.555468000,0.0000
53.161.254.252,<->,48.54.131.41,0,0,1,93,1,93,0.555424000,0.0000
215.158.238.81,<->,192.228.30.34,1,1229,0,0,1,1229,0.555295000,0.0000
215.158.239.49,<->,38.104.11.60,1,1373,0,0,1,1373,0.555233000,0.0000
158.206.162.249,<->,139.163.26.146,0,0,1,99,1,99,0.555194000,0.0000
141.32.13.13,<->,139.193.141.139,0,0,1,389,1,389,0.555139000,0.0000
133.178.226.28,<->,89.86.110.10,1,1149,0,0,1,1149,0.554816000,0.0000
207.172.228.166,<->,136.25.188.225,0,0,1,93,1,93,0.554349000,0.0000
215.158.239.51,<->,204.56.169.160,1,93,0,0,1,93,0.554241000,0.0000
207.86.5.44,<->,50.224.76.235,0,0,1,668,1,668,0.553978000,0.0000
101.126.187.24,<->,8.55.231.92,1,93,0,0,1,93,0.553867000,0.0000
100.228.42.97,<->,92.175.46.101,1,589,0,0,1,589,0.553399000,0.0000
204.248.217.8,<->,0.195.210.44,0,0,1,93,1,93,0.553305000,0.0000
149.56.162.236,<->,89.183.104.175,0,0,1,484,1,484,0.553239000,0.0000
195.126.148.14,<->,136.25.188.53,0,0,1,101,1,101,0.553026000,0.0000
215.158.238.241,<->,131.22.233.144,1,1044,0,0,1,1044,0.552837000,0.0000
213.186.61.123,<->,144.85.170.208,0,0,1,451,1,451,0.552786000,0.0000
215.158.238.45,<->,148.129.19.94,1,1357,0,0,1,1357,0.552357000,0.0000
215.158.239.57,<->,212.70.217.127,1,1325,0,0,1,1325,0.552012000,0.0000
221.102.56.69,<->,220.80.238.103,0,0,1,294,1,294,0.551770000,0.0000
215.158.239.70,<->,120.154.225.187,1,1181,0,0,1,1181,0.551710000,0.0000
53.221.209.144,<->,48.52.122.97,0,0,1,306,1,306,0.551684000,0.0000
113.206.203.173,<->,89.153.90.223,0,0,1,76,1,76,0.551402000,0.0000
137.137.103.117,<->,112.55.53.67,1,85,0,0,1,85,0.551112000,0.0000
204.63.216.149,<->,136.25.188.253,0,0,1,602,1,602,0.550418000,0.0000
215.158.238.120,<->,104.3.161.52,1,1277,0,0,1,1277,0.550069000,0.0000
221.102.143.189,<->,80.42.169.109,0,0,1,141,1,141,0.550048000,0.0000
193.21.29.248,<->,102.50.198.43,0,0,1,493,1,493,0.549853000,0.0000
215.158.239.79,<->,199.20.28.158,1,87,0,0,1,87,0.549624000,0.0000
148.26.113.33,<->,136.25.189.18,0,0,1,1309,1,1309,0.548980000,0.0000
143.155.227.54,<->,133.178.226.70,0,0,1,1117,1,1117,0.548724000,0.0000
136.25.188.211,<->,104.3.161.56,1,1213,0,0,1,1213,0.547924000,0.0000
136.25.188.162,<->,113.23.104.247,1,1277,0,0,1,1277,0.547834000,0.0000
215.158.239.113,<->,129.222.36.182,1,904,0,0,1,904,0.547810000,0.0000
133.32.39.0,<->,8.193.178.56,1,247,0,0,1,247,0.547118000,0.0000
215.158.238.223,<->,104.154.137.59,1,1046,0,0,1,1046,0.546815000,0.0000
205.127.108.115,<->,101.224.89.150,0,0,1,300,1,300,0.546667000,0.0000
215.158.239.56,<->,199.20.29.163,1,93,0,0,1,93,0.546650000,0.0000
112.208.20.177,<->,6.73.192.233,0,0,1,163,1,163,0.546579000,0.0000
195.40.227.240,<->,136.25.188.252,0,0,1,170,1,170,0.546269000,0.0000
215.158.239.253,<->,8.240.118.235,1,146,0,0,1,146,0.545730000,0.0000
246.253.253.170,<->,210.231.140.55,1,731,0,0,1,731,0.544978000,0.0000
207.51.134.215,<->,8.220.178.73,0,0,1,251,1,251,0.544814000,0.0000
215.158.140.60,<->,8.220.54.107,1,1144,0,0,1,1144,0.544438000,0.0000
210.229.230.19,<->,138.55.235.100,1,68,0,0,1,68,0.544222000,0.0000
207.63.119.212,<->,136.25.188.238,0,0,1,89,1,89,0.544122000,0.0000
136.25.189.77,<->,58.49.163.234,1,1357,0,0,1,1357,0.543559000,0.0000
134.240.212.232,<->,50.224.76.234,0,0,1,1240,1,1240,0.543337000,0.0000
89.85.89.215,<->,8.252.222.185,0,0,1,1213,1,1213,0.543306000,0.0000
109.1.17.28,<->,53.149.122.156,1,125,0,0,1,125,0.543102000,0.0000
89.204.29.47,<->,8.183.25.124,0,0,1,182,1,182,0.542746000,0.0000
239.66.104.92,<->,97.198.118.56,0,0,1,713,1,713,0.542295000,0.0000
215.158.238.106,<->,111.150.186.220,1,1325,0,0,1,1325,0.541753000,0.0000
133.178.226.29,<->,131.36.198.34,1,1118,0,0,1,1118,0.541664000,0.0000
127.128.216.186,<->,92.168.217.252,0,0,1,316,1,316,0.541412000,0.0000
215.158.238.96,<->,8.222.96.7,1,1309,0,0,1,1309,0.541083000,0.0000
57.31.50.25,<->,8.252.223.175,0,0,1,910,1,910,0.540502000,0.0000
246.253.253.97,<->,53.167.183.246,1,1333,0,0,1,1333,0.540090000,0.0000
111.147.205.146,<->,73.107.78.160,1,121,0,0,1,121,0.539529000,0.0000
133.178.226.19,<->,29.123.209.149,1,1069,0,0,1,1069,0.539431000,0.0000
215.201.235.99,<->,144.85.170.254,0,0,1,891,1,891,0.539253000,0.0000
133.32.39.0,<->,8.193.74.162,1,247,0,0,1,247,0.538973000,0.0000
133.178.227.27,<->,104.3.168.136,1,1357,0,0,1,1357,0.538662000,0.0000
56.112.212.218,<->,8.182.238.140,0,0,1,486,1,486,0.538655000,0.0000
159.6.238.19,<->,136.25.188.242,0,0,1,117,1,117,0.538653000,0.0000
112.29.96.63,<->,50.224.76.235,0,0,1,882,1,882,0.538639000,0.0000
53.201.106.213,<->,48.52.105.184,0,0,1,113,1,113,0.538633000,0.0000
142.241.229.0,<->,136.25.188.45,0,0,1,765,1,765,0.538537000,0.0000
196.119.218.162,<->,50.224.76.235,0,0,1,1119,1,1119,0.537977000,0.0000
230.76.194.65,<->,220.81.23.25,0,0,1,334,1,334,0.536942000,0.0000
215.158.238.94,<->,149.96.53.37,1,1405,0,0,1,1405,0.536833000,0.0000
215.158.239.92,<->,199.20.30.125,1,117,0,0,1,117,0.536709000,0.0000
142.248.146.243,<->,136.25.188.254,0,0,1,262,1,262,0.536468000,0.0000
159.119.5.206,<->,8.220.176.253,0,0,1,397,1,397,0.536446000,0.0000
136.25.188.160,<->,131.251.111.22,1,1357,0,0,1,1357,0.536250000,0.0000
92.27.219.245,<->,33.57.79.34,1,1396,0,0,1,1396,0.535898000,0.0000
215.158.238.33,<->,113.23.104.247,1,1165,0,0,1,1165,0.535705000,0.0000
133.178.226.76,<->,38.20.151.87,1,1229,0,0,1,1229,0.534973000,0.0000
207.189.93.92,<->,92.27.194.147,0,0,1,275,1,275,0.534953000,0.0000
133.178.226.28,<->,126.219.190.180,1,1229,0,0,1,1229,0.534804000,0.0000
133.178.226.61,<->,8.191.14.19,1,1310,0,0,1,1310,0.534434000,0.0000
126.198.147.25,<->,100.93.141.169,0,0,1,342,1,342,0.534426000,0.0000
93.183.125.243,<->,92.162.253.128,0,0,1,1107,1,1107,0.534276000,0.0000
232.31.148.13,<->,97.198.118.56,0,0,1,689,1,689,0.533795000,0.0000
133.178.227.79,<->,123.166.46.117,1,1038,0,0,1,1038,0.533786000,0.0000
201.205.10.52,<->,144.88.76.44,0,0,1,454,1,454,0.533626000,0.0000
201.139.235.25,<->,8.252.221.204,0,0,1,458,1,458,0.533333000,0.0000
232.31.155.11,<->,97.198.118.56,0,0,1,574,1,574,0.533170000,0.0000
231.142.162.108,<->,215.158.239.76,0,0,1,85,1,85,0.533156000,0.0000
207.58.103.150,<->,136.25.188.238,0,0,1,830,1,830,0.532906000,0.0000
232.31.148.12,<->,97.198.118.56,0,0,1,400,1,400,0.532817000,0.0000
215.158.239.99,<->,196.168.209.120,1,168,0,0,1,168,0.532767000,0.0000
144.83.60.153,<->,92.162.253.68,0,0,1,665,1,665,0.532656000,0.0000
215.158.239.5,<->,8.255.92.81,1,1034,0,0,1,1034,0.532285000,0.0000
142.228.23.76,<->,136.25.188.255,0,0,1,208,1,208,0.532229000,0.0000
215.158.239.86,<->,196.109.26.182,1,101,0,0,1,101,0.532086000,0.0000
149.231.78.69,<->,139.193.141.139,0,0,1,339,1,339,0.531579000,0.0000
215.158.238.135,<->,8.191.6.123,1,1357,0,0,1,1357,0.531443000,0.0000
215.158.238.45,<->,8.222.0.245,1,1245,0,0,1,1245,0.531441000,0.0000
143.155.227.59,<->,136.25.188.225,0,0,1,93,1,93,0.531267000,0.0000
129.225.135.222,<->,129.225.132.224,0,0,1,413,1,413,0.530933000,0.0000
111.150.207.51,<->,99.74.26.110,0,0,1,100,1,100,0.530757000,0.0000
133.178.226.29,<->,57.3.89.231,1,1325,0,0,1,1325,0.530554000,0.0000
152.44.249.112,<->,133.54.43.53,0,0,1,728,1,728,0.530409000,0.0000
136.25.188.227,<->,35.77.32.33,1,89,0,0,1,89,0.530250000,0.0000
159.112.9.198,<->,99.72.206.97,0,0,1,81,1,81,0.530103000,0.0000
215.158.239.35,<->,8.252.253.196,1,1451,0,0,1,1451,0.530038000,0.0000
133.178.227.41,<->,106.188.245.227,1,1437,0,0,1,1437,0.529476000,0.0000
139.163.26.146,<->,139.7.252.107,1,111,0,0,1,111,0.529240000,0.0000
56.112.166.221,<->,8.182.141.189,0,0,1,518,1,518,0.529065000,0.0000
196.247.34.76,<->,136.25.188.253,0,0,1,93,1,93,0.528802000,0.0000
136.25.189.33,<->,116.106.46.86,1,1373,0,0,1,1373,0.528755000,0.0000
136.88.62.107,<->,136.25.188.222,0,0,1,280,1,280,0.527626000,0.0000
143.129.40.246,<->,136.25.188.198,0,0,1,85,1,85,0.526723000,0.0000
215.158.238.189,<->,33.209.210.176,1,1217,0,0,1,1217,0.526129000,0.0000
215.158.239.93,<->,29.212.198.183,1,1213,0,0,1,1213,0.525688000,0.0000
133.178.226.76,<->,112.220.206.116,1,93,0,0,1,93,0.525648000,0.0000
136.25.188.236,<->,29.211.6.61,1,1135,0,0,1,1135,0.525377000,0.0000
215.158.239.57,<->,119.168.0.57,1,1373,0,0,1,1373,0.525319000,0.0000
232.31.43.151,<->,97.198.118.56,0,0,1,398,1,398,0.525099000,0.0000
138.98.197.173,<->,89.183.98.97,1,526,0,0,1,526,0.524953000,0.0000
204.21.247.226,<->,136.25.188.225,0,0,1,250,1,250,0.524763000,0.0000
215.158.238.66,<->,29.211.186.57,1,1101,0,0,1,1101,0.524620000,0.0000
215.158.239.57,<->,195.55.52.16,1,629,0,0,1,629,0.524617000,0.0000
73.94.145.187,<->,0.195.210.42,0,0,1,450,1,450,0.524529000,0.0000
195.40.9.209,<->,136.25.188.243,0,0,1,765,1,765,0.524227000,0.0000
207.160.220.252,<->,0.195.210.35,0,0,1,137,1,137,0.524171000,0.0000
142.236.26.141,<->,136.25.188.225,0,0,1,306,1,306,0.523981000,0.0000
210.229.230.21,<->,145.44.124.147,1,50,0,0,1,50,0.523922000,0.0000
215.158.238.133,<->,111.151.70.20,1,1341,0,0,1,1341,0.523743000,0.0000
136.25.189.12,<->,6.73.9.210,1,1405,0,0,1,1405,0.523639000,0.0000
210.229.230.19,<->,6.192.99.218,1,68,0,0,1,68,0.523474000,0.0000
100.92.104.175,<->,88.8.73.190,1,138,0,0,1,138,0.522924000,0.0000
159.228.245.125,<->,159.137.208.5,0,0,1,1003,1,1003,0.522699000,0.0000
215.158.239.78,<->,126.219.49.136,1,1357,0,0,1,1357,0.522462000,0.0000
251.60.180.100,<->,101.73.153.44,0,0,1,50,1,50,0.521743000,0.0000
232.31.108.53,<->,97.198.118.56,0,0,1,397,1,397,0.521622000,0.0000
246.253.253.113,<->,210.209.251.211,1,323,0,0,1,323,0.521353000,0.0000
136.25.189.12,<->,133.146.0.169,1,1373,0,0,1,1373,0.521268000,0.0000
232.31.43.149,<->,97.198.118.56,0,0,1,407,1,407,0.521057000,0.0000
159.13.153.140,<->,129.124.149.147,1,760,0,0,1,760,0.520946000,0.0000
232.31.241.228,<->,97.198.118.56,0,0,1,531,1,531,0.520743000,0.0000
196.233.230.61,<->,8.182.139.40,0,0,1,75,1,75,0.520650000,0.0000
118.192.88.114,<->,80.41.4.115,0,0,1,249,1,249,0.520649000,0.0000
215.158.239.69,<->,126.219.194.40,1,1485,0,0,1,1485,0.520578000,0.0000
144.92.163.176,<->,53.167.48.249,1,75,0,0,1,75,0.519685000,0.0000
8.220.189.81,<->,6.101.97.58,1,1334,0,0,1,1334,0.519201000,0.0000
215.158.239.109,<->,80.57.208.13,1,733,0,0,1,733,0.518486000,0.0000
108.39.251.230,<->,50.224.76.235,0,0,1,1163,1,1163,0.518034000,0.0000
144.85.170.208,<->,144.61.1.168,1,552,0,0,1,552,0.517317000,0.0000
248.239.169.84,<->,8.49.69.216,1,365,0,0,1,365,0.516771000,0.0000
80.41.15.5,<->,27.116.206.43,1,450,0,0,1,450,0.516519000,0.0000
221.102.103.73,<->,199.12.102.145,1,455,0,0,1,455,0.516277000,0.0000
129.224.112.220,<->,97.242.126.205,1,106,0,0,1,106,0.516186000,0.0000
136.25.188.226,<->,57.199.250.198,1,1341,0,0,1,1341,0.516074000,0.0000
136.25.188.38,<->,56.19.241.86,1,1297,0,0,1,1297,0.515955000,0.0000
136.25.188.44,<->,29.214.64.169,1,1373,0,0,1,1373,0.515678000,0.0000
215.158.238.80,<->,113.23.104.247,1,1133,0,0,1,1133,0.515361000,0.0000
215.158.239.76,<->,207.61.251.48,1,561,0,0,1,561,0.514784000,0.0000
136.25.188.173,<->,112.220.206.107,1,264,0,0,1,264,0.514501000,0.0000
133.178.226.233,<->,97.174.232.56,1,334,0,0,1,334,0.514352000,0.0000
215.158.239.35,<->,120.155.14.168,1,62,0,0,1,62,0.513827000,0.0000
195.69.152.181,<->,136.25.188.243,0,0,1,651,1,651,0.513319000,0.0000
139.163.26.238,<->,27.11.188.105,1,182,0,0,1,182,0.512911000,0.0000
199.8.138.98,<->,196.148.133.194,0,0,1,184,1,184,0.512629000,0.0000
159.13.141.83,<->,50.145.197.62,1,454,0,0,1,454,0.512485000,0.0000
122.213.95.243,<->,50.224.76.235,0,0,1,1121,1,1121,0.512276000,0.0000
68.208.141.19,<->,8.52.171.120,0,0,1,581,1,581,0.512112000,0.0000
215.158.239.78,<->,195.15.17.107,1,767,0,0,1,767,0.511698000,0.0000
215.158.238.123,<->,113.23.21.200,1,1213,0,0,1,1213,0.511031000,0.0000
215.158.61.182,<->,8.176.8.201,0,0,1,173,1,173,0.511004000,0.0000
99.162.77.146,<->,54.38.184.33,1,234,0,0,1,234,0.510780000,0.0000
215.158.239.79,<->,199.20.28.42,1,125,0,0,1,125,0.510750000,0.0000
215.158.239.85,<->,196.92.199.220,1,765,0,0,1,765,0.509827000,0.0000
135.253.11.54,<->,133.178.226.30,0,0,1,1325,1,1325,0.509268000,0.0000
213.221.90.234,<->,144.85.170.248,0,0,1,843,1,843,0.509226000,0.0000
215.158.238.133,<->,114.166.219.43,1,1149,0,0,1,1149,0.509147000,0.0000
195.126.152.22,<->,136.25.188.178,0,0,1,259,1,259,0.509139000,0.0000
133.178.226.30,<->,56.19.241.25,1,1229,0,0,1,1229,0.509133000,0.0000
215.158.239.35,<->,8.222.7.181,1,1113,0,0,1,1113,0.509077000,0.0000
215.158.239.57,<->,33.209.219.92,1,437,0,0,1,437,0.508776000,0.0000
192.229.212.192,<->,136.250.252.100,1,107,0,0,1,107,0.508727000,0.0000
215.158.239.87,<->,195.80.215.36,1,408,0,0,1,408,0.508716000,0.0000
215.158.140.64,<->,111.151.107.208,1,100,0,0,1,100,0.508621000,0.0000
194.232.117.36,<->,136.25.188.253,0,0,1,749,1,749,0.508614000,0.0000
195.40.190.30,<->,136.25.188.211,0,0,1,765,1,765,0.508395000,0.0000
17.99.120.221,<->,8.53.4.185,0,0,1,608,1,608,0.508260000,0.0000
215.158.239.96,<->,207.61.227.81,1,93,0,0,1,93,0.507813000,0.0000
215.158.239.78,<->,196.93.124.62,1,781,0,0,1,781,0.507636000,0.0000
215.158.103.203,<->,124.20.100.129,1,192,0,0,1,192,0.507247000,0.0000
216.144.221.35,<->,215.158.140.207,0,0,1,427,1,427,0.506240000,0.0000
92.170.88.168,<->,92.27.219.31,0,0,1,131,1,131,0.506066000,0.0000
207.3.171.193,<->,8.52.230.164,0,0,1,710,1,710,0.505841000,0.0000
215.158.140.60,<->,131.219.110.171,1,1216,0,0,1,1216,0.505604000,0.0000
215.158.239.78,<->,207.167.190.60,1,226,0,0,1,226,0.505104000,0.0000
117.6.100.72,<->,50.224.76.234,0,0,1,95,1,95,0.505091000,0.0000
220.80.133.58,<->,8.55.224.156,1,141,0,0,1,141,0.504952000,0.0000
215.158.238.75,<->,143.20.121.128,1,1180,0,0,1,1180,0.504847000,0.0000
215.158.238.250,<->,158.85.50.137,1,1046,0,0,1,1046,0.504718000,0.0000
215.158.238.209,<->,123.166.46.220,1,1226,0,0,1,1226,0.504319000,0.0000
215.158.239.43,<->,8.255.92.118,1,1262,0,0,1,1262,0.503683000,0.0000
215.158.238.82,<->,8.191.15.11,1,1309,0,0,1,1309,0.503421000,0.0000
215.158.238.112,<->,69.150.169.203,1,1213,0,0,1,1213,0.503260000,0.0000
136.25.189.1,<->,29.211.5.249,1,1229,0,0,1,1229,0.503180000,0.0000
111.20.172.177,<->,111.20.168.123,0,0,1,800,1,800,0.503145000,0.0000
215.158.238.64,<->,142.204.32.86,1,1325,0,0,1,1325,0.503080000,0.0000
136.25.188.197,<->,8.217.44.58,1,1357,0,0,1,1357,0.502947000,0.0000
136.25.188.237,<->,113.23.104.247,1,1133,0,0,1,1133,0.502540000,0.0000
136.25.189.83,<->,122.216.233.84,1,1325,0,0,1,1325,0.502373000,0.0000
215.158.238.32,<->,122.158.49.233,1,1325,0,0,1,1325,0.502319000,0.0000
215.158.239.35,<->,106.188.184.69,1,139,0,0,1,139,0.502193000,0.0000
48.16.206.213,<->,8.252.221.221,0,0,1,993,1,993,0.502054000,0.0000
149.101.111.205,<->,50.224.89.239,0,0,1,91,1,91,0.501611000,0.0000
17.255.107.2,<->,8.220.191.217,0,0,1,533,1,533,0.501237000,0.0000
215.158.238.45,<->,141.39.23.85,1,1213,0,0,1,1213,0.501179000,0.0000
215.158.239.113,<->,215.158.61.189,1,658,0,0,1,658,0.500899000,0.0000
215.158.238.209,<->,215.158.6.213,1,1357,0,0,1,1357,0.500822000,0.0000
215.158.238.241,<->,29.214.211.1,1,1144,0,0,1,1144,0.500811000,0.0000
215.158.238.107,<->,113.23.40.36,1,1117,0,0,1,1117,0.500759000,0.0000
133.178.227.247,<->,113.207.47.231,1,745,0,0,1,745,0.500097000,0.0000
127.107.246.132,<->,92.168.217.173,0,0,1,317,1,317,0.499943000,0.0000
215.158.239.48,<->,199.20.5.165,1,101,0,0,1,101,0.499873000,0.0000
136.25.188.197,<->,122.158.179.43,1,1165,0,0,1,1165,0.499602000,0.0000
220.28.114.28,<->,215.158.238.252,0,0,1,705,1,705,0.499540000,0.0000
247.136.142.216,<->,159.194.183.177,1,500,0,0,1,500,0.499441000,0.0000
215.158.238.106,<->,143.227.65.185,1,1197,0,0,1,1197,0.499085000,0.0000
215.158.61.191,<->,8.176.8.210,0,0,1,1229,1,1229,0.498947000,0.0000
220.20.200.41,<->,42.105.196.8,1,1111,0,0,1,1111,0.498871000,0.0000
215.158.238.148,<->,128.62.135.152,1,1165,0,0,1,1165,0.498640000,0.0000
215.158.239.96,<->,196.90.112.117,1,765,0,0,1,765,0.498515000,0.0000
215.158.61.193,<->,8.176.8.182,0,0,1,877,1,877,0.498121000,0.0000
215.158.239.50,<->,199.39.229.223,1,89,0,0,1,89,0.497996000,0.0000
123.119.26.157,<->,89.183.104.168,0,0,1,718,1,718,0.497809000,0.0000
215.158.239.35,<->,106.188.214.11,1,97,0,0,1,97,0.497490000,0.0000
252.98.149.68,<->,140.146.142.42,1,81,0,0,1,81,0.497226000,0.0000
215.158.239.36,<->,111.151.109.41,1,100,0,0,1,100,0.497197000,0.0000
215.158.238.135,<->,38.206.2.171,1,1021,0,0,1,1021,0.497054000,0.0000
215.158.238.82,<->,112.220.206.107,1,190,0,0,1,190,0.496635000,0.0000
117.155.180.110,<->,99.75.44.80,0,0,1,112,1,112,0.496425000,0.0000
139.163.26.146,<->,122.209.190.26,1,113,0,0,1,113,0.496132000,0.0000
144.85.170.208,<->,91.69.181.135,1,757,0,0,1,757,0.495808000,0.0000
192.224.20.76,<->,133.178.227.138,0,0,1,205,1,205,0.495714000,0.0000
215.158.238.45,<->,89.86.110.85,1,1389,0,0,1,1389,0.495699000,0.0000
145.252.112.144,<->,105.201.86.202,1,272,0,0,1,272,0.495607000,0.0000
215.158.238.141,<->,8.222.213.66,1,1069,0,0,1,1069,0.495491000,0.0000
132.152.144.120,<->,50.224.76.235,0,0,1,1050,1,1050,0.495257000,0.0000
248.239.124.20,<->,27.253.69.198,1,235,0,0,1,235,0.494945000,0.0000
50.224.76.235,<->,29.95.130.169,1,1285,0,0,1,1285,0.494933000,0.0000
215.158.140.76,<->,139.163.163.198,1,1384,0,0,1,1384,0.494648000,0.0000
215.158.140.83,<->,192.171.32.25,1,1272,0,0,1,1272,0.494535000,0.0000
108.137.1.17,<->,0.195.210.44,0,0,1,87,1,87,0.494497000,0.0000
124.30.115.231,<->,50.224.76.235,0,0,1,726,1,726,0.494295000,0.0000
195.68.111.162,<->,136.25.188.241,0,0,1,117,1,117,0.494212000,0.0000
215.158.238.81,<->,8.240.117.16,1,1117,0,0,1,1117,0.494171000,0.0000
221.102.56.69,<->,136.181.39.23,0,0,1,294,1,294,0.494100000,0.0000
144.85.170.208,<->,98.87.144.198,1,663,0,0,1,663,0.493720000,0.0000
224.148.1.28,<->,220.50.239.169,1,810,0,0,1,810,0.493612000,0.0000
143.135.87.181,<->,136.25.188.210,0,0,1,1021,1,1021,0.493211000,0.0000
215.158.239.99,<->,196.105.59.105,1,93,0,0,1,93,0.492921000,0.0000
141.35.174.83,<->,8.252.221.197,0,0,1,199,1,199,0.492545000,0.0000
215.158.239.78,<->,199.20.31.244,1,765,0,0,1,765,0.492289000,0.0000
215.158.239.84,<->,199.20.28.239,1,602,0,0,1,602,0.492281000,0.0000
215.158.238.121,<->,72.23.179.41,1,1357,0,0,1,1357,0.491685000,0.0000
215.158.238.71,<->,100.216.78.145,1,554,0,0,1,554,0.491620000,0.0000
202.33.79.78,<->,136.25.188.179,0,0,1,794,1,794,0.491405000,0.0000
145.252.121.82,<->,117.35.156.71,1,395,0,0,1,395,0.491237000,0.0000
133.178.227.79,<->,29.212.42.226,1,1102,0,0,1,1102,0.490982000,0.0000
215.158.239.87,<->,143.44.174.59,1,608,0,0,1,608,0.490634000,0.0000
215.158.239.93,<->,194.237.113.199,1,304,0,0,1,304,0.490578000,0.0000
215.158.238.238,<->,6.29.108.75,1,313,0,0,1,313,0.490340000,0.0000
76.179.67.62,<->,8.252.221.205,0,0,1,474,1,474,0.490135000,0.0000
54.92.119.24,<->,48.54.190.23,0,0,1,54,1,54,0.489969000,0.0000
215.158.239.56,<->,195.14.36.68,1,87,0,0,1,87,0.489968000,0.0000
133.178.227.76,<->,8.40.51.203,1,1063,0,0,1,1063,0.489696000,0.0000
192.205.37.205,<->,133.178.226.38,0,0,1,1412,1,1412,0.489642000,0.0000
215.158.238.177,<->,8.57.163.138,1,1405,0,0,1,1405,0.489639000,0.0000
136.25.188.177,<->,38.104.11.0,1,1426,0,0,1,1426,0.489202000,0.0000
215.158.239.76,<->,207.166.82.223,1,93,0,0,1,93,0.489161000,0.0000
222.41.149.170,<->,50.224.80.64,0,0,1,362,1,362,0.489141000,0.0000
215.158.239.93,<->,199.20.28.62,1,101,0,0,1,101,0.488849000,0.0000
215.158.239.99,<->,194.251.125.110,1,93,0,0,1,93,0.488712000,0.0000
204.186.94.133,<->,136.25.188.225,0,0,1,602,1,602,0.488581000,0.0000
215.158.239.49,<->,199.20.6.213,1,247,0,0,1,247,0.488465000,0.0000
215.158.239.48,<->,199.82.79.91,1,765,0,0,1,765,0.488438000,0.0000
201.136.184.217,<->,133.178.227.41,0,0,1,1389,1,1389,0.488382000,0.0000
196.93.174.232,<->,136.25.188.46,0,0,1,394,1,394,0.488310000,0.0000
204.185.57.134,<->,136.25.188.240,0,0,1,93,1,93,0.488120000,0.0000
215.158.238.92,<->,104.3.168.217,1,1165,0,0,1,1165,0.488115000,0.0000
215.158.140.76,<->,119.196.23.70,1,1048,0,0,1,1048,0.487969000,0.0000
133.178.226.61,<->,106.188.252.235,1,1197,0,0,1,1197,0.487788000,0.0000
215.158.238.236,<->,8.241.233.59,1,1208,0,0,1,1208,0.487621000,0.0000
215.158.239.99,<->,196.93.134.195,1,259,0,0,1,259,0.487595000,0.0000
133.178.227.63,<->,133.56.180.8,1,541,0,0,1,541,0.487499000,0.0000
235.103.190.78,<->,8.182.235.164,0,0,1,427,1,427,0.486741000,0.0000
215.158.238.72,<->,112.220.206.107,1,1277,0,0,1,1277,0.486452000,0.0000
220.55.102.139,<->,220.28.109.110,1,313,0,0,1,313,0.486415000,0.0000
139.193.141.139,<->,27.149.101.100,1,302,0,0,1,302,0.486340000,0.0000
133.178.227.59,<->,29.211.165.9,1,245,0,0,1,245,0.486136000,0.0000
97.199.185.128,<->,54.38.56.26,1,876,0,0,1,876,0.486055000,0.0000
220.28.85.14,<->,215.158.140.88,0,0,1,1434,1,1434,0.485808000,0.0000
221.102.56.69,<->,98.128.56.58,0,0,1,294,1,294,0.484850000,0.0000
144.86.149.153,<->,27.11.31.205,1,237,0,0,1,237,0.484583000,0.0000
98.128.155.134,<->,8.45.175.127,1,382,0,0,1,382,0.484581000,0.0000
215.158.239.78,<->,207.16.17.95,1,132,0,0,1,132,0.484509000,0.0000
199.111.0.242,<->,8.182.224.248,0,0,1,973,1,973,0.484415000,0.0000
95.246.192.238,<->,8.252.221.199,0,0,1,286,1,286,0.484126000,0.0000
215.158.238.83,<->,148.129.19.195,1,1229,0,0,1,1229,0.483801000,0.0000
8.252.223.142,<->,8.219.187.245,1,990,0,0,1,990,0.483791000,0.0000
215.158.239.56,<->,199.20.28.241,1,839,0,0,1,839,0.483719000,0.0000
142.236.21.32,<->,136.25.188.225,0,0,1,797,1,797,0.483567000,0.0000
215.158.140.93,<->,201.136.143.26,1,1037,0,0,1,1037,0.483536000,0.0000
139.163.102.15,<->,107.12.120.56,1,445,0,0,1,445,0.483357000,0.0000
215.158.140.14,<->,96.150.228.178,1,299,0,0,1,299,0.483201000,0.0000
215.158.238.93,<->,131.36.198.41,1,1399,0,0,1,1399,0.483014000,0.0000
139.8.186.160,<->,133.178.227.19,0,0,1,1485,1,1485,0.482360000,0.0000
102.44.126.45,<->,54.37.224.223,1,308,0,0,1,308,0.482335000,0.0000
215.158.238.223,<->,131.144.113.139,1,1277,0,0,1,1277,0.482061000,0.0000
215.158.239.86,<->,8.179.43.72,1,1357,0,0,1,1357,0.481698000,0.0000
133.178.226.61,<->,118.20.108.65,1,1325,0,0,1,1325,0.481525000,0.0000
215.158.239.49,<->,113.23.66.221,1,1213,0,0,1,1213,0.481500000,0.0000
198.146.28.67,<->,138.98.237.239,0,0,1,1388,1,1388,0.481486000,0.0000
104.233.173.202,<->,50.224.76.248,0,0,1,927,1,927,0.481369000,0.0000
204.186.166.56,<->,136.25.188.242,0,0,1,781,1,781,0.481260000,0.0000
97.126.4.255,<->,27.10.93.204,1,62,0,0,1,62,0.481106000,0.0000
17.78.176.236,<->,8.250.148.57,0,0,1,630,1,630,0.481081000,0.0000
199.98.153.74,<->,136.25.188.225,0,0,1,1341,1,1341,0.480881000,0.0000
143.155.227.40,<->,133.178.226.19,0,0,1,1181,1,1181,0.480346000,0.0000
206.197.147.242,<->,50.224.76.235,0,0,1,1164,1,1164,0.479947000,0.0000
143.251.236.166,<->,0.195.210.46,0,0,1,93,1,93,0.479708000,0.0000
50.224.76.234,<->,30.183.186.118,1,1130,0,0,1,1130,0.479635000,0.0000
148.26.113.3,<->,136.25.189.2,0,0,1,1341,1,1341,0.479566000,0.0000
133.178.227.41,<->,133.56.180.0,1,133,0,0,1,133,0.479381000,0.0000
215.158.239.94,<->,149.96.171.90,1,1005,0,0,1,1005,0.479099000,0.0000
215.158.61.145,<->,136.25.188.35,0,0,1,429,1,429,0.478993000,0.0000
136.25.188.160,<->,69.150.169.180,1,1229,0,0,1,1229,0.478500000,0.0000
215.158.238.236,<->,128.194.247.54,1,1110,0,0,1,1110,0.478483000,0.0000
111.147.134.65,<->,97.110.90.234,1,509,0,0,1,509,0.477991000,0.0000
215.158.239.5,<->,80.47.111.181,1,979,0,0,1,979,0.476962000,0.0000
136.25.189.95,<->,96.156.169.227,1,599,0,0,1,599,0.476805000,0.0000
142.190.76.165,<->,136.25.188.252,0,0,1,172,1,172,0.476708000,0.0000
199.33.110.34,<->,136.25.188.252,0,0,1,765,1,765,0.476660000,0.0000
245.207.109.18,<->,8.252.222.177,0,0,1,377,1,377,0.476390000,0.0000
215.158.238.45,<->,68.124.221.43,1,1117,0,0,1,1117,0.476153000,0.0000
136.25.188.53,<->,57.210.107.42,1,1261,0,0,1,1261,0.476106000,0.0000
215.158.239.97,<->,142.166.122.161,1,689,0,0,1,689,0.476025000,0.0000
145.242.124.39,<->,99.75.205.146,0,0,1,194,1,194,0.475926000,0.0000
195.41.194.229,<->,136.25.188.163,0,0,1,749,1,749,0.475856000,0.0000
199.80.148.235,<->,136.25.188.160,0,0,1,87,1,87,0.475764000,0.0000
126.198.147.25,<->,100.93.44.55,0,0,1,339,1,339,0.475655000,0.0000
136.25.188.45,<->,112.220.206.107,1,1229,0,0,1,1229,0.475619000,0.0000
145.116.223.66,<->,133.178.226.245,0,0,1,573,1,573,0.475520000,0.0000
215.158.61.183,<->,8.176.8.205,0,0,1,429,1,429,0.475513000,0.0000
199.12.113.243,<->,136.25.188.198,0,0,1,561,1,561,0.475036000,0.0000
215.158.239.79,<->,199.20.4.95,1,117,0,0,1,117,0.474184000,0.0000
197.113.64.163,<->,136.25.188.222,0,0,1,87,1,87,0.474052000,0.0000
59.142.198.227,<->,8.252.221.238,0,0,1,251,1,251,0.473344000,0.0000
133.178.226.197,<->,6.116.14.117,1,683,0,0,1,683,0.473171000,0.0000
220.28.65.25,<->,111.147.98.142,0,0,1,109,1,109,0.472876000,0.0000
139.193.141.139,<->,69.218.198.30,1,251,0,0,1,251,0.472649000,0.0000
215.158.239.76,<->,199.20.31.181,1,908,0,0,1,908,0.472625000,0.0000
231.143.44.103,<->,136.25.188.222,0,0,1,382,1,382,0.472608000,0.0000
215.158.238.104,<->,115.140.139.149,1,1357,0,0,1,1357,0.472440000,0.0000
89.183.104.130,<->,76.178.32.105,1,95,0,0,1,95,0.472430000,0.0000
215.158.239.49,<->,196.105.77.195,1,733,0,0,1,733,0.472188000,0.0000
215.158.239.84,<->,114.25.48.60,1,1213,0,0,1,1213,0.471893000,0.0000
215.158.239.120,<->,109.206.125.189,1,538,0,0,1,538,0.471868000,0.0000
138.74.97.124,<->,133.54.28.251,0,0,1,440,1,440,0.471622000,0.0000
203.236.63.34,<->,136.25.188.241,0,0,1,93,1,93,0.471445000,0.0000
136.25.189.88,<->,29.209.59.164,1,1373,0,0,1,1373,0.471372000,0.0000
111.151.109.20,<->,8.252.221.118,0,0,1,100,1,100,0.471309000,0.0000
215.158.239.77,<->,196.90.193.245,1,797,0,0,1,797,0.471119000,0.0000
196.17.240.209,<->,50.224.76.234,0,0,1,1273,1,1273,0.471038000,0.0000
136.139.59.84,<->,133.178.226.29,0,0,1,1373,1,1373,0.470804000,0.0000
132.222.168.185,<->,59.53.181.235,1,112,0,0,1,112,0.470523000,0.0000
139.193.141.139,<->,125.196.33.22,1,393,0,0,1,393,0.470339000,0.0000
215.158.61.243,<->,8.176.8.250,0,0,1,1408,1,1408,0.470235000,0.0000
139.36.119.93,<->,99.74.87.192,0,0,1,1481,1,1481,0.469672000,0.0000
215.158.238.198,<->,192.224.20.231,1,1048,0,0,1,1048,0.469671000,0.0000
111.151.109.27,<->,8.252.222.35,0,0,1,100,1,100,0.469504000,0.0000
136.25.188.202,<->,56.97.186.150,1,70,0,0,1,70,0.468834000,0.0000
220.40.166.212,<->,215.158.238.99,0,0,1,1245,1,1245,0.468806000,0.0000
148.132.60.151,<->,92.162.253.217,0,0,1,567,1,567,0.468440000,0.0000
215.158.239.32,<->,149.96.50.9,1,1199,0,0,1,1199,0.468413000,0.0000
207.237.137.5,<->,136.25.188.211,0,0,1,906,1,906,0.468388000,0.0000
215.158.30.50,<->,6.73.247.123,0,0,1,494,1,494,0.468374000,0.0000
136.25.189.80,<->,96.156.169.163,1,69,0,0,1,69,0.468276000,0.0000
215.158.239.49,<->,106.7.35.105,1,1277,0,0,1,1277,0.468160000,0.0000
196.247.87.19,<->,136.25.188.252,0,0,1,93,1,93,0.468152000,0.0000
220.28.108.254,<->,215.158.238.91,0,0,1,1316,1,1316,0.468031000,0.0000
215.158.238.66,<->,112.220.206.107,1,1197,0,0,1,1197,0.467775000,0.0000
215.202.174.57,<->,215.158.239.85,0,0,1,1501,1,1501,0.467704000,0.0000
92.162.46.53,<->,8.43.220.205,0,0,1,144,1,144,0.467620000,0.0000
204.200.53.204,<->,136.25.188.173,0,0,1,644,1,644,0.467619000,0.0000
204.186.155.189,<->,136.25.188.208,0,0,1,146,1,146,0.467234000,0.0000
215.158.238.135,<->,113.23.117.105,1,1037,0,0,1,1037,0.467104000,0.0000
215.158.239.49,<->,29.213.219.95,1,1229,0,0,1,1229,0.466906000,0.0000
111.199.237.35,<->,0.195.210.44,0,0,1,87,1,87,0.466871000,0.0000
111.147.253.179,<->,53.245.123.102,1,93,0,0,1,93,0.466522000,0.0000
17.5.228.52,<->,8.220.184.183,0,0,1,637,1,637,0.466517000,0.0000
148.186.207.40,<->,136.25.188.160,0,0,1,1213,1,1213,0.466451000,0.0000
142.221.183.232,<->,136.25.188.53,0,0,1,602,1,602,0.466442000,0.0000
144.85.170.208,<->,98.87.147.134,1,695,0,0,1,695,0.466335000,0.0000
133.178.227.76,<->,133.56.180.5,1,149,0,0,1,149,0.466315000,0.0000
143.129.189.14,<->,136.25.188.225,0,0,1,87,1,87,0.466292000,0.0000
136.25.189.32,<->,69.132.46.246,1,989,0,0,1,989,0.466142000,0.0000
215.158.238.96,<->,133.73.194.32,1,1245,0,0,1,1245,0.465948000,0.0000
194.194.108.97,<->,50.223.3.228,0,0,1,228,1,228,0.465815000,0.0000
96.76.243.91,<->,50.224.76.234,0,0,1,691,1,691,0.465705000,0.0000
136.25.188.210,<->,126.219.194.119,1,1213,0,0,1,1213,0.465615000,0.0000
144.85.170.208,<->,91.69.181.254,1,434,0,0,1,434,0.465519000,0.0000
246.253.235.13,<->,76.3.28.78,1,103,0,0,1,103,0.465436000,0.0000
199.32.175.7,<->,136.25.188.226,0,0,1,653,1,653,0.465364000,0.0000
215.158.239.78,<->,199.79.113.71,1,117,0,0,1,117,0.464502000,0.0000
203.212.63.74,<->,8.220.234.4,0,0,1,174,1,174,0.464135000,0.0000
195.126.22.14,<->,136.25.188.55,0,0,1,701,1,701,0.464116000,0.0000
158.178.164.100,<->,100.228.42.163,0,0,1,597,1,597,0.464039000,0.0000
50.224.95.2,<->,38.162.94.107,1,568,0,0,1,568,0.463981000,0.0000
104.247.205.211,<->,92.27.194.147,0,0,1,248,1,248,0.463938000,0.0000
133.178.226.197,<->,102.40.147.23,1,742,0,0,1,742,0.463830000,0.0000
192.65.81.245,<->,109.127.101.16,1,499,0,0,1,499,0.463791000,0.0000
135.243.190.251,<->,8.52.179.111,0,0,1,722,1,722,0.463579000,0.0000
80.40.56.218,<->,54.44.62.184,1,94,0,0,1,94,0.463058000,0.0000
215.158.239.41,<->,8.253.128.25,1,1496,0,0,1,1496,0.462858000,0.0000
215.158.239.48,<->,199.20.5.98,1,1102,0,0,1,1102,0.462682000,0.0000
133.178.227.40,<->,69.132.194.25,1,1051,0,0,1,1051,0.462373000,0.0000
215.158.140.221,<->,133.20.250.202,1,232,0,0,1,232,0.461789000,0.0000
221.102.56.69,<->,102.83.220.113,0,0,1,294,1,294,0.461552000,0.0000
215.158.239.50,<->,199.20.28.202,1,101,0,0,1,101,0.461345000,0.0000
215.158.238.45,<->,120.155.14.75,1,1165,0,0,1,1165,0.461230000,0.0000
98.18.104.222,<->,80.41.4.117,0,0,1,680,1,680,0.461157000,0.0000
215.158.238.107,<->,104.154.137.193,1,1325,0,0,1,1325,0.460887000,0.0000
142.241.156.114,<->,136.25.188.46,0,0,1,146,1,146,0.458820000,0.0000
215.158.239.49,<->,199.20.28.43,1,602,0,0,1,602,0.458596000,0.0000
53.203.244.195,<->,48.54.252.54,0,0,1,269,1,269,0.458015000,0.0000
215.158.238.148,<->,126.219.193.188,1,1021,0,0,1,1021,0.457487000,0.0000
139.163.20.196,<->,99.22.236.63,1,527,0,0,1,527,0.457381000,0.0000
215.158.238.236,<->,126.219.132.231,1,1049,0,0,1,1049,0.457317000,0.0000
133.178.226.247,<->,111.150.207.148,1,100,0,0,1,100,0.457246000,0.0000
133.178.227.76,<->,29.211.6.132,1,1213,0,0,1,1213,0.456963000,0.0000
247.136.131.250,<->,8.55.211.213,1,294,0,0,1,294,0.456711000,0.0000
215.158.239.95,<->,142.208.6.43,1,85,0,0,1,85,0.456075000,0.0000
197.113.99.116,<->,136.25.188.255,0,0,1,701,1,701,0.455734000,0.0000
215.158.238.134,<->,113.23.104.247,1,1229,0,0,1,1229,0.455548000,0.0000
220.20.200.5,<->,127.255.90.88,1,898,0,0,1,898,0.455425000,0.0000
215.158.239.50,<->,142.254.245.204,1,620,0,0,1,620,0.455323000,0.0000
221.102.56.69,<->,109.1.60.22,0,0,1,294,1,294,0.455156000,0.0000
139.163.26.146,<->,0.141.40.222,1,111,0,0,1,111,0.455064000,0.0000
97.126.14.75,<->,53.240.123.131,1,487,0,0,1,487,0.455032000,0.0000
204.185.57.248,<->,136.25.188.223,0,0,1,479,1,479,0.454836000,0.0000
102.83.203.80,<->,8.222.6.88,1,1143,0,0,1,1143,0.454816000,0.0000
136.116.9.78,<->,58.43.188.11,1,478,0,0,1,478,0.454622000,0.0000
204.200.32.214,<->,136.25.188.162,0,0,1,632,1,632,0.454615000,0.0000
215.158.239.99,<->,142.208.6.43,1,85,0,0,1,85,0.454602000,0.0000
243.117.82.191,<->,220.55.94.156,0,0,1,462,1,462,0.454243000,0.0000
215.158.239.94,<->,8.215.68.90,1,1392,0,0,1,1392,0.453722000,0.0000
215.158.238.133,<->,113.106.118.9,1,1181,0,0,1,1181,0.453686000,0.0000
215.158.239.57,<->,196.106.58.186,1,87,0,0,1,87,0.453673000,0.0000
197.7.112.170,<->,50.223.3.228,0,0,1,184,1,184,0.453482000,0.0000
215.158.239.85,<->,199.20.29.90,1,602,0,0,1,602,0.453320000,0.0000
207.179.110.12,<->,50.224.76.234,0,0,1,604,1,604,0.453157000,0.0000
215.158.140.83,<->,8.220.54.202,1,1098,0,0,1,1098,0.452659000,0.0000
215.158.239.95,<->,199.20.30.201,1,107,0,0,1,107,0.452422000,0.0000
199.68.163.42,<->,136.25.188.220,0,0,1,616,1,616,0.452239000,0.0000
215.158.238.96,<->,192.204.151.99,1,1373,0,0,1,1373,0.452042000,0.0000
196.89.167.0,<->,136.25.188.222,0,0,1,717,1,717,0.451861000,0.0000
136.25.188.237,<->,48.131.156.26,1,1357,0,0,1,1357,0.451730000,0.0000
136.25.189.14,<->,114.25.48.55,1,1389,0,0,1,1389,0.451433000,0.0000
204.186.166.56,<->,136.25.188.176,0,0,1,781,1,781,0.451276000,0.0000
50.224.89.239,<->,27.253.253.217,1,79,0,0,1,79,0.451238000,0.0000
215.158.140.92,<->,215.158.42.38,1,1072,0,0,1,1072,0.451118000,0.0000
197.4.13.58,<->,136.25.188.55,0,0,1,1181,1,1181,0.450782000,0.0000
136.25.188.225,<->,33.239.214.171,1,1197,0,0,1,1197,0.450778000,0.0000
199.44.120.51,<->,8.20.87.153,0,0,1,135,1,135,0.450764000,0.0000
210.229.230.21,<->,99.203.178.222,1,68,0,0,1,68,0.450582000,0.0000
133.178.227.204,<->,111.150.207.92,1,100,0,0,1,100,0.450428000,0.0000
195.54.103.39,<->,136.25.188.227,0,0,1,722,1,722,0.449985000,0.0000
118.38.6.71,<->,50.224.80.64,0,0,1,622,1,622,0.449700000,0.0000
136.25.188.197,<->,8.222.7.21,1,1149,0,0,1,1149,0.449408000,0.0000
145.11.91.233,<->,50.224.76.235,0,0,1,62,1,62,0.449256000,0.0000
215.158.239.58,<->,196.92.45.73,1,87,0,0,1,87,0.448978000,0.0000
136.25.189.77,<->,8.222.58.219,1,1293,0,0,1,1293,0.448437000,0.0000
215.158.238.95,<->,146.10.166.85,1,1309,0,0,1,1309,0.448402000,0.0000
100.95.193.114,<->,8.55.224.156,1,79,0,0,1,79,0.448331000,0.0000
136.25.188.235,<->,0.195.237.14,1,256,0,0,1,256,0.448086000,0.0000
136.25.188.227,<->,69.150.168.218,1,1277,0,0,1,1277,0.447019000,0.0000
137.21.23.50,<->,111.151.106.218,1,100,0,0,1,100,0.446621000,0.0000
99.170.105.20,<->,89.183.104.139,0,0,1,432,1,432,0.446601000,0.0000
133.178.226.61,<->,8.222.212.27,1,1133,0,0,1,1133,0.446476000,0.0000
213.221.90.199,<->,144.85.170.254,0,0,1,449,1,449,0.446332000,0.0000
138.126.75.69,<->,133.178.226.235,0,0,1,792,1,792,0.446199000,0.0000
231.142.181.214,<->,215.158.239.97,0,0,1,109,1,109,0.446064000,0.0000
6.145.164.138,<->,0.195.210.44,0,0,1,136,1,136,0.445961000,0.0000
196.112.237.232,<->,8.252.222.205,0,0,1,1325,1,1325,0.445384000,0.0000
136.25.189.13,<->,29.213.219.10,1,1413,0,0,1,1413,0.444938000,0.0000
215.158.238.133,<->,126.219.132.237,1,1373,0,0,1,1373,0.444887000,0.0000
142.241.120.60,<->,136.25.188.209,0,0,1,765,1,765,0.444610000,0.0000
215.158.140.241,<->,140.174.84.20,1,1364,0,0,1,1364,0.444344000,0.0000
36.123.55.226,<->,8.20.87.32,0,0,1,97,1,97,0.444249000,0.0000
215.158.238.220,<->,139.163.163.176,1,1362,0,0,1,1362,0.443995000,0.0000
204.184.41.206,<->,136.25.188.176,0,0,1,602,1,602,0.443922000,0.0000
215.158.239.56,<->,199.20.29.64,1,797,0,0,1,797,0.443367000,0.0000
247.136.184.192,<->,137.225.173.74,1,61,0,0,1,61,0.442896000,0.0000
152.100.10.249,<->,139.163.96.94,0,0,1,50,1,50,0.442797000,0.0000
249.101.109.210,<->,136.141.44.253,1,81,0,0,1,81,0.442725000,0.0000
92.27.117.27,<->,89.153.95.12,0,0,1,109,1,109,0.442716000,0.0000
215.158.239.181,<->,57.210.104.90,1,282,0,0,1,282,0.442702000,0.0000
199.69.184.152,<->,136.25.188.220,0,0,1,593,1,593,0.442692000,0.0000
97.100.51.234,<->,80.27.152.99,0,0,1,1025,1,1025,0.442526000,0.0000
197.113.84.184,<->,136.25.188.255,0,0,1,157,1,157,0.442334000,0.0000
250.5.201.28,<->,0.195.210.42,0,0,1,139,1,139,0.442276000,0.0000
199.20.31.187,<->,92.27.194.147,0,0,1,263,1,263,0.442136000,0.0000
215.158.238.133,<->,8.191.0.72,1,1181,0,0,1,1181,0.442016000,0.0000
215.158.238.141,<->,61.34.184.244,1,1197,0,0,1,1197,0.441939000,0.0000
215.158.239.68,<->,199.20.31.19,1,190,0,0,1,190,0.441916000,0.0000
197.7.81.19,<->,0.195.210.42,0,0,1,85,1,85,0.441528000,0.0000
215.158.238.72,<->,122.216.233.224,1,1309,0,0,1,1309,0.441372000,0.0000
221.102.56.69,<->,109.2.12.217,0,0,1,294,1,294,0.441106000,0.0000
156.152.163.10,<->,8.252.222.21,0,0,1,354,1,354,0.441031000,0.0000
215.158.61.191,<->,136.25.188.41,0,0,1,429,1,429,0.440807000,0.0000
195.5.235.136,<->,136.25.188.255,0,0,1,561,1,561,0.440565000,0.0000
215.158.239.76,<->,196.91.254.208,1,1090,0,0,1,1090,0.440433000,0.0000
207.172.56.76,<->,136.25.188.252,0,0,1,602,1,602,0.440140000,0.0000
215.158.239.31,<->,125.84.52.215,1,1354,0,0,1,1354,0.439765000,0.0000
215.158.239.29,<->,139.161.104.175,1,1311,0,0,1,1311,0.439700000,0.0000
133.178.226.80,<->,57.227.82.220,1,1245,0,0,1,1245,0.439555000,0.0000
136.123.45.60,<->,8.52.183.96,0,0,1,121,1,121,0.439530000,0.0000
111.147.242.144,<->,8.18.125.73,1,451,0,0,1,451,0.439334000,0.0000
215.158.239.78,<->,207.61.15.197,1,85,0,0,1,85,0.439209000,0.0000
136.25.188.220,<->,131.6.152.9,1,1085,0,0,1,1085,0.439136000,0.0000
133.178.226.224,<->,113.207.61.212,1,283,0,0,1,283,0.438637000,0.0000
98.23.105.53,<->,8.252.221.171,0,0,1,649,1,649,0.438293000,0.0000
111.147.204.204,<->,54.92.218.196,1,118,0,0,1,118,0.438051000,0.0000
116.141.230.22,<->,92.27.219.23,0,0,1,229,1,229,0.437027000,0.0000
215.158.238.21,<->,113.23.101.68,1,1341,0,0,1,1341,0.436522000,0.0000
50.136.151.223,<->,8.20.87.246,0,0,1,334,1,334,0.436436000,0.0000
53.69.143.15,<->,48.55.109.114,0,0,1,93,1,93,0.436042000,0.0000
247.136.143.247,<->,158.224.198.185,1,60,0,0,1,60,0.435715000,0.0000
215.158.239.87,<->,199.82.249.236,1,749,0,0,1,749,0.435539000,0.0000
215.158.238.82,<->,113.24.246.181,1,1069,0,0,1,1069,0.435452000,0.0000
142.209.105.143,<->,136.25.188.220,0,0,1,259,1,259,0.435436000,0.0000
201.211.112.213,<->,133.178.226.28,0,0,1,1085,1,1085,0.435317000,0.0000
127.255.84.41,<->,92.162.253.82,0,0,1,573,1,573,0.435083000,0.0000
68.212.95.38,<->,8.52.164.127,0,0,1,507,1,507,0.434983000,0.0000
215.158.238.105,<->,29.212.182.225,1,1261,0,0,1,1261,0.434948000,0.0000
215.158.239.19,<->,125.84.52.247,1,67,0,0,1,67,0.434764000,0.0000
195.71.188.138,<->,136.25.188.209,0,0,1,765,1,765,0.434620000,0.0000
210.229.230.18,<->,107.111.197.177,1,80,0,0,1,80,0.434218000,0.0000
248.225.27.2,<->,56.114.235.120,1,816,0,0,1,816,0.434134000,0.0000
132.18.67.31,<->,99.73.141.255,0,0,1,397,1,397,0.433865000,0.0000
215.158.239.70,<->,193.10.94.194,1,1197,0,0,1,1197,0.433696000,0.0000
136.25.188.233,<->,0.195.253.228,1,1322,0,0,1,1322,0.433580000,0.0000
204.187.61.28,<->,136.25.188.174,0,0,1,1007,1,1007,0.433493000,0.0000
54.37.145.251,<->,48.54.44.240,0,0,1,65,1,65,0.433156000,0.0000
215.158.238.188,<->,158.85.50.154,1,1048,0,0,1,1048,0.433091000,0.0000
133.54.43.53,<->,33.15.205.222,1,719,0,0,1,719,0.433027000,0.0000
92.27.219.44,<->,53.214.117.99,1,293,0,0,1,293,0.432926000,0.0000
246.254.97.230,<->,139.33.174.12,1,596,0,0,1,596,0.432675000,0.0000
148.113.20.250,<->,80.38.61.209,0,0,1,618,1,618,0.432613000,0.0000
136.25.188.55,<->,69.31.238.37,1,1325,0,0,1,1325,0.432612000,0.0000
133.32.39.0,<->,8.193.178.40,1,247,0,0,1,247,0.432219000,0.0000
215.158.239.29,<->,8.255.92.81,1,1162,0,0,1,1162,0.431872000,0.0000
215.158.239.51,<->,199.20.63.99,1,853,0,0,1,853,0.431850000,0.0000
144.85.170.208,<->,98.87.146.141,1,391,0,0,1,391,0.431734000,0.0000
215.158.239.92,<->,199.20.30.40,1,602,0,0,1,602,0.431376000,0.0000
215.158.238.67,<->,122.158.49.246,1,1165,0,0,1,1165,0.431142000,0.0000
203.114.99.122,<->,136.25.188.52,0,0,1,1005,1,1005,0.430923000,0.0000
119.111.182.206,<->,50.224.76.234,0,0,1,404,1,404,0.430370000,0.0000
221.102.56.51,<->,6.74.193.103,0,0,1,413,1,413,0.430182000,0.0000
215.158.140.241,<->,144.54.92.44,1,1085,0,0,1,1085,0.430150000,0.0000
204.187.192.134,<->,136.25.188.178,0,0,1,541,1,541,0.429646000,0.0000
139.193.141.139,<->,126.198.102.162,1,87,0,0,1,87,0.429583000,0.0000
215.158.239.59,<->,57.31.99.55,1,1229,0,0,1,1229,0.429435000,0.0000
136.25.188.44,<->,8.252.213.15,1,1245,0,0,1,1245,0.429397000,0.0000
139.163.26.146,<->,122.219.245.59,1,157,0,0,1,157,0.429335000,0.0000
145.252.125.198,<->,116.96.63.23,1,387,0,0,1,387,0.429222000,0.0000
112.47.191.84,<->,92.27.27.180,0,0,1,317,1,317,0.428843000,0.0000
207.62.87.215,<->,136.25.188.46,0,0,1,89,1,89,0.428411000,0.0000
213.38.136.197,<->,8.45.175.127,1,141,0,0,1,141,0.428056000,0.0000
133.178.226.212,<->,80.47.228.197,1,790,0,0,1,790,0.427801000,0.0000
215.158.239.70,<->,207.191.20.186,1,605,0,0,1,605,0.427700000,0.0000
143.23.111.212,<->,136.25.188.52,0,0,1,105,1,105,0.426799000,0.0000
136.129.94.157,<->,111.199.225.189,1,416,0,0,1,416,0.426752000,0.0000
136.181.43.98,<->,56.114.235.120,1,760,0,0,1,760,0.426714000,0.0000
192.226.44.53,<->,133.178.227.251,0,0,1,281,1,281,0.426517000,0.0000
249.101.121.52,<->,132.18.67.30,1,473,0,0,1,473,0.426251000,0.0000
111.150.207.179,<->,8.252.222.101,0,0,1,100,1,100,0.425754000,0.0000
207.217.71.87,<->,92.27.194.147,0,0,1,249,1,249,0.425722000,0.0000
136.25.189.15,<->,104.154.137.20,1,1245,0,0,1,1245,0.425385000,0.0000
136.25.188.254,<->,113.23.104.247,1,93,0,0,1,93,0.425302000,0.0000
215.158.238.88,<->,145.116.209.4,1,506,0,0,1,506,0.425115000,0.0000
210.229.230.18,<->,100.31.1.3,1,68,0,0,1,68,0.424748000,0.0000
133.178.226.61,<->,8.222.109.84,1,1278,0,0,1,1278,0.424724000,0.0000
220.39.233.55,<->,215.158.238.221,0,0,1,1087,1,1087,0.424597000,0.0000
139.5.114.201,<->,136.25.189.7,0,0,1,432,1,432,0.424591000,0.0000
69.128.170.175,<->,6.130.64.218,1,112,0,0,1,112,0.424506000,0.0000
145.116.118.68,<->,66.13.81.240,1,262,0,0,1,262,0.424295000,0.0000
128.110.138.173,<->,8.252.222.211,0,0,1,1181,1,1181,0.424165000,0.0000
215.158.239.201,<->,192.226.44.66,1,232,0,0,1,232,0.423845000,0.0000
215.158.238.72,<->,8.42.43.88,1,1245,0,0,1,1245,0.423265000,0.0000
192.64.244.21,<->,50.248.185.204,1,215,0,0,1,215,0.423241000,0.0000
192.64.204.221,<->,105.133.26.208,1,112,0,0,1,112,0.423159000,0.0000
199.50.85.249,<->,136.25.188.255,0,0,1,657,1,657,0.422436000,0.0000
144.86.151.96,<->,8.16.244.137,1,315,0,0,1,315,0.422315000,0.0000
210.221.111.110,<->,8.222.6.127,1,881,0,0,1,881,0.422282000,0.0000
133.178.226.30,<->,117.155.166.218,1,1149,0,0,1,1149,0.421910000,0.0000
133.178.227.19,<->,126.219.246.222,1,1129,0,0,1,1129,0.421752000,0.0000
215.158.239.76,<->,199.20.4.236,1,632,0,0,1,632,0.421702000,0.0000
136.25.189.18,<->,57.226.224.40,1,181,0,0,1,181,0.421559000,0.0000
158.27.245.185,<->,139.193.141.139,0,0,1,519,1,519,0.420977000,0.0000
213.186.52.14,<->,144.85.170.246,0,0,1,1079,1,1079,0.420930000,0.0000
113.202.241.177,<->,80.40.53.91,0,0,1,108,1,108,0.420640000,0.0000
215.158.239.97,<->,196.0.101.103,1,797,0,0,1,797,0.420617000,0.0000
156.190.55.10,<->,50.145.216.49,1,146,0,0,1,146,0.420386000,0.0000
199.68.150.136,<->,136.25.188.237,0,0,1,391,1,391,0.420280000,0.0000
133.32.39.0,<->,14.71.93.60,1,419,0,0,1,419,0.419503000,0.0000
111.20.168.27,<->,100.206.91.174,1,209,0,0,1,209,0.419393000,0.0000
215.158.238.132,<->,89.70.190.250,1,1213,0,0,1,1213,0.419332000,0.0000
249.101.100.85,<->,210.209.251.211,1,524,0,0,1,524,0.419281000,0.0000
210.229.230.18,<->,100.190.211.77,1,68,0,0,1,68,0.419228000,0.0000
133.178.226.71,<->,29.211.176.199,1,1005,0,0,1,1005,0.419179000,0.0000
136.25.189.1,<->,96.156.169.212,1,1384,0,0,1,1384,0.418984000,0.0000
133.178.227.247,<->,29.212.196.161,1,1349,0,0,1,1349,0.418738000,0.0000
133.178.227.76,<->,8.240.116.213,1,1069,0,0,1,1069,0.418734000,0.0000
136.25.189.80,<->,114.150.180.138,1,1277,0,0,1,1277,0.418720000,0.0000
241.5.27.230,<->,215.158.239.59,0,0,1,1181,1,1181,0.418659000,0.0000
199.38.230.44,<->,136.25.188.209,0,0,1,765,1,765,0.418424000,0.0000
94.192.42.180,<->,8.252.222.186,0,0,1,117,1,117,0.418409000,0.0000
144.85.170.248,<->,98.87.146.200,1,887,0,0,1,887,0.418204000,0.0000
215.158.239.56,<->,199.79.149.107,1,117,0,0,1,117,0.418187000,0.0000
142.223.190.242,<->,136.25.188.252,0,0,1,867,1,867,0.417736000,0.0000
148.190.126.29,<->,133.178.226.29,0,0,1,1181,1,1181,0.417479000,0.0000
215.158.239.94,<->,57.31.50.197,1,1357,0,0,1,1357,0.417389000,0.0000
215.158.43.153,<->,8.252.223.201,0,0,1,97,1,97,0.417108000,0.0000
148.224.137.93,<->,136.25.189.1,0,0,1,1357,1,1357,0.416340000,0.0000
215.158.238.97,<->,113.23.66.212,1,181,0,0,1,181,0.416210000,0.0000
206.103.214.31,<->,136.25.189.81,0,0,1,1357,1,1357,0.416016000,0.0000
142.229.125.36,<->,136.25.188.163,0,0,1,101,1,101,0.415655000,0.0000
241.120.29.237,<->,215.158.239.59,0,0,1,1197,1,1197,0.415332000,0.0000
215.158.238.69,<->,98.219.126.175,1,925,0,0,1,925,0.415271000,0.0000
215.158.238.246,<->,111.151.142.216,1,100,0,0,1,100,0.415221000,0.0000
215.158.239.76,<->,196.91.232.74,1,749,0,0,1,749,0.415173000,0.0000
139.163.26.146,<->,120.45.127.197,1,99,0,0,1,99,0.415146000,0.0000
139.193.141.209,<->,127.106.156.222,1,515,0,0,1,515,0.414963000,0.0000
210.221.107.50,<->,8.222.6.226,1,182,0,0,1,182,0.414553000,0.0000
199.38.230.44,<->,136.25.188.241,0,0,1,765,1,765,0.414395000,0.0000
139.193.141.139,<->,0.34.75.142,1,235,0,0,1,235,0.414268000,0.0000
136.25.189.13,<->,72.23.48.195,1,1213,0,0,1,1213,0.414228000,0.0000
91.243.252.184,<->,80.41.252.59,0,0,1,128,1,128,0.414077000,0.0000
215.158.238.107,<->,32.183.36.250,1,1165,0,0,1,1165,0.413654000,0.0000
215.158.239.94,<->,122.216.233.180,1,1309,0,0,1,1309,0.413492000,0.0000
215.158.239.49,<->,80.56.79.101,1,1213,0,0,1,1213,0.413341000,0.0000
136.25.189.31,<->,129.15.253.166,1,1197,0,0,1,1197,0.413220000,0.0000
215.158.239.95,<->,199.20.29.121,1,107,0,0,1,107,0.412733000,0.0000
159.137.141.196,<->,134.240.235.240,1,667,0,0,1,667,0.412433000,0.0000
140.68.8.29,<->,92.168.217.228,0,0,1,530,1,530,0.412154000,0.0000
215.158.238.138,<->,0.195.237.14,1,243,0,0,1,243,0.412129000,0.0000
197.81.94.168,<->,136.25.188.239,0,0,1,733,1,733,0.412120000,0.0000
213.186.52.51,<->,144.85.170.254,0,0,1,765,1,765,0.411472000,0.0000
215.158.238.148,<->,69.132.194.95,1,1357,0,0,1,1357,0.411388000,0.0000
48.17.210.32,<->,8.252.222.132,0,0,1,141,1,141,0.411125000,0.0000
224.250.64.91,<->,102.50.157.50,0,0,1,68,1,68,0.411018000,0.0000
229.107.126.52,<->,139.163.26.146,0,0,1,99,1,99,0.410995000,0.0000
215.158.239.38,<->,215.158.58.237,1,1450,0,0,1,1450,0.410736000,0.0000
210.229.230.22,<->,82.122.77.131,1,68,0,0,1,68,0.410598000,0.0000
199.15.255.209,<->,136.25.188.252,0,0,1,707,1,707,0.410488000,0.0000
97.127.101.156,<->,54.58.255.143,1,125,0,0,1,125,0.410462000,0.0000
204.200.52.99,<->,136.25.188.178,0,0,1,132,1,132,0.410155000,0.0000
215.158.239.87,<->,33.209.219.82,1,565,0,0,1,565,0.409884000,0.0000
204.3.166.30,<->,136.25.188.253,0,0,1,75,1,75,0.409797000,0.0000
199.71.2.125,<->,136.25.188.173,0,0,1,902,1,902,0.409722000,0.0000
215.158.238.209,<->,100.50.96.162,1,1357,0,0,1,1357,0.409581000,0.0000
215.158.238.66,<->,29.211.186.149,1,1341,0,0,1,1341,0.409517000,0.0000
109.222.208.65,<->,54.43.5.17,1,157,0,0,1,157,0.409429000,0.0000
231.139.0.115,<->,136.25.188.176,0,0,1,1023,1,1023,0.409428000,0.0000
199.50.19.159,<->,136.25.188.160,0,0,1,638,1,638,0.409032000,0.0000
159.58.186.67,<->,8.20.87.155,0,0,1,597,1,597,0.408738000,0.0000
144.85.170.208,<->,98.87.147.161,1,712,0,0,1,712,0.408664000,0.0000
133.178.227.229,<->,100.224.243.73,1,289,0,0,1,289,0.408525000,0.0000
102.228.188.41,<->,50.224.80.64,0,0,1,615,1,615,0.408522000,0.0000
215.158.238.220,<->,155.197.206.249,1,1043,0,0,1,1043,0.408482000,0.0000
215.158.239.56,<->,196.7.80.159,1,157,0,0,1,157,0.408016000,0.0000
133.244.28.234,<->,112.60.2.68,1,98,0,0,1,98,0.407548000,0.0000
110.73.111.83,<->,89.153.91.164,0,0,1,1340,1,1340,0.407515000,0.0000
114.183.93.59,<->,50.224.89.241,0,0,1,1243,1,1243,0.406839000,0.0000
204.60.83.192,<->,136.25.188.225,0,0,1,190,1,190,0.406371000,0.0000
53.214.109.33,<->,8.228.214.88,0,0,1,87,1,87,0.406019000,0.0000
159.23.227.242,<->,125.156.219.10,1,629,0,0,1,629,0.405777000,0.0000
50.51.186.123,<->,8.220.189.156,0,0,1,638,1,638,0.404459000,0.0000
215.158.238.212,<->,131.141.218.103,1,266,0,0,1,266,0.404344000,0.0000
148.247.248.83,<->,139.193.141.139,0,0,1,290,1,290,0.403994000,0.0000
199.15.39.181,<->,136.25.188.227,0,0,1,669,1,669,0.403771000,0.0000
146.249.226.233,<->,8.252.222.173,0,0,1,259,1,259,0.403750000,0.0000
136.25.189.1,<->,126.219.194.155,1,1229,0,0,1,1229,0.403569000,0.0000
215.158.238.233,<->,98.219.126.175,1,603,0,0,1,603,0.403500000,0.0000
142.241.62.105,<->,136.25.188.199,0,0,1,630,1,630,0.403163000,0.0000
136.25.189.77,<->,135.229.0.201,1,1373,0,0,1,1373,0.403102000,0.0000
197.113.99.201,<->,136.25.188.175,0,0,1,547,1,547,0.403081000,0.0000
149.96.133.55,<->,50.224.76.235,0,0,1,955,1,955,0.402939000,0.0000
129.225.134.86,<->,129.225.132.224,0,0,1,972,1,972,0.402913000,0.0000
215.158.239.61,<->,100.224.166.115,1,618,0,0,1,618,0.402610000,0.0000
215.158.238.80,<->,116.107.47.35,1,1229,0,0,1,1229,0.402483000,0.0000
122.184.13.50,<->,8.52.178.227,0,0,1,562,1,562,0.402276000,0.0000
215.158.239.92,<->,195.80.209.137,1,685,0,0,1,685,0.402082000,0.0000
133.178.227.76,<->,123.166.46.118,1,1245,0,0,1,1245,0.402045000,0.0000
126.198.149.124,<->,99.73.248.65,0,0,1,345,1,345,0.401916000,0.0000
54.37.1.37,<->,48.54.158.36,0,0,1,457,1,457,0.401820000,0.0000
215.158.140.60,<->,8.192.205.87,1,1119,0,0,1,1119,0.401657000,0.0000
210.209.251.214,<->,145.16.88.13,0,0,1,481,1,481,0.401336000,0.0000
29.212.202.59,<->,8.252.223.106,0,0,1,1181,1,1181,0.401148000,0.0000
76.179.107.76,<->,8.252.222.77,0,0,1,354,1,354,0.401132000,0.0000
17.23.199.82,<->,8.220.233.27,0,0,1,96,1,96,0.400644000,0.0000
196.20.95.28,<->,8.52.182.119,0,0,1,847,1,847,0.400084000,0.0000
136.25.188.252,<->,112.235.95.11,1,1293,0,0,1,1293,0.400036000,0.0000
221.102.143.189,<->,192.65.51.237,0,0,1,63,1,63,0.400020000,0.0000
100.92.38.16,<->,89.205.254.2,1,685,0,0,1,685,0.399622000,0.0000
215.158.238.67,<->,136.139.59.126,1,1165,0,0,1,1165,0.399567000,0.0000
249.101.127.5,<->,54.38.108.23,1,125,0,0,1,125,0.399115000,0.0000
215.158.238.104,<->,141.39.23.74,1,1293,0,0,1,1293,0.398982000,0.0000
210.229.230.18,<->,80.89.242.216,1,68,0,0,1,68,0.398915000,0.0000
215.158.140.231,<->,131.144.116.219,1,1200,0,0,1,1200,0.398875000,0.0000
216.184.2.219,<->,136.25.189.31,0,0,1,945,1,945,0.398776000,0.0000
215.158.238.243,<->,8.222.6.193,1,1134,0,0,1,1134,0.398578000,0.0000
221.102.56.69,<->,109.1.92.249,0,0,1,294,1,294,0.398395000,0.0000
215.158.239.56,<->,196.94.184.187,1,602,0,0,1,602,0.398139000,0.0000
194.244.41.92,<->,50.224.76.235,0,0,1,1177,1,1177,0.398138000,0.0000
215.158.238.113,<->,116.106.61.226,1,1229,0,0,1,1229,0.398050000,0.0000
204.21.111.107,<->,136.25.188.236,0,0,1,313,1,313,0.397426000,0.0000
144.85.170.254,<->,91.69.181.168,1,438,0,0,1,438,0.397222000,0.0000
195.127.94.67,<->,136.25.188.236,0,0,1,561,1,561,0.397166000,0.0000
131.158.117.199,<->,50.224.76.248,0,0,1,514,1,514,0.397162000,0.0000
110.222.166.99,<->,50.224.76.235,0,0,1,590,1,590,0.397137000,0.0000
215.158.238.82,<->,131.2.115.231,1,1309,0,0,1,1309,0.396997000,0.0000
80.41.3.199,<->,8.55.211.213,1,294,0,0,1,294,0.396793000,0.0000
196.148.99.61,<->,53.243.94.134,1,287,0,0,1,287,0.396544000,0.0000
215.158.43.154,<->,8.252.223.202,0,0,1,97,1,97,0.396122000,0.0000
136.25.189.33,<->,72.23.48.213,1,1341,0,0,1,1341,0.395500000,0.0000
215.158.239.87,<->,142.252.67.76,1,85,0,0,1,85,0.395477000,0.0000
197.106.249.131,<->,136.25.188.209,0,0,1,93,1,93,0.395462000,0.0000
238.110.17.81,<->,50.224.76.235,0,0,1,1065,1,1065,0.395119000,0.0000
138.121.99.24,<->,8.220.186.82,0,0,1,183,1,183,0.394716000,0.0000
197.107.77.140,<->,136.25.188.163,0,0,1,93,1,93,0.394244000,0.0000
149.99.93.52,<->,133.178.226.29,0,0,1,1149,1,1149,0.394200000,0.0000
105.134.162.139,<->,92.162.253.113,0,0,1,605,1,605,0.394048000,0.0000
215.158.239.87,<->,131.144.113.52,1,165,0,0,1,165,0.393171000,0.0000
199.121.228.9,<->,136.25.188.175,0,0,1,101,1,101,0.393125000,0.0000
220.50.210.22,<->,215.158.239.31,0,0,1,467,1,467,0.392950000,0.0000
84.242.135.61,<->,50.224.76.235,0,0,1,679,1,679,0.392887000,0.0000
215.158.239.49,<->,199.20.29.187,1,602,0,0,1,602,0.392331000,0.0000
220.55.168.247,<->,53.157.11.198,1,209,0,0,1,209,0.392314000,0.0000
194.233.123.96,<->,136.25.188.222,0,0,1,93,1,93,0.391619000,0.0000
215.158.238.68,<->,0.195.253.228,1,1408,0,0,1,1408,0.391461000,0.0000
215.158.239.112,<->,109.126.137.237,1,94,0,0,1,94,0.391371000,0.0000
199.70.186.96,<->,136.25.188.160,0,0,1,272,1,272,0.391339000,0.0000
215.158.239.86,<->,199.20.29.240,1,717,0,0,1,717,0.391322000,0.0000
200.174.222.92,<->,54.36.230.207,1,285,0,0,1,285,0.390926000,0.0000
215.158.238.56,<->,113.23.7.38,1,1453,0,0,1,1453,0.390922000,0.0000
64.77.204.181,<->,0.195.210.44,0,0,1,87,1,87,0.390824000,0.0000
215.158.239.30,<->,149.96.50.30,1,112,0,0,1,112,0.390260000,0.0000
35.61.123.189,<->,8.252.223.146,0,0,1,627,1,627,0.390218000,0.0000
215.158.239.77,<->,195.81.10.41,1,781,0,0,1,781,0.390217000,0.0000
215.158.238.148,<->,29.211.186.201,1,1373,0,0,1,1373,0.390136000,0.0000
204.89.88.245,<->,92.27.194.147,0,0,1,230,1,230,0.389966000,0.0000
149.96.171.61,<->,136.25.189.2,0,0,1,1373,1,1373,0.389769000,0.0000
215.158.239.50,<->,199.20.5.15,1,101,0,0,1,101,0.389386000,0.0000
138.121.99.24,<->,8.220.185.56,0,0,1,443,1,443,0.389314000,0.0000
133.178.227.70,<->,48.131.159.8,1,1069,0,0,1,1069,0.389190000,0.0000
231.143.13.188,<->,136.25.188.53,0,0,1,93,1,93,0.388819000,0.0000
215.158.238.132,<->,57.225.219.36,1,1117,0,0,1,1117,0.388811000,0.0000
132.216.20.76,<->,101.126.180.109,0,0,1,928,1,928,0.388794000,0.0000
136.25.189.57,<->,89.80.251.6,1,1261,0,0,1,1261,0.388762000,0.0000
108.150.35.124,<->,8.52.188.25,0,0,1,429,1,429,0.388288000,0.0000
210.209.251.214,<->,132.51.5.140,0,0,1,481,1,481,0.388046000,0.0000
215.201.83.92,<->,54.38.254.96,1,425,0,0,1,425,0.387977000,0.0000
215.158.239.84,<->,196.91.162.27,1,240,0,0,1,240,0.387764000,0.0000
215.158.239.48,<->,199.20.28.213,1,117,0,0,1,117,0.387696000,0.0000
136.25.189.0,<->,120.154.71.25,1,1501,0,0,1,1501,0.387598000,0.0000
158.85.50.66,<->,133.178.227.14,0,0,1,1210,1,1210,0.387275000,0.0000
143.132.89.47,<->,136.25.188.175,0,0,1,272,1,272,0.387253000,0.0000
130.206.82.110,<->,50.224.76.235,0,0,1,1005,1,1005,0.387044000,0.0000
215.158.239.85,<->,195.6.197.173,1,101,0,0,1,101,0.386987000,0.0000
82.196.213.153,<->,8.20.87.210,0,0,1,508,1,508,0.386953000,0.0000
215.158.238.126,<->,100.224.166.120,1,364,0,0,1,364,0.386652000,0.0000
215.158.238.120,<->,113.23.21.215,1,93,0,0,1,93,0.386579000,0.0000
121.4.83.222,<->,50.224.76.235,0,0,1,970,1,970,0.386294000,0.0000
215.158.239.70,<->,207.191.236.228,1,602,0,0,1,602,0.385540000,0.0000
215.158.238.133,<->,8.255.92.246,1,1069,0,0,1,1069,0.385452000,0.0000
204.56.195.61,<->,136.25.188.176,0,0,1,101,1,101,0.385424000,0.0000
192.66.157.68,<->,8.45.175.127,1,252,0,0,1,252,0.384969000,0.0000
215.158.239.218,<->,159.137.139.233,1,837,0,0,1,837,0.384621000,0.0000
199.8.94.20,<->,8.20.87.206,0,0,1,555,1,555,0.384597000,0.0000
112.226.31.137,<->,92.168.217.241,0,0,1,537,1,537,0.384267000,0.0000
89.154.147.189,<->,50.224.120.135,0,0,1,93,1,93,0.384032000,0.0000
215.158.140.231,<->,48.131.157.1,1,1116,0,0,1,1116,0.383965000,0.0000
215.158.140.60,<->,48.131.159.5,1,1114,0,0,1,1114,0.383945000,0.0000
89.183.104.174,<->,14.70.166.219,1,109,0,0,1,109,0.383854000,0.0000
93.95.39.140,<->,50.224.76.248,0,0,1,1127,1,1127,0.383732000,0.0000
215.158.239.86,<->,29.211.228.186,1,1270,0,0,1,1270,0.383460000,0.0000
192.67.181.145,<->,100.224.242.186,1,97,0,0,1,97,0.383434000,0.0000
215.158.239.101,<->,129.222.39.189,1,1327,0,0,1,1327,0.383089000,0.0000
215.158.239.58,<->,196.94.176.109,1,797,0,0,1,797,0.382873000,0.0000
92.27.219.41,<->,40.199.74.69,1,56,0,0,1,56,0.382731000,0.0000
144.85.170.254,<->,91.69.185.225,1,442,0,0,1,442,0.382615000,0.0000
142.191.33.17,<->,136.25.188.45,0,0,1,172,1,172,0.382253000,0.0000
215.158.239.96,<->,199.20.6.120,1,602,0,0,1,602,0.382158000,0.0000
138.121.99.24,<->,8.220.179.126,0,0,1,319,1,319,0.381899000,0.0000
86.192.9.193,<->,0.195.210.24,0,0,1,93,1,93,0.381873000,0.0000
215.158.239.50,<->,199.97.194.182,1,1277,0,0,1,1277,0.381776000,0.0000
132.18.67.26,<->,109.1.39.1,0,0,1,399,1,399,0.380630000,0.0000
133.178.227.255,<->,105.119.200.175,1,765,0,0,1,765,0.380558000,0.0000
215.158.239.93,<->,207.190.52.97,1,93,0,0,1,93,0.380346000,0.0000
133.178.226.29,<->,57.210.107.19,1,1245,0,0,1,1245,0.380244000,0.0000
143.129.109.145,<->,136.25.188.252,0,0,1,547,1,547,0.380024000,0.0000
53.161.2.103,<->,6.95.3.106,0,0,1,605,1,605,0.378793000,0.0000
133.178.227.59,<->,133.56.180.79,1,1247,0,0,1,1247,0.378723000,0.0000
215.158.239.77,<->,195.49.173.230,1,172,0,0,1,172,0.377940000,0.0000
133.178.226.31,<->,8.191.15.73,1,1357,0,0,1,1357,0.377819000,0.0000
215.158.239.77,<->,199.80.210.102,1,93,0,0,1,93,0.377564000,0.0000
194.234.236.73,<->,136.25.188.243,0,0,1,765,1,765,0.377427000,0.0000
136.25.188.255,<->,57.227.83.169,1,1357,0,0,1,1357,0.377239000,0.0000
192.224.20.21,<->,136.25.188.221,0,0,1,1213,1,1213,0.377216000,0.0000
204.63.102.223,<->,136.25.188.226,0,0,1,765,1,765,0.377127000,0.0000
215.158.239.78,<->,114.94.161.207,1,1453,0,0,1,1453,0.377110000,0.0000
102.45.241.111,<->,92.162.252.33,0,0,1,217,1,217,0.376904000,0.0000
215.158.238.132,<->,42.97.54.90,1,1245,0,0,1,1245,0.376773000,0.0000
98.128.197.1,<->,8.49.114.128,1,421,0,0,1,421,0.376763000,0.0000
215.158.238.45,<->,29.212.195.22,1,1213,0,0,1,1213,0.376677000,0.0000
142.253.228.242,<->,136.25.188.225,0,0,1,81,1,81,0.376500000,0.0000
215.158.238.241,<->,8.222.6.193,1,1309,0,0,1,1309,0.376363000,0.0000
215.158.238.177,<->,48.131.156.68,1,1229,0,0,1,1229,0.376208000,0.0000
133.178.226.37,<->,96.155.60.246,1,148,0,0,1,148,0.376179000,0.0000
247.136.130.61,<->,193.51.144.204,1,740,0,0,1,740,0.376086000,0.0000
136.25.188.254,<->,8.222.212.11,1,1229,0,0,1,1229,0.376060000,0.0000
215.158.61.191,<->,8.176.8.233,0,0,1,573,1,573,0.376010000,0.0000
215.158.238.66,<->,8.220.51.155,1,1341,0,0,1,1341,0.375963000,0.0000
215.158.239.28,<->,117.155.166.216,1,1196,0,0,1,1196,0.375368000,0.0000
54.36.246.164,<->,48.55.145.196,0,0,1,125,1,125,0.375322000,0.0000
222.3.112.217,<->,139.163.26.146,0,0,1,99,1,99,0.375178000,0.0000
215.158.238.188,<->,8.219.184.85,1,1051,0,0,1,1051,0.375087000,0.0000
136.25.188.179,<->,117.155.166.218,1,1261,0,0,1,1261,0.374964000,0.0000
53.195.186.155,<->,35.56.101.196,0,0,1,512,1,512,0.374267000,0.0000
215.158.238.226,<->,120.190.31.242,1,1257,0,0,1,1257,0.373899000,0.0000
210.229.230.19,<->,80.233.205.8,1,263,0,0,1,263,0.373713000,0.0000
140.174.80.100,<->,133.178.227.16,0,0,1,1049,1,1049,0.373615000,0.0000
215.158.61.243,<->,8.176.8.246,0,0,1,429,1,429,0.373613000,0.0000
133.178.226.29,<->,131.1.253.226,1,1373,0,0,1,1373,0.373526000,0.0000
126.198.149.124,<->,100.92.202.96,0,0,1,344,1,344,0.373501000,0.0000
215.158.61.209,<->,97.126.31.89,0,0,1,346,1,346,0.373368000,0.0000
139.193.141.139,<->,102.88.140.214,1,494,0,0,1,494,0.373332000,0.0000
192.64.217.166,<->,122.109.241.138,1,112,0,0,1,112,0.373053000,0.0000
148.255.136.245,<->,136.25.189.33,0,0,1,1213,1,1213,0.372649000,0.0000
142.191.168.149,<->,136.25.188.162,0,0,1,630,1,630,0.372600000,0.0000
89.153.94.107,<->,54.37.224.121,1,1072,0,0,1,1072,0.372140000,0.0000
109.222.246.96,<->,33.240.41.79,1,112,0,0,1,112,0.372027000,0.0000
204.184.0.201,<->,136.25.188.163,0,0,1,907,1,907,0.371968000,0.0000
93.151.122.182,<->,50.224.76.234,0,0,1,1291,1,1291,0.371677000,0.0000
115.67.32.44,<->,50.224.106.182,0,0,1,466,1,466,0.371653000,0.0000
136.25.189.45,<->,57.199.250.198,1,1373,0,0,1,1373,0.371518000,0.0000
149.96.85.100,<->,139.163.26.146,0,0,1,99,1,99,0.371255000,0.0000
133.178.227.16,<->,29.214.211.23,1,1035,0,0,1,1035,0.371170000,0.0000
100.50.96.162,<->,8.252.223.153,0,0,1,1106,1,1106,0.370988000,0.0000
210.226.164.244,<->,54.43.249.8,1,157,0,0,1,157,0.370862000,0.0000
143.91.217.78,<->,136.25.188.45,0,0,1,282,1,282,0.370786000,0.0000
215.158.239.49,<->,199.20.30.204,1,172,0,0,1,172,0.370532000,0.0000
207.172.176.187,<->,136.25.188.44,0,0,1,378,1,378,0.370319000,0.0000
221.102.56.69,<->,220.80.171.36,0,0,1,294,1,294,0.370197000,0.0000
220.28.115.46,<->,136.25.189.93,0,0,1,982,1,982,0.369784000,0.0000
215.158.239.99,<->,142.240.138.160,1,95,0,0,1,95,0.369488000,0.0000
215.158.238.73,<->,8.240.116.183,1,1149,0,0,1,1149,0.369455000,0.0000
133.178.226.71,<->,56.1.237.36,1,1213,0,0,1,1213,0.369226000,0.0000
215.158.140.231,<->,201.211.113.41,1,1397,0,0,1,1397,0.368394000,0.0000
215.158.239.79,<->,199.20.6.140,1,87,0,0,1,87,0.368182000,0.0000
136.25.188.55,<->,104.3.161.40,1,1229,0,0,1,1229,0.367632000,0.0000
215.158.238.196,<->,154.183.124.176,1,1229,0,0,1,1229,0.367548000,0.0000
136.25.189.92,<->,96.156.169.173,1,421,0,0,1,421,0.367342000,0.0000
215.158.238.96,<->,149.99.92.11,1,1293,0,0,1,1293,0.367243000,0.0000
221.102.56.69,<->,80.40.106.78,0,0,1,294,1,294,0.367152000,0.0000
220.55.174.116,<->,57.227.119.229,1,525,0,0,1,525,0.364822000,0.0000
204.187.137.207,<->,136.25.188.255,0,0,1,101,1,101,0.364587000,0.0000
136.25.188.47,<->,122.158.52.199,1,1229,0,0,1,1229,0.364309000,0.0000
148.174.129.26,<->,139.193.141.139,0,0,1,498,1,498,0.363953000,0.0000
133.178.226.30,<->,6.116.14.117,1,1229,0,0,1,1229,0.363634000,0.0000
195.110.45.244,<->,50.223.3.228,0,0,1,173,1,173,0.363544000,0.0000
215.158.238.33,<->,126.219.132.253,1,1357,0,0,1,1357,0.363498000,0.0000
136.25.189.1,<->,8.252.253.227,1,213,0,0,1,213,0.363292000,0.0000
215.158.61.189,<->,8.176.8.180,0,0,1,1149,1,1149,0.362814000,0.0000
80.38.16.211,<->,79.136.250.50,1,460,0,0,1,460,0.362477000,0.0000
215.158.238.149,<->,100.224.138.251,1,224,0,0,1,224,0.361834000,0.0000
215.158.61.203,<->,8.176.8.203,0,0,1,1421,1,1421,0.360856000,0.0000
215.158.140.93,<->,72.23.148.203,1,1151,0,0,1,1151,0.360539000,0.0000
215.158.239.57,<->,114.25.48.41,1,1213,0,0,1,1213,0.360201000,0.0000
109.222.193.26,<->,8.232.109.12,1,106,0,0,1,106,0.360160000,0.0000
202.33.58.1,<->,136.25.188.240,0,0,1,87,1,87,0.360147000,0.0000
215.158.239.79,<->,207.236.72.252,1,170,0,0,1,170,0.360144000,0.0000
197.113.99.59,<->,136.25.188.225,0,0,1,93,1,93,0.359930000,0.0000
98.129.75.233,<->,58.43.188.9,1,363,0,0,1,363,0.359594000,0.0000
216.144.219.173,<->,215.158.140.193,0,0,1,642,1,642,0.359465000,0.0000
133.178.226.7,<->,38.104.11.53,1,1373,0,0,1,1373,0.359343000,0.0000
109.50.149.126,<->,8.183.25.124,0,0,1,354,1,354,0.359190000,0.0000
136.25.188.179,<->,130.165.253.86,1,1245,0,0,1,1245,0.359144000,0.0000
111.146.169.221,<->,53.231.93.123,1,81,0,0,1,81,0.358703000,0.0000
215.158.238.95,<->,201.211.112.213,1,957,0,0,1,957,0.358444000,0.0000
215.158.238.73,<->,106.188.183.91,1,1144,0,0,1,1144,0.358331000,0.0000
133.178.226.61,<->,38.206.161.75,1,1245,0,0,1,1245,0.358293000,0.0000
215.158.239.76,<->,89.80.251.9,1,1245,0,0,1,1245,0.357974000,0.0000
215.158.238.198,<->,29.211.165.35,1,1041,0,0,1,1041,0.357773000,0.0000
111.147.246.5,<->,105.122.151.39,1,301,0,0,1,301,0.357693000,0.0000
136.25.189.13,<->,126.219.49.42,1,1053,0,0,1,1053,0.357580000,0.0000
215.158.238.140,<->,116.107.47.42,1,1229,0,0,1,1229,0.357562000,0.0000
136.139.59.117,<->,133.178.226.77,0,0,1,1023,1,1023,0.356984000,0.0000
159.137.226.155,<->,89.183.98.97,1,526,0,0,1,526,0.356686000,0.0000
192.65.168.51,<->,8.55.211.213,1,294,0,0,1,294,0.356531000,0.0000
144.85.170.208,<->,98.87.147.122,1,1196,0,0,1,1196,0.356489000,0.0000
215.158.238.133,<->,131.144.113.182,1,1357,0,0,1,1357,0.356315000,0.0000
215.158.239.79,<->,142.223.153.67,1,107,0,0,1,107,0.355977000,0.0000
215.158.238.198,<->,215.158.6.213,1,1109,0,0,1,1109,0.355889000,0.0000
215.158.61.145,<->,136.25.188.41,0,0,1,1485,1,1485,0.355844000,0.0000
207.56.101.49,<->,136.25.188.163,0,0,1,344,1,344,0.355633000,0.0000
204.200.44.174,<->,136.25.188.255,0,0,1,172,1,172,0.355321000,0.0000
195.54.95.180,<->,136.25.188.52,0,0,1,765,1,765,0.355307000,0.0000
8.252.221.236,<->,4.120.147.110,1,452,0,0,1,452,0.355083000,0.0000
200.174.223.64,<->,53.161.35.31,1,93,0,0,1,93,0.354791000,0.0000
133.178.226.71,<->,69.31.239.13,1,1120,0,0,1,1120,0.354566000,0.0000
215.158.239.119,<->,53.210.166.146,1,201,0,0,1,201,0.354264000,0.0000
213.221.90.129,<->,144.85.170.208,0,0,1,439,1,439,0.354161000,0.0000
215.158.239.95,<->,199.20.31.35,1,101,0,0,1,101,0.353836000,0.0000
133.54.43.82,<->,122.129.6.152,1,697,0,0,1,697,0.353716000,0.0000
192.226.161.53,<->,133.178.226.19,0,0,1,1197,1,1197,0.353019000,0.0000
207.173.5.199,<->,136.25.188.52,0,0,1,602,1,602,0.352965000,0.0000
235.42.34.20,<->,215.158.238.105,0,0,1,1181,1,1181,0.352896000,0.0000
144.85.170.254,<->,91.69.185.155,1,756,0,0,1,756,0.352715000,0.0000
199.116.164.175,<->,50.223.3.228,0,0,1,228,1,228,0.352612000,0.0000
194.233.238.26,<->,136.25.188.46,0,0,1,101,1,101,0.352446000,0.0000
235.228.110.72,<->,139.163.26.146,0,0,1,99,1,99,0.352106000,0.0000
126.198.149.124,<->,111.146.143.209,0,0,1,341,1,341,0.352032000,0.0000
210.208.231.236,<->,102.51.41.219,0,0,1,108,1,108,0.351716000,0.0000
143.52.27.234,<->,136.25.188.176,0,0,1,1105,1,1105,0.351561000,0.0000
215.158.239.93,<->,0.34.21.10,1,1229,0,0,1,1229,0.351275000,0.0000
207.58.119.140,<->,136.25.188.55,0,0,1,101,1,101,0.351224000,0.0000
136.25.188.176,<->,126.219.102.191,1,1325,0,0,1,1325,0.350968000,0.0000
194.218.9.93,<->,8.182.229.19,0,0,1,911,1,911,0.350853000,0.0000
220.39.174.196,<->,215.158.239.84,0,0,1,1261,1,1261,0.350568000,0.0000
231.255.191.45,<->,80.40.46.139,0,0,1,376,1,376,0.350011000,0.0000
209.91.187.251,<->,8.52.148.104,0,0,1,401,1,401,0.349878000,0.0000
215.158.140.131,<->,215.158.42.206,1,818,0,0,1,818,0.349566000,0.0000
246.253.253.171,<->,111.151.239.176,1,968,0,0,1,968,0.349061000,0.0000
142.240.54.193,<->,136.25.188.175,0,0,1,117,1,117,0.348827000,0.0000
109.1.57.207,<->,50.224.76.235,0,0,1,518,1,518,0.348691000,0.0000
215.158.239.96,<->,194.199.198.183,1,87,0,0,1,87,0.348483000,0.0000
215.158.238.238,<->,112.235.18.28,1,1205,0,0,1,1205,0.348391000,0.0000
133.32.39.1,<->,8.191.1.176,1,247,0,0,1,247,0.347305000,0.0000
136.139.59.125,<->,136.25.188.220,0,0,1,1022,1,1022,0.346714000,0.0000
247.136.134.246,<->,192.169.60.182,1,294,0,0,1,294,0.346384000,0.0000
92.27.219.215,<->,53.75.225.119,1,914,0,0,1,914,0.346223000,0.0000
196.94.112.182,<->,50.224.76.248,0,0,1,617,1,617,0.346094000,0.0000
207.6.70.159,<->,8.182.139.197,0,0,1,180,1,180,0.346060000,0.0000
215.158.239.50,<->,199.20.29.149,1,141,0,0,1,141,0.346048000,0.0000
117.13.158.151,<->,50.224.76.234,0,0,1,542,1,542,0.346034000,0.0000
215.158.239.84,<->,204.2.66.40,1,771,0,0,1,771,0.345922000,0.0000
220.20.200.190,<->,121.105.194.40,1,572,0,0,1,572,0.345659000,0.0000
215.158.239.66,<->,56.97.186.37,1,1157,0,0,1,1157,0.345559000,0.0000
133.178.227.229,<->,100.224.243.90,1,289,0,0,1,289,0.345546000,0.0000
148.186.207.231,<->,133.178.226.49,0,0,1,1133,1,1133,0.345519000,0.0000
145.192.91.197,<->,8.52.178.108,0,0,1,1073,1,1073,0.345493000,0.0000
133.178.226.37,<->,6.116.14.11,1,1197,0,0,1,1197,0.345372000,0.0000
215.158.239.6,<->,8.190.216.215,1,1452,0,0,1,1452,0.344679000,0.0000
229.45.59.129,<->,8.181.151.154,1,398,0,0,1,398,0.344421000,0.0000
158.14.116.39,<->,50.224.89.237,0,0,1,79,1,79,0.343383000,0.0000
215.158.239.56,<->,199.20.31.9,1,781,0,0,1,781,0.343357000,0.0000
215.158.239.99,<->,199.20.31.39,1,87,0,0,1,87,0.343303000,0.0000
215.158.238.133,<->,143.155.227.33,1,93,0,0,1,93,0.343292000,0.0000
215.158.238.177,<->,128.23.167.156,1,1133,0,0,1,1133,0.343266000,0.0000
215.158.238.123,<->,136.139.59.102,1,1022,0,0,1,1022,0.342830000,0.0000
247.136.152.114,<->,131.2.232.125,1,603,0,0,1,603,0.342299000,0.0000
133.225.140.202,<->,80.42.174.46,0,0,1,405,1,405,0.342276000,0.0000
215.158.239.49,<->,199.20.30.3,1,101,0,0,1,101,0.342223000,0.0000
215.158.238.176,<->,8.188.227.52,1,1080,0,0,1,1080,0.342112000,0.0000
207.58.58.110,<->,136.25.188.178,0,0,1,797,1,797,0.341917000,0.0000
215.158.140.93,<->,29.211.228.179,1,1066,0,0,1,1066,0.341735000,0.0000
215.158.239.49,<->,199.20.31.76,1,765,0,0,1,765,0.341439000,0.0000
215.158.239.58,<->,195.80.42.180,1,282,0,0,1,282,0.341180000,0.0000
215.158.239.95,<->,194.251.64.62,1,765,0,0,1,765,0.340592000,0.0000
215.158.239.97,<->,196.105.121.181,1,157,0,0,1,157,0.340583000,0.0000
222.103.245.212,<->,221.102.118.5,0,0,1,542,1,542,0.340343000,0.0000
193.78.140.154,<->,92.162.253.253,0,0,1,114,1,114,0.340297000,0.0000
215.158.239.16,<->,8.219.187.246,1,1094,0,0,1,1094,0.340282000,0.0000
207.173.206.252,<->,136.25.188.44,0,0,1,602,1,602,0.340071000,0.0000
200.174.223.85,<->,54.36.129.165,1,214,0,0,1,214,0.340061000,0.0000
93.95.34.144,<->,92.168.217.253,0,0,1,348,1,348,0.339839000,0.0000
215.158.239.102,<->,215.158.61.203,1,1392,0,0,1,1392,0.339826000,0.0000
95.245.97.163,<->,8.252.221.199,0,0,1,319,1,319,0.339730000,0.0000
109.222.207.76,<->,53.244.1.230,1,1469,0,0,1,1469,0.339542000,0.0000
215.158.239.93,<->,199.20.30.134,1,117,0,0,1,117,0.338798000,0.0000
215.158.239.78,<->,125.84.55.30,1,1405,0,0,1,1405,0.338360000,0.0000
207.238.20.126,<->,136.25.188.254,0,0,1,281,1,281,0.338307000,0.0000
220.55.108.80,<->,137.44.153.229,1,281,0,0,1,281,0.338134000,0.0000
215.158.239.95,<->,194.186.217.194,1,93,0,0,1,93,0.338116000,0.0000
221.102.143.189,<->,220.81.54.34,0,0,1,141,1,141,0.338082000,0.0000
207.173.34.35,<->,136.25.188.55,0,0,1,901,1,901,0.337866000,0.0000
215.158.239.92,<->,194.199.203.105,1,827,0,0,1,827,0.337785000,0.0000
204.62.243.249,<->,136.25.188.55,0,0,1,995,1,995,0.337661000,0.0000
199.69.255.191,<->,136.25.188.239,0,0,1,749,1,749,0.337434000,0.0000
215.158.238.152,<->,0.195.237.14,1,896,0,0,1,896,0.337432000,0.0000
215.158.238.135,<->,136.139.59.124,1,1101,0,0,1,1101,0.337257000,0.0000
215.158.140.92,<->,131.144.113.138,1,1294,0,0,1,1294,0.337173000,0.0000
136.25.189.29,<->,116.106.46.58,1,1396,0,0,1,1396,0.336673000,0.0000
202.178.8.212,<->,97.127.83.152,0,0,1,330,1,330,0.336656000,0.0000
215.158.238.177,<->,6.116.31.8,1,763,0,0,1,763,0.336656000,0.0000
89.86.110.223,<->,8.252.223.162,0,0,1,1049,1,1049,0.336599000,0.0000
142.207.250.34,<->,136.25.188.198,0,0,1,85,1,85,0.336011000,0.0000
133.178.226.28,<->,120.154.177.212,1,1069,0,0,1,1069,0.335705000,0.0000
136.25.189.57,<->,69.132.46.143,1,1357,0,0,1,1357,0.335533000,0.0000
215.158.238.66,<->,29.214.73.149,1,1085,0,0,1,1085,0.335496000,0.0000
243.123.125.57,<->,92.162.253.11,0,0,1,1039,1,1039,0.335448000,0.0000
199.122.61.247,<->,136.25.188.54,0,0,1,312,1,312,0.335387000,0.0000
215.158.239.51,<->,199.20.5.43,1,765,0,0,1,765,0.335316000,0.0000
136.25.189.63,<->,96.156.169.166,1,310,0,0,1,310,0.335229000,0.0000
215.158.140.205,<->,8.222.7.155,1,1178,0,0,1,1178,0.334656000,0.0000
215.158.239.113,<->,129.222.39.145,1,1044,0,0,1,1044,0.334615000,0.0000
215.158.140.83,<->,131.1.195.27,1,1377,0,0,1,1377,0.334571000,0.0000
205.227.96.9,<->,136.25.189.0,0,0,1,309,1,309,0.334444000,0.0000
215.158.238.72,<->,149.161.153.88,1,1373,0,0,1,1373,0.334264000,0.0000
235.42.34.24,<->,215.158.238.135,0,0,1,1197,1,1197,0.334170000,0.0000
215.158.239.77,<->,195.83.72.213,1,141,0,0,1,141,0.334096000,0.0000
192.171.32.182,<->,136.25.189.14,0,0,1,1341,1,1341,0.333988000,0.0000
249.101.109.210,<->,136.141.44.252,1,60,0,0,1,60,0.333975000,0.0000
102.50.53.121,<->,33.250.186.2,1,107,0,0,1,107,0.333428000,0.0000
199.18.9.104,<->,136.25.188.179,0,0,1,1213,1,1213,0.333118000,0.0000
215.158.238.142,<->,126.219.132.252,1,1213,0,0,1,1213,0.333111000,0.0000
133.171.98.209,<->,8.220.176.253,0,0,1,282,1,282,0.333059000,0.0000
117.35.55.89,<->,8.31.37.163,0,0,1,791,1,791,0.333001000,0.0000
133.32.39.0,<->,14.71.90.213,1,271,0,0,1,271,0.332894000,0.0000
136.25.189.60,<->,96.156.169.178,1,754,0,0,1,754,0.332383000,0.0000
50.224.76.230,<->,6.212.127.225,1,1160,0,0,1,1160,0.331954000,0.0000
143.155.227.54,<->,136.25.188.254,0,0,1,1133,1,1133,0.331707000,0.0000
142.236.211.60,<->,136.25.188.199,0,0,1,701,1,701,0.331552000,0.0000
136.50.56.220,<->,109.1.72.27,0,0,1,997,1,997,0.331529000,0.0000
133.178.226.60,<->,113.23.21.212,1,1325,0,0,1,1325,0.331523000,0.0000
136.25.189.22,<->,100.216.78.145,1,58,0,0,1,58,0.331435000,0.0000
204.130.137.8,<->,0.195.210.46,0,0,1,93,1,93,0.331133000,0.0000
215.158.238.97,<->,33.239.214.179,1,1357,0,0,1,1357,0.331078000,0.0000
136.139.59.124,<->,133.178.226.19,0,0,1,1277,1,1277,0.330559000,0.0000
110.42.4.97,<->,50.224.80.67,0,0,1,421,1,421,0.330500000,0.0000
126.152.82.108,<->,80.41.53.34,0,0,1,921,1,921,0.330330000,0.0000
207.117.189.228,<->,80.38.39.192,0,0,1,431,1,431,0.330254000,0.0000
69.243.197.158,<->,8.252.221.236,0,0,1,452,1,452,0.330125000,0.0000
215.158.238.112,<->,156.165.33.20,1,1197,0,0,1,1197,0.329936000,0.0000
215.158.238.106,<->,61.35.70.231,1,1069,0,0,1,1069,0.329830000,0.0000
199.71.174.164,<->,136.25.188.252,0,0,1,172,1,172,0.329806000,0.0000
145.76.230.106,<->,33.233.141.0,0,0,1,259,1,259,0.329673000,0.0000
215.158.238.95,<->,38.51.98.247,1,1245,0,0,1,1245,0.329524000,0.0000
215.158.140.92,<->,113.20.94.212,1,1039,0,0,1,1039,0.329365000,0.0000
204.200.42.202,<->,136.25.188.52,0,0,1,733,1,733,0.328895000,0.0000
247.136.157.176,<->,8.55.140.54,1,1144,0,0,1,1144,0.328890000,0.0000
199.69.142.235,<->,136.25.188.222,0,0,1,93,1,93,0.328543000,0.0000
148.226.51.110,<->,50.224.76.230,0,0,1,537,1,537,0.328416000,0.0000
213.221.90.192,<->,144.85.170.208,0,0,1,431,1,431,0.328283000,0.0000
100.151.99.70,<->,8.52.222.23,0,0,1,1218,1,1218,0.328003000,0.0000
119.159.22.233,<->,92.162.253.161,0,0,1,343,1,343,0.327961000,0.0000
145.252.121.82,<->,119.53.190.76,1,453,0,0,1,453,0.327815000,0.0000
215.158.238.82,<->,120.80.17.23,1,1213,0,0,1,1213,0.327128000,0.0000
215.158.239.99,<->,199.20.28.166,1,168,0,0,1,168,0.326970000,0.0000
207.58.162.88,<->,136.25.188.236,0,0,1,89,1,89,0.326249000,0.0000
215.158.239.68,<->,199.32.117.198,1,145,0,0,1,145,0.326230000,0.0000
215.158.239.48,<->,199.20.4.179,1,831,0,0,1,831,0.326102000,0.0000
120.118.68.174,<->,50.224.76.234,0,0,1,779,1,779,0.326031000,0.0000
215.158.238.221,<->,18.203.159.187,1,803,0,0,1,803,0.325880000,0.0000
215.158.238.123,<->,106.188.251.194,1,1231,0,0,1,1231,0.325664000,0.0000
199.69.47.42,<->,136.25.188.160,0,0,1,522,1,522,0.325581000,0.0000
216.184.2.174,<->,6.73.247.20,0,0,1,381,1,381,0.325557000,0.0000
215.158.239.77,<->,195.127.43.47,1,657,0,0,1,657,0.325491000,0.0000
197.113.99.120,<->,136.25.188.177,0,0,1,632,1,632,0.324966000,0.0000
50.224.76.235,<->,29.91.23.23,1,1069,0,0,1,1069,0.324443000,0.0000
195.13.87.15,<->,136.25.188.253,0,0,1,1165,1,1165,0.324409000,0.0000
215.158.239.76,<->,199.20.30.201,1,573,0,0,1,573,0.324318000,0.0000
136.25.189.77,<->,56.28.207.192,1,1341,0,0,1,1341,0.324141000,0.0000
136.25.189.77,<->,6.73.23.200,1,1197,0,0,1,1197,0.323912000,0.0000
215.158.238.236,<->,140.174.84.9,1,1050,0,0,1,1050,0.323770000,0.0000
133.178.226.78,<->,8.222.212.42,1,1213,0,0,1,1213,0.323547000,0.0000
215.158.238.93,<->,113.23.21.223,1,1181,0,0,1,1181,0.323330000,0.0000
215.158.239.95,<->,142.254.246.164,1,117,0,0,1,117,0.323301000,0.0000
35.55.100.4,<->,8.182.244.177,0,0,1,572,1,572,0.323262000,0.0000
252.98.132.211,<->,54.46.168.68,1,1348,0,0,1,1348,0.322706000,0.0000
212.164.143.229,<->,99.164.219.173,1,625,0,0,1,625,0.322086000,0.0000
136.25.188.211,<->,69.132.194.107,1,1373,0,0,1,1373,0.322048000,0.0000
215.158.239.24,<->,215.158.127.153,1,1056,0,0,1,1056,0.321928000,0.0000
102.44.98.96,<->,54.36.89.97,1,216,0,0,1,216,0.321803000,0.0000
93.181.154.75,<->,92.27.219.16,0,0,1,51,1,51,0.321673000,0.0000
133.178.226.61,<->,99.192.168.155,1,1285,0,0,1,1285,0.321660000,0.0000
215.158.238.105,<->,192.229.40.108,1,1213,0,0,1,1213,0.321233000,0.0000
133.178.227.79,<->,106.188.253.131,1,1271,0,0,1,1271,0.321183000,0.0000
215.158.238.45,<->,8.191.6.123,1,1133,0,0,1,1133,0.321156000,0.0000
215.158.238.115,<->,139.160.226.175,1,1229,0,0,1,1229,0.321133000,0.0000
215.158.238.81,<->,205.227.96.20,1,1069,0,0,1,1069,0.321065000,0.0000
215.158.238.123,<->,136.139.59.105,1,1021,0,0,1,1021,0.320749000,0.0000
197.113.99.177,<->,136.25.188.55,0,0,1,172,1,172,0.320695000,0.0000
136.116.9.67,<->,50.224.80.67,0,0,1,422,1,422,0.320639000,0.0000
215.158.238.85,<->,145.116.209.76,1,506,0,0,1,506,0.320589000,0.0000
215.158.58.203,<->,6.73.247.85,0,0,1,853,1,853,0.320293000,0.0000
215.158.61.195,<->,8.176.8.189,0,0,1,589,1,589,0.319424000,0.0000
117.6.225.235,<->,8.31.37.174,0,0,1,1149,1,1149,0.319251000,0.0000
135.243.190.253,<->,8.52.176.134,0,0,1,1217,1,1217,0.319240000,0.0000
149.197.243.185,<->,80.38.54.169,0,0,1,799,1,799,0.319200000,0.0000
136.25.188.196,<->,131.144.114.209,1,1325,0,0,1,1325,0.319136000,0.0000
144.86.150.152,<->,0.61.61.17,1,717,0,0,1,717,0.319092000,0.0000
136.25.188.252,<->,113.23.104.221,1,1229,0,0,1,1229,0.318830000,0.0000
79.210.154.10,<->,50.224.76.234,0,0,1,187,1,187,0.318502000,0.0000
141.162.130.245,<->,136.25.188.161,0,0,1,1181,1,1181,0.318284000,0.0000
136.25.188.226,<->,122.158.51.87,1,1325,0,0,1,1325,0.318270000,0.0000
215.158.238.74,<->,104.3.169.55,1,1037,0,0,1,1037,0.317835000,0.0000
149.150.11.46,<->,139.163.5.140,0,0,1,112,1,112,0.317089000,0.0000
215.158.238.97,<->,29.211.186.197,1,1277,0,0,1,1277,0.316746000,0.0000
215.158.140.76,<->,122.159.123.1,1,1088,0,0,1,1088,0.316589000,0.0000
200.174.28.109,<->,54.37.1.37,1,634,0,0,1,634,0.316042000,0.0000
8.252.223.145,<->,8.219.187.248,1,1001,0,0,1,1001,0.316036000,0.0000
100.206.84.172,<->,92.162.253.125,0,0,1,262,1,262,0.315689000,0.0000
195.68.97.235,<->,136.25.188.252,0,0,1,781,1,781,0.315670000,0.0000
138.5.92.214,<->,97.198.98.33,0,0,1,277,1,277,0.315640000,0.0000
210.229.230.19,<->,129.6.176.62,1,68,0,0,1,68,0.315554000,0.0000
197.106.84.186,<->,8.182.224.248,0,0,1,276,1,276,0.315126000,0.0000
195.3.103.216,<->,136.25.189.34,0,0,1,1213,1,1213,0.314397000,0.0000
97.168.79.246,<->,91.40.228.115,1,1220,0,0,1,1220,0.314302000,0.0000
133.178.226.244,<->,111.150.74.50,1,789,0,0,1,789,0.314033000,0.0000
204.200.53.246,<->,136.25.188.220,0,0,1,132,1,132,0.313861000,0.0000
215.158.238.23,<->,29.212.199.99,1,1373,0,0,1,1373,0.313690000,0.0000
92.27.4.183,<->,82.198.194.236,0,0,1,81,1,81,0.313571000,0.0000
215.158.238.190,<->,33.209.219.19,1,1181,0,0,1,1181,0.313337000,0.0000
143.76.165.4,<->,8.182.248.147,0,0,1,861,1,861,0.313053000,0.0000
204.187.163.107,<->,136.25.188.243,0,0,1,282,1,282,0.312955000,0.0000
215.158.140.19,<->,111.150.207.173,1,100,0,0,1,100,0.312860000,0.0000
246.254.97.228,<->,27.11.61.128,1,588,0,0,1,588,0.312790000,0.0000
215.158.238.64,<->,29.211.186.197,1,1357,0,0,1,1357,0.312641000,0.0000
215.158.140.173,<->,92.25.107.157,1,793,0,0,1,793,0.312494000,0.0000
215.158.238.92,<->,143.20.121.130,1,1261,0,0,1,1261,0.312119000,0.0000
207.239.73.208,<->,136.25.188.53,0,0,1,141,1,141,0.312094000,0.0000
145.235.126.55,<->,50.224.76.234,0,0,1,614,1,614,0.311807000,0.0000
143.89.71.49,<->,136.25.188.225,0,0,1,298,1,298,0.311449000,0.0000
239.227.105.202,<->,8.49.69.216,1,382,0,0,1,382,0.311379000,0.0000
133.178.226.37,<->,131.1.253.208,1,1373,0,0,1,1373,0.311263000,0.0000
249.101.118.54,<->,100.206.91.27,1,197,0,0,1,197,0.310811000,0.0000
215.158.238.114,<->,91.57.173.62,1,1277,0,0,1,1277,0.310319000,0.0000
142.221.173.130,<->,136.25.188.46,0,0,1,296,1,296,0.310063000,0.0000
207.173.221.153,<->,136.25.188.52,0,0,1,93,1,93,0.309941000,0.0000
215.158.239.78,<->,114.25.48.41,1,1245,0,0,1,1245,0.309934000,0.0000
156.165.37.111,<->,133.178.227.16,0,0,1,1357,1,1357,0.309408000,0.0000
215.158.239.96,<->,199.20.30.134,1,93,0,0,1,93,0.309274000,0.0000
139.193.141.139,<->,116.175.209.73,1,279,0,0,1,279,0.309135000,0.0000
199.57.193.8,<->,50.223.3.228,0,0,1,229,1,229,0.308969000,0.0000
215.158.239.51,<->,207.115.154.92,1,781,0,0,1,781,0.308819000,0.0000
215.158.238.135,<->,57.199.250.198,1,1357,0,0,1,1357,0.308680000,0.0000
215.158.238.176,<->,69.150.168.252,1,1261,0,0,1,1261,0.308462000,0.0000
215.158.238.135,<->,29.212.194.181,1,1197,0,0,1,1197,0.308424000,0.0000
142.249.34.157,<->,136.25.188.174,0,0,1,85,1,85,0.308370000,0.0000
136.25.188.175,<->,131.1.195.220,1,1404,0,0,1,1404,0.308327000,0.0000
145.208.180.148,<->,53.68.232.129,1,419,0,0,1,419,0.308306000,0.0000
136.25.188.237,<->,48.129.132.228,1,1101,0,0,1,1101,0.307991000,0.0000
215.158.239.95,<->,199.20.31.102,1,101,0,0,1,101,0.307462000,0.0000
207.204.177.249,<->,50.224.76.234,0,0,1,1187,1,1187,0.307000000,0.0000
215.158.140.92,<->,140.174.85.75,1,1149,0,0,1,1149,0.306754000,0.0000
202.124.175.48,<->,8.252.222.199,0,0,1,475,1,475,0.306551000,0.0000
72.157.196.58,<->,0.195.210.8,0,0,1,420,1,420,0.306468000,0.0000
143.54.161.12,<->,8.20.87.153,0,0,1,559,1,559,0.306165000,0.0000
197.113.99.151,<->,136.25.188.241,0,0,1,858,1,858,0.306132000,0.0000
133.178.226.80,<->,112.235.116.201,1,1149,0,0,1,1149,0.306056000,0.0000
199.38.60.19,<->,136.25.188.175,0,0,1,170,1,170,0.305540000,0.0000
215.158.239.71,<->,131.144.113.62,1,1229,0,0,1,1229,0.305390000,0.0000
17.143.241.23,<->,8.220.176.253,0,0,1,535,1,535,0.305297000,0.0000
97.182.7.27,<->,8.220.178.246,0,0,1,75,1,75,0.305276000,0.0000
215.158.239.79,<->,207.115.200.229,1,632,0,0,1,632,0.305060000,0.0000
210.229.230.22,<->,97.115.82.210,1,68,0,0,1,68,0.304978000,0.0000
215.158.239.19,<->,105.51.161.75,1,407,0,0,1,407,0.304547000,0.0000
215.158.238.223,<->,29.212.182.20,1,1030,0,0,1,1030,0.304388000,0.0000
136.25.188.224,<->,111.151.70.52,1,1341,0,0,1,1341,0.304372000,0.0000
221.102.143.189,<->,98.128.110.36,0,0,1,141,1,141,0.304166000,0.0000
215.158.239.84,<->,143.68.145.136,1,749,0,0,1,749,0.304136000,0.0000
215.158.238.45,<->,29.213.195.55,1,277,0,0,1,277,0.303969000,0.0000
215.158.238.132,<->,212.70.217.102,1,1165,0,0,1,1165,0.303905000,0.0000
253.244.5.101,<->,50.224.76.235,0,0,1,597,1,597,0.303739000,0.0000
136.25.188.254,<->,29.214.108.91,1,1357,0,0,1,1357,0.303376000,0.0000
202.178.9.232,<->,133.32.2.73,0,0,1,459,1,459,0.303139000,0.0000
145.242.126.139,<->,99.167.188.131,1,169,0,0,1,169,0.303087000,0.0000
220.55.109.168,<->,220.28.110.136,1,336,0,0,1,336,0.303081000,0.0000
215.158.238.154,<->,111.151.142.246,1,100,0,0,1,100,0.303032000,0.0000
215.158.239.95,<->,196.93.205.113,1,685,0,0,1,685,0.303000000,0.0000
136.25.189.31,<->,120.154.131.7,1,1293,0,0,1,1293,0.302954000,0.0000
215.158.140.231,<->,113.20.94.221,1,1095,0,0,1,1095,0.302793000,0.0000
106.168.190.66,<->,99.75.96.88,0,0,1,137,1,137,0.302594000,0.0000
133.178.226.61,<->,57.247.184.219,1,1117,0,0,1,1117,0.302489000,0.0000
213.38.198.143,<->,77.18.248.187,1,53,0,0,1,53,0.302486000,0.0000
215.158.239.92,<->,199.20.29.189,1,101,0,0,1,101,0.302388000,0.0000
215.158.238.135,<->,131.1.195.220,1,117,0,0,1,117,0.302208000,0.0000
133.178.226.255,<->,97.4.157.0,1,233,0,0,1,233,0.301984000,0.0000
149.254.205.158,<->,133.178.226.30,0,0,1,1229,1,1229,0.301966000,0.0000
215.158.239.41,<->,8.191.15.28,1,435,0,0,1,435,0.301909000,0.0000
17.6.117.77,<->,8.220.188.138,0,0,1,205,1,205,0.301808000,0.0000
132.51.185.39,<->,8.52.222.117,0,0,1,1073,1,1073,0.301596000,0.0000
207.61.68.151,<->,136.25.188.226,0,0,1,346,1,346,0.301437000,0.0000
43.55.242.82,<->,8.252.221.204,0,0,1,458,1,458,0.301232000,0.0000
134.0.214.2,<->,89.183.104.136,0,0,1,465,1,465,0.301122000,0.0000
136.25.188.210,<->,76.100.108.197,1,1261,0,0,1,1261,0.301030000,0.0000
129.28.175.197,<->,50.224.76.230,0,0,1,1096,1,1096,0.300990000,0.0000
215.158.239.95,<->,196.91.10.176,1,781,0,0,1,781,0.300510000,0.0000
136.25.189.30,<->,48.129.132.211,1,1389,0,0,1,1389,0.300140000,0.0000
220.28.73.211,<->,136.25.188.49,0,0,1,228,1,228,0.300109000,0.0000
215.158.238.144,<->,80.57.141.219,1,506,0,0,1,506,0.300016000,0.0000
205.95.37.167,<->,92.27.194.117,0,0,1,446,1,446,0.299948000,0.0000
202.33.202.124,<->,136.25.188.240,0,0,1,93,1,93,0.299496000,0.0000
139.163.20.196,<->,131.124.23.163,1,572,0,0,1,572,0.299192000,0.0000
69.246.61.13,<->,8.252.223.162,0,0,1,223,1,223,0.299162000,0.0000
17.255.107.2,<->,8.220.191.251,0,0,1,557,1,557,0.299037000,0.0000
159.25.67.144,<->,8.182.252.86,0,0,1,608,1,608,0.298910000,0.0000
221.102.56.69,<->,192.67.161.246,0,0,1,294,1,294,0.298282000,0.0000
200.174.197.247,<->,53.160.87.174,1,93,0,0,1,93,0.297924000,0.0000
215.158.238.33,<->,131.36.105.43,1,1226,0,0,1,1226,0.297731000,0.0000
215.158.238.73,<->,119.168.0.144,1,1341,0,0,1,1341,0.297716000,0.0000
131.22.119.229,<->,92.162.253.145,0,0,1,622,1,622,0.297706000,0.0000
112.7.58.75,<->,50.224.76.230,0,0,1,841,1,841,0.297440000,0.0000
144.85.170.254,<->,91.69.185.128,1,438,0,0,1,438,0.297393000,0.0000
200.174.208.0,<->,53.160.87.174,1,93,0,0,1,93,0.297331000,0.0000
142.208.84.30,<->,136.25.188.163,0,0,1,797,1,797,0.297289000,0.0000
195.22.148.17,<->,50.224.76.235,0,0,1,721,1,721,0.297172000,0.0000
195.13.140.158,<->,136.25.188.209,0,0,1,132,1,132,0.297082000,0.0000
246.254.97.107,<->,143.54.7.114,1,1424,0,0,1,1424,0.296872000,0.0000
215.158.238.251,<->,61.35.70.37,1,1070,0,0,1,1070,0.296646000,0.0000
215.158.239.95,<->,142.236.169.88,1,1222,0,0,1,1222,0.296355000,0.0000
215.158.239.4,<->,120.155.14.151,1,300,0,0,1,300,0.296313000,0.0000
133.178.226.30,<->,29.213.216.233,1,1053,0,0,1,1053,0.296252000,0.0000
202.33.110.228,<->,136.25.188.52,0,0,1,797,1,797,0.296197000,0.0000
221.102.143.189,<->,109.3.153.204,0,0,1,141,1,141,0.296001000,0.0000
100.116.238.33,<->,92.27.27.167,0,0,1,508,1,508,0.295996000,0.0000
215.158.234.124,<->,91.51.217.98,0,0,1,224,1,224,0.295610000,0.0000
133.54.30.209,<->,38.28.228.78,1,279,0,0,1,279,0.295555000,0.0000
220.55.169.75,<->,27.202.117.216,1,63,0,0,1,63,0.295460000,0.0000
145.170.227.223,<->,8.52.163.19,0,0,1,366,1,366,0.295306000,0.0000
215.158.238.23,<->,197.125.117.164,1,1469,0,0,1,1469,0.294732000,0.0000
249.101.117.55,<->,127.230.111.246,1,904,0,0,1,904,0.294683000,0.0000
215.158.239.181,<->,113.207.62.162,1,94,0,0,1,94,0.294664000,0.0000
221.102.143.189,<->,192.66.169.73,0,0,1,141,1,141,0.294599000,0.0000
113.173.255.196,<->,92.162.253.115,0,0,1,419,1,419,0.294501000,0.0000
144.85.170.254,<->,91.69.181.255,1,749,0,0,1,749,0.294467000,0.0000
215.158.239.79,<->,207.16.222.29,1,157,0,0,1,157,0.294286000,0.0000
194.237.14.36,<->,136.25.188.238,0,0,1,141,1,141,0.294230000,0.0000
197.81.83.18,<->,8.182.235.164,0,0,1,577,1,577,0.294123000,0.0000
235.253.220.227,<->,133.178.227.16,0,0,1,1373,1,1373,0.294045000,0.0000
231.142.194.212,<->,136.25.188.220,0,0,1,765,1,765,0.293821000,0.0000
215.158.239.49,<->,195.49.84.18,1,101,0,0,1,101,0.293728000,0.0000
92.162.253.36,<->,27.199.161.199,1,988,0,0,1,988,0.292721000,0.0000
201.139.255.220,<->,8.252.221.198,0,0,1,616,1,616,0.292720000,0.0000
215.158.238.98,<->,29.213.219.69,1,1101,0,0,1,1101,0.292653000,0.0000
8.252.223.143,<->,8.222.6.193,1,1149,0,0,1,1149,0.292631000,0.0000
159.23.226.94,<->,79.29.239.45,1,76,0,0,1,76,0.292517000,0.0000
97.126.4.255,<->,27.10.94.65,1,62,0,0,1,62,0.292329000,0.0000
220.28.108.254,<->,215.158.239.65,0,0,1,1084,1,1084,0.292047000,0.0000
252.138.212.250,<->,136.25.188.178,0,0,1,914,1,914,0.291445000,0.0000
133.178.227.12,<->,69.246.42.12,1,1283,0,0,1,1283,0.291390000,0.0000
200.174.207.72,<->,53.167.40.217,1,592,0,0,1,592,0.291364000,0.0000
215.158.239.244,<->,112.235.95.53,1,147,0,0,1,147,0.291359000,0.0000
87.13.216.134,<->,8.220.191.154,0,0,1,788,1,788,0.291260000,0.0000
195.13.254.86,<->,136.25.188.53,0,0,1,608,1,608,0.291247000,0.0000
215.158.238.107,<->,146.248.115.222,1,1181,0,0,1,1181,0.291245000,0.0000
212.70.217.68,<->,136.25.188.241,0,0,1,1229,1,1229,0.291187000,0.0000
50.224.80.64,<->,50.118.185.242,1,366,0,0,1,366,0.290914000,0.0000
197.152.202.235,<->,0.195.210.46,0,0,1,1281,1,1281,0.290647000,0.0000
50.224.76.235,<->,17.12.130.178,1,244,0,0,1,244,0.290575000,0.0000
200.175.152.2,<->,53.213.42.33,1,113,0,0,1,113,0.290127000,0.0000
92.27.219.33,<->,4.240.67.99,1,278,0,0,1,278,0.289887000,0.0000
215.158.239.96,<->,199.20.4.0,1,541,0,0,1,541,0.289624000,0.0000
148.56.229.121,<->,136.25.189.81,0,0,1,1197,1,1197,0.289304000,0.0000
136.25.188.240,<->,8.255.92.246,1,93,0,0,1,93,0.289228000,0.0000
197.113.98.49,<->,136.25.188.178,0,0,1,1056,1,1056,0.289216000,0.0000
199.18.9.104,<->,136.25.188.211,0,0,1,1325,1,1325,0.288906000,0.0000
199.51.199.220,<->,136.25.188.253,0,0,1,302,1,302,0.288667000,0.0000
89.216.125.163,<->,53.224.84.147,1,75,0,0,1,75,0.288516000,0.0000
215.158.238.33,<->,192.204.170.197,1,1357,0,0,1,1357,0.288444000,0.0000
215.158.238.132,<->,120.154.177.214,1,1261,0,0,1,1261,0.288426000,0.0000
142.191.85.69,<->,136.25.188.222,0,0,1,701,1,701,0.288070000,0.0000
111.147.102.130,<->,92.27.195.51,1,152,0,0,1,152,0.287932000,0.0000
243.117.82.135,<->,144.86.144.224,0,0,1,952,1,952,0.287308000,0.0000
141.23.229.64,<->,136.25.189.57,0,0,1,1293,1,1293,0.286168000,0.0000
136.181.48.230,<->,53.230.100.50,1,1389,0,0,1,1389,0.285964000,0.0000
215.158.140.185,<->,56.51.205.138,1,1205,0,0,1,1205,0.285926000,0.0000
215.158.239.28,<->,125.84.52.247,1,67,0,0,1,67,0.285248000,0.0000
220.40.166.219,<->,215.158.238.83,0,0,1,1309,1,1309,0.285005000,0.0000
192.70.16.212,<->,50.224.80.67,0,0,1,753,1,753,0.284878000,0.0000
246.253.253.96,<->,147.11.11.175,1,757,0,0,1,757,0.284833000,0.0000
215.158.61.195,<->,136.25.189.214,0,0,1,717,1,717,0.284718000,0.0000
215.158.238.142,<->,112.220.206.117,1,1133,0,0,1,1133,0.284347000,0.0000
210.158.44.46,<->,145.255.183.195,1,142,0,0,1,142,0.284195000,0.0000
215.158.42.95,<->,133.178.226.223,0,0,1,93,1,93,0.283985000,0.0000
207.60.155.192,<->,136.25.188.253,0,0,1,765,1,765,0.283888000,0.0000
197.161.237.128,<->,136.25.188.236,0,0,1,612,1,612,0.283887000,0.0000
136.25.188.242,<->,104.3.168.202,1,1261,0,0,1,1261,0.283542000,0.0000
117.20.48.130,<->,50.224.76.235,0,0,1,539,1,539,0.283355000,0.0000
136.25.188.237,<->,69.31.238.54,1,1325,0,0,1,1325,0.282790000,0.0000
122.239.148.163,<->,80.40.51.140,0,0,1,50,1,50,0.282641000,0.0000
197.103.151.87,<->,136.25.188.44,0,0,1,181,1,181,0.282619000,0.0000
196.205.203.197,<->,136.25.188.243,0,0,1,172,1,172,0.281981000,0.0000
133.178.227.19,<->,125.216.43.40,1,1045,0,0,1,1045,0.281595000,0.0000
101.123.193.252,<->,8.55.195.24,1,191,0,0,1,191,0.281538000,0.0000
143.155.227.33,<->,133.178.226.90,0,0,1,93,1,93,0.281325000,0.0000
215.158.61.189,<->,8.176.8.105,0,0,1,1133,1,1133,0.280894000,0.0000
203.117.167.190,<->,0.195.210.42,0,0,1,720,1,720,0.280729000,0.0000
136.25.188.211,<->,76.100.108.240,1,1277,0,0,1,1277,0.280412000,0.0000
215.158.239.7,<->,29.212.196.39,1,1484,0,0,1,1484,0.280395000,0.0000
215.158.238.122,<->,29.214.73.166,1,1165,0,0,1,1165,0.280392000,0.0000
136.25.189.42,<->,96.156.169.238,1,384,0,0,1,384,0.280258000,0.0000
220.20.200.65,<->,149.19.161.234,1,339,0,0,1,339,0.280052000,0.0000
220.28.114.28,<->,215.158.238.85,0,0,1,1155,1,1155,0.279849000,0.0000
143.155.227.33,<->,136.25.188.220,0,0,1,93,1,93,0.279543000,0.0000
199.32.116.94,<->,136.25.188.226,0,0,1,93,1,93,0.279367000,0.0000
199.69.255.191,<->,136.25.188.253,0,0,1,749,1,749,0.279020000,0.0000
143.45.0.139,<->,133.178.226.31,0,0,1,1229,1,1229,0.278941000,0.0000
213.38.244.185,<->,8.45.175.127,1,75,0,0,1,75,0.278776000,0.0000
252.189.162.82,<->,8.182.243.69,0,0,1,95,1,95,0.278642000,0.0000
101.70.107.210,<->,53.214.239.188,1,113,0,0,1,113,0.278536000,0.0000
136.25.188.220,<->,69.150.168.218,1,1357,0,0,1,1357,0.278513000,0.0000
128.156.85.188,<->,8.176.8.194,0,0,1,100,1,100,0.278394000,0.0000
215.158.239.95,<->,199.20.28.234,1,93,0,0,1,93,0.278251000,0.0000
215.158.238.83,<->,111.150.34.246,1,1309,0,0,1,1309,0.277509000,0.0000
136.25.188.240,<->,29.211.186.213,1,1213,0,0,1,1213,0.277504000,0.0000
143.20.20.122,<->,50.224.76.234,0,0,1,244,1,244,0.277241000,0.0000
215.158.238.74,<->,113.23.21.231,1,1165,0,0,1,1165,0.277138000,0.0000
215.158.238.66,<->,143.155.227.33,1,93,0,0,1,93,0.277057000,0.0000
119.45.10.74,<->,92.162.253.96,0,0,1,214,1,214,0.276829000,0.0000
246.253.134.208,<->,30.199.160.255,1,240,0,0,1,240,0.276588000,0.0000
149.207.3.10,<->,50.224.89.243,0,0,1,254,1,254,0.276550000,0.0000
195.70.196.238,<->,136.25.188.163,0,0,1,765,1,765,0.276465000,0.0000
215.158.239.19,<->,8.222.7.162,1,1213,0,0,1,1213,0.276283000,0.0000
129.236.114.39,<->,33.233.141.39,0,0,1,600,1,600,0.276153000,0.0000
215.158.239.94,<->,148.129.19.193,1,1485,0,0,1,1485,0.275865000,0.0000
111.151.106.219,<->,99.74.27.56,0,0,1,100,1,100,0.275731000,0.0000
133.178.227.18,<->,8.219.187.244,1,1425,0,0,1,1425,0.275408000,0.0000
109.222.223.113,<->,53.234.201.87,1,629,0,0,1,629,0.275366000,0.0000
207.63.175.159,<->,136.25.188.174,0,0,1,1444,1,1444,0.275311000,0.0000
196.245.75.18,<->,136.25.188.208,0,0,1,1086,1,1086,0.274981000,0.0000
136.25.188.220,<->,124.72.95.5,1,1245,0,0,1,1245,0.274943000,0.0000
149.118.151.184,<->,136.25.188.224,0,0,1,1197,1,1197,0.274751000,0.0000
94.192.127.152,<->,8.252.221.236,0,0,1,444,1,444,0.274691000,0.0000
215.158.238.105,<->,126.207.73.76,1,1309,0,0,1,1309,0.274113000,0.0000
215.158.239.48,<->,199.20.29.35,1,765,0,0,1,765,0.274006000,0.0000
215.158.239.49,<->,199.20.30.48,1,234,0,0,1,234,0.273939000,0.0000
215.158.238.104,<->,192.227.190.231,1,245,0,0,1,245,0.273839000,0.0000
215.158.239.77,<->,207.88.93.21,1,1357,0,0,1,1357,0.273555000,0.0000
159.223.99.55,<->,8.43.182.255,0,0,1,673,1,673,0.273130000,0.0000
197.159.127.97,<->,136.25.188.220,0,0,1,87,1,87,0.272954000,0.0000
215.158.239.57,<->,96.135.155.31,1,1213,0,0,1,1213,0.272939000,0.0000
133.54.43.82,<->,117.13.88.12,1,629,0,0,1,629,0.272852000,0.0000
136.25.189.15,<->,133.146.0.147,1,1229,0,0,1,1229,0.272427000,0.0000
215.158.238.134,<->,126.219.60.223,1,1181,0,0,1,1181,0.272392000,0.0000
90.240.135.74,<->,53.200.51.184,1,285,0,0,1,285,0.272350000,0.0000
136.25.189.94,<->,96.156.169.251,1,965,0,0,1,965,0.271841000,0.0000
133.178.227.252,<->,100.50.96.80,1,893,0,0,1,893,0.271736000,0.0000
195.4.59.185,<->,136.25.188.253,0,0,1,93,1,93,0.271221000,0.0000
195.71.159.111,<->,136.25.188.209,0,0,1,500,1,500,0.271170000,0.0000
133.178.226.7,<->,112.220.206.116,1,1277,0,0,1,1277,0.270682000,0.0000
124.152.145.65,<->,80.42.182.80,0,0,1,737,1,737,0.270651000,0.0000
149.161.10.42,<->,50.224.76.248,0,0,1,1078,1,1078,0.270562000,0.0000
50.224.76.235,<->,27.153.116.94,1,733,0,0,1,733,0.270508000,0.0000
215.158.239.97,<->,199.51.155.93,1,89,0,0,1,89,0.270347000,0.0000
215.158.239.79,<->,196.0.112.179,1,97,0,0,1,97,0.270316000,0.0000
199.68.225.45,<->,136.25.188.198,0,0,1,101,1,101,0.270050000,0.0000
136.25.188.254,<->,6.116.31.21,1,1229,0,0,1,1229,0.269701000,0.0000
136.25.189.11,<->,96.156.169.205,1,685,0,0,1,685,0.269660000,0.0000
69.243.104.90,<->,8.252.221.198,0,0,1,315,1,315,0.269300000,0.0000
215.158.239.76,<->,142.241.37.119,1,759,0,0,1,759,0.269250000,0.0000
215.158.238.94,<->,29.214.71.108,1,1277,0,0,1,1277,0.269200000,0.0000
215.158.239.182,<->,100.224.132.151,1,204,0,0,1,204,0.269170000,0.0000
136.25.189.15,<->,96.156.169.213,1,1341,0,0,1,1341,0.269155000,0.0000
215.158.238.148,<->,111.150.186.207,1,1181,0,0,1,1181,0.269115000,0.0000
197.107.92.124,<->,136.25.188.55,0,0,1,146,1,146,0.268404000,0.0000
144.148.84.204,<->,80.42.188.249,0,0,1,83,1,83,0.267998000,0.0000
215.158.239.33,<->,33.209.213.0,1,115,0,0,1,115,0.267956000,0.0000
215.158.238.66,<->,205.227.96.23,1,1213,0,0,1,1213,0.267721000,0.0000
92.27.219.208,<->,35.33.19.191,1,78,0,0,1,78,0.266231000,0.0000
215.158.239.71,<->,207.188.86.6,1,93,0,0,1,93,0.266163000,0.0000
117.252.133.1,<->,50.224.76.234,0,0,1,1039,1,1039,0.266096000,0.0000
215.158.239.76,<->,196.91.143.41,1,334,0,0,1,334,0.266010000,0.0000
215.158.238.95,<->,8.189.240.232,1,1149,0,0,1,1149,0.265975000,0.0000
145.10.193.189,<->,50.224.76.234,0,0,1,994,1,994,0.265900000,0.0000
215.158.140.75,<->,114.94.161.226,1,1060,0,0,1,1060,0.265716000,0.0000
141.24.62.189,<->,39.43.133.101,0,0,1,449,1,449,0.264978000,0.0000
143.245.251.3,<->,8.20.87.195,0,0,1,482,1,482,0.264734000,0.0000
109.1.16.46,<->,53.69.90.226,1,125,0,0,1,125,0.264730000,0.0000
198.157.156.29,<->,139.163.5.140,0,0,1,387,1,387,0.264634000,0.0000
136.25.188.237,<->,8.222.96.7,1,1213,0,0,1,1213,0.264367000,0.0000
8.252.222.224,<->,4.123.76.148,1,286,0,0,1,286,0.264358000,0.0000
80.27.153.103,<->,4.129.110.82,1,125,0,0,1,125,0.264348000,0.0000
143.128.121.231,<->,136.25.188.252,0,0,1,170,1,170,0.263810000,0.0000
142.248.52.241,<->,136.25.188.237,0,0,1,602,1,602,0.263744000,0.0000
156.165.33.1,<->,133.178.227.14,0,0,1,1051,1,1051,0.263501000,0.0000
114.56.80.51,<->,8.52.139.192,0,0,1,539,1,539,0.263342000,0.0000
126.149.134.158,<->,50.224.76.235,0,0,1,1046,1,1046,0.263114000,0.0000
215.158.238.236,<->,139.163.163.208,1,1389,0,0,1,1389,0.262945000,0.0000
220.20.200.178,<->,144.83.60.153,1,1102,0,0,1,1102,0.262885000,0.0000
215.158.239.50,<->,57.227.83.212,1,1309,0,0,1,1309,0.262819000,0.0000
215.158.239.77,<->,143.68.145.136,1,765,0,0,1,765,0.262739000,0.0000
199.54.17.239,<->,8.182.224.87,0,0,1,925,1,925,0.262339000,0.0000
111.147.71.150,<->,53.245.79.95,1,125,0,0,1,125,0.260583000,0.0000
149.184.89.86,<->,136.25.189.80,0,0,1,1357,1,1357,0.260455000,0.0000
215.158.239.49,<->,148.26.113.21,1,1389,0,0,1,1389,0.260171000,0.0000
215.158.238.198,<->,192.226.161.87,1,1088,0,0,1,1088,0.260110000,0.0000
88.1.225.184,<->,8.176.8.48,0,0,1,1397,1,1397,0.259815000,0.0000
215.158.238.73,<->,112.220.206.116,1,1277,0,0,1,1277,0.259588000,0.0000
215.158.239.32,<->,6.29.97.54,1,1168,0,0,1,1168,0.259531000,0.0000
99.72.141.223,<->,33.250.15.79,1,561,0,0,1,561,0.259460000,0.0000
215.158.140.167,<->,131.36.66.75,1,1093,0,0,1,1093,0.259457000,0.0000
215.158.239.50,<->,196.91.187.31,1,797,0,0,1,797,0.259309000,0.0000
192.64.234.182,<->,115.151.14.15,1,1020,0,0,1,1020,0.258738000,0.0000
142.204.32.86,<->,136.25.188.223,0,0,1,1293,1,1293,0.258645000,0.0000
195.41.107.235,<->,136.25.188.198,0,0,1,170,1,170,0.258626000,0.0000
215.158.238.201,<->,53.231.140.175,1,97,0,0,1,97,0.258604000,0.0000
227.29.202.222,<->,92.27.27.178,0,0,1,158,1,158,0.258531000,0.0000
100.124.212.156,<->,80.41.38.205,0,0,1,292,1,292,0.258442000,0.0000
60.101.171.11,<->,8.252.222.176,0,0,1,749,1,749,0.258261000,0.0000
239.66.58.12,<->,138.98.204.211,0,0,1,566,1,566,0.258165000,0.0000
221.102.103.73,<->,195.85.158.128,1,531,0,0,1,531,0.257677000,0.0000
215.158.239.85,<->,135.229.0.202,1,1165,0,0,1,1165,0.257385000,0.0000
215.158.239.95,<->,199.20.28.145,1,1091,0,0,1,1091,0.257291000,0.0000
216.103.78.156,<->,50.224.76.234,0,0,1,518,1,518,0.256978000,0.0000
204.187.97.205,<->,136.25.188.54,0,0,1,602,1,602,0.256873000,0.0000
204.61.43.101,<->,136.25.188.253,0,0,1,758,1,758,0.256809000,0.0000
133.178.227.70,<->,111.150.187.244,1,1293,0,0,1,1293,0.256787000,0.0000
235.253.218.218,<->,215.158.238.92,0,0,1,1261,1,1261,0.256733000,0.0000
117.6.225.235,<->,8.31.37.160,0,0,1,1197,1,1197,0.256441000,0.0000
111.199.225.127,<->,0.195.210.44,0,0,1,87,1,87,0.256432000,0.0000
221.102.143.189,<->,220.80.132.255,0,0,1,141,1,141,0.256227000,0.0000
111.20.171.168,<->,33.233.141.40,0,0,1,1203,1,1203,0.255809000,0.0000
215.158.140.92,<->,48.131.158.245,1,1113,0,0,1,1113,0.255751000,0.0000
133.164.32.53,<->,54.50.173.203,1,75,0,0,1,75,0.255284000,0.0000
119.209.96.190,<->,50.224.76.234,0,0,1,1420,1,1420,0.255079000,0.0000
142.229.85.25,<->,136.25.188.160,0,0,1,821,1,821,0.255031000,0.0000
215.158.239.87,<->,204.2.140.38,1,932,0,0,1,932,0.255024000,0.0000
205.127.108.115,<->,101.224.89.253,0,0,1,846,1,846,0.254962000,0.0000
215.158.239.56,<->,199.20.5.43,1,765,0,0,1,765,0.254892000,0.0000
215.158.239.56,<->,199.20.7.105,1,717,0,0,1,717,0.254764000,0.0000
98.156.229.198,<->,8.182.226.122,0,0,1,517,1,517,0.254733000,0.0000
133.178.227.204,<->,111.151.142.208,1,100,0,0,1,100,0.254633000,0.0000
80.27.153.100,<->,4.129.110.82,1,125,0,0,1,125,0.254453000,0.0000
230.240.128.168,<->,8.52.135.109,0,0,1,382,1,382,0.254059000,0.0000
215.158.238.32,<->,197.103.151.87,1,1229,0,0,1,1229,0.253981000,0.0000
136.25.188.47,<->,8.222.212.22,1,1213,0,0,1,1213,0.253602000,0.0000
215.158.239.85,<->,199.33.244.90,1,817,0,0,1,817,0.253361000,0.0000
231.143.131.80,<->,136.25.188.160,0,0,1,240,1,240,0.253028000,0.0000
139.163.68.55,<->,110.45.99.143,1,51,0,0,1,51,0.253004000,0.0000
215.158.238.105,<->,29.212.193.25,1,1357,0,0,1,1357,0.252971000,0.0000
143.23.168.28,<->,136.25.188.241,0,0,1,694,1,694,0.252867000,0.0000
144.85.170.208,<->,91.69.181.227,1,755,0,0,1,755,0.252801000,0.0000
133.54.16.199,<->,117.130.2.181,1,1125,0,0,1,1125,0.252731000,0.0000
159.137.162.213,<->,105.108.227.231,1,344,0,0,1,344,0.252575000,0.0000
215.158.239.56,<->,196.88.157.91,1,701,0,0,1,701,0.252125000,0.0000
80.42.141.64,<->,8.177.1.203,1,1233,0,0,1,1233,0.252104000,0.0000
199.122.160.203,<->,136.25.188.163,0,0,1,238,1,238,0.252091000,0.0000
215.158.239.70,<->,149.254.114.228,1,1405,0,0,1,1405,0.251930000,0.0000
199.38.167.77,<->,136.25.188.174,0,0,1,146,1,146,0.251762000,0.0000
136.25.189.0,<->,56.28.207.202,1,1309,0,0,1,1309,0.251718000,0.0000
215.158.239.57,<->,199.20.30.40,1,602,0,0,1,602,0.251363000,0.0000
136.25.189.33,<->,122.216.233.77,1,1373,0,0,1,1373,0.251355000,0.0000
215.158.238.32,<->,8.191.6.219,1,1197,0,0,1,1197,0.251300000,0.0000
92.27.219.159,<->,27.64.147.6,1,419,0,0,1,419,0.251066000,0.0000
143.155.227.33,<->,136.25.188.226,0,0,1,93,1,93,0.250936000,0.0000
139.249.95.234,<->,100.120.38.6,1,93,0,0,1,93,0.250780000,0.0000
141.125.248.132,<->,0.195.210.42,0,0,1,932,1,932,0.250548000,0.0000
220.20.206.14,<->,129.78.117.164,0,0,1,703,1,703,0.250127000,0.0000
142.207.210.114,<->,136.25.188.225,0,0,1,101,1,101,0.250035000,0.0000
98.128.47.45,<->,8.45.175.127,1,321,0,0,1,321,0.249639000,0.0000
133.178.226.29,<->,8.252.213.40,1,1181,0,0,1,1181,0.249613000,0.0000
133.178.227.57,<->,29.212.192.60,1,1308,0,0,1,1308,0.249597000,0.0000
207.63.96.43,<->,136.25.188.175,0,0,1,765,1,765,0.249540000,0.0000
215.158.239.84,<->,199.106.134.127,1,157,0,0,1,157,0.249195000,0.0000
215.158.239.86,<->,196.88.121.14,1,101,0,0,1,101,0.249167000,0.0000
133.178.226.247,<->,100.224.163.93,1,557,0,0,1,557,0.248760000,0.0000
215.158.239.87,<->,204.2.203.208,1,117,0,0,1,117,0.248723000,0.0000
111.151.106.235,<->,8.252.221.195,0,0,1,100,1,100,0.248532000,0.0000
220.28.73.211,<->,136.25.188.249,0,0,1,819,1,819,0.248410000,0.0000
136.25.188.242,<->,61.72.108.214,1,1213,0,0,1,1213,0.248022000,0.0000
193.46.99.189,<->,92.27.27.177,0,0,1,112,1,112,0.247765000,0.0000
133.178.226.43,<->,109.126.137.220,1,240,0,0,1,240,0.247463000,0.0000
215.158.238.32,<->,113.23.21.231,1,1085,0,0,1,1085,0.247373000,0.0000
136.25.189.43,<->,96.156.169.239,1,323,0,0,1,323,0.246350000,0.0000
202.33.127.224,<->,136.25.188.220,0,0,1,93,1,93,0.246191000,0.0000
112.208.20.199,<->,100.92.157.52,0,0,1,50,1,50,0.245493000,0.0000
126.198.147.25,<->,100.92.93.23,0,0,1,339,1,339,0.245158000,0.0000
200.174.219.227,<->,53.68.206.154,1,953,0,0,1,953,0.244834000,0.0000
215.158.238.32,<->,29.212.182.225,1,1069,0,0,1,1069,0.244800000,0.0000
133.178.227.14,<->,8.40.51.168,1,1053,0,0,1,1053,0.244791000,0.0000
210.229.230.18,<->,101.194.225.29,1,68,0,0,1,68,0.244786000,0.0000
215.158.239.76,<->,207.190.173.163,1,93,0,0,1,93,0.243841000,0.0000
199.71.208.67,<->,136.25.188.198,0,0,1,101,1,101,0.243819000,0.0000
215.158.239.58,<->,199.20.29.33,1,602,0,0,1,602,0.243781000,0.0000
246.254.97.229,<->,54.58.153.140,1,87,0,0,1,87,0.243659000,0.0000
215.158.239.84,<->,149.184.89.90,1,1421,0,0,1,1421,0.243573000,0.0000
200.174.219.221,<->,53.68.113.123,1,88,0,0,1,88,0.243242000,0.0000
215.158.239.87,<->,199.20.28.132,1,117,0,0,1,117,0.242916000,0.0000
143.155.227.57,<->,136.25.188.226,0,0,1,1101,1,1101,0.242576000,0.0000
215.158.239.205,<->,53.213.51.229,1,285,0,0,1,285,0.242563000,0.0000
215.158.239.4,<->,122.158.246.191,1,1472,0,0,1,1472,0.242348000,0.0000
136.25.188.47,<->,113.20.94.83,1,1213,0,0,1,1213,0.242323000,0.0000
80.40.80.132,<->,8.55.211.213,1,294,0,0,1,294,0.242204000,0.0000
74.141.177.167,<->,8.252.221.198,0,0,1,490,1,490,0.242179000,0.0000
215.158.239.94,<->,195.49.84.18,1,101,0,0,1,101,0.242026000,0.0000
215.158.61.145,<->,8.176.8.245,0,0,1,557,1,557,0.241971000,0.0000
142.236.66.64,<->,136.25.188.242,0,0,1,602,1,602,0.241831000,0.0000
249.101.200.44,<->,27.187.152.161,1,593,0,0,1,593,0.241726000,0.0000
210.209.251.211,<->,111.147.248.65,0,0,1,1315,1,1315,0.241602000,0.0000
215.158.238.244,<->,80.56.91.248,1,100,0,0,1,100,0.241338000,0.0000
142.254.141.3,<->,136.25.188.225,0,0,1,87,1,87,0.241201000,0.0000
136.25.188.222,<->,41.159.226.106,1,121,0,0,1,121,0.241089000,0.0000
215.158.239.95,<->,207.62.13.218,1,93,0,0,1,93,0.240284000,0.0000
136.25.189.0,<->,29.214.73.130,1,1373,0,0,1,1373,0.240120000,0.0000
133.244.30.133,<->,127.103.229.214,1,98,0,0,1,98,0.240110000,0.0000
215.158.238.196,<->,126.219.60.193,1,1213,0,0,1,1213,0.239616000,0.0000
215.158.238.94,<->,57.41.134.74,1,1197,0,0,1,1197,0.239541000,0.0000
215.158.238.223,<->,61.35.70.28,1,1405,0,0,1,1405,0.238663000,0.0000
6.145.149.122,<->,0.195.210.44,0,0,1,87,1,87,0.238508000,0.0000
215.158.238.106,<->,192.226.161.103,1,1405,0,0,1,1405,0.238410000,0.0000
133.178.226.30,<->,113.23.117.116,1,1165,0,0,1,1165,0.238372000,0.0000
215.158.238.21,<->,8.222.109.83,1,1469,0,0,1,1469,0.238261000,0.0000
199.69.184.152,<->,136.25.188.198,0,0,1,593,1,593,0.238059000,0.0000
136.25.188.208,<->,131.1.232.163,1,421,0,0,1,421,0.237943000,0.0000
136.25.188.47,<->,119.196.23.40,1,1229,0,0,1,1229,0.237701000,0.0000
215.158.239.95,<->,199.20.31.26,1,168,0,0,1,168,0.237489000,0.0000
142.248.117.198,<->,136.25.188.239,0,0,1,641,1,641,0.237154000,0.0000
215.158.238.92,<->,32.183.36.108,1,1293,0,0,1,1293,0.236638000,0.0000
111.151.142.208,<->,8.252.221.117,0,0,1,100,1,100,0.236587000,0.0000
215.158.239.33,<->,113.86.1.40,1,105,0,0,1,105,0.236359000,0.0000
215.158.238.73,<->,194.205.112.171,1,1373,0,0,1,1373,0.236298000,0.0000
243.117.83.12,<->,139.163.1.75,0,0,1,863,1,863,0.236113000,0.0000
220.40.166.213,<->,215.158.238.33,0,0,1,1325,1,1325,0.235856000,0.0000
213.186.52.49,<->,144.85.170.208,0,0,1,1075,1,1075,0.235835000,0.0000
136.25.188.53,<->,95.90.127.146,1,573,0,0,1,573,0.235802000,0.0000
207.87.58.96,<->,136.25.188.176,0,0,1,146,1,146,0.234709000,0.0000
215.158.239.49,<->,196.92.118.173,1,619,0,0,1,619,0.234609000,0.0000
215.158.239.68,<->,199.20.31.72,1,93,0,0,1,93,0.233966000,0.0000
215.158.239.48,<->,143.91.230.56,1,897,0,0,1,897,0.233506000,0.0000
215.158.238.98,<->,133.73.194.233,1,1197,0,0,1,1197,0.233448000,0.0000
136.25.189.9,<->,96.156.169.204,1,85,0,0,1,85,0.233360000,0.0000
215.158.239.69,<->,207.115.229.207,1,165,0,0,1,165,0.233345000,0.0000
207.84.253.83,<->,136.25.188.209,0,0,1,552,1,552,0.232738000,0.0000
136.25.188.209,<->,41.169.88.140,1,141,0,0,1,141,0.232735000,0.0000
215.158.238.95,<->,111.150.34.250,1,1213,0,0,1,1213,0.232569000,0.0000
239.66.110.113,<->,203.215.177.38,0,0,1,891,1,891,0.232480000,0.0000
247.136.171.196,<->,26.218.94.114,1,129,0,0,1,129,0.232393000,0.0000
142.221.98.201,<->,136.25.188.243,0,0,1,331,1,331,0.232363000,0.0000
215.158.140.187,<->,6.15.196.136,1,1162,0,0,1,1162,0.232336000,0.0000
143.155.227.33,<->,133.178.226.31,0,0,1,93,1,93,0.232059000,0.0000
136.25.189.4,<->,129.175.139.163,1,397,0,0,1,397,0.231826000,0.0000
215.158.238.9,<->,114.150.180.148,1,1249,0,0,1,1249,0.231481000,0.0000
66.12.221.199,<->,8.43.215.120,0,0,1,837,1,837,0.231404000,0.0000
195.124.206.22,<->,136.25.188.163,0,0,1,117,1,117,0.231400000,0.0000
99.115.52.80,<->,8.220.179.94,0,0,1,286,1,286,0.231232000,0.0000
133.244.31.120,<->,80.27.154.175,1,205,0,0,1,205,0.231182000,0.0000
204.56.0.132,<->,136.25.188.209,0,0,1,101,1,101,0.230790000,0.0000
215.158.140.234,<->,131.141.219.100,1,266,0,0,1,266,0.230683000,0.0000
133.178.226.30,<->,8.252.214.62,1,1277,0,0,1,1277,0.230526000,0.0000
93.95.33.176,<->,50.224.76.234,0,0,1,568,1,568,0.230464000,0.0000
207.87.58.96,<->,136.25.188.254,0,0,1,146,1,146,0.230285000,0.0000
142.253.143.16,<->,136.25.188.197,0,0,1,690,1,690,0.229752000,0.0000
215.158.238.73,<->,8.219.184.150,1,1245,0,0,1,1245,0.229430000,0.0000
207.188.103.167,<->,136.25.188.252,0,0,1,589,1,589,0.229339000,0.0000
144.87.238.89,<->,8.182.230.205,0,0,1,679,1,679,0.229293000,0.0000
215.158.61.145,<->,8.176.8.104,0,0,1,398,1,398,0.228995000,0.0000
133.178.227.24,<->,8.240.116.185,1,1101,0,0,1,1101,0.228927000,0.0000
202.33.14.128,<->,136.25.188.54,0,0,1,101,1,101,0.228900000,0.0000
139.163.26.146,<->,117.59.189.183,1,145,0,0,1,145,0.228796000,0.0000
133.54.43.75,<->,106.219.64.22,1,384,0,0,1,384,0.228705000,0.0000
142.229.223.78,<->,136.25.188.44,0,0,1,101,1,101,0.228586000,0.0000
207.115.7.231,<->,92.27.194.147,0,0,1,249,1,249,0.228504000,0.0000
112.208.20.81,<->,100.92.157.52,0,0,1,50,1,50,0.228251000,0.0000
195.41.107.235,<->,136.25.188.243,0,0,1,170,1,170,0.228083000,0.0000
221.102.56.69,<->,109.3.172.183,0,0,1,294,1,294,0.227955000,0.0000
92.168.217.252,<->,50.136.138.82,1,547,0,0,1,547,0.227867000,0.0000
148.23.229.9,<->,133.178.226.19,0,0,1,1261,1,1261,0.227663000,0.0000
215.158.238.72,<->,42.226.3.107,1,1309,0,0,1,1309,0.227649000,0.0000
80.27.156.197,<->,74.87.133.34,1,174,0,0,1,174,0.227227000,0.0000
215.158.239.56,<->,199.20.31.143,1,101,0,0,1,101,0.227163000,0.0000
215.158.239.58,<->,204.226.121.155,1,93,0,0,1,93,0.226964000,0.0000
142.223.129.33,<->,136.25.188.241,0,0,1,275,1,275,0.226895000,0.0000
215.158.239.95,<->,207.190.102.92,1,101,0,0,1,101,0.226874000,0.0000
215.158.239.198,<->,145.234.121.95,1,646,0,0,1,646,0.226840000,0.0000
195.64.5.202,<->,8.20.87.206,0,0,1,539,1,539,0.225968000,0.0000
215.158.239.113,<->,215.158.42.215,1,514,0,0,1,514,0.225392000,0.0000
133.178.227.2,<->,89.86.110.233,1,1088,0,0,1,1088,0.225383000,0.0000
201.136.184.218,<->,136.25.188.199,0,0,1,1373,1,1373,0.225175000,0.0000
247.136.233.125,<->,100.224.242.153,1,97,0,0,1,97,0.225119000,0.0000
215.158.239.94,<->,199.20.5.151,1,172,0,0,1,172,0.224712000,0.0000
136.25.189.45,<->,8.252.253.190,1,1181,0,0,1,1181,0.224537000,0.0000
221.102.114.234,<->,207.193.113.191,1,95,0,0,1,95,0.224343000,0.0000
215.158.238.81,<->,122.158.49.128,1,1357,0,0,1,1357,0.224192000,0.0000
215.158.238.106,<->,143.227.65.142,1,1181,0,0,1,1181,0.224186000,0.0000
220.6.92.146,<->,8.182.235.164,0,0,1,272,1,272,0.223980000,0.0000
159.137.243.209,<->,127.20.87.202,1,717,0,0,1,717,0.223557000,0.0000
76.179.50.153,<->,8.252.221.230,0,0,1,454,1,454,0.222742000,0.0000
215.158.239.51,<->,199.20.6.158,1,701,0,0,1,701,0.222588000,0.0000
89.183.111.155,<->,8.163.116.117,1,388,0,0,1,388,0.222160000,0.0000
136.25.189.33,<->,29.211.5.121,1,1261,0,0,1,1261,0.222102000,0.0000
224.250.64.84,<->,100.95.182.74,0,0,1,68,1,68,0.221969000,0.0000
247.136.184.130,<->,210.209.251.211,1,442,0,0,1,442,0.221712000,0.0000
158.215.83.215,<->,133.54.22.11,0,0,1,565,1,565,0.220894000,0.0000
210.229.230.20,<->,100.63.23.85,1,68,0,0,1,68,0.220402000,0.0000
215.158.238.123,<->,29.212.182.225,1,1213,0,0,1,1213,0.220393000,0.0000
215.158.239.71,<->,199.66.137.180,1,1293,0,0,1,1293,0.220221000,0.0000
133.8.10.152,<->,111.20.168.141,0,0,1,1130,1,1130,0.219712000,0.0000
215.158.238.80,<->,143.155.227.54,1,1197,0,0,1,1197,0.219466000,0.0000
220.243.198.21,<->,8.252.222.85,0,0,1,608,1,608,0.219435000,0.0000
215.158.238.81,<->,192.227.190.244,1,277,0,0,1,277,0.219378000,0.0000
112.208.20.81,<->,102.50.183.146,0,0,1,50,1,50,0.219338000,0.0000
133.178.226.215,<->,131.31.253.219,1,145,0,0,1,145,0.219202000,0.0000
215.158.238.135,<->,38.104.11.3,1,1325,0,0,1,1325,0.219201000,0.0000
215.158.239.68,<->,195.55.52.123,1,89,0,0,1,89,0.219096000,0.0000
215.158.140.83,<->,126.219.100.251,1,1196,0,0,1,1196,0.218846000,0.0000
92.27.219.163,<->,6.118.108.124,1,288,0,0,1,288,0.218259000,0.0000
144.64.138.107,<->,129.254.101.205,1,187,0,0,1,187,0.218111000,0.0000
247.203.163.230,<->,50.224.76.230,0,0,1,735,1,735,0.218015000,0.0000
149.96.170.163,<->,136.25.188.52,0,0,1,1229,1,1229,0.217354000,0.0000
50.224.76.235,<->,29.220.119.83,1,640,0,0,1,640,0.217176000,0.0000
215.158.238.236,<->,93.39.51.107,1,1135,0,0,1,1135,0.216751000,0.0000
149.163.129.230,<->,136.25.189.77,0,0,1,1126,1,1126,0.216075000,0.0000
215.158.239.56,<->,199.20.30.229,1,93,0,0,1,93,0.215801000,0.0000
194.233.63.160,<->,136.25.188.53,0,0,1,657,1,657,0.215728000,0.0000
139.163.1.138,<->,116.229.128.136,1,242,0,0,1,242,0.215697000,0.0000
136.25.188.209,<->,112.220.206.107,1,1085,0,0,1,1085,0.215678000,0.0000
215.158.238.114,<->,205.37.248.14,1,1245,0,0,1,1245,0.214475000,0.0000
139.193.141.139,<->,124.55.74.224,1,345,0,0,1,345,0.214441000,0.0000
97.168.88.160,<->,54.36.97.247,1,75,0,0,1,75,0.214158000,0.0000
142.244.204.227,<->,136.25.188.242,0,0,1,303,1,303,0.214136000,0.0000
195.70.149.228,<->,136.25.188.178,0,0,1,101,1,101,0.213978000,0.0000
199.72.31.82,<->,136.25.188.239,0,0,1,101,1,101,0.213766000,0.0000
142.191.151.66,<->,136.25.188.241,0,0,1,1092,1,1092,0.213689000,0.0000
120.158.42.249,<->,111.147.104.245,0,0,1,50,1,50,0.213613000,0.0000
215.158.239.92,<->,199.106.140.78,1,93,0,0,1,93,0.213553000,0.0000
233.97.214.110,<->,129.6.83.11,0,0,1,1165,1,1165,0.213285000,0.0000
215.158.127.244,<->,133.178.227.27,0,0,1,1105,1,1105,0.213044000,0.0000
141.118.203.107,<->,8.252.221.205,0,0,1,535,1,535,0.212801000,0.0000
220.28.85.14,<->,136.25.188.250,0,0,1,126,1,126,0.212317000,0.0000
204.123.249.197,<->,8.182.248.147,0,0,1,129,1,129,0.212181000,0.0000
133.178.227.14,<->,38.20.151.75,1,1098,0,0,1,1098,0.212172000,0.0000
199.122.3.251,<->,136.25.188.175,0,0,1,309,1,309,0.211979000,0.0000
215.158.238.99,<->,118.20.87.65,1,1277,0,0,1,1277,0.211646000,0.0000
194.253.92.242,<->,8.252.222.197,0,0,1,765,1,765,0.211500000,0.0000
195.40.217.107,<->,136.25.188.208,0,0,1,604,1,604,0.211383000,0.0000
80.41.9.195,<->,8.49.69.216,1,129,0,0,1,129,0.211342000,0.0000
109.95.80.134,<->,50.224.89.239,0,0,1,91,1,91,0.210222000,0.0000
195.43.114.8,<->,136.25.188.55,0,0,1,1087,1,1087,0.209951000,0.0000
142.229.9.248,<->,136.25.188.238,0,0,1,1277,1,1277,0.209944000,0.0000
213.221.90.156,<->,50.224.76.234,0,0,1,750,1,750,0.209748000,0.0000
136.25.188.53,<->,122.158.245.144,1,1197,0,0,1,1197,0.209577000,0.0000
235.42.34.20,<->,215.158.238.104,0,0,1,93,1,93,0.209395000,0.0000
215.158.239.33,<->,8.255.92.138,1,1034,0,0,1,1034,0.209345000,0.0000
129.225.132.224,<->,129.225.131.156,1,665,0,0,1,665,0.209286000,0.0000
215.158.239.6,<->,8.241.236.218,1,136,0,0,1,136,0.209104000,0.0000
139.193.141.143,<->,132.30.97.203,1,1112,0,0,1,1112,0.208956000,0.0000
111.150.187.126,<->,8.252.223.146,0,0,1,1133,1,1133,0.208941000,0.0000
143.128.155.113,<->,136.25.188.54,0,0,1,101,1,101,0.208609000,0.0000
133.178.227.14,<->,131.144.114.251,1,1069,0,0,1,1069,0.208566000,0.0000
139.33.175.144,<->,111.146.238.44,0,0,1,329,1,329,0.208395000,0.0000
142.223.114.231,<->,136.25.188.253,0,0,1,95,1,95,0.208322000,0.0000
220.20.200.56,<->,119.159.22.233,1,384,0,0,1,384,0.208143000,0.0000
111.147.118.136,<->,53.214.110.173,1,1245,0,0,1,1245,0.208135000,0.0000
17.198.244.92,<->,8.220.206.230,0,0,1,263,1,263,0.208030000,0.0000
215.158.239.49,<->,199.122.128.102,1,178,0,0,1,178,0.207985000,0.0000
136.25.188.44,<->,8.179.43.82,1,1389,0,0,1,1389,0.207477000,0.0000
57.133.55.41,<->,50.224.76.248,0,0,1,1281,1,1281,0.207288000,0.0000
119.207.123.153,<->,109.1.24.236,0,0,1,97,1,97,0.207116000,0.0000
215.158.239.35,<->,91.57.162.254,1,140,0,0,1,140,0.206988000,0.0000
215.158.238.123,<->,143.227.65.227,1,1501,0,0,1,1501,0.206890000,0.0000
215.158.239.92,<->,142.249.139.146,1,316,0,0,1,316,0.206701000,0.0000
53.244.237.146,<->,48.53.33.94,0,0,1,286,1,286,0.206612000,0.0000
143.68.164.76,<->,136.25.188.241,0,0,1,701,1,701,0.206377000,0.0000
220.80.238.163,<->,8.45.172.190,1,294,0,0,1,294,0.206351000,0.0000
215.158.238.83,<->,112.220.206.107,1,1293,0,0,1,1293,0.205824000,0.0000
50.224.76.235,<->,38.30.94.85,1,1500,0,0,1,1500,0.205690000,0.0000
204.58.99.194,<->,136.25.188.55,0,0,1,302,1,302,0.205610000,0.0000
215.158.238.198,<->,69.150.169.254,1,1086,0,0,1,1086,0.205422000,0.0000
215.158.61.189,<->,8.176.8.95,0,0,1,399,1,399,0.205139000,0.0000
120.159.169.25,<->,50.224.76.230,0,0,1,525,1,525,0.205044000,0.0000
142.239.45.22,<->,8.182.227.180,0,0,1,449,1,449,0.204935000,0.0000
136.25.188.237,<->,112.220.206.107,1,1309,0,0,1,1309,0.204800000,0.0000
210.220.219.150,<->,53.231.195.207,1,715,0,0,1,715,0.204433000,0.0000
199.71.209.205,<->,136.25.188.220,0,0,1,830,1,830,0.204290000,0.0000
139.163.26.146,<->,93.216.208.210,1,99,0,0,1,99,0.204155000,0.0000
133.178.226.19,<->,8.241.236.64,1,1053,0,0,1,1053,0.203963000,0.0000
99.175.215.250,<->,92.27.27.157,0,0,1,85,1,85,0.203306000,0.0000
195.6.143.23,<->,136.25.188.177,0,0,1,95,1,95,0.203289000,0.0000
206.195.206.101,<->,129.92.113.35,0,0,1,180,1,180,0.203018000,0.0000
215.158.239.101,<->,129.222.39.218,1,940,0,0,1,940,0.202681000,0.0000
108.39.84.149,<->,50.224.89.241,0,0,1,157,1,157,0.202602000,0.0000
136.25.188.242,<->,122.159.68.137,1,1069,0,0,1,1069,0.202418000,0.0000
136.25.188.236,<->,30.73.95.215,1,93,0,0,1,93,0.202379000,0.0000
220.38.238.124,<->,133.178.227.27,0,0,1,1154,1,1154,0.202047000,0.0000
204.63.114.169,<->,136.25.188.222,0,0,1,781,1,781,0.201705000,0.0000
143.22.101.172,<->,8.182.241.177,0,0,1,449,1,449,0.201516000,0.0000
131.45.239.182,<->,92.162.253.133,0,0,1,439,1,439,0.201489000,0.0000
195.4.148.171,<->,136.25.188.199,0,0,1,101,1,101,0.201150000,0.0000
215.158.238.238,<->,131.36.105.63,1,1223,0,0,1,1223,0.201047000,0.0000
215.158.238.107,<->,113.23.66.104,1,1149,0,0,1,1149,0.200999000,0.0000
248.239.173.39,<->,221.102.143.189,1,141,0,0,1,141,0.200839000,0.0000
215.158.239.94,<->,143.53.141.154,1,151,0,0,1,151,0.200661000,0.0000
204.185.111.248,<->,136.25.188.253,0,0,1,1096,1,1096,0.200652000,0.0000
159.137.162.213,<->,6.212.69.136,1,344,0,0,1,344,0.200411000,0.0000
215.158.61.242,<->,136.25.189.222,0,0,1,733,1,733,0.200095000,0.0000
143.134.48.175,<->,136.25.188.242,0,0,1,182,1,182,0.199897000,0.0000
136.25.189.94,<->,96.156.169.238,1,1436,0,0,1,1436,0.199611000,0.0000
192.226.161.66,<->,133.178.227.70,0,0,1,1405,1,1405,0.199538000,0.0000
215.158.239.48,<->,195.49.29.14,1,781,0,0,1,781,0.199498000,0.0000
204.200.45.252,<->,136.25.188.209,0,0,1,886,1,886,0.199457000,0.0000
155.132.50.123,<->,139.163.96.127,0,0,1,50,1,50,0.199446000,0.0000
133.178.227.242,<->,96.155.60.130,1,909,0,0,1,909,0.199100000,0.0000
139.163.26.146,<->,118.116.102.66,1,111,0,0,1,111,0.199038000,0.0000
98.158.87.56,<->,8.182.250.109,0,0,1,545,1,545,0.198604000,0.0000
136.25.189.221,<->,8.222.214.24,1,1112,0,0,1,1112,0.198400000,0.0000
207.3.215.218,<->,50.223.3.228,0,0,1,228,1,228,0.198287000,0.0000
207.87.58.96,<->,136.25.188.163,0,0,1,146,1,146,0.197757000,0.0000
215.158.239.95,<->,199.20.28.15,1,1101,0,0,1,1101,0.197695000,0.0000
104.245.45.167,<->,50.224.76.230,0,0,1,1365,1,1365,0.197603000,0.0000
136.25.188.197,<->,104.3.161.55,1,1213,0,0,1,1213,0.197457000,0.0000
215.158.140.7,<->,91.57.169.16,1,93,0,0,1,93,0.197398000,0.0000
143.132.83.17,<->,136.25.188.242,0,0,1,733,1,733,0.197200000,0.0000
146.10.166.93,<->,136.25.189.83,0,0,1,917,1,917,0.196718000,0.0000
210.229.230.18,<->,46.43.202.67,1,68,0,0,1,68,0.196661000,0.0000
215.158.239.94,<->,199.20.29.83,1,157,0,0,1,157,0.196514000,0.0000
192.64.225.61,<->,122.239.148.149,1,68,0,0,1,68,0.196463000,0.0000
215.158.239.57,<->,199.20.31.175,1,141,0,0,1,141,0.196380000,0.0000
138.68.166.197,<->,8.252.221.249,0,0,1,329,1,329,0.196163000,0.0000
215.158.239.76,<->,199.71.175.124,1,765,0,0,1,765,0.195790000,0.0000
200.175.139.115,<->,54.37.5.99,1,87,0,0,1,87,0.195763000,0.0000
139.47.253.215,<->,111.147.243.205,0,0,1,528,1,528,0.195333000,0.0000
144.83.60.153,<->,92.162.253.127,0,0,1,627,1,627,0.195254000,0.0000
215.158.239.92,<->,195.55.59.183,1,629,0,0,1,629,0.195194000,0.0000
215.158.239.68,<->,195.7.109.234,1,109,0,0,1,109,0.194996000,0.0000
215.158.238.95,<->,140.138.86.214,1,1277,0,0,1,1277,0.194827000,0.0000
215.158.238.84,<->,145.116.209.4,1,506,0,0,1,506,0.194817000,0.0000
192.224.20.18,<->,136.25.188.252,0,0,1,1149,1,1149,0.194656000,0.0000
142.249.130.203,<->,136.25.188.255,0,0,1,669,1,669,0.194574000,0.0000
136.25.189.28,<->,135.228.221.198,1,181,0,0,1,181,0.194487000,0.0000
143.193.10.182,<->,8.183.25.25,0,0,1,289,1,289,0.194273000,0.0000
220.39.233.53,<->,215.158.238.209,0,0,1,1103,1,1103,0.194084000,0.0000
215.158.61.203,<->,8.176.8.240,0,0,1,1378,1,1378,0.194054000,0.0000
121.74.207.64,<->,92.162.253.217,0,0,1,1102,1,1102,0.193804000,0.0000
215.158.239.19,<->,126.219.102.191,1,1479,0,0,1,1479,0.193477000,0.0000
136.25.188.163,<->,35.104.42.45,1,101,0,0,1,101,0.193431000,0.0000
215.158.238.33,<->,140.174.80.136,1,1357,0,0,1,1357,0.193358000,0.0000
215.158.238.45,<->,130.165.253.86,1,1069,0,0,1,1069,0.193293000,0.0000
136.25.189.59,<->,29.212.180.215,1,1197,0,0,1,1197,0.193261000,0.0000
215.158.140.87,<->,80.34.211.22,1,689,0,0,1,689,0.193252000,0.0000
8.220.176.253,<->,6.74.212.63,1,314,0,0,1,314,0.193221000,0.0000
192.227.191.242,<->,133.178.227.138,0,0,1,1059,1,1059,0.192936000,0.0000
136.25.189.46,<->,113.23.66.247,1,1261,0,0,1,1261,0.192903000,0.0000
215.158.238.64,<->,27.178.41.18,1,1181,0,0,1,1181,0.192710000,0.0000
141.184.244.243,<->,100.228.42.88,0,0,1,425,1,425,0.192486000,0.0000
17.224.231.224,<->,8.20.87.94,0,0,1,368,1,368,0.191822000,0.0000
136.25.189.14,<->,42.97.54.96,1,1181,0,0,1,1181,0.191583000,0.0000
64.105.12.84,<->,53.244.229.106,1,417,0,0,1,417,0.191450000,0.0000
215.158.239.30,<->,8.255.92.65,1,1190,0,0,1,1190,0.191217000,0.0000
192.67.181.42,<->,124.22.107.37,1,175,0,0,1,175,0.191182000,0.0000
195.107.189.92,<->,0.195.210.46,0,0,1,643,1,643,0.190880000,0.0000
196.148.79.57,<->,8.181.37.222,1,404,0,0,1,404,0.190740000,0.0000
111.150.207.144,<->,8.252.223.137,0,0,1,100,1,100,0.190113000,0.0000
139.163.96.104,<->,50.22.161.1,1,198,0,0,1,198,0.189982000,0.0000
89.183.104.248,<->,50.149.205.38,1,78,0,0,1,78,0.189811000,0.0000
215.158.140.75,<->,156.165.33.9,1,1186,0,0,1,1186,0.189786000,0.0000
158.224.196.13,<->,80.42.179.101,0,0,1,91,1,91,0.189583000,0.0000
247.136.234.120,<->,8.45.253.200,1,125,0,0,1,125,0.189289000,0.0000
142.249.172.162,<->,136.25.188.52,0,0,1,426,1,426,0.189089000,0.0000
133.178.227.57,<->,126.219.102.8,1,1095,0,0,1,1095,0.188954000,0.0000
8.252.223.153,<->,8.219.185.37,1,1032,0,0,1,1032,0.188571000,0.0000
195.7.4.75,<->,136.25.188.175,0,0,1,170,1,170,0.188519000,0.0000
136.25.189.130,<->,99.127.114.35,1,61,0,0,1,61,0.188486000,0.0000
215.158.238.82,<->,100.224.138.214,1,1413,0,0,1,1413,0.188475000,0.0000
231.143.109.135,<->,136.25.188.253,0,0,1,145,1,145,0.188226000,0.0000
133.178.226.80,<->,57.227.83.61,1,1197,0,0,1,1197,0.187698000,0.0000
8.252.221.204,<->,4.122.166.119,1,452,0,0,1,452,0.187619000,0.0000
210.229.230.22,<->,149.233.202.52,1,68,0,0,1,68,0.187572000,0.0000
246.253.146.225,<->,143.120.91.175,1,1165,0,0,1,1165,0.187517000,0.0000
195.54.147.188,<->,136.25.188.54,0,0,1,765,1,765,0.187456000,0.0000
143.68.192.161,<->,136.25.188.53,0,0,1,93,1,93,0.187354000,0.0000
215.158.239.92,<->,199.20.29.6,1,781,0,0,1,781,0.187329000,0.0000
215.158.239.51,<->,194.250.210.175,1,304,0,0,1,304,0.187004000,0.0000
195.17.159.17,<->,136.25.188.254,0,0,1,1341,1,1341,0.186990000,0.0000
133.178.227.57,<->,8.221.197.107,1,1053,0,0,1,1053,0.186938000,0.0000
200.174.195.241,<->,53.160.23.38,1,57,0,0,1,57,0.186710000,0.0000
116.242.46.12,<->,89.183.104.191,0,0,1,63,1,63,0.186578000,0.0000
136.25.188.45,<->,29.214.108.136,1,1389,0,0,1,1389,0.186507000,0.0000
195.127.213.242,<->,136.25.188.238,0,0,1,87,1,87,0.186500000,0.0000
215.158.238.80,<->,148.129.19.125,1,1357,0,0,1,1357,0.186398000,0.0000
215.158.239.51,<->,199.20.29.52,1,897,0,0,1,897,0.185948000,0.0000
215.158.61.253,<->,99.74.26.170,0,0,1,316,1,316,0.185939000,0.0000
149.252.245.58,<->,136.25.189.77,0,0,1,1213,1,1213,0.185714000,0.0000
205.89.143.65,<->,50.224.76.234,0,0,1,958,1,958,0.185548000,0.0000
215.158.238.33,<->,207.217.81.70,1,1149,0,0,1,1149,0.185450000,0.0000
215.158.238.123,<->,114.150.180.157,1,1181,0,0,1,1181,0.184940000,0.0000
133.178.227.16,<->,106.188.252.213,1,1119,0,0,1,1119,0.184909000,0.0000
111.147.206.204,<->,53.69.124.66,1,97,0,0,1,97,0.184535000,0.0000
215.158.238.67,<->,106.188.183.96,1,1418,0,0,1,1418,0.184384000,0.0000
215.158.61.242,<->,8.176.8.97,0,0,1,1117,1,1117,0.184354000,0.0000
215.158.238.82,<->,57.227.83.202,1,1341,0,0,1,1341,0.184239000,0.0000
192.67.173.89,<->,54.35.100.140,1,319,0,0,1,319,0.183731000,0.0000
215.158.238.123,<->,80.57.141.61,1,1213,0,0,1,1213,0.183554000,0.0000
111.147.252.19,<->,111.5.197.195,1,1238,0,0,1,1238,0.182810000,0.0000
215.158.239.94,<->,199.20.6.137,1,101,0,0,1,101,0.182760000,0.0000
139.163.26.146,<->,103.191.109.156,1,157,0,0,1,157,0.182379000,0.0000
215.158.239.78,<->,137.199.206.19,1,1229,0,0,1,1229,0.182200000,0.0000
105.116.242.83,<->,92.27.219.225,0,0,1,288,1,288,0.182078000,0.0000
97.126.23.133,<->,92.161.83.172,1,1068,0,0,1,1068,0.181933000,0.0000
215.158.238.223,<->,126.219.100.189,1,1045,0,0,1,1045,0.181905000,0.0000
192.67.152.128,<->,68.81.15.237,1,50,0,0,1,50,0.181747000,0.0000
144.87.238.91,<->,8.182.139.26,0,0,1,602,1,602,0.181669000,0.0000
104.92.51.130,<->,89.183.109.134,0,0,1,107,1,107,0.180302000,0.0000
136.25.189.83,<->,56.28.207.201,1,1453,0,0,1,1453,0.179873000,0.0000
215.158.239.95,<->,207.60.52.190,1,765,0,0,1,765,0.179605000,0.0000
142.253.225.218,<->,136.25.188.236,0,0,1,101,1,101,0.179004000,0.0000
68.208.141.19,<->,8.220.186.82,0,0,1,162,1,162,0.178954000,0.0000
215.158.238.73,<->,104.3.168.214,1,1165,0,0,1,1165,0.178939000,0.0000
136.25.188.197,<->,29.214.108.90,1,1309,0,0,1,1309,0.178904000,0.0000
205.186.128.193,<->,8.220.239.41,0,0,1,1129,1,1129,0.178795000,0.0000
215.158.239.79,<->,143.76.107.81,1,260,0,0,1,260,0.178442000,0.0000
142.253.111.215,<->,136.25.188.174,0,0,1,146,1,146,0.178356000,0.0000
136.158.73.32,<->,133.178.226.178,0,0,1,476,1,476,0.178286000,0.0000
143.13.61.112,<->,136.25.188.175,0,0,1,85,1,85,0.178217000,0.0000
198.204.76.255,<->,136.25.188.224,0,0,1,1005,1,1005,0.178182000,0.0000
136.25.189.2,<->,72.23.194.222,1,1357,0,0,1,1357,0.177716000,0.0000
206.243.231.162,<->,111.147.176.215,0,0,1,253,1,253,0.177557000,0.0000
109.3.128.230,<->,8.45.175.127,1,87,0,0,1,87,0.177476000,0.0000
199.33.57.242,<->,136.25.188.241,0,0,1,357,1,357,0.177431000,0.0000
215.158.239.92,<->,69.132.46.142,1,1197,0,0,1,1197,0.177277000,0.0000
249.101.238.96,<->,105.201.219.15,1,253,0,0,1,253,0.177050000,0.0000
48.16.21.21,<->,8.252.222.199,0,0,1,348,1,348,0.176612000,0.0000
215.158.239.48,<->,207.61.69.132,1,93,0,0,1,93,0.176452000,0.0000
125.216.43.101,<->,8.252.222.241,0,0,1,1357,1,1357,0.176353000,0.0000
197.125.117.203,<->,133.178.227.40,0,0,1,1100,1,1100,0.176277000,0.0000
137.165.179.99,<->,92.162.253.49,0,0,1,963,1,963,0.176118000,0.0000
215.158.238.105,<->,8.47.120.244,1,1021,0,0,1,1021,0.175851000,0.0000
115.83.161.215,<->,35.56.96.84,0,0,1,382,1,382,0.175585000,0.0000
197.113.99.170,<->,136.25.188.196,0,0,1,749,1,749,0.175407000,0.0000
221.102.143.189,<->,102.83.155.28,0,0,1,141,1,141,0.175334000,0.0000
215.158.239.56,<->,196.1.219.223,1,382,0,0,1,382,0.175324000,0.0000
215.158.238.67,<->,8.240.116.201,1,93,0,0,1,93,0.174838000,0.0000
215.158.140.83,<->,61.72.108.237,1,1231,0,0,1,1231,0.174823000,0.0000
199.38.230.179,<->,136.25.188.209,0,0,1,593,1,593,0.174800000,0.0000
215.158.239.29,<->,8.222.97.97,1,1461,0,0,1,1461,0.174760000,0.0000
125.199.233.239,<->,8.182.230.134,0,0,1,284,1,284,0.174389000,0.0000
199.81.22.23,<->,136.25.188.253,0,0,1,101,1,101,0.174347000,0.0000
195.69.87.202,<->,136.25.188.239,0,0,1,708,1,708,0.174250000,0.0000
199.38.184.112,<->,91.231.195.125,0,0,1,158,1,158,0.174153000,0.0000
159.112.9.198,<->,99.74.131.242,0,0,1,81,1,81,0.174036000,0.0000
122.12.244.202,<->,92.162.253.84,0,0,1,783,1,783,0.173267000,0.0000
231.143.135.39,<->,136.25.188.209,0,0,1,93,1,93,0.172895000,0.0000
139.193.141.139,<->,112.19.158.143,1,276,0,0,1,276,0.172182000,0.0000
215.158.42.204,<->,8.252.221.212,0,0,1,281,1,281,0.172134000,0.0000
142.236.140.119,<->,136.25.188.252,0,0,1,87,1,87,0.172100000,0.0000
215.158.239.91,<->,98.219.126.140,1,1244,0,0,1,1244,0.171600000,0.0000
148.190.124.23,<->,133.178.227.79,0,0,1,1102,1,1102,0.171561000,0.0000
116.141.20.175,<->,50.224.76.230,0,0,1,1268,1,1268,0.171459000,0.0000
215.158.238.95,<->,89.85.89.215,1,1293,0,0,1,1293,0.171374000,0.0000
215.158.238.141,<->,113.23.117.117,1,1245,0,0,1,1245,0.170713000,0.0000
199.33.198.154,<->,136.25.188.177,0,0,1,93,1,93,0.170705000,0.0000
218.4.176.27,<->,159.42.43.76,1,406,0,0,1,406,0.170257000,0.0000
243.117.125.59,<->,220.55.100.127,0,0,1,221,1,221,0.170237000,0.0000
215.158.239.220,<->,215.158.61.145,1,774,0,0,1,774,0.170045000,0.0000
247.136.192.123,<->,0.41.29.5,1,50,0,0,1,50,0.169736000,0.0000
101.70.123.35,<->,100.83.51.93,1,120,0,0,1,120,0.169582000,0.0000
192.229.43.33,<->,133.178.227.242,0,0,1,637,1,637,0.169516000,0.0000
80.42.155.7,<->,8.44.70.165,1,294,0,0,1,294,0.169237000,0.0000
132.18.67.30,<->,101.123.187.192,0,0,1,349,1,349,0.169127000,0.0000
133.244.30.133,<->,27.9.159.143,1,176,0,0,1,176,0.168712000,0.0000
136.25.188.163,<->,8.222.212.22,1,1213,0,0,1,1213,0.168287000,0.0000
215.158.239.30,<->,149.96.60.154,1,112,0,0,1,112,0.168018000,0.0000
215.158.238.95,<->,89.86.110.10,1,1293,0,0,1,1293,0.168009000,0.0000
136.25.188.47,<->,61.72.108.203,1,1357,0,0,1,1357,0.167960000,0.0000
204.62.40.203,<->,136.25.188.53,0,0,1,172,1,172,0.167815000,0.0000
215.158.239.49,<->,196.0.238.210,1,101,0,0,1,101,0.167685000,0.0000
136.25.188.242,<->,106.17.143.227,1,1053,0,0,1,1053,0.167425000,0.0000
99.162.77.146,<->,53.213.13.72,1,745,0,0,1,745,0.167382000,0.0000
220.28.109.52,<->,136.25.188.245,0,0,1,514,1,514,0.167080000,0.0000
192.229.40.116,<->,136.25.188.161,0,0,1,1213,1,1213,0.166767000,0.0000
53.77.175.166,<->,8.228.208.183,0,0,1,215,1,215,0.166544000,0.0000
215.158.238.236,<->,89.86.110.213,1,1053,0,0,1,1053,0.166506000,0.0000
133.178.227.76,<->,133.56.180.87,1,1340,0,0,1,1340,0.166279000,0.0000
215.158.61.237,<->,99.74.26.218,0,0,1,1486,1,1486,0.165844000,0.0000
215.158.238.233,<->,111.151.142.231,1,100,0,0,1,100,0.165840000,0.0000
207.191.134.246,<->,136.25.188.226,0,0,1,1094,1,1094,0.165727000,0.0000
129.225.135.200,<->,129.225.132.224,0,0,1,658,1,658,0.165211000,0.0000
215.158.239.33,<->,114.142.109.166,1,91,0,0,1,91,0.165072000,0.0000
248.239.188.96,<->,243.49.81.33,1,471,0,0,1,471,0.164828000,0.0000
196.201.67.113,<->,8.252.222.61,0,0,1,541,1,541,0.164754000,0.0000
231.140.105.59,<->,215.158.239.49,0,0,1,765,1,765,0.164747000,0.0000
215.158.238.236,<->,8.222.2.53,1,1151,0,0,1,1151,0.163768000,0.0000
215.158.239.19,<->,118.20.114.94,1,137,0,0,1,137,0.163736000,0.0000
92.27.219.20,<->,75.92.56.156,1,1396,0,0,1,1396,0.163574000,0.0000
136.25.189.0,<->,8.222.58.219,1,1277,0,0,1,1277,0.163550000,0.0000
221.102.56.69,<->,109.2.14.67,0,0,1,294,1,294,0.163513000,0.0000
215.158.238.243,<->,149.163.129.234,1,1309,0,0,1,1309,0.163384000,0.0000
54.37.53.245,<->,48.53.243.255,0,0,1,1174,1,1174,0.163069000,0.0000
102.45.233.201,<->,92.162.252.139,0,0,1,179,1,179,0.163001000,0.0000
215.158.238.107,<->,42.189.53.24,1,1101,0,0,1,1101,0.162464000,0.0000
195.41.76.161,<->,136.25.188.163,0,0,1,708,1,708,0.161914000,0.0000
142.221.6.119,<->,136.25.188.178,0,0,1,781,1,781,0.161409000,0.0000
215.158.239.253,<->,113.24.0.18,1,94,0,0,1,94,0.161107000,0.0000
207.58.208.45,<->,136.25.188.253,0,0,1,95,1,95,0.160963000,0.0000
194.232.226.23,<->,136.25.188.55,0,0,1,765,1,765,0.160819000,0.0000
215.158.239.93,<->,194.251.64.62,1,765,0,0,1,765,0.160340000,0.0000
204.184.134.174,<->,136.25.188.242,0,0,1,101,1,101,0.160255000,0.0000
136.25.189.32,<->,97.243.113.36,1,1421,0,0,1,1421,0.160022000,0.0000
215.158.239.7,<->,118.20.114.86,1,142,0,0,1,142,0.159856000,0.0000
144.87.238.89,<->,8.182.253.40,0,0,1,944,1,944,0.159830000,0.0000
215.158.238.133,<->,192.205.37.221,1,1135,0,0,1,1135,0.159738000,0.0000
133.178.226.30,<->,29.212.203.155,1,1229,0,0,1,1229,0.159413000,0.0000
215.158.239.68,<->,195.96.152.197,1,87,0,0,1,87,0.159085000,0.0000
136.25.188.253,<->,29.211.186.214,1,1341,0,0,1,1341,0.159023000,0.0000
215.158.239.41,<->,8.222.97.79,1,1455,0,0,1,1455,0.158904000,0.0000
194.233.103.247,<->,136.25.188.255,0,0,1,141,1,141,0.158745000,0.0000
215.158.238.75,<->,122.158.49.151,1,209,0,0,1,209,0.158513000,0.0000
136.25.188.55,<->,111.150.186.246,1,413,0,0,1,413,0.158259000,0.0000
210.229.230.20,<->,83.8.21.57,1,68,0,0,1,68,0.158188000,0.0000
220.59.101.80,<->,100.95.200.24,0,0,1,103,1,103,0.158059000,0.0000
100.182.194.179,<->,50.224.89.237,0,0,1,79,1,79,0.157925000,0.0000
156.165.37.93,<->,133.178.227.14,0,0,1,1087,1,1087,0.157911000,0.0000
203.49.227.252,<->,145.252.127.155,0,0,1,828,1,828,0.157635000,0.0000
148.129.30.28,<->,136.25.189.32,0,0,1,1357,1,1357,0.157496000,0.0000
213.186.52.86,<->,144.85.170.254,0,0,1,449,1,449,0.157415000,0.0000
215.158.238.83,<->,140.174.80.67,1,1405,0,0,1,1405,0.157390000,0.0000
215.158.61.145,<->,8.176.8.251,0,0,1,1405,1,1405,0.157365000,0.0000
215.158.239.56,<->,196.1.15.75,1,1095,0,0,1,1095,0.157120000,0.0000
221.102.56.69,<->,6.74.193.170,0,0,1,294,1,294,0.156973000,0.0000
215.158.239.96,<->,142.209.141.104,1,101,0,0,1,101,0.156615000,0.0000
220.20.200.105,<->,144.83.60.153,1,559,0,0,1,559,0.156531000,0.0000
136.25.189.57,<->,57.31.64.72,1,1309,0,0,1,1309,0.156309000,0.0000
200.10.139.22,<->,8.252.221.196,0,0,1,199,1,199,0.156169000,0.0000
215.158.239.34,<->,80.47.111.181,1,1197,0,0,1,1197,0.156147000,0.0000
149.92.32.188,<->,92.162.253.66,0,0,1,359,1,359,0.156066000,0.0000
133.178.226.224,<->,8.53.223.192,1,94,0,0,1,94,0.155954000,0.0000
146.149.85.75,<->,8.252.221.205,0,0,1,329,1,329,0.155954000,0.0000
215.158.239.57,<->,199.20.30.111,1,141,0,0,1,141,0.155807000,0.0000
207.88.225.180,<->,8.182.136.240,0,0,1,721,1,721,0.155755000,0.0000
139.193.141.139,<->,113.183.198.133,1,420,0,0,1,420,0.155652000,0.0000
207.92.141.166,<->,8.252.222.222,0,0,1,117,1,117,0.155448000,0.0000
97.183.195.190,<->,56.120.131.76,1,687,0,0,1,687,0.155198000,0.0000
215.158.239.5,<->,57.210.104.235,1,68,0,0,1,68,0.155196000,0.0000
207.191.135.206,<->,136.25.188.163,0,0,1,855,1,855,0.155147000,0.0000
142.207.252.64,<->,136.25.188.253,0,0,1,95,1,95,0.155110000,0.0000
204.56.11.214,<->,136.25.188.175,0,0,1,749,1,749,0.154883000,0.0000
215.158.239.57,<->,196.1.176.223,1,602,0,0,1,602,0.154842000,0.0000
199.73.105.151,<->,136.25.188.198,0,0,1,170,1,170,0.154653000,0.0000
112.178.178.127,<->,80.41.20.85,0,0,1,1297,1,1297,0.154584000,0.0000
215.158.239.79,<->,199.20.5.126,1,101,0,0,1,101,0.154571000,0.0000
145.110.157.4,<->,50.223.3.228,0,0,1,218,1,218,0.154429000,0.0000
137.21.23.55,<->,131.229.126.74,1,474,0,0,1,474,0.154352000,0.0000
215.158.239.79,<->,194.232.3.98,1,170,0,0,1,170,0.153572000,0.0000
215.158.239.79,<->,199.106.113.244,1,272,0,0,1,272,0.153406000,0.0000
215.158.239.42,<->,8.241.236.200,1,667,0,0,1,667,0.153090000,0.0000
133.178.226.197,<->,106.188.254.175,1,145,0,0,1,145,0.153052000,0.0000
215.158.61.182,<->,8.176.8.247,0,0,1,253,1,253,0.152676000,0.0000
136.25.189.18,<->,38.104.11.3,1,1437,0,0,1,1437,0.152569000,0.0000
215.202.174.43,<->,215.158.239.93,0,0,1,1357,1,1357,0.152147000,0.0000
136.25.189.28,<->,57.226.224.23,1,1197,0,0,1,1197,0.151975000,0.0000
195.0.26.234,<->,108.134.126.45,0,0,1,648,1,648,0.151596000,0.0000
144.54.85.141,<->,136.25.188.173,0,0,1,492,1,492,0.151535000,0.0000
215.158.238.143,<->,143.155.227.33,1,1101,0,0,1,1101,0.151399000,0.0000
136.201.88.243,<->,8.220.176.253,0,0,1,505,1,505,0.151129000,0.0000
215.158.239.101,<->,129.222.39.167,1,109,0,0,1,109,0.151101000,0.0000
195.4.163.27,<->,136.25.188.198,0,0,1,1093,1,1093,0.150941000,0.0000
215.158.239.58,<->,204.226.109.183,1,170,0,0,1,170,0.150575000,0.0000
210.229.230.22,<->,132.123.119.173,1,80,0,0,1,80,0.150568000,0.0000
144.83.60.153,<->,92.162.253.70,0,0,1,514,1,514,0.150239000,0.0000
215.158.239.33,<->,126.219.102.214,1,1334,0,0,1,1334,0.150066000,0.0000
199.33.118.97,<->,136.25.188.227,0,0,1,172,1,172,0.150058000,0.0000
133.178.226.19,<->,8.188.227.39,1,1197,0,0,1,1197,0.149445000,0.0000
215.158.238.243,<->,131.1.195.27,1,1213,0,0,1,1213,0.149356000,0.0000
215.158.239.99,<->,199.14.81.132,1,97,0,0,1,97,0.149321000,0.0000
94.194.201.39,<->,8.252.221.204,0,0,1,474,1,474,0.148923000,0.0000
139.163.5.140,<->,29.165.29.168,1,112,0,0,1,112,0.148824000,0.0000
86.198.159.86,<->,0.195.210.24,0,0,1,381,1,381,0.148735000,0.0000
215.158.239.40,<->,139.161.104.245,1,1127,0,0,1,1127,0.148673000,0.0000
17.41.77.69,<->,8.220.181.167,0,0,1,107,1,107,0.148587000,0.0000
207.60.237.243,<->,136.25.188.54,0,0,1,813,1,813,0.148383000,0.0000
100.95.89.103,<->,89.86.110.6,1,453,0,0,1,453,0.148182000,0.0000
199.32.203.17,<->,136.25.188.174,0,0,1,765,1,765,0.148100000,0.0000
159.137.162.213,<->,93.215.154.0,1,344,0,0,1,344,0.146806000,0.0000
210.229.230.19,<->,192.78.170.35,1,68,0,0,1,68,0.146757000,0.0000
194.232.231.194,<->,92.27.194.147,0,0,1,263,1,263,0.146738000,0.0000
207.173.191.151,<->,136.25.188.225,0,0,1,101,1,101,0.146637000,0.0000
132.5.76.132,<->,8.52.180.162,0,0,1,548,1,548,0.146616000,0.0000
139.244.182.239,<->,8.220.191.251,0,0,1,337,1,337,0.146547000,0.0000
249.101.116.54,<->,206.243.231.162,1,103,0,0,1,103,0.145429000,0.0000
144.85.170.254,<->,97.22.63.173,1,703,0,0,1,703,0.145066000,0.0000
136.25.188.45,<->,113.23.104.245,1,1229,0,0,1,1229,0.145003000,0.0000
215.158.61.243,<->,8.176.8.233,0,0,1,109,1,109,0.144893000,0.0000
215.158.238.198,<->,29.214.69.218,1,1341,0,0,1,1341,0.144699000,0.0000
241.5.27.232,<->,215.158.239.92,0,0,1,1197,1,1197,0.144472000,0.0000
127.70.90.110,<->,80.38.44.96,0,0,1,134,1,134,0.144373000,0.0000
142.190.183.140,<->,136.25.188.196,0,0,1,95,1,95,0.144354000,0.0000
215.158.238.250,<->,29.214.108.55,1,1083,0,0,1,1083,0.144280000,0.0000
215.158.140.19,<->,215.158.58.243,1,317,0,0,1,317,0.144044000,0.0000
192.67.179.218,<->,127.155.247.137,1,148,0,0,1,148,0.143882000,0.0000
215.158.238.133,<->,192.204.123.117,1,1229,0,0,1,1229,0.143846000,0.0000
215.158.239.234,<->,192.226.44.116,1,233,0,0,1,233,0.143445000,0.0000
215.158.238.218,<->,215.158.34.98,1,568,0,0,1,568,0.143379000,0.0000
139.246.60.47,<->,8.250.152.93,0,0,1,370,1,370,0.143104000,0.0000
207.63.177.218,<->,136.25.188.226,0,0,1,101,1,101,0.142916000,0.0000
206.103.215.203,<->,136.25.189.81,0,0,1,1229,1,1229,0.142894000,0.0000
201.211.197.225,<->,139.193.141.207,0,0,1,524,1,524,0.141434000,0.0000
136.25.188.199,<->,125.216.33.160,1,1149,0,0,1,1149,0.141332000,0.0000
97.126.106.44,<->,54.37.197.187,1,535,0,0,1,535,0.141281000,0.0000
133.178.226.215,<->,130.36.8.133,1,768,0,0,1,768,0.141092000,0.0000
80.40.63.107,<->,8.55.224.156,1,141,0,0,1,141,0.140701000,0.0000
48.18.247.140,<->,8.252.221.198,0,0,1,309,1,309,0.140277000,0.0000
195.43.243.197,<->,136.25.188.46,0,0,1,226,1,226,0.140198000,0.0000
199.82.50.188,<->,136.25.188.225,0,0,1,593,1,593,0.140102000,0.0000
192.205.242.85,<->,133.178.226.214,0,0,1,224,1,224,0.140024000,0.0000
144.85.170.246,<->,144.54.7.171,1,706,0,0,1,706,0.139937000,0.0000
142.254.34.156,<->,136.25.188.53,0,0,1,690,1,690,0.139674000,0.0000
80.27.158.233,<->,6.255.60.209,1,1153,0,0,1,1153,0.139550000,0.0000
252.98.180.173,<->,112.208.20.152,1,50,0,0,1,50,0.139021000,0.0000
195.70.253.186,<->,136.25.188.252,0,0,1,709,1,709,0.138901000,0.0000
200.175.35.79,<->,54.36.159.13,1,79,0,0,1,79,0.138705000,0.0000
192.226.161.66,<->,133.178.227.1,0,0,1,1405,1,1405,0.138076000,0.0000
213.186.52.9,<->,144.85.170.254,0,0,1,408,1,408,0.138053000,0.0000
197.119.129.152,<->,8.183.25.25,0,0,1,93,1,93,0.137225000,0.0000
8.252.223.130,<->,8.222.7.160,1,1170,0,0,1,1170,0.137006000,0.0000
215.158.239.51,<->,199.20.4.160,1,93,0,0,1,93,0.136961000,0.0000
243.117.82.44,<->,129.78.117.164,0,0,1,967,1,967,0.136833000,0.0000
215.158.238.66,<->,113.23.7.56,1,1133,0,0,1,1133,0.136634000,0.0000
93.182.142.92,<->,0.195.210.42,0,0,1,85,1,85,0.136454000,0.0000
215.158.239.86,<->,149.184.89.86,1,1213,0,0,1,1213,0.136298000,0.0000
131.45.239.182,<->,92.162.253.83,0,0,1,439,1,439,0.136269000,0.0000
136.25.188.242,<->,126.219.58.56,1,1117,0,0,1,1117,0.136134000,0.0000
215.158.239.5,<->,96.135.154.124,1,185,0,0,1,185,0.136095000,0.0000
215.158.238.9,<->,192.229.40.2,1,1453,0,0,1,1453,0.135925000,0.0000
215.158.238.64,<->,8.222.96.20,1,1341,0,0,1,1341,0.135807000,0.0000
80.38.39.90,<->,53.250.249.111,1,265,0,0,1,265,0.135784000,0.0000
74.142.203.248,<->,8.252.221.204,0,0,1,794,1,794,0.135440000,0.0000
215.158.239.96,<->,199.20.4.111,1,1022,0,0,1,1022,0.135399000,0.0000
200.175.51.143,<->,53.213.63.93,1,637,0,0,1,637,0.135273000,0.0000
215.158.239.41,<->,215.158.127.162,1,674,0,0,1,674,0.135265000,0.0000
133.178.227.1,<->,8.219.187.248,1,1320,0,0,1,1320,0.135105000,0.0000
215.158.239.96,<->,207.236.9.27,1,170,0,0,1,170,0.135050000,0.0000
215.158.239.78,<->,195.42.32.139,1,182,0,0,1,182,0.134842000,0.0000
220.28.85.14,<->,215.158.238.252,0,0,1,958,1,958,0.134777000,0.0000
133.178.226.28,<->,106.188.253.129,1,925,0,0,1,925,0.134605000,0.0000
158.85.50.170,<->,133.178.227.16,0,0,1,1095,1,1095,0.134583000,0.0000
215.158.140.206,<->,41.132.115.82,1,172,0,0,1,172,0.134573000,0.0000
215.158.239.70,<->,204.0.146.238,1,904,0,0,1,904,0.134482000,0.0000
133.178.226.29,<->,86.151.231.8,1,1277,0,0,1,1277,0.134193000,0.0000
136.25.189.0,<->,61.35.70.200,1,1357,0,0,1,1357,0.134141000,0.0000
139.193.141.139,<->,27.149.104.52,1,316,0,0,1,316,0.133762000,0.0000
220.20.200.105,<->,131.45.239.178,1,295,0,0,1,295,0.133706000,0.0000
221.102.122.201,<->,89.10.2.92,1,460,0,0,1,460,0.133504000,0.0000
215.158.239.77,<->,196.91.86.109,1,282,0,0,1,282,0.132930000,0.0000
101.70.115.178,<->,92.22.138.195,1,58,0,0,1,58,0.132911000,0.0000
133.178.227.14,<->,18.202.90.214,1,1103,0,0,1,1103,0.132639000,0.0000
221.102.56.69,<->,98.128.33.24,0,0,1,294,1,294,0.132457000,0.0000
136.25.188.160,<->,104.3.161.68,1,1229,0,0,1,1229,0.132404000,0.0000
133.178.227.14,<->,8.192.205.88,1,1185,0,0,1,1185,0.132339000,0.0000
133.178.227.16,<->,131.31.183.150,1,1094,0,0,1,1094,0.132235000,0.0000
215.158.239.94,<->,195.15.87.61,1,117,0,0,1,117,0.132020000,0.0000
222.28.123.161,<->,50.224.76.234,0,0,1,713,1,713,0.131935000,0.0000
210.209.251.211,<->,111.147.160.100,0,0,1,1338,1,1338,0.131841000,0.0000
204.200.33.169,<->,136.25.188.224,0,0,1,654,1,654,0.131808000,0.0000
142.167.151.105,<->,136.25.188.52,0,0,1,93,1,93,0.131748000,0.0000
149.254.114.242,<->,136.25.189.2,0,0,1,1357,1,1357,0.131547000,0.0000
133.178.227.76,<->,56.100.165.119,1,1177,0,0,1,1177,0.131080000,0.0000
111.199.226.232,<->,0.195.210.44,0,0,1,93,1,93,0.130904000,0.0000
132.18.67.28,<->,100.182.180.242,0,0,1,339,1,339,0.130872000,0.0000
220.20.200.48,<->,116.123.12.248,1,248,0,0,1,248,0.130801000,0.0000
215.158.239.58,<->,207.59.86.226,1,306,0,0,1,306,0.130526000,0.0000
192.67.175.129,<->,115.250.95.90,1,484,0,0,1,484,0.130502000,0.0000
199.52.198.133,<->,136.25.188.178,0,0,1,637,1,637,0.130437000,0.0000
215.158.239.96,<->,207.213.62.211,1,765,0,0,1,765,0.130275000,0.0000
159.137.162.213,<->,122.205.7.221,1,344,0,0,1,344,0.130178000,0.0000
215.158.239.35,<->,111.151.239.85,1,475,0,0,1,475,0.130173000,0.0000
215.158.238.72,<->,57.227.82.232,1,1261,0,0,1,1261,0.129229000,0.0000
195.71.152.119,<->,136.25.188.46,0,0,1,797,1,797,0.129214000,0.0000
133.178.226.14,<->,104.3.168.189,1,1149,0,0,1,1149,0.129080000,0.0000
136.18.96.155,<->,8.182.235.164,0,0,1,182,1,182,0.129071000,0.0000
80.42.182.80,<->,8.209.235.29,1,390,0,0,1,390,0.128807000,0.0000
209.91.188.207,<->,8.52.147.55,0,0,1,1187,1,1187,0.128717000,0.0000
215.158.238.251,<->,33.239.214.162,1,1181,0,0,1,1181,0.128191000,0.0000
199.69.184.152,<->,136.25.188.253,0,0,1,593,1,593,0.128152000,0.0000
215.158.239.32,<->,140.218.109.20,1,61,0,0,1,61,0.128016000,0.0000
215.158.140.204,<->,8.222.7.154,1,973,0,0,1,973,0.127832000,0.0000
215.158.238.96,<->,29.214.71.102,1,1373,0,0,1,1373,0.127791000,0.0000
215.158.140.221,<->,50.220.141.103,1,768,0,0,1,768,0.127598000,0.0000
132.7.177.108,<->,111.146.159.190,0,0,1,717,1,717,0.127541000,0.0000
133.178.226.29,<->,119.196.23.41,1,1165,0,0,1,1165,0.127451000,0.0000
136.139.59.86,<->,136.25.188.243,0,0,1,1373,1,1373,0.127254000,0.0000
215.158.239.81,<->,139.69.162.57,1,141,0,0,1,141,0.127145000,0.0000
109.91.112.127,<->,100.228.42.40,0,0,1,649,1,649,0.127068000,0.0000
215.158.238.89,<->,145.116.209.93,1,506,0,0,1,506,0.126918000,0.0000
100.206.91.174,<->,33.233.141.91,0,0,1,209,1,209,0.126489000,0.0000
215.158.239.92,<->,199.20.31.95,1,107,0,0,1,107,0.126321000,0.0000
207.62.152.200,<->,136.25.188.225,0,0,1,357,1,357,0.126204000,0.0000
142.255.15.124,<->,136.25.188.252,0,0,1,117,1,117,0.126120000,0.0000
136.25.189.7,<->,0.195.237.14,1,382,0,0,1,382,0.126038000,0.0000
144.87.238.91,<->,8.182.138.83,0,0,1,1386,1,1386,0.125972000,0.0000
254.70.166.176,<->,192.64.195.164,0,0,1,84,1,84,0.125269000,0.0000
142.253.140.101,<->,136.25.188.175,0,0,1,781,1,781,0.125108000,0.0000
207.86.243.25,<->,8.252.222.223,0,0,1,93,1,93,0.124857000,0.0000
195.70.106.33,<->,136.25.188.241,0,0,1,304,1,304,0.124234000,0.0000
97.193.13.236,<->,8.52.171.120,0,0,1,609,1,609,0.124060000,0.0000
215.158.238.81,<->,113.23.104.212,1,1181,0,0,1,1181,0.123833000,0.0000
215.158.239.85,<->,118.20.100.105,1,1357,0,0,1,1357,0.123754000,0.0000
215.158.238.236,<->,131.2.115.215,1,1116,0,0,1,1116,0.123146000,0.0000
215.158.238.113,<->,76.100.108.235,1,1405,0,0,1,1405,0.123061000,0.0000
109.222.199.19,<->,95.221.82.196,1,50,0,0,1,50,0.122397000,0.0000
247.136.156.74,<->,100.124.212.156,1,75,0,0,1,75,0.122068000,0.0000
50.224.76.235,<->,6.72.205.67,1,308,0,0,1,308,0.121844000,0.0000
143.41.107.161,<->,50.224.76.234,0,0,1,1425,1,1425,0.121719000,0.0000
97.203.5.146,<->,8.182.244.237,0,0,1,562,1,562,0.121664000,0.0000
158.150.10.58,<->,139.163.68.55,0,0,1,51,1,51,0.121292000,0.0000
231.140.77.165,<->,215.158.239.95,0,0,1,797,1,797,0.120774000,0.0000
95.77.217.246,<->,50.224.76.235,0,0,1,416,1,416,0.120431000,0.0000
92.168.217.241,<->,50.136.136.40,1,315,0,0,1,315,0.120332000,0.0000
102.254.104.31,<->,97.198.108.233,0,0,1,205,1,205,0.120320000,0.0000
215.158.239.70,<->,199.20.30.18,1,101,0,0,1,101,0.119999000,0.0000
200.174.194.174,<->,54.37.1.37,1,519,0,0,1,519,0.119798000,0.0000
144.38.71.156,<->,8.204.73.39,1,178,0,0,1,178,0.119641000,0.0000
98.248.200.18,<->,8.183.25.124,0,0,1,95,1,95,0.119563000,0.0000
248.239.96.151,<->,8.52.178.59,0,0,1,201,1,201,0.119492000,0.0000
215.158.239.94,<->,115.157.30.159,1,1261,0,0,1,1261,0.119341000,0.0000
215.158.140.195,<->,99.74.26.195,1,980,0,0,1,980,0.119305000,0.0000
215.158.127.200,<->,8.252.223.131,0,0,1,1389,1,1389,0.119024000,0.0000
199.33.198.154,<->,136.25.188.227,0,0,1,93,1,93,0.118761000,0.0000
136.25.188.30,<->,54.52.91.50,1,573,0,0,1,573,0.118482000,0.0000
252.98.139.211,<->,139.33.175.144,1,1098,0,0,1,1098,0.118373000,0.0000
143.29.160.151,<->,80.38.22.80,0,0,1,784,1,784,0.118282000,0.0000
98.219.126.37,<->,80.38.52.231,0,0,1,396,1,396,0.117972000,0.0000
195.41.45.253,<->,136.25.188.238,0,0,1,701,1,701,0.117658000,0.0000
133.178.227.73,<->,133.56.180.2,1,541,0,0,1,541,0.117563000,0.0000
74.19.77.65,<->,50.224.76.235,0,0,1,557,1,557,0.117431000,0.0000
213.38.202.60,<->,8.55.211.213,1,294,0,0,1,294,0.117029000,0.0000
146.170.140.236,<->,80.27.157.123,0,0,1,561,1,561,0.116963000,0.0000
146.14.145.55,<->,133.178.226.70,0,0,1,1101,1,1101,0.116932000,0.0000
204.200.36.112,<->,136.25.188.220,0,0,1,304,1,304,0.116640000,0.0000
145.176.8.232,<->,102.83.21.26,0,0,1,312,1,312,0.116592000,0.0000
215.158.238.121,<->,112.220.206.22,1,93,0,0,1,93,0.116579000,0.0000
136.25.188.172,<->,33.239.214.186,1,1421,0,0,1,1421,0.116481000,0.0000
136.25.188.161,<->,57.160.185.42,1,1149,0,0,1,1149,0.116442000,0.0000
215.158.239.85,<->,199.20.31.215,1,781,0,0,1,781,0.116148000,0.0000
215.158.239.78,<->,29.213.219.42,1,1213,0,0,1,1213,0.115762000,0.0000
215.158.239.49,<->,142.190.173.110,1,93,0,0,1,93,0.115664000,0.0000
215.158.3.191,<->,133.178.227.250,0,0,1,809,1,809,0.115053000,0.0000
89.86.110.221,<->,8.252.223.153,0,0,1,1095,1,1095,0.115013000,0.0000
215.158.238.221,<->,126.219.100.188,1,1101,0,0,1,1101,0.114879000,0.0000
8.220.190.86,<->,6.101.113.132,1,489,0,0,1,489,0.114085000,0.0000
133.178.226.14,<->,99.192.168.150,1,1359,0,0,1,1359,0.113658000,0.0000
159.190.89.148,<->,8.182.253.40,0,0,1,1183,1,1183,0.113356000,0.0000
215.158.140.207,<->,144.114.39.18,1,452,0,0,1,452,0.113340000,0.0000
99.162.77.146,<->,54.38.254.96,1,876,0,0,1,876,0.112921000,0.0000
99.75.57.252,<->,0.33.116.215,1,289,0,0,1,289,0.112661000,0.0000
117.32.177.100,<->,50.224.76.234,0,0,1,899,1,899,0.112660000,0.0000
50.138.145.160,<->,8.20.87.94,0,0,1,446,1,446,0.112652000,0.0000
210.209.251.211,<->,80.41.38.205,0,0,1,442,1,442,0.112572000,0.0000
224.148.99.69,<->,53.244.238.82,1,286,0,0,1,286,0.112552000,0.0000
246.253.253.96,<->,111.151.239.145,1,634,0,0,1,634,0.112309000,0.0000
215.158.140.168,<->,100.224.243.98,1,553,0,0,1,553,0.112113000,0.0000
199.52.66.100,<->,136.25.188.178,0,0,1,101,1,101,0.111742000,0.0000
215.158.239.78,<->,195.54.70.232,1,330,0,0,1,330,0.111507000,0.0000
215.158.238.82,<->,192.228.30.26,1,1373,0,0,1,1373,0.111307000,0.0000
195.14.32.123,<->,136.25.188.163,0,0,1,101,1,101,0.111235000,0.0000
53.149.69.158,<->,48.53.172.18,0,0,1,63,1,63,0.110886000,0.0000
148.146.91.24,<->,133.178.226.7,0,0,1,1373,1,1373,0.110724000,0.0000
215.158.238.7,<->,8.188.227.111,1,93,0,0,1,93,0.110684000,0.0000
215.158.239.35,<->,120.155.14.153,1,86,0,0,1,86,0.110391000,0.0000
136.25.189.13,<->,124.11.230.205,1,1261,0,0,1,1261,0.110344000,0.0000
220.28.115.46,<->,136.25.189.6,0,0,1,780,1,780,0.109670000,0.0000
80.42.138.90,<->,0.239.65.47,1,78,0,0,1,78,0.109599000,0.0000
102.232.21.79,<->,89.90.104.87,1,386,0,0,1,386,0.109596000,0.0000
215.158.239.76,<->,196.105.29.157,1,653,0,0,1,653,0.108564000,0.0000
215.158.239.17,<->,80.47.111.170,1,1034,0,0,1,1034,0.108470000,0.0000
215.158.61.221,<->,99.74.26.116,0,0,1,805,1,805,0.108347000,0.0000
215.158.238.72,<->,112.220.206.63,1,1261,0,0,1,1261,0.108254000,0.0000
136.25.188.47,<->,33.209.219.58,1,1181,0,0,1,1181,0.108109000,0.0000
248.239.171.126,<->,221.102.56.69,1,294,0,0,1,294,0.108038000,0.0000
234.124.221.110,<->,97.198.98.32,0,0,1,190,1,190,0.107709000,0.0000
215.158.239.97,<->,204.21.59.9,1,95,0,0,1,95,0.107582000,0.0000
133.178.226.29,<->,69.132.194.22,1,1133,0,0,1,1133,0.107435000,0.0000
109.222.212.108,<->,8.234.89.60,1,257,0,0,1,257,0.106452000,0.0000
205.127.108.113,<->,33.233.141.68,0,0,1,546,1,546,0.106335000,0.0000
196.234.82.171,<->,8.182.231.198,0,0,1,717,1,717,0.106255000,0.0000
215.158.140.231,<->,8.57.163.149,1,1079,0,0,1,1079,0.106191000,0.0000
195.15.166.92,<->,136.25.188.177,0,0,1,87,1,87,0.105802000,0.0000
215.158.239.70,<->,142.236.193.144,1,749,0,0,1,749,0.105760000,0.0000
215.158.238.234,<->,215.158.33.114,1,611,0,0,1,611,0.105620000,0.0000
215.158.238.67,<->,122.159.245.165,1,1229,0,0,1,1229,0.105428000,0.0000
197.113.64.247,<->,136.25.188.225,0,0,1,781,1,781,0.105118000,0.0000
215.158.238.45,<->,29.212.198.104,1,1181,0,0,1,1181,0.104546000,0.0000
122.206.38.212,<->,50.224.76.235,0,0,1,534,1,534,0.104403000,0.0000
210.220.217.226,<->,54.50.173.203,1,710,0,0,1,710,0.104193000,0.0000
215.158.140.87,<->,114.75.170.84,1,131,0,0,1,131,0.103898000,0.0000
215.158.239.6,<->,8.222.7.169,1,1289,0,0,1,1289,0.103704000,0.0000
142.249.110.104,<->,136.25.188.238,0,0,1,89,1,89,0.103689000,0.0000
220.55.123.87,<->,27.11.152.179,1,289,0,0,1,289,0.103667000,0.0000
129.31.196.8,<->,95.221.124.146,1,134,0,0,1,134,0.103347000,0.0000
215.158.238.135,<->,212.70.75.109,1,1213,0,0,1,1213,0.103053000,0.0000
220.254.188.83,<->,8.220.176.253,0,0,1,474,1,474,0.103010000,0.0000
109.222.209.61,<->,53.240.255.220,1,299,0,0,1,299,0.102847000,0.0000
144.86.149.237,<->,124.50.117.248,1,451,0,0,1,451,0.102660000,0.0000
159.57.90.83,<->,111.147.91.126,0,0,1,494,1,494,0.102503000,0.0000
58.43.188.11,<->,6.72.7.129,0,0,1,412,1,412,0.102435000,0.0000
97.168.65.251,<->,54.52.236.37,1,129,0,0,1,129,0.100967000,0.0000
207.175.241.53,<->,136.25.188.238,0,0,1,170,1,170,0.100768000,0.0000
220.18.254.59,<->,99.167.136.236,0,0,1,203,1,203,0.100625000,0.0000
203.88.16.156,<->,0.195.210.46,0,0,1,415,1,415,0.100352000,0.0000
210.229.230.20,<->,192.166.163.67,1,68,0,0,1,68,0.100155000,0.0000
136.25.188.254,<->,106.188.236.202,1,1229,0,0,1,1229,0.100083000,0.0000
215.158.238.134,<->,111.150.187.55,1,1245,0,0,1,1245,0.099007000,0.0000
86.194.117.24,<->,0.195.210.24,0,0,1,717,1,717,0.098983000,0.0000
215.158.239.93,<->,207.16.255.47,1,117,0,0,1,117,0.098962000,0.0000
195.65.1.186,<->,133.178.226.28,0,0,1,1325,1,1325,0.098689000,0.0000
111.40.71.197,<->,92.27.27.181,0,0,1,547,1,547,0.098409000,0.0000
54.37.81.137,<->,48.52.146.190,0,0,1,110,1,110,0.098346000,0.0000
215.158.238.134,<->,148.23.229.11,1,1149,0,0,1,1149,0.098294000,0.0000
215.158.239.34,<->,111.151.239.84,1,474,0,0,1,474,0.098199000,0.0000
210.229.230.22,<->,82.146.182.113,1,68,0,0,1,68,0.097455000,0.0000
194.234.232.96,<->,136.25.188.198,0,0,1,95,1,95,0.097404000,0.0000
80.41.35.44,<->,54.36.159.13,1,79,0,0,1,79,0.097333000,0.0000
86.135.81.65,<->,8.252.222.68,0,0,1,789,1,789,0.097300000,0.0000
124.31.227.155,<->,50.224.76.234,0,0,1,497,1,497,0.097165000,0.0000
156.156.178.129,<->,8.252.222.134,0,0,1,226,1,226,0.097035000,0.0000
127.128.203.248,<->,92.168.217.198,0,0,1,705,1,705,0.096815000,0.0000
215.158.239.58,<->,199.20.30.180,1,172,0,0,1,172,0.096764000,0.0000
133.178.226.234,<->,111.151.239.138,1,810,0,0,1,810,0.096290000,0.0000
215.158.61.183,<->,8.176.8.186,0,0,1,1098,1,1098,0.095961000,0.0000
215.158.239.221,<->,215.158.61.189,1,429,0,0,1,429,0.095370000,0.0000
109.1.35.61,<->,33.57.79.33,1,50,0,0,1,50,0.095295000,0.0000
207.60.121.202,<->,136.25.188.55,0,0,1,765,1,765,0.095277000,0.0000
215.158.140.172,<->,131.36.66.69,1,1222,0,0,1,1222,0.094799000,0.0000
133.178.227.79,<->,18.202.90.200,1,1142,0,0,1,1142,0.094770000,0.0000
86.135.66.19,<->,8.252.222.49,0,0,1,141,1,141,0.094699000,0.0000
215.158.61.183,<->,8.176.8.202,0,0,1,1445,1,1445,0.094590000,0.0000
111.88.67.250,<->,109.222.230.66,0,0,1,157,1,157,0.094384000,0.0000
215.158.238.123,<->,126.219.196.170,1,1341,0,0,1,1341,0.094306000,0.0000
122.172.176.39,<->,50.224.76.235,0,0,1,981,1,981,0.094072000,0.0000
136.25.188.220,<->,131.1.253.227,1,1278,0,0,1,1278,0.094060000,0.0000
195.69.137.250,<->,136.25.188.53,0,0,1,861,1,861,0.093932000,0.0000
133.178.226.19,<->,119.168.0.145,1,1181,0,0,1,1181,0.093861000,0.0000
215.158.239.92,<->,199.20.29.65,1,172,0,0,1,172,0.093710000,0.0000
215.158.61.242,<->,8.176.8.240,0,0,1,1437,1,1437,0.093618000,0.0000
192.204.243.74,<->,133.178.227.134,0,0,1,1501,1,1501,0.093548000,0.0000
156.165.37.64,<->,136.25.189.59,0,0,1,1357,1,1357,0.093050000,0.0000
215.158.239.84,<->,142.236.209.44,1,653,0,0,1,653,0.092743000,0.0000
100.202.202.53,<->,8.183.18.70,0,0,1,641,1,641,0.092107000,0.0000
148.190.124.36,<->,133.178.227.27,0,0,1,1104,1,1104,0.091816000,0.0000
195.7.138.184,<->,136.25.188.241,0,0,1,170,1,170,0.091725000,0.0000
215.158.238.173,<->,143.155.231.52,1,1135,0,0,1,1135,0.091709000,0.0000
215.158.239.58,<->,199.20.5.176,1,791,0,0,1,791,0.091575000,0.0000
215.158.238.95,<->,128.123.91.58,1,1197,0,0,1,1197,0.090900000,0.0000
215.158.239.54,<->,133.56.180.20,1,1437,0,0,1,1437,0.090509000,0.0000
54.38.77.23,<->,48.54.50.60,0,0,1,345,1,345,0.090488000,0.0000
215.158.140.75,<->,131.144.112.245,1,1038,0,0,1,1038,0.090329000,0.0000
133.178.226.29,<->,131.1.253.249,1,1357,0,0,1,1357,0.090024000,0.0000
139.33.175.144,<->,97.126.106.44,0,0,1,1452,1,1452,0.089936000,0.0000
215.158.239.101,<->,129.222.39.139,1,991,0,0,1,991,0.089850000,0.0000
139.193.141.139,<->,119.111.182.206,1,488,0,0,1,488,0.089394000,0.0000
215.158.238.241,<->,104.3.168.55,1,1094,0,0,1,1094,0.089171000,0.0000
215.158.239.93,<->,199.70.165.39,1,1080,0,0,1,1080,0.089123000,0.0000
221.102.143.189,<->,80.40.251.150,0,0,1,573,1,573,0.089067000,0.0000
231.142.127.224,<->,215.158.239.85,0,0,1,608,1,608,0.088940000,0.0000
159.137.162.213,<->,103.186.254.87,1,344,0,0,1,344,0.088688000,0.0000
142.220.26.164,<->,136.25.188.198,0,0,1,797,1,797,0.088681000,0.0000
159.150.169.25,<->,8.176.39.253,0,0,1,474,1,474,0.088677000,0.0000
95.247.78.62,<->,8.252.221.205,0,0,1,454,1,454,0.088419000,0.0000
99.74.26.219,<->,8.191.135.35,1,215,0,0,1,215,0.088328000,0.0000
215.158.238.221,<->,8.40.51.86,1,1245,0,0,1,1245,0.088273000,0.0000
215.158.140.92,<->,29.214.69.93,1,1101,0,0,1,1101,0.088271000,0.0000
139.161.104.139,<->,133.178.226.200,0,0,1,762,1,762,0.087638000,0.0000
215.158.238.107,<->,192.224.21.33,1,1213,0,0,1,1213,0.087239000,0.0000
113.123.98.95,<->,92.168.217.244,0,0,1,317,1,317,0.086283000,0.0000
133.178.226.28,<->,96.155.60.212,1,175,0,0,1,175,0.086192000,0.0000
231.140.176.16,<->,136.25.188.44,0,0,1,89,1,89,0.086037000,0.0000
246.253.168.231,<->,112.11.94.153,1,641,0,0,1,641,0.085559000,0.0000
215.158.239.102,<->,128.156.85.146,1,100,0,0,1,100,0.085469000,0.0000
246.254.97.112,<->,56.114.235.120,1,567,0,0,1,567,0.085370000,0.0000
202.33.237.102,<->,136.25.188.240,0,0,1,87,1,87,0.084982000,0.0000
139.254.214.188,<->,48.107.69.154,1,1273,0,0,1,1273,0.084836000,0.0000
215.158.239.97,<->,199.20.7.168,1,781,0,0,1,781,0.084814000,0.0000
204.95.168.51,<->,50.224.89.243,0,0,1,1069,1,1069,0.084602000,0.0000
210.209.251.223,<->,111.147.202.234,0,0,1,481,1,481,0.084307000,0.0000
106.27.95.251,<->,80.40.1.240,0,0,1,79,1,79,0.083798000,0.0000
111.199.226.46,<->,0.195.210.44,0,0,1,109,1,109,0.083711000,0.0000
215.158.238.45,<->,57.227.189.165,1,1325,0,0,1,1325,0.083600000,0.0000
215.158.239.40,<->,122.29.158.180,1,1459,0,0,1,1459,0.083539000,0.0000
215.158.140.216,<->,215.158.58.162,1,267,0,0,1,267,0.083475000,0.0000
249.101.234.169,<->,193.46.99.189,1,112,0,0,1,112,0.083399000,0.0000
196.113.221.85,<->,0.195.210.44,0,0,1,93,1,93,0.083361000,0.0000
148.240.80.52,<->,50.224.76.235,0,0,1,553,1,553,0.082990000,0.0000
215.158.239.48,<->,196.90.26.87,1,717,0,0,1,717,0.082790000,0.0000
140.68.9.127,<->,8.252.222.97,0,0,1,346,1,346,0.082583000,0.0000
215.158.238.33,<->,76.100.108.197,1,1277,0,0,1,1277,0.082458000,0.0000
195.127.171.142,<->,136.25.188.236,0,0,1,312,1,312,0.082432000,0.0000
106.217.40.27,<->,22.59.31.30,0,0,1,76,1,76,0.082305000,0.0000
215.158.140.207,<->,131.36.105.41,1,1379,0,0,1,1379,0.082145000,0.0000
136.25.189.30,<->,131.2.102.22,1,1373,0,0,1,1373,0.082017000,0.0000
231.140.77.165,<->,215.158.239.92,0,0,1,797,1,797,0.081962000,0.0000
215.158.140.173,<->,83.252.76.100,1,249,0,0,1,249,0.081897000,0.0000
133.178.226.203,<->,80.47.161.166,1,711,0,0,1,711,0.081864000,0.0000
231.143.227.224,<->,136.25.188.253,0,0,1,765,1,765,0.081851000,0.0000
215.158.239.32,<->,106.188.184.104,1,341,0,0,1,341,0.081627000,0.0000
215.158.239.92,<->,207.191.103.111,1,294,0,0,1,294,0.081594000,0.0000
215.158.238.64,<->,131.1.195.248,1,1213,0,0,1,1213,0.081320000,0.0000
200.10.103.173,<->,8.252.222.46,0,0,1,117,1,117,0.081191000,0.0000
127.73.51.196,<->,50.224.89.243,0,0,1,1085,1,1085,0.081134000,0.0000
136.18.96.155,<->,8.182.244.237,0,0,1,1457,1,1457,0.080745000,0.0000
142.175.130.184,<->,50.223.3.230,0,0,1,265,1,265,0.080678000,0.0000
159.23.227.132,<->,117.16.217.37,1,76,0,0,1,76,0.080021000,0.0000
133.178.226.29,<->,119.196.23.26,1,1117,0,0,1,1117,0.079744000,0.0000
92.168.217.200,<->,50.136.162.200,1,311,0,0,1,311,0.079509000,0.0000
133.178.226.28,<->,57.31.51.199,1,1085,0,0,1,1085,0.079318000,0.0000
142.240.166.10,<->,136.25.188.253,0,0,1,1448,1,1448,0.079111000,0.0000
215.158.239.69,<->,149.254.114.235,1,1229,0,0,1,1229,0.079041000,0.0000
136.25.189.57,<->,98.28.95.88,1,1085,0,0,1,1085,0.078347000,0.0000
215.158.238.67,<->,80.47.228.219,1,1341,0,0,1,1341,0.078286000,0.0000
136.25.189.0,<->,8.33.226.58,1,1325,0,0,1,1325,0.078184000,0.0000
136.25.188.163,<->,116.106.61.226,1,1197,0,0,1,1197,0.078065000,0.0000
101.87.213.136,<->,100.228.42.72,0,0,1,637,1,637,0.077924000,0.0000
152.100.7.72,<->,50.224.80.64,0,0,1,621,1,621,0.077866000,0.0000
215.158.239.87,<->,57.199.250.213,1,1341,0,0,1,1341,0.077271000,0.0000
53.201.231.216,<->,48.53.35.6,0,0,1,621,1,621,0.076167000,0.0000
111.150.207.239,<->,8.252.221.195,0,0,1,100,1,100,0.076167000,0.0000
221.102.98.9,<->,100.239.17.130,1,549,0,0,1,549,0.076019000,0.0000
215.158.140.252,<->,8.222.212.22,1,1138,0,0,1,1138,0.075977000,0.0000
220.20.200.134,<->,131.45.239.182,1,327,0,0,1,327,0.075960000,0.0000
204.184.202.173,<->,136.25.188.222,0,0,1,93,1,93,0.075845000,0.0000
17.255.107.2,<->,8.220.178.194,0,0,1,470,1,470,0.075609000,0.0000
137.137.103.117,<->,123.212.48.165,1,85,0,0,1,85,0.075537000,0.0000
215.158.239.70,<->,199.20.30.146,1,861,0,0,1,861,0.075490000,0.0000
142.207.236.246,<->,136.25.188.220,0,0,1,303,1,303,0.075035000,0.0000
218.188.29.5,<->,80.27.158.227,0,0,1,353,1,353,0.075011000,0.0000
215.158.239.50,<->,199.20.31.12,1,904,0,0,1,904,0.074959000,0.0000
215.158.239.93,<->,57.199.250.221,1,1357,0,0,1,1357,0.074857000,0.0000
203.145.18.130,<->,8.20.87.237,0,0,1,602,1,602,0.074848000,0.0000
197.113.64.180,<->,136.25.188.254,0,0,1,93,1,93,0.074792000,0.0000
215.158.140.87,<->,119.168.0.136,1,1471,0,0,1,1471,0.074704000,0.0000
142.208.72.144,<->,136.25.188.176,0,0,1,274,1,274,0.074618000,0.0000
136.138.112.15,<->,133.178.226.28,0,0,1,1296,1,1296,0.074215000,0.0000
215.158.239.49,<->,57.227.81.11,1,1325,0,0,1,1325,0.074017000,0.0000
220.28.65.9,<->,215.158.140.232,0,0,1,1433,1,1433,0.073973000,0.0000
101.70.126.211,<->,54.51.94.174,1,445,0,0,1,445,0.073941000,0.0000
133.244.30.133,<->,119.111.182.129,1,101,0,0,1,101,0.073739000,0.0000
247.136.175.22,<->,56.114.235.120,1,876,0,0,1,876,0.073718000,0.0000
215.158.239.97,<->,142.221.13.37,1,93,0,0,1,93,0.073716000,0.0000
133.178.227.12,<->,133.56.180.22,1,1315,0,0,1,1315,0.073554000,0.0000
204.90.255.169,<->,8.52.135.156,0,0,1,95,1,95,0.073487000,0.0000
120.148.82.112,<->,50.224.93.77,0,0,1,50,1,50,0.073375000,0.0000
215.158.239.4,<->,102.225.141.27,1,1142,0,0,1,1142,0.073262000,0.0000
54.37.127.247,<->,8.30.100.213,0,0,1,604,1,604,0.073093000,0.0000
149.197.244.196,<->,144.71.43.240,0,0,1,101,1,101,0.073076000,0.0000
205.170.188.93,<->,50.224.76.235,0,0,1,1138,1,1138,0.072969000,0.0000
196.29.116.141,<->,50.223.3.228,0,0,1,229,1,229,0.072422000,0.0000
129.16.253.173,<->,129.1.96.220,0,0,1,762,1,762,0.072071000,0.0000
199.81.87.108,<->,136.25.188.225,0,0,1,89,1,89,0.071978000,0.0000
215.158.238.80,<->,136.138.112.232,1,1357,0,0,1,1357,0.071605000,0.0000
215.158.239.70,<->,196.109.201.160,1,781,0,0,1,781,0.071431000,0.0000
109.1.100.42,<->,8.45.162.111,1,286,0,0,1,286,0.071350000,0.0000
192.170.241.192,<->,8.252.221.166,0,0,1,171,1,171,0.071218000,0.0000
143.155.227.33,<->,136.25.188.199,0,0,1,264,1,264,0.070936000,0.0000
131.148.26.40,<->,100.228.42.102,0,0,1,661,1,661,0.070894000,0.0000
48.131.158.227,<->,8.252.223.153,0,0,1,1133,1,1133,0.070890000,0.0000
133.178.226.30,<->,93.156.41.103,1,829,0,0,1,829,0.070705000,0.0000
129.201.127.101,<->,50.224.76.235,0,0,1,643,1,643,0.070540000,0.0000
222.78.138.95,<->,50.224.76.234,0,0,1,1177,1,1177,0.070329000,0.0000
195.7.73.125,<->,136.25.188.175,0,0,1,1005,1,1005,0.070274000,0.0000
215.158.238.95,<->,99.192.168.186,1,1275,0,0,1,1275,0.069886000,0.0000
136.25.188.55,<->,120.154.221.215,1,1341,0,0,1,1341,0.069485000,0.0000
215.158.239.97,<->,194.234.131.165,1,1074,0,0,1,1074,0.069337000,0.0000
195.40.100.63,<->,136.25.188.236,0,0,1,877,1,877,0.069231000,0.0000
215.158.239.41,<->,29.214.74.170,1,1453,0,0,1,1453,0.068809000,0.0000
215.158.140.195,<->,8.222.7.162,1,975,0,0,1,975,0.068472000,0.0000
215.158.239.48,<->,195.13.176.139,1,781,0,0,1,781,0.068099000,0.0000
87.1.164.149,<->,8.52.154.162,0,0,1,354,1,354,0.067947000,0.0000
133.178.226.80,<->,96.155.60.247,1,1446,0,0,1,1446,0.067866000,0.0000
204.186.80.166,<->,136.25.188.174,0,0,1,101,1,101,0.067841000,0.0000
109.49.74.13,<->,8.182.136.57,0,0,1,1172,1,1172,0.067793000,0.0000
159.137.141.196,<->,134.252.17.141,1,1023,0,0,1,1023,0.067730000,0.0000
194.237.212.197,<->,136.25.188.53,0,0,1,525,1,525,0.067500000,0.0000
215.158.239.50,<->,29.214.73.92,1,1357,0,0,1,1357,0.067461000,0.0000
136.25.188.254,<->,111.151.239.44,1,1277,0,0,1,1277,0.067092000,0.0000
204.3.67.2,<->,136.25.188.176,0,0,1,378,1,378,0.066977000,0.0000
139.163.126.226,<->,17.100.3.178,1,518,0,0,1,518,0.066682000,0.0000
89.86.110.24,<->,8.252.222.204,0,0,1,1181,1,1181,0.066298000,0.0000
224.33.81.238,<->,80.41.32.204,0,0,1,89,1,89,0.066077000,0.0000
215.158.238.96,<->,159.23.130.171,1,1309,0,0,1,1309,0.066033000,0.0000
210.229.230.20,<->,100.51.146.119,1,68,0,0,1,68,0.065915000,0.0000
215.158.238.75,<->,112.220.206.116,1,1213,0,0,1,1213,0.065522000,0.0000
143.44.47.150,<->,136.25.188.209,0,0,1,93,1,93,0.065205000,0.0000
199.51.185.92,<->,136.25.188.174,0,0,1,512,1,512,0.064818000,0.0000
143.43.195.76,<->,136.25.188.236,0,0,1,93,1,93,0.064798000,0.0000
195.43.201.16,<->,136.25.188.243,0,0,1,107,1,107,0.064787000,0.0000
215.158.239.95,<->,207.115.175.147,1,830,0,0,1,830,0.064778000,0.0000
199.39.54.6,<->,136.25.188.177,0,0,1,798,1,798,0.064746000,0.0000
215.158.140.207,<->,98.249.65.6,1,445,0,0,1,445,0.064727000,0.0000
136.25.189.31,<->,96.156.169.215,1,1213,0,0,1,1213,0.064559000,0.0000
215.158.239.70,<->,204.3.9.234,1,669,0,0,1,669,0.064530000,0.0000
215.158.238.45,<->,158.178.187.53,1,1213,0,0,1,1213,0.064474000,0.0000
215.158.239.94,<->,194.234.164.216,1,749,0,0,1,749,0.064337000,0.0000
197.161.214.193,<->,136.25.188.225,0,0,1,87,1,87,0.064125000,0.0000
215.158.238.81,<->,112.164.79.42,1,1181,0,0,1,1181,0.064077000,0.0000
203.116.230.54,<->,136.25.188.174,0,0,1,259,1,259,0.063374000,0.0000
195.41.210.142,<->,136.25.188.196,0,0,1,549,1,549,0.063217000,0.0000
129.197.254.237,<->,6.73.243.231,0,0,1,629,1,629,0.063092000,0.0000
204.200.61.167,<->,136.25.188.177,0,0,1,132,1,132,0.062846000,0.0000
136.139.59.124,<->,133.178.226.49,0,0,1,93,1,93,0.062533000,0.0000
69.31.238.221,<->,8.176.8.220,0,0,1,1137,1,1137,0.062441000,0.0000
215.158.238.241,<->,106.188.253.228,1,1045,0,0,1,1045,0.061896000,0.0000
224.250.64.86,<->,100.95.6.174,0,0,1,50,1,50,0.061783000,0.0000
207.172.193.53,<->,136.25.188.176,0,0,1,797,1,797,0.061782000,0.0000
133.178.227.208,<->,131.36.201.103,1,894,0,0,1,894,0.061692000,0.0000
215.158.238.163,<->,111.151.106.211,1,100,0,0,1,100,0.061553000,0.0000
220.250.48.114,<->,139.163.66.202,0,0,1,81,1,81,0.061408000,0.0000
142.245.147.40,<->,136.25.188.253,0,0,1,93,1,93,0.061179000,0.0000
207.57.143.124,<->,136.25.188.255,0,0,1,95,1,95,0.061170000,0.0000
227.56.252.224,<->,139.163.96.94,0,0,1,50,1,50,0.061073000,0.0000
94.194.43.230,<->,8.252.221.196,0,0,1,303,1,303,0.060799000,0.0000
204.63.121.235,<->,136.25.188.227,0,0,1,101,1,101,0.060282000,0.0000
215.158.239.87,<->,207.228.147.30,1,161,0,0,1,161,0.059720000,0.0000
111.150.207.194,<->,8.252.221.118,0,0,1,100,1,100,0.059591000,0.0000
215.158.239.49,<->,112.220.198.117,1,1325,0,0,1,1325,0.059202000,0.0000
207.59.140.137,<->,136.25.188.177,0,0,1,95,1,95,0.058777000,0.0000
146.234.135.111,<->,136.25.189.80,0,0,1,1341,1,1341,0.058690000,0.0000
143.68.153.232,<->,136.25.188.255,0,0,1,170,1,170,0.058119000,0.0000
215.158.239.79,<->,156.165.37.67,1,1261,0,0,1,1261,0.058087000,0.0000
195.43.118.8,<->,136.25.188.178,0,0,1,93,1,93,0.057998000,0.0000
140.145.218.202,<->,133.178.226.29,0,0,1,1165,1,1165,0.057995000,0.0000
215.158.238.226,<->,140.190.46.212,1,1117,0,0,1,1117,0.057940000,0.0000
215.158.239.99,<->,204.0.175.239,1,1098,0,0,1,1098,0.057612000,0.0000
136.25.189.77,<->,122.216.233.153,1,1357,0,0,1,1357,0.057525000,0.0000
194.237.254.104,<->,136.25.188.236,0,0,1,93,1,93,0.057239000,0.0000
126.198.149.124,<->,100.93.84.183,0,0,1,344,1,344,0.057010000,0.0000
48.131.158.235,<->,8.252.223.143,0,0,1,1181,1,1181,0.056922000,0.0000
133.178.226.28,<->,122.158.70.40,1,1197,0,0,1,1197,0.056870000,0.0000
215.158.239.92,<->,143.89.71.213,1,170,0,0,1,170,0.056758000,0.0000
141.108.233.205,<->,8.176.8.219,0,0,1,1082,1,1082,0.056517000,0.0000
54.93.237.157,<->,48.52.156.226,0,0,1,84,1,84,0.056423000,0.0000
215.158.238.95,<->,89.80.251.7,1,1357,0,0,1,1357,0.056185000,0.0000
210.220.219.152,<->,8.35.106.57,1,83,0,0,1,83,0.056139000,0.0000
53.213.200.116,<->,48.53.34.86,0,0,1,285,1,285,0.055989000,0.0000
143.206.95.244,<->,0.195.210.33,0,0,1,113,1,113,0.055795000,0.0000
215.158.238.177,<->,122.158.245.24,1,1217,0,0,1,1217,0.055665000,0.0000
129.236.115.241,<->,111.20.168.122,0,0,1,1115,1,1115,0.055442000,0.0000
212.70.75.118,<->,136.25.189.15,0,0,1,1229,1,1229,0.055305000,0.0000
215.158.238.33,<->,112.235.95.74,1,1064,0,0,1,1064,0.055234000,0.0000
142.253.81.150,<->,136.25.188.198,0,0,1,765,1,765,0.055160000,0.0000
192.204.170.200,<->,136.25.188.221,0,0,1,1341,1,1341,0.054861000,0.0000
136.25.189.28,<->,91.247.40.69,1,101,0,0,1,101,0.054831000,0.0000
207.172.243.214,<->,136.25.188.176,0,0,1,1095,1,1095,0.054820000,0.0000
192.170.241.202,<->,8.252.222.235,0,0,1,171,1,171,0.054282000,0.0000
215.158.239.93,<->,122.216.233.155,1,1213,0,0,1,1213,0.054063000,0.0000
147.183.119.67,<->,8.252.221.236,0,0,1,678,1,678,0.053860000,0.0000
98.232.166.102,<->,57.211.62.3,1,144,0,0,1,144,0.053597000,0.0000
230.91.28.191,<->,192.64.218.144,0,0,1,50,1,50,0.053502000,0.0000
196.206.251.113,<->,136.25.188.222,0,0,1,272,1,272,0.052973000,0.0000
127.240.164.174,<->,50.224.76.235,0,0,1,435,1,435,0.052758000,0.0000
215.158.239.77,<->,199.20.5.252,1,101,0,0,1,101,0.052585000,0.0000
220.20.200.248,<->,119.159.22.233,1,343,0,0,1,343,0.052531000,0.0000
215.158.239.94,<->,196.94.171.96,1,101,0,0,1,101,0.052423000,0.0000
158.14.120.148,<->,101.224.206.46,0,0,1,107,1,107,0.052386000,0.0000
142.221.52.212,<->,136.25.188.224,0,0,1,749,1,749,0.052119000,0.0000
215.158.239.99,<->,199.20.28.70,1,101,0,0,1,101,0.051315000,0.0000
215.158.239.56,<->,199.52.227.183,1,685,0,0,1,685,0.051245000,0.0000
195.54.100.230,<->,136.25.188.241,0,0,1,101,1,101,0.050874000,0.0000
193.15.140.40,<->,50.224.76.235,0,0,1,1218,1,1218,0.050821000,0.0000
215.158.238.6,<->,207.201.134.57,1,131,0,0,1,131,0.050599000,0.0000
145.158.254.247,<->,133.178.227.227,0,0,1,94,1,94,0.050113000,0.0000
215.158.61.183,<->,8.176.8.213,0,0,1,189,1,189,0.049897000,0.0000
231.142.233.199,<->,136.25.188.252,0,0,1,319,1,319,0.049889000,0.0000
215.158.239.7,<->,8.219.187.249,1,1233,0,0,1,1233,0.049781000,0.0000
195.5.1.74,<->,136.25.188.46,0,0,1,701,1,701,0.049090000,0.0000
139.163.26.146,<->,117.25.85.194,1,111,0,0,1,111,0.048888000,0.0000
145.128.230.16,<->,8.220.235.203,0,0,1,369,1,369,0.048730000,0.0000
139.241.56.147,<->,136.25.189.52,0,0,1,509,1,509,0.048695000,0.0000
235.42.34.20,<->,215.158.238.97,0,0,1,1213,1,1213,0.048556000,0.0000
101.49.217.41,<->,50.224.80.67,0,0,1,453,1,453,0.048554000,0.0000
159.70.27.69,<->,144.86.146.31,0,0,1,1213,1,1213,0.048488000,0.0000
53.201.208.209,<->,8.30.106.217,0,0,1,181,1,181,0.048446000,0.0000
215.158.239.50,<->,207.228.196.160,1,378,0,0,1,378,0.048365000,0.0000
114.215.225.176,<->,89.183.104.227,0,0,1,1396,1,1396,0.047726000,0.0000
195.121.224.243,<->,8.182.234.113,0,0,1,817,1,817,0.047643000,0.0000
215.158.239.48,<->,199.20.30.28,1,765,0,0,1,765,0.047557000,0.0000
210.158.44.59,<->,121.74.207.64,1,1064,0,0,1,1064,0.047438000,0.0000
196.206.136.251,<->,136.25.188.225,0,0,1,97,1,97,0.046545000,0.0000
148.26.113.236,<->,133.178.227.24,0,0,1,1055,1,1055,0.046366000,0.0000
215.158.239.58,<->,199.20.7.19,1,894,0,0,1,894,0.046329000,0.0000
145.78.129.144,<->,8.220.239.66,0,0,1,87,1,87,0.046039000,0.0000
122.186.169.249,<->,8.220.195.228,0,0,1,935,1,935,0.046033000,0.0000
241.14.130.240,<->,80.38.36.113,0,0,1,714,1,714,0.045519000,0.0000
136.25.189.46,<->,29.212.199.40,1,1357,0,0,1,1357,0.045307000,0.0000
192.229.210.156,<->,50.10.84.183,1,93,0,0,1,93,0.044959000,0.0000
136.25.188.175,<->,126.219.194.132,1,713,0,0,1,713,0.044944000,0.0000
193.7.225.128,<->,8.220.176.253,0,0,1,547,1,547,0.044749000,0.0000
204.200.172.228,<->,136.25.188.254,0,0,1,85,1,85,0.044668000,0.0000
204.62.56.8,<->,136.25.188.178,0,0,1,1098,1,1098,0.044399000,0.0000
206.243.231.162,<->,97.168.64.127,0,0,1,113,1,113,0.044393000,0.0000
50.183.211.51,<->,8.52.246.194,0,0,1,716,1,716,0.044368000,0.0000
92.27.27.177,<->,42.27.147.254,1,341,0,0,1,341,0.044337000,0.0000
142.249.242.192,<->,136.25.188.255,0,0,1,101,1,101,0.043052000,0.0000
136.25.188.198,<->,131.1.232.133,1,410,0,0,1,410,0.042744000,0.0000
215.158.238.92,<->,8.223.224.53,1,1245,0,0,1,1245,0.042405000,0.0000
215.158.239.70,<->,196.94.6.49,1,273,0,0,1,273,0.042053000,0.0000
54.36.191.119,<->,48.54.254.104,0,0,1,61,1,61,0.041994000,0.0000
98.67.154.211,<->,54.55.213.137,1,76,0,0,1,76,0.041439000,0.0000
76.145.196.38,<->,8.52.222.199,0,0,1,615,1,615,0.041106000,0.0000
138.98.151.44,<->,124.50.117.254,1,638,0,0,1,638,0.041070000,0.0000
93.181.134.50,<->,92.27.219.253,0,0,1,81,1,81,0.040909000,0.0000
215.158.239.41,<->,8.222.7.169,1,1217,0,0,1,1217,0.040560000,0.0000
136.25.188.224,<->,42.97.54.62,1,1229,0,0,1,1229,0.040375000,0.0000
100.28.122.63,<->,50.224.80.64,0,0,1,1121,1,1121,0.040168000,0.0000
144.85.170.254,<->,91.69.185.232,1,742,0,0,1,742,0.040160000,0.0000
198.8.34.104,<->,139.163.5.140,0,0,1,112,1,112,0.039982000,0.0000
215.158.239.40,<->,8.222.7.181,1,1198,0,0,1,1198,0.039826000,0.0000
159.2.58.132,<->,8.52.171.120,0,0,1,737,1,737,0.039818000,0.0000
98.16.139.251,<->,8.52.171.31,0,0,1,75,1,75,0.039790000,0.0000
204.185.186.30,<->,136.25.188.198,0,0,1,282,1,282,0.039762000,0.0000
100.206.91.174,<->,33.233.141.26,0,0,1,209,1,209,0.039365000,0.0000
202.178.8.218,<->,139.163.26.238,0,0,1,345,1,345,0.039253000,0.0000
144.83.60.153,<->,92.162.253.125,0,0,1,626,1,626,0.039238000,0.0000
245.161.124.44,<->,8.252.222.157,0,0,1,765,1,765,0.038684000,0.0000
192.65.25.39,<->,112.208.20.230,1,163,0,0,1,163,0.038591000,0.0000
17.61.229.116,<->,8.220.204.147,0,0,1,1389,1,1389,0.038590000,0.0000
195.13.151.25,<->,136.25.188.222,0,0,1,765,1,765,0.038319000,0.0000
192.170.241.167,<->,8.252.221.164,0,0,1,409,1,409,0.038004000,0.0000
197.113.99.244,<->,136.25.188.197,0,0,1,858,1,858,0.037882000,0.0000
111.199.229.21,<->,0.195.210.44,0,0,1,175,1,175,0.037735000,0.0000
97.181.15.45,<->,8.220.202.31,0,0,1,458,1,458,0.037612000,0.0000
215.158.239.69,<->,8.42.43.36,1,1261,0,0,1,1261,0.037483000,0.0000
140.19.166.244,<->,133.178.227.16,0,0,1,1373,1,1373,0.037434000,0.0000
215.158.239.40,<->,57.210.104.212,1,1404,0,0,1,1404,0.037378000,0.0000
109.0.245.91,<->,8.49.69.216,1,394,0,0,1,394,0.037234000,0.0000
215.158.239.182,<->,106.188.226.67,1,205,0,0,1,205,0.037184000,0.0000
210.220.219.153,<->,139.33.175.144,1,267,0,0,1,267,0.037168000,0.0000
53.149.99.50,<->,48.54.53.142,0,0,1,328,1,328,0.036815000,0.0000
199.20.12.66,<->,92.27.194.147,0,0,1,354,1,354,0.036551000,0.0000
215.158.239.79,<->,195.41.216.49,1,93,0,0,1,93,0.036522000,0.0000
137.137.109.30,<->,54.69.178.55,1,125,0,0,1,125,0.035997000,0.0000
136.25.189.59,<->,131.6.152.4,1,1245,0,0,1,1245,0.035959000,0.0000
246.253.253.96,<->,145.242.124.31,1,426,0,0,1,426,0.035543000,0.0000
215.158.239.50,<->,143.135.157.252,1,715,0,0,1,715,0.035503000,0.0000
215.158.239.95,<->,196.91.24.37,1,190,0,0,1,190,0.035196000,0.0000
215.158.239.221,<->,215.158.61.191,1,1410,0,0,1,1410,0.035011000,0.0000
124.86.24.82,<->,8.31.37.162,0,0,1,733,1,733,0.034694000,0.0000
220.28.65.9,<->,215.158.239.61,0,0,1,684,1,684,0.034637000,0.0000
199.53.111.156,<->,136.25.188.163,0,0,1,101,1,101,0.034418000,0.0000
215.158.238.83,<->,29.214.71.95,1,1245,0,0,1,1245,0.033823000,0.0000
109.50.181.214,<->,8.182.225.124,0,0,1,97,1,97,0.033774000,0.0000
215.158.239.182,<->,68.231.30.24,1,94,0,0,1,94,0.033456000,0.0000
129.225.135.192,<->,129.225.132.224,0,0,1,577,1,577,0.032831000,0.0000
133.178.226.161,<->,54.52.195.79,1,109,0,0,1,109,0.032713000,0.0000
136.25.189.89,<->,114.94.161.217,1,1197,0,0,1,1197,0.032667000,0.0000
136.25.188.221,<->,126.219.247.16,1,1325,0,0,1,1325,0.032156000,0.0000
215.158.239.49,<->,199.20.7.148,1,101,0,0,1,101,0.032054000,0.0000
136.25.189.12,<->,135.229.0.221,1,1245,0,0,1,1245,0.031907000,0.0000
133.178.226.30,<->,8.252.253.235,1,1197,0,0,1,1197,0.031789000,0.0000
111.146.194.62,<->,53.149.30.218,1,125,0,0,1,125,0.031779000,0.0000
215.158.239.93,<->,106.155.128.76,1,1229,0,0,1,1229,0.031777000,0.0000
139.163.26.146,<->,131.33.20.26,1,99,0,0,1,99,0.031752000,0.0000
98.67.131.24,<->,53.189.131.169,1,298,0,0,1,298,0.031584000,0.0000
215.158.239.32,<->,8.222.7.154,1,1200,0,0,1,1200,0.031386000,0.0000
197.113.99.96,<->,136.25.188.209,0,0,1,920,1,920,0.031339000,0.0000
215.158.61.254,<->,8.252.221.233,0,0,1,396,1,396,0.031301000,0.0000
8.252.223.140,<->,8.219.187.249,1,1252,0,0,1,1252,0.030745000,0.0000
207.117.20.8,<->,8.252.222.178,0,0,1,101,1,101,0.030477000,0.0000
128.156.218.12,<->,50.224.76.235,0,0,1,1143,1,1143,0.030101000,0.0000
142.206.242.124,<->,92.27.194.147,0,0,1,248,1,248,0.030098000,0.0000
143.10.66.79,<->,136.25.188.45,0,0,1,172,1,172,0.029772000,0.0000
136.25.189.13,<->,120.154.131.7,1,1293,0,0,1,1293,0.029634000,0.0000
8.252.223.153,<->,8.192.205.73,1,1033,0,0,1,1033,0.029464000,0.0000
192.67.157.104,<->,119.78.222.103,1,112,0,0,1,112,0.029319000,0.0000
50.223.3.229,<->,27.199.226.18,1,300,0,0,1,300,0.029068000,0.0000
215.158.238.99,<->,0.34.21.19,1,1341,0,0,1,1341,0.029053000,0.0000
215.158.239.95,<->,195.43.141.71,1,172,0,0,1,172,0.029021000,0.0000
215.158.238.38,<->,144.253.55.121,1,704,0,0,1,704,0.028777000,0.0000
207.191.243.144,<->,136.25.188.196,0,0,1,170,1,170,0.028749000,0.0000
246.254.97.229,<->,54.55.44.79,1,362,0,0,1,362,0.028389000,0.0000
204.186.114.86,<->,136.25.188.237,0,0,1,765,1,765,0.028363000,0.0000
215.158.238.66,<->,57.4.201.250,1,1485,0,0,1,1485,0.028232000,0.0000
215.158.61.191,<->,8.176.8.240,0,0,1,685,1,685,0.028204000,0.0000
215.158.238.123,<->,197.125.116.84,1,1037,0,0,1,1037,0.028032000,0.0000
215.158.238.106,<->,131.215.37.23,1,1277,0,0,1,1277,0.028018000,0.0000
215.158.239.94,<->,113.23.66.232,1,1325,0,0,1,1325,0.027898000,0.0000
142.248.63.21,<->,136.25.188.255,0,0,1,170,1,170,0.027274000,0.0000
129.92.117.26,<->,111.20.62.72,1,204,0,0,1,204,0.027179000,0.0000
215.158.239.78,<->,196.92.139.128,1,602,0,0,1,602,0.027097000,0.0000
111.147.237.184,<->,104.143.73.202,1,51,0,0,1,51,0.026855000,0.0000
159.137.162.213,<->,122.217.246.204,1,344,0,0,1,344,0.026675000,0.0000
133.178.226.28,<->,126.219.58.56,1,1197,0,0,1,1197,0.026464000,0.0000
116.255.114.125,<->,50.224.76.234,0,0,1,647,1,647,0.026218000,0.0000
215.158.239.50,<->,195.83.167.74,1,602,0,0,1,602,0.026113000,0.0000
194.232.127.157,<->,136.25.188.242,0,0,1,101,1,101,0.025448000,0.0000
215.158.238.95,<->,33.239.214.170,1,245,0,0,1,245,0.025434000,0.0000
122.245.156.85,<->,50.224.76.230,0,0,1,539,1,539,0.024734000,0.0000
229.45.207.12,<->,53.230.44.150,1,651,0,0,1,651,0.024607000,0.0000
215.158.61.193,<->,8.176.8.193,0,0,1,658,1,658,0.024539000,0.0000
128.204.129.154,<->,50.224.76.230,0,0,1,121,1,121,0.024467000,0.0000
194.232.200.149,<->,136.25.188.46,0,0,1,101,1,101,0.024284000,0.0000
196.88.176.13,<->,136.25.188.239,0,0,1,87,1,87,0.024279000,0.0000
221.102.103.73,<->,194.245.224.227,1,491,0,0,1,491,0.024225000,0.0000
215.158.238.189,<->,131.36.66.82,1,1146,0,0,1,1146,0.024153000,0.0000
139.1.221.230,<->,136.25.189.18,0,0,1,1213,1,1213,0.024121000,0.0000
220.20.200.36,<->,131.45.239.178,1,439,0,0,1,439,0.024109000,0.0000
215.158.140.231,<->,61.35.22.249,1,1118,0,0,1,1118,0.024015000,0.0000
215.158.238.197,<->,8.50.118.65,1,1244,0,0,1,1244,0.023950000,0.0000
215.158.239.78,<->,204.21.1.62,1,172,0,0,1,172,0.023821000,0.0000
142.236.203.19,<->,136.25.188.176,0,0,1,101,1,101,0.023630000,0.0000
136.25.189.30,<->,122.216.233.184,1,1501,0,0,1,1501,0.023185000,0.0000
138.121.99.24,<->,8.220.176.253,0,0,1,351,1,351,0.023097000,0.0000
117.10.216.132,<->,50.224.76.235,0,0,1,85,1,85,0.022863000,0.0000
204.63.132.211,<->,136.25.188.177,0,0,1,250,1,250,0.022788000,0.0000
215.158.238.97,<->,131.144.113.169,1,1389,0,0,1,1389,0.022620000,0.0000
215.158.239.79,<->,194.202.105.155,1,765,0,0,1,765,0.022297000,0.0000
215.158.238.177,<->,61.35.22.200,1,1075,0,0,1,1075,0.021999000,0.0000
98.128.69.239,<->,8.55.221.134,1,75,0,0,1,75,0.021993000,0.0000
206.241.64.92,<->,80.41.51.42,0,0,1,213,1,213,0.021625000,0.0000
17.61.232.100,<->,8.220.233.99,0,0,1,170,1,170,0.021401000,0.0000
102.34.34.14,<->,98.67.158.12,0,0,1,396,1,396,0.021256000,0.0000
89.183.110.72,<->,0.70.165.207,1,894,0,0,1,894,0.021202000,0.0000
93.181.154.111,<->,92.27.219.161,0,0,1,140,1,140,0.021156000,0.0000
139.193.141.139,<->,0.34.13.137,1,284,0,0,1,284,0.021113000,0.0000
136.25.188.202,<->,80.57.141.218,1,93,0,0,1,93,0.020922000,0.0000
33.233.141.67,<->,17.62.194.122,1,559,0,0,1,559,0.020100000,0.0000
215.158.238.83,<->,142.234.196.229,1,1373,0,0,1,1373,0.019829000,0.0000
215.158.238.95,<->,128.180.137.170,1,1165,0,0,1,1165,0.019806000,0.0000
196.87.7.181,<->,136.25.188.253,0,0,1,117,1,117,0.019601000,0.0000
136.25.189.59,<->,128.69.139.94,1,1229,0,0,1,1229,0.019428000,0.0000
142.209.70.144,<->,136.25.188.252,0,0,1,797,1,797,0.019426000,0.0000
134.5.66.105,<->,109.222.250.46,0,0,1,209,1,209,0.019412000,0.0000
133.178.226.60,<->,80.47.111.107,1,1245,0,0,1,1245,0.019318000,0.0000
100.182.151.25,<->,8.37.245.94,1,141,0,0,1,141,0.019132000,0.0000
215.158.239.51,<->,199.20.7.145,1,87,0,0,1,87,0.018894000,0.0000
249.101.100.85,<->,53.230.38.130,1,157,0,0,1,157,0.018771000,0.0000
204.186.218.123,<->,136.25.188.225,0,0,1,182,1,182,0.018245000,0.0000
215.158.239.79,<->,199.20.31.125,1,934,0,0,1,934,0.018192000,0.0000
8.222.48.251,<->,6.73.247.6,0,0,1,537,1,537,0.017917000,0.0000
220.50.226.64,<->,136.181.43.206,0,0,1,119,1,119,0.017804000,0.0000
195.6.101.83,<->,136.25.188.176,0,0,1,845,1,845,0.017666000,0.0000
149.73.217.200,<->,50.224.89.243,0,0,1,1206,1,1206,0.017166000,0.0000
89.155.199.142,<->,8.182.226.78,0,0,1,553,1,553,0.017136000,0.0000
215.158.239.84,<->,194.250.220.170,1,330,0,0,1,330,0.017083000,0.0000
146.249.226.8,<->,8.252.222.172,0,0,1,172,1,172,0.016989000,0.0000
248.239.152.81,<->,8.45.175.127,1,433,0,0,1,433,0.016871000,0.0000
136.25.188.196,<->,106.188.236.202,1,1197,0,0,1,1197,0.016400000,0.0000
215.158.238.133,<->,120.155.14.70,1,1197,0,0,1,1197,0.016289000,0.0000
199.111.27.63,<->,8.182.241.53,0,0,1,269,1,269,0.016057000,0.0000
199.51.129.216,<->,136.25.188.197,0,0,1,259,1,259,0.015941000,0.0000
215.158.238.96,<->,142.239.121.93,1,1293,0,0,1,1293,0.015604000,0.0000
192.229.216.117,<->,91.51.31.120,1,95,0,0,1,95,0.015297000,0.0000
215.158.238.81,<->,122.158.49.195,1,1261,0,0,1,1261,0.014951000,0.0000
215.158.239.50,<->,199.20.30.157,1,132,0,0,1,132,0.014891000,0.0000
210.209.251.214,<->,137.137.124.27,0,0,1,432,1,432,0.014886000,0.0000
215.158.239.95,<->,195.7.21.76,1,95,0,0,1,95,0.014299000,0.0000
48.19.181.200,<->,8.252.221.236,0,0,1,452,1,452,0.014231000,0.0000
195.5.201.107,<->,136.25.188.45,0,0,1,885,1,885,0.013922000,0.0000
8.182.228.191,<->,6.242.27.151,1,386,0,0,1,386,0.013362000,0.0000
215.158.239.47,<->,98.219.126.175,1,369,0,0,1,369,0.013060000,0.0000
192.205.38.163,<->,133.32.39.0,0,0,1,247,1,247,0.012511000,0.0000
50.224.76.235,<->,50.183.208.169,1,516,0,0,1,516,0.012421000,0.0000
207.58.195.47,<->,136.25.188.252,0,0,1,602,1,602,0.011749000,0.0000
215.158.239.58,<->,199.20.30.109,1,87,0,0,1,87,0.011663000,0.0000
136.181.33.181,<->,0.195.216.195,1,141,0,0,1,141,0.011642000,0.0000
145.189.24.252,<->,8.52.185.143,0,0,1,262,1,262,0.011631000,0.0000
136.25.189.16,<->,133.56.180.0,1,1229,0,0,1,1229,0.011307000,0.0000
69.246.46.252,<->,8.252.222.28,0,0,1,101,1,101,0.011202000,0.0000
133.178.227.41,<->,120.20.132.11,1,1146,0,0,1,1146,0.010992000,0.0000
215.158.239.57,<->,159.23.130.168,1,1213,0,0,1,1213,0.010852000,0.0000
220.20.200.143,<->,131.45.239.182,1,526,0,0,1,526,0.010346000,0.0000
136.25.189.13,<->,29.214.73.158,1,1357,0,0,1,1357,0.010319000,0.0000
142.208.56.126,<->,136.25.188.226,0,0,1,170,1,170,0.010173000,0.0000
220.39.233.168,<->,215.158.238.67,0,0,1,1379,1,1379,0.010132000,0.0000
112.220.206.122,<->,82.237.235.220,0,0,1,129,1,129,0.010123000,0.0000
215.158.238.106,<->,6.73.247.65,1,1101,0,0,1,1101,0.010066000,0.0000
111.20.168.123,<->,92.160.6.109,1,1109,0,0,1,1109,0.009771000,0.0000
136.25.189.12,<->,8.215.68.80,1,1309,0,0,1,1309,0.009393000,0.0000
246.253.132.250,<->,119.127.190.237,1,434,0,0,1,434,0.009140000,0.0000
194.210.128.41,<->,8.182.250.65,0,0,1,648,1,648,0.008903000,0.0000
93.181.154.49,<->,92.27.27.154,0,0,1,50,1,50,0.008900000,0.0000
215.158.239.4,<->,215.158.127.163,1,57,0,0,1,57,0.008686000,0.0000
215.158.23.23,<->,144.29.28.236,1,68,0,0,1,68,0.008468000,0.0000
207.200.94.18,<->,8.182.224.87,0,0,1,464,1,464,0.007942000,0.0000
136.25.189.18,<->,133.56.180.11,1,1325,0,0,1,1325,0.007658000,0.0000
109.222.200.93,<->,105.65.93.60,1,294,0,0,1,294,0.007657000,0.0000
143.104.159.198,<->,8.182.227.180,0,0,1,561,1,561,0.007633000,0.0000
195.6.148.119,<->,136.25.188.209,0,0,1,89,1,89,0.007548000,0.0000
215.158.239.99,<->,207.16.240.201,1,781,0,0,1,781,0.007374000,0.0000
215.158.239.49,<->,199.20.31.103,1,765,0,0,1,765,0.007368000,0.0000
220.39.29.166,<->,99.74.26.96,0,0,1,144,1,144,0.007331000,0.0000
215.158.239.95,<->,199.20.28.0,1,93,0,0,1,93,0.007328000,0.0000
215.158.239.182,<->,106.188.226.65,1,284,0,0,1,284,0.007189000,0.0000
204.185.245.104,<->,136.25.188.220,0,0,1,717,1,717,0.007091000,0.0000
215.158.3.131,<->,133.178.227.244,0,0,1,93,1,93,0.006949000,0.0000
136.25.188.210,<->,113.23.104.220,1,1277,0,0,1,1277,0.006870000,0.0000
133.178.226.19,<->,29.212.182.225,1,1325,0,0,1,1325,0.006669000,0.0000
221.102.122.48,<->,139.254.211.64,1,87,0,0,1,87,0.006478000,0.0000
231.140.176.221,<->,136.25.188.178,0,0,1,101,1,101,0.006162000,0.0000
195.5.128.204,<->,136.25.188.254,0,0,1,269,1,269,0.005438000,0.0000
133.178.226.202,<->,56.28.207.218,1,296,0,0,1,296,0.005361000,0.0000
111.20.168.123,<->,92.160.6.96,1,377,0,0,1,377,0.005188000,0.0000
97.126.27.248,<->,53.83.245.42,1,75,0,0,1,75,0.004996000,0.0000
215.158.238.220,<->,93.39.51.85,1,1047,0,0,1,1047,0.004980000,0.0000
111.181.98.129,<->,8.55.195.24,1,75,0,0,1,75,0.004837000,0.0000
231.140.159.21,<->,136.25.188.175,0,0,1,93,1,93,0.004823000,0.0000
92.27.219.178,<->,33.57.74.163,1,50,0,0,1,50,0.004745000,0.0000
249.101.97.200,<->,50.145.202.200,1,109,0,0,1,109,0.004502000,0.0000
199.73.78.21,<->,136.25.188.174,0,0,1,608,1,608,0.004476000,0.0000
215.158.239.77,<->,8.255.92.180,1,1421,0,0,1,1421,0.004360000,0.0000
212.70.217.75,<->,133.178.226.18,0,0,1,1357,1,1357,0.004323000,0.0000
6.145.169.245,<->,0.195.210.44,0,0,1,87,1,87,0.004226000,0.0000
101.126.178.62,<->,8.55.195.24,1,97,0,0,1,97,0.004154000,0.0000
107.253.12.221,<->,8.182.228.20,0,0,1,1137,1,1137,0.003918000,0.0000
204.21.78.129,<->,136.25.188.253,0,0,1,87,1,87,0.003557000,0.0000
139.33.174.95,<->,97.126.14.75,0,0,1,597,1,597,0.003523000,0.0000
53.231.73.166,<->,48.53.16.89,0,0,1,97,1,97,0.003303000,0.0000
192.67.144.154,<->,30.179.117.60,1,93,0,0,1,93,0.003287000,0.0000
215.158.239.69,<->,196.106.64.72,1,382,0,0,1,382,0.003152000,0.0000
215.158.239.92,<->,196.94.66.138,1,593,0,0,1,593,0.003043000,0.0000
215.158.30.187,<->,8.252.222.32,0,0,1,93,1,93,0.002936000,0.0000
215.158.239.58,<->,196.105.70.214,1,717,0,0,1,717,0.002699000,0.0000
50.204.103.37,<->,8.220.176.253,0,0,1,367,1,367,0.002620000,0.0000
136.25.189.83,<->,80.56.79.87,1,1294,0,0,1,1294,0.002289000,0.0000
139.193.141.139,<->,115.139.86.211,1,378,0,0,1,378,0.001992000,0.0000
212.118.48.193,<->,8.52.169.61,0,0,1,75,1,75,0.001880000,0.0000
133.165.252.43,<->,109.127.101.16,1,509,0,0,1,509,0.001689000,0.0000
243.117.106.157,<->,80.38.36.175,0,0,1,1290,1,1290,0.001648000,0.0000
199.121.82.30,<->,136.25.188.255,0,0,1,87,1,87,0.001571000,0.0000
222.65.25.155,<->,132.18.67.27,1,105,0,0,1,105,0.001118000,0.0000
213.186.59.241,<->,144.85.170.246,0,0,1,858,1,858,0.001060000,0.0000
159.23.225.100,<->,142.247.156.43,1,88,0,0,1,88,0.000984000,0.0000
218.4.176.27,<->,8.207.172.239,1,575,0,0,1,575,0.000982000,0.0000
215.158.239.48,<->,194.251.64.62,1,765,0,0,1,765,0.000691000,0.0000
215.158.239.69,<->,199.20.22.89,1,93,0,0,1,93,0.000536000,0.0000
197.113.99.50,<->,136.25.188.253,0,0,1,93,1,93,0.000214000,0.0000
215.158.238.67,<->,131.1.195.247,1,1325,0,0,1,1325,0.000124000,0.0000
